fTNear,fTFar,fDelT,fQNear,fQFar,d
118939298405,118939298398,-7,102,28,40
7886493,7886493,0,1680,1946,40
10923945,10923942,-3,628,2260,40
11106704,11106719,15,111,4966,40
12242614,12242596,-18,773,2615,40
12513992,12513997,5,2656,1396,40
13129479,13129482,3,2586,2354,40
15652843,15652837,-6,1120,2362,40
16945946,16945941,-5,1153,4122,40
17257774,17257766,-8,25,1090,40
20197312,20197309,-3,1581,3283,40
20287969,20287962,-7,774,2773,40
20977028,20977038,10,19,1041,40
23458419,23458415,-4,1464,3799,40
28324466,28324461,-5,996,3549,40
28870054,28870074,20,517,2013,40
30418113,30418107,-6,945,2641,40
33076310,33076302,-8,804,3600,40
36505483,36505487,4,2462,1432,40
37885715,37885711,-4,1245,2730,40
41511884,41511878,-6,1278,3667,40
58767714,58767712,-2,1033,2146,40
59196855,59196866,11,59,668,40
61955462,61955457,-5,1210,4011,40
63925122,63925113,-9,16779,52760,40
65186451,65186446,-5,773,3858,40
66973606,66973599,-7,245,1476,40
68192503,68192506,3,11319,10666,40
70537635,70537629,-6,986,3701,40
71297636,71297638,2,165,961,40
73537250,73537254,4,2109,994,40
79505934,79505928,-6,1156,3829,40
81449045,81449064,19,150,826,40
83482255,83482251,-4,892,2537,40
85664378,85664373,-5,1001,4163,40
87009931,87009926,-5,1167,4034,40
94846286,94846279,-7,901,4270,40
94882840,94882850,10,30,1048,40
95063205,95063226,21,1123,2658,40
98002391,98002395,4,1386,1514,40
98602870,98602890,20,577,1452,40
104597394,104597390,-4,952,4034,40
108515891,108515884,-7,1036,3390,40
111040566,111040583,17,1391,96,40
112416818,112416812,-6,1022,7550,40
113351911,113351906,-5,537,1497,40
113658704,113658723,19,601,3761,40
114556510,114556524,14,827,224,40
114804017,114804012,-5,1360,1597,40
124470487,124470481,-6,1260,3838,40
127390434,127390441,7,3998,1769,40
130059066,130059061,-5,1262,3941,40
130289363,130289357,-6,1036,4488,40
135102934,135102929,-5,806,2248,40
140712785,140712781,-4,1069,1791,40
147260961,147260954,-7,1246,3981,40
147832376,147832371,-5,2133,5939,40
148315558,148315551,-7,940,3360,40
148543635,148543630,-5,1175,3229,40
152885606,152885607,1,2743,2173,40
155084978,155084972,-6,942,3240,40
158812012,158812017,5,2197,1297,40
162427892,162427886,-6,801,3757,40
173519369,173519356,-13,970,307,40
176863678,176863675,-3,1061,2073,40
177234454,177234435,-19,223,1848,40
182118528,182118531,3,26451,21590,40
186611874,186611868,-6,858,4440,40
188867440,188867434,-6,1088,4096,40
190123331,190123326,-5,897,2437,40
190186761,190186754,-7,1071,2881,40
192796781,192796776,-5,1434,5758,40
193724845,193724839,-6,1238,4317,40
194190242,194190237,-5,966,1852,40
194709398,194709393,-5,730,3617,40
201198243,201198239,-4,2279,5617,40
201444468,201444462,-6,1000,4009,40
201613693,201613715,22,292,924,40
206174370,206174363,-7,838,3733,40
206479192,206479211,19,44,1019,40
210924084,210924093,9,251,641,40
211419886,211419906,20,694,3741,40
213091959,213091954,-5,720,2099,40
215666646,215666638,-8,985,3314,40
222968005,222967998,-7,602,2923,40
227414189,227414185,-4,1473,3345,40
237697300,237697294,-6,465,2590,40
241595569,241595575,6,3207,1099,40
243789217,243789213,-4,1151,4771,40
243967173,243967161,-12,1217,4547,40
244563548,244563568,20,490,3244,40
256544521,256544515,-6,1365,4278,40
257144987,257144987,0,1933,1863,40
262107527,262107520,-7,1398,4685,40
275763284,275763278,-6,930,2500,40
279159587,279159581,-6,852,4067,40
279472132,279472141,9,265,1382,40
288562162,288562178,16,600,2585,40
291647321,291647313,-8,1178,4304,40
291823647,291823635,-12,171,860,40
304438086,304438080,-6,1367,5590,40
305148892,305148901,9,150,1440,40
306548119,306548114,-5,994,2100,40
311961502,311961497,-5,1884,3607,40
317335219,317335213,-6,743,1655,40
321957729,321957723,-6,935,3852,40
325317714,325317696,-18,3098,637,40
326214614,326214608,-6,1066,3056,40
328547435,328547427,-8,1451,4650,40
332130199,332130192,-7,999,4900,40
339436058,339436052,-6,854,3542,40
343871311,343871306,-5,729,3999,40
344228771,344228766,-5,1107,2629,40
344974589,344974583,-6,1172,2715,40
348366024,348366019,-5,952,2542,40
350364739,350364733,-6,2782,6418,40
355266918,355266913,-5,1172,4233,40
360834225,360834230,5,3757,1999,40
363394577,363394570,-7,1033,4422,40
371330987,371330982,-5,1065,3830,40
372105773,372105793,20,858,4542,40
372611721,372611715,-6,1462,3576,40
375059165,375059169,4,2900,1514,40
382839522,382839517,-5,1488,7085,40
388812648,388812642,-6,1268,4272,40
388907375,388907356,-19,787,2430,40
403475670,403475662,-8,1092,3942,40
406048673,406048666,-7,873,3306,40
407672662,407672658,-4,888,3225,40
409665099,409665097,-2,855,1306,40
410395800,410395818,18,249,1196,40
422139430,422139422,-8,992,2343,40
423531431,423531426,-5,763,3580,40
429967843,429967837,-6,1177,3604,40
431765815,431765813,-2,1170,1934,40
435678766,435678761,-5,1141,4622,40
437624915,437624910,-5,295,1280,40
437883079,437883095,16,1090,4017,40
438679771,438679766,-5,797,3055,40
438837614,438837626,12,383,863,40
441087263,441087257,-6,1046,4545,40
446538670,446538664,-6,662,2018,40
452157566,452157561,-5,777,1598,40
452418418,452418410,-8,807,2396,40
457844530,457844525,-5,1042,3765,40
458898438,458898426,-12,165,718,40
459466410,459466411,1,662,1321,40
459559119,459559138,19,565,3500,40
460498277,460498270,-7,824,3804,40
460852252,460852244,-8,275,1403,40
463174349,463174349,0,1071,1861,40
466142682,466142677,-5,1421,5072,40
472020853,472020854,1,767,987,40
477721090,477721084,-6,812,3540,40
477749862,477749849,-13,1192,4376,40
479938370,479938362,-8,920,3637,40
480027665,480027656,-9,242,1183,40
481546870,481546864,-6,1254,4904,40
483063810,483063805,-5,1282,3776,40
483543526,483543519,-7,1295,4655,40
484448539,484448533,-6,1347,4722,40
484594866,484594863,-3,1131,3708,40
486584798,486584792,-6,1675,6603,40
486621096,486621092,-4,1116,3792,40
489299128,489299122,-6,1184,2953,40
492946299,492946293,-6,709,3373,40
501237463,501237456,-7,1048,3517,40
501505132,501505150,18,244,1372,40
505153908,505153902,-6,1022,5232,40
507143331,507143326,-5,1001,4193,40
507553324,507553318,-6,994,4525,40
509248361,509248353,-8,856,4338,40
510600685,510600706,21,160,1490,40
514720286,514720294,8,5506,940,40
518188167,518188162,-5,836,2446,40
518252271,518252291,20,675,2486,40
518710055,518710061,6,16754,57871,40
524842210,524842205,-5,923,3347,40
526096110,526096106,-4,1016,1715,40
529897639,529897633,-6,931,3461,40
533231943,533231937,-6,864,3350,40
535430139,535430133,-6,1122,2584,40
537481921,537481917,-4,1363,3582,40
538009180,538009173,-7,976,2669,40
538301622,538301637,15,1156,3017,40
541182229,541182221,-8,994,3028,40
544472854,544472848,-6,1270,3673,40
545574652,545574646,-6,1532,4746,40
545913943,545913936,-7,1000,4019,40
546401802,546401797,-5,1131,5070,40
547603679,547603674,-5,997,3149,40
551209549,551209543,-6,1179,3874,40
552351514,552351516,2,1461,1785,40
552766480,552766474,-6,793,1819,40
555423113,555423120,7,2357,535,40
556207192,556207186,-6,1113,3778,40
570180221,570180220,-1,27582,27867,40
572725066,572725070,4,3602,2470,40
573475898,573475894,-4,699,2573,40
573772558,573772577,19,929,3565,40
574981371,574981362,-9,782,2454,40
578369510,578369506,-4,1003,3828,40
583027825,583027820,-5,1417,2860,40
583073110,583073123,13,326,1264,40
584102566,584102558,-8,865,4185,40
587803377,587803373,-4,831,2910,40
589554165,589554158,-7,1370,2899,40
589909533,589909546,13,26,908,40
592730741,592730741,0,800,805,40
594059494,594059490,-4,709,2355,40
595612275,595612270,-5,1539,3623,40
598289526,598289518,-8,525,2247,40
601209535,601209530,-5,811,3411,40
607035687,607035681,-6,1351,5005,40
609385629,609385624,-5,1149,3451,40
610776295,610776288,-7,861,3485,40
611073535,611073550,15,260,984,40
611995390,611995371,-19,205,934,40
616929751,616929745,-6,878,2716,40
617400412,617400432,20,695,1839,40
619476502,619476496,-6,859,4429,40
624874674,624874666,-8,1120,4330,40
632293343,632293337,-6,1193,4044,40
632539797,632539782,-15,746,2772,40
633114480,633114458,-22,185,1347,40
633727439,633727444,5,353,3166,40
634762178,634762173,-5,1009,3104,40
635709920,635709918,-2,632,768,40
639447698,639447693,-5,1007,3387,40
640690670,640690663,-7,1521,4753,40
647137425,647137404,-21,1627,645,40
650127109,650127099,-10,280,1207,40
650340829,650340839,10,196,1207,40
651912957,651912966,9,366,1230,40
653978254,653978248,-6,843,5150,40
661441849,661441843,-6,1392,3973,40
663879386,663879383,-3,1122,2384,40
667571191,667571185,-6,1154,3085,40
670091134,670091134,0,1034,1126,40
670272804,670272799,-5,900,4791,40
673101338,673101332,-6,1181,3946,40
679693770,679693765,-5,1360,4847,40
682130481,682130476,-5,1158,3862,40
683613605,683613613,8,150,1283,40
683750629,683750649,20,382,1025,40
685350581,685350576,-5,1472,5656,40
685519522,685519515,-7,827,4242,40
690641360,690641354,-6,1209,4060,40
695112538,695112533,-5,858,3694,40
706245206,706245200,-6,1222,3007,40
708913603,708913598,-5,1068,3443,40
712390762,712390765,3,1383,998,40
716488787,716488781,-6,1583,8081,40
717145971,717145966,-5,1143,3798,40
719826862,719826858,-4,954,3527,40
720905846,720905850,4,1522,813,40
721701682,721701675,-7,928,2393,40
722023598,722023594,-4,1168,2337,40
728285663,728285660,-3,1254,2695,40
728361669,728361691,22,256,1386,40
729552985,729552978,-7,1197,4037,40
739179678,739179681,3,1613,1610,40
740790189,740790185,-4,1447,3593,40
753471689,753471684,-5,1399,3676,40
755620523,755620518,-5,879,4618,40
757364889,757364883,-6,1028,1788,40
757674125,757674145,20,694,3430,40
758862138,758862133,-5,669,2080,40
761390282,761390277,-5,1102,4190,40
762714557,762714552,-5,860,4764,40
763418950,763418955,5,4806,2329,40
768318307,768318301,-6,1287,6078,40
768621684,768621687,3,13,634,40
775570587,775570582,-5,952,3231,40
775935758,775935754,-4,1170,2976,40
795067830,795067837,7,2448,1344,40
804429335,804429330,-5,1072,3742,40
804775537,804775530,-7,1142,3270,40
808065854,808065853,-1,983,1779,40
815989067,815989067,0,1612,1719,40
818321159,818321154,-5,1272,4155,40
824635600,824635595,-5,744,3050,40
824720916,824720929,13,311,1846,40
826045031,826045035,4,4455,2715,40
828031594,828031585,-9,37,680,40
835116242,835116237,-5,1402,2819,40
836356708,836356700,-8,949,3725,40
840860997,840860992,-5,1323,4682,40
850238297,850238290,-7,787,4475,40
852872955,852872950,-5,991,3842,40
858977029,858977027,-2,832,2876,40
861498949,861498943,-6,826,2866,40
863207239,863207241,2,1183,1507,40
866519297,866519291,-6,853,3832,40
869429711,869429705,-6,1007,3332,40
872022514,872022509,-5,1199,3721,40
872531336,872531347,11,45,949,40
884572906,884572906,0,1080,1028,40
890392945,890392939,-6,768,3362,40
891730242,891730237,-5,1126,2802,40
894442575,894442569,-6,1046,2764,40
899147790,899147786,-4,1166,4375,40
899209014,899209009,-5,898,3982,40
901657414,901657409,-5,779,2229,40
901962911,901962897,-14,196,1134,40
903469341,903469326,-15,71,1108,40
903700582,903700574,-8,335,1326,40
904355591,904355610,19,86,1075,40
904658700,904658702,2,66,849,40
905910131,905910125,-6,562,3297,40
911970049,911970044,-5,2305,7406,40
913802281,913802261,-20,834,3009,40
915197150,915197142,-8,1348,4915,40
921598943,921598927,-16,25796,19427,40
922852766,922852787,21,1593,1307,40
927324945,927324939,-6,951,2979,40
927456391,927456373,-18,69,1037,40
930336029,930336033,4,1388,1069,40
930908573,930908569,-4,901,2727,40
931649142,931649161,19,830,2761,40
932475036,932475042,6,1770,1246,40
945153209,945153201,-8,1198,3929,40
947425024,947425018,-6,1308,4142,40
947453567,947453566,-1,886,1473,40
952316158,952316153,-5,808,2690,40
973370738,973370732,-6,1323,4525,40
977275696,977275697,1,1231,2351,40
994332874,994332867,-7,659,2054,40
994857838,994857832,-6,1444,3529,40
999173490,999173489,-1,1380,2561,40
999349990,999349983,-7,1134,3597,40
999736942,999736941,-1,338,1240,40
1000130084,1000130065,-19,879,2519,40
1000774044,1000774058,14,19571,28288,40
1005126023,1005126017,-6,1110,4498,40
1009282410,1009282410,0,3188,4508,40
1027837354,1027837358,4,2130,1338,40
1032543349,1032543344,-5,958,4079,40
1038594269,1038594271,2,1039,1237,40
1038842673,1038842667,-6,1060,4383,40
1041805122,1041805105,-17,1140,2704,40
1047193433,1047193426,-7,857,3771,40
1047783918,1047783913,-5,1219,3494,40
1051773619,1051773614,-5,809,3866,40
1056564279,1056564297,18,477,2679,40
1059439809,1059439802,-7,1072,4043,40
1061562594,1061562589,-5,852,2262,40
1061683717,1061683709,-8,2744,10528,40
1062731001,1062730994,-7,733,4116,40
1064286954,1064286946,-8,971,3518,40
1068581151,1068581145,-6,1465,6865,40
1076803485,1076803479,-6,792,3022,40
1078147355,1078147351,-4,823,3211,40
1080235853,1080235846,-7,1010,3002,40
1080698406,1080698388,-18,961,3377,40
1080944910,1080944922,12,1036,3620,40
1082534354,1082534339,-15,1336,216,40
1088441086,1088441079,-7,1172,3138,40
1091487778,1091487786,8,3773,1335,40
1092145502,1092145494,-8,1029,4283,40
1099619505,1099619501,-4,535,1912,40
1099672806,1099672785,-21,24,1300,40
1101571262,1101571254,-8,869,2331,40
1119232345,1119232339,-6,962,3770,40
1119654716,1119654734,18,528,2149,40
1120862680,1120862673,-7,1502,4708,40
1128202891,1128202885,-6,804,3534,40
1128252256,1128252272,16,190,1439,40
1128812455,1128812442,-13,1130,4131,40
1132797047,1132797041,-6,787,3384,40
1133203151,1133203150,-1,317,1420,40
1135440538,1135440539,1,3205,2917,40
1146552662,1146552661,-1,1098,1518,40
1146616046,1146616044,-2,183,2469,40
1151331138,1151331133,-5,716,3202,40
1155217562,1155217555,-7,755,4074,40
1155586988,1155586980,-8,913,3272,40
1156170356,1156170349,-7,440,1579,40
1156373432,1156373426,-6,1208,2684,40
1163178911,1163178916,5,2561,1553,40
1165254970,1165254964,-6,878,3497,40
1167654227,1167654223,-4,973,2862,40
1173096227,1173096224,-3,952,2381,40
1176135618,1176135613,-5,1368,2888,40
1180477927,1180477926,-1,656,1560,40
1187798754,1187798748,-6,967,3758,40
1188919499,1188919496,-3,1162,1864,40
1189901110,1189901103,-7,932,3763,40
1191024671,1191024650,-21,87,1227,40
1197220689,1197220685,-4,880,2334,40
1200255941,1200255934,-7,1199,3937,40
1203347406,1203347402,-4,1044,2496,40
1208086460,1208086461,1,1752,1489,40
1208270343,1208270338,-5,872,2807,40
1210050205,1210050198,-7,1205,4037,40
1210467974,1210467955,-19,219,1376,40
1221822297,1221822292,-5,1040,4315,40
1221852557,1221852570,13,330,1391,40
1223713969,1223713962,-7,1137,5246,40
1228968390,1228968388,-2,35174,62342,40
1240391906,1240391902,-4,1048,2888,40
1240916279,1240916298,19,722,4044,40
1241994177,1241994171,-6,1076,4433,40
1242928203,1242928196,-7,1059,3305,40
1243858290,1243858284,-6,1203,3150,40
1244508711,1244508720,9,268,1452,40
1244668770,1244668762,-8,984,4097,40
1247040549,1247040541,-8,798,2141,40
1247624678,1247624670,-8,262,876,40
1249571519,1249571513,-6,884,2820,40
1256899370,1256899368,-2,1147,1868,40
1263967494,1263967487,-7,1974,6453,40
1265560747,1265560740,-7,1227,3210,40
1266415551,1266415544,-7,1107,3865,40
1266981537,1266981542,5,4058,3366,40
1268513022,1268513018,-4,1241,4015,40
1269145411,1269145409,-2,1388,2572,40
1270182376,1270182376,0,10951,14652,40
1274095233,1274095228,-5,702,2940,40
1281115504,1281115500,-4,1029,4233,40
1281590871,1281590851,-20,190,1333,40
1291642630,1291642625,-5,826,3651,40
1297801142,1297801136,-6,1012,3981,40
1298303198,1298303208,10,18119,22668,40
1308648766,1308648759,-7,1347,5654,40
1311514967,1311514964,-3,177,1227,40
1315974505,1315974499,-6,1428,3335,40
1322360166,1322360169,3,1499,631,40
1328152974,1328152980,6,1674,1080,40
1328812895,1328812889,-6,1301,3974,40
1329163415,1329163427,12,267,993,40
1334591681,1334591675,-6,1081,2608,40
1349646154,1349646149,-5,783,1592,40
1352340542,1352340536,-6,1945,6646,40
1358732663,1358732659,-4,1142,3305,40
1359082743,1359082736,-7,912,3104,40
1369917946,1369917945,-1,1165,1720,40
1372576332,1372576349,17,364,850,40
1386807182,1386807174,-8,850,2644,40
1390110902,1390110897,-5,955,4221,40
1390477934,1390477952,18,430,2328,40
1392396845,1392396842,-3,1403,2920,40
1393291253,1393291274,21,708,2589,40
1393553749,1393553746,-3,1558,4137,40
1398360871,1398360866,-5,994,3289,40
1402244681,1402244677,-4,1280,3067,40
1402550158,1402550153,-5,1278,4492,40
1404468463,1404468456,-7,843,3663,40
1406070526,1406070521,-5,784,3253,40
1406990324,1406990305,-19,1080,3127,40
1428751883,1428751877,-6,1403,3865,40
1431678538,1431678535,-3,726,3255,40
1432981750,1432981753,3,2694,1968,40
1436192364,1436192370,6,3381,1374,40
1447965881,1447965874,-7,1320,5087,40
1450356899,1450356894,-5,970,2250,40
1452088549,1452088544,-5,777,3104,40
1455620410,1455620409,-1,1523,2284,40
1469526282,1469526285,3,3266,3030,40
1469681525,1469681518,-7,1146,3895,40
1471828130,1471828130,0,2891,4453,40
1487088065,1487088058,-7,1036,3693,40
1490544359,1490544350,-9,1135,4437,40
1494647794,1494647789,-5,1111,3019,40
1496328904,1496328914,10,20890,47322,40
1511624881,1511624874,-7,975,4566,40
1512102885,1512102906,21,377,994,40
1515248768,1515248764,-4,1341,2439,40
1518780418,1518780413,-5,705,3490,40
1531437762,1531437758,-4,1180,5148,40
1531512276,1531512297,21,263,1133,40
1531996231,1531996209,-22,141,978,40
1532778671,1532778669,-2,1677,2265,40
1535636979,1535636973,-6,735,1909,40
1536421672,1536421666,-6,1386,5404,40
1536973455,1536973440,-15,318,1473,40
1543241334,1543241341,7,3077,1595,40
1546254685,1546254678,-7,1337,4098,40
1553840054,1553840069,15,940,3863,40
1557088529,1557088522,-7,757,3579,40
1561722067,1561722062,-5,1400,4255,40
1563683431,1563683426,-5,895,3587,40
1563934158,1563934157,-1,137,1259,40
1564589989,1564589983,-6,1418,5098,40
1572366454,1572366449,-5,1134,4411,40
1573170592,1573170589,-3,687,3301,40
1575245114,1575245115,1,3830,4114,40
1579760854,1579760849,-5,827,3265,40
1584778782,1584778778,-4,983,3603,40
1585154023,1585154042,19,141,1083,40
1585857490,1585857495,5,1810,983,40
1588915862,1588915855,-7,1327,4405,40
1592439058,1592439052,-6,834,3731,40
1593000343,1593000321,-22,1150,3392,40
1593277516,1593277535,19,520,1444,40
1593880566,1593880560,-6,990,4422,40
1603692138,1603692145,7,1238,1280,40
1609222707,1609222706,-1,2136,3178,40
1610784662,1610784658,-4,1353,3601,40
1611238818,1611238816,-2,1201,1994,40
1619031913,1619031911,-2,864,1934,40
1625498914,1625498907,-7,871,3402,40
1625643043,1625643039,-4,1150,5502,40
1638253130,1638253122,-8,1276,6133,40
1646886557,1646886560,3,3508,1795,40
1647665610,1647665605,-5,949,2849,40
1649450965,1649450958,-7,1077,3243,40
1651141661,1651141655,-6,1949,5203,40
1652312474,1652312473,-1,1844,4057,40
1657406367,1657406363,-4,1126,4354,40
1667321267,1667321262,-5,1382,4136,40
1668567422,1668567417,-5,712,4149,40
1670072437,1670072416,-21,1056,5833,40
1670428094,1670428110,16,199,2977,40
1671298268,1671298245,-23,503,1176,40
1674582031,1674582026,-5,1303,3769,40
1676623673,1676623667,-6,1448,4056,40
1681563471,1681563472,1,2389,3613,40
1684977034,1684977029,-5,1288,3631,40
1685089518,1685089531,13,127,883,40
1688235425,1688235418,-7,801,3642,40
1696035126,1696035125,-1,1423,1570,40
1701819611,1701819610,-1,888,1326,40
1703135530,1703135524,-6,1561,2864,40
1710914507,1710914501,-6,970,3271,40
1711243424,1711243427,3,117,1131,40
1714406858,1714406858,0,1637,2319,40
1718200481,1718200475,-6,857,2686,40
1732018727,1732018723,-4,1184,2497,40
1745220376,1745220371,-5,2434,5276,40
1746917652,1746917645,-7,1544,5609,40
1747434975,1747434969,-6,984,5685,40
1747978470,1747978463,-7,1064,3557,40
1751654731,1751654750,19,3964,1268,40
1753136817,1753136811,-6,963,4299,40
1755964198,1755964205,7,8301,3789,40
1756884798,1756884792,-6,906,3067,40
1766327324,1766327317,-7,1011,3774,40
1769038087,1769038081,-6,715,3038,40
1773170218,1773170211,-7,1432,4563,40
1787272274,1787272270,-4,730,3269,40
1792092781,1792092781,0,1611,2530,40
1792279282,1792279276,-6,661,3037,40
1792364503,1792364499,-4,68,1028,40
1792945532,1792945530,-2,1422,1732,40
1798560015,1798560021,6,2598,2718,40
1806352282,1806352276,-6,780,4036,40
1807253018,1807253012,-6,1381,3647,40
1809335159,1809335153,-6,802,3118,40
1812017389,1812017385,-4,1510,2384,40
1814932511,1814932505,-6,1349,3728,40
1817766080,1817766074,-6,1531,3963,40
1819749943,1819749938,-5,1192,2950,40
1830770031,1830770026,-5,913,3886,40
1831396117,1831396109,-8,1122,3565,40
1832714893,1832714874,-19,247,1164,40
1833440620,1833440623,3,14754,18197,40
1834219237,1834219231,-6,948,3372,40
1835258050,1835258042,-8,760,3219,40
1835677739,1835677733,-6,1163,4153,40
1837481139,1837481133,-6,1030,2958,40
1838922739,1838922734,-5,1345,3393,40
1840440379,1840440374,-5,1045,3759,40
1840497902,1840497922,20,151,898,40
1844416473,1844416467,-6,916,4113,40
1847458962,1847458957,-5,1136,3771,40
1857368975,1857368969,-6,739,3038,40
1863145518,1863145511,-7,1174,3687,40
1869838691,1869838686,-5,1090,2791,40
1871531158,1871531152,-6,1230,5151,40
1872856511,1872856509,-2,64,1364,40
1899705455,1899705449,-6,1009,4617,40
1901540724,1901540718,-6,814,3886,40
1908222551,1908222546,-5,1135,3904,40
1918778755,1918778747,-8,847,3854,40
1921191061,1921191044,-17,214,1009,40
1922076230,1922076210,-20,163,982,40
1925627854,1925627846,-8,705,2776,40
1930907612,1930907606,-6,1072,3919,40
1936296650,1936296648,-2,928,1153,40
1940060419,1940060414,-5,1057,2158,40
1942897180,1942897174,-6,1091,3409,40
1952170582,1952170577,-5,1296,3609,40
1953951998,1953951993,-5,1428,3306,40
1961574298,1961574291,-7,1186,3827,40
1961994894,1961994886,-8,1211,3413,40
1967298286,1967298290,4,1735,1777,40
1971831522,1971831518,-4,633,2644,40
1973608509,1973608505,-4,986,4188,40
1978204167,1978204161,-6,746,2291,40
1980538287,1980538281,-6,921,3716,40
1985895061,1985895048,-13,371,1654,40
1986666806,1986666821,15,207,1311,40
1989600218,1989600214,-4,1019,2809,40
1995053170,1995053164,-6,1234,3547,40
2000402180,2000402175,-5,745,3127,40
2001365761,2001365753,-8,1036,4057,40
2019073345,2019073337,-8,727,3770,40
2019750790,2019750810,20,518,1206,40
2020289743,2020289737,-6,2968,7551,40
2024673899,2024673895,-4,1247,2568,40
2026661297,2026661291,-6,1045,3842,40
2029740326,2029740322,-4,1186,3915,40
2029807283,2029807289,6,10429,35394,40
2030233554,2030233549,-5,1143,4145,40
2034623574,2034623569,-5,1424,3851,40
2038942939,2038942927,-12,30719,20158,40
2046240659,2046240653,-6,1170,3302,40
2048631364,2048631356,-8,725,2971,40
2057196166,2057196159,-7,574,4195,40
2057248323,2057248317,-6,1335,4932,40
2057659784,2057659778,-6,855,3938,40
2064667921,2064667914,-7,1333,3768,40
2065506694,2065506712,18,44,3342,40
2068139346,2068139339,-7,788,5211,40
2068943848,2068943866,18,224,2207,40
2071657644,2071657638,-6,963,3872,40
2072694282,2072694281,-1,2777,4810,40
2074483687,2074483682,-5,946,2461,40
2074541359,2074541370,11,355,1474,40
2074619390,2074619398,8,189,1230,40
2076563574,2076563571,-3,801,3011,40
2082531243,2082531238,-5,1130,3652,40
2087365176,2087365170,-6,828,3453,40
2088935692,2088935685,-7,823,2386,40
2105607889,2105607883,-6,1375,3275,40
2106261742,2106261749,7,3129,1494,40
2106639414,2106639409,-5,1022,3646,40
2106784202,2106784207,5,5435,2374,40
2113679503,2113679518,15,1143,1276,40
2115531081,2115531074,-7,1318,4586,40
2121181334,2121181319,-15,181,1288,40
2121932803,2121932796,-7,1093,3114,40
2125349583,2125349584,1,2075,1765,40
2133181239,2133181230,-9,896,3594,40
2134373248,2134373254,6,163,891,40
2137416563,2137416555,-8,865,3688,40
2140552634,2140552630,-4,893,2078,40
2146704662,2146704666,4,1537,849,40
2147658619,2147658614,-5,787,2935,40
2160881093,2160881086,-7,220,1262,40
2162747803,2162747798,-5,1295,3174,40
2163254062,2163254055,-7,975,3874,40
2164319638,2164319629,-9,98,1288,40
2171422831,2171422835,4,1377,1126,40
2173309219,2173309221,2,1735,1656,40
2174108606,2174108599,-7,1100,6103,40
2176398843,2176398838,-5,1043,4060,40
2178212003,2178211997,-6,1038,3356,40
2180726501,2180726494,-7,1172,3872,40
2181515182,2181515178,-4,1138,3992,40
2182342665,2182342658,-7,737,3740,40
2186292439,2186292433,-6,1443,4109,40
2186359085,2186359083,-2,198,1383,40
2189722176,2189722170,-6,1402,2406,40
2192222311,2192222305,-6,1299,3864,40
2198443938,2198443930,-8,813,3791,40
2203182484,2203182478,-6,1007,3923,40
2203463953,2203463948,-5,772,3485,40
2205542871,2205542864,-7,829,3449,40
2206118992,2206119005,13,688,2686,40
2206461737,2206461730,-7,1236,3160,40
2206706702,2206706714,12,853,2706,40
2208556273,2208556269,-4,798,3590,40
2209654383,2209654379,-4,917,3204,40
2214111174,2214111168,-6,861,3598,40
2227768978,2227768979,1,132,1064,40
2228571596,2228571590,-6,1038,3439,40
2229054789,2229054794,5,3090,2262,40
2229955536,2229955542,6,3100,1183,40
2233298933,2233298912,-21,109,1931,40
2233591517,2233591519,2,46,1252,40
2237783782,2237783777,-5,532,1080,40
2238613254,2238613247,-7,1182,4155,40
2241277274,2241277270,-4,1180,2564,40
2252816305,2252816299,-6,1335,3237,40
2256985394,2256985411,17,20,954,40
2264860727,2264860721,-6,1185,5763,40
2266712144,2266712141,-3,617,2398,40
2269457009,2269457005,-4,815,3709,40
2269608232,2269608243,11,453,1909,40
2277934853,2277934847,-6,780,3734,40
2285984381,2285984374,-7,1225,4095,40
2286516096,2286516089,-7,1326,4695,40
2306246369,2306246375,6,4495,1978,40
2306662787,2306662781,-6,1001,2561,40
2308839833,2308839830,-3,939,2895,40
2326008443,2326008436,-7,586,2070,40
2329079503,2329079518,15,724,2887,40
2331152790,2331152784,-6,1035,3171,40
2336694488,2336694484,-4,2466,6064,40
2339428985,2339428979,-6,686,2960,40
2341006558,2341006552,-6,758,3971,40
2342715214,2342715209,-5,888,2978,40
2346929850,2346929857,7,8652,2967,40
2348471810,2348471805,-5,626,1707,40
2351918115,2351918110,-5,809,3844,40
2355620045,2355620037,-8,596,3852,40
2355904247,2355904243,-4,882,2708,40
2359228785,2359228778,-7,1008,3438,40
2359625719,2359625734,15,1711,7865,40
2363032910,2363032905,-5,520,2385,40
2370721994,2370721987,-7,820,3475,40
2371187093,2371187085,-8,1037,3458,40
2372436614,2372436633,19,315,899,40
2376801636,2376801650,14,15194,34453,40
2393028196,2393028196,0,33914,19383,40
2393254461,2393254456,-5,776,2627,40
2397181681,2397181674,-7,1115,3957,40
2415076188,2415076181,-7,712,2267,40
2416723668,2416723662,-6,1277,4641,40
2417263783,2417263786,3,1367,1274,40
2417595949,2417595941,-8,878,3052,40
2419868238,2419868233,-5,972,3565,40
2422806758,2422806750,-8,892,4150,40
2423065359,2423065370,11,129,1375,40
2423239197,2423239214,17,232,2283,40
2426800401,2426800397,-4,795,3160,40
2433096907,2433096901,-6,1087,4134,40
2434239905,2434239910,5,2013,1199,40
2441192127,2441192122,-5,1376,3687,40
2447060658,2447060656,-2,756,1809,40
2454901726,2454901719,-7,656,3878,40
2457369798,2457369794,-4,823,3108,40
2458873398,2458873394,-4,940,3963,40
2459290705,2459290698,-7,1037,3168,40
2460721469,2460721461,-8,756,4167,40
2464956929,2464956921,-8,801,3935,40
2465546052,2465546044,-8,220,1572,40
2466489429,2466489422,-7,1246,4650,40
2466780668,2466780663,-5,109,916,40
2469214387,2469214383,-4,803,3166,40
2469751543,2469751537,-6,761,3558,40
2470397020,2470397027,7,178,2098,40
2470461128,2470461122,-6,1300,4821,40
2473191051,2473191045,-6,899,4317,40
2474193550,2474193530,-20,104,628,40
2483388502,2483388498,-4,691,3570,40
2489778466,2489778459,-7,1051,3142,40
2494662570,2494662565,-5,926,2310,40
2495335310,2495335290,-20,404,2184,40
2508832776,2508832786,10,234,1567,40
2513968854,2513968859,5,4748,2348,40
2514187526,2514187521,-5,1065,3100,40
2516383697,2516383702,5,3568,1541,40
2516795313,2516795327,14,597,176,40
2520197338,2520197333,-5,889,3000,40
2531382823,2531382817,-6,980,3240,40
2538011063,2538011058,-5,1168,2887,40
2547446882,2547446877,-5,1100,4148,40
2556933010,2556933005,-5,1643,5426,40
2564456323,2564456317,-6,957,2843,40
2570135611,2570135605,-6,751,1934,40
2570595684,2570595676,-8,1076,4515,40
2574319043,2574319036,-7,842,3454,40
2575192469,2575192478,9,73,1370,40
2576233215,2576233207,-8,12,682,40
2576751086,2576751079,-7,709,2490,40
2578134902,2578134890,-12,494,2530,40
2581023502,2581023495,-7,1299,3721,40
2583283934,2583283929,-5,1264,4015,40
2583592670,2583592664,-6,926,3881,40
2585897790,2585897785,-5,613,1762,40
2587460995,2587460990,-5,1013,2817,40
2591500334,2591500334,0,673,1433,40
2595789731,2595789726,-5,884,3212,40
2596988174,2596988170,-4,783,3280,40
2601171266,2601171259,-7,1015,2805,40
2602427303,2602427321,18,448,944,40
2612878055,2612878049,-6,998,3783,40
2613000623,2613000626,3,276,753,40
2614955044,2614955046,2,1850,2013,40
2625451780,2625451780,0,1543,1568,40
2626236293,2626236287,-6,217,790,40
2627491570,2627491571,1,1446,2105,40
2627896122,2627896117,-5,911,3552,40
2629019054,2629019049,-5,616,2649,40
2630045874,2630045868,-6,918,4030,40
2636438006,2636437999,-7,1193,5046,40
2640275311,2640275306,-5,1143,2911,40
2644466865,2644466858,-7,1218,3054,40
2645643963,2645643957,-6,738,2854,40
2645739503,2645739494,-9,233,1075,40
2649006071,2649006076,5,2540,1705,40
2649057010,2649057031,21,2356,1152,40
2657438026,2657438019,-7,482,2320,40
2661749403,2661749402,-1,988,1395,40
2667282493,2667282486,-7,1129,3585,40
2674098754,2674098749,-5,927,3546,40
2676194095,2676194088,-7,644,2444,40
2676287527,2676287544,17,534,3279,40
2676548630,2676548625,-5,1075,4661,40
2681172598,2681172593,-5,1253,4195,40
2682908927,2682908930,3,146,915,40
2683270989,2683270983,-6,970,4186,40
2683487064,2683487079,15,155,1350,40
2690668951,2690668946,-5,918,4073,40
2693305034,2693305018,-16,122,1125,40
2695013142,2695013136,-6,16545,16867,40
2696138314,2696138308,-6,804,2899,40
2696670464,2696670477,13,660,1521,40
2708719999,2708719994,-5,876,2680,40
2712932486,2712932481,-5,832,2616,40
2713893459,2713893451,-8,786,3287,40
2716332196,2716332202,6,4085,2030,40
2725498088,2725498082,-6,1138,3868,40
2725537564,2725537553,-11,831,3158,40
2730233130,2730233127,-3,2429,7035,40
2733938898,2733938892,-6,1019,2822,40
2734836320,2734836314,-6,636,1960,40
2738957473,2738957466,-7,935,4108,40
2739179078,2739179073,-5,1135,3780,40
2742008166,2742008163,-3,1121,1970,40
2742463590,2742463585,-5,1240,4128,40
2742899357,2742899377,20,1199,3066,40
2751352432,2751352425,-7,1185,5304,40
2757517850,2757517845,-5,909,3115,40
2759690562,2759690557,-5,698,3891,40
2760082885,2760082886,1,266,921,40
2761908264,2761908258,-6,1082,4509,40
2762045806,2762045815,9,175,877,40
2764651153,2764651146,-7,1068,4352,40
2779098410,2779098404,-6,762,2359,40
2785849814,2785849807,-7,926,5087,40
2787133834,2787133830,-4,1067,4108,40
2787630571,2787630566,-5,1288,4595,40
2789484218,2789484214,-4,896,2726,40
2791404713,2791404706,-7,1154,3617,40
2792444991,2792444972,-19,243,1140,40
2799327875,2799327868,-7,855,5094,40
2805928689,2805928695,6,6711,2381,40
2812701163,2812701157,-6,1188,6354,40
2816029249,2816029242,-7,929,3830,40
2825834258,2825834254,-4,804,2912,40
2826944967,2826944962,-5,787,2975,40
2828993838,2828993833,-5,772,2682,40
2837275398,2837275392,-6,1253,4011,40
2837650451,2837650446,-5,596,2074,40
2841007790,2841007784,-6,756,4091,40
2841115721,2841115724,3,2858,1877,40
2850264004,2850263997,-7,1503,4474,40
2852112636,2852112631,-5,1096,4425,40
2853385594,2853385586,-8,1185,5473,40
2853923407,2853923412,5,102,1065,40
2854492282,2854492277,-5,892,3822,40
2862628494,2862628490,-4,1073,3004,40
2863275435,2863275426,-9,431,1525,40
2864662913,2864662908,-5,1173,4465,40
2866250091,2866250085,-6,1363,2763,40
2868406121,2868406113,-8,1096,4276,40
2878314912,2878314905,-7,1202,4843,40
2879428018,2879428020,2,2202,1794,40
2881893713,2881893718,5,1944,1537,40
2885863515,2885863509,-6,964,3340,40
2886115878,2886115871,-7,1077,4325,40
2886677504,2886677521,17,875,4058,40
2889572997,2889572993,-4,640,3192,40
2890530456,2890530450,-6,982,3782,40
2895410970,2895410965,-5,662,1870,40
2895679630,2895679624,-6,1408,3224,40
2896386723,2896386725,2,902,1480,40
2902644319,2902644319,0,940,2105,40
2904504251,2904504245,-6,940,3526,40
2905797102,2905797096,-6,1085,3268,40
2907746599,2907746578,-21,240,1257,40
2909031293,2909031281,-12,51,709,40
2911602827,2911602822,-5,1286,3136,40
2912600313,2912600309,-4,717,2090,40
2915175226,2915175223,-3,999,1746,40
2915663838,2915663831,-7,1365,5154,40
2919119303,2919119297,-6,990,3317,40
2919200742,2919200737,-5,919,3289,40
2919287839,2919287817,-22,661,2780,40
2923257599,2923257594,-5,978,2341,40
2925464278,2925464273,-5,972,3590,40
2925600788,2925600782,-6,1159,4792,40
2936751233,2936751238,5,4202,1641,40
2937969997,2937969991,-6,935,4248,40
2938011321,2938011315,-6,991,3415,40
2938356425,2938356421,-4,1012,2847,40
2943108730,2943108722,-8,1154,3838,40
2943676170,2943676169,-1,1674,2133,40
2945549432,2945549425,-7,881,6578,40
2945674733,2945674753,20,253,1364,40
2945807166,2945807160,-6,864,4227,40
2949434910,2949434905,-5,1699,9309,40
2949589831,2949589825,-6,1069,3499,40
2954515977,2954515971,-6,1097,3991,40
2957749726,2957749722,-4,728,3290,40
2967728659,2967728654,-5,717,2042,40
2971275156,2971275150,-6,1021,3312,40
2971770142,2971770137,-5,1253,4308,40
2980349430,2980349423,-7,1146,3481,40
2981009925,2981009920,-5,1348,4305,40
2983345239,2983345235,-4,1007,2001,40
2986752583,2986752578,-5,1198,4337,40
2988435234,2988435229,-5,1383,4099,40
2989363749,2989363743,-6,1298,3101,40
2991004726,2991004721,-5,1312,2704,40
2991333933,2991333955,22,150,881,40
2998239214,2998239209,-5,775,2078,40
3005700070,3005700071,1,2331,2779,40
3006513558,3006513551,-7,1098,4267,40
3006677744,3006677762,18,180,1279,40
3010112802,3010112806,4,2599,1572,40
3012560824,3012560820,-4,1512,3133,40
3023758966,3023758962,-4,923,3034,40
3024202099,3024202093,-6,1539,4123,40
3024933754,3024933748,-6,1065,5412,40
3024975403,3024975396,-7,1047,4172,40
3025713710,3025713698,-12,986,3632,40
3027357336,3027357330,-6,1038,3994,40
3027677567,3027677586,19,248,1281,40
3029546650,3029546643,-7,736,3638,40
3035349384,3035349391,7,1182,873,40
3037121781,3037121777,-4,1861,4742,40
3037633569,3037633562,-7,1057,4134,40
3038798935,3038798925,-10,130,837,40
3043670779,3043670771,-8,981,4317,40
3044737189,3044737197,8,1604,1709,40
3048252822,3048252817,-5,1408,3572,40
3050316113,3050316106,-7,720,3304,40
3051826695,3051826710,15,627,3618,40
3053376857,3053376854,-3,1049,3033,40
3054425057,3054425052,-5,1201,4296,40
3056982842,3056982848,6,2202,864,40
3057748722,3057748727,5,1580,963,40
3062177374,3062177370,-4,815,2331,40
3062784360,3062784374,14,344,1921,40
3070451240,3070451234,-6,1518,4418,40
3072946175,3072946171,-4,974,4663,40
3077367157,3077367150,-7,980,3240,40
3079811630,3079811624,-6,1083,5378,40
3081949466,3081949460,-6,1157,4426,40
3082375536,3082375525,-11,35,1044,40
3086505756,3086505750,-6,1022,4251,40
3092421640,3092421635,-5,1089,4112,40
3092482571,3092482566,-5,871,3013,40
3093438508,3093438514,6,276,882,40
3096995340,3096995334,-6,1152,3820,40
3097380517,3097380501,-16,190,1329,40
3100142819,3100142813,-6,791,2010,40
3102486442,3102486436,-6,789,3125,40
3102816847,3102816837,-10,268,1266,40
3104956020,3104956037,17,1149,5597,40
3107520193,3107520187,-6,1179,4314,40
3107917791,3107917785,-6,867,3696,40
3123873558,3123873553,-5,1237,3877,40
3124550045,3124550033,-12,670,1324,40
3131976565,3131976559,-6,879,3574,40
3137454297,3137454281,-16,1052,3261,40
3149812307,3149812307,0,1444,2078,40
3151574270,3151574264,-6,1009,3702,40
3154653863,3154653853,-10,25416,16987,40
3161563385,3161563378,-7,864,3496,40
3168115950,3168115941,-9,1086,3551,40
3169258614,3169258595,-19,337,1326,40
3171212070,3171212066,-4,992,3957,40
3189649134,3189649122,-12,3136,785,40
3191545662,3191545657,-5,1338,4856,40
3193403117,3193403109,-8,1027,3420,40
3193811719,3193811734,15,299,1216,40
3194349478,3194349473,-5,960,4936,40
3197178830,3197178823,-7,733,3151,40
3203426102,3203426095,-7,1222,4185,40
3204002341,3204002338,-3,1348,2745,40
3205903724,3205903719,-5,589,1770,40
3208823766,3208823771,5,2050,1504,40
3213634688,3213634681,-7,1294,2868,40
3221802656,3221802649,-7,946,2896,40
3222643662,3222643655,-7,1052,3633,40
3223348435,3223348430,-5,913,3188,40
3223911351,3223911342,-9,191,2051,40
3233856154,3233856147,-7,1198,4682,40
3235539242,3235539235,-7,1092,4593,40
3236717149,3236717150,1,1689,2259,40
3237207982,3237207978,-4,1081,3734,40
3237601454,3237601449,-5,743,3694,40
3238183816,3238183827,11,467,1992,40
3258901195,3258901190,-5,1065,4893,40
3264439127,3264439123,-4,964,3598,40
3265492374,3265492393,19,1190,3656,40
3265910170,3265910162,-8,1294,4481,40
3268180998,3268180990,-8,1232,3885,40
3273648350,3273648349,-1,1707,2908,40
3276708294,3276708287,-7,869,3038,40
3277426312,3277426305,-7,883,2479,40
3277579166,3277579187,21,111,777,40
3281735775,3281735768,-7,748,2390,40
3283969762,3283969758,-4,982,2383,40
3286441636,3286441629,-7,1280,3684,40
3302263154,3302263149,-5,805,2544,40
3302394981,3302394995,14,297,1142,40
3309833846,3309833839,-7,1099,3792,40
3310013769,3310013765,-4,1359,4046,40
3310155004,3310154993,-11,1020,3419,40
3312408607,3312408602,-5,982,3098,40
3316730610,3316730605,-5,792,2445,40
3317469396,3317469417,21,565,2064,40
3318042231,3318042226,-5,948,3643,40
3321842497,3321842495,-2,1528,2472,40
3323688626,3323688629,3,1532,1483,40
3324858538,3324858531,-7,857,3355,40
3325683534,3325683531,-3,20,972,40
3331011315,3331011310,-5,1383,3915,40
3338117874,3338117869,-5,1522,3197,40
3338704101,3338704094,-7,1010,3894,40
3338865071,3338865087,16,120,1306,40
3341898067,3341898062,-5,741,3454,40
3345973390,3345973383,-7,1001,3956,40
3346390560,3346390577,17,311,623,40
3347955687,3347955685,-2,1459,2292,40
3349490762,3349490762,0,1631,1496,40
3361228061,3361228057,-4,994,3404,40
3371234511,3371234505,-6,551,3512,40
3380922045,3380922038,-7,649,2602,40
3385744880,3385744875,-5,1136,3007,40
3388820554,3388820546,-8,1440,4077,40
3395764575,3395764578,3,1593,1264,40
3396137015,3396137010,-5,870,2453,40
3400620810,3400620805,-5,1044,4382,40
3420230550,3420230543,-7,861,4778,40
3420497212,3420497225,13,258,1030,40
3426073891,3426073886,-5,850,3712,40
3428007846,3428007841,-5,671,1144,40
3428452446,3428452441,-5,989,3010,40
3430596116,3430596110,-6,1405,5301,40
3439856192,3439856186,-6,1018,3761,40
3441004355,3441004350,-5,944,3577,40
3446572386,3446572405,19,790,2214,40
3449580869,3449580887,18,2826,2021,40
3450131678,3450131671,-7,493,1648,40
3465125859,3465125855,-4,1143,2103,40
3466412856,3466412850,-6,1589,3541,40
3466536255,3466536248,-7,742,3175,40
3466876933,3466876924,-9,1011,3259,40
3466929664,3466929681,17,837,3308,40
3467386262,3467386256,-6,1157,4130,40
3469317965,3469317957,-8,622,4428,40
3469450040,3469450053,13,337,2110,40
3481980326,3481980330,4,2808,1419,40
3487448387,3487448382,-5,916,2185,40
3489800503,3489800497,-6,1296,4325,40
3492966414,3492966409,-5,1179,4892,40
3495860587,3495860581,-6,1339,4239,40
3496309286,3496309279,-7,806,3031,40
3501772265,3501772258,-7,1416,3967,40
3510437687,3510437683,-4,630,1932,40
3514140843,3514140838,-5,1380,3790,40
3521895237,3521895233,-4,795,3616,40
3536362813,3536362807,-6,1464,3281,40
3542083194,3542083187,-7,806,3010,40
3542530191,3542530185,-6,1028,3441,40
3544002788,3544002785,-3,1090,2571,40
3544874738,3544874732,-6,862,3570,40
3548373992,3548373985,-7,1070,3720,40
3548841999,3548841991,-8,1242,4695,40
3549892829,3549892834,5,2524,1476,40
3563609429,3563609426,-3,587,2376,40
3563760713,3563760706,-7,872,2985,40
3569458503,3569458498,-5,1087,3734,40
3584055850,3584055845,-5,852,3854,40
3587102950,3587102945,-5,1278,3795,40
3588794590,3588794592,2,1791,1946,40
3600473878,3600473876,-2,1111,2687,40
3601595375,3601595364,-11,197,1008,40
3601989379,3601989374,-5,853,3806,40
3606687413,3606687406,-7,1157,4097,40
3607302079,3607302093,14,272,1304,40
3616580931,3616580927,-4,1096,3050,40
3616634003,3616634002,-1,924,1368,40
3621759851,3621759846,-5,1187,2836,40
3629200548,3629200549,1,1440,1518,40
3645994439,3645994444,5,3156,1333,40
3653250290,3653250283,-7,858,3817,40
3663639086,3663639080,-6,675,2906,40
3664262597,3664262590,-7,1277,4568,40
3680960990,3680960983,-7,832,2103,40
3681347174,3681347165,-9,183,897,40
3686563318,3686563313,-5,1186,3433,40
3686800174,3686800186,12,256,1113,40
3687419030,3687419025,-5,775,2613,40
3692573831,3692573825,-6,1021,4379,40
3694267022,3694267017,-5,945,4344,40
3694619892,3694619883,-9,899,3465,40
3695953591,3695953586,-5,1126,3711,40
3700129736,3700129738,2,2349,2001,40
3706056059,3706056060,1,1115,1508,40
3706977943,3706977937,-6,920,4098,40
3707721346,3707721341,-5,1127,3456,40
3708388279,3708388275,-4,1062,2657,40
3718733726,3718733718,-8,1058,5361,40
3722596327,3722596333,6,3862,2122,40
3724350715,3724350715,0,1778,1757,40
3725748447,3725748427,-20,887,1253,40
3726080295,3726080310,15,1350,5964,40
3730416580,3730416574,-6,737,3700,40
3730677966,3730677982,16,374,1900,40
3734894269,3734894276,7,5505,2040,40
3736356965,3736356958,-7,958,3182,40
3736490620,3736490613,-7,85,1371,40
3740011612,3740011606,-6,1167,4670,40
3745354734,3745354727,-7,1068,5156,40
3753220239,3753220234,-5,891,2917,40
3753473656,3753473665,9,236,928,40
3754992818,3754992813,-5,1045,4308,40
3757938465,3757938471,6,6593,3902,40
3761180148,3761180142,-6,1070,3783,40
3765926807,3765926822,15,438,1613,40
3769262141,3769262136,-5,1116,3915,40
3774173867,3774173861,-6,916,2945,40
3785139514,3785139508,-6,646,3038,40
3785225933,3785225951,18,406,2304,40
3786231839,3786231834,-5,951,3993,40
3793106315,3793106310,-5,923,3953,40
3798096515,3798096509,-6,1050,1769,40
3798579221,3798579215,-6,40,894,40
3804291297,3804291291,-6,976,3674,40
3805155089,3805155089,0,671,1309,40
3832119159,3832119153,-6,1217,4087,40
3834078200,3834078196,-4,774,1458,40
3834898204,3834898223,19,998,3945,40
3834942723,3834942717,-6,865,3677,40
3839916945,3839916939,-6,1291,4669,40
3840541973,3840541989,16,277,2601,40
3843273563,3843273558,-5,774,4325,40
3845898585,3845898585,0,2062,2548,40
3850538823,3850538830,7,3597,1538,40
3852712387,3852712379,-8,833,4104,40
3853105474,3853105469,-5,1079,4030,40
3854440375,3854440374,-1,1805,3418,40
3856640303,3856640295,-8,905,3329,40
3860347057,3860347050,-7,915,3306,40
3866161798,3866161793,-5,905,3525,40
3867323328,3867323328,0,1358,2095,40
3868320799,3868320794,-5,904,2801,40
3869532535,3869532515,-20,1116,4428,40
3869704890,3869704885,-5,814,4045,40
3873397386,3873397379,-7,667,1979,40
3882178668,3882178661,-7,1109,3681,40
3889636294,3889636288,-6,1090,3836,40
3895609723,3895609722,-1,861,1684,40
3898290161,3898290183,22,135,1153,40
3899568162,3899568155,-7,1115,3990,40
3901062772,3901062775,3,1602,1173,40
3905629942,3905629938,-4,1216,3219,40
3906508700,3906508695,-5,171,1311,40
3906716489,3906716483,-6,1414,2827,40
3906757455,3906757462,7,430,1336,40
3909735728,3909735722,-6,946,3410,40
3910774087,3910774077,-10,1107,3559,40
3913115171,3913115169,-2,1279,2439,40
3913521469,3913521463,-6,899,4322,40
3919350337,3919350331,-6,1222,3128,40
3921925794,3921925798,4,1316,1393,40
3921953538,3921953533,-5,1232,4390,40
3923345311,3923345303,-8,950,3911,40
3924049655,3924049647,-8,942,3617,40
3927736077,3927736073,-4,1180,2827,40
3930738862,3930738858,-4,920,3635,40
3931088230,3931088248,18,558,2088,40
3942069447,3942069445,-2,1172,2865,40
3943694627,3943694621,-6,695,2126,40
3943757622,3943757642,20,136,1388,40
3944302799,3944302802,3,201,1280,40
3950355055,3950355050,-5,975,3401,40
3950510150,3950510159,9,17993,25942,40
3950888410,3950888409,-1,2904,3144,40
3951607774,3951607770,-4,1154,2698,40
3956267300,3956267293,-7,1140,4872,40
3958495102,3958495086,-16,10,1737,40
3961857451,3961857445,-6,1219,3867,40
3962734697,3962734697,0,1037,1449,40
3968286466,3968286457,-9,688,2648,40
3974103743,3974103737,-6,1130,3926,40
3979359910,3979359903,-7,1269,4203,40
3980503532,3980503552,20,221,1509,40
3992199114,3992199108,-6,1189,4533,40
3992566438,3992566433,-5,1131,3842,40
3994198726,3994198718,-8,1060,3739,40
4003327341,4003327337,-4,1215,3553,40
4003421781,4003421774,-7,964,4169,40
4004600190,4004600185,-5,1056,4463,40
4005380738,4005380734,-4,1210,3294,40
4006786154,4006786154,0,4662,6715,40
4009985681,4009985674,-7,942,3950,40
4016943430,4016943443,13,10328,43490,40
4017627629,4017627622,-7,1047,3253,40
4018763668,4018763669,1,1075,2619,40
4018969784,4018969778,-6,1209,5025,40
4020487376,4020487393,17,890,2408,40
4025483335,4025483329,-6,1217,2791,40
4028692473,4028692474,1,1673,1236,40
4029198793,4029198786,-7,1113,3356,40
4035005215,4035005210,-5,798,2950,40
4037652857,4037652850,-7,946,4786,40
4047874932,4047874927,-5,176,1281,40
4048856611,4048856610,-1,1158,2116,40
4053504390,4053504385,-5,1242,4489,40
4053854190,4053854190,0,3526,9890,40
4056745581,4056745574,-7,1031,4626,40
4057144630,4057144618,-12,269,1332,40
4058449991,4058449985,-6,829,3064,40
4058514535,4058514524,-11,627,3329,40
4060241809,4060241802,-7,1147,3468,40
4060622228,4060622214,-14,1052,2751,40
4061118350,4061118345,-5,1152,3011,40
4061896094,4061896093,-1,850,2647,40
4062176842,4062176838,-4,1146,3381,40
4071750506,4071750499,-7,693,2427,40
4078736311,4078736306,-5,1066,3886,40
4084331638,4084331633,-5,767,2077,40
4084914661,4084914654,-7,1202,4272,40
4086271485,4086271483,-2,2803,4773,40
4089116379,4089116378,-1,619,1564,40
4091242113,4091242108,-5,1070,4310,40
4092774505,4092774500,-5,732,2991,40
4096558722,4096558718,-4,983,2566,40
4101947484,4101947478,-6,968,4017,40
4102206136,4102206145,9,190,645,40
4104107091,4104107083,-8,786,2982,40
4105157854,4105157847,-7,1361,4418,40
4110437102,4110437096,-6,1532,3976,40
4115734291,4115734287,-4,848,2482,40
4119180059,4119180054,-5,1405,3851,40
4127851810,4127851802,-8,944,3487,40
4136233319,4136233313,-6,1116,3187,40
4145547396,4145547390,-6,1362,3712,40
4146397527,4146397521,-6,1014,3401,40
4146628242,4146628234,-8,1175,3458,40
4146915543,4146915525,-18,346,1902,40
4147925951,4147925946,-5,691,3166,40
4153315670,4153315675,5,5512,2803,40
4158405193,4158405198,5,4072,2050,40
4159709225,4159709231,6,3532,1408,40
4170250914,4170250908,-6,1032,2400,40
4174647130,4174647122,-8,812,4077,40
4174730428,4174730422,-6,1009,2789,40
4186946867,4186946860,-7,1169,2709,40
4187341662,4187341658,-4,991,2882,40
4187620422,4187620415,-7,226,1003,40
4193747765,4193747760,-5,871,3059,40
4196548244,4196548238,-6,1249,3383,40
4199471393,4199471388,-5,1418,3237,40
4206785871,4206785870,-1,1393,1577,40
4212798311,4212798306,-5,1436,4391,40
4216057507,4216057502,-5,1000,3288,40
4224371790,4224371797,7,5567,1235,40
4226993398,4226993393,-5,1327,3655,40
4227019521,4227019515,-6,1324,4778,40
4239977244,4239977242,-2,2673,3414,40
4246809333,4246809325,-8,1182,5074,40
4247968270,4247968249,-21,925,4226,40
4250163006,4250162993,-13,301,1302,40
4253959410,4253959417,7,3862,1852,40
4255992819,4255992823,4,19904,25680,40
4257039969,4257039962,-7,962,4013,40
4258981577,4258981571,-6,1366,5251,40
4259521694,4259521713,19,324,2296,40
4260065059,4260065053,-6,1158,2933,40
4264199282,4264199291,9,11527,33191,40
4264572152,4264572134,-18,237,1282,40
4265311515,4265311512,-3,1876,3833,40
4268205565,4268205571,6,6179,2603,40
4272925536,4272925530,-6,1011,3655,40
4273048982,4273048977,-5,977,3593,40
4278189835,4278189849,14,1131,724,40
4284324290,4284324284,-6,1038,3124,40
4289441275,4289441269,-6,1002,2706,40
4295586286,4295586281,-5,1091,2814,40
4295660904,4295660922,18,441,1735,40
4295734676,4295734669,-7,1192,3049,40
4299230482,4299230476,-6,1027,3419,40
4311135853,4311135849,-4,926,3319,40
4311596234,4311596227,-7,1512,4111,40
4315140186,4315140181,-5,879,3469,40
4319665565,4319665571,6,1929,1574,40
4321720854,4321720849,-5,1238,4145,40
4326807826,4326807820,-6,901,4069,40
4329363220,4329363206,-14,114,1252,40
4330184197,4330184193,-4,895,3414,40
4332392553,4332392546,-7,1101,4151,40
4332626530,4332626522,-8,963,5522,40
4339951957,4339951951,-6,966,4743,40
4340463865,4340463868,3,2010,1695,40
4353670097,4353670104,7,3019,1138,40
4358933380,4358933374,-6,1005,3848,40
4359275212,4359275230,18,1349,6531,40
4359847796,4359847792,-4,243,753,40
4362186279,4362186283,4,1161,286,40
4365135191,4365135185,-6,1312,3601,40
4370494827,4370494823,-4,897,3311,40
4373981627,4373981620,-7,901,3184,40
4374287790,4374287777,-13,569,2295,40
4374866643,4374866637,-6,936,4167,40
4376763458,4376763455,-3,742,4040,40
4379656386,4379656390,4,3647,2911,40
4380201131,4380201136,5,1434,1333,40
4382935439,4382935434,-5,805,2723,40
4394463014,4394463011,-3,1085,2928,40
4398390975,4398390969,-6,1225,2578,40
4400010582,4400010577,-5,1200,3814,40
4401056047,4401056055,8,435,1574,40
4401120091,4401120084,-7,920,3459,40
4401462037,4401462032,-5,1379,5651,40
4401959584,4401959596,12,954,2999,40
4412592626,4412592633,7,1749,2001,40
4413902799,4413902800,1,2050,2455,40
4418079786,4418079777,-9,918,3795,40
4422306338,4422306333,-5,699,2222,40
4422851755,4422851749,-6,1025,2953,40
4432298331,4432298323,-8,1136,5983,40
4436826002,4436825995,-7,1159,3222,40
4437770339,4437770333,-6,957,3608,40
4445369541,4445369534,-7,861,3673,40
4445438444,4445438466,22,521,2371,40
4448446422,4448446416,-6,711,2323,40
4464287035,4464287018,-17,2070,895,40
4465945969,4465945974,5,2232,1252,40
4466317117,4466317110,-7,1149,3843,40
4467681067,4467681062,-5,1353,3031,40
4468037627,4468037621,-6,667,2279,40
4468476653,4468476666,13,213,1063,40
4472582368,4472582362,-6,1604,3467,40
4472671431,4472671434,3,221,1327,40
4473210446,4473210426,-20,1014,4036,40
4473371749,4473371768,19,508,1435,40
4473865002,4473864997,-5,1217,3507,40
4480284814,4480284811,-3,1196,2195,40
4480828554,4480828561,7,8081,4229,40
4485340525,4485340525,0,1426,1283,40
4491552383,4491552379,-4,980,2684,40
4491802628,4491802638,10,21,1230,40
4516470374,4516470369,-5,1201,3706,40
4526087919,4526087915,-4,851,2168,40
4530309801,4530309793,-8,961,4315,40
4531250693,4531250695,2,2427,2279,40
4531386230,4531386233,3,1141,1878,40
4531680350,4531680341,-9,309,1698,40
4540180262,4540180256,-6,1112,4619,40
4546058755,4546058750,-5,965,3075,40
4546353636,4546353646,10,495,2435,40
4551232769,4551232764,-5,1140,3984,40
4551964308,4551964290,-18,130,2341,40
4556693774,4556693774,0,3766,3392,40
4560562656,4560562655,-1,2016,2511,40
4565016836,4565016829,-7,826,3909,40
4565554175,4565554163,-12,278,748,40
4566463981,4566463990,9,15127,9461,40
4599005687,4599005682,-5,840,2327,40
4600970536,4600970531,-5,1211,3259,40
4601922542,4601922540,-2,161,835,40
4603007283,4603007281,-2,1849,4254,40
4604298265,4604298258,-7,697,3484,40
4605118797,4605118785,-12,210,1404,40
4612824907,4612824902,-5,994,2250,40
4614829167,4614829162,-5,651,2846,40
4616690602,4616690597,-5,961,4163,40
4627498135,4627498129,-6,1102,4618,40
4630444702,4630444698,-4,838,2350,40
4631753502,4631753495,-7,1282,4552,40
4633369326,4633369322,-4,1005,2888,40
4636228582,4636228583,1,1379,1326,40
4640680171,4640680164,-7,1004,3722,40
4641497831,4641497823,-8,1027,2785,40
4642082495,4642082482,-13,11,1159,40
4644291297,4644291290,-7,1341,5070,40
4644765244,4644765244,0,2266,2902,40
4653569766,4653569762,-4,925,4191,40
4657350931,4657350949,18,226,979,40
4659133719,4659133710,-9,1139,3153,40
4662298136,4662298130,-6,1489,4929,40
4662656227,4662656221,-6,753,3865,40
4664375410,4664375405,-5,933,3992,40
4666721786,4666721786,0,798,903,40
4669737044,4669737038,-6,1230,3961,40
4670179358,4670179354,-4,1628,4102,40
4671607977,4671607971,-6,831,3400,40
4671798463,4671798482,19,1242,4063,40
4674162251,4674162253,2,129,1086,40
4674766888,4674766882,-6,1012,5067,40
4680762052,4680762046,-6,810,3586,40
4681154863,4681154871,8,16,1475,40
4690189155,4690189149,-6,1401,3809,40
4694623601,4694623600,-1,1699,1984,40
4704385246,4704385241,-5,1094,4729,40
4710539883,4710539877,-6,851,1921,40
4715199642,4715199656,14,74,1234,40
4715712559,4715712543,-16,246,1251,40
4715935255,4715935264,9,138,2356,40
4717784342,4717784337,-5,1249,3763,40
4718419609,4718419604,-5,682,2972,40
4723469532,4723469526,-6,1026,3407,40
4723824819,4723824813,-6,1109,4052,40
4723863221,4723863215,-6,755,4135,40
4725185466,4725185471,5,8249,19907,40
4726046919,4726046912,-7,1118,4333,40
4726931725,4726931711,-14,158,762,40
4728724270,4728724267,-3,1250,2085,40
4731657543,4731657537,-6,1054,3288,40
4736157113,4736157107,-6,1340,4402,40
4737312757,4737312752,-5,1438,4480,40
4740512333,4740512329,-4,925,3765,40
4742912081,4742912074,-7,1231,4273,40
4751795462,4751795456,-6,819,2315,40
4753891033,4753891030,-3,750,2046,40
4757742954,4757742949,-5,839,3898,40
4758262045,4758262030,-15,724,4463,40
4758864088,4758864107,19,297,1785,40
4761258820,4761258842,22,727,3780,40
4762093639,4762093632,-7,1336,4249,40
4767052390,4767052395,5,4352,1893,40
4772777793,4772777798,5,62,865,40
4778260501,4778260494,-7,1254,4105,40
4778789834,4778789830,-4,1061,2722,40
4779650621,4779650616,-5,723,2667,40
4780020679,4780020696,17,921,2861,40
4781831005,4781830999,-6,1251,3618,40
4785664163,4785664157,-6,1024,4336,40
4785955156,4785955149,-7,146,1366,40
4786768830,4786768823,-7,998,3249,40
4796112348,4796112342,-6,1121,4845,40
4803451314,4803451309,-5,1155,3786,40
4803686525,4803686510,-15,1045,437,40
4808878325,4808878320,-5,856,3259,40
4824239590,4824239584,-6,905,3274,40
4824830343,4824830338,-5,891,2083,40
4830496364,4830496361,-3,1187,2175,40
4833830855,4833830848,-7,808,2757,40
4835593268,4835593263,-5,1082,2765,40
4837048703,4837048713,10,185,1114,40
4847204059,4847204054,-5,1034,2902,40
4850651865,4850651859,-6,852,3448,40
4851442586,4851442590,4,2334,1687,40
4858075869,4858075864,-5,1038,4356,40
4860182010,4860182003,-7,1192,3966,40
4875181233,4875181233,0,2465,3501,40
4876129322,4876129316,-6,969,4041,40
4876933823,4876933817,-6,1004,4281,40
4877530774,4877530780,6,50,820,40
4879491259,4879491255,-4,679,1558,40
4880137359,4880137371,12,1099,4126,40
4880318636,4880318617,-19,210,835,40
4888694377,4888694373,-4,1015,4216,40
4894555791,4894555784,-7,1068,3418,40
4913600173,4913600179,6,14402,4851,40
4915817891,4915817887,-4,925,3965,40
4915849427,4915849421,-6,650,2967,40
4923160290,4923160283,-7,866,2879,40
4924193607,4924193598,-9,741,2426,40
4924302060,4924302047,-13,58,1053,40
4932708980,4932708997,17,965,4442,40
4940949945,4940949936,-9,938,5351,40
4941163038,4941163057,19,769,3314,40
4943567849,4943567845,-4,1255,2817,40
4945087515,4945087511,-4,989,3067,40
4952703574,4952703568,-6,940,4552,40
4953108432,4953108449,17,675,4440,40
4953586450,4953586446,-4,1597,5166,40
4953683286,4953683280,-6,1121,3932,40
4960757218,4960757212,-6,1254,4857,40
4961254014,4961254011,-3,814,2791,40
4961487076,4961487090,14,211,1424,40
4962208720,4962208732,12,120,2210,40
4964861719,4964861722,3,2635,1748,40
4967189210,4967189203,-7,950,3811,40
4972494430,4972494422,-8,928,6378,40
4972775540,4972775521,-19,291,1447,40
4973464885,4973464878,-7,815,2797,40
4977982391,4977982385,-6,1343,6118,40
4978782255,4978782254,-1,1638,2320,40
4987497974,4987497969,-5,1042,3620,40
4991080088,4991080088,0,1476,2186,40
4993178158,4993178152,-6,782,1905,40
4995578466,4995578460,-6,1243,4097,40
5003736346,5003736341,-5,517,3113,40
5005071435,5005071430,-5,956,4016,40
5017649303,5017649297,-6,769,4755,40
5021792121,5021792114,-7,1003,3505,40
5036741350,5036741345,-5,110,1847,40
5038367807,5038367801,-6,1758,4486,40
5041137155,5041137150,-5,969,3211,40
5041947570,5041947564,-6,1074,4803,40
5043255421,5043255425,4,2589,1680,40
5043593510,5043593504,-6,1120,3149,40
5047634466,5047634461,-5,1030,4887,40
5052361122,5052361117,-5,1357,4713,40
5057307316,5057307309,-7,37114,13628,40
5060231344,5060231338,-6,903,2941,40
5062054149,5062054147,-2,1162,2258,40
5062288841,5062288846,5,2917,1485,40
5074439337,5074439329,-8,1075,5936,40
5074597712,5074597730,18,862,3850,40
5075176292,5075176313,21,882,2761,40
5084984498,5084984493,-5,742,3365,40
5087570150,5087570156,6,7751,4277,40
5092724250,5092724262,12,221,1073,40
5094736667,5094736662,-5,948,3754,40
5097757029,5097757023,-6,839,3312,40
5099174973,5099174992,19,216,1637,40
5100341853,5100341847,-6,887,3589,40
5103257701,5103257694,-7,1144,3871,40
5105219351,5105219345,-6,777,3490,40
5108226343,5108226339,-4,812,3122,40
5108879579,5108879576,-3,1004,2712,40
5109029551,5109029564,13,1253,4537,40
5127376917,5127376912,-5,1013,4311,40
5130176527,5130176523,-4,385,2613,40
5140010743,5140010738,-5,1100,3073,40
5143241260,5143241256,-4,679,2279,40
5149150850,5149150846,-4,1214,1614,40
5150315830,5150315826,-4,1117,2638,40
5150929627,5150929621,-6,695,2842,40
5150958303,5150958311,8,339,1096,40
5152403301,5152403293,-8,1122,5315,40
5166809214,5166809218,4,2492,1406,40
5176975723,5176975726,3,1171,1001,40
5177397947,5177397941,-6,1192,4424,40
5177951598,5177951590,-8,150,1475,40
5184370820,5184370813,-7,1015,3720,40
5192490314,5192490307,-7,1342,4822,40
5193603983,5193603981,-2,1526,2439,40
5193838196,5193838189,-7,923,2217,40
5199248429,5199248423,-6,1222,4424,40
5199809719,5199809735,16,31,1016,40
5207920124,5207920118,-6,1080,3836,40
5208120164,5208120170,6,101,1207,40
5212567127,5212567121,-6,1301,2890,40
5214502631,5214502625,-6,554,1795,40
5217072568,5217072573,5,68,1132,40
5217539381,5217539391,10,16726,28916,40
5219033506,5219033501,-5,929,2809,40
5223217626,5223217631,5,1635,1058,40
5225176964,5225176958,-6,1050,4969,40
5225262285,5225262299,14,61,1267,40
5226875179,5226875174,-5,1049,3285,40
5228329780,5228329774,-6,937,2491,40
5228928374,5228928373,-1,1397,2362,40
5229551264,5229551258,-6,1306,3562,40
5234474809,5234474803,-6,536,1568,40
5234635868,5234635848,-20,208,1472,40
5236961051,5236961045,-6,970,3340,40
5238775115,5238775109,-6,710,3469,40
5257666873,5257666866,-7,1165,5426,40
5259146377,5259146370,-7,2531,8213,40
5264144269,5264144264,-5,1177,3982,40
5266730894,5266730889,-5,705,3431,40
5273624477,5273624478,1,1811,1534,40
5275796541,5275796538,-3,1138,2128,40
5279892875,5279892870,-5,914,3222,40
5280419936,5280419941,5,33,903,40
5281700620,5281700621,1,1285,1817,40
5282421790,5282421783,-7,1354,4792,40
5289720703,5289720697,-6,985,4628,40
5291440880,5291440874,-6,848,2926,40
5297333542,5297333537,-5,1092,5633,40
5299648604,5299648598,-6,1460,4288,40
5302909464,5302909456,-8,741,2332,40
5304361680,5304361690,10,257,1355,40
5305968150,5305968144,-6,1563,4901,40
5308290276,5308290282,6,1835,1132,40
5313210411,5313210425,14,123,1099,40
5314362369,5314362362,-7,1216,4593,40
5317387566,5317387562,-4,960,2178,40
5317644247,5317644247,0,191,953,40
5320575005,5320575001,-4,1078,3998,40
5320748216,5320748229,13,195,1411,40
5321506415,5321506417,2,250,1244,40
5324829255,5324829249,-6,726,2974,40
5325181741,5325181738,-3,160,773,40
5327153102,5327153099,-3,251,1295,40
5327273764,5327273761,-3,1440,2603,40
5329511164,5329511158,-6,1144,3126,40
5330376103,5330376119,16,509,1344,40
5333468030,5333468026,-4,820,2841,40
5338692374,5338692369,-5,2754,6308,40
5340120772,5340120765,-7,961,2299,40
5342433977,5342433971,-6,891,3481,40
5348090839,5348090833,-6,524,1829,40
5349364686,5349364689,3,49,1296,40
5352105882,5352105877,-5,752,3730,40
5352358719,5352358703,-16,33,1030,40
5352922215,5352922230,15,471,1234,40
5356899673,5356899668,-5,971,3235,40
5364340415,5364340410,-5,662,3712,40
5364966599,5364966598,-1,151,1040,40
5365927878,5365927883,5,2078,1081,40
5370578579,5370578574,-5,1019,2494,40
5373863810,5373863801,-9,374,1422,40
5378112407,5378112401,-6,1130,3416,40
5382971407,5382971402,-5,1102,2251,40
5384935673,5384935669,-4,1191,3266,40
5393496396,5393496390,-6,763,3563,40
5394301666,5394301660,-6,1618,4772,40
5396427835,5396427830,-5,822,3753,40
5396571487,5396571479,-8,937,5002,40
5396701543,5396701524,-19,119,1204,40
5400221143,5400221137,-6,1495,4175,40
5407491018,5407491013,-5,1022,2159,40
5408644103,5408644097,-6,797,3959,40
5411732082,5411732075,-7,630,2917,40
5413363670,5413363686,16,175,1033,40
5414729114,5414729109,-5,934,4061,40
5415644474,5415644475,1,2951,2923,40
5416482654,5416482645,-9,1091,4534,40
5417499850,5417499842,-8,839,4141,40
5417954021,5417954023,2,1447,1905,40
5425097189,5425097182,-7,1143,3268,40
5431577968,5431577970,2,2293,1486,40
5439183189,5439183185,-4,850,1980,40
5450706891,5450706885,-6,970,2675,40
5460659032,5460659027,-5,911,3691,40
5466520611,5466520626,15,294,889,40
5479663754,5479663749,-5,593,2698,40
5479725645,5479725634,-11,250,941,40
5491195722,5491195717,-5,1173,3047,40
5493402448,5493402467,19,959,3843,40
5496452202,5496452196,-6,867,3407,40
5506539129,5506539136,7,3386,1671,40
5508058733,5508058728,-5,1091,3568,40
5509199866,5509199859,-7,1158,4538,40
5520359626,5520359620,-6,777,3991,40
5521008617,5521008610,-7,1304,4947,40
5522226258,5522226253,-5,1221,4706,40
5524243412,5524243420,8,1160,1225,40
5528039062,5528039058,-4,1534,4990,40
5528662954,5528662946,-8,888,3418,40
5530410506,5530410501,-5,1446,4473,40
5532741205,5532741199,-6,1472,4102,40
5535768020,5535768014,-6,949,4585,40
5538547117,5538547112,-5,1025,2806,40
5540727619,5540727613,-6,1010,3645,40
5542674004,5542673998,-6,958,4536,40
5545132513,5545132506,-7,911,4158,40
5545250233,5545250227,-6,1294,3054,40
5549350040,5549350040,0,1209,1396,40
5553589214,5553589209,-5,1211,4111,40
5555797134,5555797129,-5,788,2301,40
5556236504,5556236506,2,3417,2480,40
5558313015,5558313007,-8,983,4335,40
5565639622,5565639617,-5,895,6443,40
5570121866,5570121860,-6,1354,4769,40
5579611782,5579611785,3,1733,24148,40
5582037795,5582037790,-5,889,3245,40
5583127505,5583127506,1,1606,1624,40
5584591830,5584591822,-8,975,3943,40
5595956299,5595956291,-8,712,2810,40
5600134517,5600134512,-5,1183,3676,40
5600970058,5600970053,-5,359,3370,40
5602193605,5602193599,-6,1108,3447,40
5605719923,5605719917,-6,745,3395,40
5608035700,5608035704,4,1364,949,40
5608921031,5608921024,-7,886,3638,40
5610122912,5610122906,-6,1101,3561,40
5611561343,5611561337,-6,1327,4876,40
5614802480,5614802486,6,1684,20318,40
5621068857,5621068857,0,1197,1865,40
5621232461,5621232482,21,677,2080,40
5627338083,5627338077,-6,1098,4072,40
5632892897,5632892901,4,1360,1656,40
5636939806,5636939801,-5,967,3296,40
5637319174,5637319157,-17,765,3417,40
5660511193,5660511190,-3,985,1471,40
5660784543,5660784537,-6,1057,3603,40
5666082786,5666082780,-6,877,4181,40
5668073083,5668073078,-5,794,3505,40
5668395661,5668395665,4,91,1001,40
5674589964,5674589952,-12,48359,3925,40
5677969456,5677969462,6,3092,1532,40
5684880203,5684880197,-6,502,1884,40
5684977325,5684977330,5,24,1297,40
5690798185,5690798181,-4,1253,2773,40
5702881155,5702881149,-6,1631,5782,40
5704308778,5704308770,-8,1073,2938,40
5705334125,5705334125,0,1539,2032,40
5706686743,5706686735,-8,717,3211,40
5707067249,5707067254,5,1063,627,40
5714435442,5714435435,-7,983,3540,40
5724035486,5724035493,7,5495,2344,40
5724182156,5724182151,-5,537,905,40
5732750858,5732750854,-4,1326,2548,40
5741977653,5741977647,-6,1177,3030,40
5743090878,5743090873,-5,707,2685,40
5743155894,5743155902,8,357,1496,40
5743746181,5743746195,14,668,2753,40
5746316519,5746316514,-5,867,5029,40
5746375149,5746375142,-7,93,1138,40
5754364453,5754364455,2,2339,1258,40
5761452743,5761452737,-6,784,3293,40
5766964941,5766964935,-6,1535,3020,40
5770554211,5770554200,-11,807,3510,40
5772133460,5772133454,-6,1046,4059,40
5772516239,5772516222,-17,202,1006,40
5775493877,5775493883,6,5876,2885,40
5782733997,5782733989,-8,1280,4916,40
5782832951,5782832951,0,118,1160,40
5783693317,5783693322,5,54541,29143,40
5783862382,5783862374,-8,1228,5284,40
5784534888,5784534881,-7,1178,3448,40
5794345873,5794345867,-6,1097,3678,40
5798011978,5798011972,-6,1254,4313,40
5800885429,5800885422,-7,785,4160,40
5806646660,5806646654,-6,1098,2566,40
5814233090,5814233086,-4,1307,3264,40
5816325151,5816325143,-8,635,2867,40
5830672589,5830672587,-2,2658,3886,40
5830752862,5830752855,-7,996,3768,40
5831297210,5831297210,0,1416,1331,40
5838490875,5838490869,-6,1038,3427,40
5839563835,5839563829,-6,1077,3455,40
5854123217,5854123211,-6,874,3946,40
5858363168,5858363170,2,1057,742,40
5860161922,5860161918,-4,855,2144,40
5860494885,5860494890,5,1916,889,40
5861301603,5861301600,-3,1516,2135,40
5862720021,5862720016,-5,771,4048,40
5863008382,5863008397,15,950,2477,40
5866845851,5866845848,-3,700,1630,40
5877488658,5877488654,-4,1200,2385,40
5885265283,5885265277,-6,931,3421,40
5885759377,5885759373,-4,672,1738,40
5886007076,5886007061,-15,947,2932,40
5886224890,5886224885,-5,1211,4111,40
5894076711,5894076704,-7,751,2712,40
5897929963,5897929956,-7,1052,4981,40
5900070855,5900070850,-5,987,3153,40
5915803974,5915803965,-9,1007,5034,40
5933970272,5933970265,-7,895,3757,40
5934242647,5934242642,-5,765,3173,40
5934367996,5934367986,-10,330,1069,40
5948088874,5948088868,-6,949,3574,40
5948738764,5948738775,11,105,796,40
5951105533,5951105544,11,247,1451,40
5963456367,5963456361,-6,1010,4139,40
5963632551,5963632528,-23,43,1262,40
5964542118,5964542115,-3,1252,2440,40
5967797384,5967797380,-4,851,2898,40
5972866514,5972866509,-5,1197,2816,40
5973158662,5973158673,11,449,2713,40
5974358839,5974358833,-6,882,4092,40
5986138757,5986138749,-8,1349,5181,40
5989222316,5989222311,-5,782,2921,40
5991984744,5991984747,3,3386,2378,40
5995233695,5995233692,-3,657,1636,40
5999656486,5999656485,-1,573,2172,40
6000581852,6000581854,2,1670,1557,40
6002781266,6002781262,-4,1254,3711,40
6011412938,6011412932,-6,1060,4459,40
6026674666,6026674663,-3,723,1151,40
6028626016,6028626019,3,1938,1444,40
6031232114,6031232106,-8,1314,4650,40
6032148795,6032148790,-5,724,2922,40
6042241720,6042241714,-6,1269,3240,40
6045922015,6045922011,-4,874,2918,40
6047457573,6047457567,-6,1196,1701,40
6047751166,6047751181,15,193,1065,40
6058164624,6058164619,-5,1396,2086,40
6086615575,6086615553,-22,2724,2475,40
6089971018,6089971014,-4,653,2834,40
6095022626,6095022621,-5,1203,3717,40
6095370502,6095370514,12,819,3049,40
6095800985,6095800986,1,1041,1141,40
6100358812,6100358823,11,455,2094,40
6109725925,6109725927,2,20383,18654,40
6114024845,6114024861,16,1477,3075,40
6118105291,6118105283,-8,941,3233,40
6123862637,6123862633,-4,1393,2512,40
6127250583,6127250578,-5,459,3666,40
6131084194,6131084190,-4,1202,3823,40
6131550197,6131550216,19,337,1303,40
6133608303,6133608298,-5,660,2905,40
6135538670,6135538670,0,934,1501,40
6139261157,6139261163,6,6782,25150,40
6139961338,6139961345,7,4288,1793,40
6144913675,6144913669,-6,914,3240,40
6146593022,6146593002,-20,166,1298,40
6149101246,6149101240,-6,1197,3282,40
6149382659,6149382654,-5,847,3764,40
6150237219,6150237215,-4,1151,3318,40
6157567625,6157567619,-6,1341,4008,40
6162367547,6162367553,6,13544,6164,40
6168724698,6168724690,-8,1037,3743,40
6168977557,6168977552,-5,990,3931,40
6169184990,6169184976,-14,848,2838,40
6169919508,6169919524,16,63,692,40
6173458983,6173458989,6,16181,49831,40
6178146439,6178146445,6,2302,1709,40
6178615071,6178615066,-5,867,2368,40
6179312828,6179312822,-6,1093,3030,40
6186126177,6186126170,-7,784,4080,40
6190316659,6190316654,-5,799,4159,40
6193706549,6193706545,-4,938,3823,40
6195579367,6195579371,4,3035,1932,40
6195943879,6195943873,-6,1229,3413,40
6197870121,6197870114,-7,951,4376,40
6197981026,6197981022,-4,816,2856,40
6198925885,6198925890,5,7672,2776,40
6201253051,6201253046,-5,1011,3724,40
6201905150,6201905169,19,702,1661,40
6203149195,6203149187,-8,962,4047,40
6209074938,6209074931,-7,982,3645,40
6210722977,6210722983,6,2611,1405,40
6211463217,6211463217,0,1299,1840,40
6217125101,6217125114,13,15058,41335,40
6217840035,6217840042,7,7325,28028,40
6218746639,6218746646,7,5730,2930,40
6225630142,6225630146,4,2516,1222,40
6230960652,6230960646,-6,1036,3306,40
6232391798,6232391810,12,329,2430,40
6240112215,6240112209,-6,780,2646,40
6247325182,6247325176,-6,952,3925,40
6258519845,6258519838,-7,1162,3389,40
6258928947,6258928946,-1,891,1316,40
6260651842,6260651842,0,2921,4031,40
6261113049,6261113054,5,2595,1516,40
6262667305,6262667300,-5,1364,3793,40
6265658613,6265658609,-4,1107,3420,40
6271270250,6271270254,4,8218,16884,40
6278363978,6278363983,5,1862,1289,40
6279368076,6279368069,-7,848,3015,40
6280491652,6280491655,3,1171,859,40
6287470629,6287470623,-6,969,3676,40
6296269738,6296269755,17,242,853,40
6299170965,6299170959,-6,1084,2436,40
6308276990,6308276983,-7,807,3403,40
6308759798,6308759787,-11,192,924,40
6309693400,6309693412,12,874,2411,40
6313324078,6313324073,-5,3699,13899,40
6314690590,6314690586,-4,1278,3012,40
6317204682,6317204677,-5,1016,3621,40
6320730662,6320730657,-5,786,2716,40
6320916684,6320916688,4,337,1105,40
6321650628,6321650618,-10,348,1563,40
6322657653,6322657647,-6,1279,5399,40
6323067550,6323067545,-5,1149,3997,40
6323979528,6323979543,15,134,838,40
6327285343,6327285338,-5,383,1973,40
6332089056,6332089061,5,1774,1394,40
6340052494,6340052488,-6,1538,5710,40
6340081061,6340081054,-7,1378,4438,40
6345865123,6345865116,-7,694,4086,40
6346999459,6346999453,-6,1035,3156,40
6347684346,6347684339,-7,1257,3909,40
6350262934,6350262930,-4,523,1486,40
6350859466,6350859461,-5,1303,2750,40
6357999934,6357999930,-4,815,2327,40
6365607379,6365607374,-5,834,2769,40
6369453275,6369453269,-6,862,3087,40
6371143333,6371143339,6,1436,914,40
6375345775,6375345777,2,739,1212,40
6376008567,6376008562,-5,1267,2247,40
6382756912,6382756918,6,5229,2399,40
6383723517,6383723518,1,1004,1181,40
6385420979,6385420972,-7,1586,9132,40
6390715746,6390715740,-6,1021,4398,40
6391211988,6391211992,4,2632,2038,40
6402933280,6402933273,-7,1267,4901,40
6402982646,6402982667,21,528,4193,40
6409524286,6409524289,3,2301,1036,40
6410828590,6410828584,-6,1081,3065,40
6415476698,6415476691,-7,1152,4373,40
6426959727,6426959721,-6,1129,2705,40
6427513293,6427513291,-2,425,1127,40
6428518220,6428518235,15,448,1619,40
6440903078,6440903073,-5,1154,2944,40
6442264298,6442264294,-4,380,2842,40
6447924380,6447924374,-6,1717,6157,40
6449587437,6449587431,-6,1040,3933,40
6458510967,6458510962,-5,1119,3549,40
6461634557,6461634554,-3,1696,2906,40
6469264908,6469264902,-6,1051,3972,40
6471867786,6471867786,0,788,1465,40
6472653277,6472653291,14,452,3531,40
6478368433,6478368432,-1,2014,4869,40
6478845041,6478845037,-4,1314,3419,40
6479123154,6479123161,7,3397,1800,40
6482363341,6482363335,-6,996,3770,40
6490295722,6490295717,-5,968,3487,40
6490599871,6490599891,20,589,3554,40
6493399009,6493399004,-5,711,3437,40
6494241380,6494241398,18,483,2667,40
6499311099,6499311094,-5,400,2873,40
6501208574,6501208574,0,2886,4361,40
6508917967,6508917962,-5,1115,2666,40
6513958920,6513958913,-7,930,3756,40
6523215348,6523215339,-9,731,4725,40
6524921535,6524921518,-17,44,1529,40
6525207966,6525207961,-5,1149,3593,40
6530146421,6530146415,-6,1003,3753,40
6530380651,6530380646,-5,1236,5628,40
6531876991,6531876993,2,1530,1518,40
6535721036,6535721030,-6,704,2814,40
6536606518,6536606526,8,225,1466,40
6536861047,6536861049,2,357,2257,40
6547512382,6547512377,-5,973,3695,40
6548716315,6548716310,-5,1242,3216,40
6552523614,6552523611,-3,1947,4201,40
6573255795,6573255789,-6,1097,3203,40
6575058189,6575058183,-6,1466,3668,40
6583460382,6583460377,-5,885,3710,40
6589349666,6589349670,4,2984,1464,40
6589993115,6589993112,-3,1092,2738,40
6594476645,6594476638,-7,876,3772,40
6595708070,6595708063,-7,832,3049,40
6610761152,6610761149,-3,1050,3306,40
6620873833,6620873826,-7,2810,12483,40
6628228767,6628228758,-9,1359,4917,40
6633660386,6633660381,-5,912,3481,40
6634730415,6634730410,-5,743,3039,40
6640632203,6640632196,-7,1212,4058,40
6642688398,6642688393,-5,952,4319,40
6643270758,6643270739,-19,857,2667,40
6643508526,6643508513,-13,1416,4015,40
6644882127,6644882126,-1,956,1105,40
6646314566,6646314577,11,69,907,40
6649654426,6649654418,-8,1320,5440,40
6649686864,6649686866,2,2530,1953,40
6650305226,6650305218,-8,852,2595,40
6653665123,6653665117,-6,1146,3114,40
6655057746,6655057741,-5,1540,3820,40
6655514284,6655514282,-2,1296,2096,40
6656612532,6656612525,-7,822,3990,40
6657959010,6657959004,-6,1710,5188,40
6659446626,6659446621,-5,1070,4558,40
6659879336,6659879330,-6,1158,5172,40
6660156223,6660156222,-1,103,1382,40
6663600294,6663600286,-8,702,3342,40
6666556075,6666556070,-5,934,4103,40
6670952846,6670952841,-5,829,2991,40
6676427286,6676427279,-7,1589,4577,40
6681622131,6681622124,-7,1069,4669,40
6690182687,6690182683,-4,1301,4390,40
6702278833,6702278835,2,1204,1229,40
6705485879,6705485873,-6,844,3678,40
6708544121,6708544116,-5,1282,4903,40
6721993931,6721993930,-1,1945,2732,40
6722645790,6722645786,-4,614,2955,40
6730765063,6730765057,-6,932,2261,40
6731176303,6731176311,8,48,696,40
6732245361,6732245354,-7,1460,6774,40
6733589686,6733589696,10,417,4020,40
6739250702,6739250691,-11,537,5603,40
6739367751,6739367769,18,241,902,40
6742930728,6742930724,-4,879,3243,40
6750204929,6750204929,0,2736,1931,40
6753000127,6753000121,-6,597,3006,40
6757083899,6757083893,-6,874,4531,40
6760790926,6760790929,3,2247,1680,40
6774878617,6774878620,3,1566,1224,40
6778008759,6778008754,-5,645,877,40
6778921826,6778921822,-4,801,2408,40
6791318406,6791318402,-4,648,2348,40
6804137760,6804137754,-6,914,3277,40
6806312533,6806312527,-6,1275,4439,40
6806465645,6806465638,-7,949,4195,40
6806565654,6806565655,1,156,940,40
6809460018,6809460018,0,5247,6986,40
6812297263,6812297257,-6,1201,3809,40
6818946020,6818946014,-6,1513,3746,40
6820867132,6820867134,2,158,1703,40
6821041011,6821041005,-6,625,4236,40
6824817126,6824817110,-16,222,2736,40
6826342414,6826342413,-1,1503,2395,40
6829814151,6829814145,-6,1178,5234,40
6832798486,6832798480,-6,1059,3838,40
6843766857,6843766861,4,2427,1708,40
6848994675,6848994669,-6,959,2239,40
6854398530,6854398526,-4,986,2619,40
6854887526,6854887519,-7,981,4346,40
6859328253,6859328250,-3,1251,3572,40
6865241577,6865241570,-7,1012,4347,40
6868088562,6868088557,-5,922,2325,40
6875902227,6875902222,-5,870,3265,40
6879443455,6879443474,19,126,1139,40
6881988821,6881988819,-2,1358,1533,40
6884609789,6884609783,-6,1282,4000,40
6884688532,6884688552,20,994,3600,40
6889046586,6889046593,7,6093,2537,40
6889655742,6889655745,3,1177,1185,40
6896015214,6896015219,5,2591,1366,40
6897515602,6897515596,-6,571,4053,40
6897811877,6897811881,4,2809,1364,40
6899708120,6899708124,4,2886,1419,40
6900069746,6900069739,-7,833,3406,40
6906024591,6906024585,-6,869,4154,40
6910635767,6910635762,-5,591,2457,40
6912259931,6912259925,-6,1098,3544,40
6918513614,6918513608,-6,920,3422,40
6921949827,6921949820,-7,915,4137,40
6922914451,6922914445,-6,928,3049,40
6923201272,6923201281,9,300,1154,40
6924485769,6924485765,-4,1098,2707,40
6933359069,6933359063,-6,1240,4735,40
6934502504,6934502498,-6,896,4327,40
6934566845,6934566847,2,49,1484,40
6937204107,6937204102,-5,690,1797,40
6938345806,6938345826,20,164,736,40
6940243300,6940243294,-6,1208,2896,40
6943359173,6943359166,-7,1615,3909,40
6943648876,6943648881,5,46,1306,40
6949998761,6949998756,-5,1096,2967,40
6952911330,6952911325,-5,658,3044,40
6953219749,6953219771,22,176,785,40
6971892385,6971892379,-6,1127,3933,40
6980284411,6980284407,-4,1074,3542,40
6981906819,6981906815,-4,945,3005,40
6982097494,6982097474,-20,1376,3778,40
6982244262,6982244263,1,1253,916,40
6986079105,6986079098,-7,1212,3882,40
6990396287,6990396282,-5,1606,4798,40
6991263037,6991263031,-6,1232,3792,40
6991706159,6991706156,-3,2321,4413,40
6996176375,6996176382,7,110,1104,40
6998607854,6998607851,-3,1489,2393,40
7002520017,7002520010,-7,800,4618,40
7005200042,7005200038,-4,1331,4177,40
7005598366,7005598361,-5,1152,3741,40
7009283375,7009283369,-6,1039,3735,40
7012685411,7012685405,-6,1243,4073,40
7015168043,7015168039,-4,1021,3759,40
7015948287,7015948282,-5,1196,2958,40
7020532206,7020532202,-4,980,1848,40
7021353448,7021353453,5,21892,42008,40
7022053430,7022053424,-6,1235,4264,40
7022434383,7022434376,-7,1325,2023,40
7022689044,7022689037,-7,88,962,40
7023892574,7023892575,1,2820,2809,40
7026195516,7026195510,-6,801,3713,40
7027740421,7027740400,-21,106,925,40
7029005796,7029005791,-5,102,989,40
7029946955,7029946950,-5,1243,3837,40
7031080430,7031080430,0,1271,1435,40
7035520030,7035520025,-5,1125,3555,40
7035708362,7035708353,-9,1039,2977,40
7040131826,7040131821,-5,1029,3896,40
7042503257,7042503254,-3,2204,6692,40
7044929479,7044929474,-5,1446,3694,40
7045875038,7045875034,-4,588,3050,40
7046715589,7046715582,-7,916,4251,40
7054144287,7054144303,16,100,1385,40
7059838059,7059838054,-5,905,3491,40
7065527319,7065527313,-6,851,3724,40
7065572221,7065572236,15,548,3075,40
7066310906,7066310899,-7,1190,4081,40
7072443870,7072443865,-5,708,3536,40
7073724568,7073724570,2,5704,6051,40
7077870932,7077870950,18,440,1446,40
7080857913,7080857908,-5,993,3378,40
7081985082,7081985077,-5,1352,3484,40
7082094623,7082094617,-6,1111,4038,40
7088748771,7088748763,-8,826,4135,40
7088800129,7088800121,-8,830,4031,40
7091297615,7091297610,-5,832,3547,40
7092647684,7092647674,-10,234,1300,40
7095577749,7095577743,-6,912,3102,40
7095789272,7095789266,-6,1320,5101,40
7095858942,7095858937,-5,137,2098,40
7110903537,7110903530,-7,1015,4026,40
7116176607,7116176604,-3,902,2670,40
7117273367,7117273346,-21,926,6861,40
7118841800,7118841793,-7,1456,3731,40
7127188406,7127188424,18,932,3206,40
7128402587,7128402581,-6,1447,4097,40
7129955582,7129955575,-7,1052,5367,40
7131864211,7131864206,-5,797,3451,40
7134493373,7134493367,-6,1177,3767,40
7134738096,7134738089,-7,1299,2888,40
7142056323,7142056317,-6,844,3080,40
7148576638,7148576632,-6,1209,4345,40
7152402918,7152402913,-5,1140,4382,40
7162545031,7162545037,6,5836,2916,40
7165508078,7165508073,-5,1281,5273,40
7166523782,7166523778,-4,1066,3581,40
7168592978,7168592974,-4,1046,3484,40
7170352093,7170352108,15,361,1708,40
7170549224,7170549234,10,348,1363,40
7172371693,7172371687,-6,1243,3723,40
7175275802,7175275797,-5,515,993,40
7180810703,7180810697,-6,868,4614,40
7184203642,7184203634,-8,1096,4679,40
7184339070,7184339083,13,535,2956,40
7189600326,7189600320,-6,1120,3389,40
7191423145,7191423138,-7,1067,4106,40
7207636707,7207636701,-6,952,3360,40
7221018622,7221018618,-4,1272,1980,40
7221508737,7221508734,-3,1079,2354,40
7228221383,7228221378,-5,1039,3663,40
7229653415,7229653411,-4,1165,3712,40
7239410989,7239410984,-5,1185,4013,40
7241357622,7241357617,-5,912,2884,40
7243177726,7243177721,-5,1030,4929,40
7247598585,7247598579,-6,846,4371,40
7249564351,7249564351,0,1442,1332,40
7255043516,7255043519,3,30409,17774,40
7258241206,7258241201,-5,1130,3837,40
7264852433,7264852427,-6,1726,3562,40
7269018279,7269018281,2,1114,248,40
7285450811,7285450805,-6,792,3173,40
7287532823,7287532817,-6,894,3912,40
7292955550,7292955550,0,42579,26168,40
7293793759,7293793752,-7,1361,4892,40
7294058119,7294058131,12,1114,3371,40
7297537502,7297537494,-8,1294,4621,40
7301886977,7301886972,-5,1104,5293,40
7302311558,7302311565,7,90,1410,40
7304402397,7304402392,-5,924,3076,40
7305067364,7305067354,-10,312,2190,40
7317228311,7317228306,-5,1327,4728,40
7322211797,7322211791,-6,793,2830,40
7322333744,7322333749,5,255,1304,40
7323245115,7323245112,-3,1014,1589,40
7330916431,7330916425,-6,1333,3800,40
7331753766,7331753785,19,1065,3227,40
7335350654,7335350649,-5,684,3349,40
7338719085,7338719086,1,4428,3972,40
7341825371,7341825386,15,285,1369,40
7342288895,7342288907,12,178,1247,40
7344959298,7344959294,-4,1040,3497,40
7345912470,7345912466,-4,1060,4008,40
7350050263,7350050257,-6,850,3357,40
7351793725,7351793720,-5,1287,3351,40
7354292244,7354292238,-6,960,2703,40
7355208494,7355208494,0,137,1026,40
7355663408,7355663414,6,3430,1480,40
7357836255,7357836249,-6,1167,3697,40
7358809879,7358809875,-4,697,2066,40
7359433902,7359433922,20,189,1106,40
7360241580,7360241572,-8,809,2894,40
7370604667,7370604661,-6,1066,3427,40
7378211304,7378211297,-7,856,3075,40
7384713966,7384713960,-6,846,3263,40
7387083610,7387083602,-8,1290,3685,40
7387371832,7387371831,-1,1714,2546,40
7387892095,7387892091,-4,661,2757,40
7390648464,7390648462,-2,2122,4110,40
7401200129,7401200126,-3,2775,4827,40
7403476962,7403476968,6,1188,1654,40
7407252467,7407252462,-5,1107,2934,40
7407547870,7407547867,-3,623,2555,40
7411886923,7411886918,-5,993,3646,40
7419075487,7419075466,-21,897,429,40
7424949420,7424949427,7,11224,27133,40
7429403799,7429403793,-6,1027,4338,40
7430287412,7430287414,2,40053,18401,40
7436910879,7436910866,-13,730,4150,40
7437629800,7437629815,15,434,2621,40
7437665311,7437665327,16,266,1524,40
7440310319,7440310322,3,2272,2530,40
7445888017,7445888010,-7,1449,4518,40
7452870439,7452870434,-5,649,3011,40
7466269018,7466269010,-8,1136,3654,40
7473905573,7473905563,-10,958,3767,40
7474506029,7474506035,6,10206,2487,40
7481262073,7481262078,5,21371,38270,40
7481815625,7481815626,1,1468,2063,40
7484253880,7484253880,0,1080,1373,40
7487894820,7487894814,-6,1455,3715,40
7488156348,7488156368,20,791,3501,40
7488802129,7488802127,-2,1577,2704,40
7489516821,7489516843,22,329,2003,40
7489833186,7489833179,-7,1270,2821,40
7490623106,7490623102,-4,960,4055,40
7492101409,7492101406,-3,1019,1971,40
7492935413,7492935407,-6,2957,11463,40
7493384501,7493384497,-4,659,2446,40
7493517102,7493517123,21,171,1170,40
7497191923,7497191917,-6,842,4562,40
7497247622,7497247642,20,1662,4556,40
7517818238,7517818244,6,3221,1672,40
7517846226,7517846219,-7,924,3937,40
7519636627,7519636621,-6,1208,3053,40
7523271842,7523271837,-5,1292,3691,40
7523981429,7523981430,1,888,949,40
7528427834,7528427828,-6,823,3231,40
7528634397,7528634409,12,274,772,40
7531730843,7531730846,3,2373,2300,40
7538778534,7538778532,-2,1077,1398,40
7540408850,7540408854,4,1823,1121,40
7547092758,7547092752,-6,1114,3333,40
7547175104,7547175123,19,278,1052,40
7556634073,7556634073,0,1039,331,40
7556965412,7556965429,17,1106,3552,40
7558790471,7558790470,-1,4425,6332,40
7563299786,7563299780,-6,1087,2671,40
7574874646,7574874644,-2,668,1658,40
7598962527,7598962521,-6,663,4517,40
7605437803,7605437801,-2,1049,1898,40
7609310239,7609310233,-6,1117,3916,40
7612511198,7612511192,-6,1408,3196,40
7616131327,7616131322,-5,717,2455,40
7617004519,7617004520,1,5,1105,40
7628901617,7628901609,-8,1177,4390,40
7636635781,7636635774,-7,839,3350,40
7639563443,7639563445,2,906,1314,40
7642101278,7642101274,-4,1100,2137,40
7642267236,7642267224,-12,1024,2368,40
7643663350,7643663354,4,2617,2695,40
7644038476,7644038469,-7,935,4392,40
7644372198,7644372193,-5,243,1542,40
7646652577,7646652573,-4,1236,3736,40
7654348626,7654348621,-5,1334,3303,40
7656342545,7656342537,-8,742,3305,40
7657334755,7657334749,-6,905,4115,40
7661901235,7661901241,6,68141,32100,40
7675458051,7675458044,-7,763,2585,40
7679206610,7679206602,-8,607,5289,40
7688598914,7688598909,-5,1110,3177,40
7696026246,7696026241,-5,738,3231,40
7696140606,7696140618,12,1127,3670,40
7697269063,7697269058,-5,987,4214,40
7703564427,7703564429,2,1121,1311,40
7722158251,7722158248,-3,692,3781,40
7724801809,7724801803,-6,958,2545,40
7733491862,7733491858,-4,843,2956,40
7733796543,7733796532,-11,910,3392,40
7734383999,7734383993,-6,877,3104,40
7737115288,7737115282,-6,855,3867,40
7738926206,7738926216,10,318,1651,40
7739740654,7739740645,-9,1254,4847,40
7739794100,7739794117,17,1235,2546,40
7743847922,7743847920,-2,1139,1810,40
7744869336,7744869353,17,1084,4405,40
7745099152,7745099170,18,40,1535,40
7752312995,7752312989,-6,954,3574,40
7760037457,7760037452,-5,1105,4357,40
7760086536,7760086541,5,173,945,40
7764746618,7764746615,-3,1204,3851,40
7765608943,7765608938,-5,881,2842,40
7773879231,7773879225,-6,1124,3813,40
7774158951,7774158965,14,261,1364,40
7776907763,7776907757,-6,775,2580,40
7800031103,7800031097,-6,926,2493,40
7802952435,7802952430,-5,919,2541,40
7803180165,7803180178,13,703,3408,40
7803628787,7803628783,-4,1187,3090,40
7805147236,7805147227,-9,40,627,40
7811595227,7811595221,-6,734,2225,40
7812712327,7812712325,-2,1187,2799,40
7815055098,7815055106,8,3885,1436,40
7817313057,7817313050,-7,892,5416,40
7819455080,7819455074,-6,988,3761,40
7822206863,7822206857,-6,1070,4303,40
7822262812,7822262806,-6,844,3903,40
7824101534,7824101528,-6,998,3829,40
7825946726,7825946731,5,3491,1761,40
7838950270,7838950263,-7,769,2616,40
7846881329,7846881322,-7,723,3905,40
7853643957,7853643951,-6,1183,3580,40
7853858573,7853858573,0,1117,1986,40
7853885013,7853885013,0,19872,23483,40
7865695177,7865695172,-5,1090,3383,40
7866570695,7866570689,-6,791,3595,40
7869928764,7869928764,0,661,222,40
7874503833,7874503826,-7,819,2570,40
7876231453,7876231446,-7,990,4258,40
7876477815,7876477826,11,319,973,40
7880629813,7880629806,-7,1247,4533,40
7887594423,7887594416,-7,758,3689,40
7887915337,7887915340,3,23539,25968,40
7891082401,7891082394,-7,969,3570,40
7891259542,7891259562,20,1638,1821,40
7905248234,7905248227,-7,1407,5520,40
7911090881,7911090879,-2,1408,2051,40
7911804231,7911804235,4,370,984,40
7913611969,7913611962,-7,1186,3385,40
7913958645,7913958637,-8,159,1213,40
7916759487,7916759474,-13,378,63,40
7921398927,7921398922,-5,609,3297,40
7925284670,7925284665,-5,951,3846,40
7928448655,7928448660,5,8415,3758,40
7932191517,7932191512,-5,1097,3385,40
7933299518,7933299513,-5,918,2936,40
7942496614,7942496612,-2,1305,2391,40
7945105206,7945105200,-6,1102,3560,40
7950269524,7950269518,-6,1387,3939,40
7953774023,7953774026,3,1462,1393,40
7955138259,7955138254,-5,1079,2885,40
7956834249,7956834243,-6,826,2255,40
7958078045,7958078038,-7,1197,3702,40
7959152884,7959152874,-10,113,1310,40
7959791975,7959791968,-7,907,4090,40
7961388139,7961388134,-5,744,4602,40
7976146599,7976146595,-4,801,2426,40
7976353215,7976353193,-22,375,1561,40
7979537334,7979537350,16,1660,1044,40
7986574937,7986574931,-6,1316,5236,40
7986692703,7986692718,15,341,1908,40
7991921524,7991921521,-3,799,3331,40
7992186174,7992186165,-9,117,744,40
7997304010,7997304005,-5,1337,3630,40
8005316099,8005316095,-4,689,2080,40
8005753061,8005753054,-7,920,3865,40
8006490191,8006490186,-5,395,1025,40
8007596049,8007596043,-6,995,3925,40
8008265094,8008265073,-21,200,1093,40
8010223285,8010223280,-5,868,2554,40
8010290704,8010290721,17,514,2969,40
8013920159,8013920153,-6,1020,3520,40
8014897703,8014897722,19,163,909,40
8015879229,8015879225,-4,1494,2810,40
8032113034,8032113026,-8,571,2763,40
8032422085,8032422080,-5,692,1630,40
8034483127,8034483122,-5,1032,3492,40
8034581867,8034581861,-6,1038,3324,40
8039535704,8039535698,-6,1125,3589,40
8041907180,8041907185,5,2192,1653,40
8044982053,8044982049,-4,968,2768,40
8046365540,8046365533,-7,1205,4178,40
8047495310,8047495305,-5,915,2465,40
8051417284,8051417279,-5,731,3044,40
8052726659,8052726652,-7,955,2337,40
8058430622,8058430615,-7,1100,4396,40
8059075174,8059075182,8,4363,1073,40
8075846729,8075846724,-5,1094,3475,40
8076368844,8076368839,-5,257,1013,40
8079374702,8079374696,-6,1103,4724,40
8094824207,8094824201,-6,1017,3955,40
8097331009,8097331012,3,2472,2236,40
8107272835,8107272829,-6,995,2474,40
8107852070,8107852081,11,206,692,40
8108726362,8108726357,-5,1071,4099,40
8110154416,8110154416,0,1308,2111,40
8114513327,8114513321,-6,978,4164,40
8116860849,8116860844,-5,674,2439,40
8118579090,8118579084,-6,796,2690,40
8119146805,8119146823,18,163,1053,40
8122987622,8122987616,-6,870,4462,40
8132754591,8132754584,-7,1351,4998,40
8137813835,8137813829,-6,1013,4448,40
8139477307,8139477301,-6,954,3396,40
8140084355,8140084358,3,21588,18769,40
8141106918,8141106913,-5,989,4065,40
8141811199,8141811213,14,223,1244,40
8156313631,8156313625,-6,1316,5028,40
8157992059,8157992051,-8,854,4052,40
8160846800,8160846807,7,6804,1346,40
8166091049,8166091056,7,5645,2461,40
8169095830,8169095826,-4,576,3236,40
8183920240,8183920236,-4,1757,3762,40
8185437083,8185437077,-6,983,3049,40
8185489422,8185489402,-20,81,758,40
8186982566,8186982574,8,7476,32790,40
8191404935,8191404927,-8,1151,4513,40
8192897746,8192897740,-6,863,4550,40
8194844217,8194844211,-6,1048,4338,40
8196690559,8196690553,-6,202,1138,40
8202079578,8202079573,-5,830,3373,40
8204195821,8204195829,8,75,1154,40
8208745561,8208745555,-6,1543,5727,40
8209158192,8209158203,11,117,1411,40
8212778240,8212778237,-3,986,2088,40
8226419754,8226419746,-8,890,3931,40
8251852926,8251852921,-5,707,2832,40
8252074184,8252074185,1,282,867,40
8255095818,8255095813,-5,1151,3894,40
8262078692,8262078704,12,11007,55867,40
8266579287,8266579281,-6,1188,3087,40
8267401500,8267401516,16,680,2649,40
8279902293,8279902303,10,12742,32238,40
8281862221,8281862215,-6,1126,4140,40
8286563897,8286563890,-7,1213,3283,40
8286591164,8286591158,-6,1179,4393,40
8288688190,8288688185,-5,1266,4533,40
8296321247,8296321241,-6,1238,4331,40
8304001821,8304001822,1,1778,1677,40
8305013935,8305013931,-4,731,2676,40
8308182339,8308182343,4,2555,1571,40
8309378833,8309378828,-5,375,1661,40
8313024635,8313024629,-6,1038,4226,40
8315897727,8315897727,0,1194,1352,40
8319379967,8319379962,-5,767,2955,40
8320958508,8320958502,-6,976,2876,40
8323717357,8323717350,-7,1197,2779,40
8329792750,8329792745,-5,797,3705,40
8330139572,8330139565,-7,68,1052,40
8332478899,8332478894,-5,700,2653,40
8333152621,8333152616,-5,1094,4574,40
8336782401,8336782401,0,1061,1355,40
8337721876,8337721889,13,270,1312,40
8337856918,8337856914,-4,2050,5538,40
8338622914,8338622914,0,1205,1380,40
8339150812,8339150817,5,366,994,40
8340437514,8340437510,-4,1113,4068,40
8343923741,8343923754,13,13097,41122,40
8347868131,8347868138,7,45,863,40
8349436849,8349436843,-6,902,4079,40
8350154968,8350154961,-7,821,3233,40
8350431174,8350431175,1,1718,2322,40
8357787660,8357787654,-6,1202,3282,40
8358218341,8358218359,18,21,442,40
8358593034,8358593026,-8,901,4197,40
8359354097,8359354090,-7,750,2899,40
8362232673,8362232676,3,2237,1506,40
8363050715,8363050708,-7,767,3827,40
8364643265,8364643261,-4,1076,2919,40
8365787657,8365787650,-7,863,3707,40
8369458465,8369458459,-6,1031,2721,40
8379004845,8379004838,-7,560,2090,40
8382455050,8382455048,-2,1919,4755,40
8385984148,8385984150,2,2245,1549,40
8388755294,8388755301,7,4701,1358,40
8392814495,8392814489,-6,1248,4244,40
8394473042,8394473034,-8,828,3784,40
8397476009,8397476015,6,7936,26020,40
8397762971,8397762964,-7,1080,5060,40
8405533934,8405533939,5,2193,1554,40
8407733737,8407733730,-7,972,3677,40
8409681653,8409681649,-4,1113,3104,40
8413000529,8413000524,-5,1243,3107,40
8416116495,8416116489,-6,981,2448,40
8416907746,8416907739,-7,1192,3941,40
8418983564,8418983557,-7,1304,3683,40
8423079830,8423079826,-4,1350,3696,40
8423578774,8423578766,-8,850,7192,40
8427120118,8427120113,-5,1086,2780,40
8434737054,8434737049,-5,798,2386,40
8435191471,8435191466,-5,633,3135,40
8437935694,8437935688,-6,1230,4955,40
8438309646,8438309652,6,2135,1259,40
8452460499,8452460494,-5,833,3285,40
8454271434,8454271443,9,10700,56393,40
8455923715,8455923710,-5,1207,3520,40
8456615366,8456615356,-10,1287,3562,40
8457058055,8457058050,-5,1218,3726,40
8463565618,8463565617,-1,1486,2887,40
8478254892,8478254886,-6,1472,4036,40
8479567334,8479567329,-5,1317,5120,40
8480944121,8480944117,-4,1184,4051,40
8483767334,8483767349,15,193,907,40
8484236733,8484236739,6,3353,1211,40
8488098637,8488098632,-5,1011,3574,40
8489253590,8489253586,-4,1294,3885,40
8490420175,8490420169,-6,933,4333,40
8494563618,8494563633,15,94,1241,40
8496222346,8496222345,-1,1041,2227,40
8501494192,8501494201,9,644,90,40
8507725754,8507725773,19,115,1440,40
8507932340,8507932330,-10,286,1547,40
8509399972,8509399966,-6,1320,4111,40
8512163651,8512163647,-4,1338,4764,40
8512848417,8512848411,-6,1315,4655,40
8519567954,8519567948,-6,1843,9939,40
8519620169,8519620163,-6,1128,3483,40
8520617878,8520617873,-5,867,2948,40
8526640660,8526640661,1,1349,1567,40
8531564402,8531564395,-7,1227,3388,40
8532079463,8532079474,11,408,1431,40
8532825185,8532825178,-7,1364,4036,40
8533815820,8533815813,-7,1114,3011,40
8538833889,8538833881,-8,1573,3403,40
8539063621,8539063616,-5,800,3608,40
8540443423,8540443417,-6,740,3859,40
8556671173,8556671167,-6,1166,4451,40
8560101238,8560101231,-7,1299,5071,40
8562844384,8562844387,3,1545,1008,40
8568345400,8568345392,-8,1284,5256,40
8569109153,8569109148,-5,1376,5412,40
8569188421,8569188402,-19,93,1159,40
8572444294,8572444299,5,2727,1417,40
8575266551,8575266546,-5,1351,4431,40
8576407642,8576407642,0,965,1395,40
8583906844,8583906838,-6,1060,3218,40
8587138177,8587138171,-6,1082,4466,40
8587984967,8587984983,16,630,1818,40
8588683014,8588683015,1,2528,2723,40
8589114389,8589114381,-8,1030,3715,40
8591994378,8591994384,6,1916,1410,40
8592662802,8592662804,2,2847,2340,40
8593020295,8593020289,-6,2197,7022,40
8593162346,8593162344,-2,829,2070,40
8596640572,8596640566,-6,1308,2840,40
8597235943,8597235961,18,969,4573,40
8597495261,8597495254,-7,1400,4101,40
8600534198,8600534193,-5,933,2600,40
8600586165,8600586159,-6,1133,3716,40
8600763934,8600763946,12,320,1399,40
8606213853,8606213846,-7,859,4722,40
8607243147,8607243143,-4,820,2386,40
8607697490,8607697485,-5,796,4272,40
8608392295,8608392289,-6,1090,4076,40
8620853189,8620853194,5,2466,2217,40
8622962781,8622962777,-4,1501,5314,40
8630750851,8630750845,-6,1002,2555,40
8632219645,8632219638,-7,861,3976,40
8638712575,8638712569,-6,1012,2999,40
8642218818,8642218813,-5,1421,3231,40
8642727877,8642727863,-14,46,913,40
8643458871,8643458886,15,676,3960,40
8645195975,8645195969,-6,1103,3464,40
8645688382,8645688394,12,974,3969,40
8654208502,8654208494,-8,1002,4447,40
8666123587,8666123582,-5,902,3524,40
8668953517,8668953518,1,1715,2309,40
8670213902,8670213896,-6,778,3039,40
8674291686,8674291679,-7,1120,3297,40
8675562423,8675562420,-3,1914,4911,40
8675677386,8675677382,-4,1237,4621,40
8679050670,8679050663,-7,924,3916,40
8681062520,8681062534,14,195,1289,40
8682155288,8682155282,-6,1507,3241,40
8685000011,8685000011,0,2633,3867,40
8686138500,8686138488,-12,536,1435,40
8690390713,8690390706,-7,1087,4384,40
8691433971,8691433966,-5,815,2791,40
8694580710,8694580706,-4,1272,4404,40
8696107510,8696107502,-8,1084,3532,40
8697561367,8697561362,-5,1652,5537,40
8699116972,8699116964,-8,983,3970,40
8700755912,8700755900,-12,132,1134,40
8702933299,8702933291,-8,515,2579,40
8703408232,8703408250,18,129,1221,40
8709692623,8709692630,7,5785,1969,40
8713580378,8713580370,-8,1311,5531,40
8717061831,8717061826,-5,1108,3156,40
8723206522,8723206518,-4,2287,5313,40
8730154285,8730154280,-5,835,3665,40
8743453882,8743453876,-6,1421,3499,40
8746698407,8746698401,-6,618,2385,40
8748136589,8748136585,-4,1668,2870,40
8748680843,8748680837,-6,912,2606,40
8749853555,8749853550,-5,746,4130,40
8750889811,8750889806,-5,959,2542,40
8754644254,8754644248,-6,603,2620,40
8757823967,8757823962,-5,753,3439,40
8758382998,8758382998,0,189,1006,40
8758784523,8758784521,-2,3753,4474,40
8759971276,8759971270,-6,1129,4033,40
8768735467,8768735460,-7,662,2387,40
8769936806,8769936805,-1,1085,1995,40
8775727728,8775727722,-6,1269,3852,40
8783667024,8783667017,-7,925,3017,40
8791620055,8791620061,6,1980,1092,40
8796186638,8796186633,-5,926,3206,40
8798195523,8798195530,7,2696,1283,40
8798760253,8798760246,-7,920,3394,40
8805216220,8805216214,-6,645,2629,40
8807115070,8807115068,-2,1367,2326,40
8807318282,8807318277,-5,860,2375,40
8808746880,8808746874,-6,784,3391,40
8808924213,8808924230,17,968,2390,40
8810181234,8810181239,5,20812,42113,40
8816040004,8816039997,-7,1945,7096,40
8821498593,8821498587,-6,1817,7324,40
8828067602,8828067598,-4,44,1212,40
8834069821,8834069818,-3,735,2600,40
8838828219,8838828214,-5,541,2930,40
8841203112,8841203117,5,2126,1209,40
8841845601,8841845598,-3,1785,3706,40
8854170814,8854170808,-6,1443,5030,40
8856143891,8856143885,-6,878,5205,40
8856509719,8856509734,15,632,3397,40
8863706066,8863706066,0,20686,33576,40
8864469410,8864469405,-5,679,2016,40
8866698460,8866698453,-7,647,2753,40
8867017445,8867017461,16,1112,3323,40
8873447214,8873447213,-1,807,1524,40
8874565637,8874565651,14,3,883,40
8874682790,8874682811,21,182,1238,40
8885323965,8885323961,-4,659,3076,40
8885983070,8885983064,-6,735,2355,40
8887232739,8887232733,-6,1210,2888,40
8888426385,8888426390,5,2479,1016,40
8892262774,8892262765,-9,652,1608,40
8893776190,8893776208,18,349,1538,40
8894477222,8894477217,-5,787,3090,40
8897732286,8897732280,-6,884,3603,40
8897972548,8897972537,-11,558,1966,40
8899676327,8899676323,-4,901,3684,40
8908433311,8908433302,-9,1273,5881,40
8909389844,8909389838,-6,871,3660,40
8909699086,8909699105,19,1105,3860,40
8912374803,8912374795,-8,1122,4329,40
8916400935,8916400942,7,2796,1189,40
8916671472,8916671466,-6,1222,3546,40
8930548762,8930548759,-3,865,2122,40
8937016107,8937016101,-6,861,3086,40
8951002881,8951002887,6,3543,1993,40
8952022355,8952022351,-4,1844,3293,40
8956190719,8956190714,-5,792,3566,40
8957764918,8957764911,-7,944,4976,40
8981911770,8981911769,-1,1196,2894,40
8983302174,8983302168,-6,902,4114,40
8983368389,8983368370,-19,169,678,40
8983896089,8983896083,-6,1403,5096,40
8983979059,8983979053,-6,1465,3580,40
8992774712,8992774714,2,1633,1881,40
8995200361,8995200354,-7,1159,3582,40
8997909722,8997909716,-6,586,3768,40
9014199241,9014199235,-6,1016,3405,40
9015160302,9015160297,-5,990,3126,40
9015523014,9015522995,-19,320,1557,40
9019861044,9019861038,-6,1130,2939,40
9020063727,9020063710,-17,277,1292,40
9020928081,9020928088,7,3248,1428,40
9022438008,9022438011,3,33699,18925,40
9025460421,9025460414,-7,1372,4937,40
9025968463,9025968458,-5,1263,3712,40
9030696629,9030696622,-7,912,3115,40
9035242962,9035242955,-7,924,4135,40
9037466487,9037466482,-5,775,3175,40
9049225897,9049225891,-6,881,3167,40
9050211461,9050211454,-7,1275,4354,40
9050575659,9050575654,-5,1005,3724,40
9051036389,9051036385,-4,22212,7539,40
9051115396,9051115390,-6,1073,3482,40
9052965040,9052965033,-7,1089,3626,40
9058828856,9058828851,-5,845,3838,40
9060193913,9060193906,-7,1240,5377,40
9060966974,9060966976,2,1160,1227,40
9065062359,9065062353,-6,1003,4619,40
9067663457,9067663442,-15,354,2508,40
9068233528,9068233542,14,116,1860,40
9068376511,9068376522,11,694,3121,40
9070446240,9070446245,5,966,940,40
9073994478,9073994473,-5,1003,4173,40
9077082235,9077082229,-6,1223,1395,40
9084416405,9084416398,-7,1222,3225,40
9087035884,9087035878,-6,1227,4186,40
9087103210,9087103207,-3,1171,1743,40
9087197500,9087197515,15,134,1038,40
9088207597,9088207578,-19,966,3707,40
9089746190,9089746184,-6,671,3982,40
9095097267,9095097268,1,6239,25953,40
9098341338,9098341345,7,3274,929,40
9101859621,9101859615,-6,1317,5078,40
9109399081,9109399078,-3,1134,2244,40
9118279125,9118279107,-18,1322,4069,40
9118537220,9118537214,-6,1128,4109,40
9118819006,9118819006,0,181,761,40
9122807866,9122807862,-4,824,2837,40
9123616166,9123616158,-8,887,4397,40
9124919966,9124919986,20,190,1002,40
9131492869,9131492862,-7,1155,2953,40
9132616054,9132616049,-5,1092,3052,40
9134422489,9134422483,-6,881,3323,40
9138474739,9138474738,-1,18227,6832,40
9138919229,9138919222,-7,871,3985,40
9141541478,9141541478,0,1348,2013,40
9148494277,9148494272,-5,1082,5124,40
9151938638,9151938633,-5,834,4431,40
9151976773,9151976794,21,733,3796,40
9152492816,9152492819,3,1476,1539,40
9152584856,9152584866,10,51,968,40
9160784223,9160784220,-3,641,2339,40
9170594734,9170594727,-7,1144,4016,40
9170938093,9170938087,-6,1297,3785,40
9177821567,9177821561,-6,858,3466,40
9185717222,9185717217,-5,929,3844,40
9187064410,9187064404,-6,893,2661,40
9187863630,9187863651,21,267,1371,40
9191082279,9191082273,-6,841,1857,40
9197275450,9197275442,-8,1198,4466,40
9198571387,9198571378,-9,910,5410,40
9198894495,9198894486,-9,970,3505,40
9199627816,9199627825,9,239,982,40
9203263754,9203263749,-5,989,3640,40
9204172460,9204172462,2,249,1333,40
9207602034,9207602027,-7,963,3317,40
9212457422,9212457418,-4,1032,2782,40
9227993371,9227993365,-6,1043,3396,40
9228992967,9228992963,-4,972,3772,40
9229598748,9229598730,-18,236,1708,40
9244356862,9244356861,-1,1230,953,40
9246754995,9246754989,-6,1158,4205,40
9248958361,9248958353,-8,979,3315,40
9249176591,9249176610,19,145,1744,40
9253261630,9253261623,-7,1434,4521,40
9258824731,9258824726,-5,1037,3014,40
9265576963,9265576942,-21,1188,459,40
9268721913,9268721908,-5,1179,2997,40
9273283502,9273283497,-5,882,3725,40
9275766629,9275766634,5,4296,1270,40
9278403104,9278403101,-3,1944,4269,40
9278734402,9278734396,-6,866,3997,40
9285496066,9285496059,-7,970,4275,40
9290952046,9290952040,-6,1086,4874,40
9292229770,9292229764,-6,1171,4111,40
9292333614,9292333629,15,931,2906,40
9295325614,9295325608,-6,1409,3689,40
9295409410,9295409415,5,2476,899,40
9295913475,9295913469,-6,868,3833,40
9296097428,9296097419,-9,284,1569,40
9297325632,9297325646,14,104,1051,40
9302232259,9302232266,7,12486,4611,40
9310044697,9310044691,-6,1535,5410,40
9312118175,9312118165,-10,253,1168,40
9314067667,9314067662,-5,1024,3263,40
9315717315,9315717306,-9,1273,4144,40
9316080983,9316080969,-14,106,1203,40
9317253427,9317253423,-4,1388,2740,40
9319770043,9319770038,-5,761,2466,40
9337598297,9337598292,-5,822,2629,40
9350297858,9350297853,-5,722,3181,40
9350716544,9350716538,-6,997,3184,40
9357913925,9357913920,-5,919,3311,40
9373948130,9373948125,-5,1038,2666,40
9373995143,9373995120,-23,141,10501,40
9375046791,9375046799,8,3745,1567,40
9375152238,9375152230,-8,829,5566,40
9377131237,9377131231,-6,947,4109,40
9384173611,9384173606,-5,981,3541,40
9391103974,9391103967,-7,987,2812,40
9400272070,9400272066,-4,977,3742,40
9400549052,9400549073,21,586,2388,40
9407784815,9407784810,-5,1332,4666,40
9409895067,9409895059,-8,1044,4427,40
9412636794,9412636789,-5,694,3094,40
9412734732,9412734730,-2,121,817,40
9424547778,9424547760,-18,7352,1745,40
9425185498,9425185493,-5,1012,4577,40
9430737205,9430737200,-5,1233,4354,40
9430864142,9430864132,-10,997,2924,40
9431460527,9431460521,-6,848,3141,40
9432651802,9432651797,-5,1417,4774,40
9441933090,9441933104,14,253,1858,40
9448525004,9448524997,-7,638,3174,40
9449036998,9449037017,19,826,3208,40
9451256679,9451256673,-6,931,3017,40
9459334615,9459334618,3,1713,1429,40
9468916410,9468916405,-5,1094,3736,40
9488810378,9488810375,-3,910,2630,40
9497559683,9497559674,-9,1505,6100,40
9502030667,9502030666,-1,793,1545,40
9507311256,9507311250,-6,888,4014,40
9509083621,9509083614,-7,488,2146,40
9517200630,9517200629,-1,1621,1401,40
9519783877,9519783878,1,32601,31772,40
9533720375,9533720370,-5,854,2925,40
9539497818,9539497813,-5,997,3492,40
9548616045,9548616037,-8,1350,5513,40
9553971453,9553971448,-5,1260,3392,40
9555160002,9555160009,7,3698,1555,40
9565866381,9565866377,-4,758,3802,40
9566019295,9566019289,-6,1416,3821,40
9566749738,9566749733,-5,1025,3145,40
9568525206,9568525211,5,53,982,40
9569383673,9569383680,7,12443,20614,40
9572634818,9572634806,-12,3137,12238,40
9575820324,9575820318,-6,807,3470,40
9575978474,9575978467,-7,990,3205,40
9584828702,9584828682,-20,1675,709,40
9585075293,9585075286,-7,1250,9146,40
9589421452,9589421446,-6,567,2175,40
9594444155,9594444149,-6,1057,3035,40
9594730289,9594730283,-6,951,3759,40
9595488474,9595488468,-6,1399,6054,40
9596624689,9596624682,-7,1240,5023,40
9596662533,9596662527,-6,111,1066,40
9611847145,9611847145,0,1311,1966,40
9623417087,9623417081,-6,987,4250,40
9625072356,9625072361,5,4947,2411,40
9625675494,9625675497,3,2447,1226,40
9625923933,9625923929,-4,1052,3437,40
9628778730,9628778732,2,1598,989,40
9635021902,9635021901,-1,2750,4627,40
9636739950,9636739957,7,2351,1055,40
9637697581,9637697574,-7,1124,4331,40
9638818116,9638818103,-13,184,1030,40
9639348999,9639349005,6,4441,2458,40
9647584166,9647584164,-2,111,3612,40
9650541989,9650541971,-18,1889,1470,40
9656236641,9656236638,-3,1270,2803,40
9657223499,9657223494,-5,1096,4630,40
9660126443,9660126437,-6,1141,4016,40
9661509151,9661509138,-13,989,3830,40
9661813733,9661813748,15,75,1058,40
9664065971,9664065965,-6,952,3815,40
9667623694,9667623693,-1,772,727,40
9670009127,9670009120,-7,1019,4744,40
9672658535,9672658529,-6,1065,3720,40
9674618398,9674618379,-19,60,1296,40
9674880982,9674880977,-5,163,1330,40
9677811100,9677811097,-3,1128,3298,40
9686531213,9686531215,2,2905,2467,40
9693426705,9693426700,-5,1075,4811,40
9695038264,9695038266,2,4126,2555,40
9695404629,9695404633,4,5104,2295,40
9699469339,9699469333,-6,713,2444,40
9700031463,9700031458,-5,920,2826,40
9702707865,9702707860,-5,1185,3696,40
9703315950,9703315966,16,829,4015,40
9705998413,9705998409,-4,842,1986,40
9706072325,9706072317,-8,830,2938,40
9706108462,9706108458,-4,624,1593,40
9715139175,9715139168,-7,1180,5789,40
9720321334,9720321326,-8,884,3225,40
9720485339,9720485334,-5,845,2633,40
9721387884,9721387877,-7,996,2811,40
9726840472,9726840474,2,1361,1079,40
9731409955,9731409948,-7,871,3408,40
9732140459,9732140453,-6,966,3442,40
9732461310,9732461328,18,882,3748,40
9734097334,9734097329,-5,1056,4085,40
9735179697,9735179693,-4,823,2982,40
9735786295,9735786310,15,396,2135,40
9741462106,9741462100,-6,1214,3298,40
9745136759,9745136755,-4,1321,3901,40
9747481811,9747481806,-5,1174,2807,40
9748247093,9748247106,13,437,2539,40
9758187283,9758187278,-5,1165,4654,40
9761190096,9761190102,6,2205,1262,40
9763368583,9763368575,-8,1020,3628,40
9775132072,9775132068,-4,992,3648,40
9775779053,9775779049,-4,716,2584,40
9778432010,9778432005,-5,1044,3162,40
9778849190,9778849193,3,2356,2635,40
9788781499,9788781494,-5,1020,3718,40
9791890640,9791890641,1,2159,2740,40
9797414454,9797414448,-6,1041,4261,40
9801091870,9801091866,-4,850,3277,40
9807785094,9807785098,4,3211,2150,40
9815714978,9815714973,-5,1359,4839,40
9818740730,9818740722,-8,1269,4537,40
9824838287,9824838282,-5,1360,3729,40
9826379178,9826379173,-5,735,3239,40
9829480341,9829480343,2,1849,1757,40
9831841546,9831841542,-4,1112,3448,40
9832119822,9832119821,-1,170,1102,40
9832734295,9832734290,-5,1110,4226,40
9832806723,9832806730,7,3726,1569,40
9838006511,9838006505,-6,905,2187,40
9846616061,9846616058,-3,1193,4168,40
9849307110,9849307107,-3,1181,4020,40
9864322563,9864322557,-6,882,3132,40
9874043730,9874043723,-7,1031,3699,40
9875278478,9875278470,-8,1146,3301,40
9875728213,9875728195,-18,243,1042,40
9876506025,9876506025,0,19525,7477,40
9883037403,9883037397,-6,738,2582,40
9892079553,9892079546,-7,1028,4883,40
9898467559,9898467554,-5,1144,3966,40
9910400046,9910400040,-6,1098,3574,40
9914815900,9914815902,2,1358,1136,40
9918152493,9918152486,-7,688,3360,40
9919489467,9919489464,-3,1354,1658,40
9920838463,9920838458,-5,810,3445,40
9921420021,9921420015,-6,830,3231,40
9921685102,9921685116,14,393,1624,40
9922717159,9922717153,-6,727,2427,40
9923997098,9923997093,-5,1253,3951,40
9926465522,9926465505,-17,879,3228,40
9928548310,9928548308,-2,164,1403,40
9935409950,9935409943,-7,969,3255,40
9940270815,9940270810,-5,1001,2999,40
9950072039,9950072033,-6,973,3535,40
9950193069,9950193058,-11,881,2377,40
9957178355,9957178350,-5,598,1787,40
9957397591,9957397589,-2,122,1174,40
9966904316,9966904310,-6,878,3355,40
9982692942,9982692949,7,2655,1462,40
9984325174,9984325174,0,1817,2211,40
9994287379,9994287370,-9,894,3695,40
9995070086,9995070099,13,420,1682,40
10007061078,10007061072,-6,1131,3835,40
10008678555,10008678549,-6,1252,2727,40
10010180922,10010180926,4,4446,1905,40
10013852498,10013852493,-5,1060,3585,40
10013879157,10013879174,17,455,2298,40
10021174789,10021174786,-3,1024,1810,40
10022264799,10022264793,-6,1337,3884,40
10029438371,10029438371,0,1309,2239,40
10031786669,10031786662,-7,1336,4216,40
10032221239,10032221221,-18,903,4669,40
10033673808,10033673810,2,3233,3166,40
10040700376,10040700372,-4,859,4195,40
10044208483,10044208476,-7,852,6108,40
10045480676,10045480670,-6,199,1224,40
10050778087,10050778082,-5,1089,3717,40
10051996693,10051996689,-4,843,2929,40
10052763307,10052763300,-7,1242,4163,40
10054629191,10054629185,-6,798,2096,40
10059849589,10059849582,-7,1156,3328,40
10059924255,10059924242,-13,117,1156,40
10060305157,10060305159,2,146,941,40
10061285025,10061285021,-4,1130,3017,40
10061798168,10061798187,19,106,712,40
10069088593,10069088587,-6,1239,4500,40
10074331059,10074331051,-8,1196,3190,40
10076016652,10076016647,-5,1043,4469,40
10079828913,10079828918,5,6327,2888,40
10083194049,10083194041,-8,1046,4098,40
10086100625,10086100620,-5,939,3589,40
10095489382,10095489377,-5,1298,3394,40
10098298422,10098298417,-5,561,2092,40
10098796254,10098796274,20,714,2866,40
10113553832,10113553826,-6,1090,3494,40
10117339521,10117339542,21,687,2397,40
10119585006,10119584999,-7,724,3459,40
10119706084,10119706090,6,268,1745,40
10121480089,10121480092,3,6482,3421,40
10122439958,10122439952,-6,745,3628,40
10123739869,10123739887,18,928,3609,40
10131936173,10131936166,-7,1375,3564,40
10133267968,10133267963,-5,713,3921,40
10136129967,10136129962,-5,645,3578,40
10137683238,10137683233,-5,1035,2491,40
10137929260,10137929243,-17,101,1421,40
10139826509,10139826503,-6,1197,3121,40
10142680463,10142680457,-6,853,2135,40
10142788566,10142788561,-5,887,3439,40
10148842738,10148842737,-1,1201,1407,40
10149962661,10149962660,-1,1162,1737,40
10153598631,10153598626,-5,808,2980,40
10158324863,10158324857,-6,706,4805,40
10158783034,10158783031,-3,1063,2690,40
10166196609,10166196602,-7,1163,3326,40
10174139459,10174139453,-6,858,2974,40
10179432870,10179432872,2,1799,1638,40
10188226618,10188226611,-7,833,3145,40
10188934014,10188934034,20,385,1185,40
10192340294,10192340289,-5,932,4231,40
10199133728,10199133722,-6,890,3241,40
10213496462,10213496457,-5,850,4037,40
10217875990,10217875983,-7,679,3087,40
10217950656,10217950675,19,337,1073,40
10245282175,10245282169,-6,1330,4921,40
10247601262,10247601257,-5,924,3112,40
10247794678,10247794662,-16,95,857,40
10253645066,10253645062,-4,962,3390,40
10254947371,10254947366,-5,1006,3100,40
10255169724,10255169718,-6,162,1108,40
10255674567,10255674581,14,605,4077,40
10259291957,10259291953,-4,871,3013,40
10260683715,10260683709,-6,1218,3954,40
10261118709,10261118729,20,123,1317,40
10261783219,10261783212,-7,1107,3965,40
10273166028,10273166025,-3,758,1921,40
10276159802,10276159797,-5,988,4257,40
10282749600,10282749594,-6,1123,3745,40
10282909669,10282909661,-8,944,3666,40
10287700741,10287700732,-9,1343,8399,40
10287769597,10287769616,19,298,1662,40
10291423890,10291423886,-4,1293,3289,40
10291456212,10291456233,21,1049,3960,40
10294197031,10294197043,12,113,3401,40
10297247824,10297247830,6,1889,732,40
10299720390,10299720385,-5,874,2008,40
10300257622,10300257617,-5,819,3461,40
10305726690,10305726685,-5,1021,3845,40
10313056682,10313056674,-8,1074,4678,40
10326691083,10326691073,-10,1247,2998,40
10331803767,10331803761,-6,1029,5476,40
10339550986,10339550979,-7,917,3503,40
10342348964,10342348957,-7,1094,4131,40
10344698834,10344698828,-6,890,2773,40
10358631449,10358631444,-5,961,2923,40
10359516586,10359516581,-5,939,2948,40
10362008422,10362008426,4,1459,699,40
10365869099,10365869092,-7,1204,4457,40
10365919326,10365919322,-4,965,3467,40
10383102750,10383102743,-7,1402,5511,40
10393656997,10393656993,-4,838,3057,40
10394245686,10394245684,-2,1241,3608,40
10404830835,10404830827,-8,747,4461,40
10405178376,10405178390,14,718,3332,40
10414609143,10414609138,-5,841,3442,40
10416470970,10416470962,-8,1812,4912,40
10427610692,10427610708,16,904,2911,40
10439494602,10439494597,-5,1067,3517,40
10446879551,10446879546,-5,1090,3363,40
10448392673,10448392668,-5,1104,3172,40
10456560635,10456560632,-3,1324,2716,40
10459365863,10459365857,-6,2394,5450,40
10467555802,10467555805,3,2125,1325,40
10467772499,10467772494,-5,927,2973,40
10473394462,10473394456,-6,980,4099,40
10483505423,10483505417,-6,1014,2430,40
10484481383,10484481381,-2,3991,7843,40
10488945642,10488945636,-6,1305,4343,40
10489173374,10489173373,-1,1069,2577,40
10490691817,10490691810,-7,1078,4129,40
10493071477,10493071470,-7,825,2724,40
10494078590,10494078610,20,1026,3381,40
10496092642,10496092635,-7,1213,4085,40
10501700010,10501700005,-5,739,2749,40
10508150857,10508150854,-3,1152,2321,40
10508587722,10508587718,-4,1148,2581,40
10509691893,10509691887,-6,1210,4468,40
10509866846,10509866839,-7,1101,4274,40
10511393763,10511393758,-5,940,2887,40
10515885990,10515885985,-5,1182,3485,40
10517897311,10517897306,-5,1127,4015,40
10536264355,10536264350,-5,816,3663,40
10547890559,10547890554,-5,1134,3603,40
10548247509,10548247495,-14,317,1119,40
10549554583,10549554577,-6,377,3516,40
10555137806,10555137803,-3,2411,4113,40
10563707577,10563707570,-7,1318,4419,40
10580132821,10580132814,-7,858,4106,40
10580472879,10580472861,-18,44,1680,40
10583463103,10583463116,13,1323,210,40
10587626817,10587626810,-7,964,3579,40
10592872577,10592872570,-7,938,3423,40
10593026246,10593026260,14,143,755,40
10594598750,10594598751,1,2769,2704,40
10600512811,10600512805,-6,1246,4241,40
10603134506,10603134500,-6,727,3480,40
10605579430,10605579434,4,2606,1491,40
10605933610,10605933602,-8,1061,3903,40
10606905007,10606905009,2,118,1056,40
10609124022,10609124043,21,1599,2627,40
10610127783,10610127779,-4,1871,4703,40
10611192689,10611192696,7,4908,1894,40
10616336055,10616336048,-7,1016,3928,40
10622702063,10622702058,-5,1290,3224,40
10626000489,10626000494,5,1991,996,40
10631179814,10631179808,-6,1049,3288,40
10631414330,10631414323,-7,1063,4508,40
10635919693,10635919687,-6,1226,4111,40
10638025025,10638025030,5,2486,1734,40
10641215643,10641215638,-5,1112,3965,40
10644945905,10644945898,-7,566,1759,40
10645006604,10645006598,-6,1374,4412,40
10650442107,10650442106,-1,845,842,40
10659997374,10659997369,-5,846,3664,40
10676564730,10676564724,-6,1497,4198,40
10677519378,10677519378,0,1512,1741,40
10679360561,10679360563,2,24059,15685,40
10681538425,10681538419,-6,1023,4331,40
10684487465,10684487446,-19,103,622,40
10688456840,10688456834,-6,1338,2890,40
10688645308,10688645323,15,958,3990,40
10690636300,10690636293,-7,980,3291,40
10693983830,10693983829,-1,906,1878,40
10694415883,10694415881,-2,1333,1890,40
10694853141,10694853135,-6,1166,3163,40
10694968556,10694968579,23,190,1504,40
10703011817,10703011811,-6,1252,4129,40
10705652279,10705652273,-6,982,4002,40
10707961389,10707961382,-7,1190,2343,40
10710186081,10710186083,2,23392,21757,40
10715030179,10715030173,-6,1142,3616,40
10716580549,10716580566,17,399,1064,40
10723626110,10723626105,-5,805,3071,40
10724169832,10724169838,6,317,2664,40
10724367717,10724367721,4,2361,1186,40
10724947166,10724947165,-1,4652,8490,40
10728771251,10728771245,-6,1031,2713,40
10731300353,10731300350,-3,1267,2379,40
10731960718,10731960712,-6,785,5018,40
10737924970,10737924963,-7,1065,3648,40
10738059823,10738059838,15,230,1100,40
10744555201,10744555197,-4,1157,4114,40
10744607445,10744607461,16,36,1110,40
10751153158,10751153153,-5,947,3660,40
10753769590,10753769585,-5,1332,3934,40
10760921442,10760921441,-1,646,1281,40
10765275590,10765275584,-6,1108,3269,40
10774477383,10774477378,-5,918,3403,40
10779919271,10779919266,-5,932,2452,40
10780306221,10780306243,22,190,1105,40
10787749744,10787749741,-3,204,1048,40
10788312233,10788312227,-6,767,3425,40
10788741660,10788741666,6,1498,782,40
10789266303,10789266323,20,1173,3975,40
10789714369,10789714365,-4,1126,3010,40
10790074070,10790074070,0,971,1924,40
10790241231,10790241227,-4,326,1390,40
10791067774,10791067766,-8,896,2771,40
10791211080,10791211095,15,757,4956,40
10801185010,10801185005,-5,967,2821,40
10802010258,10802010255,-3,896,2198,40
10804532878,10804532873,-5,763,3166,40
10808890050,10808890045,-5,981,4488,40
10809200486,10809200502,16,966,2801,40
10810787632,10810787626,-6,900,3679,40
10811244996,10811245017,21,364,916,40
10813554076,10813554083,7,26,942,40
10815869124,10815869118,-6,1005,3780,40
10822938027,10822938027,0,1297,2032,40
10825203431,10825203426,-5,1171,3712,40
10830543899,10830543894,-5,993,2522,40
10830611068,10830611087,19,133,1109,40
10833443212,10833443217,5,2114,1110,40
10834384680,10834384674,-6,1072,4207,40
10837246997,10837246991,-6,1010,2652,40
10841415642,10841415637,-5,897,3666,40
10841475555,10841475549,-6,1042,3786,40
10844813979,10844813972,-7,1080,4494,40
10856885733,10856885729,-4,562,1810,40
10860653237,10860653232,-5,762,3646,40
10870179061,10870179055,-6,1365,3365,40
10876644563,10876644560,-3,837,2733,40
10878852672,10878852666,-6,698,3649,40
10878929687,10878929673,-14,954,4026,40
10883630982,10883630978,-4,1496,3527,40
10884765135,10884765139,4,890,911,40
10886022911,10886022905,-6,674,3172,40
10891047577,10891047570,-7,566,2086,40
10891122573,10891122557,-16,146,999,40
10891889471,10891889479,8,1421,3618,40
10896255510,10896255518,8,3150,1290,40
10904860571,10904860564,-7,1058,4826,40
10905363774,10905363790,16,697,2739,40
10913111833,10913111827,-6,941,3338,40
10919331050,10919331050,0,1742,2282,40
10920558575,10920558578,3,152,1281,40
10921345106,10921345098,-8,702,3828,40
10922329331,10922329323,-8,1014,4339,40
10925002595,10925002588,-7,1180,3670,40
10926515372,10926515363,-9,1255,4615,40
10928445747,10928445742,-5,994,5087,40
10928835479,10928835493,14,358,1752,40
10931064179,10931064174,-5,837,3379,40
10933115555,10933115553,-2,1307,2359,40
10938680286,10938680279,-7,1562,4872,40
10941814097,10941814088,-9,736,3610,40
10948808747,10948808741,-6,785,4990,40
10951201059,10951201053,-6,1088,2400,40
10954505866,10954505865,-1,821,1288,40
10958007423,10958007413,-10,32883,15849,40
10959471919,10959471914,-5,871,3048,40
10968816851,10968816845,-6,1047,4736,40
10974246298,10974246294,-4,1616,4133,40
10979391501,10979391495,-6,642,2834,40
10981935271,10981935265,-6,538,3205,40
10985300506,10985300500,-6,835,3434,40
10988124961,10988124954,-7,1173,3528,40
10988870622,10988870622,0,1835,2110,40
10991595159,10991595167,8,4301,1240,40
10993371306,10993371299,-7,707,3522,40
10993474764,10993474758,-6,148,1078,40
10999197466,10999197460,-6,448,1594,40
11001663269,11001663263,-6,695,2743,40
11002109166,11002109182,16,165,1322,40
11009073789,11009073789,0,1020,1594,40
11013912738,11013912734,-4,960,3526,40
11014453144,11014453158,14,310,822,40
11015864776,11015864770,-6,994,5169,40
11017263829,11017263822,-7,1104,4556,40
11027710481,11027710476,-5,1388,3317,40
11027824647,11027824641,-6,687,4150,40
11027945823,11027945817,-6,1168,3612,40
11039608857,11039608852,-5,859,3826,40
11039654718,11039654712,-6,1117,4065,40
11039846838,11039846858,20,428,1883,40
11041108421,11041108414,-7,990,3168,40
11061731653,11061731646,-7,803,4738,40
11062567995,11062567990,-5,1285,4765,40
11065143453,11065143447,-6,1052,3386,40
11065489509,11065489530,21,150,1524,40
11067027107,11067027101,-6,1295,3900,40
11069814066,11069814060,-6,940,2938,40
11073944438,11073944432,-6,927,3886,40
11088829495,11088829490,-5,608,2384,40
11088894365,11088894363,-2,141,1280,40
11094420098,11094420091,-7,896,3704,40
11097895818,11097895813,-5,1114,3527,40
11097970351,11097970345,-6,1249,3938,40
11102388838,11102388832,-6,1260,4536,40
11103130139,11103130134,-5,1003,3035,40
11106152103,11106152096,-7,1234,4229,40
11107313296,11107313291,-5,1586,4659,40
11107939428,11107939445,17,1386,3311,40
11111972895,11111972899,4,19887,30562,40
11119814226,11119814222,-4,847,3955,40
11120576390,11120576386,-4,1036,4453,40
11122805702,11122805695,-7,1106,3498,40
11124730265,11124730258,-7,994,3460,40
11135087714,11135087708,-6,1032,5581,40
11139079206,11139079202,-4,765,3176,40
11144089938,11144089933,-5,968,3392,40
11144536024,11144536038,14,462,2323,40
11146130119,11146130114,-5,1136,3324,40
11149027034,11149027028,-6,777,3345,40
11153263380,11153263374,-6,1252,3862,40
11158801918,11158801912,-6,573,2373,40
11162064162,11162064156,-6,1086,2227,40
11169816424,11169816438,14,348,2613,40
11171713285,11171713281,-4,1303,3888,40
11176794613,11176794606,-7,937,4013,40
11184311662,11184311656,-6,985,4683,40
11184710757,11184710778,21,447,859,40
11187594776,11187594771,-5,946,3003,40
11188683311,11188683304,-7,1261,4426,40
11194744148,11194744145,-3,1337,2242,40
11201799189,11201799205,16,824,3378,40
11207205147,11207205146,-1,1263,2864,40
11209700730,11209700726,-4,2220,3632,40
11212009164,11212009174,10,480,1574,40
11213234245,11213234240,-5,778,2717,40
11213560048,11213560065,17,1504,2539,40
11215165598,11215165602,4,1907,1441,40
11229032977,11229032970,-7,1204,3913,40
11230683236,11230683221,-15,163,1181,40
11233863306,11233863302,-4,1011,2704,40
11234217845,11234217839,-6,1283,4088,40
11239817710,11239817703,-7,857,3624,40
11241663879,11241663871,-8,709,2884,40
11253475011,11253475006,-5,870,2568,40
11254666149,11254666141,-8,1110,3593,40
11255666358,11255666353,-5,1082,3518,40
11260747446,11260747439,-7,1589,4779,40
11274608698,11274608694,-4,1084,3467,40
11286228463,11286228457,-6,886,3474,40
11293028183,11293028178,-5,928,4153,40
11293296478,11293296460,-18,226,1032,40
11297527551,11297527547,-4,1085,3446,40
11300264493,11300264486,-7,1086,3635,40
11300375061,11300375078,17,771,2420,40
11305047146,11305047142,-4,927,2037,40
11306170814,11306170825,11,307,1260,40
11311646047,11311646041,-6,1237,4541,40
11312235267,11312235261,-6,1186,6885,40
11317526647,11317526641,-6,1085,4622,40
11324528626,11324528629,3,1958,1707,40
11327920708,11327920725,17,2782,5080,40
11340041214,11340041209,-5,1294,4474,40
11340163876,11340163862,-14,342,951,40
11341839886,11341839881,-5,1327,4925,40
11342543014,11342542997,-17,112,1808,40
11349483547,11349483550,3,2155,2101,40
11351000066,11351000058,-8,1303,4165,40
11351813972,11351813967,-5,183,936,40
11352845397,11352845409,12,310,1402,40
11362246849,11362246845,-4,1143,4171,40
11362383621,11362383610,-11,239,932,40
11364528094,11364528073,-21,871,2385,40
11365530222,11365530217,-5,899,2245,40
11365765889,11365765882,-7,1157,4342,40
11366640758,11366640779,21,28,1578,40
11367337196,11367337190,-6,1079,3818,40
11367401926,11367401913,-13,207,937,40
11368076727,11368076735,8,735,141,40
11373027134,11373027130,-4,1166,2690,40
11386980553,11386980552,-1,3110,3876,40
11390501694,11390501689,-5,1428,4120,40
11395402941,11395402941,0,1466,2237,40
11398346517,11398346512,-5,1179,4716,40
11402281351,11402281345,-6,889,3643,40
11402661822,11402661836,14,516,2203,40
11408202334,11408202327,-7,776,4412,40
11417331126,11417331121,-5,864,2749,40
11422691951,11422691948,-3,767,1603,40
11422725757,11422725767,10,95547,109354,40
11432096493,11432096489,-4,936,3710,40
11433530427,11433530422,-5,813,1979,40
11434364448,11434364467,19,717,2423,40
11436650407,11436650402,-5,778,3131,40
11442515165,11442515161,-4,1305,4856,40
11443345840,11443345859,19,218,1383,40
11445418169,11445418173,4,3541,1979,40
11446026841,11446026834,-7,887,3228,40
11448435995,11448435990,-5,882,2644,40
11449477696,11449477689,-7,1489,4249,40
11453473611,11453473623,12,801,4412,40
11455687551,11455687546,-5,1170,4407,40
11455829268,11455829253,-15,258,1348,40
11456505723,11456505717,-6,985,3728,40
11456661839,11456661851,12,229,1124,40
11457524189,11457524205,16,400,1136,40
11460097832,11460097829,-3,26175,56402,40
11460229559,11460229553,-6,1014,4391,40
11465859078,11465859071,-7,910,3139,40
11473950922,11473950918,-4,1388,4418,40
11474835057,11474835058,1,1532,1703,40
11475361736,11475361719,-17,96,1011,40
11476106098,11476106093,-5,849,4094,40
11479234555,11479234550,-5,773,2503,40
11484884518,11484884513,-5,896,3380,40
11485088064,11485088077,13,1183,4591,40
11500303571,11500303566,-5,1099,3932,40
11500839971,11500839976,5,4239,2234,40
11506754149,11506754145,-4,1060,3689,40
11507853036,11507853033,-3,92,777,40
11523459486,11523459486,0,7606,9291,40
11524076491,11524076498,7,66916,22094,40
11526205543,11526205538,-5,1047,3244,40
11526954512,11526954528,16,241,1090,40
11531491009,11531491005,-4,1668,3476,40
11532969076,11532969072,-4,1087,3363,40
11540038306,11540038303,-3,668,1631,40
11547310283,11547310301,18,55,1121,40
11548157864,11548157867,3,257,1512,40
11548465900,11548465893,-7,681,2212,40
11552902555,11552902549,-6,1175,3189,40
11553007406,11553007405,-1,1264,2273,40
11553699945,11553699940,-5,1075,4817,40
11570695831,11570695825,-6,1010,4216,40
11571806337,11571806330,-7,948,3894,40
11577407398,11577407392,-6,804,3224,40
11596109747,11596109741,-6,1078,4403,40
11597224839,11597224832,-7,916,3878,40
11600707824,11600707819,-5,1127,3495,40
11605991452,11605991454,2,1734,1814,40
11606097655,11606097670,15,884,2792,40
11607488742,11607488736,-6,1195,3570,40
11607806058,11607806053,-5,851,1926,40
11617437319,11617437314,-5,2632,5102,40
11617709410,11617709405,-5,899,3026,40
11617825832,11617825823,-9,864,4246,40
11618254302,11618254322,20,855,3694,40
11623021574,11623021568,-6,713,3328,40
11623241087,11623241082,-5,719,1996,40
11623587096,11623587091,-5,890,3375,40
11623967471,11623967459,-12,293,1143,40
11629535715,11629535709,-6,602,2541,40
11635425422,11635425414,-8,1246,3950,40
11636455332,11636455355,23,1316,4243,40
11636646553,11636646559,6,2599,953,40
11638928298,11638928294,-4,1026,3664,40
11645720394,11645720395,1,1159,1122,40
11651624119,11651624118,-1,1122,2243,40
11653213343,11653213346,3,1423,1717,40
11655053021,11655053014,-7,839,2763,40
11657947718,11657947713,-5,726,4707,40
11658394708,11658394702,-6,1058,3277,40
11666235526,11666235521,-5,1024,2815,40
11668809183,11668809177,-6,1218,3490,40
11670641490,11670641485,-5,845,3410,40
11671037798,11671037819,21,184,1329,40
11672486394,11672486393,-1,1339,2697,40
11683973282,11683973277,-5,1326,3568,40
11687716045,11687716039,-6,1337,3083,40
11688927341,11688927342,1,1755,1664,40
11689320250,11689320255,5,2311,682,40
11691322158,11691322153,-5,349,966,40
11691753292,11691753287,-5,933,3609,40
11692823699,11692823697,-2,1220,3505,40
11699839645,11699839638,-7,921,3310,40
11706350430,11706350423,-7,1070,3115,40
11708366938,11708366933,-5,925,3809,40
11722460508,11722460503,-5,1522,4345,40
11727006795,11727006790,-5,970,4054,40
11731625959,11731625954,-5,1022,3627,40
11732936735,11732936729,-6,988,4592,40
11740362281,11740362275,-6,1035,3713,40
11742538065,11742538062,-3,1018,1655,40
11747379373,11747379367,-6,1303,3289,40
11753349106,11753349105,-1,2757,3572,40
11760800923,11760800902,-21,1071,4161,40
11761190734,11761190741,7,5162,1709,40
11765416935,11765416930,-5,737,3047,40
11766420781,11766420803,22,507,2324,40
11770501322,11770501331,9,10332,23333,40
11771138220,11771138213,-7,1024,3475,40
11779408294,11779408289,-5,870,3785,40
11780327805,11780327790,-15,68,877,40
11781576018,11781576012,-6,1578,5073,40
11785356138,11785356130,-8,1254,4739,40
11785511295,11785511277,-18,865,4257,40
11789361705,11789361701,-4,910,2969,40
11792715832,11792715825,-7,963,7667,40
11795473693,11795473693,0,2210,3189,40
11804381453,11804381447,-6,970,3363,40
11816726545,11816726541,-4,930,3306,40
11817709814,11817709808,-6,303,2159,40
11830791404,11830791399,-5,1001,3151,40
11834165327,11834165322,-5,1294,4005,40
11836582725,11836582719,-6,930,4320,40
11838983283,11838983278,-5,1154,5176,40
11841071625,11841071618,-7,1141,3115,40
11842543471,11842543465,-6,1164,3355,40
11843895731,11843895737,6,5323,2856,40
11844631103,11844631106,3,1908,1337,40
11847354486,11847354479,-7,838,2945,40
11848088046,11848088058,12,610,2358,40
11848561025,11848561024,-1,29639,20325,40
11850451761,11850451755,-6,852,2948,40
11850629044,11850629049,5,2,1145,40
11851348613,11851348606,-7,826,3834,40
11853847598,11853847591,-7,962,3171,40
11858625430,11858625426,-4,1243,4845,40
11859496598,11859496592,-6,1597,4389,40
11859524366,11859524382,16,376,1234,40
11862970390,11862970383,-7,710,3037,40
11863061091,11863061086,-5,861,2696,40
11863669749,11863669742,-7,968,4259,40
11873522342,11873522335,-7,984,3602,40
11873728334,11873728349,15,473,2301,40
11876726120,11876726113,-7,1307,4450,40
11878129949,11878129937,-12,1085,4063,40
11886511290,11886511283,-7,1160,3736,40
11893935365,11893935359,-6,1033,2964,40
11894045118,11894045135,17,690,3217,40
11895020378,11895020374,-4,1089,3071,40
11896006291,11896006284,-7,959,3137,40
11910873167,11910873174,7,12652,25024,40
11910931083,11910931077,-6,833,2659,40
11918562939,11918562933,-6,1393,3687,40
11918953438,11918953449,11,290,2840,40
11923543355,11923543350,-5,807,2430,40
11924171902,11924171899,-3,1279,3636,40
11937727235,11937727230,-5,940,3350,40
11941216558,11941216553,-5,1045,3636,40
11942016984,11942016977,-7,897,3413,40
11947232690,11947232689,-1,2037,2071,40
11948431193,11948431187,-6,879,3947,40
11949241162,11949241156,-6,1042,3538,40
11951443841,11951443837,-4,832,3448,40
11955001283,11955001276,-7,532,2979,40
11958829719,11958829713,-6,981,3092,40
11958907980,11958907965,-15,184,752,40
11959194375,11959194370,-5,318,1012,40
11961766080,11961766085,5,5272,2327,40
11962699136,11962699130,-6,1281,3163,40
11968869386,11968869380,-6,1107,3263,40
11971417491,11971417486,-5,911,3126,40
11971650119,11971650130,11,262,1294,40
11971883192,11971883186,-6,240,1594,40
11972113135,11972113143,8,91,1068,40
11976932731,11976932726,-5,1218,3600,40
11979227747,11979227741,-6,1185,3343,40
11979963859,11979963855,-4,828,1883,40
11981736485,11981736479,-6,825,5394,40
11981880222,11981880239,17,880,2982,40
11983439826,11983439835,9,62,1094,40
11985173875,11985173869,-6,711,3494,40
11987290565,11987290562,-3,720,2331,40
11988786525,11988786518,-7,1058,4161,40
11989607106,11989607098,-8,1024,5014,40
11991193370,11991193364,-6,886,2315,40
11991656444,11991656455,11,155,1114,40
11994998327,11994998321,-6,1418,4238,40
12019087460,12019087466,6,3216,1235,40
12020111863,12020111855,-8,865,3251,40
12020434673,12020434666,-7,1078,3124,40
12020600869,12020600889,20,780,3015,40
12029242379,12029242375,-4,4627,7376,40
12030042569,12030042554,-15,148,1205,40
12031217416,12031217433,17,576,1771,40
12036564379,12036564370,-9,439,1648,40
12041866518,12041866515,-3,894,2426,40
12042033392,12042033405,13,281,1186,40
12043837218,12043837214,-4,935,2933,40
12044862625,12044862627,2,1916,1810,40
12050020214,12050020213,-1,21615,11033,40
12053862857,12053862850,-7,1203,4149,40
12054251727,12054251721,-6,817,4970,40
12054788392,12054788405,13,247,1483,40
12057573873,12057573865,-8,956,3974,40
12059117562,12059117569,7,2063,1194,40
12072497710,12072497705,-5,528,2014,40
12072653878,12072653879,1,323,989,40
12087443101,12087443094,-7,632,4129,40
12100264606,12100264598,-8,1294,3537,40
12105688693,12105688688,-5,920,3944,40
12110169722,12110169715,-7,959,4196,40
12110465278,12110465291,13,495,1557,40
12113293030,12113293025,-5,1244,3725,40
12113592982,12113592977,-5,1186,3242,40
12128780970,12128780969,-1,732,1413,40
12129053966,12129053973,7,470,1216,40
12133251210,12133251215,5,3017,1144,40
12139926413,12139926406,-7,1080,3976,40
12140023684,12140023702,18,251,1122,40
12140172594,12140172589,-5,935,4609,40
12144590794,12144590790,-4,680,3187,40
12144999342,12144999330,-12,53,1155,40
12150067326,12150067321,-5,1112,4067,40
12159343650,12159343644,-6,1431,5630,40
12161971217,12161971224,7,7746,2272,40
12165123113,12165123105,-8,811,2600,40
12166124694,12166124688,-6,999,2847,40
12170698393,12170698387,-6,1179,4353,40
12177333787,12177333782,-5,1058,5141,40
12188021619,12188021614,-5,1144,2938,40
12188195878,12188195872,-6,1170,3023,40
12192820622,12192820617,-5,866,3248,40
12203502398,12203502392,-6,1629,5328,40
12203749527,12203749532,5,24,1084,40
12207645773,12207645766,-7,1158,4873,40
12209301231,12209301226,-5,967,4605,40
12212374917,12212374914,-3,1591,3869,40
12212442410,12212442404,-6,957,3092,40
12214493507,12214493501,-6,1100,3600,40
12216589675,12216589677,2,8760,9646,40
12218548115,12218548109,-6,852,3227,40
12220367061,12220367056,-5,961,2559,40
12220444510,12220444506,-4,832,3581,40
12222473449,12222473458,9,12140,33712,40
12229094681,12229094673,-8,962,3223,40
12229283774,12229283790,16,575,2595,40
12232486045,12232486041,-4,928,3677,40
12234207219,12234207218,-1,851,2306,40
12235828855,12235828848,-7,1728,11132,40
12248844446,12248844439,-7,753,3006,40
12252007322,12252007339,17,992,5214,40
12252763921,12252763915,-6,722,3204,40
12258179450,12258179445,-5,768,3136,40
12259030677,12259030682,5,2039,981,40
12259222627,12259222622,-5,1232,6064,40
12262002722,12262002717,-5,497,1476,40
12262135126,12262135146,20,208,1196,40
12264272611,12264272612,1,6846,22464,40
12284223018,12284223014,-4,778,2392,40
12284970879,12284970892,13,679,2508,40
12294639847,12294639850,3,2064,1537,40
12307295667,12307295660,-7,1161,4614,40
12309339383,12309339378,-5,833,3289,40
12309969227,12309969221,-6,1225,2790,40
12315528007,12315528011,4,5373,3244,40
12316250649,12316250654,5,2329,988,40
12324422811,12324422812,1,1671,21479,40
12326494346,12326494345,-1,1386,1794,40
12327405840,12327405836,-4,1851,4946,40
12327447526,12327447519,-7,123,1067,40
12329948587,12329948582,-5,997,2788,40
12330253283,12330253278,-5,794,3920,40
12336531722,12336531718,-4,1153,3869,40
12344028982,12344028977,-5,1077,3363,40
12344954678,12344954673,-5,676,3241,40
12346487001,12346486999,-2,1726,2031,40
12348827014,12348827009,-5,708,3907,40
12349459093,12349459103,10,35589,58689,40
12354419314,12354419309,-5,988,3047,40
12354496135,12354496152,17,885,4186,40
12355030195,12355030190,-5,1200,4661,40
12355557658,12355557653,-5,1116,3444,40
12358849729,12358849723,-6,769,2793,40
12359411193,12359411186,-7,832,3908,40
12362310874,12362310870,-4,1016,3158,40
12364464842,12364464846,4,2599,1705,40
12366342287,12366342282,-5,848,3135,40
12366572036,12366572022,-14,443,1159,40
12367104759,12367104753,-6,1386,3614,40
12370622930,12370622923,-7,880,3199,40
12372963727,12372963721,-6,798,3569,40
12372994423,12372994406,-17,62,690,40
12374895855,12374895848,-7,1182,3968,40
12385402775,12385402769,-6,828,3383,40
12386479194,12386479188,-6,1125,4033,40
12389427037,12389427033,-4,804,7120,40
12404135582,12404135577,-5,632,1865,40
12409165462,12409165455,-7,1183,4609,40
12409290669,12409290656,-13,707,2762,40
12416037535,12416037529,-6,831,2884,40
12417312637,12417312633,-4,1034,4665,40
12417898667,12417898662,-5,720,2113,40
12420912740,12420912734,-6,765,2710,40
12420965085,12420965064,-21,860,2244,40
12427469266,12427469259,-7,1136,4402,40
12436279547,12436279542,-5,885,2537,40
12441092186,12441092207,21,1390,181,40
12444135182,12444135176,-6,1125,3752,40
12453453908,12453453909,1,537,2191,40
12457705695,12457705689,-6,453,3035,40
12463858249,12463858243,-6,794,4213,40
12464381037,12464381031,-6,287,2164,40
12466177271,12466177251,-20,143,782,40
12473170079,12473170073,-6,1042,4027,40
12473612912,12473612906,-6,938,2994,40
12476744587,12476744582,-5,993,3623,40
12479921369,12479921362,-7,986,3742,40
12480900430,12480900424,-6,1082,3376,40
12483088662,12483088657,-5,1233,3394,40
12502206741,12502206737,-4,967,3020,40
12511357209,12511357204,-5,94,1141,40
12512437892,12512437888,-4,1452,3005,40
12513389524,12513389520,-4,1131,2079,40
12516191517,12516191511,-6,1221,3081,40
12516441669,12516441690,21,183,1111,40
12521531780,12521531776,-4,750,3475,40
12523672734,12523672735,1,1574,1695,40
12523940468,12523940467,-1,1167,2504,40
12525899379,12525899374,-5,811,3955,40
12527109534,12527109529,-5,1093,3914,40
12532004082,12532004077,-5,938,3444,40
12541368441,12541368434,-7,1263,5109,40
12544693674,12544693667,-7,845,3390,40
12551126839,12551126834,-5,1102,3232,40
12551869222,12551869242,20,405,2359,40
12555151542,12555151537,-5,753,3530,40
12558570035,12558570030,-5,658,3883,40
12558880518,12558880534,16,161,1189,40
12574593105,12574593101,-4,1518,4714,40
12575955151,12575955145,-6,1257,4190,40
12577496503,12577496498,-5,1139,4060,40
12584118983,12584118978,-5,867,2804,40
12584466192,12584466210,18,215,913,40
12594397482,12594397477,-5,1107,4109,40
12597070945,12597070939,-6,823,4872,40
12597424762,12597424758,-4,962,3819,40
12601743188,12601743181,-7,745,5103,40
12603071533,12603071538,5,5406,1836,40
12615637250,12615637244,-6,1321,4543,40
12618270221,12618270214,-7,1045,5813,40
12631233397,12631233392,-5,1156,3329,40
12631967004,12631966999,-5,216,1451,40
12636775833,12636775828,-5,1071,3002,40
12639170040,12639170032,-8,1092,4999,40
12642724413,12642724415,2,1379,1074,40
12645382458,12645382451,-7,1005,3499,40
12652500782,12652500776,-6,1095,2876,40
12653335335,12653335324,-11,896,3118,40
12654831358,12654831341,-17,290,2752,40
12663170240,12663170233,-7,732,3763,40
12665774858,12665774853,-5,938,2501,40
12669894650,12669894643,-7,846,3119,40
12669968548,12669968543,-5,780,3991,40
12670004527,12670004522,-5,1221,5279,40
12671650925,12671650926,1,6143,8353,40
12676541963,12676541962,-1,2730,3851,40
12677325291,12677325286,-5,793,3489,40
12678932736,12678932731,-5,838,2706,40
12681440011,12681440018,7,4295,1488,40
12681538610,12681538605,-5,1032,4552,40
12681606408,12681606426,18,420,748,40
12688516557,12688516564,7,15193,14856,40
12689206178,12689206174,-4,754,2337,40
12689596773,12689596786,13,353,2121,40
12692295074,12692295067,-7,1044,3297,40
12694920715,12694920710,-5,1312,3439,40
12699819475,12699819481,6,2079,1157,40
12704504762,12704504757,-5,890,3421,40
12704732350,12704732342,-8,1469,4907,40
12705179114,12705179109,-5,868,3578,40
12705362828,12705362822,-6,1630,6534,40
12706314314,12706314308,-6,893,3345,40
12714028639,12714028633,-6,1364,4870,40
12725034111,12725034105,-6,1254,3608,40
12729788633,12729788626,-7,787,3726,40
12738913819,12738913819,0,1599,1763,40
12742928363,12742928363,0,1251,2023,40
12747728077,12747728073,-4,1218,3678,40
12751686657,12751686656,-1,1590,1397,40
12752308003,12752308003,0,1467,2278,40
12753842925,12753842919,-6,1097,4058,40
12767873426,12767873421,-5,983,4177,40
12770832116,12770832114,-2,139,1154,40
12773091850,12773091844,-6,1128,2862,40
12777931897,12777931891,-6,674,2399,40
12778040928,12778040943,15,336,874,40
12783913393,12783913392,-1,792,1690,40
12785340443,12785340438,-5,1014,4086,40
12787318860,12787318873,13,658,3017,40
12792773925,12792773919,-6,1076,3939,40
12793770488,12793770482,-6,951,3748,40
12795177401,12795177395,-6,1344,4963,40
12795911389,12795911407,18,807,3904,40
12796800011,12796800006,-5,1015,3636,40
12797009990,12797009994,4,1655,1566,40
12799546946,12799546929,-17,975,1992,40
12800315111,12800315114,3,49,1730,40
12802366169,12802366164,-5,825,3349,40
12804314194,12804314187,-7,1158,3607,40
12805974206,12805974198,-8,1145,2956,40
12819835850,12819835843,-7,910,4003,40
12823031702,12823031695,-7,748,3912,40
12823579982,12823579991,9,301,778,40
12825277499,12825277495,-4,1072,3048,40
12825569451,12825569445,-6,1062,4296,40
12835035981,12835035985,4,11651,7282,40
12839161950,12839161945,-5,1514,4488,40
12845480922,12845480917,-5,1096,4018,40
12847494298,12847494292,-6,1190,5526,40
12848084942,12848084935,-7,1237,4330,40
12856709239,12856709231,-8,422,3208,40
12875343109,12875343106,-3,1150,2804,40
12875428958,12875428971,13,600,1858,40
12882871298,12882871290,-8,1135,4495,40
12883500117,12883500130,13,569,1425,40
12884588155,12884588146,-9,910,3659,40
12885264398,12885264415,17,1068,4725,40
12885514553,12885514554,1,2026,2092,40
12888406802,12888406797,-5,1306,4106,40
12890363681,12890363674,-7,1234,2676,40
12891770774,12891770773,-1,1328,2446,40
12892522186,12892522182,-4,1112,3475,40
12893029048,12893029053,5,2120,1226,40
12895061513,12895061506,-7,1172,4548,40
12896973825,12896973829,4,4018,3139,40
12899157421,12899157410,-11,596,3867,40
12900224356,12900224363,7,2437,1588,40
12901541303,12901541309,6,2739,1169,40
12901741242,12901741235,-7,645,1974,40
12902577663,12902577668,5,148,2183,40
12904169975,12904169975,0,1196,1595,40
12905944822,12905944817,-5,1341,4783,40
12909580955,12909580959,4,681,696,40
12911267333,12911267330,-3,1290,2458,40
12915293206,12915293205,-1,2415,2576,40
12921059923,12921059917,-6,904,2500,40
12924908178,12924908170,-8,827,5048,40
12925260856,12925260875,19,338,1124,40
12925778673,12925778666,-7,1028,3607,40
12925920726,12925920705,-21,115,1404,40
12942190307,12942190315,8,124,513,40
12943798941,12943798934,-7,850,3550,40
12943896455,12943896446,-9,163,1053,40
12947712969,12947712964,-5,556,4645,40
12956470077,12956470070,-7,1370,3632,40
12963042987,12963042981,-6,837,3176,40
12973828769,12973828766,-3,1092,2203,40
12974854267,12974854259,-8,1208,3187,40
12975380218,12975380210,-8,852,3380,40
12979245905,12979245898,-7,1239,3491,40
12983191577,12983191579,2,1345,1456,40
12985235926,12985235922,-4,788,1779,40
12986320275,12986320270,-5,1279,5208,40
12988171554,12988171551,-3,1181,1908,40
12993776930,12993776926,-4,1021,3827,40
12995149677,12995149670,-7,1211,4693,40
13020395801,13020395807,6,2400,1899,40
13021378108,13021378103,-5,1286,3703,40
13031363957,13031363950,-7,1999,9448,40
13036050135,13036050134,-1,1869,1384,40
13037123387,13037123380,-7,1023,3696,40
13043550421,13043550418,-3,612,2871,40
13052184510,13052184505,-5,844,3873,40
13053193995,13053193993,-2,2097,4575,40
13058449154,13058449147,-7,859,4533,40
13060880183,13060880178,-5,1490,3252,40
13061542222,13061542243,21,1631,9544,40
13063063278,13063063274,-4,1030,2825,40
13067865459,13067865454,-5,594,2148,40
13072382495,13072382489,-6,1245,5095,40
13075731744,13075731736,-8,879,4133,40
13076911796,13076911811,15,128,591,40
13085572351,13085572346,-5,1015,4130,40
13085903576,13085903588,12,300,1575,40
13091500884,13091500878,-6,834,3933,40
13092673115,13092673108,-7,1169,3674,40
13095608777,13095608770,-7,2133,6893,40
13098906634,13098906628,-6,1004,4814,40
13101861445,13101861438,-7,875,3148,40
13102937200,13102937202,2,334,1148,40
13103422430,13103422423,-7,986,4558,40
13103602598,13103602602,4,187,1255,40
13108094622,13108094602,-20,944,3543,40
13109190437,13109190430,-7,958,2982,40
13111678442,13111678441,-1,148,1034,40
13112550521,13112550513,-8,1239,4323,40
13112761694,13112761679,-15,148,1211,40
13113010982,13113010962,-20,759,3666,40
13114668775,13114668783,8,2137,940,40
13118850897,13118850889,-8,1068,4235,40
13119000420,13119000413,-7,935,3576,40
13120139101,13120139114,13,304,1784,40
13120221837,13120221827,-10,153,1206,40
13123442683,13123442677,-6,1025,3726,40
13123531741,13123531742,1,251,700,40
13126128679,13126128673,-6,975,3876,40
13126760769,13126760764,-5,1087,3312,40
13130662827,13130662830,3,744,796,40
13148405414,13148405407,-7,1442,4647,40
13148470334,13148470343,9,199,2914,40
13149156622,13149156635,13,482,1385,40
13151310195,13151310189,-6,1278,3462,40
13156043599,13156043594,-5,951,4032,40
13156711429,13156711423,-6,906,3044,40
13157826993,13157826985,-8,819,3084,40
13157866182,13157866198,16,340,1123,40
13160455282,13160455290,8,3758,1976,40
13160693341,13160693336,-5,1026,2513,40
13161477832,13161477843,11,874,3107,40
13165260144,13165260139,-5,807,2044,40
13167043983,13167043978,-5,656,3666,40
13167879589,13167879602,13,262,1392,40
13172997891,13172997886,-5,930,2443,40
13173417573,13173417566,-7,793,4300,40
13173947280,13173947282,2,90,791,40
13175953326,13175953319,-7,720,3775,40
13177292787,13177292785,-2,1504,2723,40
13177695519,13177695511,-8,1083,4967,40
13183055762,13183055757,-5,373,1832,40
13188627130,13188627127,-3,1441,1869,40
13190334800,13190334794,-6,898,2719,40
13192421438,13192421431,-7,608,2099,40
13196366466,13196366463,-3,1183,2481,40
13197714934,13197714926,-8,1253,4106,40
13203504229,13203504225,-4,1222,3889,40
13205431084,13205431078,-6,735,3538,40
13208320282,13208320277,-5,1131,4996,40
13211719450,13211719445,-5,1117,3852,40
13212244159,13212244159,0,136,1121,40
13213090330,13213090326,-4,806,2958,40
13213752203,13213752198,-5,931,3199,40
13219858174,13219858169,-5,919,3125,40
13226894269,13226894270,1,1522,1379,40
13228678654,13228678647,-7,1170,4373,40
13229141198,13229141193,-5,1068,4044,40
13234969207,13234969221,14,78,1886,40
13236276880,13236276875,-5,1167,3699,40
13241726527,13241726522,-5,849,3491,40
13243997787,13243997781,-6,1247,5298,40
13247751469,13247751464,-5,1178,4312,40
13248083514,13248083508,-6,1139,3844,40
13248654534,13248654529,-5,851,3549,40
13249725995,13249725990,-5,1152,3413,40
13250484895,13250484887,-8,286,1442,40
13258974902,13258974903,1,16,5023,40
13273218869,13273218865,-4,747,2506,40
13275696005,13275695999,-6,630,2400,40
13276060688,13276060705,17,474,2499,40
13279810755,13279810750,-5,739,3120,40
13280083508,13280083527,19,1350,3893,40
13282129490,13282129485,-5,1090,3236,40
13283799819,13283799834,15,15124,42034,40
13286117790,13286117785,-5,1458,3843,40
13296500401,13296500398,-3,370,991,40
13308141271,13308141269,-2,826,1850,40
13308765949,13308765945,-4,761,2294,40
13310237979,13310237974,-5,1345,3806,40
13310732377,13310732373,-4,892,3183,40
13314146973,13314146970,-3,1123,1511,40
13315986723,13315986717,-6,1245,4663,40
13317619082,13317619077,-5,2499,5671,40
13317948908,13317948901,-7,966,4118,40
13318794006,13318794000,-6,1076,3136,40
13319828136,13319828131,-5,955,3016,40
13328192493,13328192487,-6,727,4036,40
13330759827,13330759842,15,12290,44208,40
13334152726,13334152722,-4,729,3306,40
13336675599,13336675593,-6,935,3653,40
13337081487,13337081486,-1,1781,1549,40
13342816660,13342816657,-3,990,2922,40
13354355903,13354355906,3,1386,1676,40
13356064749,13356064749,0,1477,1205,40
13357655444,13357655450,6,4142,1630,40
13363357589,13363357585,-4,862,2410,40
13366260095,13366260091,-4,663,2558,40
13367502354,13367502346,-8,1066,5059,40
13371657721,13371657702,-19,124,1036,40
13375023062,13375023057,-5,550,2753,40
13385230072,13385230065,-7,1284,4218,40
13389982654,13389982659,5,3453,1494,40
13390769146,13390769142,-4,358,1746,40
13391678109,13391678102,-7,894,6159,40
13391969974,13391969985,11,289,1581,40
13393314329,13393314335,6,3612,1954,40
13403815446,13403815441,-5,1273,3690,40
13409139094,13409139089,-5,1546,3904,40
13410980279,13410980273,-6,974,4237,40
13411576831,13411576826,-5,883,2863,40
13414622042,13414622037,-5,1248,3873,40
13418238873,13418238871,-2,915,2415,40
13418603308,13418603318,10,456,2338,40
13426203853,13426203849,-4,896,4842,40
13426614674,13426614667,-7,1148,3362,40
13428974822,13428974818,-4,986,3024,40
13431470053,13431470049,-4,1101,3404,40
13431531484,13431531480,-4,835,1834,40
13444301214,13444301210,-4,754,3424,40
13447297615,13447297634,19,392,2483,40
13449737470,13449737467,-3,1253,3638,40
13450776740,13450776750,10,230,1723,40
13451716375,13451716394,19,284,1166,40
13455750632,13455750626,-6,784,3216,40
13457116355,13457116349,-6,546,1426,40
13462795537,13462795531,-6,1441,4474,40
13463965695,13463965689,-6,981,3300,40
13471118866,13471118858,-8,669,3530,40
13471327830,13471327838,8,156,1741,40
13475252201,13475252198,-3,1353,2983,40
13476278224,13476278217,-7,1146,4402,40
13479555586,13479555581,-5,1502,3792,40
13479966307,13479966299,-8,1397,4444,40
13480279234,13480279229,-5,692,2472,40
13480733717,13480733737,20,528,4474,40
13481724559,13481724553,-6,1065,4638,40
13484508108,13484508100,-8,1255,4474,40
13488014096,13488014090,-6,989,2835,40
13488533266,13488533261,-5,1494,3472,40
13491592451,13491592445,-6,1189,4768,40
13493361250,13493361245,-5,873,3049,40
13493799606,13493799615,9,132,1664,40
13494597780,13494597763,-17,328,1203,40
13498906142,13498906139,-3,628,1173,40
13500309642,13500309636,-6,466,1509,40
13507166346,13507166339,-7,867,3327,40
13507260876,13507260869,-7,562,1661,40
13508829303,13508829316,13,372,1659,40
13510230511,13510230519,8,309,1690,40
13510427035,13510427026,-9,1047,3769,40
13512331223,13512331218,-5,919,3599,40
13512880412,13512880394,-18,1296,4546,40
13512931129,13512931123,-6,613,2815,40
13514290866,13514290862,-4,1171,5292,40
13518983388,13518983382,-6,859,3017,40
13520152022,13520152035,13,908,4348,40
13521025882,13521025874,-8,1036,3171,40
13531982609,13531982602,-7,1122,3651,40
13532999614,13532999614,0,2054,2412,40
13535034298,13535034297,-1,1346,2265,40
13543989114,13543989106,-8,943,5713,40
13554684340,13554684334,-6,1262,7529,40
13565700255,13565700249,-6,1238,3574,40
13565842548,13565842554,6,247,1898,40
13566741965,13566741960,-5,1101,4415,40
13567997389,13567997385,-4,1075,3616,40
13568303171,13568303165,-6,751,4132,40
13572415254,13572415247,-7,1139,3083,40
13573816007,13573816001,-6,943,3845,40
13577365511,13577365505,-6,907,2979,40
13580437483,13580437477,-6,862,2758,40
13582341047,13582341040,-7,1038,4975,40
13582746188,13582746211,23,381,1593,40
13585066066,13585066061,-5,835,3647,40
13585442743,13585442729,-14,1073,5239,40
13585998597,13585998604,7,2691,1493,40
13596798845,13596798838,-7,1100,4966,40
13598791636,13598791659,23,946,2241,40
13602190506,13602190505,-1,3138,4226,40
13604826269,13604826286,17,533,2299,40
13607805908,13607805902,-6,760,3193,40
13607907696,13607907707,11,785,2567,40
13609621425,13609621418,-7,992,4217,40
13616603843,13616603839,-4,989,3035,40
13622678683,13622678677,-6,807,3821,40
13626746769,13626746762,-7,1042,4357,40
13628386198,13628386193,-5,943,3216,40
13633198863,13633198858,-5,817,3740,40
13634644450,13634644446,-4,658,2139,40
13639688633,13639688628,-5,1439,5921,40
13640421996,13640422013,17,565,3219,40
13655670438,13655670439,1,1719,1337,40
13665063127,13665063122,-5,732,3334,40
13666269437,13666269433,-4,92,1289,40
13666687782,13666687797,15,485,1777,40
13677062835,13677062827,-8,900,5460,40
13683257486,13683257482,-4,691,2499,40
13693257056,13693257050,-6,1143,4297,40
13694819325,13694819318,-7,1168,5621,40
13697568566,13697568561,-5,674,4313,40
13706095266,13706095260,-6,874,3753,40
13710042713,13710042709,-4,950,3841,40
13711238535,13711238530,-5,1311,2957,40
13714123929,13714123924,-5,992,2925,40
13714172154,13714172158,4,1661,1542,40
13716854769,13716854763,-6,1080,2778,40
13717007670,13717007654,-16,105,799,40
13720777241,13720777236,-5,1081,4177,40
13721244363,13721244357,-6,1365,5050,40
13727247151,13727247154,3,34550,28218,40
13729582691,13729582681,-10,1094,4580,40
13731309209,13731309204,-5,1679,4971,40
13736975002,13736975001,-1,1527,2358,40
13739305058,13739305053,-5,1081,3461,40
13741997156,13741997144,-12,2142,872,40
13742278522,13742278518,-4,936,2838,40
13742307438,13742307444,6,180,984,40
13742591998,13742591990,-8,1054,4791,40
13754310223,13754310219,-4,1194,3600,40
13757306313,13757306319,6,8603,3399,40
13769013952,13769013957,5,3898,2432,40
13776920466,13776920459,-7,1062,2629,40
13783096355,13783096349,-6,784,2344,40
13791131675,13791131668,-7,938,3315,40
13792206986,13792206980,-6,1453,5793,40
13792400013,13792400010,-3,70,1212,40
13792698956,13792698979,23,360,945,40
13793378149,13793378143,-6,946,2967,40
13795073972,13795073966,-6,1195,2751,40
13795617667,13795617670,3,2705,2652,40
13799561050,13799561044,-6,998,3780,40
13799658126,13799658141,15,1135,4449,40
13799816395,13799816390,-5,887,2007,40
13801639982,13801639976,-6,836,2851,40
13802100710,13802100723,13,152,1200,40
13802895623,13802895641,18,326,1229,40
13807046098,13807046094,-4,1252,4625,40
13810002775,13810002770,-5,848,4096,40
13815727915,13815727909,-6,1221,3178,40
13819211915,13819211907,-8,220,1849,40
13823310726,13823310725,-1,938,1683,40
13824179935,13824179954,19,416,1943,40
13835926567,13835926573,6,5900,2488,40
13840906152,13840906147,-5,802,2655,40
13848289774,13848289766,-8,672,2930,40
13856252866,13856252861,-5,980,2804,40
13863347179,13863347173,-6,1708,5741,40
13863728561,13863728554,-7,831,3462,40
13864962374,13864962362,-12,283,821,40
13873656110,13873656105,-5,802,3329,40
13878512553,13878512546,-7,1237,3910,40
13882916068,13882916075,7,2115,37111,40
13885172671,13885172672,1,1247,1633,40
13891367062,13891367055,-7,608,2895,40
13891416250,13891416246,-4,1290,3276,40
13892282133,13892282129,-4,1013,2474,40
13893312971,13893312965,-6,1034,4580,40
13894338226,13894338221,-5,780,3177,40
13901132746,13901132739,-7,1065,2699,40
13903795075,13903795075,0,1556,2586,40
13904953974,13904953969,-5,867,3641,40
13905321199,13905321210,11,118,1304,40
13914239256,13914239250,-6,855,2871,40
13917391751,13917391746,-5,743,2727,40
13921539405,13921539399,-6,1088,4826,40
13921888726,13921888706,-20,1468,4355,40
13924585763,13924585757,-6,1063,2806,40
13926616998,13926616992,-6,985,3223,40
13929608761,13929608755,-6,951,3677,40
13931829824,13931829820,-4,1106,2735,40
13932754853,13932754834,-19,225,1028,40
13941343357,13941343352,-5,1076,2970,40
13952184439,13952184432,-7,1145,5980,40
13952782251,13952782245,-6,854,3161,40
13958919977,13958919982,5,2544,1264,40
13959812776,13959812769,-7,679,3190,40
13960359373,13960359359,-14,162,1097,40
13963135230,13963135225,-5,1260,3406,40
13970144850,13970144845,-5,1328,4355,40
13971217454,13971217447,-7,1435,5951,40
13975124682,13975124674,-8,792,3341,40
13978329891,13978329886,-5,1093,3732,40
13981375757,13981375749,-8,1563,5773,40
13982304498,13982304495,-3,678,3887,40
13982620189,13982620188,-1,363,1968,40
13986069406,13986069401,-5,909,3317,40
13989117385,13989117381,-4,901,3328,40
13991924601,13991924601,0,601,439,40
14000712497,14000712492,-5,1106,2320,40
14003073277,14003073273,-4,1372,2755,40
14004774803,14004774798,-5,1221,3013,40
14009856543,14009856541,-2,1331,2792,40
14010308679,14010308658,-21,1429,4072,40
14016255190,14016255191,1,11239,11090,40
14017900631,14017900625,-6,741,3990,40
14019016304,14019016299,-5,881,3865,40
14021226534,14021226529,-5,804,3737,40
14021819795,14021819790,-5,759,1983,40
14022806357,14022806345,-12,137,1382,40
14025655379,14025655376,-3,994,2024,40
14026670366,14026670359,-7,1198,4394,40
14039069314,14039069309,-5,841,3757,40
14040276887,14040276880,-7,430,2713,40
14041348576,14041348569,-7,908,3285,40
14042481062,14042481057,-5,24,786,40
14043527397,14043527392,-5,890,3601,40
14046852239,14046852239,0,1463,2087,40
14058551394,14058551389,-5,960,3716,40
14059925653,14059925673,20,1520,3389,40
14065301682,14065301683,1,1214,1296,40
14070290362,14070290354,-8,836,1758,40
14076868361,14076868356,-5,1102,3715,40
14078664927,14078664926,-1,1766,3145,40
14081128499,14081128494,-5,962,3613,40
14081204992,14081204993,1,12874,12644,40
14084028063,14084028060,-3,879,3485,40
14085559927,14085559920,-7,748,3459,40
14086814235,14086814229,-6,1152,3473,40
14092333618,14092333625,7,3247,1346,40
14092671868,14092671862,-6,1463,3147,40
14095337554,14095337549,-5,1197,4928,40
14095410629,14095410629,0,83,1518,40
14096461320,14096461314,-6,1380,2897,40
14097678139,14097678133,-6,960,2775,40
14097710270,14097710286,16,241,1096,40
14098177507,14098177484,-23,1014,599,40
14106340807,14106340800,-7,1231,3180,40
14106815357,14106815342,-15,73,1556,40
14106948054,14106948067,13,844,3138,40
14120915871,14120915865,-6,1000,5160,40
14122518502,14122518495,-7,453,2075,40
14128285275,14128285280,5,2581,1938,40
14134260912,14134260917,5,2064,1271,40
14138537507,14138537500,-7,910,3719,40
14139025494,14139025508,14,325,2397,40
14143414343,14143414339,-4,919,2811,40
14144232062,14144232058,-4,1376,3506,40
14144817234,14144817229,-5,1212,3700,40
14145610933,14145610950,17,426,2050,40
14148973309,14148973329,20,349,1642,40
14149428239,14149428237,-2,878,1590,40
14151915497,14151915493,-4,985,2663,40
14152152061,14152152053,-8,90,1150,40
14170822077,14170822074,-3,1185,2646,40
14174056364,14174056348,-16,830,4564,40
14174333685,14174333706,21,1622,1469,40
14179004730,14179004725,-5,1160,3549,40
14186362888,14186362882,-6,2750,7956,40
14191775090,14191775096,6,4566,2450,40
14192340790,14192340798,8,12807,32728,40
14194567076,14194567082,6,3754,2015,40
14199021711,14199021705,-6,813,2571,40
14201420047,14201420037,-10,752,3230,40
14204999487,14204999480,-7,768,3633,40
14205622310,14205622300,-10,65,1105,40
14214356434,14214356428,-6,1101,3643,40
14218135357,14218135352,-5,901,2346,40
14223119839,14223119834,-5,1025,4026,40
14223332045,14223332052,7,4349,1725,40
14224687967,14224687962,-5,1129,2487,40
14226999141,14226999147,6,4731,1886,40
14228254933,14228254926,-7,1095,3265,40
14229844294,14229844290,-4,598,2763,40
14238115182,14238115178,-4,1222,2622,40
14238446515,14238446511,-4,1213,2839,40
14240847410,14240847417,7,3216,1735,40
14243716422,14243716425,3,6873,4996,40
14246305207,14246305202,-5,1499,4437,40
14247939282,14247939275,-7,1171,3966,40
14250347736,14250347734,-2,1939,2902,40
14251649861,14251649869,8,7186,1486,40
14253118706,14253118699,-7,845,3006,40
14253913656,14253913667,11,589,2793,40
14254146256,14254146250,-6,1359,4911,40
14256083577,14256083574,-3,22517,15169,40
14257922708,14257922714,6,3669,1981,40
14264161841,14264161837,-4,884,3212,40
14264361496,14264361498,2,164,941,40
14264847374,14264847389,15,604,3545,40
14276647444,14276647449,5,2347,1137,40
14297858529,14297858525,-4,871,3802,40
14300912034,14300912033,-1,1783,2707,40
14304690122,14304690116,-6,759,2732,40
14308254646,14308254641,-5,1153,5462,40
14334345639,14334345634,-5,1194,3337,40
14336707383,14336707403,20,1634,1799,40
14337619768,14337619762,-6,1062,3000,40
14337691357,14337691362,5,50,1147,40
14338236999,14338236985,-14,217,909,40
14338648311,14338648304,-7,1232,2789,40
14338841199,14338841208,9,422,1833,40
14340295931,14340295925,-6,1150,4605,40
14341105612,14341105632,20,863,4080,40
14343962389,14343962383,-6,1053,3148,40
14346946503,14346946497,-6,1392,3924,40
14348131260,14348131275,15,71,1276,40
14350505533,14350505526,-7,628,1991,40
14355751853,14355751861,8,7845,3237,40
14356316526,14356316522,-4,1692,7105,40
14361683912,14361683893,-19,351,1411,40
14362041187,14362041182,-5,887,4168,40
14368006819,14368006814,-5,823,4317,40
14371358593,14371358586,-7,1203,3617,40
14371434023,14371434009,-14,145,1511,40
14376089701,14376089695,-6,691,7210,40
14379437816,14379437810,-6,1170,3211,40
14385758191,14385758183,-8,1033,4232,40
14394880785,14394880778,-7,923,4160,40
14399755571,14399755564,-7,1194,3748,40
14404459350,14404459345,-5,928,2267,40
14409153431,14409153425,-6,1260,3573,40
14416510017,14416510023,6,3000,1257,40
14420172575,14420172569,-6,974,2436,40
14420481250,14420481246,-4,732,2657,40
14423454077,14423454075,-2,772,237,40
14425002055,14425002049,-6,1076,4591,40
14426362436,14426362429,-7,1231,4136,40
14426757549,14426757530,-19,981,3107,40
14427567207,14427567201,-6,958,3486,40
14427675806,14427675825,19,717,3809,40
14431425790,14431425785,-5,992,3777,40
14436811574,14436811569,-5,1285,2784,40
14438727493,14438727487,-6,1442,4613,40
14439875606,14439875601,-5,1178,3600,40
14448936002,14448935996,-6,1068,3402,40
14449770120,14449770134,14,177,1781,40
14451306551,14451306543,-8,892,2647,40
14457904559,14457904551,-8,1010,3559,40
14460939811,14460939805,-6,807,4927,40
14460992100,14460992111,11,65,862,40
14462823142,14462823133,-9,920,2999,40
14467387152,14467387158,6,4123,1519,40
14467673401,14467673400,-1,3198,4483,40
14468180857,14468180850,-7,760,3366,40
14468208189,14468208181,-8,203,1290,40
14470734009,14470734003,-6,1171,4989,40
14471294225,14471294219,-6,886,2172,40
14474653454,14474653454,0,2894,3898,40
14477886801,14477886795,-6,1288,3867,40
14479948395,14479948400,5,9136,30132,40
14481248731,14481248735,4,2204,1194,40
14483401509,14483401504,-5,865,4026,40
14484592023,14484592017,-6,1527,2861,40
14487183866,14487183859,-7,1018,2998,40
14487620255,14487620270,15,401,1411,40
14488222162,14488222162,0,1306,1979,40
14496512691,14496512684,-7,636,2948,40
14500691770,14500691762,-8,880,5439,40
14501792339,14501792334,-5,897,2407,40
14502348916,14502348906,-10,144,1101,40
14503907594,14503907613,19,964,3753,40
14506372382,14506372378,-4,738,2458,40
14512926428,14512926418,-10,1035,4021,40
14519203785,14519203778,-7,1166,3752,40
14523014821,14523014815,-6,686,3400,40
14527408098,14527408092,-6,1601,4660,40
14527887537,14527887542,5,2502,1374,40
14531971053,14531971053,0,3203,15636,40
14538059513,14538059507,-6,1090,4857,40
14539649534,14539649546,12,283,1244,40
14539793949,14539793953,4,95,620,40
14540528470,14540528485,15,1057,3829,40
14541120599,14541120592,-7,1101,3480,40
14541440448,14541440459,11,753,4441,40
14543206450,14543206442,-8,845,3051,40
14549251269,14549251275,6,3133,1843,40
14552232675,14552232668,-7,639,2748,40
14554048275,14554048268,-7,1073,2858,40
14555160869,14555160865,-4,783,1976,40
14556328517,14556328511,-6,973,4411,40
14556429869,14556429884,15,940,4051,40
14561955727,14561955721,-6,733,2776,40
14569663767,14569663763,-4,906,1876,40
14575809040,14575809039,-1,863,1360,40
14578816984,14578816979,-5,1523,3558,40
14580128034,14580128027,-7,1429,3654,40
14600458591,14600458586,-5,940,3232,40
14601804322,14601804318,-4,694,3805,40
14601999988,14601999993,5,4918,2051,40
14606276871,14606276865,-6,804,4477,40
14608206936,14608206941,5,2748,1888,40
14609874931,14609874925,-6,1167,3052,40
14609941695,14609941693,-2,1164,1905,40
14612669688,14612669681,-7,747,2195,40
14615721663,14615721656,-7,974,3546,40
14616227846,14616227862,16,962,3548,40
14617116816,14617116810,-6,1452,4393,40
14627354668,14627354665,-3,919,2184,40
14632117463,14632117457,-6,990,3728,40
14632154590,14632154571,-19,154,833,40
14638376226,14638376220,-6,787,5814,40
14639998589,14639998605,16,1375,1261,40
14644920657,14644920650,-7,990,3895,40
14645658999,14645658995,-4,778,1792,40
14649343929,14649343923,-6,1107,3770,40
14655954987,14655954981,-6,824,4389,40
14659557962,14659557957,-5,818,3410,40
14665121790,14665121783,-7,1017,3313,40
14672577441,14672577446,5,1935,1169,40
14679114282,14679114277,-5,932,4111,40
14688873420,14688873414,-6,1376,4038,40
14703355187,14703355184,-3,680,2453,40
14703862706,14703862711,5,2660,1701,40
14705338674,14705338668,-6,925,2575,40
14706715859,14706715858,-1,1414,1406,40
14726098462,14726098456,-6,627,3696,40
14730755362,14730755358,-4,21437,10504,40
14731739630,14731739625,-5,696,3092,40
14735769635,14735769639,4,1210,1188,40
14738754816,14738754809,-7,992,4439,40
14742419094,14742419090,-4,1079,3183,40
14742528681,14742528674,-7,879,3659,40
14743020800,14743020819,19,306,884,40
14743575117,14743575111,-6,870,3660,40
14744228278,14744228264,-14,251,1668,40
14744312016,14744312026,10,82,759,40
14745931949,14745931944,-5,967,2682,40
14746090105,14746090111,6,1438,955,40
14753317723,14753317722,-1,1028,1841,40
14753725309,14753725325,16,823,3622,40
14767103261,14767103255,-6,901,3924,40
14767287509,14767287525,16,167,1455,40
14772614551,14772614542,-9,500,1779,40
14782320168,14782320163,-5,1271,3584,40
14782494333,14782494319,-14,113,1319,40
14782923454,14782923475,21,205,855,40
14783945619,14783945614,-5,1002,3844,40
14788747215,14788747208,-7,899,3786,40
14789095746,14789095754,8,10742,37788,40
14789392557,14789392541,-16,64,1083,40
14795723109,14795723115,6,2684,1536,40
14796669483,14796669477,-6,927,4147,40
14797385670,14797385665,-5,983,3591,40
14802154694,14802154690,-4,2194,5223,40
14808076093,14808076094,1,1096,1862,40
14810693466,14810693462,-4,1027,3109,40
14810883954,14810883949,-5,926,3167,40
14811024901,14811024907,6,192,986,40
14819569653,14819569647,-6,693,3210,40
14821287302,14821287295,-7,1067,3801,40
14824989682,14824989676,-6,1170,3810,40
14827365646,14827365641,-5,907,2926,40
14828514990,14828514994,4,1515,1750,40
14830035432,14830035426,-6,1061,3244,40
14837092927,14837092924,-3,702,2229,40
14842019734,14842019729,-5,1072,2484,40
14851619168,14851619162,-6,896,3936,40
14851649048,14851649066,18,430,2441,40
14852459355,14852459351,-4,437,2277,40
14853144384,14853144394,10,144,929,40
14855353803,14855353798,-5,684,2347,40
14861068312,14861068306,-6,864,2102,40
14861559373,14861559362,-11,275,1127,40
14869922695,14869922689,-6,1197,3847,40
14878586808,14878586809,1,189,1668,40
14879897826,14879897822,-4,956,1846,40
14880348710,14880348726,16,548,2245,40
14883301748,14883301741,-7,835,5120,40
14888156121,14888156117,-4,673,2980,40
14888855919,14888855910,-9,928,3340,40
14900281354,14900281350,-4,983,2494,40
14903830434,14903830429,-5,1111,2656,40
14906287906,14906287903,-3,1123,3421,40
14906400739,14906400746,7,3211,1302,40
14907592986,14907592981,-5,1025,3057,40
14907921999,14907922018,19,892,3569,40
14919601154,14919601161,7,2700,1580,40
14920534338,14920534333,-5,1290,4921,40
14921997268,14921997263,-5,911,3156,40
14926497567,14926497562,-5,666,3374,40
14927558101,14927558118,17,339,785,40
14928257606,14928257602,-4,1017,2699,40
14930419963,14930419958,-5,1066,3239,40
14937775621,14937775630,9,208,1470,40
14952275047,14952275038,-9,735,4787,40
14963284116,14963284104,-12,2861,1646,40
14963924430,14963924434,4,1625,1316,40
14964643314,14964643313,-1,2846,3831,40
14965291393,14965291389,-4,877,3271,40
14977630072,14977630067,-5,1133,3274,40
14979480162,14979480157,-5,972,3971,40
14979613709,14979613704,-5,1083,2815,40
14979882772,14979882795,23,258,1003,40
14983995447,14983995441,-6,814,3415,40
14986552531,14986552531,0,1879,2131,40
14987554661,14987554654,-7,957,4820,40
14990198889,14990198883,-6,774,2915,40
14991475025,14991475019,-6,814,2066,40
14994951238,14994951230,-8,1140,4470,40
14995710860,14995710847,-13,356,752,40
15002681362,15002681365,3,7818,26569,40
15006286139,15006286133,-6,845,3581,40
15006412014,15006412033,19,101,802,40
15008538709,15008538702,-7,661,4112,40
15014918202,15014918195,-7,1229,3803,40
15020400226,15020400221,-5,1049,4011,40
15030393493,15030393501,8,3171,803,40
15033019331,15033019322,-9,1020,3687,40
15033094088,15033094082,-6,739,4644,40
15033851814,15033851810,-4,714,1757,40
15034103118,15034103138,20,709,3315,40
15039685066,15039685061,-5,887,3268,40
15044408693,15044408686,-7,1038,3653,40
15044541774,15044541794,20,221,2233,40
15049175063,15049175062,-1,1851,3317,40
15053230462,15053230457,-5,943,3175,40
15066515414,15066515409,-5,1092,4053,40
15069004954,15069004946,-8,789,3293,40
15078988613,15078988609,-4,686,1547,40
15082239377,15082239379,2,1683,1966,40
15082275411,15082275419,8,3004,1484,40
15084052329,15084052322,-7,765,4635,40
15084646252,15084646240,-12,336,1684,40
15085417733,15085417745,12,628,2612,40
15093549341,15093549340,-1,1106,1540,40
15096526386,15096526386,0,1091,2372,40
15107570385,15107570386,1,2620,2142,40
15126808030,15126808025,-5,853,2706,40
15127029431,15127029428,-3,1042,1778,40
15129490708,15129490705,-3,1605,2252,40
15130499010,15130499030,20,95,1323,40
15131120886,15131120880,-6,894,3304,40
15137733363,15137733355,-8,1146,4390,40
15138372664,15138372666,2,1963,1827,40
15141017031,15141017023,-8,1085,3513,40
15141796814,15141796808,-6,1210,4171,40
15143885945,15143885949,4,4619,1562,40
15144863862,15144863867,5,1986,1203,40
15157319729,15157319724,-5,528,2169,40
15157887255,15157887258,3,1021,1404,40
15158174077,15158174090,13,839,3918,40
15160983561,15160983557,-4,993,3089,40
15161980507,15161980502,-5,1177,3477,40
15164326301,15164326295,-6,918,3466,40
15186874699,15186874693,-6,1343,4955,40
15191490973,15191490968,-5,1198,3517,40
15191708535,15191708514,-21,984,3459,40
15191806236,15191806259,23,623,1668,40
15195675634,15195675630,-4,1258,2923,40
15212416143,15212416138,-5,960,3356,40
15214502393,15214502386,-7,1849,7403,40
15215895138,15215895134,-4,740,2939,40
15216717605,15216717598,-7,1138,4482,40
15217975421,15217975414,-7,291,973,40
15228534161,15228534155,-6,1225,4128,40
15228672526,15228672522,-4,853,2694,40
15234374281,15234374274,-7,1827,4828,40
15238130573,15238130567,-6,1244,4846,40
15239849036,15239849032,-4,1494,3712,40
15240278375,15240278389,14,663,4614,40
15244649018,15244649013,-5,916,3287,40
15245326367,15245326385,18,101,1554,40
15250500637,15250500641,4,4181,2063,40
15251885789,15251885791,2,4213,3731,40
15260117020,15260117013,-7,1123,3093,40
15265660822,15265660818,-4,885,3573,40
15266902470,15266902464,-6,875,3578,40
15267484096,15267484090,-6,834,4229,40
15268076440,15268076459,19,356,1041,40
15271749178,15271749171,-7,1031,4594,40
15272483078,15272483087,9,3650,1248,40
15272511691,15272511682,-9,1015,4265,40
15278648066,15278648072,6,1981,1057,40
15284563065,15284563061,-4,939,3075,40
15288829379,15288829371,-8,1326,3678,40
15293790183,15293790176,-7,1220,4488,40
15294417407,15294417404,-3,968,3754,40
15296701694,15296701697,3,1265,1051,40
15298308286,15298308280,-6,1050,5125,40
15301411580,15301411573,-7,1051,3297,40
15302617070,15302617065,-5,686,3437,40
15306462651,15306462645,-6,1159,2210,40
15312783804,15312783798,-6,1065,5339,40
15322909291,15322909285,-6,1307,5360,40
15323592226,15323592234,8,3743,1543,40
15329353316,15329353310,-6,810,2179,40
15329778909,15329778899,-10,167,1086,40
15330105830,15330105824,-6,1757,4759,40
15334429059,15334429054,-5,1130,3838,40
15338527193,15338527186,-7,1408,3374,40
15349926962,15349926954,-8,1132,3512,40
15354969162,15354969159,-3,1255,1826,40
15355468959,15355468978,19,816,2126,40
15355657465,15355657470,5,5535,27723,40
15355794610,15355794605,-5,951,3164,40
15357115111,15357115124,13,499,3093,40
15360530921,15360530916,-5,806,2809,40
15367721029,15367721039,10,259,934,40
15370883725,15370883711,-14,1321,777,40
15373222730,15373222739,9,4995,1188,40
15373425202,15373425197,-5,540,2643,40
15374354501,15374354517,16,377,1501,40
15377455138,15377455133,-5,1141,3427,40
15385171165,15385171158,-7,790,3071,40
15388519189,15388519181,-8,1262,5753,40
15388791853,15388791854,1,198,964,40
15389774391,15389774390,-1,185,1538,40
15391223175,15391223169,-6,828,4319,40
15391258154,15391258148,-6,789,3279,40
15400045694,15400045686,-8,1021,3518,40
15403581472,15403581465,-7,653,3653,40
15405624355,15405624367,12,551,2034,40
15406470097,15406470105,8,13281,34577,40
15406787591,15406787589,-2,1155,2063,40
15407361212,15407361205,-7,1079,4513,40
15409352811,15409352802,-9,559,2512,40
15428478202,15428478198,-4,1094,2884,40
15429233955,15429233947,-8,839,4635,40
15429531333,15429531334,1,270,1116,40
15436126146,15436126141,-5,520,2534,40
15440929746,15440929740,-6,922,4560,40
15441914196,15441914214,18,223,1075,40
15443358877,15443358872,-5,255,1585,40
15446912038,15446912035,-3,1125,2616,40
15451969587,15451969581,-6,1072,2855,40
15452875658,15452875653,-5,1302,3471,40
15458027471,15458027465,-6,703,2571,40
15459018175,15459018170,-5,728,3305,40
15461541352,15461541344,-8,838,2632,40
15463987182,15463987178,-4,754,3876,40
15471297503,15471297497,-6,722,4910,40
15477170013,15477170007,-6,1331,3648,40
15479310314,15479310308,-6,933,2505,40
15481140286,15481140281,-5,724,2270,40
15491778152,15491778145,-7,611,3434,40
15493185535,15493185525,-10,891,3033,40
15494738298,15494738298,0,721,953,40
15495870942,15495870935,-7,968,5663,40
15496067766,15496067771,5,3421,1431,40
15501467474,15501467473,-1,1210,1714,40
15502375703,15502375706,3,128,892,40
15505953222,15505953217,-5,1648,4877,40
15509257106,15509257100,-6,826,2740,40
15510173732,15510173748,16,842,3592,40
15510800057,15510800050,-7,1141,3142,40
15519078011,15519078005,-6,977,3776,40
15519245158,15519245154,-4,1368,4722,40
15520825178,15520825180,2,200,1573,40
15521375932,15521375914,-18,105,936,40
15523276613,15523276610,-3,1189,1747,40
15523435516,15523435509,-7,1346,4347,40
15529787008,15529787001,-7,885,3678,40
15535383313,15535383306,-7,1139,3785,40
15536170582,15536170562,-20,275,1385,40
15536520862,15536520854,-8,1075,3902,40
15542798255,15542798257,2,2364,2762,40
15546136339,15546136333,-6,829,3835,40
15559418826,15559418806,-20,828,2615,40
15564065770,15564065765,-5,1017,4674,40
15565632230,15565632226,-4,1222,4288,40
15566147341,15566147335,-6,149,1137,40
15569492531,15569492524,-7,1014,3532,40
15569698971,15569698966,-5,871,3301,40
15569767917,15569767902,-15,378,1380,40
15580655894,15580655888,-6,1472,3246,40
15580925751,15580925746,-5,1452,4689,40
15585287781,15585287775,-6,1185,2876,40
15595627703,15595627706,3,1589,1279,40
15596341122,15596341117,-5,1017,3641,40
15602452407,15602452402,-5,954,3342,40
15604730649,15604730642,-7,583,2695,40
15618383112,15618383129,17,660,2240,40
15621531055,15621531050,-5,993,3805,40
15623105488,15623105482,-6,1186,3263,40
15624447989,15624447986,-3,727,2276,40
15626001722,15626001716,-6,528,2056,40
15627276730,15627276725,-5,780,2327,40
15627748302,15627748306,4,2706,1975,40
15629426257,15629426252,-5,873,2883,40
15631431262,15631431255,-7,818,3411,40
15637570427,15637570422,-5,819,2777,40
15640605181,15640605177,-4,1592,3635,40
15649317055,15649317050,-5,993,2419,40
15652842774,15652842777,3,3459,3072,40
15661978659,15661978654,-5,1450,3998,40
15663188223,15663188214,-9,1193,2829,40
15666477323,15666477318,-5,890,2291,40
15674537618,15674537612,-6,1723,4612,40
15675782538,15675782533,-5,1253,3712,40
15676100320,15676100313,-7,731,3797,40
15681638633,15681638625,-8,826,3659,40
15693698299,15693698294,-5,1121,3966,40
15694081454,15694081432,-22,52,886,40
15694475174,15694475168,-6,1707,4391,40
15694620806,15694620801,-5,715,3661,40
15695683310,15695683305,-5,1183,4697,40
15698040170,15698040182,12,258,1594,40
15699527347,15699527342,-5,693,2657,40
15703996034,15703996028,-6,850,4457,40
15711400809,15711400804,-5,1137,3800,40
15713267253,15713267246,-7,542,4536,40
15714212781,15714212801,20,974,3366,40
15726224130,15726224123,-7,982,3696,40
15730010914,15730010918,4,2102,1142,40
15733009701,15733009696,-5,867,3068,40
15734041811,15734041808,-3,1394,2438,40
15744077187,15744077179,-8,1020,4000,40
15744160343,15744160342,-1,193,980,40
15746075503,15746075498,-5,570,4579,40
15749655298,15749655295,-3,17305,26337,40
15759644906,15759644899,-7,1146,3616,40
15768102042,15768102037,-5,1002,3345,40
15768772719,15768772712,-7,809,2918,40
15769299903,15769299897,-6,1089,3302,40
15783324463,15783324458,-5,997,4143,40
15783489078,15783489090,12,691,2709,40
15786628607,15786628601,-6,844,3028,40
15787988161,15787988154,-7,1149,6350,40
15790621274,15790621269,-5,1111,3181,40
15796785601,15796785607,6,5423,1878,40
15796830937,15796830930,-7,998,2753,40
15800555767,15800555762,-5,796,3217,40
15801114845,15801114842,-3,218,1106,40
15803206420,15803206423,3,31192,21673,40
15807920081,15807920082,1,1799,1516,40
15808678649,15808678654,5,4196,1886,40
15810664012,15810664020,8,11383,36906,40
15821920357,15821920349,-8,1059,4092,40
15823825966,15823825959,-7,1203,3386,40
15824250504,15824250520,16,1333,3913,40
15826216227,15826216221,-6,1141,4961,40
15826405902,15826405894,-8,1079,4713,40
15829032531,15829032526,-5,1075,3472,40
15829117442,15829117437,-5,1059,3227,40
15838026316,15838026330,14,918,2632,40
15841232479,15841232473,-6,1267,2075,40
15842636434,15842636429,-5,1011,2824,40
15843370777,15843370773,-4,46,1114,40
15843808325,15843808322,-3,1995,3717,40
15844710718,15844710713,-5,691,3644,40
15844961353,15844961349,-4,1100,2105,40
15850503095,15850503089,-6,1145,4723,40
15860512867,15860512859,-8,1064,3555,40
15861426582,15861426577,-5,1015,2126,40
15861514445,15861514464,19,244,893,40
15862114007,15862114005,-2,417,1011,40
15865607965,15865607958,-7,514,3458,40
15874739346,15874739341,-5,839,2769,40
15876478980,15876478973,-7,827,5887,40
15878054904,15878054904,0,2575,3428,40
15890544380,15890544375,-5,1142,3448,40
15892627815,15892627820,5,3021,1111,40
15895214709,15895214703,-6,1215,3712,40
15896161446,15896161438,-8,1059,3278,40
15905371874,15905371874,0,1435,2069,40
15905585347,15905585343,-4,1449,3257,40
15914329574,15914329569,-5,1008,3446,40
15923078954,15923078949,-5,1282,3078,40
15923435063,15923435056,-7,392,1905,40
15923817706,15923817701,-5,1217,3426,40
15924202464,15924202458,-6,906,3174,40
15924320866,15924320861,-5,970,3414,40
15940903783,15940903790,7,2829,1438,40
15948060918,15948060932,14,906,1076,40
15951584031,15951584025,-6,793,3910,40
15953891394,15953891387,-7,987,3684,40
15958485457,15958485449,-8,1438,4563,40
15970117339,15970117334,-5,967,4727,40
15972873550,15972873546,-4,775,3384,40
15973673386,15973673379,-7,954,5279,40
15973779968,15973779981,13,676,1867,40
15977833963,15977833966,3,1877,1505,40
15979765036,15979765029,-7,778,4196,40
15981479915,15981479914,-1,4240,16260,40
15982999267,15982999261,-6,1042,4498,40
15987294586,15987294580,-6,1033,2857,40
15989852615,15989852607,-8,993,3596,40
15996937568,15996937560,-8,1120,3307,40
15998544430,15998544430,0,1255,1919,40
16007745348,16007745342,-6,656,3522,40
16009694889,16009694883,-6,846,2819,40
16011958217,16011958214,-3,214,998,40
16014735422,16014735427,5,52638,94264,40
16015358352,16015358345,-7,1243,4074,40
16019720292,16019720285,-7,1505,3986,40
16031229235,16031229229,-6,1423,4638,40
16035928546,16035928546,0,1314,1793,40
16036561513,16036561515,2,1915,1148,40
16039834385,16039834381,-4,808,3865,40
16039935926,16039935931,5,144,1196,40
16044590594,16044590587,-7,1161,4778,40
16048280477,16048280470,-7,1073,3854,40
16050035060,16050035055,-5,1087,4481,40
16058770072,16058770076,4,51854,34552,40
16066304796,16066304790,-6,642,1842,40
16067834118,16067834113,-5,770,2775,40
16067899903,16067899906,3,172,1366,40
16075591919,16075591913,-6,971,3267,40
16079388087,16079388082,-5,1168,4433,40
16079571033,16079571032,-1,19389,21583,40
16081695019,16081695014,-5,1161,3799,40
16088626362,16088626376,14,40258,12666,40
16090587305,16090587300,-5,967,2181,40
16090890352,16090890359,7,225,1215,40
16093599858,16093599851,-7,919,4023,40
16094494120,16094494115,-5,1400,3676,40
16094987682,16094987675,-7,891,3018,40
16095603689,16095603682,-7,1374,4682,40
16095831471,16095831475,4,261,1114,40
16098936233,16098936227,-6,535,1322,40
16100310590,16100310610,20,283,1441,40
16100559342,16100559349,7,63,790,40
16101051279,16101051285,6,17688,47389,40
16106425649,16106425642,-7,979,3226,40
16106860647,16106860634,-13,137,1337,40
16107539047,16107539041,-6,1241,4041,40
16108495774,16108495770,-4,3676,8562,40
16110322678,16110322698,20,47,1006,40
16118994661,16118994654,-7,755,4004,40
16130178738,16130178734,-4,809,2533,40
16132260638,16132260633,-5,971,4163,40
16135777755,16135777750,-5,1200,3799,40
16136351034,16136351028,-6,1498,4902,40
16150021846,16150021841,-5,954,3679,40
16150092815,16150092794,-21,106,640,40
16153087026,16153087019,-7,881,3121,40
16155357598,16155357591,-7,972,1791,40
16157062354,16157062348,-6,1051,3918,40
16157516388,16157516399,11,1185,3407,40
16157954975,16157954968,-7,706,3777,40
16161103648,16161103645,-3,1337,2859,40
16166830306,16166830301,-5,885,4136,40
16166959478,16166959473,-5,940,4239,40
16171349946,16171349941,-5,1257,4032,40
16173780634,16173780629,-5,893,5064,40
16178677227,16178677222,-5,1140,3150,40
16178892018,16178892013,-5,1263,5310,40
16182875577,16182875573,-4,1255,3465,40
16184538250,16184538244,-6,1167,3939,40
16186400418,16186400412,-6,797,3165,40
16188080532,16188080519,-13,1135,3333,40
16189967987,16189967982,-5,828,4521,40
16190347397,16190347415,18,809,3889,40
16190384825,16190384819,-6,1012,4399,40
16192135381,16192135385,4,2833,854,40
16195050029,16195050036,7,6807,2502,40
16196712418,16196712413,-5,1122,3950,40
16197283302,16197283318,16,547,3003,40
16209913434,16209913428,-6,1140,3106,40
16217552901,16217552894,-7,1275,4731,40
16217593438,16217593454,16,300,1474,40
16219144443,16219144452,9,14548,8188,40
16229667025,16229667020,-5,1549,4862,40
16230413208,16230413188,-20,186,12860,40
16230584830,16230584839,9,4132,1213,40
16236831479,16236831473,-6,967,3570,40
16237663841,16237663835,-6,1044,3160,40
16245187874,16245187878,4,2383,1136,40
16246924901,16246924902,1,1140,1562,40
16254977743,16254977741,-2,303,1266,40
16255180521,16255180531,10,11674,39740,40
16257315361,16257315366,5,3669,1992,40
16260092309,16260092303,-6,880,4095,40
16266750758,16266750754,-4,1065,3035,40
16267156620,16267156609,-11,1065,3355,40
16267583352,16267583359,7,4511,2145,40
16269022154,16269022149,-5,735,1576,40
16271394467,16271394461,-6,915,3624,40
16285656178,16285656175,-3,1325,2138,40
16294220503,16294220497,-6,853,3890,40
16296424374,16296424367,-7,970,3500,40
16299479077,16299479070,-7,1180,4832,40
16300214437,16300214430,-7,1264,3165,40
16301994537,16301994541,4,1688,1866,40
16305008219,16305008216,-3,558,1528,40
16305162127,16305162129,2,135,1339,40
16309284185,16309284187,2,1943,2243,40
16309403817,16309403814,-3,2081,4067,40
16321322125,16321322118,-7,1062,3354,40
16324244665,16324244659,-6,1212,4124,40
16324887866,16324887858,-8,1213,6534,40
16326162229,16326162225,-4,960,5015,40
16328274603,16328274598,-5,981,3357,40
16330567832,16330567827,-5,810,2625,40
16330643981,16330643975,-6,66,1051,40
16331568694,16331568688,-6,698,2580,40
16332389446,16332389449,3,1894,1562,40
16338033510,16338033505,-5,1098,4471,40
16341827527,16341827522,-5,1105,4582,40
16352701123,16352701117,-6,713,3028,40
16353138421,16353138425,4,162,1053,40
16355241802,16355241795,-7,818,4253,40
16362504002,16362504003,1,1311,1086,40
16365450214,16365450209,-5,953,3892,40
16377806894,16377806890,-4,992,3096,40
16380939742,16380939735,-7,900,2580,40
16381859830,16381859841,11,152,777,40
16388157299,16388157291,-8,1008,3199,40
16392119789,16392119782,-7,1193,3926,40
16404185980,16404185983,3,2728,1648,40
16423758927,16423758921,-6,952,4338,40
16426917879,16426917873,-6,1090,3828,40
16429170414,16429170409,-5,695,3754,40
16432934021,16432934014,-7,1169,5120,40
16433979258,16433979253,-5,1090,3985,40
16434536855,16434536849,-6,1203,4061,40
16439997835,16439997832,-3,1197,4202,40
16440162918,16440162912,-6,1335,4913,40
16441085210,16441085206,-4,1197,3620,40
16447684822,16447684818,-4,855,3546,40
16448582197,16448582190,-7,1003,2837,40
16448956382,16448956399,17,406,1011,40
16449453913,16449453906,-7,1050,2868,40
16449490173,16449490194,21,948,2929,40
16449527335,16449527329,-6,1128,7157,40
16454625544,16454625538,-6,1422,3466,40
16461209414,16461209409,-5,1089,4780,40
16475683898,16475683893,-5,792,3393,40
16476416300,16476416314,14,80,830,40
16485548603,16485548595,-8,21038,49260,40
16485820225,16485820221,-4,999,2296,40
16488895151,16488895145,-6,838,3351,40
16491038997,16491038991,-6,993,4329,40
16491238378,16491238383,5,2158,1403,40
16497402195,16497402188,-7,1803,4792,40
16503911386,16503911393,7,5136,2619,40
16508679951,16508679944,-7,859,3321,40
16509040113,16509040107,-6,1361,3607,40
16513839898,16513839891,-7,1257,3750,40
16514907560,16514907571,11,852,3920,40
16517652401,16517652394,-7,861,5121,40
16522370798,16522370793,-5,814,3370,40
16525857252,16525857245,-7,1182,4238,40
16527266609,16527266602,-7,1239,3791,40
16532435205,16532435202,-3,1481,2153,40
16532682190,16532682188,-2,257,1221,40
16534594902,16534594897,-5,815,2486,40
16542380011,16542380009,-2,22296,13690,40
16542995217,16542995222,5,2467,1833,40
16546929745,16546929755,10,15351,11904,40
16549286467,16549286475,8,7882,1942,40
16551180266,16551180264,-2,1325,2594,40
16554993071,16554993066,-5,902,2778,40
16555442612,16555442598,-14,211,1679,40
16559149384,16559149379,-5,1109,3104,40
16561938891,16561938890,-1,1371,1709,40
16564258598,16564258593,-5,945,3820,40
16564567020,16564567038,18,1109,4575,40
16564844791,16564844789,-2,240,1018,40
16569764363,16569764358,-5,1113,4231,40
16574199658,16574199652,-6,1065,3678,40
16575395168,16575395170,2,63,626,40
16583438276,16583438270,-6,862,3081,40
16583619887,16583619890,3,188,1418,40
16587359104,16587359098,-6,956,3495,40
16587764823,16587764809,-14,12,910,40
16591230122,16591230117,-5,1641,4126,40
16592856676,16592856670,-6,1032,4700,40
16603264423,16603264417,-6,466,4341,40
16603900713,16603900707,-6,803,4037,40
16607056042,16607056037,-5,1034,3698,40
16613705767,16613705760,-7,628,1824,40
16615609358,16615609352,-6,999,3307,40
16615978645,16615978631,-14,106,1195,40
16625588383,16625588377,-6,1036,4254,40
16628596921,16628596916,-5,1168,3566,40
16633292278,16633292274,-4,676,2239,40
16635167938,16635167932,-6,716,3969,40
16639273258,16639273256,-2,660,2412,40
16643419232,16643419226,-6,921,4566,40
16645130693,16645130691,-2,177,1214,40
16646435117,16646435139,22,849,2187,40
16648679920,16648679914,-6,1166,3549,40
16648760960,16648760962,2,1919,1145,40
16651653553,16651653547,-6,1095,2747,40
16653693096,16653693103,7,2521,1141,40
16654601163,16654601157,-6,1156,4620,40
16661201609,16661201614,5,1553,1508,40
16661501363,16661501355,-8,574,1223,40
16668598187,16668598182,-5,1007,2961,40
16669441974,16669441969,-5,944,3141,40
16688694219,16688694228,9,2070,1902,40
16690354815,16690354810,-5,1099,4156,40
16700170930,16700170924,-6,946,3326,40
16702313851,16702313845,-6,816,3534,40
16709086959,16709086953,-6,1476,4046,40
16715628943,16715628937,-6,1129,3175,40
16717659978,16717659973,-5,997,3102,40
16718555197,16718555213,16,359,1131,40
16737802314,16737802310,-4,882,2123,40
16738539653,16738539646,-7,968,3588,40
16740377503,16740377517,14,239,1047,40
16744040774,16744040769,-5,1061,4270,40
16745859011,16745859006,-5,883,3376,40
16746643205,16746643221,16,649,2396,40
16747787914,16747787910,-4,816,3893,40
16747906589,16747906586,-3,266,2249,40
16748000367,16748000361,-6,1097,4295,40
16750309783,16750309778,-5,600,1523,40
16758651424,16758651418,-6,892,2805,40
16758783832,16758783848,16,1125,4216,40
16759540734,16759540722,-12,886,3905,40
16759731173,16759731194,21,695,3789,40
16765801862,16765801856,-6,1188,3965,40
16766664002,16766664021,19,854,2185,40
16767194637,16767194632,-5,1451,3595,40
16778729154,16778729146,-8,873,3099,40
16779181151,16779181142,-9,713,3806,40
16779369141,16779369134,-7,324,1168,40
16780288726,16780288744,18,362,1246,40
16788777586,16788777581,-5,1031,3526,40
16789512006,16789512001,-5,137,962,40
16789755245,16789755267,22,394,1386,40
16792597645,16792597640,-5,1039,3696,40
16794481563,16794481569,6,1906,1114,40
16797037909,16797037902,-7,874,4397,40
16802152183,16802152185,2,1730,1483,40
16807054259,16807054254,-5,637,1578,40
16810346917,16810346912,-5,1167,3717,40
16810695370,16810695366,-4,888,3023,40
16818280032,16818280029,-3,1433,3176,40
16818913020,16818913015,-5,979,3599,40
16819855965,16819855975,10,31,1020,40
16820807912,16820807924,12,34,1395,40
16821359325,16821359342,17,371,1704,40
16823312769,16823312770,1,2223,2011,40
16823905654,16823905650,-4,992,3362,40
16842160109,16842160102,-7,1014,4677,40
16844304368,16844304371,3,37945,28193,40
16854991378,16854991373,-5,948,4137,40
16855550434,16855550439,5,3175,1801,40
16861772490,16861772483,-7,1169,2502,40
16865060640,16865060634,-6,1289,2706,40
16866450603,16866450598,-5,836,1813,40
16866589436,16866589433,-3,144,1169,40
16867963118,16867963114,-4,808,3087,40
16869331100,16869331081,-19,866,3733,40
16872961053,16872961047,-6,1055,4493,40
16873102534,16873102554,20,70,1553,40
16874509035,16874509055,20,707,1786,40
16881359710,16881359704,-6,978,4235,40
16882206380,16882206375,-5,619,2237,40
16883420364,16883420358,-6,1499,5360,40
16883580903,16883580899,-4,756,2123,40
16893909209,16893909204,-5,670,3934,40
16896466213,16896466218,5,2627,1272,40
16899112750,16899112743,-7,1090,6526,40
16902544555,16902544561,6,1114,202,40
16903607892,16903607889,-3,57164,34477,40
16922906673,16922906671,-2,649,1163,40
16924851665,16924851659,-6,970,3114,40
16926045587,16926045581,-6,962,4835,40
16930363202,16930363201,-1,1343,2732,40
16930840903,16930840897,-6,864,3182,40
16931498959,16931498946,-13,272,954,40
16934092099,16934092094,-5,993,3517,40
16936933449,16936933445,-4,1048,3370,40
16948405373,16948405366,-7,1088,4332,40
16949476146,16949476141,-5,794,2145,40
16963378278,16963378273,-5,1345,4306,40
16968944740,16968944740,0,1214,1647,40
16969155293,16969155279,-14,109,1179,40
16969825342,16969825341,-1,3272,3159,40
16979764323,16979764317,-6,791,2749,40
16984359318,16984359313,-5,1659,6355,40
16986858146,16986858140,-6,1319,4845,40
16989930459,16989930453,-6,743,2242,40
16995624818,16995624813,-5,702,3176,40
16995761205,16995761190,-15,199,1504,40
16999563138,16999563134,-4,775,3854,40
17000326494,17000326496,2,1223,1757,40
17002588626,17002588620,-6,722,3921,40
17004469342,17004469335,-7,646,2934,40
17008728359,17008728370,11,13231,42491,40
17009780439,17009780433,-6,1243,4738,40
17011162473,17011162465,-8,868,4154,40
17016217327,17016217323,-4,906,3407,40
17020778537,17020778532,-5,797,3714,40
17028204015,17028204010,-5,925,3910,40
17028879012,17028879013,1,51,1759,40
17030527758,17030527750,-8,686,2772,40
17031600509,17031600504,-5,843,2428,40
17034354878,17034354876,-2,2242,6338,40
17035160973,17035160967,-6,1652,6217,40
17043712965,17043712958,-7,2089,3147,40
17046010031,17046010046,15,287,874,40
17050949643,17050949634,-9,1096,4455,40
17056223628,17056223626,-2,868,1105,40
17058708241,17058708237,-4,1204,1914,40
17058739076,17058739075,-1,190,710,40
17059780279,17059780273,-6,776,4013,40
17064444817,17064444810,-7,922,3641,40
17069199055,17069199049,-6,1313,4317,40
17069542387,17069542378,-9,1365,4012,40
17076457708,17076457702,-6,697,4049,40
17076945464,17076945442,-22,283,1745,40
17083724763,17083724763,0,1651,178,40
17084487881,17084487879,-2,4999,7551,40
17088474813,17088474813,0,3460,4425,40
17093365639,17093365634,-5,1797,5523,40
17095758986,17095758982,-4,1027,3468,40
17099161148,17099161142,-6,1024,3723,40
17100062151,17100062164,13,169,984,40
17103830880,17103830880,0,1727,2039,40
17105067400,17105067394,-6,1096,4114,40
17105106927,17105106947,20,725,3608,40
17108045369,17108045362,-7,1118,3698,40
17117856362,17117856358,-4,763,1871,40
17122474227,17122474219,-8,1247,4699,40
17125516994,17125516986,-8,894,3407,40
17126194460,17126194454,-6,1221,4077,40
17140095520,17140095514,-6,1411,3533,40
17142935943,17142935937,-6,1130,5379,40
17144027973,17144027965,-8,1232,4383,40
17144787911,17144787910,-1,920,1974,40
17148391171,17148391165,-6,790,2663,40
17148691863,17148691853,-10,754,3579,40
17148767438,17148767459,21,1034,3521,40
17150895858,17150895855,-3,906,3129,40
17152932651,17152932660,9,20990,1179,40
17154807534,17154807528,-6,828,2675,40
17156652581,17156652576,-5,1182,3144,40
17156694461,17156694482,21,296,693,40
17157492454,17157492455,1,306,1415,40
17159615268,17159615265,-3,800,2478,40
17159892361,17159892353,-8,691,2883,40
17159950367,17159950383,16,401,1822,40
17162863607,17162863601,-6,1057,4697,40
17164599794,17164599789,-5,1399,3519,40
17167756998,17167756994,-4,566,3462,40
17167955600,17167955616,16,513,2964,40
17170259915,17170259909,-6,1116,4218,40
17183268030,17183268025,-5,1148,3610,40
17193483097,17193483090,-7,1408,5214,40
17200020826,17200020820,-6,636,3741,40
17200332413,17200332421,8,293,944,40
17203569186,17203569181,-5,710,3309,40
17204199974,17204199979,5,341,1403,40
17206034936,17206034930,-6,1027,3846,40
17211297844,17211297851,7,283,1041,40
17214191673,17214191670,-3,1037,3256,40
17215225883,17215225884,1,1470,1568,40
17223264816,17223264809,-7,983,5044,40
17233415048,17233415042,-6,939,3184,40
17242237295,17242237290,-5,1281,3682,40
17242286900,17242286895,-5,172,865,40
17246660542,17246660535,-7,714,3982,40
17248475723,17248475717,-6,1250,5087,40
17251459280,17251459274,-6,992,4770,40
17263657398,17263657393,-5,759,3471,40
17265309545,17265309537,-8,1048,4618,40
17265852637,17265852650,13,97,1230,40
17269066858,17269066850,-8,912,3719,40
17269541164,17269541159,-5,870,3632,40
17269910885,17269910870,-15,1060,1551,40
17270460269,17270460286,17,991,6460,40
17270848383,17270848378,-5,1031,4171,40
17271588055,17271588049,-6,1135,3365,40
17272523408,17272523419,11,1209,4139,40
17275342578,17275342583,5,2364,1327,40
17275988572,17275988573,1,2228,2137,40
17276344604,17276344602,-2,913,2574,40
17279103450,17279103444,-6,749,2125,40
17284156392,17284156385,-7,1077,3376,40
17285823074,17285823077,3,1376,1486,40
17298899990,17298899984,-6,1329,4230,40
17301686074,17301686070,-4,606,3067,40
17302891284,17302891279,-5,514,2300,40
17303866522,17303866519,-3,973,1787,40
17304026525,17304026542,17,988,3918,40
17310523434,17310523430,-4,1161,2920,40
17312009197,17312009190,-7,898,4261,40
17320815412,17320815433,21,409,1824,40
17324832999,17324832993,-6,683,3973,40
17325987849,17325987842,-7,919,1835,40
17326335966,17326335966,0,381,1256,40
17335037187,17335037190,3,76,1321,40
17335952359,17335952355,-4,2192,5947,40
17337792363,17337792357,-6,873,3068,40
17345371829,17345371822,-7,852,3644,40
17345606382,17345606394,12,683,1525,40
17348191513,17348191506,-7,1615,3768,40
17348656729,17348656722,-7,1180,6479,40
17353205430,17353205437,7,86,1202,40
17361370265,17361370261,-4,996,3153,40
17362928811,17362928806,-5,1400,3409,40
17369654173,17369654166,-7,597,2881,40
17370176525,17370176518,-7,819,3499,40
17371636882,17371636874,-8,792,4546,40
17371914833,17371914830,-3,2850,5018,40
17372251208,17372251201,-7,721,2426,40
17372375407,17372375414,7,2980,1613,40
17374984799,17374984790,-9,912,5105,40
17375696614,17375696628,14,749,2022,40
17386239819,17386239822,3,2075,1584,40
17386607734,17386607730,-4,777,3238,40
17388660901,17388660897,-4,1105,3400,40
17390027607,17390027604,-3,1394,2833,40
17398673262,17398673257,-5,1028,3480,40
17398719559,17398719541,-18,1043,4899,40
17400161047,17400161038,-9,1076,3418,40
17403559205,17403559209,4,14207,1440,40
17405589241,17405589235,-6,2336,9519,40
17408516481,17408516497,16,2043,1864,40
17414904526,17414904530,4,1232,1102,40
17416110963,17416110958,-5,1511,3392,40
17416948422,17416948418,-4,1071,4607,40
17419140842,17419140837,-5,1069,3688,40
17423263956,17423263949,-7,1129,3737,40
17423622108,17423622127,19,1276,4052,40
17423933336,17423933354,18,222,1239,40
17430823738,17430823735,-3,810,3902,40
17441156729,17441156724,-5,779,3621,40
17441454588,17441454610,22,360,915,40
17445494194,17445494188,-6,997,2348,40
17456456170,17456456174,4,1354,1560,40
17467510696,17467510703,7,6896,29077,40
17471636477,17471636481,4,1547,1458,40
17475837142,17475837140,-2,23217,17954,40
17477999985,17477999982,-3,1335,3590,40
17478716466,17478716459,-7,978,3996,40
17479668567,17479668562,-5,182,1273,40
17484085442,17484085437,-5,697,3627,40
17484502500,17484502495,-5,794,2771,40
17485367524,17485367518,-6,1277,5976,40
17486171790,17486171804,14,273,2852,40
17489394065,17489394060,-5,622,3245,40
17489653718,17489653705,-13,3,748,40
17490172719,17490172717,-2,1321,1920,40
17495667223,17495667218,-5,1078,3010,40
17496715639,17496715640,1,1510,2089,40
17498658302,17498658295,-7,1140,2654,40
17499470870,17499470890,20,639,2950,40
17502918451,17502918446,-5,1224,3759,40
17506613242,17506613237,-5,1196,3640,40
17510628235,17510628237,2,2671,2653,40
17512596700,17512596694,-6,642,3338,40
17515426163,17515426158,-5,768,3880,40
17516051573,17516051591,18,172,1074,40
17518619231,17518619225,-6,887,3448,40
17519614485,17519614474,-11,165,909,40
17520044267,17520044261,-6,1215,3713,40
17520180381,17520180401,20,900,3391,40
17520315695,17520315690,-5,1255,3874,40
17520837906,17520837900,-6,1194,4006,40
17527019821,17527019819,-2,2334,4858,40
17529333757,17529333753,-4,695,2295,40
17532650941,17532650936,-5,693,3274,40
17536468696,17536468690,-6,697,3233,40
17537282309,17537282331,22,682,2794,40
17548215018,17548215023,5,5704,3557,40
17552351635,17552351627,-8,913,3256,40
17558556150,17558556145,-5,869,2861,40
17560857683,17560857683,0,1,571,40
17567532142,17567532135,-7,1495,6279,40
17569243083,17569243078,-5,814,3071,40
17578454703,17578454705,2,38088,35478,40
17578543726,17578543721,-5,937,2397,40
17581293627,17581293622,-5,926,3691,40
17587002302,17587002298,-4,889,4081,40
17589503997,17589503997,0,1611,1443,40
17591278559,17591278562,3,1950,1936,40
17591893429,17591893434,5,2570,1618,40
17603237001,17603237001,0,1575,2209,40
17604220132,17604220126,-6,987,3557,40
17605940448,17605940442,-6,870,3669,40
17607985406,17607985401,-5,536,2954,40
17609478917,17609478910,-7,901,4596,40
17617303882,17617303887,5,34543,124554,40
17618726190,17618726206,16,17775,52038,40
17632155494,17632155489,-5,1121,5432,40
17632320642,17632320634,-8,918,5067,40
17632588257,17632588251,-6,906,4064,40
17634406343,17634406344,1,1224,1693,40
17636760583,17636760578,-5,1248,4035,40
17638608861,17638608855,-6,1200,3623,40
17638822162,17638822157,-5,1005,5068,40
17650451418,17650451413,-5,1274,4199,40
17652029750,17652029752,2,1067,1086,40
17658900856,17658900846,-10,1413,3837,40
17659001632,17659001650,18,686,2939,40
17660139315,17660139310,-5,1289,4357,40
17663500242,17663500237,-5,1008,1834,40
17663965477,17663965469,-8,228,1346,40
17672304156,17672304150,-6,978,7651,40
17673355526,17673355547,21,21,897,40
17681040037,17681040030,-7,836,5032,40
17683036585,17683036581,-4,1047,3046,40
17684088626,17684088619,-7,924,2957,40
17684382456,17684382463,7,69,543,40
17684776831,17684776848,17,565,4017,40
17687730413,17687730406,-7,1010,4162,40
17688417912,17688417923,11,457,2097,40
17689691575,17689691571,-4,928,1201,40
17702326299,17702326297,-2,1571,2763,40
17703215885,17703215881,-4,1001,3903,40
17703263719,17703263733,14,173,1252,40
17705437477,17705437469,-8,1076,3855,40
17705771821,17705771842,21,988,3670,40
17707328317,17707328310,-7,1398,3952,40
17711261240,17711261233,-7,2153,9966,40
17718798255,17718798249,-6,879,2893,40
17718971940,17718971931,-9,3,1240,40
17724623931,17724623927,-4,1016,2833,40
17725089644,17725089626,-18,1094,3029,40
17727264062,17727264068,6,6130,2608,40
17728901839,17728901835,-4,885,1488,40
17742048907,17742048900,-7,948,5644,40
17753123735,17753123729,-6,1046,2084,40
17753281920,17753281925,5,164,1011,40
17754403182,17754403201,19,379,2239,40
17763466598,17763466592,-6,1068,2989,40
17766449987,17766449981,-6,832,4092,40
17767739953,17767739946,-7,1268,5118,40
17773783374,17773783370,-4,1218,3503,40
17776188644,17776188639,-5,818,1989,40
17790365936,17790365930,-6,859,3249,40
17793235727,17793235734,7,2153,954,40
17797348743,17797348738,-5,1017,2807,40
17804131606,17804131598,-8,1365,5528,40
17804161541,17804161549,8,4913,1735,40
17804503741,17804503747,6,2593,1462,40
17814366917,17814366910,-7,1119,3645,40
17828258520,17828258514,-6,986,3307,40
17833452922,17833452918,-4,954,2610,40
17840125906,17840125900,-6,831,3364,40
17840700868,17840700865,-3,42,975,40
17841846437,17841846429,-8,890,3562,40
17843256798,17843256797,-1,196,1275,40
17845044247,17845044241,-6,1400,3305,40
17852193912,17852193906,-6,1179,3272,40
17853514257,17853514250,-7,898,4328,40
17856869519,17856869512,-7,1083,5284,40
17857056982,17857056967,-15,273,1397,40
17862465023,17862465022,-1,3624,5956,40
17863586286,17863586282,-4,819,2173,40
17864364201,17864364195,-6,749,3225,40
17864419903,17864419896,-7,911,3019,40
17864639766,17864639784,18,638,2232,40
17864839185,17864839179,-6,931,4076,40
17869957215,17869957207,-8,1061,4019,40
17880664487,17880664481,-6,211,3001,40
17887060813,17887060806,-7,1002,3238,40
17888991479,17888991474,-5,1303,4166,40
17889531406,17889531421,15,1142,2630,40
17892506070,17892506064,-6,26054,13981,40
17900038339,17900038335,-4,820,2273,40
17900882916,17900882926,10,277,1093,40
17903961591,17903961584,-7,1282,4506,40
17905193566,17905193562,-4,1271,2644,40
17912556618,17912556613,-5,1288,2930,40
17913060400,17913060419,19,216,817,40
17919553826,17919553821,-5,921,5394,40
17929466215,17929466210,-5,1184,3476,40
17931138422,17931138418,-4,1071,2819,40
17931847934,17931847953,19,878,3432,40
17940002461,17940002457,-4,857,2852,40
17945130479,17945130470,-9,1134,4653,40
17945619714,17945619708,-6,1251,2949,40
17952375950,17952375943,-7,796,2357,40
17960564277,17960564270,-7,1243,5015,40
17960675855,17960675862,7,339,1019,40
17967820095,17967820093,-2,1542,3308,40
17973593925,17973593921,-4,1093,3848,40
17975182297,17975182295,-2,2054,3047,40
17976614552,17976614563,11,12958,39503,40
17989010256,17989010250,-6,1055,4048,40
17993214970,17993214964,-6,902,4649,40
18001177255,18001177249,-6,1016,4115,40
18003721598,18003721590,-8,962,4294,40
18014803687,18014803681,-6,907,4459,40
18024291850,18024291845,-5,577,1723,40
18029718943,18029718937,-6,812,4045,40
18036529665,18036529673,8,5777,2399,40
18039927943,18039927945,2,1334,1682,40
18040683763,18040683758,-5,1181,3468,40
18041143207,18041143202,-5,781,3363,40
18041580509,18041580530,21,442,1522,40
18042169292,18042169290,-2,890,1892,40
18050109757,18050109750,-7,1493,4109,40
18054372026,18054372021,-5,1129,4000,40
18054775035,18054775028,-7,809,2161,40
18055318447,18055318441,-6,1055,4604,40
18056886642,18056886639,-3,997,1461,40
18057643910,18057643929,19,636,2614,40
18057863226,18057863230,4,1761,1496,40
18059324734,18059324729,-5,1020,3011,40
18059561894,18059561889,-5,740,3471,40
18063130413,18063130405,-8,945,3334,40
18079011532,18079011528,-4,25012,11772,40
18090453525,18090453525,0,1647,2095,40
18090952243,18090952238,-5,858,3523,40
18094221344,18094221338,-6,987,3586,40
18094929146,18094929142,-4,1280,3590,40
18094956141,18094956162,21,842,3953,40
18095685278,18095685285,7,2596,1383,40
18101212817,18101212810,-7,943,4851,40
18101450834,18101450822,-12,958,3507,40
18102270912,18102270909,-3,1140,3128,40
18102754509,18102754502,-7,550,3230,40
18102879383,18102879397,14,549,2487,40
18118102653,18118102648,-5,2480,5964,40
18124809869,18124809862,-7,270,1220,40
18126873679,18126873674,-5,1255,2462,40
18128356813,18128356807,-6,1003,4027,40
18133942366,18133942361,-5,1094,3450,40
18136770691,18136770687,-4,617,1866,40
18139387103,18139387098,-5,992,4928,40
18148115497,18148115490,-7,881,3146,40
18151909561,18151909555,-6,923,2672,40
18153924366,18153924360,-6,875,3426,40
18167529238,18167529234,-4,979,2746,40
18171494750,18171494745,-5,989,2442,40
18172224381,18172224376,-5,955,3760,40
18174915742,18174915737,-5,1154,3881,40
18180653751,18180653745,-6,917,3634,40
18181330825,18181330820,-5,1326,2725,40
18182970018,18182970024,6,2534,1512,40
18184032675,18184032670,-5,1255,4524,40
18184777993,18184777987,-6,1627,11419,40
18185239897,18185239890,-7,898,4580,40
18185475408,18185475419,11,602,2723,40
18185680499,18185680492,-7,1119,2942,40
18185759285,18185759306,21,535,1856,40
18195458267,18195458258,-9,955,4035,40
18195909294,18195909310,16,289,1500,40
18195997391,18195997393,2,3697,3244,40
18196161202,18196161207,5,2115,1181,40
18202246112,18202246106,-6,1404,4521,40
18206032427,18206032421,-6,703,3500,40
18206756878,18206756870,-8,937,2706,40
18207999214,18207999213,-1,1322,2347,40
18215260157,18215260153,-4,1159,3808,40
18218448979,18218448974,-5,1025,3326,40
18223015566,18223015561,-5,790,4784,40
18227992091,18227992078,-13,11058,43617,40
18235273145,18235273137,-8,1014,4956,40
18235580847,18235580831,-16,244,1157,40
18238983163,18238983161,-2,1405,2757,40
18240546659,18240546654,-5,808,3732,40
18241012567,18241012570,3,202,1204,40
18242135214,18242135197,-17,73,1104,40
18246375553,18246375549,-4,1080,4216,40
18256016189,18256016184,-5,963,4098,40
18256847009,18256847001,-8,108,1837,40
18257126103,18257126118,15,939,2433,40
18265493934,18265493929,-5,615,3210,40
18266754907,18266754902,-5,1326,3616,40
18269951426,18269951419,-7,907,2893,40
18270198742,18270198758,16,278,1998,40
18271757887,18271757881,-6,1451,3813,40
18271920772,18271920754,-18,180,1352,40
18274497746,18274497737,-9,809,4054,40
18274632981,18274632987,6,181,1375,40
18277261402,18277261405,3,2013,1392,40
18279563587,18279563581,-6,1187,2903,40
18281732747,18281732750,3,1735,1018,40
18293517592,18293517586,-6,1288,3154,40
18294418582,18294418577,-5,1272,4791,40
18298320079,18298320074,-5,733,3027,40
18298960535,18298960530,-5,1024,3606,40
18306433646,18306433640,-6,714,3385,40
18307884038,18307884033,-5,1143,2747,40
18308167212,18308167208,-4,286,1457,40
18309324119,18309324113,-6,1069,3680,40
18313245424,18313245418,-6,1046,2123,40
18313623705,18313623698,-7,1073,3697,40
18315387451,18315387445,-6,840,4845,40
18317280825,18317280823,-2,1411,2344,40
18317429980,18317429969,-11,268,1113,40
18322440962,18322440954,-8,1359,4212,40
18331478668,18331478663,-5,1213,3573,40
18331770115,18331770115,0,1086,2064,40
18332143928,18332143922,-6,963,3487,40
18332239758,18332239768,10,115,945,40
18333669313,18333669319,6,2931,1066,40
18336434654,18336434649,-5,918,5355,40
18337965637,18337965630,-7,920,3617,40
18345986567,18345986560,-7,743,3324,40
18350004408,18350004401,-7,1019,2968,40
18358488375,18358488369,-6,882,3841,40
18363736506,18363736501,-5,1286,3925,40
18372501766,18372501774,8,2743,1140,40
18382319354,18382319350,-4,1015,3212,40
18387036607,18387036601,-6,862,4063,40
18389303981,18389303978,-3,2451,4732,40
18390247449,18390247443,-6,1219,3952,40
18393434126,18393434122,-4,1315,3515,40
18395170054,18395170049,-5,908,4337,40
18397561623,18397561618,-5,1366,3671,40
18399420783,18399420774,-9,1130,5389,40
18409276073,18409276077,4,2354,1316,40
18410518353,18410518346,-7,1061,4791,40
18410704230,18410704246,16,567,3761,40
18411588958,18411588955,-3,1419,4031,40
18413360805,18413360798,-7,502,1619,40
18413404031,18413404043,12,260,988,40
18414879321,18414879315,-6,713,3901,40
18418930547,18418930541,-6,1041,3799,40
18420152312,18420152318,6,177,1185,40
18427263561,18427263557,-4,619,2202,40
18427895934,18427895938,4,38,1190,40
18428011396,18428011418,22,323,1008,40
18430236454,18430236460,6,10394,33051,40
18434631353,18434631345,-8,953,3724,40
18436563998,18436563998,0,2174,2426,40
18443562158,18443562153,-5,856,2676,40
18443758455,18443758450,-5,746,4875,40
18443889582,18443889578,-4,1139,3412,40
18445450526,18445450520,-6,1311,5699,40
18447284281,18447284291,10,12630,23364,40
18447449659,18447449655,-4,860,4034,40
18451927065,18451927062,-3,2147,3775,40
18456327656,18456327658,2,2550,1566,40
18457375559,18457375553,-6,1286,3695,40
18464011038,18464011033,-5,1201,3167,40
18464045446,18464045451,5,2511,1451,40
18470978866,18470978861,-5,1208,2740,40
18474045425,18474045418,-7,1363,4376,40
18474167659,18474167661,2,1308,1897,40
18474306698,18474306693,-5,954,3493,40
18475328152,18475328147,-5,1644,4743,40
18476609537,18476609530,-7,910,3339,40
18478746465,18478746461,-4,1191,3129,40
18483947120,18483947114,-6,1095,3366,40
18485266613,18485266609,-4,899,3649,40
18485429942,18485429935,-7,922,3028,40
18485667863,18485667857,-6,828,3450,40
18486807079,18486807072,-7,1204,4664,40
18491687097,18491687090,-7,801,3652,40
18492852286,18492852293,7,10563,4264,40
18495857973,18495857967,-6,1092,3944,40
18497758038,18497758034,-4,1201,3851,40
18499595657,18499595650,-7,742,4982,40
18501660892,18501660886,-6,1239,4299,40
18503193808,18503193802,-6,1700,6036,40
18506680516,18506680511,-5,972,3431,40
18510352903,18510352897,-6,910,1819,40
18510837584,18510837570,-14,92,1081,40
18522084981,18522084974,-7,1320,3591,40
18526893298,18526893292,-6,685,1914,40
18527259174,18527259173,-1,125,1575,40
18528327340,18528327325,-15,203,1253,40
18528884117,18528884134,17,1109,4175,40
18529963877,18529963878,1,1143,925,40
18531840722,18531840717,-5,1370,5044,40
18533316399,18533316393,-6,1187,4186,40
18541140413,18541140433,20,2581,1261,40
18545918111,18545918106,-5,1159,2170,40
18551514667,18551514662,-5,888,3337,40
18553880525,18553880517,-8,1132,3009,40
18555162934,18555162929,-5,1284,5132,40
18556831972,18556831991,19,1719,1686,40
18557124646,18557124641,-5,611,3055,40
18560823704,18560823697,-7,754,3449,40
18570233302,18570233317,15,554,2094,40
18572459995,18572459989,-6,961,3637,40
18576871011,18576871005,-6,1047,2875,40
18576927672,18576927673,1,159,1412,40
18577679720,18577679714,-6,1256,4638,40
18579691796,18579691804,8,9347,1434,40
18590779491,18590779485,-6,1098,3344,40
18591554182,18591554161,-21,4,926,40
18592340822,18592340817,-5,1386,6732,40
18598307385,18598307379,-6,973,3103,40
18599741679,18599741671,-8,909,2920,40
18600694645,18600694633,-12,146,1493,40
18604215717,18604215711,-6,867,4701,40
18605148862,18605148877,15,186,1373,40
18620671554,18620671532,-22,7684,32949,40
18621457454,18621457449,-5,1572,4158,40
18621706028,18621706022,-6,973,2542,40
18624584277,18624584262,-15,1004,3157,40
18624782205,18624782226,21,435,1278,40
18629327485,18629327491,6,2500,1089,40
18629602181,18629602174,-7,1380,3966,40
18638911197,18638911195,-2,859,1631,40
18647390070,18647390065,-5,1361,2866,40
18650003638,18650003634,-4,1221,4813,40
18650582517,18650582510,-7,752,3347,40
18658415447,18658415442,-5,1307,4444,40
18658710191,18658710186,-5,823,2979,40
18672435584,18672435577,-7,1191,3294,40
18672682756,18672682754,-2,184,790,40
18673844055,18673844048,-7,558,2366,40
18673872685,18673872664,-21,272,778,40
18676650710,18676650705,-5,647,3331,40
18683489663,18683489656,-7,1208,4592,40
18685436730,18685436734,4,1245,970,40
18690905778,18690905773,-5,978,3423,40
18691681419,18691681414,-5,1031,2199,40
18698403555,18698403551,-4,880,3269,40
18703423202,18703423196,-6,863,3244,40
18706019189,18706019184,-5,1316,3906,40
18713239019,18713239013,-6,942,3987,40
18713800396,18713800411,15,557,2937,40
18714326278,18714326273,-5,2015,4909,40
18727985390,18727985385,-5,1228,2938,40
18737414485,18737414480,-5,1007,3490,40
18740774330,18740774323,-7,860,2971,40
18741046509,18741046502,-7,187,801,40
18748092258,18748092250,-8,940,4131,40
18748547823,18748547818,-5,1022,3959,40
18755414977,18755414970,-7,833,3505,40
18766572489,18766572482,-7,748,3345,40
18768561464,18768561458,-6,833,3289,40
18768611839,18768611825,-14,167,1164,40
18774320163,18774320158,-5,639,1880,40
18778315895,18778315889,-6,1000,3086,40
18779072535,18779072526,-9,1472,4736,40
18781624822,18781624816,-6,426,1106,40
18783102424,18783102445,21,1143,3455,40
18786894229,18786894225,-4,1463,2908,40
18789377367,18789377362,-5,713,3823,40
18789549709,18789549711,2,240,1293,40
18791830256,18791830250,-6,787,3803,40
18795525651,18795525645,-6,852,2780,40
18806207561,18806207554,-7,679,4592,40
18808880090,18808880085,-5,1289,3904,40
18818761253,18818761255,2,1932,1401,40
18823253141,18823253134,-7,1311,4431,40
18834320901,18834320896,-5,734,2496,40
18848855470,18848855471,1,1800,2080,40
18851020683,18851020677,-6,1098,4625,40
18856027258,18856027251,-7,1189,4410,40
18860455618,18860455614,-4,873,4863,40
18865024469,18865024462,-7,1343,4256,40
18867612075,18867612087,12,630,1139,40
18869363481,18869363491,10,133,853,40
18869730274,18869730272,-2,1225,1877,40
18880046965,18880046970,5,2876,1047,40
18881176483,18881176477,-6,861,3233,40
18882468929,18882468931,2,1106,1246,40
18884303142,18884303136,-6,1211,3455,40
18885380803,18885380797,-6,831,2695,40
18895344039,18895344031,-8,1038,3357,40
18897629444,18897629434,-10,170,1265,40
18916585433,18916585427,-6,1326,4188,40
18923239822,18923239830,8,3115,1745,40
18927530003,18927530006,3,1891,1765,40
18930574985,18930574978,-7,1221,4835,40
18931590600,18931590602,2,907,846,40
18932719071,18932719066,-5,1122,4401,40
18933046139,18933046133,-6,857,3343,40
18935301656,18935301650,-6,1059,3660,40
18936018557,18936018578,21,432,2076,40
18941030554,18941030550,-4,1366,2723,40
18945466515,18945466509,-6,1248,3581,40
18946305647,18946305641,-6,1177,3965,40
18946533367,18946533362,-5,669,2652,40
18949104958,18949104951,-7,1001,4035,40
18952249846,18952249839,-7,880,3566,40
18954110029,18954110024,-5,1305,3418,40
18959343631,18959343625,-6,669,3366,40
18960912054,18960912058,4,2516,2026,40
18963524203,18963524206,3,1139,745,40
18965374983,18965374978,-5,959,2994,40
18965602236,18965602222,-14,118,923,40
18967707294,18967707288,-6,998,2682,40
18968580363,18968580357,-6,1080,4014,40
18971496768,18971496775,7,16040,19893,40
18980787623,18980787623,0,2496,3745,40
18984375229,18984375233,4,2657,1880,40
18996834399,18996834398,-1,6824,10255,40
19001724012,19001724007,-5,1246,3076,40
19013319956,19013319958,2,1560,1590,40
19013763327,19013763321,-6,851,2662,40
19013884790,19013884807,17,794,2530,40
19020123099,19020123090,-9,1136,5301,40
19020540094,19020540081,-13,1038,4409,40
19024474751,19024474745,-6,1035,2663,40
19030960733,19030960730,-3,756,2240,40
19034651140,19034651139,-1,2220,1984,40
19037898743,19037898738,-5,932,4763,40
19038043175,19038043154,-21,248,1067,40
19042135987,19042135981,-6,744,3091,40
19046521460,19046521454,-6,1049,3341,40
19055381155,19055381151,-4,785,1995,40
19055978585,19055978579,-6,1068,2188,40
19057699613,19057699608,-5,1203,3096,40
19058030213,19058030229,16,473,1579,40
19061542216,19061542210,-6,1199,3974,40
19062415945,19062415947,2,2253,1525,40
19063004307,19063004301,-6,553,2185,40
19064266677,19064266692,15,393,1458,40
19068162414,19068162406,-8,934,3867,40
19070525327,19070525321,-6,841,3344,40
19076474256,19076474249,-7,616,2227,40
19078047763,19078047757,-6,1149,3393,40
19080643423,19080643417,-6,825,2098,40
19081634598,19081634600,2,9338,10833,40
19082833110,19082833104,-6,1534,3923,40
19084477313,19084477307,-6,1162,3969,40
19094670079,19094670074,-5,737,3128,40
19096395186,19096395180,-6,887,3783,40
19096594167,19096594184,17,948,1875,40
19096773728,19096773741,13,503,1230,40
19101398042,19101398045,3,1631,1848,40
19102462379,19102462374,-5,1107,4215,40
19103039743,19103039742,-1,410,1270,40
19105409714,19105409714,0,1907,2216,40
19113160491,19113160485,-6,1357,5347,40
19113526316,19113526311,-5,832,3120,40
19124517321,19124517314,-7,1337,4955,40
19126905143,19126905142,-1,1266,2114,40
19141300631,19141300624,-7,1138,3828,40
19146272257,19146272252,-5,1944,4954,40
19146562457,19146562451,-6,1422,4539,40
19147198759,19147198757,-2,1372,3456,40
19149214475,19149214470,-5,1064,3561,40
19149462559,19149462559,0,74,772,40
19164353701,19164353695,-6,872,3763,40
19181414756,19181414750,-6,961,3982,40
19188477673,19188477666,-7,871,3786,40
19188882407,19188882402,-5,1819,3588,40
19189545610,19189545605,-5,876,3390,40
19194669218,19194669210,-8,793,3376,40
19198185843,19198185837,-6,1056,3960,40
19202515186,19202515181,-5,1000,2790,40
19213371743,19213371746,3,3204,2857,40
19217928455,19217928450,-5,954,3390,40
19221981756,19221981770,14,1138,1064,40
19227309507,19227309501,-6,972,5528,40
19227391032,19227391017,-15,76,1299,40
19230929376,19230929369,-7,1090,2938,40
19237156182,19237156175,-7,982,4066,40
19247043826,19247043822,-4,1042,2984,40
19247824519,19247824518,-1,167,1252,40
19248688041,19248688034,-7,1394,2780,40
19255168738,19255168732,-6,775,3527,40
19255633718,19255633717,-1,135,1263,40
19258573531,19258573525,-6,865,4380,40
19260402953,19260402975,22,513,1328,40
19261401158,19261401153,-5,977,4105,40
19263564117,19263564113,-4,1119,2669,40
19276593764,19276593758,-6,1349,4415,40
19283543262,19283543256,-6,1361,4188,40
19284268710,19284268706,-4,764,1060,40
19288702635,19288702629,-6,895,2567,40
19292943637,19292943633,-4,621,2593,40
19308990229,19308990225,-4,1072,3727,40
19315139404,19315139398,-6,1117,4742,40
19317957507,19317957502,-5,1132,2459,40
19322812570,19322812569,-1,1380,2606,40
19324212997,19324212991,-6,1051,3916,40
19324751255,19324751254,-1,1157,2114,40
19325712130,19325712127,-3,954,2281,40
19331419230,19331419225,-5,1238,2837,40
19333549324,19333549319,-5,1135,3414,40
19335419089,19335419086,-3,1344,3384,40
19336553521,19336553515,-6,1345,4321,40
19340005422,19340005415,-7,68,816,40
19344689916,19344689908,-8,879,3292,40
19359681767,19359681762,-5,955,3525,40
19360997343,19360997337,-6,1291,3994,40
19361319189,19361319184,-5,962,3119,40
19362971853,19362971875,22,290,1072,40
19364179239,19364179219,-20,901,3044,40
19364749583,19364749577,-6,1180,2816,40
19366999738,19366999732,-6,1135,3457,40
19369104374,19369104369,-5,1092,4229,40
19369324238,19369324258,20,901,3344,40
19372468990,19372468990,0,1211,2061,40
19373456231,19373456249,18,277,1093,40
19378329083,19378329082,-1,1546,2775,40
19378392341,19378392346,5,2659,1348,40
19378687770,19378687762,-8,831,4638,40
19383276287,19383276282,-5,1461,3222,40
19383815974,19383815992,18,625,2133,40
19387348837,19387348855,18,1548,1625,40
19387814250,19387814246,-4,1327,3817,40
19394824031,19394824025,-6,927,3384,40
19395507670,19395507658,-12,313,1097,40
19395803975,19395803962,-13,854,2833,40
19398428155,19398428149,-6,893,2996,40
19398842687,19398842681,-6,1067,4112,40
19403670309,19403670302,-7,1069,3220,40
19404106471,19404106466,-5,731,3059,40
19421994651,19421994646,-5,1497,2974,40
19422250172,19422250194,22,380,1540,40
19431293354,19431293349,-5,572,1754,40
19432233837,19432233858,21,316,1684,40
19440970230,19440970223,-7,752,4747,40
19441960876,19441960875,-1,228,937,40
19441991048,19441991061,13,348,1237,40
19442647196,19442647190,-6,1081,2731,40
19444625777,19444625770,-7,903,2073,40
19449021215,19449021209,-6,882,4702,40
19453360583,19453360578,-5,1356,3867,40
19464795623,19464795627,4,2389,1460,40
19464836451,19464836454,3,1105,520,40
19466255033,19466255036,3,1712,1617,40
19473816786,19473816780,-6,439,3125,40
19474081094,19474081114,20,901,3801,40
19480049041,19480049034,-7,702,3809,40
19481957751,19481957745,-6,775,3063,40
19490930936,19490930933,-3,893,1744,40
19497594465,19497594480,15,208,827,40
19497914543,19497914538,-5,708,4490,40
19498221431,19498221425,-6,1322,4289,40
19499221835,19499221829,-6,1012,4168,40
19501978922,19501978920,-2,8406,12076,40
19509079587,19509079585,-2,1150,2090,40
19509473399,19509473405,6,298,1069,40
19511432234,19511432229,-5,1008,2904,40
19516418803,19516418798,-5,1295,3516,40
19517881331,19517881325,-6,1109,4273,40
19518863166,19518863159,-7,1130,4435,40
19522149172,19522149166,-6,981,3365,40
19533013521,19533013516,-5,971,2728,40
19533647033,19533647027,-6,911,3526,40
19533839427,19533839422,-5,1186,3445,40
19538330578,19538330573,-5,729,2512,40
19538714355,19538714349,-6,1155,3727,40
19543858688,19543858682,-6,1079,4105,40
19544490774,19544490767,-7,856,4141,40
19544958931,19544958925,-6,1140,3418,40
19552703903,19552703899,-4,80,1800,40
19553091393,19553091387,-6,853,2981,40
19558716506,19558716500,-6,1044,2146,40
19559901176,19559901170,-6,940,2860,40
19570781250,19570781265,15,989,2227,40
19582783979,19582783974,-5,1124,3757,40
19582904141,19582904132,-9,212,1653,40
19589554031,19589554026,-5,1369,3975,40
19589794005,19589794025,20,681,2453,40
19596345434,19596345429,-5,941,4752,40
19596541872,19596541876,4,216,1192,40
19601838193,19601838188,-5,961,3908,40
19602115125,19602115118,-7,1415,4137,40
19602420334,19602420351,17,106,1586,40
19605526852,19605526853,1,1535,2033,40
19605791246,19605791241,-5,1034,3251,40
19606922290,19606922297,7,6117,2697,40
19608498286,19608498282,-4,1060,1868,40
19608931943,19608931961,18,802,3669,40
19614398246,19614398241,-5,706,2508,40
19615985353,19615985347,-6,710,3542,40
19620021336,19620021330,-6,1110,4061,40
19620458926,19620458936,10,549,162,40
19620894383,19620894378,-5,641,3543,40
19621321437,19621321433,-4,1628,2191,40
19622271082,19622271077,-5,976,3658,40
19625676675,19625676667,-8,935,3403,40
19631041551,19631041544,-7,938,2828,40
19632703371,19632703365,-6,593,2833,40
19636545207,19636545201,-6,1328,4077,40
19638546933,19638546942,9,16455,19345,40
19640786378,19640786372,-6,1263,3705,40
19641000227,19641000223,-4,985,3722,40
19645923874,19645923866,-8,824,3295,40
19650000669,19650000662,-7,836,3761,40
19652208250,19652208245,-5,1399,6878,40
19658223343,19658223337,-6,1189,3845,40
19659056522,19659056516,-6,1607,4353,40
19667523046,19667523041,-5,813,4108,40
19667862524,19667862538,14,111,1863,40
19668890262,19668890254,-8,1458,4575,40
19669261806,19669261786,-20,148,1059,40
19683476936,19683476929,-7,1313,3711,40
19695950139,19695950142,3,1891,1762,40
19704256843,19704256838,-5,1278,4010,40
19710804285,19710804279,-6,863,2748,40
19711582343,19711582362,19,93,1356,40
19712100445,19712100464,19,746,2139,40
19712740574,19712740569,-5,967,3069,40
19714290319,19714290310,-9,734,3700,40
19714654180,19714654178,-2,151,1894,40
19716272038,19716272034,-4,1357,3026,40
19719420759,19719420754,-5,1432,5097,40
19723803355,19723803348,-7,927,3717,40
19725512198,19725512193,-5,836,3761,40
19728974479,19728974471,-8,906,3157,40
19730764363,19730764356,-7,1061,3406,40
19731038508,19731038491,-17,231,1316,40
19741046411,19741046391,-20,1780,1429,40
19744382027,19744382020,-7,1355,9691,40
19745229917,19745229933,16,1057,3248,40
19748381556,19748381542,-14,79,1250,40
19764703889,19764703882,-7,1643,7824,40
19765179879,19765179884,5,210,2652,40
19765249894,19765249891,-3,427,1224,40
19776430623,19776430618,-5,836,3359,40
19782582515,19782582522,7,8823,17153,40
19785954401,19785954394,-7,1080,3633,40
19787273703,19787273685,-18,134,2911,40
19798880506,19798880501,-5,1002,2749,40
19802168583,19802168577,-6,683,2726,40
19815085329,19815085324,-5,1178,3153,40
19816543207,19816543201,-6,1044,5028,40
19819568714,19819568708,-6,1520,6748,40
19819616879,19819616892,13,607,3106,40
19820873297,19820873289,-8,997,3378,40
19823834537,19823834538,1,1447,1266,40
19824332248,19824332260,12,854,2230,40
19826833310,19826833305,-5,1237,4315,40
19834451121,19834451117,-4,1125,1947,40
19835458039,19835458034,-5,548,1994,40
19836437661,19836437674,13,20578,23675,40
19837967751,19837967753,2,2288,1851,40
19844927837,19844927831,-6,1261,4115,40
19848152598,19848152590,-8,1014,4055,40
19848785837,19848785830,-7,791,1986,40
19849633109,19849633117,8,296,1103,40
19851634453,19851634449,-4,2097,6340,40
19854563813,19854563807,-6,812,4415,40
19856212838,19856212843,5,1373,1013,40
19865378811,19865378806,-5,931,2584,40
19867420920,19867420933,13,240,1034,40
19868299354,19868299347,-7,1177,3822,40
19868537693,19868537684,-9,1032,4581,40
19869805551,19869805545,-6,941,3294,40
19877202463,19877202470,7,12808,24442,40
19881223297,19881223293,-4,1225,4785,40
19896446340,19896446334,-6,1433,5394,40
19897433658,19897433653,-5,880,3726,40
19897794880,19897794896,16,102,1562,40
19900157040,19900157047,7,319,1151,40
19908106810,19908106806,-4,1318,3847,40
19911041854,19911041854,0,1393,1775,40
19911211579,19911211573,-6,851,3229,40
19912312190,19912312203,13,166,1169,40
19912480030,19912480039,9,85,950,40
19913219423,19913219417,-6,950,4466,40
19917542709,19917542703,-6,983,3445,40
19918213775,19918213775,0,181,1178,40
19918295733,19918295714,-19,66,1082,40
19921646394,19921646388,-6,1335,5102,40
19921831166,19921831185,19,193,1228,40
19925540517,19925540513,-4,889,2850,40
19925704224,19925704235,11,430,1104,40
19925937844,19925937834,-10,786,4435,40
19927702557,19927702550,-7,1395,5497,40
19951124942,19951124933,-9,1532,6011,40
19952563558,19952563553,-5,749,4319,40
19952716373,19952716367,-6,799,3340,40
19963441195,19963441190,-5,1080,2888,40
19970454973,19970454966,-7,929,3816,40
19974817894,19974817889,-5,833,2332,40
19976347119,19976347115,-4,814,2942,40
19987933435,19987933432,-3,391,1070,40
19992685208,19992685201,-7,882,3119,40
19992899932,19992899938,6,268,1229,40
19993369893,19993369885,-8,1033,3897,40
20002605217,20002605213,-4,1060,2164,40
20002732345,20002732337,-8,1059,3565,40
20002893843,20002893836,-7,872,2943,40
20007486556,20007486546,-10,169,997,40
20009233034,20009233029,-5,925,3067,40
20010008094,20010008086,-8,1077,3415,40
20010212744,20010212756,12,2,1038,40
20010716931,20010716925,-6,1206,3278,40
20026411598,20026411590,-8,1095,3543,40
20027493348,20027493370,22,1149,3817,40
20033747570,20033747564,-6,896,4963,40
20036802082,20036802077,-5,1505,5127,40
20041915701,20041915701,0,1398,2158,40
20042899831,20042899825,-6,1177,3928,40
20044619077,20044619074,-3,919,1443,40
20053533425,20053533421,-4,703,2452,40
20053819478,20053819487,9,112,1485,40
20058811350,20058811346,-4,1092,3903,40
20062369374,20062369369,-5,994,3698,40
20069435963,20069435958,-5,1537,4530,40
20084037331,20084037329,-2,1188,2598,40
20086234126,20086234122,-4,761,2433,40
20103002137,20103002130,-7,968,3257,40
20103349727,20103349740,13,753,3610,40
20109777871,20109777863,-8,1081,1780,40
20110268022,20110268033,11,412,3885,40
20113658938,20113658935,-3,1962,2421,40
20114664294,20114664288,-6,704,2796,40
20116417981,20116417986,5,1935,2026,40
20123248451,20123248445,-6,1013,3173,40
20124992324,20124992317,-7,1026,4349,40
20135572590,20135572585,-5,1266,4351,40
20139604458,20139604453,-5,962,3366,40
20142851218,20142851215,-3,517,709,40
20146211611,20146211608,-3,1016,2743,40
20155896215,20155896208,-7,1067,3626,40
20157292144,20157292140,-4,804,2384,40
20157997047,20157997055,8,122,936,40
20159947772,20159947765,-7,979,3441,40
20160214101,20160214110,9,182,1374,40
20168768804,20168768798,-6,918,3736,40
20169875370,20169875364,-6,1169,4686,40
20171242442,20171242444,2,3110,2997,40
20173104546,20173104545,-1,2230,2170,40
20181140049,20181140056,7,2565,905,40
20181801970,20181801965,-5,868,3011,40
20184552090,20184552083,-7,844,3437,40
20191163050,20191163045,-5,1500,3699,40
20192489714,20192489710,-4,981,3000,40
20196134791,20196134786,-5,1225,3445,40
20200951109,20200951102,-7,1242,4754,40
20202085447,20202085440,-7,808,3057,40
20209287591,20209287583,-8,21647,14290,40
20211488894,20211488889,-5,905,2650,40
20217638426,20217638425,-1,1635,2485,40
20217837790,20217837782,-8,441,1464,40
20219242645,20219242648,3,2359,1409,40
20220869295,20220869290,-5,1335,3380,40
20231913210,20231913205,-5,655,2494,40
20232063327,20232063340,13,930,2945,40
20232796045,20232796038,-7,949,3904,40
20233598101,20233598116,15,14388,55508,40
20235705111,20235705128,17,38818,18021,40
20235914524,20235914527,3,2539,1444,40
20246043204,20246043197,-7,918,3942,40
20248625190,20248625191,1,2068,2670,40
20249407798,20249407800,2,2350,2136,40
20262120401,20262120408,7,4504,2299,40
20262364643,20262364638,-5,1206,3759,40
20262400420,20262400402,-18,52,967,40
20265339311,20265339317,6,3557,1994,40
20265750493,20265750499,6,3387,1409,40
20270991071,20270991066,-5,1048,3580,40
20281955121,20281955116,-5,1187,4034,40
20285897032,20285897041,9,301,1444,40
20291569562,20291569557,-5,800,2772,40
20294690493,20294690486,-7,1440,4068,40
20304886393,20304886397,4,2127,1601,40
20307344731,20307344724,-7,747,3220,40
20308890491,20308890483,-8,1118,4177,40
20309887103,20309887097,-6,1019,3798,40
20311221891,20311221883,-8,1010,3588,40
20317295278,20317295279,1,1915,3101,40
20317467534,20317467526,-8,721,4147,40
20318099095,20318099089,-6,1248,4181,40
20324948668,20324948664,-4,991,2948,40
20325714227,20325714219,-8,1159,4481,40
20328657614,20328657609,-5,844,3140,40
20335570178,20335570171,-7,774,5027,40
20342954242,20342954235,-7,896,3586,40
20344245577,20344245571,-6,845,2073,40
20345106239,20345106242,3,136,1443,40
20345748442,20345748436,-6,1138,2489,40
20345828863,20345828847,-16,5,1087,40
20347887727,20347887721,-6,1347,4471,40
20350200313,20350200308,-5,635,3857,40
20359875921,20359875914,-7,44,1041,40
20363658626,20363658622,-4,1313,4906,40
20367349206,20367349202,-4,1481,4765,40
20372282673,20372282669,-4,608,1530,40
20385464446,20385464441,-5,970,2807,40
20387282361,20387282357,-4,1529,2753,40
20388924076,20388924071,-5,971,3570,40
20399386659,20399386655,-4,684,4012,40
20400684453,20400684448,-5,980,3985,40
20402079884,20402079902,18,203,999,40
20402643782,20402643775,-7,1089,3414,40
20403313946,20403313943,-3,4336,10436,40
20406345062,20406345055,-7,990,3214,40
20406765088,20406765082,-6,937,3712,40
20406885060,20406885080,20,241,1275,40
20410469625,20410469626,1,1364,1671,40
20418412039,20418412031,-8,1003,3736,40
20422539278,20422539274,-4,1780,3457,40
20427904443,20427904437,-6,1128,4123,40
20429257656,20429257660,4,50684,52621,40
20431076259,20431076253,-6,1076,4973,40
20431372776,20431372775,-1,98,1236,40
20434361881,20434361885,4,2643,1265,40
20439138526,20439138519,-7,927,4378,40
20440354323,20440354318,-5,1097,4542,40
20440508674,20440508666,-8,1131,4758,40
20446879687,20446879682,-5,1271,2847,40
20446924156,20446924139,-17,158,1119,40
20447569253,20447569251,-2,307,1431,40
20470727133,20470727127,-6,1134,3921,40
20471389124,20471389146,22,144,1317,40
20477367034,20477367038,4,283,1192,40
20478202983,20478202962,-21,157,705,40
20480450702,20480450706,4,3676,14992,40
20488124413,20488124418,5,48,1192,40
20490257443,20490257438,-5,1222,3156,40
20494550916,20494550912,-4,1140,3906,40
20495296671,20495296660,-11,146,995,40
20500958226,20500958221,-5,827,2114,40
20503854706,20503854699,-7,959,4654,40
20504349895,20504349894,-1,59,515,40
20505310270,20505310264,-6,750,3292,40
20511050955,20511050967,12,243,1298,40
20514841794,20514841788,-6,1570,5414,40
20515763659,20515763654,-5,1074,3607,40
20516211951,20516211963,12,266,1233,40
20518423216,20518423210,-6,1274,3818,40
20518544390,20518544402,12,1089,4048,40
20519373910,20519373906,-4,163,761,40
20519715091,20519715086,-5,949,3307,40
20526954312,20526954306,-6,1011,2382,40
20530448542,20530448535,-7,1173,4103,40
20532016754,20532016749,-5,790,3030,40
20532255573,20532255585,12,150,1275,40
20533871370,20533871365,-5,893,5038,40
20535041961,20535041956,-5,1006,4120,40
20536754303,20536754295,-8,1155,3971,40
20537470158,20537470152,-6,1246,4802,40
20544646089,20544646095,6,1668,1133,40
20551614344,20551614337,-7,1082,4288,40
20558332534,20558332529,-5,924,3289,40
20558435855,20558435861,6,31,1129,40
20561895513,20561895508,-5,817,3054,40
20564696260,20564696254,-6,1031,3464,40
20566717517,20566717504,-13,993,3153,40
20566797368,20566797382,14,143,1013,40
20576895964,20576895970,6,8469,21745,40
20580802723,20580802716,-7,1002,3974,40
20580922552,20580922531,-21,177,1190,40
20581474240,20581474242,2,120,1505,40
20581575417,20581575410,-7,657,2873,40
20581653679,20581653667,-12,142,690,40
20582057238,20582057257,19,171,1206,40
20584629650,20584629645,-5,538,3458,40
20585325254,20585325249,-5,1214,4138,40
20587021567,20587021563,-4,1596,3947,40
20605527351,20605527345,-6,1052,3400,40
20608996671,20608996666,-5,497,2209,40
20609813940,20609813921,-19,146,722,40
20612932906,20612932900,-6,623,1718,40
20617986102,20617986094,-8,1027,4652,40
20628955537,20628955539,2,2584,1846,40
20630285559,20630285553,-6,1427,5414,40
20630356014,20630356009,-5,1413,2941,40
20633884654,20633884647,-7,907,3248,40
20634206518,20634206519,1,156,862,40
20634662998,20634663012,14,976,3498,40
20640300430,20640300425,-5,778,4085,40
20643491026,20643491021,-5,701,2325,40
20648812313,20648812307,-6,822,3494,40
20654351215,20654351208,-7,1035,3343,40
20659041042,20659041034,-8,1365,4971,40
20664396877,20664396870,-7,1017,3292,40
20669854637,20669854630,-7,1127,4361,40
20677363549,20677363562,13,200,943,40
20681100535,20681100529,-6,881,5425,40
20684008122,20684008118,-4,1133,3470,40
20684451712,20684451722,10,188,1077,40
20687206843,20687206839,-4,748,3311,40
20703905222,20703905238,16,803,3229,40
20704154075,20704154068,-7,825,4101,40
20705011667,20705011661,-6,1196,3814,40
20705405237,20705405249,12,99,976,40
20708032055,20708032049,-6,1362,3644,40
20712055635,20712055629,-6,854,4388,40
20712178168,20712178165,-3,1250,1349,40
20720960190,20720960182,-8,1149,4250,40
20724352530,20724352525,-5,473,1696,40
20728577373,20728577366,-7,986,3253,40
20730009582,20730009574,-8,1110,4782,40
20740863439,20740863443,4,3527,3468,40
20744282210,20744282206,-4,1172,3413,40
20745296228,20745296230,2,282,1307,40
20746036318,20746036334,16,377,1740,40
20749317784,20749317778,-6,939,2748,40
20750765814,20750765807,-7,1346,3710,40
20751702249,20751702233,-16,260,896,40
20753132148,20753132141,-7,1274,4342,40
20768006618,20768006614,-4,842,3436,40
20770866198,20770866190,-8,923,4524,40
20771108816,20771108834,18,654,2776,40
20772916373,20772916367,-6,1252,3902,40
20777651227,20777651221,-6,1113,3291,40
20781001790,20781001786,-4,1096,5342,40
20783105874,20783105878,4,2966,1790,40
20784030166,20784030159,-7,728,3866,40
20784068256,20784068275,19,697,965,40
20784264807,20784264814,7,52,894,40
20788981005,20788980999,-6,1136,5639,40
20801822956,20801822963,7,2167,994,40
20803986556,20803986557,1,1262,1603,40
20804232018,20804232012,-6,893,3602,40
20804353672,20804353683,11,244,959,40
20811087789,20811087786,-3,1227,3628,40
20813773690,20813773683,-7,1462,4232,40
20827668983,20827668979,-4,863,4505,40
20829079607,20829079602,-5,617,2889,40
20831050451,20831050448,-3,1226,2201,40
20831652797,20831652812,15,719,3013,40
20835524399,20835524394,-5,1052,3221,40
20840113858,20840113853,-5,758,2504,40
20846047098,20846047099,1,1561,1384,40
20847548914,20847548909,-5,847,3210,40
20848816302,20848816294,-8,980,2908,40
20849940455,20849940449,-6,1024,4259,40
20849988513,20849988506,-7,391,1130,40
20851545139,20851545131,-8,1171,6513,40
20851590325,20851590345,20,298,1254,40
20852013891,20852013885,-6,1280,2920,40
20852062293,20852062307,14,324,891,40
20857177097,20857177098,1,1632,1926,40
20865182314,20865182312,-2,902,1491,40
20866319501,20866319516,15,802,3003,40
20867531153,20867531147,-6,851,3629,40
20870892351,20870892346,-5,1498,4185,40
20878419065,20878419058,-7,746,2780,40
20885844643,20885844637,-6,1067,4213,40
20886048711,20886048729,18,164,1368,40
20888838860,20888838856,-4,916,1526,40
20891846930,20891846926,-4,1100,3104,40
20898971766,20898971760,-6,1457,4701,40
20903530671,20903530670,-1,41219,18293,40
20909523254,20909523257,3,1353,1464,40
20911567890,20911567885,-5,5816,16628,40
20919266823,20919266817,-6,1003,4011,40
20919391646,20919391660,14,595,3437,40
20923885546,20923885543,-3,1195,2766,40
20925740643,20925740647,4,2076,1173,40
20927686959,20927686954,-5,944,4150,40
20929124617,20929124611,-6,1201,3813,40
20932681082,20932681078,-4,936,2721,40
20933872330,20933872331,1,1352,1494,40
20941793766,20941793769,3,1405,1575,40
20945020110,20945020105,-5,800,3225,40
20945100438,20945100446,8,192,722,40
20948227237,20948227230,-7,998,3146,40
20955933442,20955933434,-8,685,4080,40
20958897370,20958897379,9,3520,1754,40
20959402447,20959402445,-2,1963,2052,40
20960499565,20960499560,-5,1010,2851,40
20963983743,20963983738,-5,843,3683,40
20976579918,20976579924,6,3855,2017,40
20978782667,20978782661,-6,834,4099,40
20985442045,20985442040,-5,783,3120,40
20990477001,20990476993,-8,132,992,40
20993023881,20993023873,-8,929,2287,40
20993588382,20993588368,-14,125,926,40
20994758072,20994758086,14,464,2379,40
21013699707,21013699699,-8,896,2869,40
21017352871,21017352866,-5,1049,4546,40
21019882443,21019882437,-6,1257,4517,40
21020029868,21020029861,-7,44,475,40
21024610286,21024610289,3,2304,1930,40
21026426499,21026426492,-7,955,3576,40
21034657851,21034657846,-5,1040,3061,40
21035621457,21035621462,5,2179,1731,40
21036751568,21036751561,-7,1191,4378,40
21037188792,21037188786,-6,1388,4479,40
21047795651,21047795642,-9,1010,7364,40
21049507223,21049507218,-5,932,3964,40
21054376958,21054376953,-5,1404,5633,40
21056306005,21056305999,-6,645,2573,40
21063377939,21063377933,-6,895,3539,40
21065172431,21065172425,-6,1210,3278,40
21078641106,21078641107,1,1629,1121,40
21086705002,21086704997,-5,1467,4316,40
21090146028,21090146022,-6,1266,3788,40
21093747171,21093747152,-19,341,896,40
21099722533,21099722526,-7,1391,4744,40
21100320157,21100320177,20,543,3310,40
21104128026,21104128018,-8,1073,4740,40
21121235294,21121235289,-5,713,3265,40
21130541375,21130541367,-8,1037,3730,40
21130636824,21130636838,14,462,1359,40
21132147647,21132147641,-6,601,2066,40
21135975810,21135975805,-5,971,3373,40
21136378723,21136378714,-9,834,2361,40
21139547354,21139547349,-5,1024,2700,40
21139868588,21139868591,3,163,751,40
21144560673,21144560669,-4,871,2616,40
21144748079,21144748083,4,45490,32460,40
21151539980,21151539973,-7,1066,4808,40
21166779671,21166779665,-6,1222,4338,40
21167630304,21167630299,-5,1411,4854,40
21175139078,21175139075,-3,839,1989,40
21176714203,21176714206,3,3913,2721,40
21181026778,21181026773,-5,972,3237,40
21182692277,21182692269,-8,782,3631,40
21187015142,21187015137,-5,726,3184,40
21192437634,21192437628,-6,1101,4395,40
21202705554,21202705549,-5,1075,3377,40
21203087078,21203087098,20,435,1986,40
21206669114,21206669109,-5,1230,4065,40
21210898129,21210898124,-5,1047,4304,40
21212675940,21212675934,-6,958,3848,40
21228149278,21228149273,-5,975,3533,40
21229850570,21229850565,-5,1086,3959,40
21235801986,21235801981,-5,741,2624,40
21237283615,21237283607,-8,884,3879,40
21237411220,21237411242,22,528,3818,40
21238692920,21238692925,5,4029,2195,40
21251255406,21251255402,-4,2450,5377,40
21252883779,21252883774,-5,1133,5183,40
21263693803,21263693795,-8,34676,11862,40
21265387737,21265387731,-6,1185,1940,40
21265555708,21265555711,3,228,1103,40
21268952403,21268952395,-8,604,2152,40
21280244914,21280244907,-7,1070,4195,40
21286660817,21286660798,-19,271,1391,40
21291319871,21291319862,-9,881,2373,40
21301983058,21301983053,-5,1095,4421,40
21302293495,21302293479,-16,1191,3344,40
21310648371,21310648367,-4,1244,1672,40
21314809169,21314809182,13,12801,46156,40
21320751715,21320751709,-6,654,2731,40
21325721217,21325721213,-4,32225,11539,40
21326119822,21326119822,0,3210,3249,40
21334503079,21334503086,7,8631,2528,40
21338387330,21338387323,-7,1118,3317,40
21340059062,21340059064,2,15196,14361,40
21345198557,21345198553,-4,1035,2884,40
21348682958,21348682953,-5,900,3147,40
21349639257,21349639257,0,3141,4713,40
21359074635,21359074637,2,1514,1858,40
21360586165,21360586157,-8,1103,4809,40
21360980174,21360980193,19,441,1398,40
21362270485,21362270479,-6,1044,4200,40
21363393334,21363393336,2,1482,1091,40
21364221866,21364221860,-6,1492,5450,40
21366217890,21366217885,-5,1202,3194,40
21367273118,21367273112,-6,1010,3701,40
21370942006,21370942003,-3,1466,3196,40
21372187868,21372187882,14,711,2441,40
21373307647,21373307646,-1,850,1721,40
21375704666,21375704660,-6,1199,2447,40
21377512593,21377512597,4,1814,1910,40
21377984669,21377984664,-5,1529,3431,40
21381182155,21381182149,-6,941,3015,40
21383442182,21383442178,-4,821,2882,40
21385482810,21385482806,-4,507,1657,40
21390237413,21390237398,-15,901,4740,40
21395004697,21395004691,-6,986,3233,40
21398165121,21398165113,-8,1129,2989,40
21399010027,21399010023,-4,1081,5222,40
21399216446,21399216442,-4,879,3308,40
21399910693,21399910683,-10,546,1608,40
21403348007,21403348002,-5,973,3400,40
21406225302,21406225300,-2,1577,3753,40
21412655694,21412655690,-4,1040,4212,40
21412860550,21412860545,-5,688,4328,40
21416245674,21416245666,-8,874,3052,40
21422940977,21422940971,-6,1235,3810,40
21423121096,21423121112,16,539,3146,40
21423760328,21423760322,-6,1083,3898,40
21427759369,21427759362,-7,1208,3880,40
21433125538,21433125533,-5,1160,4148,40
21433898554,21433898546,-8,614,3186,40
21452148675,21452148669,-6,1059,4810,40
21452766706,21452766698,-8,1342,3956,40
21453155574,21453155558,-16,889,2703,40
21456085953,21456085953,0,1160,1227,40
21460244082,21460244078,-4,1204,4998,40
21463002169,21463002171,2,1481,1615,40
21469167455,21469167450,-5,949,3644,40
21471538801,21471538793,-8,937,4302,40
21476204133,21476204128,-5,858,5263,40
21482005318,21482005319,1,1825,2202,40
21486658371,21486658365,-6,1020,2832,40
21488355566,21488355560,-6,865,3693,40
21488524600,21488524618,18,872,3546,40
21489778777,21489778773,-4,1000,3539,40
21491289702,21491289695,-7,994,2564,40
21492057630,21492057649,19,615,1946,40
21494205661,21494205679,18,104,1053,40
21494813533,21494813527,-6,1435,5557,40
21498877834,21498877827,-7,1017,5203,40
21502097061,21502097067,6,4032,1576,40
21506361500,21506361505,5,1582,1202,40
21507521623,21507521618,-5,579,2530,40
21507695742,21507695762,20,247,1062,40
21508952696,21508952693,-3,944,4920,40
21509646126,21509646125,-1,52,1079,40
21515280398,21515280393,-5,1098,4364,40
21515592397,21515592391,-6,1058,4091,40
21522235507,21522235504,-3,1558,2919,40
21527589636,21527589634,-2,1790,3115,40
21528756758,21528756753,-5,989,4018,40
21529999043,21529999038,-5,994,3374,40
21531784923,21531784918,-5,1368,2551,40
21533187210,21533187203,-7,970,3465,40
21533655854,21533655871,17,235,939,40
21538830419,21538830414,-5,855,3322,40
21541392549,21541392544,-5,1490,4567,40
21543267382,21543267375,-7,670,2164,40
21550135606,21550135602,-4,801,1894,40
21550974478,21550974498,20,101,1103,40
21554622768,21554622764,-4,2390,5611,40
21555210923,21555210929,6,36191,16859,40
21555737903,21555737894,-9,691,2289,40
21556752789,21556752781,-8,1122,4143,40
21557473886,21557473880,-6,1057,5149,40
21568633146,21568633148,2,19555,38834,40
21571559260,21571559253,-7,1177,3540,40
21576654486,21576654478,-8,1077,3972,40
21576935031,21576935031,0,1110,2137,40
21586095891,21586095885,-6,802,2747,40
21613767214,21613767217,3,1622,1640,40
21620381382,21620381377,-5,1288,3305,40
21621362865,21621362859,-6,1352,2541,40
21622901240,21622901258,18,152,1259,40
21623223358,21623223347,-11,194,2757,40
21634133437,21634133433,-4,709,2212,40
21638323882,21638323874,-8,1122,4270,40
21643102138,21643102130,-8,881,4559,40
21651294987,21651294983,-4,754,3928,40
21658782683,21658782677,-6,842,3907,40
21659525644,21659525647,3,253,1123,40
21661242658,21661242654,-4,410,957,40
21664731186,21664731182,-4,677,3249,40
21667247877,21667247869,-8,1259,5331,40
21667727824,21667727818,-6,1305,3399,40
21676157275,21676157269,-6,904,2925,40
21684009227,21684009223,-4,599,2401,40
21691385765,21691385766,1,2422,2855,40
21697481080,21697481074,-6,1171,3439,40
21699180494,21699180475,-19,135,803,40
21701690923,21701690918,-5,911,4529,40
21702772383,21702772367,-16,40,2253,40
21703170709,21703170694,-15,801,1541,40
21705552515,21705552510,-5,1087,3639,40
21705777627,21705777630,3,2074,1608,40
21706155331,21706155325,-6,999,3172,40
21710271140,21710271147,7,3157,1360,40
21715662003,21715661995,-8,621,1873,40
21723439727,21723439728,1,1017,1533,40
21726055604,21726055599,-5,1589,3615,40
21732042833,21732042852,19,941,4539,40
21732353159,21732353153,-6,1433,2384,40
21734505049,21734505051,2,1673,1291,40
21737762266,21737762261,-5,745,2287,40
21739125875,21739125867,-8,779,2895,40
21747774764,21747774758,-6,1291,4506,40
21748039666,21748039661,-5,1095,3304,40
21748441843,21748441838,-5,1035,3643,40
21748581544,21748581534,-10,79,913,40
21751500761,21751500769,8,3118,1540,40
21756793046,21756793039,-7,25481,13285,40
21757267713,21757267706,-7,1286,3394,40
21763414434,21763414429,-5,949,4199,40
21765607040,21765607035,-5,1115,3255,40
21767181537,21767181534,-3,1267,1257,40
21767825882,21767825880,-2,1087,2758,40
21769511663,21769511660,-3,1002,2737,40
21769546100,21769546090,-10,1031,3629,40
21771873466,21771873459,-7,1307,4035,40
21772993401,21772993394,-7,906,3504,40
21774111248,21774111260,12,369,1215,40
21774900694,21774900714,20,116,1283,40
21776547102,21776547095,-7,1205,3496,40
21780894641,21780894637,-4,770,2595,40
21781318980,21781318963,-17,626,1550,40
21785113591,21785113586,-5,1515,2989,40
21787083716,21787083723,7,4208,1647,40
21801850373,21801850373,0,2892,3223,40
21801976335,21801976330,-5,1093,3545,40
21802606165,21802606182,17,734,3398,40
21802797207,21802797201,-6,837,3436,40
21803047311,21803047314,3,159,1068,40
21803886372,21803886370,-2,154,1403,40
21807252807,21807252808,1,1652,2301,40
21813221537,21813221543,6,2957,1894,40
21814973532,21814973544,12,443,1446,40
21822029520,21822029538,18,54,1332,40
21822854923,21822854918,-5,1124,3269,40
21829616770,21829616762,-8,944,2047,40
21832416958,21832416954,-4,1349,3943,40
21842008902,21842008900,-2,888,1661,40
21843931161,21843931167,6,2816,1667,40
21844884971,21844884966,-5,798,3290,40
21848293905,21848293906,1,981,1694,40
21852062486,21852062480,-6,825,3124,40
21852910465,21852910458,-7,1194,2622,40
21852938045,21852938038,-7,746,2518,40
21866014892,21866014889,-3,1140,3501,40
21868136647,21868136642,-5,638,1527,40
21868291276,21868291293,17,293,1178,40
21870623496,21870623490,-6,944,4716,40
21874277526,21874277518,-8,931,3652,40
21875939043,21875939038,-5,1138,3864,40
21888568471,21888568466,-5,1217,3571,40
21889561656,21889561658,2,3974,2813,40
21894050118,21894050110,-8,901,3323,40
21895891215,21895891218,3,12287,9270,40
21897374252,21897374268,16,689,4136,40
21898212098,21898212098,0,1014,1680,40
21908051716,21908051707,-9,754,2375,40
21915375594,21915375587,-7,944,4301,40
21916689289,21916689292,3,2029,1546,40
21918790866,21918790861,-5,755,379,40
21925371888,21925371901,13,376,2178,40
21932029114,21932029114,0,518,1740,40
21935264119,21935264114,-5,1188,3628,40
21936816291,21936816286,-5,944,4244,40
21954148610,21954148609,-1,1182,1803,40
21955703649,21955703645,-4,1494,4752,40
21957726901,21957726895,-6,806,3018,40
21963194106,21963194100,-6,1009,2932,40
21966496799,21966496793,-6,894,3321,40
21967097063,21967097072,9,321,1011,40
21979704470,21979704465,-5,1102,3938,40
21980100917,21980100912,-5,1360,3788,40
21983763403,21983763396,-7,826,2831,40
21986116670,21986116665,-5,1019,2926,40
21996322942,21996322936,-6,753,3482,40
21999612815,21999612809,-6,877,145,40
22006558170,22006558171,1,3481,2897,40
22010668359,22010668353,-6,774,2559,40
22014245989,22014245982,-7,1053,3163,40
22015568317,22015568314,-3,996,1434,40
22015822922,22015822917,-5,903,2427,40
22019024146,22019024147,1,1530,1311,40
22020697404,22020697398,-6,1287,2721,40
22021372402,22021372409,7,2971,996,40
22028306822,22028306814,-8,879,4546,40
22037130731,22037130726,-5,797,3264,40
22047180513,22047180506,-7,910,3953,40
22048039927,22048039918,-9,115,953,40
22048302078,22048302088,10,57,679,40
22050147758,22050147753,-5,929,3386,40
22055456711,22055456706,-5,343,1083,40
22062691223,22062691217,-6,891,3347,40
22063983110,22063983106,-4,887,1736,40
22064388811,22064388813,2,1793,1466,40
22065964435,22065964431,-4,776,2803,40
22068290457,22068290452,-5,1263,4509,40
22071548001,22071548006,5,2056,1025,40
22073663809,22073663801,-8,952,2481,40
22075389430,22075389449,19,848,3165,40
22076111194,22076111190,-4,1175,3692,40
22085755749,22085755752,3,2288,1917,40
22087402315,22087402312,-3,1151,3210,40
22087567126,22087567123,-3,2261,3578,40
22089859839,22089859834,-5,1154,4490,40
22090047373,22090047366,-7,1415,3590,40
22095085931,22095085926,-5,1235,3720,40
22095676795,22095676788,-7,830,4340,40
22095880671,22095880670,-1,238,1811,40
22101011475,22101011469,-6,1135,4369,40
22106685883,22106685877,-6,923,3228,40
22106972131,22106972123,-8,940,2971,40
22108614930,22108614924,-6,2210,8425,40
22112199157,22112199164,7,11284,3478,40
22117418548,22117418561,13,1994,1117,40
22128881259,22128881253,-6,1277,4365,40
22130367515,22130367509,-6,1547,4661,40
22131572039,22131572032,-7,1198,3951,40
22131894047,22131894035,-12,115,884,40
22134062793,22134062789,-4,1079,4743,40
22136676258,22136676253,-5,1183,3676,40
22137619090,22137619093,3,2511,1861,40
22138163891,22138163886,-5,1036,3375,40
22138276614,22138276615,1,1278,1200,40
22138345258,22138345253,-5,761,3049,40
22140432135,22140432129,-6,1285,4787,40
22151692090,22151692086,-4,1166,3501,40
22153582995,22153582987,-8,970,3383,40
22153912873,22153912867,-6,736,3692,40
22161157710,22161157702,-8,793,1953,40
22162590197,22162590215,18,738,5218,40
22165198496,22165198491,-5,1130,1797,40
22165916065,22165916061,-4,1533,4991,40
22166190995,22166190989,-6,842,3774,40
22168146686,22168146679,-7,1104,4894,40
22174498931,22174498911,-20,370,1046,40
22176899875,22176899869,-6,880,3077,40
22186679159,22186679142,-17,2583,895,40
22191180342,22191180334,-8,908,3588,40
22200845054,22200845047,-7,991,2528,40
22202959196,22202959189,-7,1102,4012,40
22204280498,22204280493,-5,1098,4540,40
22209268614,22209268609,-5,1112,4790,40
22211031604,22211031597,-7,898,2754,40
22212101134,22212101130,-4,807,3772,40
22213419587,22213419581,-6,1175,4226,40
22213624037,22213624018,-19,199,1232,40
22215474094,22215474090,-4,1231,5072,40
22216309381,22216309382,1,3516,2892,40
22220674059,22220674053,-6,1516,5915,40
22221173719,22221173714,-5,983,2756,40
22221638861,22221638877,16,794,4094,40
22225369958,22225369953,-5,1146,3759,40
22227794706,22227794702,-4,1148,3285,40
22227934696,22227934695,-1,1274,1889,40
22231664961,22231664954,-7,1293,4289,40
22244643869,22244643863,-6,1310,4642,40
22245592142,22245592137,-5,859,3637,40
22245947223,22245947241,18,348,847,40
22247499898,22247499902,4,1190,793,40
22247609942,22247609946,4,2565,1237,40
22249274490,22249274485,-5,1072,4306,40
22254688593,22254688584,-9,1114,3046,40
22257360518,22257360518,0,1101,1912,40
22258203181,22258203193,12,172,1859,40
22261099602,22261099596,-6,1018,3782,40
22265115400,22265115394,-6,1006,2251,40
22269820734,22269820726,-8,1202,5322,40
22270355441,22270355449,8,7205,3092,40
22271602518,22271602514,-4,707,2765,40
22279491647,22279491639,-8,680,3731,40
22279917956,22279917945,-11,153,912,40
22282649685,22282649682,-3,2006,4315,40
22285627006,22285627001,-5,1360,4452,40
22289328612,22289328611,-1,2906,3887,40
22294119258,22294119254,-4,667,2491,40
22295711316,22295711309,-7,1135,5079,40
22303669950,22303669944,-6,1359,2771,40
22304334390,22304334407,17,408,1264,40
22308539749,22308539744,-5,1275,5014,40
22308874402,22308874395,-7,1147,3864,40
22310448453,22310448446,-7,854,3601,40
22323829478,22323829478,0,3734,16825,40
22323979789,22323979782,-7,1055,4065,40
22324889841,22324889835,-6,758,2200,40
22326883750,22326883756,6,12887,21555,40
22328476083,22328476078,-5,1668,4801,40
22331825096,22331825091,-5,1565,5893,40
22332235081,22332235076,-5,1072,3139,40
22333450951,22333450946,-5,950,3640,40
22347892878,22347892875,-3,729,1154,40
22348257420,22348257415,-5,852,2657,40
22349848650,22349848646,-4,1045,2690,40
22352032642,22352032642,0,1811,1956,40
22355257985,22355257978,-7,1046,5303,40
22355748745,22355748739,-6,1218,3076,40
22357851301,22357851295,-6,1409,4270,40
22358529578,22358529569,-9,1180,3893,40
22359429499,22359429493,-6,996,2488,40
22363496526,22363496525,-1,1354,1975,40
22367270306,22367270301,-5,1108,3741,40
22367319310,22367319306,-4,390,1467,40
22369666278,22369666273,-5,1214,3737,40
22371772142,22371772136,-6,1324,4649,40
22373154278,22373154273,-5,1130,3924,40
22373744030,22373744017,-13,949,3448,40
22374135984,22374135989,5,2195,1456,40
22380705210,22380705203,-7,1031,3781,40
22389084857,22389084850,-7,917,3089,40
22393993539,22393993530,-9,274,2207,40
22400473477,22400473470,-7,718,3344,40
22406174458,22406174454,-4,1032,4090,40
22408617759,22408617759,0,1074,1707,40
22420399489,22420399482,-7,1096,5345,40
22421923990,22421923983,-7,784,4163,40
22422867245,22422867241,-4,891,3018,40
22424122406,22424122398,-8,1265,5319,40
22433086034,22433086027,-7,1100,4898,40
22434484890,22434484886,-4,601,1749,40
22436572563,22436572555,-8,964,4867,40
22442680339,22442680334,-5,1058,2661,40
22443502550,22443502570,20,358,1122,40
22445512314,22445512307,-7,769,3161,40
22446419702,22446419697,-5,885,3672,40
22449233962,22449233957,-5,955,3621,40
22451741941,22451741934,-7,1289,4997,40
22451856623,22451856618,-5,1088,3500,40
22452003861,22452003881,20,864,3372,40
22452765664,22452765676,12,539,1828,40
22460148939,22460148932,-7,1465,4751,40
22472264730,22472264723,-7,1211,2804,40
22472959039,22472959034,-5,1027,4085,40
22473046756,22473046774,18,96,1318,40
22474692814,22474692811,-3,259,1086,40
22474871252,22474871246,-6,140,1025,40
22477836425,22477836420,-5,1086,3606,40
22490892875,22490892870,-5,1075,3294,40
22491854634,22491854635,1,1047,1010,40
22492032345,22492032351,6,52224,19480,40
22497633466,22497633457,-9,804,3222,40
22497912822,22497912817,-5,1176,3807,40
22504932042,22504932037,-5,1258,5236,40
22505417625,22505417619,-6,718,3855,40
22505491567,22505491558,-9,1046,3606,40
22506277782,22506277794,12,29,976,40
22507912142,22507912162,20,836,4698,40
22508113686,22508113674,-12,1061,3619,40
22509951659,22509951650,-9,613,1861,40
22510221533,22510221547,14,593,2105,40
22512333855,22512333849,-6,747,3493,40
22513866482,22513866478,-4,1953,4896,40
22514887026,22514887021,-5,1276,4599,40
22519270902,22519270897,-5,1082,1967,40
22528191069,22528191062,-7,748,3330,40
22530230605,22530230598,-7,900,4588,40
22537693463,22537693457,-6,947,3130,40
22537927292,22537927314,22,439,1439,40
22538697501,22538697495,-6,1112,4679,40
22542733403,22542733398,-5,2189,5810,40
22543714897,22543714900,3,1408,1658,40
22549398498,22549398498,0,1988,2385,40
22550271186,22550271179,-7,932,3146,40
22552665213,22552665213,0,1319,1807,40
22560477085,22560477085,0,2343,2873,40
22561368233,22561368226,-7,598,3577,40
22562779678,22562779682,4,2155,1253,40
22571729902,22571729906,4,2097,1763,40
22575794503,22575794509,6,2608,1655,40
22577661402,22577661397,-5,893,3036,40
22588962460,22588962454,-6,673,3037,40
22592564963,22592564957,-6,923,2684,40
22593100902,22593100889,-13,1046,3559,40
22600126867,22600126862,-5,1153,3721,40
22602182163,22602182158,-5,872,3425,40
22611610491,22611610485,-6,909,3500,40
22615715490,22615715485,-5,1218,4401,40
22624286091,22624286086,-5,1259,3290,40
22629580662,22629580657,-5,1169,3769,40
22634453838,22634453830,-8,930,2881,40
22648078993,22648078987,-6,1048,4756,40
22649903146,22649903138,-8,1331,4877,40
22650177293,22650177273,-20,172,1443,40
22650882974,22650882968,-6,1243,5944,40
22655696831,22655696826,-5,794,3081,40
22656935206,22656935226,20,655,1235,40
22659143415,22659143410,-5,1444,4386,40
22660568386,22660568377,-9,1047,4709,40
22661162070,22661162075,5,236,956,40
22662034300,22662034322,22,644,3223,40
22667034670,22667034669,-1,1339,1655,40
22672048338,22672048333,-5,776,3187,40
22679080585,22679080586,1,1288,1885,40
22681964697,22681964693,-4,23809,15397,40
22683810127,22683810125,-2,1869,3657,40
22685992658,22685992653,-5,989,3812,40
22688305131,22688305127,-4,845,2492,40
22690862300,22690862294,-6,1021,3905,40
22695715629,22695715621,-8,807,3768,40
22698626248,22698626245,-3,2122,4641,40
22698772118,22698772106,-12,937,757,40
22704642235,22704642229,-6,810,2874,40
22705111374,22705111367,-7,1290,4565,40
22720796619,22720796614,-5,1099,3409,40
22721295742,22721295758,16,715,4217,40
22729512835,22729512830,-5,1035,4717,40
22733084158,22733084151,-7,1120,3987,40
22735989650,22735989654,4,1723,1091,40
22751746057,22751746053,-4,1059,3585,40
22752626527,22752626519,-8,823,3293,40
22752696740,22752696733,-7,969,3812,40
22753418041,22753418034,-7,717,2221,40
22754166140,22754166133,-7,1213,3835,40
22755618832,22755618839,7,3974,1719,40
22757578042,22757578037,-5,1117,3651,40
22757900431,22757900409,-22,156,1651,40
22764548531,22764548529,-2,1557,3113,40
22779686958,22779686953,-5,1066,3985,40
22779790950,22779790965,15,1192,5178,40
22783847401,22783847395,-6,934,3366,40
22784452835,22784452830,-5,540,3025,40
22785138743,22785138743,0,2840,3472,40
22785686077,22785686073,-4,1686,3837,40
22788504446,22788504438,-8,2029,8380,40
22789283453,22789283446,-7,1287,4820,40
22790745452,22790745450,-2,1647,1748,40
22791088152,22791088169,17,514,2605,40
22800074178,22800074172,-6,734,2751,40
22805889074,22805889067,-7,862,2706,40
22807214425,22807214419,-6,959,3424,40
22807605854,22807605855,1,8182,8420,40
22812373029,22812373022,-7,1065,5355,40
22812739610,22812739604,-6,904,3791,40
22814727804,22814727798,-6,1289,4215,40
22817393902,22817393895,-7,786,2582,40
22818949191,22818949187,-4,953,2950,40
22819728324,22819728345,21,869,4036,40
22819908943,22819908958,15,608,2315,40
22823148414,22823148409,-5,620,2155,40
22830872822,22830872816,-6,1527,4233,40
22842070755,22842070750,-5,874,4646,40
22846647530,22846647526,-4,1107,4615,40
22846988014,22846988007,-7,966,4174,40
22847931235,22847931230,-5,928,3317,40
22848471857,22848471861,4,2082,1691,40
22848554554,22848554550,-4,1175,3789,40
22849322477,22849322481,4,2121,2404,40
22857469896,22857469890,-6,927,3120,40
22864761776,22864761793,17,217,1031,40
22865355937,22865355931,-6,919,4872,40
22872931258,22872931254,-4,866,2732,40
22881467581,22881467576,-5,16421,16043,40
22884557266,22884557259,-7,1032,4393,40
22884800856,22884800850,-6,677,3788,40
22889610519,22889610511,-8,1114,3207,40
22892719523,22892719519,-4,1119,3325,40
22895207549,22895207541,-8,1146,5051,40
22898548527,22898548520,-7,782,3774,40
22899826503,22899826501,-2,1333,3639,40
22903219253,22903219266,13,18277,29638,40
22904341055,22904341053,-2,1110,2852,40
22905538213,22905538210,-3,1231,2395,40
22916490264,22916490258,-6,1304,4173,40
22917345654,22917345650,-4,988,3030,40
22919951966,22919951959,-7,1768,3944,40
22919986766,22919986759,-7,1569,4469,40
22927725737,22927725730,-7,1343,3981,40
22930253901,22930253899,-2,1321,2313,40
22930430420,22930430405,-15,110,939,40
22931244623,22931244615,-8,757,2647,40
22931547496,22931547490,-6,893,3114,40
22940857879,22940857874,-5,1093,3955,40
22954378800,22954378822,22,293,1379,40
22955888730,22955888723,-7,1243,5303,40
22959369661,22959369656,-5,1474,4090,40
22959891832,22959891823,-9,54,1486,40
22962850509,22962850504,-5,1196,2951,40
22965321810,22965321816,6,4902,1569,40
22968235867,22968235858,-9,596,4197,40
22972787085,22972787081,-4,1116,2711,40
22983254846,22983254852,6,3134,1149,40
22988877729,22988877722,-7,813,3629,40
22990432709,22990432698,-11,5,1451,40
22991389822,22991389815,-7,770,3573,40
22993006634,22993006629,-5,917,3250,40
22993062815,22993062818,3,7,1415,40
22996859790,22996859783,-7,1065,4289,40
23003146287,23003146282,-5,1057,5113,40
23003307782,23003307793,11,292,1436,40
23005547589,23005547582,-7,1047,3104,40
23006748575,23006748565,-10,179,1159,40
23007240908,23007240897,-11,1079,3168,40
23014642120,23014642141,21,14359,52608,40
23019929878,23019929873,-5,808,2988,40
23036455775,23036455771,-4,1228,4015,40
23040801301,23040801294,-7,1031,3934,40
23041227965,23041227962,-3,32123,13474,40
23041547250,23041547245,-5,963,3368,40
23042792811,23042792805,-6,1000,4266,40
23043520669,23043520673,4,683,1494,40
23043814071,23043814083,12,1130,4752,40
23048550204,23048550198,-6,1163,4157,40
23060040850,23060040847,-3,628,1445,40
23065585944,23065585938,-6,1369,4458,40
23065858173,23065858188,15,934,3912,40
23067243515,23067243508,-7,1083,5147,40
23068107628,23068107621,-7,436,1154,40
23068389128,23068389137,9,97,891,40
23068532533,23068532530,-3,1281,2302,40
23069991311,23069991306,-5,1025,3193,40
23073970215,23073970209,-6,1040,4616,40
23074243935,23074243939,4,84,1219,40
23075467382,23075467375,-7,615,3620,40
23077184991,23077184988,-3,889,2696,40
23082931651,23082931645,-6,1089,4774,40
23097523206,23097523201,-5,1088,3258,40
23098906700,23098906693,-7,465,2059,40
23098942390,23098942407,17,433,1049,40
23100233630,23100233625,-5,1129,3134,40
23109500597,23109500597,0,1321,1491,40
23109556636,23109556630,-6,112,1157,40
23110394838,23110394833,-5,914,2745,40
23124554898,23124554894,-4,1218,2289,40
23126612289,23126612285,-4,1153,2510,40
23127063090,23127063086,-4,1441,4826,40
23135279479,23135279479,0,209,1170,40
23138623395,23138623390,-5,961,3604,40
23147510862,23147510854,-8,956,4345,40
23147681240,23147681252,12,467,1868,40
23154153898,23154153893,-5,982,3479,40
23165835691,23165835685,-6,1284,4334,40
23173945527,23173945527,0,472,1318,40
23176967519,23176967514,-5,1626,7355,40
23191261113,23191261106,-7,1179,4162,40
23191952284,23191952297,13,73,1205,40
23206013345,23206013339,-6,1061,3945,40
23206195143,23206195141,-2,1926,3758,40
23207874627,23207874621,-6,1046,2888,40
23208453049,23208453041,-8,1026,3381,40
23212495440,23212495453,13,926,4234,40
23215387225,23215387229,4,3261,2265,40
23216221083,23216221085,2,744,481,40
23231254783,23231254785,2,1284,1494,40
23231923070,23231923070,0,802,1750,40
23235732361,23235732355,-6,1041,3400,40
23237025542,23237025538,-4,890,3276,40
23237501487,23237501506,19,707,3056,40
23242317647,23242317641,-6,1100,4477,40
23254424858,23254424853,-5,714,3159,40
23254603439,23254603457,18,821,4278,40
23256035027,23256035021,-6,902,3415,40
23272871696,23272871686,-10,1008,4172,40
23272948134,23272948146,12,206,1389,40
23274096386,23274096381,-5,733,3615,40
23274256628,23274256615,-13,162,1110,40
23278717572,23278717566,-6,942,4067,40
23280098883,23280098877,-6,1049,3602,40
23282186853,23282186841,-12,206,1155,40
23286602768,23286602762,-6,1185,4155,40
23291001358,23291001339,-19,90,835,40
23292570466,23292570463,-3,784,1806,40
23297015803,23297015800,-3,1825,4334,40
23301140990,23301140993,3,2865,2561,40
23306688920,23306688916,-4,1065,2651,40
23308250322,23308250330,8,9084,25956,40
23319625754,23319625750,-4,745,3142,40
23324782079,23324782074,-5,756,2506,40
23326708358,23326708354,-4,497,2023,40
23331806269,23331806265,-4,1512,4328,40
23339075998,23339075993,-5,1067,3217,40
23341227303,23341227297,-6,1248,4229,40
23346069895,23346069909,14,315,1816,40
23348336450,23348336443,-7,1461,4645,40
23351783028,23351783022,-6,1164,3317,40
23352414693,23352414689,-4,1017,3927,40
23353180414,23353180415,1,263,1344,40
23380665559,23380665550,-9,1015,3450,40
23381138910,23381138899,-11,219,1148,40
23385418606,23385418599,-7,1157,5103,40
23387929994,23387929989,-5,1113,3894,40
23397645511,23397645506,-5,1127,2038,40
23397877642,23397877636,-6,908,4109,40
23398199755,23398199750,-5,1056,2616,40
23398229827,23398229824,-3,1108,2694,40
23398359829,23398359841,12,658,2388,40
23399088830,23399088827,-3,765,2160,40
23400968815,23400968820,5,2475,1747,40
23401628169,23401628161,-8,1061,3817,40
23416323336,23416323330,-6,1428,4487,40
23416851610,23416851605,-5,1268,5550,40
23426978079,23426978073,-6,600,2921,40
23427278718,23427278714,-4,1165,2859,40
23427887073,23427887078,5,2479,1211,40
23435434138,23435434133,-5,1255,3147,40
23444040167,23444040162,-5,925,3310,40
23451013234,23451013229,-5,923,2132,40
23451450437,23451450425,-12,131,1034,40
23455489678,23455489671,-7,802,3682,40
23455578021,23455578038,17,1020,4570,40
23469014099,23469014094,-5,1045,2933,40
23471817870,23471817863,-7,1208,4854,40
23472566982,23472566993,11,570,3804,40
23472687053,23472687045,-8,1539,5232,40
23474733389,23474733382,-7,797,2322,40
23481562746,23481562741,-5,1167,5017,40
23484608601,23484608596,-5,696,3198,40
23492266690,23492266685,-5,1222,3343,40
23510464290,23510464284,-6,1474,4427,40
23512490845,23512490840,-5,800,3585,40
23518607668,23518607669,1,1786,1880,40
23519700850,23519700848,-2,2646,4547,40
23520056497,23520056491,-6,1426,4227,40
23520478973,23520478967,-6,974,4503,40
23532365714,23532365710,-4,1307,5266,40
23534790331,23534790322,-9,1211,3759,40
23535108304,23535108321,17,919,3605,40
23535814423,23535814425,2,207,1231,40
23537238856,23537238851,-5,1107,3720,40
23537676685,23537676702,17,653,2819,40
23538265886,23538265882,-4,24646,11239,40
23547541750,23547541744,-6,1318,3301,40
23551668250,23551668245,-5,918,3030,40
23556140215,23556140207,-8,931,3656,40
23556986477,23556986461,-16,209,963,40
23560841682,23560841683,1,1243,2753,40
23561508421,23561508419,-2,14,707,40
23561728438,23561728433,-5,1101,4765,40
23564956302,23564956295,-7,1160,1579,40
23566631769,23566631765,-4,1332,1760,40
23567743946,23567743944,-2,1364,2272,40
23572409410,23572409403,-7,1057,3404,40
23577517569,23577517563,-6,1137,3908,40
23577903415,23577903431,16,195,1185,40
23582265651,23582265646,-5,1152,4098,40
23582564853,23582564870,17,629,2992,40
23584049543,23584049541,-2,801,1945,40
23585043350,23585043347,-3,1093,3322,40
23595266268,23595266262,-6,870,4966,40
23595424452,23595424466,14,316,1247,40
23595532629,23595532627,-2,269,1521,40
23596237006,23596237024,18,1602,3704,40
23596991658,23596991650,-8,1143,6699,40
23598713186,23598713179,-7,802,2257,40
23599174341,23599174354,13,850,2726,40
23599733993,23599733989,-4,1212,3119,40
23601135073,23601135068,-5,1112,3471,40
23601425448,23601425466,18,217,1381,40
23605603914,23605603919,5,1318,1346,40
23605650282,23605650276,-6,992,6171,40
23606632095,23606632109,14,430,1919,40
23612612528,23612612521,-7,720,2816,40
23617519155,23617519146,-9,511,4618,40
23626605665,23626605685,20,519,1699,40
23628476757,23628476751,-6,1171,3277,40
23628526467,23628526461,-6,810,3397,40
23628633959,23628633948,-11,674,3799,40
23629588667,23629588661,-6,979,3029,40
23637559228,23637559224,-4,1666,3369,40
23644108728,23644108747,19,432,2099,40
23647589955,23647589951,-4,652,1174,40
23649853614,23649853609,-5,1033,3499,40
23653792614,23653792609,-5,1303,4061,40
23655826988,23655826981,-7,1124,4296,40
23663564340,23663564346,6,29373,21598,40
23665427766,23665427762,-4,1127,3125,40
23666930222,23666930223,1,1708,2503,40
23671888710,23671888703,-7,1204,4957,40
23677613662,23677613662,0,1194,2064,40
23677846200,23677846219,19,548,1189,40
23681042672,23681042667,-5,1069,2302,40
23686525183,23686525177,-6,908,3851,40
23689077691,23689077690,-1,827,2017,40
23705983536,23705983530,-6,1335,6322,40
23707724165,23707724161,-4,1197,4050,40
23720333107,23720333101,-6,1054,2716,40
23720366638,23720366634,-4,863,2334,40
23720426852,23720426870,18,230,1769,40
23740189505,23740189499,-6,1186,4069,40
23740588214,23740588218,4,308,1949,40
23748121676,23748121673,-3,5280,10272,40
23754343788,23754343783,-5,831,3433,40
23754901697,23754901695,-2,1516,1825,40
23755501670,23755501688,18,988,4741,40
23761180109,23761180113,4,4412,2987,40
23764348911,23764348906,-5,1417,3190,40
23767824719,23767824714,-5,1170,3664,40
23769309007,23769309001,-6,790,3169,40
23769563285,23769563270,-15,1241,3347,40
23770278848,23770278850,2,104,1084,40
23771780605,23771780627,22,98,772,40
23774267658,23774267653,-5,994,3647,40
23777028495,23777028499,4,1221,663,40
23777348934,23777348929,-5,447,1183,40
23782188677,23782188684,7,8355,2104,40
23782385511,23782385505,-6,1091,4438,40
23786602098,23786602091,-7,1415,4526,40
23787254659,23787254653,-6,439,1455,40
23789142315,23789142307,-8,1391,3603,40
23797779009,23797779004,-5,1206,3335,40
23797824580,23797824565,-15,1209,3724,40
23798018284,23798018305,21,544,3960,40
23812426989,23812426982,-7,1002,4774,40
23820586623,23820586618,-5,985,4237,40
23821359395,23821359389,-6,895,4033,40
23822649486,23822649505,19,2140,296,40
23830541315,23830541310,-5,915,2877,40
23835122988,23835122982,-6,924,3841,40
23851847369,23851847362,-7,1792,5485,40
23857020182,23857020178,-4,928,3880,40
23857523409,23857523424,15,1830,1195,40
23859751479,23859751474,-5,1029,4554,40
23860411118,23860411106,-12,1331,3803,40
23868819747,23868819742,-5,1386,3057,40
23870957661,23870957656,-5,804,2685,40
23880757761,23880757761,0,6302,21051,40
23887035957,23887035949,-8,1014,4176,40
23887271374,23887271390,16,124,1516,40
23891955478,23891955474,-4,841,4335,40
23894883609,23894883606,-3,912,2614,40
23897085485,23897085477,-8,1367,3527,40
23906385305,23906385299,-6,1328,3267,40
23908112266,23908112259,-7,820,2318,40
23908465777,23908465777,0,1064,1925,40
23926178581,23926178575,-6,720,2261,40
23930252596,23930252590,-6,924,2620,40
23937809538,23937809532,-6,1019,5067,40
23942550493,23942550487,-6,1399,3793,40
23945454147,23945454146,-1,1307,1591,40
23947930118,23947930110,-8,743,3390,40
23948025181,23948025171,-10,244,1140,40
23952907229,23952907230,1,1043,1285,40
23953464392,23953464407,15,650,2951,40
23954206719,23954206725,6,3260,1499,40
23956014837,23956014832,-5,1116,2874,40
23967084710,23967084706,-4,963,3003,40
23967484539,23967484516,-23,2525,1813,40
23967948637,23967948630,-7,941,3314,40
23970846091,23970846085,-6,777,2925,40
23972576918,23972576919,1,3001,2947,40
23973284527,23973284521,-6,2121,9717,40
23976210695,23976210689,-6,941,3768,40
23979587722,23979587716,-6,1291,4311,40
23980167342,23980167355,13,308,1389,40
23980800624,23980800616,-8,1160,6832,40
23988534559,23988534549,-10,42848,10716,40
23990792104,23990792107,3,1514,1208,40
23993536177,23993536171,-6,902,3908,40
23994641592,23994641609,17,581,1943,40
24001097890,24001097885,-5,1198,4542,40
24001220985,24001220982,-3,1244,2702,40
24002962530,24002962526,-4,1232,2161,40
24004758818,24004758813,-5,895,3612,40
24007393727,24007393721,-6,941,4798,40
24009361544,24009361537,-7,867,2323,40
24015297991,24015297973,-18,43,1161,40
24015695571,24015695566,-5,968,3768,40
24022962926,24022962921,-5,1011,3240,40
24024851463,24024851463,0,320,1394,40
24026274631,24026274626,-5,1089,3131,40
24026510099,24026510093,-6,1046,3731,40
24026870602,24026870597,-5,1161,2907,40
24028647302,24028647297,-5,948,3905,40
24033835530,24033835524,-6,1190,4122,40
24037462454,24037462449,-5,771,2090,40
24038782354,24038782358,4,2230,1110,40
24039557367,24039557361,-6,1354,3210,40
24046510439,24046510442,3,25602,18960,40
24054315703,24054315699,-4,742,2610,40
24055322677,24055322672,-5,747,3332,40
24056504401,24056504394,-7,664,3032,40
24060970998,24060970999,1,2171,1573,40
24061142325,24061142331,6,8756,35140,40
24062861691,24062861686,-5,837,3353,40
24064500332,24064500322,-10,943,3529,40
24064782852,24064782846,-6,1116,3054,40
24065828560,24065828578,18,532,2473,40
24065901067,24065901062,-5,877,2783,40
24067102722,24067102726,4,23947,19771,40
24068223921,24068223914,-7,982,4399,40
24073413171,24073413172,1,2110,2417,40
24078672710,24078672715,5,3437,1538,40
24083280507,24083280503,-4,1118,4220,40
24085148676,24085148669,-7,644,3864,40
24090347506,24090347502,-4,784,1657,40
24093549610,24093549608,-2,21002,9190,40
24098605631,24098605626,-5,844,2564,40
24099024456,24099024472,16,595,2903,40
24099239737,24099239730,-7,1405,3979,40
24100320614,24100320612,-2,2140,4453,40
24103040514,24103040508,-6,1099,3152,40
24112455583,24112455578,-5,827,3295,40
24113028470,24113028465,-5,1029,4232,40
24113218982,24113218978,-4,900,3561,40
24113599375,24113599366,-9,1150,3185,40
24118403543,24118403538,-5,568,2283,40
24128929806,24128929801,-5,1103,3193,40
24134713214,24134713219,5,1408,1314,40
24135520020,24135520038,18,524,2193,40
24135776286,24135776266,-20,263,1003,40
24136943645,24136943644,-1,249,1228,40
24138786273,24138786266,-7,1070,3536,40
24148655643,24148655637,-6,1278,3620,40
24153538614,24153538608,-6,1468,3971,40
24162527806,24162527799,-7,864,3885,40
24166470738,24166470732,-6,1362,3336,40
24171048909,24171048907,-2,1165,2247,40
24172691311,24172691306,-5,1073,3297,40
24176488874,24176488868,-6,952,3607,40
24179550898,24179550893,-5,961,3726,40
24180100322,24180100327,5,1999,957,40
24180826332,24180826342,10,153,910,40
24184118504,24184118511,7,3347,1497,40
24187627717,24187627712,-5,829,2940,40
24197491086,24197491094,8,2814,844,40
24198640460,24198640471,11,14367,40740,40
24199589610,24199589606,-4,868,2132,40
24200106062,24200106083,21,405,989,40
24204803741,24204803737,-4,1191,3791,40
24205446246,24205446265,19,1385,5070,40
24211493626,24211493620,-6,646,2961,40
24223572433,24223572427,-6,709,2471,40
24230500542,24230500535,-7,831,3189,40
24234021894,24234021890,-4,1047,3239,40
24237025999,24237025994,-5,995,4480,40
24251606639,24251606634,-5,821,2967,40
24251746667,24251746660,-7,951,4201,40
24259664386,24259664382,-4,990,3643,40
24259871816,24259871809,-7,908,2767,40
24264465790,24264465785,-5,773,4341,40
24266701102,24266701119,17,86,1359,40
24272906523,24272906518,-5,879,3104,40
24275334132,24275334131,-1,1323,1959,40
24276270385,24276270384,-1,2102,4418,40
24279680980,24279680974,-6,1240,3775,40
24279895249,24279895254,5,5453,4145,40
24281921056,24281921056,0,4789,18451,40
24282674536,24282674529,-7,1575,4730,40
24283358106,24283358100,-6,852,5060,40
24286526694,24286526693,-1,791,1408,40
24288627123,24288627121,-2,1163,2324,40
24289989495,24289989489,-6,1009,4165,40
24291354694,24291354690,-4,1197,3020,40
24291429815,24291429810,-5,1216,3318,40
24294283719,24294283713,-6,813,4218,40
24294762760,24294762772,12,306,1282,40
24300946247,24300946242,-5,1061,3782,40
24307321193,24307321186,-7,1119,4620,40
24311433337,24311433330,-7,967,3490,40
24314215482,24314215476,-6,953,3642,40
24314794478,24314794499,21,64,988,40
24316129016,24316129010,-6,1057,4186,40
24326415512,24326415507,-5,1103,3424,40
24330644663,24330644658,-5,966,3552,40
24335466235,24335466230,-5,1312,4615,40
24335934494,24335934505,11,171,1608,40
24336293711,24336293721,10,144,1044,40
24336943232,24336943251,19,236,1118,40
24340319284,24340319280,-4,700,3353,40
24350027054,24350027049,-5,818,3767,40
24351613236,24351613257,21,863,5016,40
24359027482,24359027477,-5,875,4190,40
24359369023,24359369033,10,421,1314,40
24361896816,24361896810,-6,1088,3838,40
24366683045,24366683049,4,3229,1545,40
24368813361,24368813358,-3,722,2741,40
24370946102,24370946097,-5,687,2522,40
24371731936,24371731945,9,572,3044,40
24377757942,24377757939,-3,2453,4483,40
24379246334,24379246328,-6,1450,6081,40
24381979086,24381979081,-5,720,3289,40
24385914908,24385914904,-4,1379,3980,40
24392025839,24392025834,-5,1141,4239,40
24397583387,24397583389,2,1442,1606,40
24400313936,24400313930,-6,800,3875,40
24400405012,24400405035,23,218,866,40
24405016306,24405016300,-6,1014,4021,40
24405412794,24405412787,-7,991,3243,40
24406340558,24406340571,13,666,1738,40
24409595623,24409595617,-6,1143,3846,40
24414463619,24414463610,-9,845,2455,40
24432516871,24432516870,-1,1031,1587,40
24433882862,24433882857,-5,764,2367,40
24434866839,24434866819,-20,785,3129,40
24434988064,24434988081,17,939,2740,40
24438497029,24438497026,-3,1341,1647,40
24447022842,24447022836,-6,882,3852,40
24449378340,24449378343,3,1937,1661,40
24449486778,24449486773,-5,962,4209,40
24451044302,24451044296,-6,1286,4157,40
24451204415,24451204407,-8,933,3819,40
24453224947,24453224942,-5,1030,2894,40
24453787870,24453787870,0,1498,1504,40
24457164569,24457164563,-6,950,4085,40
24460733795,24460733790,-5,945,4361,40
24475040803,24475040806,3,2376,2824,40
24481248619,24481248630,11,32280,50628,40
24482855902,24482855898,-4,809,3588,40
24486238702,24486238695,-7,1199,4617,40
24486591286,24486591279,-7,283,817,40
24486890542,24486890558,16,108,1039,40
24487779394,24487779389,-5,1397,3047,40
24492470298,24492470294,-4,1322,3543,40
24492715357,24492715351,-6,678,3373,40
24496187242,24496187235,-7,1219,3531,40
24501990194,24501990189,-5,940,4085,40
24502347863,24502347855,-8,892,2917,40
24504768122,24504768116,-6,1075,2867,40
24505403536,24505403530,-6,760,2848,40
24507799086,24507799079,-7,822,4525,40
24508205586,24508205585,-1,2894,5421,40
24509874383,24509874377,-6,874,2376,40
24528910224,24528910217,-7,1352,3803,40
24529699080,24529699090,10,412,1466,40
24532091958,24532091953,-5,1069,3774,40
24532155010,24532155003,-7,806,3468,40
24535321001,24535321001,0,1356,1395,40
24535577726,24535577711,-15,861,3592,40
24536305861,24536305883,22,366,2452,40
24537247206,24537247203,-3,540,2376,40
24538013071,24538013090,19,567,1415,40
24538269198,24538269204,6,3323,1455,40
24541961109,24541961105,-4,676,2221,40
24547892755,24547892760,5,2891,1566,40
24550078995,24550078988,-7,1061,4251,40
24550476549,24550476562,13,303,1366,40
24551548531,24551548526,-5,836,2890,40
24554481567,24554481576,9,10296,22696,40
24556884978,24556884972,-6,1336,3835,40
24558060575,24558060569,-6,1186,1754,40
24563270323,24563270318,-5,800,2261,40
24563829782,24563829776,-6,951,2423,40
24564057279,24564057295,16,311,6404,40
24568102835,24568102828,-7,1108,4749,40
24568205160,24568205173,13,272,1057,40
24569616702,24569616696,-6,977,3542,40
24570004669,24570004668,-1,40507,45619,40
24582602658,24582602654,-4,886,4069,40
24590604591,24590604593,2,1400,1607,40
24595199003,24595198999,-4,1076,4016,40
24597576993,24597576987,-6,875,3583,40
24600808147,24600808143,-4,854,2147,40
24611126025,24611126017,-8,700,3691,40
24625034546,24625034550,4,2464,1957,40
24625510119,24625510116,-3,1307,3145,40
24625769494,24625769487,-7,1121,3241,40
24625901620,24625901625,5,2564,1404,40
24629095193,24629095188,-5,1153,3971,40
24629166828,24629166822,-6,289,1467,40
24634227591,24634227585,-6,1037,4004,40
24634872202,24634872197,-5,1133,3907,40
24635259302,24635259296,-6,1019,2606,40
24636318270,24636318277,7,12956,25477,40
24641318318,24641318313,-5,1136,4202,40
24642266517,24642266512,-5,802,2696,40
24644644305,24644644300,-5,1452,3411,40
24651541879,24651541873,-6,1208,4320,40
24655459836,24655459830,-6,1002,3017,40
24659251241,24659251246,5,14148,6324,40
24661331576,24661331583,7,2103,1268,40
24661527374,24661527369,-5,950,2967,40
24661772968,24661772963,-5,740,4024,40
24662506379,24662506373,-6,1138,4103,40
24663707984,24663707999,15,692,1516,40
24663828726,24663828731,5,1381,21863,40
24663984272,24663984289,17,433,1770,40
24666719385,24666719392,7,11710,21796,40
24670192922,24670192902,-20,1155,517,40
24671446299,24671446294,-5,861,2352,40
24673424990,24673424984,-6,764,2565,40
24679956425,24679956420,-5,1001,4057,40
24684028706,24684028699,-7,717,3392,40
24685847027,24685847018,-9,955,4107,40
24688897333,24688897326,-7,1144,6184,40
24689808128,24689808125,-3,1089,1424,40
24696464482,24696464477,-5,1315,4006,40
24697357927,24697357921,-6,1068,3165,40
24700925527,24700925526,-1,1897,3343,40
24704614206,24704614198,-8,1183,5385,40
24704780693,24704780706,13,801,3298,40
24705201154,24705201149,-5,773,3343,40
24709980926,24709980923,-3,696,1070,40
24712446666,24712446669,3,11769,9364,40
24712615275,24712615269,-6,990,3386,40
24714768845,24714768839,-6,978,3012,40
24721384879,24721384870,-9,680,5654,40
24722480590,24722480585,-5,776,3223,40
24733328151,24733328146,-5,924,3063,40
24733791925,24733791920,-5,971,1845,40
24734115255,24734115249,-6,1394,4377,40
24745949854,24745949849,-5,1047,4880,40
24746321511,24746321502,-9,720,3170,40
24746577086,24746577105,19,301,1538,40
24753724459,24753724453,-6,1127,3918,40
24754425955,24754425956,1,4193,16370,40
24757913286,24757913289,3,1393,1115,40
24758793629,24758793646,17,802,3639,40
24763350037,24763350032,-5,865,2998,40
24766213945,24766213938,-7,1047,3538,40
24766549762,24766549754,-8,579,3571,40
24768744574,24768744572,-2,654,150,40
24770316442,24770316437,-5,1087,4373,40
24779292071,24779292065,-6,918,3694,40
24803840462,24803840456,-6,651,2387,40
24807473283,24807473287,4,1333,964,40
24808276385,24808276378,-7,837,3664,40
24809291946,24809291942,-4,1194,3336,40
24811979633,24811979626,-7,1058,2367,40
24828352640,24828352633,-7,250,2353,40
24828933559,24828933573,14,204,1207,40
24829485735,24829485731,-4,982,2687,40
24829658430,24829658422,-8,1047,4354,40
24833369946,24833369939,-7,1053,4694,40
24836010587,24836010581,-6,1196,4099,40
24842281307,24842281303,-4,694,1740,40
24845092138,24845092133,-5,257,2274,40
24845654625,24845654618,-7,955,2928,40
24845717381,24845717397,16,1085,3965,40
24851048750,24851048749,-1,1473,2642,40
24857270587,24857270581,-6,821,3296,40
24858006378,24858006384,6,1101,874,40
24858322342,24858322321,-21,2650,2488,40
24867816650,24867816646,-4,967,3460,40
24877510458,24877510452,-6,612,3043,40
24882302770,24882302762,-8,1244,4010,40
24884556326,24884556321,-5,731,3091,40
24892990146,24892990150,4,3301,1885,40
24895396443,24895396437,-6,1079,3394,40
24898981247,24898981242,-5,718,3598,40
24899403631,24899403639,8,1510,1332,40
24899796973,24899796969,-4,1112,3699,40
24899950646,24899950641,-5,1033,3431,40
24908902544,24908902543,-1,21778,13173,40
24909527038,24909527033,-5,1036,3963,40
24910738726,24910738722,-4,232,1445,40
24915275381,24915275374,-7,1129,3941,40
24931086358,24931086366,8,45293,22499,40
24931839195,24931839189,-6,1204,4350,40
24931981202,24931981198,-4,834,2859,40
24932084326,24932084341,15,754,2990,40
24932732599,24932732593,-6,1254,4485,40
24946426664,24946426670,6,5672,2506,40
24950465665,24950465662,-3,1901,4955,40
24951599942,24951599946,4,1298,711,40
24957990174,24957990169,-5,951,4384,40
24961092354,24961092349,-5,1192,4484,40
24962135661,24962135665,4,3201,1017,40
24962917929,24962917923,-6,937,3205,40
24966691321,24966691317,-4,830,3329,40
24967306394,24967306387,-7,1153,2913,40
24968180353,24968180350,-3,1213,2943,40
24968989364,24968989381,17,380,1244,40
24970837218,24970837211,-7,1018,3770,40
24978182891,24978182883,-8,962,4759,40
24979284609,24979284601,-8,1145,2252,40
24981362133,24981362126,-7,1364,4484,40
24981434014,24981434029,15,202,2746,40
24981977837,24981977830,-7,1113,4738,40
24983910042,24983910037,-5,630,1863,40
24984783747,24984783748,1,971,1484,40
24991664442,24991664434,-8,821,4185,40
24994799172,24994799170,-2,3210,4859,40
24996496568,24996496575,7,1605,1158,40
25000560738,25000560731,-7,814,3069,40
25000901126,25000901147,21,297,1479,40
25002849639,25002849633,-6,1407,5121,40
25012783700,25012783694,-6,1216,3903,40
25015833124,25015833118,-6,1105,3470,40
25016421695,25016421690,-5,1127,3035,40
25019540495,25019540490,-5,20438,49699,40
25022804826,25022804819,-7,618,3741,40
25023237468,25023237453,-15,930,5114,40
25023591209,25023591202,-7,752,3094,40
25032433282,25032433274,-8,1068,2044,40
25038304611,25038304602,-9,949,11247,40
25039020460,25039020455,-5,1040,5094,40
25053294170,25053294178,8,9680,37168,40
25067007626,25067007621,-5,1101,3097,40
25067368414,25067368401,-13,191,1194,40
25071608711,25071608724,13,506,1948,40
25075091471,25075091467,-4,1263,4067,40
25080949111,25080949104,-7,918,3562,40
25081281090,25081281082,-8,1292,4168,40
25088148976,25088148969,-7,1246,4011,40
25088459174,25088459167,-7,150,1291,40
25089783192,25089783194,2,68721,52709,40
25090126335,25090126329,-6,1083,3935,40
25090253606,25090253623,17,220,1414,40
25090975257,25090975251,-6,775,3214,40
25091167183,25091167199,16,204,1613,40
25092297142,25092297145,3,143,1011,40
25097536555,25097536550,-5,874,2893,40
25098817354,25098817350,-4,775,3287,40
25098878720,25098878738,18,947,2430,40
25112552826,25112552826,0,9243,11759,40
25116527850,25116527844,-6,1317,3871,40
25121999949,25121999942,-7,902,6967,40
25123789357,25123789349,-8,1136,4835,40
25123974469,25123974487,18,403,3013,40
25128955235,25128955232,-3,1066,1744,40
25135357053,25135357046,-7,888,3231,40
25136273434,25136273427,-7,775,4717,40
25139207107,25139207109,2,1661,1954,40
25139444554,25139444557,3,1254,1544,40
25146083560,25146083554,-6,978,3481,40
25153851602,25153851597,-5,922,4564,40
25155468007,25155467999,-8,968,3724,40
25155827967,25155827960,-7,2467,8237,40
25163801400,25163801394,-6,1276,3817,40
25163990691,25163990685,-6,836,3546,40
25165118516,25165118531,15,385,1917,40
25174163473,25174163465,-8,889,3419,40
25183092458,25183092447,-11,2113,634,40
25187478536,25187478530,-6,915,2199,40
25187939133,25187939131,-2,1515,2048,40
25189165338,25189165333,-5,971,3977,40
25199050450,25199050455,5,1878,1854,40
25204451070,25204451066,-4,711,2572,40
25205335347,25205335347,0,242,1201,40
25208373787,25208373781,-6,849,2899,40
25213773511,25213773505,-6,692,3227,40
25214660106,25214660101,-5,1167,4172,40
25220321046,25220321040,-6,1259,3166,40
25227369802,25227369782,-20,1839,602,40
25227413351,25227413345,-6,741,3015,40
25233385666,25233385662,-4,664,1651,40
25233875285,25233875299,14,41,1329,40
25234274522,25234274525,3,2395,1449,40
25234805403,25234805399,-4,1077,4361,40
25238791061,25238791060,-1,2731,4644,40
25239373702,25239373696,-6,909,3259,40
25241824975,25241824972,-3,837,2162,40
25250212419,25250212413,-6,882,3170,40
25257313458,25257313450,-8,1000,6321,40
25265762118,25265762113,-5,790,2865,40
25266380432,25266380449,17,431,1312,40
25269509887,25269509891,4,13811,8776,40
25270536706,25270536701,-5,690,2936,40
25275297234,25275297226,-8,701,5659,40
25275456294,25275456289,-5,1445,5142,40
25282029004,25282029007,3,2517,2560,40
25285984492,25285984507,15,88,1103,40
25287610658,25287610653,-5,730,2099,40
25292301061,25292301054,-7,1075,3510,40
25297165263,25297165257,-6,598,4752,40
25298637671,25298637657,-14,326,1329,40
25301654218,25301654222,4,1154,726,40
25306723621,25306723615,-6,1057,3095,40
25315748783,25315748778,-5,633,2189,40
25317141274,25317141278,4,1825,1142,40
25318440403,25318440396,-7,1073,3585,40
25320602093,25320602086,-7,1125,4286,40
25321471160,25321471173,13,827,4346,40
25321777196,25321777219,23,357,1164,40
25331106758,25331106758,0,1149,1942,40
25331186224,25331186235,11,1221,2858,40
25346004419,25346004413,-6,743,3397,40
25348062632,25348062628,-4,1656,5568,40
25350617090,25350617085,-5,1395,4916,40
25352303537,25352303533,-4,1519,3343,40
25354319975,25354319971,-4,933,3360,40
25364549615,25364549609,-6,998,4821,40
25379304046,25379304042,-4,1019,3617,40
25381483413,25381483422,9,333,1300,40
25382926639,25382926652,13,706,3549,40
25383785613,25383785606,-7,968,3341,40
25384603134,25384603129,-5,1037,4030,40
25397209658,25397209664,6,2016,1063,40
25402875985,25402875978,-7,1187,4592,40
25407831554,25407831549,-5,927,3676,40
25409620255,25409620253,-2,1654,3077,40
25411948818,25411948817,-1,1281,1699,40
25415049391,25415049386,-5,1781,4621,40
25419916958,25419916952,-6,1349,4919,40
25425920778,25425920772,-6,1067,4959,40
25435138773,25435138768,-5,703,2102,40
25440157237,25440157233,-4,961,3198,40
25440421647,25440421650,3,139,1392,40
25448010358,25448010351,-7,890,4728,40
25450455955,25450455950,-5,906,3126,40
25451884403,25451884398,-5,843,1842,40
25462583367,25462583361,-6,726,3766,40
25464944142,25464944142,0,2528,2458,40
25469705390,25469705384,-6,1121,4332,40
25479830424,25479830414,-10,997,4109,40
25480492900,25480492894,-6,566,2323,40
25489930379,25489930374,-5,967,3332,40
25489958958,25489958970,12,250,1447,40
25492256339,25492256334,-5,1181,2838,40
25493289893,25493289887,-6,265,1237,40
25494524931,25494524934,3,65180,72985,40
25495707765,25495707757,-8,1164,3989,40
25502067434,25502067429,-5,1114,4350,40
25502662449,25502662454,5,1679,1243,40
25509781366,25509781360,-6,887,3255,40
25514883997,25514884002,5,16345,7384,40
25519974313,25519974309,-4,718,3097,40
25524396621,25524396616,-5,1015,3963,40
25525545770,25525545778,8,4591,2095,40
25534879633,25534879629,-4,1127,3947,40
25545043923,25545043917,-6,898,5341,40
25546990775,25546990793,18,737,3718,40
25550815975,25550815973,-2,956,1749,40
25563662570,25563662564,-6,970,3638,40
25566711006,25566711003,-3,1197,2543,40
25572627313,25572627305,-8,113,1288,40
25576263914,25576263910,-4,1097,2986,40
25576713935,25576713954,19,287,1435,40
25581416931,25581416929,-2,1860,2569,40
25583540410,25583540417,7,3896,1691,40
25594056953,25594056945,-8,1036,10497,40
25595773386,25595773381,-5,867,3523,40
25596341802,25596341795,-7,985,2720,40
25596612062,25596612082,20,370,1369,40
25614717456,25614717461,5,4671,2073,40
25619386442,25619386435,-7,1112,3448,40
25626075943,25626075938,-5,851,3691,40
25626549055,25626549062,7,76,1205,40
25627553168,25627553159,-9,1271,3488,40
25627901670,25627901691,21,957,3139,40
25630248449,25630248443,-6,1254,4047,40
25633228605,25633228598,-7,850,2393,40
25638095787,25638095782,-5,922,3409,40
25638121786,25638121780,-6,543,2344,40
25638406302,25638406311,9,188,1257,40
25639512981,25639512974,-7,435,2145,40
25642729747,25642729740,-7,896,4082,40
25643227237,25643227245,8,204,10681,40
25649357710,25649357704,-6,1391,3714,40
25651216794,25651216786,-8,1129,4375,40
25660337906,25660337904,-2,2343,5098,40
25660812966,25660812961,-5,1135,3866,40
25662068061,25662068065,4,2188,1883,40
25665784464,25665784457,-7,1578,5316,40
25666657605,25666657619,14,27,845,40
25668655822,25668655817,-5,904,3383,40
25670300217,25670300212,-5,842,3662,40
25670366047,25670366062,15,220,1786,40
25673789542,25673789534,-8,696,3763,40
25678892451,25678892453,2,1210,1019,40
25682534103,25682534097,-6,965,3261,40
25687602845,25687602839,-6,1071,2845,40
25694728871,25694728871,0,1864,2440,40
25695767247,25695767250,3,1498,1037,40
25696843716,25696843699,-17,235,1371,40
25697355278,25697355279,1,207,975,40
25714766946,25714766941,-5,719,4571,40
25716422581,25716422561,-20,928,2860,40
25720438006,25720438001,-5,1240,3398,40
25722915470,25722915466,-4,1194,3528,40
25724598771,25724598766,-5,978,2582,40
25726008120,25726008132,12,997,3461,40
25729519346,25729519343,-3,1120,2750,40
25730070036,25730070030,-6,931,3470,40
25732695907,25732695902,-5,866,3151,40
25741217333,25741217329,-4,1279,3537,40
25742510295,25742510290,-5,1133,3741,40
25742957794,25742957791,-3,850,1906,40
25743239922,25743239916,-6,862,4293,40
25746430457,25746430450,-7,1068,3917,40
25752847224,25752847216,-8,1280,4179,40
25753062768,25753062776,8,249,1326,40
25754039722,25754039717,-5,904,4655,40
25754162000,25754162019,19,580,1116,40
25755411337,25755411333,-4,884,3882,40
25755737470,25755737470,0,78,879,40
25759022223,25759022221,-2,1309,2915,40
25760093995,25760093990,-5,472,1589,40
25764847714,25764847707,-7,1163,5021,40
25774856963,25774856957,-6,1073,4227,40
25775901930,25775901925,-5,842,3652,40
25780345749,25780345746,-3,1801,2937,40
25784413346,25784413340,-6,979,4272,40
25784709192,25784709210,18,871,5437,40
25786965920,25786965923,3,2893,2468,40
25793509499,25793509493,-6,1225,5303,40
25800166616,25800166610,-6,831,1730,40
25802301021,25802301011,-10,225,3220,40
25818312755,25818312751,-4,1221,2787,40
25821843274,25821843271,-3,1191,1946,40
25823425619,25823425614,-5,1069,4553,40
25825284169,25825284166,-3,929,2883,40
25827682756,25827682751,-5,1154,3905,40
25830549563,25830549557,-6,1061,3661,40
25831414258,25831414254,-4,814,2894,40
25832243141,25832243159,18,572,1893,40
25833105748,25833105754,6,2078,915,40
25833917010,25833917006,-4,1118,3008,40
25834356187,25834356178,-9,1161,4004,40
25844949004,25844949004,0,1533,2642,40
25847671914,25847671909,-5,1191,3049,40
25852894102,25852894095,-7,1002,4589,40
25852981735,25852981730,-5,753,3212,40
25855349781,25855349777,-4,1026,4414,40
25867041258,25867041254,-4,591,2849,40
25868529327,25868529322,-5,196,1362,40
25874449219,25874449215,-4,1076,2915,40
25875991922,25875991930,8,229,1234,40
25876537232,25876537243,11,164,1565,40
25880409535,25880409527,-8,896,4345,40
25882512938,25882512941,3,3696,2713,40
25893320612,25893320605,-7,1227,3792,40
25893552622,25893552606,-16,50,953,40
25894142038,25894142059,21,239,1027,40
25901811314,25901811308,-6,1472,4075,40
25905645625,25905645630,5,1102,976,40
25905713116,25905713134,18,1059,4647,40
25912347363,25912347355,-8,1002,5569,40
25914036941,25914036924,-17,755,35,40
25921674258,25921674252,-6,860,3670,40
25934174889,25934174879,-10,285,1037,40
25934935010,25934935004,-6,1136,4220,40
25935154418,25935154412,-6,959,2623,40
25936285659,25936285652,-7,959,5018,40
25937726613,25937726605,-8,1173,3512,40
25937972208,25937972218,10,975,3497,40
25938340321,25938340313,-8,1134,4260,40
25948205153,25948205159,6,5372,2317,40
25954307052,25954307057,5,2948,1710,40
25956405628,25956405626,-2,1154,2632,40
25963919447,25963919439,-8,25953,12477,40
25974038425,25974038422,-3,1734,3188,40
25976466029,25976466022,-7,963,4070,40
25985892697,25985892694,-3,1096,3012,40
25987592423,25987592418,-5,914,1591,40
26011583270,26011583269,-1,591,1845,40
26018852694,26018852689,-5,855,3657,40
26020936603,26020936597,-6,736,3359,40
26026594904,26026594904,0,1527,1831,40
26037542020,26037542021,1,1959,2419,40
26045206626,26045206621,-5,831,3407,40
26054378455,26054378433,-22,42,1433,40
26054441243,26054441239,-4,667,2919,40
26054517436,26054517436,0,237,1243,40
26055641742,26055641734,-8,698,5952,40
26055828772,26055828788,16,386,4185,40
26060153502,26060153496,-6,1034,3632,40
26065083722,26065083728,6,1814,1685,40
26065911627,26065911620,-7,885,3016,40
26066350737,26066350730,-7,1018,3755,40
26067167527,26067167542,15,756,2309,40
26067789181,26067789180,-1,2087,3115,40
26071744986,26071744985,-1,1486,2109,40
26082765761,26082765757,-4,1460,4121,40
26085977184,26085977186,2,1610,1058,40
26088997735,26088997730,-5,1367,3507,40
26089857156,26089857149,-7,1302,3745,40
26090202348,26090202365,17,827,1296,40
26091147291,26091147286,-5,1298,6792,40
26093865761,26093865754,-7,715,2783,40
26101465069,26101465069,0,111,1633,40
26111046150,26111046146,-4,1083,3736,40
26111295385,26111295382,-3,1401,3478,40
26114015702,26114015695,-7,1186,3489,40
26115216248,26115216243,-5,1304,2530,40
26120000302,26120000298,-4,1169,3008,40
26121804780,26121804775,-5,1170,3648,40
26122002179,26122002181,2,1477,1248,40
26126862422,26126862417,-5,897,5412,40
26127062702,26127062682,-20,269,3138,40
26137146627,26137146630,3,3175,3403,40
26138309563,26138309557,-6,1378,3856,40
26140577238,26140577231,-7,1203,4427,40
26140987635,26140987630,-5,627,3322,40
26142071470,26142071468,-2,1228,2161,40
26145159663,26145159657,-6,858,3990,40
26161950101,26161950093,-8,611,3360,40
26161997933,26161997955,22,1571,3882,40
26165708531,26165708534,3,1352,1098,40
26167041490,26167041484,-6,1047,2975,40
26172263001,26172263003,2,2203,2195,40
26173394734,26173394730,-4,925,4930,40
26175474686,26175474693,7,6361,7023,40
26175537080,26175537077,-3,854,1884,40
26175960221,26175960234,13,322,2118,40
26177723641,26177723637,-4,902,3647,40
26180541500,26180541494,-6,1055,2857,40
26180707604,26180707590,-14,85,978,40
26182353566,26182353561,-5,993,3567,40
26184354414,26184354406,-8,1186,4634,40
26194897118,26194897113,-5,769,3128,40
26195667493,26195667510,17,230,2228,40
26197473885,26197473881,-4,1864,5280,40
26197794185,26197794180,-5,1005,3799,40
26201102209,26201102202,-7,1053,4475,40
26205289131,26205289124,-7,994,3214,40
26215813138,26215813138,0,1218,902,40
26220627418,26220627417,-1,1591,1800,40
26223155825,26223155818,-7,880,2523,40
26223325407,26223325402,-5,801,2936,40
26235787095,26235787098,3,100,917,40
26240181246,26240181240,-6,884,2914,40
26243012680,26243012670,-10,605,3188,40
26243600749,26243600758,9,243,1066,40
26245568300,26245568294,-6,1174,4307,40
26245598566,26245598582,16,661,3700,40
26249887815,26249887809,-6,891,3415,40
26249947351,26249947346,-5,966,3806,40
26250574645,26250574650,5,1495,1431,40
26262584779,26262584773,-6,827,1596,40
26263735051,26263735045,-6,919,3835,40
26265128194,26265128189,-5,1060,4061,40
26266500439,26266500432,-7,878,3485,40
26268386767,26268386762,-5,1064,2862,40
26270637883,26270637877,-6,1233,4004,40
26270996080,26270996098,18,334,1286,40
26271211522,26271211515,-7,658,3799,40
26272898754,26272898749,-5,883,2944,40
26275819851,26275819846,-5,1135,3610,40
26276559311,26276559319,8,110,1088,40
26277898385,26277898385,0,2573,3508,40
26281525134,26281525130,-4,1022,4272,40
26287742262,26287742257,-5,820,3845,40
26291344105,26291344100,-5,1502,3013,40
26293951923,26293951917,-6,1031,3645,40
26294306807,26294306789,-18,1521,3301,40
26296005467,26296005461,-6,1187,5427,40
26296896149,26296896145,-4,917,3460,40
26297714855,26297714849,-6,1372,4503,40
26300322963,26300322956,-7,765,3293,40
26306104721,26306104719,-2,2062,3687,40
26313346163,26313346157,-6,914,2077,40
26317291951,26317291946,-5,1150,4321,40
26329571257,26329571261,4,1512,1223,40
26363427577,26363427570,-7,1095,3812,40
26364616862,26364616866,4,1140,1017,40
26376370751,26376370746,-5,776,3243,40
26378070183,26378070183,0,24008,26219,40
26380447122,26380447115,-7,663,2603,40
26384610936,26384610930,-6,1077,3411,40
26384813132,26384813146,14,350,1795,40
26387651900,26387651905,5,1996,1298,40
26389585174,26389585175,1,827,885,40
26392412718,26392412712,-6,820,2130,40
26392441733,26392441727,-6,171,1106,40
26394782963,26394782957,-6,895,2210,40
26397264751,26397264746,-5,2216,7394,40
26398491850,26398491845,-5,887,3298,40
26400523646,26400523642,-4,755,2680,40
26401039767,26401039772,5,2748,1836,40
26404517603,26404517598,-5,1315,2722,40
26405873143,26405873137,-6,931,3603,40
26408663388,26408663381,-7,1532,3971,40
26426015315,26426015309,-6,1212,4479,40
26428331157,26428331151,-6,975,3721,40
26428612035,26428612029,-6,796,3018,40
26429268790,26429268770,-20,1019,4704,40
26430895390,26430895395,5,4648,1876,40
26432203594,26432203586,-8,794,2736,40
26432247632,26432247645,13,696,2897,40
26439249311,26439249302,-9,866,3664,40
26441891409,26441891403,-6,1521,4816,40
26442967489,26442967482,-7,1086,3675,40
26443300239,26443300233,-6,956,2794,40
26445465925,26445465919,-6,856,3488,40
26452487669,26452487664,-5,1048,3464,40
26456956809,26456956804,-5,1894,5285,40
26458643326,26458643321,-5,1106,4962,40
26464371550,26464371551,1,1974,1810,40
26466601750,26466601743,-7,672,1215,40
26466991455,26466991450,-5,1044,3096,40
26475582214,26475582206,-8,965,5091,40
26476343214,26476343218,4,4337,3108,40
26478529718,26478529712,-6,533,1647,40
26483403769,26483403773,4,1990,853,40
26488790880,26488790882,2,2802,2977,40
26491310958,26491310953,-5,1109,3311,40
26492819574,26492819569,-5,1193,3314,40
26494056626,26494056621,-5,1107,3716,40
26497080970,26497080963,-7,1177,4596,40
26503322521,26503322516,-5,1000,3263,40
26506590681,26506590676,-5,981,3284,40
26507722457,26507722464,7,6659,2107,40
26509841393,26509841389,-4,1189,3359,40
26512603490,26512603504,14,448,2706,40
26515859392,26515859396,4,3161,2324,40
26517709974,26517709967,-7,1332,4795,40
26523060422,26523060426,4,2464,1662,40
26526943430,26526943432,2,2770,2624,40
26538913553,26538913546,-7,1084,4079,40
26538980643,26538980637,-6,1091,3607,40
26539254070,26539254089,19,810,3344,40
26540259150,26540259150,0,1216,1630,40
26545603973,26545603982,9,3655,1440,40
26546597187,26546597181,-6,1145,4577,40
26550539970,26550539963,-7,671,5579,40
26551382723,26551382717,-6,878,2406,40
26552326710,26552326703,-7,1162,4427,40
26555026006,26555025999,-7,1344,2812,40
26557408953,26557408946,-7,657,3993,40
26560217357,26560217352,-5,866,3165,40
26560727572,26560727566,-6,1086,4827,40
26572909590,26572909585,-5,1355,4107,40
26576727306,26576727299,-7,939,3439,40
26576831343,26576831356,13,70,1072,40
26583565514,26583565509,-5,1076,3030,40
26583919822,26583919837,15,1475,3543,40
26586343629,26586343622,-7,852,3819,40
26589463650,26589463645,-5,999,3446,40
26598654184,26598654178,-6,1177,3658,40
26603132209,26603132204,-5,901,4258,40
26603334309,26603334294,-15,905,3584,40
26606841902,26606841897,-5,949,3118,40
26607971624,26607971617,-7,1930,5900,40
26608101792,26608101786,-6,1202,5365,40
26609679858,26609679851,-7,1141,4595,40
26609810021,26609810014,-7,22795,19246,40
26611983406,26611983401,-5,1179,4268,40
26621482852,26621482847,-5,1028,2900,40
26627102767,26627102763,-4,913,3006,40
26627205678,26627205672,-6,1383,6017,40
26642827974,26642827968,-6,1253,3504,40
26654224725,26654224733,8,5454,2066,40
26654377971,26654377981,10,3329,1236,40
26658993509,26658993505,-4,1018,2561,40
26660519674,26660519667,-7,914,4243,40
26660956351,26660956346,-5,96,1074,40
26666374078,26666374073,-5,936,3353,40
26667942866,26667942861,-5,1011,3020,40
26668185669,26668185650,-19,51,1264,40
26669600086,26669600067,-19,140,1030,40
26673321686,26673321681,-5,1004,4091,40
26673833595,26673833591,-4,966,4010,40
26676462845,26676462837,-8,184,1090,40
26700362487,26700362482,-5,27872,14517,40
26706040647,26706040642,-5,1113,4229,40
26711370942,26711370941,-1,32810,48141,40
26712097310,26712097305,-5,1396,3970,40
26712423540,26712423546,6,272,1292,40
26713083433,26713083434,1,1638,1899,40
26715883369,26715883363,-6,1164,4239,40
26722333764,26722333758,-6,768,4063,40
26731199063,26731199057,-6,1293,3584,40
26747006303,26747006299,-4,1263,2675,40
26759522590,26759522586,-4,1115,4130,40
26763536062,26763536061,-1,1739,2522,40
26772014644,26772014637,-7,1672,8223,40
26780062271,26780062277,6,2720,802,40
26781727645,26781727648,3,1906,1935,40
26781874403,26781874401,-2,1227,1761,40
26784509604,26784509597,-7,1253,4698,40
26785011229,26785011247,18,381,1063,40
26789943407,26789943401,-6,806,3876,40
26790208438,26790208458,20,775,2052,40
26792722628,26792722621,-7,553,4092,40
26796267551,26796267547,-4,877,3578,40
26801220033,26801220028,-5,1239,3538,40
26802280098,26802280090,-8,956,2791,40
26805491317,26805491311,-6,1370,4078,40
26806602994,26806602988,-6,1061,4541,40
26807855419,26807855412,-7,1124,3740,40
26808786387,26808786393,6,3175,1219,40
26812577691,26812577686,-5,998,4168,40
26817662307,26817662311,4,4019,3073,40
26818178428,26818178421,-7,904,3834,40
26819259896,26819259914,18,756,2331,40
26822380017,26822380012,-5,741,2276,40
26825035942,26825035936,-6,502,2484,40
26825065247,26825065258,11,225,948,40
26840634815,26840634809,-6,1036,4453,40
26842207605,26842207598,-7,1421,5032,40
26842269458,26842269454,-4,1476,4791,40
26842410935,26842410937,2,96,754,40
26842533452,26842533434,-18,722,2686,40
26849927288,26849927283,-5,1147,3587,40
26854133144,26854133138,-6,2080,8600,40
26855225561,26855225555,-6,1070,2894,40
26857073937,26857073939,2,1884,1174,40
26859633369,26859633372,3,1940,1904,40
26861455402,26861455400,-2,2318,2684,40
26866291236,26866291230,-6,811,3520,40
26866494351,26866494337,-14,206,963,40
26869291180,26869291174,-6,1119,4229,40
26869922504,26869922511,7,54,1093,40
26881589333,26881589326,-7,2237,9217,40
26884348941,26884348951,10,762,1233,40
26895311149,26895311151,2,1345,1205,40
26895776439,26895776426,-13,98,1350,40
26896443614,26896443634,20,607,2704,40
26899715431,26899715426,-5,1056,4579,40
26909748294,26909748287,-7,835,4063,40
26910151421,26910151430,9,305,1391,40
26912257573,26912257570,-3,1327,2455,40
26914981425,26914981418,-7,954,2011,40
26916481589,26916481582,-7,169,1596,40
26916657054,26916657074,20,553,2498,40
26917908735,26917908718,-17,63,715,40
26920834480,26920834485,5,5143,2783,40
26925317442,26925317443,1,1779,2082,40
26925540613,26925540630,17,686,2738,40
26936020045,26936020049,4,2057,1344,40
26938366167,26938366161,-6,738,2217,40
26940118869,26940118860,-9,1043,3510,40
26941311685,26941311680,-5,913,3576,40
26951241179,26951241173,-6,1013,2422,40
26951901077,26951901073,-4,657,2712,40
26982466443,26982466438,-5,1314,4622,40
26990028950,26990028945,-5,1261,5026,40
26992556374,26992556369,-5,850,3803,40
27000011079,27000011074,-5,973,3736,40
27001577639,27001577634,-5,649,2219,40
27001700975,27001700987,12,215,934,40
27002024958,27002024970,12,377,2684,40
27002372214,27002372214,0,2526,2329,40
27002851132,27002851134,2,1840,1641,40
27009191266,27009191261,-5,912,3576,40
27012752762,27012752759,-3,1145,2278,40
27014872231,27014872224,-7,788,4239,40
27018148077,27018148073,-4,1066,3618,40
27018300405,27018300423,18,414,2060,40
27018402500,27018402494,-6,599,1941,40
27020185282,27020185277,-5,645,3452,40
27022264055,27022264049,-6,1080,3806,40
27023444013,27023444030,17,325,1288,40
27030713897,27030713890,-7,1271,4332,40
27035039667,27035039662,-5,814,2817,40
27040020006,27040020001,-5,902,3353,40
27049005792,27049005785,-7,783,3482,40
27052006384,27052006382,-2,1020,2266,40
27061723351,27061723343,-8,1111,3294,40
27064307613,27064307607,-6,1089,4669,40
27067604846,27067604845,-1,1588,2477,40
27079312741,27079312746,5,34372,20958,40
27107019326,27107019318,-8,1299,5205,40
27107078148,27107078146,-2,123,1599,40
27113774748,27113774743,-5,808,2302,40
27116226973,27116226966,-7,1346,3492,40
27123005244,27123005242,-2,1530,2527,40
27124987730,27124987751,21,78,1082,40
27126597436,27126597430,-6,1286,3416,40
27128153606,27128153606,0,9449,13031,40
27136173797,27136173791,-6,1003,3851,40
27137426542,27137426535,-7,959,3835,40
27137493479,27137493486,7,284,931,40
27138938182,27138938178,-4,1115,3335,40
27139106027,27139106024,-3,1569,2413,40
27141877776,27141877783,7,2673,965,40
27143968570,27143968571,1,1457,1549,40
27145776514,27145776509,-5,965,2553,40
27151711601,27151711597,-4,1159,4233,40
27156500075,27156500070,-5,955,4026,40
27159877068,27159877059,-9,792,4123,40
27167721805,27167721799,-6,788,3663,40
27173094899,27173094893,-6,1105,4517,40
27179156653,27179156646,-7,1301,5417,40
27183325650,27183325649,-1,1699,1813,40
27183927027,27183927021,-6,1137,3820,40
27185073806,27185073801,-5,1504,3364,40
27185155383,27185155367,-16,165,1154,40
27185531484,27185531474,-10,244,1325,40
27190198613,27190198607,-6,1216,4190,40
27192951123,27192951115,-8,940,3489,40
27193732766,27193732757,-9,713,2611,40
27193909240,27193909250,10,151,1229,40
27198803039,27198803033,-6,803,5807,40
27200408426,27200408421,-5,676,3635,40
27205039887,27205039881,-6,1052,3291,40
27205797826,27205797826,0,1231,2126,40
27206573861,27206573854,-7,1356,3941,40
27206941552,27206941546,-6,823,6615,40
27208554543,27208554537,-6,901,3075,40
27211325854,27211325849,-5,1402,3903,40
27213958770,27213958761,-9,952,3813,40
27216242482,27216242478,-4,1056,2782,40
27216435314,27216435318,4,9739,7080,40
27219492130,27219492125,-5,1196,3250,40
27222971666,27222971659,-7,668,4497,40
27228421722,27228421717,-5,997,4227,40
27228524518,27228524511,-7,887,3285,40
27230577246,27230577243,-3,1035,3172,40
27235204783,27235204774,-9,1028,5054,40
27243093094,27243093090,-4,1137,3553,40
27245632293,27245632289,-4,805,3329,40
27248630168,27248630166,-2,8734,14115,40
27249143218,27249143213,-5,902,4102,40
27249233705,27249233701,-4,963,2210,40
27249538718,27249538735,17,1063,3092,40
27250065175,27250065169,-6,899,3003,40
27250843163,27250843157,-6,1441,3974,40
27253935829,27253935822,-7,629,3366,40
27254081199,27254081213,14,890,3785,40
27256324690,27256324691,1,1018,1310,40
27258132292,27258132286,-6,933,3711,40
27258234271,27258234269,-2,198,956,40
27260307606,27260307601,-5,1030,3586,40
27260442239,27260442234,-5,533,3318,40
27261994644,27261994661,17,1273,4273,40
27262909376,27262909372,-4,878,2516,40
27263787609,27263787602,-7,1514,4751,40
27265820157,27265820163,6,2019,789,40
27288424787,27288424778,-9,896,4515,40
27288537752,27288537753,1,101,1495,40
27288867438,27288867427,-11,223,1588,40
27289792848,27289792843,-5,1664,4875,40
27291282087,27291282080,-7,1383,4135,40
27291415792,27291415809,17,1137,3939,40
27302349255,27302349248,-7,1062,3774,40
27304805367,27304805361,-6,803,3354,40
27306611988,27306611982,-6,1042,3444,40
27306931786,27306931794,8,18081,56393,40
27311392365,27311392358,-7,1025,4216,40
27316970851,27316970845,-6,521,3998,40
27318040598,27318040606,8,137,1220,40
27328783391,27328783384,-7,801,4956,40
27330739051,27330739052,1,1768,2067,40
27332098626,27332098621,-5,921,3329,40
27339027990,27339027986,-4,1002,3306,40
27345134662,27345134657,-5,1083,4022,40
27348363493,27348363495,2,2227,2353,40
27351646023,27351646018,-5,833,2504,40
27354223731,27354223726,-5,1184,4526,40
27354887873,27354887878,5,1525,986,40
27355500812,27355500831,19,1343,4702,40
27355871561,27355871557,-4,1121,4231,40
27363500580,27363500585,5,2225,1189,40
27364497006,27364497000,-6,1623,4189,40
27368052801,27368052799,-2,1314,1678,40
27372752119,27372752118,-1,1146,1842,40
27376840780,27376840802,22,808,3354,40
27379343585,27379343582,-3,15711,9839,40
27381603593,27381603590,-3,831,2332,40
27382578015,27382578015,0,1009,1471,40
27384903108,27384903126,18,177,968,40
27388662348,27388662355,7,1974,1053,40
27392114982,27392114977,-5,872,3507,40
27394456427,27394456422,-5,1168,3648,40
27396912459,27396912454,-5,896,3420,40
27410519799,27410519793,-6,1180,2393,40
27411262094,27411262105,11,144,770,40
27411392254,27411392266,12,628,3073,40
27417278390,27417278397,7,2966,1159,40
27418655557,27418655552,-5,1234,6199,40
27418763084,27418763091,7,18269,22337,40
27420676026,27420676018,-8,704,3112,40
27429790515,27429790509,-6,835,3443,40
27429847270,27429847262,-8,166,1405,40
27438481110,27438481106,-4,794,2948,40
27438858926,27438858919,-7,1337,4323,40
27441632098,27441632090,-8,1143,4274,40
27447461671,27447461665,-6,866,2574,40
27449737427,27449737418,-9,884,3226,40
27453360874,27453360868,-6,1042,2672,40
27453567486,27453567481,-5,43042,21520,40
27458778185,27458778178,-7,893,4297,40
27460916196,27460916190,-6,1087,3782,40
27462148221,27462148214,-7,673,2795,40
27462833397,27462833417,20,438,2221,40
27489971027,27489971021,-6,654,3949,40
27503145616,27503145602,-14,997,2989,40
27506406014,27506406009,-5,1263,3367,40
27512260278,27512260282,4,2500,1749,40
27516943911,27516943905,-6,1467,4684,40
27522743257,27522743257,0,30447,14652,40
27523144879,27523144873,-6,773,3405,40
27525337214,27525337209,-5,850,2843,40
27528563482,27528563478,-4,821,2162,40
27529124813,27529124803,-10,286,1169,40
27530312309,27530312324,15,320,1776,40
27530929658,27530929654,-4,1030,2334,40
27531173330,27531173336,6,4384,1459,40
27532340176,27532340170,-6,1618,3592,40
27538445741,27538445737,-4,884,3670,40
27547404787,27547404779,-8,973,2857,40
27548273107,27548273104,-3,1071,3256,40
27548320358,27548320353,-5,178,1022,40
27549285807,27549285787,-20,787,3454,40
27549330036,27549330028,-8,1028,4311,40
27554259538,27554259531,-7,1310,3503,40
27558620066,27558620071,5,3287,1386,40
27562466282,27562466276,-6,1229,3571,40
27567485608,27567485612,4,2602,1254,40
27568712357,27568712350,-7,1228,3043,40
27569211161,27569211167,6,3599,1460,40
27569600095,27569600095,0,974,1280,40
27569630215,27569630199,-16,152,1273,40
27570433183,27570433196,13,2174,5772,40
27577991902,27577991898,-4,1210,2792,40
27588258402,27588258394,-8,1197,3790,40
27594726426,27594726421,-5,463,3712,40
27598304343,27598304337,-6,701,4067,40
27600890466,27600890461,-5,674,3093,40
27601123381,27601123369,-12,140,946,40
27603158939,27603158933,-6,914,3739,40
27605885359,27605885379,20,791,3431,40
27608754482,27608754476,-6,1072,3685,40
27608789356,27608789357,1,1248,1516,40
27609272980,27609273000,20,750,3128,40
27612602072,27612602067,-5,1220,3956,40
27612971647,27612971640,-7,1022,4600,40
27613116967,27613116970,3,250,612,40
27619104185,27619104183,-2,2501,3709,40
27620582135,27620582133,-2,1155,1549,40
27622857506,27622857501,-5,811,3433,40
27625039210,27625039203,-7,1033,3154,40
27626260021,27626260028,7,2514,1089,40
27628449610,27628449606,-4,889,3043,40
27630030342,27630030337,-5,1205,3025,40
27630331678,27630331673,-5,976,3028,40
27632333911,27632333906,-5,1004,2937,40
27638224754,27638224747,-7,1123,4607,40
27639411578,27639411571,-7,489,1929,40
27642536426,27642536422,-4,1062,2578,40
27642801170,27642801165,-5,680,2722,40
27643025784,27643025803,19,229,1076,40
27648507554,27648507549,-5,1754,8039,40
27652245590,27652245585,-5,708,5064,40
27667038675,27667038669,-6,856,3851,40
27672224757,27672224762,5,1345,986,40
27673130825,27673130820,-5,1228,4583,40
27683126643,27683126637,-6,1279,5202,40
27684495545,27684495538,-7,1014,3615,40
27685059855,27685059875,20,804,1762,40
27688063962,27688063961,-1,635,1141,40
27688903149,27688903142,-7,1325,4625,40
27698333634,27698333629,-5,1267,5269,40
27700364155,27700364150,-5,672,3289,40
27702675036,27702675032,-4,1135,2498,40
27706689411,27706689408,-3,952,2380,40
27714946687,27714946681,-6,1040,3558,40
27718962023,27718962019,-4,1149,3231,40
27719201975,27719201981,6,88,941,40
27719262008,27719262018,10,1504,5097,40
27719603924,27719603926,2,1067,1326,40
27720640375,27720640369,-6,925,3304,40
27725575935,27725575931,-4,953,2458,40
27725618487,27725618508,21,398,882,40
27730466779,27730466773,-6,1213,4200,40
27743323646,27743323639,-7,898,3789,40
27744052694,27744052688,-6,1231,3309,40
27747874264,27747874258,-6,1626,4722,40
27748170794,27748170786,-8,1099,4589,40
27749161677,27749161696,19,318,1816,40
27755740563,27755740558,-5,1314,3559,40
27760415831,27760415826,-5,1022,2882,40
27766090149,27766090150,1,2626,2699,40
27772728221,27772728217,-4,936,3145,40
27786635635,27786635630,-5,1035,3104,40
27788724229,27788724222,-7,1023,4534,40
27789708633,27789708639,6,1516,947,40
27790740039,27790740034,-5,902,3122,40
27794488177,27794488177,0,1014,1578,40
27799418608,27799418627,19,518,2340,40
27803065690,27803065686,-4,884,3337,40
27815582973,27815582968,-5,923,4366,40
27815872198,27815872211,13,236,1249,40
27825789682,27825789678,-4,1089,2734,40
27826314147,27826314142,-5,762,2217,40
27827036768,27827036762,-6,772,4204,40
27833115473,27833115473,0,1366,1428,40
27839027546,27839027545,-1,2320,4601,40
27839866702,27839866698,-4,1017,2556,40
27841753324,27841753317,-7,1364,4070,40
27842410133,27842410118,-15,125,899,40
27844641078,27844641073,-5,912,2711,40
27845038445,27845038461,16,1329,4863,40
27845259623,27845259637,14,296,1314,40
27845960223,27845960230,7,225,1010,40
27858663430,27858663429,-1,2965,3650,40
27863729035,27863729026,-9,749,1320,40
27867781902,27867781898,-4,509,1937,40
27868945100,27868945103,3,3204,1715,40
27871405602,27871405601,-1,799,2086,40
27872056455,27872056457,2,387,1365,40
27883688298,27883688294,-4,973,4047,40
27887429507,27887429503,-4,2074,5599,40
27888143964,27888143961,-3,1062,3194,40
27891722020,27891722014,-6,1127,3267,40
27896693083,27896693076,-7,733,4431,40
27900698190,27900698186,-4,1132,3820,40
27901069015,27901069010,-5,1022,2919,40
27901540846,27901540840,-6,1138,3005,40
27903858934,27903858929,-5,948,2828,40
27903980062,27903980079,17,178,1011,40
27905200777,27905200771,-6,952,2921,40
27906614737,27906614733,-4,1137,4728,40
27913430202,27913430197,-5,1030,3290,40
27915039040,27915039057,17,268,1117,40
27917603850,27917603844,-6,567,3430,40
27919274423,27919274417,-6,908,2892,40
27922359893,27922359905,12,14906,47919,40
27925110730,27925110724,-6,1367,4161,40
27931507842,27931507842,0,1392,2237,40
27937615495,27937615491,-4,1305,2970,40
27941704460,27941704460,0,1144,1434,40
27942538430,27942538430,0,2831,3374,40
27944139326,27944139321,-5,604,3373,40
27944503863,27944503851,-12,97,1223,40
27948131267,27948131261,-6,971,4203,40
27951154407,27951154410,3,1989,1438,40
27960677886,27960677884,-2,1742,4350,40
27961850987,27961850982,-5,528,1953,40
27962401934,27962401929,-5,954,3162,40
27963689722,27963689716,-6,767,3026,40
27964477708,27964477701,-7,830,3556,40
27964896630,27964896624,-6,796,2890,40
27965581494,27965581486,-8,1036,4777,40
27968181746,27968181754,8,698,511,40
27970868861,27970868857,-4,1057,3232,40
27979113946,27979113947,1,2713,3941,40
27979874080,27979874074,-6,1200,4522,40
27981623698,27981623693,-5,1480,5035,40
27982671053,27982671047,-6,1065,4141,40
27984376537,27984376533,-4,1384,4082,40
27991608298,27991608293,-5,1378,3169,40
27993493643,27993493637,-6,812,4034,40
27995091357,27995091352,-5,530,2387,40
27995889301,27995889308,7,6181,2452,40
27996064569,27996064563,-6,1146,3456,40
27997773303,27997773307,4,3039,2259,40
28000173105,28000173098,-7,846,3893,40
28005407732,28005407738,6,2088,504,40
28010404831,28010404825,-6,1156,3710,40
28011862807,28011862826,19,614,3675,40
28012305305,28012305299,-6,1012,2846,40
28012437885,28012437889,4,10419,21017,40
28014191295,28014191291,-4,706,2137,40
28031456447,28031456439,-8,642,2251,40
28031620248,28031620266,18,321,1526,40
28037608619,28037608612,-7,857,3153,40
28038109086,28038109099,13,345,942,40
28041913655,28041913648,-7,1190,3173,40
28048324067,28048324068,1,1311,1255,40
28049265283,28049265281,-2,1029,2543,40
28051048946,28051048950,4,2163,1333,40
28052536630,28052536631,1,1643,1446,40
28055632942,28055632935,-7,922,3729,40
28063413154,28063413147,-7,1228,2608,40
28064312934,28064312942,8,244,930,40
28068587455,28068587450,-5,1315,3676,40
28071139982,28071139975,-7,558,3819,40
28071410822,28071410829,7,289,1605,40
28072533874,28072533869,-5,1859,7673,40
28075320495,28075320495,0,1604,2416,40
28078098134,28078098127,-7,998,3300,40
28079610122,28079610120,-2,1504,2854,40
28083284421,28083284417,-4,978,3573,40
28086295570,28086295565,-5,1007,3185,40
28086784621,28086784624,3,2650,1706,40
28092635777,28092635760,-17,990,3821,40
28092893799,28092893810,11,976,2702,40
28096178970,28096178974,4,1503,1010,40
28099890647,28099890641,-6,799,2282,40
28100066543,28100066543,0,287,2116,40
28102505277,28102505272,-5,925,3351,40
28103167269,28103167264,-5,1046,3413,40
28112525457,28112525451,-6,837,2774,40
28119465074,28119465068,-6,1343,3687,40
28121432893,28121432889,-4,1372,4310,40
28121510811,28121510812,1,1654,1843,40
28121618721,28121618714,-7,1249,4614,40
28125189281,28125189275,-6,706,3160,40
28128595773,28128595766,-7,1308,5174,40
28130094034,28130094028,-6,1084,3508,40
28131268140,28131268137,-3,4750,10161,40
28133569623,28133569616,-7,559,3077,40
28138186323,28138186318,-5,997,3716,40
28144917397,28144917394,-3,1402,1812,40
28145392416,28145392422,6,5830,2223,40
28146095049,28146095044,-5,982,2993,40
28166089887,28166089883,-4,264,1601,40
28166706855,28166706870,15,712,3692,40
28169772338,28169772332,-6,1170,3218,40
28178173108,28178173107,-1,1557,3091,40
28185985477,28185985474,-3,1335,2365,40
28186409315,28186409310,-5,810,2672,40
28189568679,28189568696,17,27641,18364,40
28202688409,28202688401,-8,586,2798,40
28208784086,28208784080,-6,647,2502,40
28210697898,28210697893,-5,1259,4176,40
28211051776,28211051758,-18,238,1064,40
28211698118,28211698100,-18,120,1350,40
28211783003,28211783006,3,2491,2574,40
28212796366,28212796361,-5,802,4566,40
28213350695,28213350695,0,82,1110,40
28216142384,28216142383,-1,1265,1974,40
28220467244,28220467244,0,35184,19887,40
28227935446,28227935441,-5,1423,3947,40
28229438918,28229438915,-3,1621,2060,40
28236257534,28236257529,-5,1027,3657,40
28236283717,28236283712,-5,341,1286,40
28250620390,28250620386,-4,693,2768,40
28255225671,28255225666,-5,1122,3845,40
28259997177,28259997169,-8,1295,4406,40
28261343225,28261343218,-7,1499,4247,40
28261990582,28261990578,-4,1290,3981,40
28264083129,28264083134,5,2635,1480,40
28264682954,28264682949,-5,865,2184,40
28268928140,28268928135,-5,1141,3185,40
28269942105,28269942098,-7,1071,5630,40
28270518707,28270518703,-4,1114,4310,40
28274034430,28274034427,-3,752,2475,40
28274732085,28274732107,22,927,3432,40
28279604045,28279604039,-6,1381,3664,40
28285385435,28285385429,-6,988,4462,40
28290913849,28290913841,-8,976,2994,40
28291425366,28291425361,-5,911,3573,40
28291463309,28291463325,16,358,1258,40
28300267275,28300267270,-5,1142,4020,40
28300509935,28300509915,-20,148,689,40
28318152673,28318152667,-6,830,3013,40
28318603606,28318603590,-16,237,1339,40
28321347800,28321347810,10,357,1946,40
28321959262,28321959256,-6,868,3872,40
28323541481,28323541485,4,4938,2158,40
28326173142,28326173136,-6,704,4038,40
28328221940,28328221934,-6,815,3481,40
28328790486,28328790491,5,1388,1560,40
28330747104,28330747110,6,3463,956,40
28333643030,28333643026,-4,1199,3255,40
28334324640,28334324639,-1,1615,2120,40
28336455292,28336455285,-7,1118,3520,40
28339263382,28339263386,4,669,681,40
28343958711,28343958706,-5,925,2381,40
28353637415,28353637410,-5,932,3847,40
28357148349,28357148362,13,304,908,40
28359834639,28359834633,-6,1006,3975,40
28361178995,28361178989,-6,1098,4185,40
28371267115,28371267107,-8,904,4658,40
28386369719,28386369713,-6,1258,4526,40
28395021860,28395021861,1,7935,7521,40
28395918898,28395918890,-8,1281,4153,40
28396687913,28396687911,-2,947,2344,40
28409498334,28409498332,-2,1021,1976,40
28410771261,28410771253,-8,966,4449,40
28411389645,28411389640,-5,954,1884,40
28412059322,28412059318,-4,847,3031,40
28417960919,28417960913,-6,1251,3947,40
28423210837,28423210838,1,1603,1203,40
28426164225,28426164232,7,6078,31425,40
28430025887,28430025881,-6,1079,4474,40
28432667446,28432667441,-5,697,2234,40
28432873679,28432873698,19,1188,3074,40
28452384139,28452384133,-6,775,4090,40
28454647549,28454647544,-5,1129,3252,40
28455185509,28455185493,-16,147,1118,40
28462027041,28462027034,-7,1610,5395,40
28462425439,28462425435,-4,736,2738,40
28464754805,28464754799,-6,1043,2939,40
28468853699,28468853693,-6,1160,4778,40
28468913668,28468913656,-12,254,1563,40
28482217979,28482217974,-5,1036,3041,40
28483988173,28483988166,-7,1077,4861,40
28489746136,28489746130,-6,1028,4154,40
28492069411,28492069404,-7,765,3451,40
28492405237,28492405230,-7,200,1202,40
28492609694,28492609689,-5,1123,4001,40
28493156369,28493156372,3,1505,1189,40
28498062816,28498062808,-8,745,3629,40
28500728398,28500728390,-8,612,1435,40
28507002925,28507002920,-5,650,3180,40
28515661332,28515661334,2,1615,1750,40
28516259292,28516259305,13,102,1214,40
28522123858,28522123857,-1,1170,1837,40
28533659228,28533659233,5,4421,1162,40
28538906947,28538906942,-5,881,4249,40
28540667558,28540667578,20,777,2887,40
28543189177,28543189170,-7,1106,5057,40
28543232064,28543232083,19,285,973,40
28546063261,28546063263,2,1616,1376,40
28548037445,28548037437,-8,950,2750,40
28551291100,28551291112,12,1229,986,40
28557542042,28557542037,-5,1295,3057,40
28564759180,28564759181,1,24256,30532,40
28570813139,28570813133,-6,835,2969,40
28574056186,28574056181,-5,1054,3933,40
28577072555,28577072552,-3,1509,2787,40
28578274221,28578274214,-7,3040,11771,40
28580672141,28580672134,-7,1409,6939,40
28581779185,28581779180,-5,912,2731,40
28590714943,28590714935,-8,914,2554,40
28592266110,28592266106,-4,1109,2714,40
28596793902,28596793903,1,2104,1747,40
28600367979,28600367973,-6,1069,3716,40
28600599885,28600599899,14,238,978,40
28600983151,28600983129,-22,1023,3604,40
28601427461,28601427477,16,878,2091,40
28605015835,28605015830,-5,1110,3986,40
28610847038,28610847034,-4,1182,2798,40
28613750726,28613750726,0,1444,1589,40
28616185297,28616185290,-7,718,3767,40
28616278628,28616278648,20,689,3213,40
28621350631,28621350626,-5,721,2786,40
28623961770,28623961783,13,15582,26072,40
28626020763,28626020758,-5,1097,2622,40
28626890834,28626890829,-5,569,1572,40
28628486974,28628486989,15,1186,2517,40
28628700476,28628700470,-6,1010,2696,40
28628819398,28628819417,19,448,2345,40
28629172506,28629172503,-3,577,2785,40
28641758180,28641758173,-7,1057,4048,40
28642830428,28642830414,-14,798,4986,40
28643921474,28643921469,-5,906,3470,40
28646159647,28646159629,-18,1064,3436,40
28650040822,28650040814,-8,803,4554,40
28650155961,28650155958,-3,1301,2722,40
28654626190,28654626194,4,3675,2901,40
28658112979,28658112973,-6,955,3919,40
28667641071,28667641066,-5,2013,4924,40
28668773534,28668773536,2,2337,2283,40
28673594538,28673594533,-5,933,2055,40
28674520284,28674520266,-18,162,1101,40
28679976931,28679976926,-5,1125,3168,40
28686899383,28686899378,-5,1074,3480,40
28687027254,28687027249,-5,1060,2651,40
28687876263,28687876259,-4,327,949,40
28690551590,28690551583,-7,638,3815,40
28690775293,28690775309,16,269,1525,40
28691389458,28691389453,-5,1381,4471,40
28696524379,28696524374,-5,1260,3785,40
28698805459,28698805454,-5,845,2652,40
28707429798,28707429799,1,16010,14127,40
28709204935,28709204930,-5,1100,4273,40
28709511619,28709511618,-1,2251,4050,40
28710724054,28710724049,-5,1358,3611,40
28713806379,28713806374,-5,986,3749,40
28714068956,28714068978,22,542,3368,40
28714339962,28714339957,-5,1235,3796,40
28717316970,28717316965,-5,1126,3134,40
28720003394,28720003396,2,2128,2868,40
28722640070,28722640064,-6,948,2492,40
28726246429,28726246425,-4,1357,1930,40
28726763571,28726763566,-5,925,3695,40
28726852315,28726852310,-5,680,2749,40
28739704894,28739704898,4,2983,1718,40
28742686103,28742686105,2,103,727,40
28754850946,28754850939,-7,1295,3821,40
28756674559,28756674554,-5,1150,2401,40
28760369745,28760369734,-11,718,3321,40
28765007177,28765007171,-6,1949,5917,40
28772137584,28772137578,-6,710,2606,40
28772783252,28772783241,-11,517,1817,40
28773539471,28773539488,17,837,2803,40
28774179814,28774179797,-17,1206,689,40
28775811561,28775811554,-7,1161,4903,40
28781846986,28781846985,-1,912,1621,40
28786709793,28786709788,-5,1048,4068,40
28786807061,28786807046,-15,899,4243,40
28794510089,28794510089,0,2183,1671,40
28809076950,28809076954,4,1603,1487,40
28817458887,28817458884,-3,1217,3141,40
28820040794,28820040792,-2,1398,2858,40
28824167717,28824167710,-7,762,2616,40
28825298958,28825298977,19,297,1188,40
28827643781,28827643774,-7,1090,3748,40
28827780414,28827780434,20,63,1076,40
28834016645,28834016641,-4,715,3294,40
28840806969,28840806965,-4,615,1526,40
28843446043,28843446038,-5,2127,5055,40
28855017326,28855017319,-7,731,3550,40
28856633220,28856633214,-6,681,3827,40
28856757324,28856757346,22,460,4214,40
28863002451,28863002446,-5,558,3146,40
28864544533,28864544530,-3,1254,1969,40
28864897074,28864897069,-5,1275,4565,40
28865773325,28865773319,-6,838,3900,40
28872261511,28872261516,5,1123,912,40
28874145144,28874145138,-6,920,2603,40
28882197359,28882197354,-5,970,3597,40
28882600052,28882600066,14,329,1287,40
28883891410,28883891412,2,3319,3403,40
28888824821,28888824821,0,1478,1563,40
28897512586,28897512589,3,4048,3688,40
28904775229,28904775226,-3,741,2972,40
28914544380,28914544375,-5,911,3009,40
28931750182,28931750178,-4,1026,2443,40
28934479100,28934479092,-8,826,2471,40
28934994206,28934994201,-5,1040,3056,40
28941448975,28941448978,3,292,1307,40
28942326369,28942326362,-7,1182,4626,40
28945616113,28945616106,-7,604,3775,40
28948531867,28948531865,-2,1034,2153,40
28955474409,28955474413,4,1531,1408,40
28972643142,28972643143,1,1898,1814,40
28978816566,28978816558,-8,866,4206,40
28979437927,28979437922,-5,1009,3016,40
28981264974,28981264980,6,13063,21296,40
28986096146,28986096151,5,2762,1677,40
28987663063,28987663059,-4,491,2517,40
28993451293,28993451287,-6,1352,4594,40
28999610497,28999610490,-7,900,4425,40
29003091682,29003091676,-6,1140,3469,40
29006897266,29006897268,2,48004,4553,40
29012510038,29012510031,-7,1044,3380,40
29012988624,29012988638,14,241,1105,40
29013119250,29013119242,-8,932,3884,40
29018094741,29018094741,0,1604,1974,40
29033640775,29033640770,-5,808,2623,40
29041848099,29041848103,4,2439,1732,40
29056168753,29056168759,6,3214,1248,40
29057181170,29057181166,-4,1234,3578,40
29064275026,29064275021,-5,1007,4532,40
29065432947,29065432939,-8,868,3958,40
29078649497,29078649491,-6,976,3255,40
29080749760,29080749753,-7,1227,4685,40
29081198438,29081198458,20,636,2947,40
29083713799,29083713793,-6,809,3090,40
29083889216,29083889229,13,179,1084,40
29088312599,29088312593,-6,1012,4287,40
29096446019,29096446013,-6,1202,4655,40
29097476998,29097477015,17,660,2648,40
29102748193,29102748185,-8,1148,3336,40
29111972482,29111972478,-4,987,2510,40
29118411258,29118411250,-8,1190,4321,40
29118989629,29118989617,-12,806,3694,40
29126394157,29126394151,-6,365,1059,40
29129762557,29129762550,-7,1183,4001,40
29135695291,29135695285,-6,1628,4239,40
29140588868,29140588862,-6,1001,3771,40
29144730353,29144730345,-8,854,3042,40
29146765679,29146765673,-6,892,2226,40
29148346327,29148346320,-7,1144,3381,40
29152360287,29152360279,-8,1078,3663,40
29152756261,29152756278,17,134,1210,40
29153188737,29153188744,7,6678,2125,40
29153303741,29153303734,-7,1069,4415,40
29160828286,29160828281,-5,1340,3595,40
29163389593,29163389589,-4,1314,3218,40
29166812631,29166812625,-6,939,3592,40
29167065376,29167065395,19,39,1013,40
29168498014,29168498007,-7,983,4474,40
29169124096,29169124098,2,1761,2335,40
29176803398,29176803403,5,102,718,40
29192838861,29192838856,-5,967,4235,40
29196009648,29196009642,-6,905,3765,40
29196516321,29196516317,-4,472,2389,40
29197346081,29197346083,2,1167,1326,40
29208517570,29208517563,-7,1020,3486,40
29215609458,29215609454,-4,982,3095,40
29216247554,29216247549,-5,827,2972,40
29222781238,29222781232,-6,1382,4307,40
29224104681,29224104674,-7,1287,2708,40
29230894243,29230894238,-5,624,2449,40
29230971255,29230971246,-9,619,649,40
29236643932,29236643934,2,22137,22391,40
29242272053,29242272069,16,663,2948,40
29242432398,29242432393,-5,863,3481,40
29243012582,29243012576,-6,871,4463,40
29243210158,29243210159,1,3921,3291,40
29244675957,29244675951,-6,1012,3962,40
29245560203,29245560198,-5,922,3143,40
29250389471,29250389463,-8,643,2701,40
29250566566,29250566552,-14,146,1339,40
29252192710,29252192705,-5,540,1708,40
29253084790,29253084783,-7,963,3755,40
29253200592,29253200604,12,485,4330,40
29253578597,29253578590,-7,1265,6229,40
29256114067,29256114062,-5,723,2964,40
29256435348,29256435362,14,715,5213,40
29259338203,29259338195,-8,1095,4740,40
29262652265,29262652258,-7,830,2398,40
29262759038,29262759031,-7,198,981,40
29263292547,29263292542,-5,1094,2194,40
29264198791,29264198786,-5,813,2638,40
29265590109,29265590102,-7,1033,4723,40
29267835311,29267835302,-9,818,4415,40
29270214405,29270214402,-3,881,1861,40
29270554221,29270554236,15,69,2034,40
29271731382,29271731380,-2,1589,2883,40
29272263388,29272263391,3,1524,1176,40
29274154602,29274154598,-4,1302,3552,40
29276154959,29276154954,-5,1010,3401,40
29281236402,29281236396,-6,972,3094,40
29282639401,29282639396,-5,1698,5943,40
29285521377,29285521371,-6,1240,2831,40
29286109636,29286109622,-14,128,788,40
29294450127,29294450121,-6,714,3928,40
29300739117,29300739121,4,1814,1021,40
29301837619,29301837617,-2,1517,2442,40
29302222486,29302222478,-8,772,3027,40
29306381766,29306381761,-5,1232,3749,40
29307710702,29307710706,4,2439,1628,40
29310488718,29310488712,-6,1241,4757,40
29312589294,29312589287,-7,1128,5220,40
29315097535,29315097528,-7,1110,4688,40
29315256917,29315256918,1,217,1126,40
29315982575,29315982570,-5,1212,3602,40
29317657334,29317657326,-8,809,3325,40
29324420939,29324420932,-7,389,3263,40
29324493394,29324493390,-4,1050,3393,40
29332342809,29332342808,-1,1127,1288,40
29333390262,29333390255,-7,1250,4764,40
29337349571,29337349566,-5,1118,3792,40
29337429510,29337429527,17,143,1221,40
29344008419,29344008413,-6,720,2266,40
29347000022,29347000017,-5,825,3281,40
29348447197,29348447191,-6,1158,3250,40
29349049621,29349049637,16,348,909,40
29352056448,29352056466,18,916,3335,40
29357967092,29357967093,1,1536,2315,40
29369531510,29369531505,-5,1422,4707,40
29375453074,29375453078,4,1949,1838,40
29378240017,29378240011,-6,910,2705,40
29379112293,29379112303,10,106,1411,40
29379327966,29379327962,-4,150,1297,40
29380478574,29380478594,20,152,1610,40
29380721781,29380721772,-9,1227,3463,40
29388259003,29388259017,14,1079,1164,40
29388681367,29388681381,14,449,1805,40
29396965634,29396965645,11,12977,49840,40
29401336661,29401336655,-6,987,4071,40
29401961312,29401961327,15,340,1424,40
29404356695,29404356694,-1,1976,2299,40
29417599261,29417599256,-5,1253,4174,40
29418757859,29418757856,-3,2163,5842,40
29419238278,29419238272,-6,1393,3759,40
29419778354,29419778346,-8,1068,3482,40
29443124067,29443124067,0,1073,2411,40
29446978702,29446978696,-6,1300,5374,40
29449634965,29449634959,-6,1053,3444,40
29449805536,29449805518,-18,198,815,40
29450829374,29450829378,4,1916,1664,40
29452938665,29452938662,-3,1021,2656,40
29455649574,29455649569,-5,1006,4063,40
29462876614,29462876634,20,305,1347,40
29462997423,29462997405,-18,139,1102,40
29473507637,29473507637,0,1343,614,40
29479529455,29479529449,-6,914,4245,40
29486859641,29486859635,-6,1003,4060,40
29487815676,29487815674,-2,205,1223,40
29488398469,29488398490,21,59,791,40
29489438250,29489438245,-5,1098,2890,40
29493169699,29493169693,-6,852,3612,40
29493345830,29493345845,15,896,3556,40
29495246951,29495246945,-6,1002,3970,40
29498032824,29498032834,10,2029,12216,40
29499464263,29499464278,15,607,2040,40
29499953298,29499953293,-5,1196,3311,40
29500122277,29500122299,22,261,801,40
29506998791,29506998788,-3,712,1332,40
29510792930,29510792922,-8,692,2073,40
29511027573,29511027594,21,204,1595,40
29512468367,29512468357,-10,1544,5152,40
29514299588,29514299581,-7,1298,4843,40
29515634992,29515634985,-7,1241,2147,40
29515926564,29515926578,14,33,1214,40
29523209436,29523209450,14,195,1235,40
29523856982,29523856976,-6,1189,5018,40
29526144447,29526144457,10,281,1501,40
29526202888,29526202889,1,1173,1262,40
29532674269,29532674262,-7,1352,7678,40
29533069928,29533069923,-5,1214,2789,40
29533225949,29533225943,-6,17,867,40
29533431872,29533431866,-6,1309,2987,40
29535893202,29535893202,0,1545,1373,40
29540220838,29540220830,-8,1178,7308,40
29541759446,29541759441,-5,805,4652,40
29544657646,29544657651,5,3592,1451,40
29546311641,29546311633,-8,686,2651,40
29549445417,29549445412,-5,1405,4250,40
29553794441,29553794438,-3,1785,2551,40
29556307361,29556307357,-4,843,3515,40
29559290637,29559290631,-6,2727,8571,40
29560237795,29560237790,-5,710,3756,40
29561596640,29561596652,12,12953,45194,40
29562164865,29562164860,-5,971,3704,40
29562591558,29562591549,-9,277,967,40
29563318159,29563318172,13,389,1325,40
29566280734,29566280728,-6,858,2599,40
29566862998,29566863018,20,819,3452,40
29567861411,29567861405,-6,833,2763,40
29570318474,29570318482,8,10438,33547,40
29571066451,29571066445,-6,1058,4847,40
29571261361,29571261357,-4,690,3326,40
29574836438,29574836432,-6,905,3475,40
29576767261,29576767254,-7,329,3005,40
29577351074,29577351067,-7,1040,4020,40
29580397514,29580397509,-5,767,2679,40
29586581827,29586581822,-5,984,3083,40
29589959243,29589959235,-8,896,3121,40
29590925262,29590925278,16,90,779,40
29594386003,29594385998,-5,1473,4198,40
29599123082,29599123077,-5,643,2959,40
29603850930,29603850924,-6,1387,10406,40
29604586565,29604586562,-3,665,3539,40
29607545254,29607545258,4,897,887,40
29607722972,29607722990,18,237,883,40
29608457535,29608457549,14,695,3152,40
29620890758,29620890755,-3,2613,4177,40
29631826590,29631826585,-5,844,1833,40
29635878895,29635878889,-6,857,3740,40
29637200551,29637200545,-6,1341,3570,40
29641935207,29641935203,-4,640,1976,40
29646423922,29646423917,-5,1136,5659,40
29659519571,29659519566,-5,867,3261,40
29660687586,29660687580,-6,1252,4958,40
29665936089,29665936085,-4,1023,3423,40
29666804037,29666804043,6,4029,2752,40
29669219673,29669219667,-6,1093,4570,40
29670548670,29670548689,19,837,2984,40
29671326551,29671326566,15,824,2340,40
29671678159,29671678154,-5,1095,3046,40
29672427235,29672427230,-5,809,3699,40
29673710970,29673710966,-4,760,2713,40
29675242134,29675242129,-5,940,2988,40
29679344695,29679344690,-5,1026,4252,40
29683040339,29683040334,-5,857,2283,40
29686181552,29686181548,-4,1184,2757,40
29690278857,29690278861,4,3687,2541,40
29694864538,29694864523,-15,15,931,40
29697953063,29697953063,0,1873,1931,40
29698500587,29698500582,-5,1288,3423,40
29699334893,29699334887,-6,149,841,40
29702400815,29702400811,-4,2120,3950,40
29703300167,29703300162,-5,1049,4265,40
29703924575,29703924557,-18,282,1196,40
29705779229,29705779229,0,1057,1777,40
29708169171,29708169166,-5,970,4419,40
29708674529,29708674522,-7,1196,4597,40
29716760019,29716760013,-6,793,2779,40
29721887487,29721887480,-7,740,2620,40
29722384887,29722384866,-21,3,1251,40
29726104811,29726104806,-5,867,2784,40
29729805241,29729805235,-6,1437,3846,40
29731038715,29731038714,-1,1238,3026,40
29732423011,29732423025,14,10958,48984,40
29733571591,29733571600,9,240,1066,40
29736173385,29736173390,5,4286,1987,40
29740106311,29740106313,2,1121,1358,40
29740301950,29740301950,0,1034,1048,40
29741755490,29741755484,-6,1064,3767,40
29743906831,29743906826,-5,1062,3440,40
29749891314,29749891307,-7,1073,3593,40
29752046109,29752046112,3,3374,1821,40
29755959263,29755959257,-6,1097,4019,40
29757974506,29757974504,-2,1461,1918,40
29764663291,29764663286,-5,620,2849,40
29765449207,29765449201,-6,1021,3910,40
29770063580,29770063575,-5,1185,4584,40
29773086903,29773086897,-6,871,3990,40
29775928350,29775928345,-5,645,3767,40
29779800657,29779800657,0,1580,2054,40
29780622854,29780622850,-4,902,3441,40
29782008685,29782008703,18,13,844,40
29785953549,29785953541,-8,1390,5196,40
29786076166,29786076179,13,482,921,40
29787651726,29787651734,8,5754,2712,40
29795795567,29795795561,-6,956,3788,40
29800043290,29800043283,-7,1252,3576,40
29800479653,29800479647,-6,653,2913,40
29806521011,29806521006,-5,915,4683,40
29810301198,29810301194,-4,463,2562,40
29810476134,29810476137,3,1093,1449,40
29810552604,29810552615,11,14354,21730,40
29811261189,29811261183,-6,1202,3411,40
29813198069,29813198063,-6,1018,4314,40
29814233433,29814233429,-4,1073,3261,40
29818993815,29818993809,-6,1192,4391,40
29827641787,29827641781,-6,847,3685,40
29827674735,29827674750,15,622,2897,40
29829450985,29829450980,-5,982,2424,40
29829511533,29829511550,17,955,2525,40
29830290858,29830290853,-5,1048,5496,40
29838216466,29838216461,-5,1189,3857,40
29840322829,29840322826,-3,905,3574,40
29841207411,29841207410,-1,2578,2949,40
29841908197,29841908191,-6,1121,4883,40
29845611141,29845611137,-4,727,3207,40
29847460634,29847460626,-8,1201,5709,40
29854422405,29854422401,-4,805,2189,40
29876756696,29876756696,0,1807,2294,40
29885512748,29885512742,-6,690,3340,40
29885907935,29885907935,0,48,1073,40
29886788758,29886788773,15,731,3324,40
29887647619,29887647598,-21,934,2703,40
29897901353,29897901346,-7,942,4367,40
29898049206,29898049199,-7,754,2550,40
29899602374,29899602367,-7,1211,3469,40
29902841014,29902841010,-4,885,3598,40
29907938031,29907938019,-12,28281,17013,40
29909212785,29909212779,-6,1013,4126,40
29909257314,29909257309,-5,2005,9072,40
29910742653,29910742657,4,2302,1254,40
29912528403,29912528398,-5,1591,4000,40
29913216830,29913216813,-17,6456,3087,40
29916474223,29916474218,-5,1067,3417,40
29919204199,29919204193,-6,1188,3489,40
29922093374,29922093377,3,1347,1466,40
29922956770,29922956764,-6,485,4191,40
29926864632,29926864626,-6,1119,4240,40
29937953570,29937953564,-6,956,4110,40
29938897308,29938897302,-6,937,3174,40
29943706874,29943706869,-5,810,3156,40
29950961931,29950961926,-5,1093,3544,40
29951278462,29951278458,-4,2658,5233,40
29951636166,29951636161,-5,1149,4050,40
29954639402,29954639397,-5,554,2476,40
29955532704,29955532718,14,75,1126,40
29962221451,29962221446,-5,1025,3558,40
29962293037,29962293055,18,932,5099,40
29966123150,29966123143,-7,1001,3377,40
29968430188,29968430183,-5,639,1375,40
29969780562,29969780555,-7,1277,2158,40
29972129499,29972129502,3,1538,1778,40
29974558826,29974558828,2,1722,1290,40
29974922921,29974922914,-7,746,1290,40
29975278237,29975278231,-6,206,1158,40
29975586558,29975586552,-6,1321,4515,40
29980872195,29980872188,-7,1010,3889,40
29983087461,29983087454,-7,911,3896,40
29983955651,29983955649,-2,17681,42121,40
29986778830,29986778835,5,3907,1816,40
29988002948,29988002942,-6,1193,4541,40
29990642258,29990642252,-6,872,2670,40
29995723279,29995723273,-6,854,3946,40
29998042688,29998042682,-6,1141,4395,40
29999266824,29999266819,-5,1080,3443,40
30000053450,30000053451,1,2216,2022,40
30012741314,30012741308,-6,1036,3366,40
30016323336,30016323330,-6,940,4777,40
30016899935,30016899930,-5,1154,2901,40
30019714839,30019714834,-5,686,4437,40
30020448878,30020448899,21,518,2983,40
30020785647,30020785639,-8,853,4222,40
30022200742,30022200734,-8,913,9020,40
30026404414,30026404408,-6,1314,3679,40
30031423274,30031423270,-4,1243,2438,40
30037015028,30037015023,-5,692,1837,40
30037164335,30037164346,11,488,2545,40
30039716620,30039716612,-8,1065,4400,40
30040898165,30040898158,-7,1089,3909,40
30041490372,30041490374,2,2089,1742,40
30048659538,30048659533,-5,819,1549,40
30049379163,30049379158,-5,124,850,40
30050330483,30050330477,-6,1199,3738,40
30053249861,30053249856,-5,1289,5297,40
30056035959,30056035955,-4,721,3270,40
30057875064,30057875044,-20,1152,5190,40
30059679754,30059679747,-7,1045,3693,40
30059913297,30059913290,-7,1057,3875,40
30071380262,30071380258,-4,1200,4412,40
30071841951,30071841934,-17,877,4392,40
30071914452,30071914471,19,236,3127,40
30074665578,30074665582,4,4926,1959,40
30080499754,30080499749,-5,983,3894,40
30081195497,30081195494,-3,1074,2352,40
30082728743,30082728736,-7,1045,4834,40
30083508434,30083508438,4,2262,1962,40
30088392949,30088392944,-5,778,2622,40
30092873969,30092873964,-5,840,3604,40
30094195578,30094195572,-6,756,3147,40
30094583880,30094583877,-3,1109,2145,40
30102823994,30102823989,-5,1257,4355,40
30106678826,30106678822,-4,1120,3234,40
30109774713,30109774706,-7,1223,3621,40
30110313727,30110313736,9,269,942,40
30110985503,30110985507,4,32021,58030,40
30113698226,30113698221,-5,918,3798,40
30115778483,30115778474,-9,942,4260,40
30120156582,30120156586,4,3273,2642,40
30125053602,30125053597,-5,1074,3005,40
30135850546,30135850539,-7,955,4130,40
30137230805,30137230826,21,874,4166,40
30139826922,30139826915,-7,1239,4118,40
30140179884,30140179900,16,199,1508,40
30144312690,30144312685,-5,1345,3738,40
30159744902,30159744897,-5,706,2448,40
30159993469,30159993490,21,953,3338,40
30160455063,30160455058,-5,854,4915,40
30161786512,30161786498,-14,1037,3867,40
30162523142,30162523120,-22,126,1149,40
30162838140,30162838126,-14,1210,6542,40
30171404525,30171404530,5,13009,6283,40
30174319175,30174319170,-5,1109,3203,40
30174889101,30174889111,10,293,1497,40
30182626024,30182626017,-7,1007,4222,40
30182822239,30182822230,-9,722,3688,40
30183100343,30183100339,-4,575,2140,40
30186015346,30186015342,-4,703,2862,40
30186543877,30186543870,-7,1154,4064,40
30192083106,30192083101,-5,958,2532,40
30197754711,30197754705,-6,1326,4271,40
30197793566,30197793581,15,762,2253,40
30203687419,30203687413,-6,750,3552,40
30203746813,30203746792,-21,1263,4965,40
30204029078,30204029091,13,937,4890,40
30206928390,30206928385,-5,1023,2687,40
30214320290,30214320283,-7,896,3222,40
30216890038,30216890031,-7,787,3939,40
30224754258,30224754259,1,2216,2915,40
30226092059,30226092061,2,1208,1307,40
30228221859,30228221862,3,2261,1820,40
30231015765,30231015758,-7,705,3047,40
30231216672,30231216688,16,196,1065,40
30233170734,30233170729,-5,829,2856,40
30239441901,30239441895,-6,1056,3273,40
30241273571,30241273567,-4,1051,3002,40
30242963237,30242963230,-7,745,3257,40
30246491404,30246491398,-6,1438,3750,40
30246774916,30246774916,0,168,1439,40
30251553706,30251553701,-5,1021,3438,40
30258692263,30258692258,-5,1102,2951,40
30263655223,30263655218,-5,1249,3209,40
30266548383,30266548377,-6,1060,5017,40
30267805050,30267805047,-3,1398,2151,40
30280101931,30280101937,6,2516,1050,40
30282666346,30282666340,-6,1053,3242,40
30289711249,30289711245,-4,670,2712,40
30290944388,30290944406,18,362,1262,40
30293512266,30293512261,-5,795,4161,40
30294032703,30294032704,1,195,1492,40
30297138546,30297138541,-5,1136,3643,40
30299898801,30299898794,-7,942,3307,40
30304068184,30304068179,-5,1077,4146,40
30308390029,30308390023,-6,989,3997,40
30310983699,30310983704,5,2584,1370,40
30313083551,30313083545,-6,1210,3662,40
30323476414,30323476410,-4,1121,3451,40
30329094398,30329094390,-8,843,2856,40
30344690298,30344690294,-4,934,2916,40
30346380766,30346380761,-5,833,2444,40
30349571706,30349571698,-8,865,3497,40
30353159462,30353159462,0,1891,1827,40
30356496527,30356496522,-5,860,2511,40
30365261226,30365261218,-8,928,3299,40
30365871228,30365871242,14,374,1344,40
30368672869,30368672863,-6,1001,3860,40
30370553278,30370553273,-5,1263,3934,40
30371399763,30371399761,-2,1210,2226,40
30371907334,30371907321,-13,645,2749,40
30384656422,30384656417,-5,1254,4481,40
30385483658,30385483671,13,348,1678,40
30387116414,30387116410,-4,1178,3021,40
30411215645,30411215641,-4,728,3072,40
30411547302,30411547322,20,1202,2801,40
30413939982,30413939976,-6,554,2706,40
30416481909,30416481904,-5,1024,3198,40
30416806942,30416806927,-15,261,899,40
30430755611,30430755604,-7,755,3190,40
30431164035,30431164037,2,1664,1563,40
30432175727,30432175722,-5,937,3665,40
30444582667,30444582665,-2,261,1265,40
30444892429,30444892429,0,207,803,40
30447161309,30447161304,-5,992,1914,40
30459520389,30459520382,-7,787,2771,40
30462286630,30462286633,3,1564,1228,40
30462866189,30462866176,-13,882,3754,40
30463104582,30463104562,-20,985,2630,40
30463204637,30463204650,13,300,1113,40
30471201921,30471201930,9,14470,33236,40
30472268518,30472268525,7,3141,1226,40
30474788713,30474788708,-5,614,3781,40
30475086381,30475086364,-17,175,1123,40
30481240799,30481240793,-6,1195,3481,40
30481408325,30481408317,-8,2534,6364,40
30486013143,30486013136,-7,1063,3884,40
30486160047,30486160062,15,547,1950,40
30486734000,30486733994,-6,631,4669,40
30489260169,30489260164,-5,1220,3695,40
30492179522,30492179518,-4,822,3619,40
30493098519,30493098513,-6,1078,4358,40
30502661892,30502661905,13,792,4076,40
30511431193,30511431189,-4,1137,1518,40
30523564354,30523564349,-5,1062,3665,40
30526095742,30526095741,-1,2114,3409,40
30526300917,30526300914,-3,825,2289,40
30526952309,30526952303,-6,910,3468,40
30531684713,30531684707,-6,973,3708,40
30532239423,30532239427,4,205,1132,40
30539756888,30539756882,-6,1011,4206,40
30554588443,30554588437,-6,1317,4053,40
30554614575,30554614590,15,125,1047,40
30555845117,30555845110,-7,752,3851,40
30556644207,30556644200,-7,680,2068,40
30558588701,30558588695,-6,1323,3548,40
30563830030,30563830031,1,1682,1911,40
30564903950,30564903959,9,16011,22041,40
30566947014,30566947006,-8,973,4185,40
30577112925,30577112922,-3,794,2648,40
30583048743,30583048745,2,3937,2998,40
30586205338,30586205340,2,1283,1362,40
30592418447,30592418442,-5,884,3256,40
30593494399,30593494399,0,3058,2858,40
30600402305,30600402300,-5,1040,4015,40
30600765702,30600765703,1,1168,1081,40
30602161557,30602161551,-6,955,5388,40
30603050558,30603050553,-5,987,3209,40
30614576621,30614576616,-5,1119,2831,40
30622937286,30622937291,5,1501,1372,40
30623588715,30623588709,-6,1045,4054,40
30625368727,30625368722,-5,851,3979,40
30625745574,30625745569,-5,658,3549,40
30626182176,30626182167,-9,1114,4293,40
30634190110,30634190107,-3,949,1588,40
30637676853,30637676855,2,123,755,40
30637987221,30637987215,-6,222,1001,40
30641763965,30641763959,-6,883,3734,40
30648437007,30648437000,-7,801,4659,40
30653785190,30653785184,-6,1312,3611,40
30654734738,30654734733,-5,849,3304,40
30663299771,30663299765,-6,1129,3634,40
30666778743,30666778740,-3,831,3911,40
30667415337,30667415343,6,2621,1163,40
30675616523,30675616505,-18,3574,1569,40
30676767109,30676767131,22,436,3533,40
30681161024,30681161018,-6,930,3892,40
30684127768,30684127763,-5,895,1923,40
30687161552,30687161566,14,726,3133,40
30690661547,30690661541,-6,866,3579,40
30700908420,30700908438,18,51,1121,40
30703101754,30703101748,-6,846,3678,40
30703240830,30703240847,17,133,1340,40
30704462917,30704462910,-7,788,2487,40
30711105077,30711105070,-7,991,3440,40
30713404034,30713404029,-5,992,4521,40
30714717096,30714717088,-8,186,991,40
30729766123,30729766116,-7,760,4378,40
30730183983,30730183972,-11,1145,5084,40
30736358194,30736358189,-5,637,2537,40
30740097447,30740097440,-7,737,3053,40
30743172891,30743172885,-6,1032,3904,40
30743968775,30743968769,-6,345,2118,40
30747489379,30747489377,-2,991,2324,40
30751334335,30751334329,-6,1218,3149,40
30755646725,30755646719,-6,1162,3295,40
30757760669,30757760662,-7,837,3630,40
30766005978,30766005973,-5,950,3005,40
30766667200,30766667205,5,259,1118,40
30769883522,30769883516,-6,1210,5941,40
30772972470,30772972474,4,31286,25865,40
30780008375,30780008369,-6,782,3488,40
30780471946,30780471940,-6,1127,4152,40
30780642700,30780642716,16,858,3595,40
30783795594,30783795593,-1,16467,26129,40
30789976811,30789976807,-4,857,3297,40
30794194316,30794194313,-3,1029,2191,40
30794591492,30794591507,15,368,1250,40
30796357034,30796357031,-3,1283,3093,40
30797139219,30797139212,-7,907,4561,40
30800862168,30800862166,-2,1533,3368,40
30804636173,30804636169,-4,663,3875,40
30805213883,30805213878,-5,809,3483,40
30805820299,30805820297,-2,2111,4220,40
30807513472,30807513455,-17,1727,1046,40
30808513926,30808513922,-4,905,3324,40
30816936178,30816936173,-5,1057,2115,40
30825004429,30825004423,-6,1180,4209,40
30831598098,30831598090,-8,1006,5592,40
30838819994,30838819990,-4,1170,4585,40
30841240876,30841240871,-5,1187,3845,40
30841970246,30841970242,-4,2501,6483,40
30842063823,30842063818,-5,1032,2992,40
30842334661,30842334664,3,1887,1434,40
30848985055,30848985061,6,9755,35964,40
30850124211,30850124217,6,4123,1313,40
30852850485,30852850478,-7,1114,3615,40
30856961666,30856961667,1,735,1237,40
30870986219,30870986213,-6,1333,3393,40
30871139786,30871139780,-6,1260,2384,40
30887279022,30887279025,3,3722,2808,40
30890429541,30890429536,-5,1028,3798,40
30897632476,30897632469,-7,662,2238,40
30897921863,30897921857,-6,1491,5660,40
30899646571,30899646566,-5,1106,3378,40
30905295472,30905295465,-7,1009,3294,40
30908527816,30908527808,-8,1274,4828,40
30910376219,30910376219,0,1024,1542,40
30912047991,30912047984,-7,1042,4519,40
30912108157,30912108173,16,878,3546,40
30920988665,30920988659,-6,1202,4357,40
30921235358,30921235374,16,967,4458,40
30921566329,30921566334,5,1957,1214,40
30925770564,30925770546,-18,1139,3949,40
30928960065,30928960058,-7,982,4737,40
30930963905,30930963902,-3,1162,4169,40
30934236966,30934236967,1,35862,42365,40
30941924894,30941924889,-5,833,5141,40
30946733870,30946733872,2,930,1409,40
30949741506,30949741501,-5,1248,4127,40
30950667013,30950667012,-1,19,1243,40
30954362359,30954362350,-9,978,3885,40
30954487423,30954487414,-9,253,1747,40
30961919319,30961919313,-6,871,4514,40
30968968096,30968968092,-4,781,2302,40
30978012499,30978012494,-5,950,1852,40
30986870973,30986870969,-4,1033,4011,40
30989427102,30989427097,-5,721,2550,40
30991904051,30991904042,-9,980,3341,40
31000888334,31000888329,-5,949,4127,40
31000942741,31000942763,22,295,1434,40
31005188402,31005188395,-7,819,3417,40
31005759477,31005759462,-15,73,1362,40
31007324800,31007324795,-5,828,2295,40
31009987609,31009987604,-5,814,3514,40
31010080462,31010080478,16,315,1427,40
31010505015,31010505030,15,77,825,40
31010860203,31010860197,-6,840,3848,40
31013516553,31013516547,-6,755,4068,40
31015249731,31015249727,-4,703,3297,40
31015751975,31015751971,-4,502,1286,40
31021863944,31021863938,-6,1124,4760,40
31024209292,31024209286,-6,1031,5762,40
31025501503,31025501498,-5,812,4145,40
31038152960,31038152954,-6,854,3229,40
31043453943,31043453938,-5,761,2268,40
31045121582,31045121584,2,2791,3533,40
31049541317,31049541326,9,4470,1234,40
31051069397,31051069391,-6,1856,4443,40
31058674181,31058674173,-8,823,3002,40
31059585149,31059585167,18,196,859,40
31062397870,31062397874,4,2594,1586,40
31067753095,31067753090,-5,1405,5024,40
31069648807,31069648803,-4,896,2197,40
31069952140,31069952135,-5,195,819,40
31081160757,31081160752,-5,2077,8617,40
31081977407,31081977401,-6,1012,2317,40
31082100935,31082100919,-16,1085,4236,40
31085478442,31085478435,-7,1165,3505,40
31086792084,31086792077,-7,1217,3727,40
31089614164,31089614159,-5,462,1062,40
31091130549,31091130563,14,823,3271,40
31096365165,31096365167,2,1421,1119,40
31110844932,31110844927,-5,1038,3479,40
31119947313,31119947306,-7,860,3205,40
31126191564,31126191561,-3,943,2561,40
31126791830,31126791826,-4,43,1005,40
31130251895,31130251890,-5,585,3296,40
31134292407,31134292407,0,327,3012,40
31153149579,31153149572,-7,818,4302,40
31153565760,31153565775,15,273,1473,40
31160130361,31160130354,-7,1027,3495,40
31165101490,31165101508,18,768,53,40
31166633225,31166633226,1,1314,1714,40
31169902716,31169902722,6,4567,1169,40
31177533340,31177533334,-6,1235,4730,40
31177635510,31177635501,-9,1080,3660,40
31180427654,31180427649,-5,1340,3297,40
31181147010,31181147005,-5,963,4023,40
31182038871,31182038869,-2,218,1537,40
31184438809,31184438806,-3,1098,2320,40
31187658726,31187658721,-5,727,3642,40
31195331032,31195331029,-3,1100,3148,40
31195792169,31195792162,-7,883,4349,40
31198451158,31198451153,-5,1166,3059,40
31198496156,31198496149,-7,395,1258,40
31204664135,31204664130,-5,1081,4099,40
31204780419,31204780412,-7,1472,5205,40
31209950111,31209950103,-8,1103,5601,40
31210026369,31210026366,-3,219,1131,40
31211822426,31211822418,-8,676,4667,40
31217986209,31217986204,-5,826,3394,40
31219806261,31219806254,-7,1404,3384,40
31221877464,31221877461,-3,1104,2873,40
31223487941,31223487936,-5,1340,3793,40
31224360041,31224360037,-4,874,2347,40
31224749959,31224749961,2,1970,1672,40
31237668339,31237668333,-6,1026,4930,40
31237815240,31237815259,19,1181,3668,40
31248605226,31248605219,-7,963,4028,40
31248668414,31248668434,20,690,3155,40
31263567978,31263567994,16,169,697,40
31272585376,31272585369,-7,1134,4303,40
31273868189,31273868194,5,2645,1383,40
31283266923,31283266915,-8,865,3161,40
31285717375,31285717368,-7,430,2650,40
31286416783,31286416777,-6,980,3307,40
31288076801,31288076796,-5,928,2811,40
31293423613,31293423606,-7,868,2818,40
31297138034,31297138028,-6,1312,3968,40
31297470353,31297470346,-7,1142,5533,40
31311806222,31311806216,-6,29981,7848,40
31321866860,31321866862,2,926,874,40
31325152245,31325152238,-7,947,3568,40
31325280428,31325280447,19,289,1195,40
31327627503,31327627501,-2,995,2413,40
31334712622,31334712613,-9,947,2815,40
31335547508,31335547497,-11,148,597,40
31340976495,31340976490,-5,895,3935,40
31344281902,31344281898,-4,1131,4403,40
31347393029,31347393033,4,2292,1780,40
31351482938,31351482941,3,2038,1434,40
31355943358,31355943353,-5,833,2914,40
31356956195,31356956199,4,2460,1104,40
31358812067,31358812060,-7,988,4191,40
31377069052,31377069046,-6,959,3260,40
31377593384,31377593377,-7,1298,4097,40
31378615098,31378615092,-6,2541,8277,40
31384329561,31384329554,-7,1649,5806,40
31384498743,31384498748,5,2933,1680,40
31393960585,31393960577,-8,1174,5107,40
31395273326,31395273322,-4,1191,4957,40
31399340017,31399340012,-5,945,5244,40
31406847926,31406847921,-5,1246,3087,40
31425979929,31425979942,13,16113,45548,40
31426345917,31426345909,-8,908,3554,40
31431054299,31431054293,-6,888,3261,40
31436932547,31436932542,-5,980,3468,40
31442580822,31442580826,4,3597,2443,40
31443875915,31443875907,-8,1046,1565,40
31454864208,31454864207,-1,1206,1730,40
31455038997,31455039000,3,222,1580,40
31455743254,31455743270,16,146,840,40
31460426273,31460426266,-7,890,4579,40
31462145777,31462145770,-7,712,3403,40
31462850920,31462850927,7,292,1336,40
31465421203,31465421205,2,2580,2215,40
31470070870,31470070865,-5,1440,4763,40
31471308209,31471308205,-4,923,3166,40
31472561672,31472561665,-7,1413,3863,40
31486049998,31486049994,-4,741,2182,40
31488961820,31488961817,-3,1491,2918,40
31493721876,31493721870,-6,973,3980,40
31500127901,31500127901,0,1044,1388,40
31501997410,31501997415,5,3215,1656,40
31509000757,31509000762,5,4197,2629,40
31510439300,31510439294,-6,1227,4271,40
31513632288,31513632279,-9,1022,5206,40
31518224411,31518224390,-21,772,1556,40
31523603917,31523603910,-7,1182,4151,40
31524633262,31524633257,-5,1123,3076,40
31530053037,31530053032,-5,1177,3487,40
31532833669,31532833665,-4,1079,3653,40
31533326513,31533326507,-6,1466,5245,40
31536069226,31536069221,-5,4049,15519,40
31539192749,31539192737,-12,4400,16583,40
31546155500,31546155496,-4,922,4028,40
31546508502,31546508497,-5,801,2686,40
31546690735,31546690748,13,799,4085,40
31548569610,31548569605,-5,940,2852,40
31551135393,31551135396,3,20330,21765,40
31557368125,31557368122,-3,842,3073,40
31558361751,31558361764,13,1243,4030,40
31561408821,31561408815,-6,1192,3280,40
31564178154,31564178149,-5,1058,3938,40
31565892942,31565892937,-5,867,2480,40
31567958727,31567958722,-5,1249,3487,40
31572959257,31572959264,7,6449,2703,40
31579510587,31579510582,-5,1125,3097,40
31581433931,31581433926,-5,961,3866,40
31597948350,31597948350,0,1583,1851,40
31598189480,31598189499,19,258,1488,40
31603238923,31603238923,0,165,1263,40
31605666493,31605666486,-7,1086,4260,40
31623061651,31623061645,-6,1245,4253,40
31635925476,31635925469,-7,1203,6003,40
31636840624,31636840641,17,462,2217,40
31638160401,31638160397,-4,995,2967,40
31639556763,31639556756,-7,1124,1982,40
31645050569,31645050563,-6,1120,5981,40
31658616162,31658616155,-7,977,4080,40
31662398373,31662398375,2,1561,1393,40
31664270290,31664270294,4,20996,31344,40
31666181794,31666181790,-4,850,2783,40
31666342709,31666342707,-2,135,1596,40
31667447791,31667447791,0,991,2618,40
31667525718,31667525737,19,1373,4582,40
31668916661,31668916661,0,19961,10495,40
31669664462,31669664469,7,3927,1026,40
31673246603,31673246598,-5,1024,3599,40
31676277571,31676277563,-8,940,3840,40
31679950937,31679950930,-7,1149,3838,40
31683139444,31683139437,-7,930,3413,40
31685427639,31685427634,-5,1204,4268,40
31685687253,31685687249,-4,1152,4065,40
31693558171,31693558165,-6,1312,3518,40
31707139399,31707139392,-7,916,3588,40
31710954693,31710954690,-3,1457,1649,40
31722476949,31722476942,-7,1496,3656,40
31722873646,31722873666,20,1315,4080,40
31725482671,31725482665,-6,1164,3865,40
31738372495,31738372485,-10,973,2784,40
31738631774,31738631768,-6,1260,4122,40
31743930167,31743930174,7,1655,942,40
31748735863,31748735857,-6,608,3314,40
31751004105,31751004099,-6,1234,3684,40
31758222810,31758222805,-5,726,2691,40
31760781382,31760781378,-4,832,2593,40
31763807851,31763807847,-4,1276,2651,40
31766361106,31766361098,-8,1309,4362,40
31767956551,31767956544,-7,638,1587,40
31768705966,31768705970,4,2434,1162,40
31781925187,31781925182,-5,957,4745,40
31785345587,31785345581,-6,1080,3855,40
31785566084,31785566077,-7,910,3107,40
31788358519,31788358514,-5,1078,3165,40
31790632111,31790632106,-5,911,4962,40
31798876565,31798876559,-6,1131,3630,40
31800293252,31800293247,-5,1092,3681,40
31806528590,31806528585,-5,969,4409,40
31833303458,31833303467,9,4186,1726,40
31837919192,31837919185,-7,1318,7526,40
31838087214,31838087205,-9,1234,4126,40
31838420932,31838420914,-18,31,711,40
31839616518,31839616523,5,2847,1346,40
31840776370,31840776362,-8,868,3252,40
31843575976,31843575969,-7,1222,3289,40
31847175735,31847175729,-6,824,3662,40
31848552302,31848552318,16,371,1714,40
31852507178,31852507182,4,1344,1276,40
31859816157,31859816151,-6,1410,5270,40
31860162283,31860162277,-6,893,2770,40
31861990214,31861990207,-7,1268,4758,40
31865590067,31865590058,-9,1112,4233,40
31883165980,31883165975,-5,1015,4139,40
31883380222,31883380214,-8,865,4982,40
31883871623,31883871600,-23,58,1376,40
31884175257,31884175249,-8,1053,5098,40
31885688533,31885688529,-4,935,2830,40
31886564647,31886564642,-5,997,2839,40
31896344102,31896344096,-6,1020,3831,40
31904969700,31904969694,-6,781,3541,40
31916020391,31916020385,-6,1137,3424,40
31916614429,31916614422,-7,1147,3504,40
31918033829,31918033824,-5,1048,4153,40
31919451218,31919451226,8,5863,2264,40
31923757158,31923757160,2,982,1428,40
31924180903,31924180897,-6,743,3927,40
31926283594,31926283587,-7,875,3077,40
31929419135,31929419115,-20,212,1131,40
31929675285,31929675279,-6,165,1206,40
31931103446,31931103439,-7,1603,5832,40
31944363378,31944363370,-8,919,4387,40
31950782680,31950782675,-5,1138,3664,40
31952524533,31952524526,-7,959,3270,40
31956858612,31956858589,-23,206,1268,40
31957049155,31957049148,-7,1067,3447,40
31958150022,31958150016,-6,1012,2665,40
31959255030,31959255031,1,1162,1244,40
31959336215,31959336210,-5,1034,4193,40
31959927839,31959927833,-6,835,3897,40
31961797174,31961797171,-3,2362,5405,40
31968549337,31968549331,-6,1193,4426,40
31968598029,31968598017,-12,68,1428,40
31973316581,31973316577,-4,1020,3301,40
31987860681,31987860684,3,2276,1431,40
31988063846,31988063867,21,557,1096,40
31992367355,31992367355,0,647,953,40
31995939534,31995939529,-5,1190,3433,40
31995997111,31995997127,16,169,1526,40
31996317083,31996317077,-6,943,2097,40
31999702830,31999702823,-7,1135,2878,40
32000547089,32000547082,-7,798,3648,40
32005890616,32005890607,-9,135,1000,40
32006050718,32006050731,13,89,995,40
32006412932,32006412915,-17,1099,3884,40
32006473618,32006473622,4,2152,1692,40
32008831431,32008831425,-6,1316,3815,40
32026629541,32026629534,-7,1166,3581,40
32029107967,32029107961,-6,1093,4428,40
32032365827,32032365821,-6,906,3288,40
32044807941,32044807935,-6,1039,3631,40
32055583483,32055583477,-6,1102,5497,40
32059310579,32059310577,-2,788,2118,40
32059450861,32059450855,-6,1354,4702,40
32060862791,32060862787,-4,1053,2514,40
32060967359,32060967347,-12,133,1222,40
32062036647,32062036639,-8,1183,5366,40
32062847985,32062847978,-7,933,3635,40
32064013562,32064013557,-5,710,2782,40
32065923595,32065923590,-5,1317,4544,40
32070704187,32070704185,-2,987,1749,40
32071513857,32071513851,-6,897,3454,40
32071692055,32071692059,4,31,842,40
32075732729,32075732733,4,1473,1465,40
32077277873,32077277866,-7,1194,3294,40
32085062170,32085062166,-4,1142,3473,40
32097197693,32097197714,21,32,1388,40
32102786526,32102786521,-5,988,1901,40
32108272819,32108272818,-1,1331,2522,40
32110404981,32110404975,-6,1194,3877,40
32112742990,32112742991,1,3082,3001,40
32112903631,32112903623,-8,1091,4274,40
32114859684,32114859677,-7,776,4202,40
32117058531,32117058525,-6,1148,3555,40
32119414299,32119414294,-5,794,3250,40
32120630741,32120630735,-6,1275,4440,40
32124675174,32124675163,-11,1302,472,40
32130748097,32130748101,4,2516,2069,40
32135570570,32135570565,-5,973,2391,40
32136882697,32136882691,-6,1030,2238,40
32137255532,32137255522,-10,134,874,40
32139303837,32139303831,-6,1230,3961,40
32145071722,32145071714,-8,628,4330,40
32147276816,32147276802,-14,216,797,40
32151289430,32151289425,-5,1001,3327,40
32154419946,32154419965,19,983,4005,40
32164729914,32164729908,-6,1215,3757,40
32165556217,32165556211,-6,709,1895,40
32165957517,32165957517,0,2853,3381,40
32166568430,32166568423,-7,741,4212,40
32168976718,32168976712,-6,908,3252,40
32169531001,32169530995,-6,942,4220,40
32171850344,32171850338,-6,1380,3697,40
32172585600,32172585597,-3,1229,2496,40
32175450043,32175450048,5,4571,2005,40
32181083730,32181083724,-6,1162,2828,40
32194220595,32194220590,-5,1054,4615,40
32195860677,32195860671,-6,1367,4875,40
32196584640,32196584634,-6,833,2723,40
32196691320,32196691301,-19,303,1482,40
32199138816,32199138810,-6,823,3597,40
32203669254,32203669253,-1,7381,10940,40
32207209721,32207209718,-3,24352,12229,40
32207491221,32207491222,1,2022,1851,40
32208969995,32208969990,-5,899,4873,40
32211126566,32211126558,-8,815,4331,40
32213797056,32213797057,1,6424,6461,40
32223934106,32223934101,-5,705,2478,40
32227977379,32227977374,-5,1299,2671,40
32229061014,32229061009,-5,1057,3777,40
32231599191,32231599191,0,2224,2125,40
32235019770,32235019765,-5,958,3667,40
32235525945,32235525938,-7,973,2725,40
32237344667,32237344662,-5,1197,2786,40
32238289091,32238289097,6,4444,1805,40
32238754957,32238754977,20,201,846,40
32246048753,32246048749,-4,1256,3359,40
32249358010,32249358016,6,5668,2523,40
32251999409,32251999404,-5,641,3935,40
32252095671,32252095684,13,377,1902,40
32255032802,32255032798,-4,629,3021,40
32255497364,32255497382,18,617,3317,40
32266648767,32266648762,-5,940,3836,40
32269061297,32269061290,-7,1054,4494,40
32269774833,32269774837,4,2766,2005,40
32275653565,32275653566,1,1077,1092,40
32278748398,32278748390,-8,1086,4014,40
32279376550,32279376556,6,189,1212,40
32284868746,32284868742,-4,872,3264,40
32287552580,32287552573,-7,959,3039,40
32295751871,32295751866,-5,1210,3825,40
32297560085,32297560078,-7,978,4644,40
32298641534,32298641529,-5,991,3732,40
32301587195,32301587190,-5,1026,3113,40
32302099662,32302099642,-20,76,1020,40
32303461834,32303461839,5,3855,1481,40
32307190397,32307190394,-3,967,2173,40
32307811825,32307811817,-8,1030,3794,40
32318238709,32318238706,-3,1362,4006,40
32327779707,32327779702,-5,1185,3262,40
32335652407,32335652401,-6,705,3569,40
32337377329,32337377324,-5,1201,3328,40
32339064502,32339064504,2,1448,1830,40
32342667169,32342667164,-5,1195,2913,40
32345154638,32345154632,-6,1038,3449,40
32345215685,32345215678,-7,1183,3562,40
32347594334,32347594329,-5,843,3549,40
32347691559,32347691577,18,227,1658,40
32348014108,32348014131,23,686,4025,40
32348109293,32348109286,-7,809,3347,40
32349614611,32349614606,-5,1013,2488,40
32356948310,32356948306,-4,1052,3101,40
32357217192,32357217185,-7,973,3725,40
32360530175,32360530194,19,870,3270,40
32360656213,32360656198,-15,989,3246,40
32361063327,32361063304,-23,920,3305,40
32363578517,32363578513,-4,981,3113,40
32364425179,32364425173,-6,1384,3851,40
32364805719,32364805713,-6,1070,4431,40
32364845437,32364845458,21,1188,3419,40
32365177486,32365177478,-8,1086,3864,40
32365218399,32365218394,-5,1438,3014,40
32375999951,32375999944,-7,1483,3683,40
32383642470,32383642468,-2,1248,1964,40
32392397422,32392397418,-4,691,2992,40
32400412634,32400412630,-4,770,3501,40
32404096793,32404096786,-7,971,2477,40
32405934546,32405934541,-5,1135,4460,40
32406514885,32406514880,-5,1144,3354,40
32407832752,32407832763,11,329,806,40
32410131618,32410131610,-8,791,3317,40
32410556391,32410556385,-6,1394,3216,40
32411389238,32411389230,-8,1272,5453,40
32412467267,32412467262,-5,1167,4206,40
32414393210,32414393215,5,3383,1952,40
32415161920,32415161913,-7,1193,2892,40
32415208167,32415208149,-18,406,1410,40
32423080830,32423080825,-5,787,3051,40
32426160085,32426160080,-5,754,3176,40
32440525788,32440525782,-6,1055,3649,40
32448589590,32448589586,-4,707,4113,40
32450731570,32450731564,-6,1234,4023,40
32452743158,32452743141,-17,773,31,40
32458922518,32458922513,-5,984,3994,40
32460044554,32460044552,-2,733,1439,40
32461649497,32461649492,-5,1342,5344,40
32467869607,32467869602,-5,818,2234,40
32471945950,32471945949,-1,1602,1545,40
32472850275,32472850268,-7,1040,3776,40
32475092763,32475092758,-5,1058,2247,40
32475557139,32475557134,-5,1099,4032,40
32478395130,32478395126,-4,1062,4013,40
32481338897,32481338891,-6,1035,3999,40
32482396219,32482396214,-5,821,3000,40
32482487630,32482487642,12,39,1371,40
32484404891,32484404886,-5,1200,4654,40
32485044469,32485044470,1,1466,1744,40
32485965663,32485965678,15,503,2792,40
32486504003,32486503999,-4,471,3137,40
32493591689,32493591694,5,986,916,40
32495131819,32495131813,-6,694,2629,40
32495367469,32495367490,21,645,4048,40
32498413623,32498413621,-2,1357,1865,40
32510050342,32510050334,-8,1258,5072,40
32511105485,32511105480,-5,735,3676,40
32519480906,32519480901,-5,1053,2737,40
32528873057,32528873051,-6,1490,4371,40
32529286151,32529286145,-6,1390,4248,40
32540789351,32540789335,-16,20,1024,40
32542321057,32542321051,-6,1093,3352,40
32547514511,32547514506,-5,519,1929,40
32548329475,32548329473,-2,928,2388,40
32552880003,32552879998,-5,1189,3230,40
32556390647,32556390642,-5,1083,3115,40
32557077743,32557077755,12,54026,11264,40
32557506162,32557506169,7,1811,1004,40
32559098370,32559098365,-5,1159,3493,40
32565723462,32565723462,0,1572,2533,40
32565951743,32565951737,-6,941,3340,40
32567398237,32567398230,-7,907,2758,40
32568273915,32568273906,-9,787,2662,40
32569714342,32569714336,-6,1263,3938,40
32571960566,32571960559,-7,912,3058,40
32572994723,32572994717,-6,1001,3978,40
32575821094,32575821089,-5,1177,3493,40
32575856736,32575856753,17,322,995,40
32578766189,32578766173,-16,866,2565,40
32582846352,32582846349,-3,1084,3330,40
32587442495,32587442513,18,616,2990,40
32591040679,32591040672,-7,822,3630,40
32594257247,32594257241,-6,726,3682,40
32598453034,32598453027,-7,7357,16084,40
32599960806,32599960801,-5,1543,5343,40
32600051416,32600051410,-6,705,2744,40
32601210822,32601210814,-8,884,3680,40
32601335838,32601335858,20,982,3500,40
32605947668,32605947674,6,3776,1454,40
32606522795,32606522789,-6,872,4516,40
32609355665,32609355658,-7,740,3108,40
32609665476,32609665493,17,755,2427,40
32611762506,32611762492,-14,3065,1241,40
32619024718,32619024713,-5,748,2556,40
32621033057,32621033053,-4,1409,3865,40
32627679411,32627679408,-3,892,2239,40
32627808548,32627808537,-11,90,1243,40
32631429028,32631429029,1,30178,17430,40
32634671700,32634671706,6,1663,961,40
32634925162,32634925153,-9,1063,6882,40
32646388133,32646388150,17,895,3014,40
32648405447,32648405441,-6,500,2215,40
32648597423,32648597423,0,78,953,40
32649363454,32649363466,12,324,994,40
32653739290,32653739283,-7,943,2149,40
32654327503,32654327507,4,277,4472,40
32655796202,32655796196,-6,1283,4391,40
32657823950,32657823943,-7,736,3697,40
32665394903,32665394898,-5,891,2885,40
32665748061,32665748049,-12,671,1311,40
32669588862,32669588857,-5,1018,3961,40
32670181086,32670181078,-8,1057,4596,40
32670410260,32670410279,19,263,1468,40
32670453022,32670453042,20,168,876,40
32673502026,32673502027,1,1491,2111,40
32678478469,32678478462,-7,1417,5571,40
32679540888,32679540882,-6,1232,4303,40
32682868054,32682868050,-4,824,2233,40
32683760767,32683760772,5,1749,1656,40
32690454964,32690454985,21,28,911,40
32695567182,32695567176,-6,949,3263,40
32696178710,32696178715,5,1430,1097,40
32705568641,32705568635,-6,1213,3928,40
32714989804,32714989819,15,798,3055,40
32719399563,32719399561,-2,1853,3607,40
32723994855,32723994850,-5,1055,3764,40
32730766502,32730766496,-6,1108,4275,40
32737072814,32737072817,3,14911,54661,40
32737606038,32737606033,-5,1119,2665,40
32740178973,32740178966,-7,10,804,40
32741125077,32741125078,1,67,1783,40
32755186069,32755186085,16,16791,24859,40
32756146581,32756146582,1,1455,2223,40
32764794083,32764794078,-5,882,3061,40
32764983562,32764983555,-7,478,4734,40
32776333798,32776333794,-4,695,1227,40
32785065461,32785065459,-2,1777,2759,40
32787374866,32787374861,-5,882,4598,40
32796310697,32796310691,-6,947,3499,40
32796520219,32796520214,-5,806,3391,40
32797496886,32797496879,-7,832,2370,40
32797647731,32797647725,-6,947,3284,40
32803313063,32803313057,-6,929,4440,40
32803602253,32803602246,-7,760,4084,40
32807127285,32807127279,-6,976,4298,40
32808388577,32808388570,-7,1006,3561,40
32814894942,32814894942,0,1411,2389,40
32815439490,32815439493,3,2022,1312,40
32816743786,32816743780,-6,1352,3950,40
32819989037,32819989033,-4,762,2363,40
32829436534,32829436530,-4,629,2350,40
32835554178,32835554171,-7,1419,4452,40
32836856206,32836856202,-4,1576,3662,40
32839070347,32839070341,-6,839,3434,40
32843279003,32843278985,-18,1449,713,40
32854380682,32854380677,-5,987,4083,40
32868525887,32868525893,6,4118,1905,40
32868982886,32868982882,-4,1082,2471,40
32869023769,32869023763,-6,893,2755,40
32869447054,32869447067,13,353,1511,40
32872421654,32872421657,3,4258,2514,40
32872476794,32872476783,-11,12473,26365,40
32873739127,32873739123,-4,1190,2734,40
32873921069,32873921051,-18,169,1417,40
32875452295,32875452298,3,205,1009,40
32876225054,32876225049,-5,402,2631,40
32889565973,32889565967,-6,1162,3523,40
32889893262,32889893282,20,815,4028,40
32894532070,32894532065,-5,793,2039,40
32895697689,32895697682,-7,870,3354,40
32898499498,32898499494,-4,855,2703,40
32898825968,32898825986,18,416,1152,40
32910285557,32910285550,-7,1252,3226,40
32911301666,32911301673,7,4336,1423,40
32923055803,32923055798,-5,887,3545,40
32928200478,32928200475,-3,2573,5894,40
32934879488,32934879483,-5,1245,4886,40
32941098385,32941098379,-6,1532,4083,40
32942107819,32942107813,-6,1115,4619,40
32943849895,32943849889,-6,591,5178,40
32944520443,32944520438,-5,965,2400,40
32944656829,32944656848,19,404,3321,40
32945498050,32945498044,-6,699,2939,40
32947894147,32947894142,-5,1030,3174,40
32951471062,32951471057,-5,882,2843,40
32953977790,32953977782,-8,690,4890,40
32965638247,32965638246,-1,679,1417,40
32966723114,32966723109,-5,1077,2444,40
32971688115,32971688110,-5,1044,4132,40
32976239875,32976239870,-5,1280,3914,40
32976817860,32976817881,21,488,2318,40
32977090502,32977090495,-7,967,4401,40
32977532704,32977532683,-21,188,1282,40
32987533646,32987533641,-5,532,1863,40
32988305426,32988305419,-7,692,3244,40
32992287518,32992287522,4,3398,2997,40
33001119010,33001119002,-8,777,3594,40
33001146963,33001146957,-6,1014,3976,40
33006811139,33006811134,-5,1117,4304,40
33007334892,33007334886,-6,1435,4433,40
33011236802,33011236797,-5,773,2172,40
33012186452,33012186468,16,134,1363,40
33017192706,33017192701,-5,992,2986,40
33020926326,33020926320,-6,1099,4218,40
33020955101,33020955116,15,548,2685,40
33021727529,33021727532,3,1581,1329,40
33023721925,33023721921,-4,941,2035,40
33033511306,33033511310,4,1090,1055,40
33042913679,33042913674,-5,1465,3283,40
33047065069,33047065071,2,106,1374,40
33052173459,33052173453,-6,782,3918,40
33052676567,33052676558,-9,1071,2973,40
33058369710,33058369710,0,1516,1444,40
33074800402,33074800405,3,2076,1345,40
33080619641,33080619637,-4,2192,5978,40
33082391971,33082391991,20,434,1529,40
33083107053,33083107046,-7,1193,4768,40
33088233910,33088233902,-8,1031,2397,40
33091560201,33091560199,-2,2314,4138,40
33094968060,33094968054,-6,1300,3726,40
33095286134,33095286114,-20,899,930,40
33102234928,33102234924,-4,1311,3368,40
33102668965,33102668981,16,562,2899,40
33102970969,33102970962,-7,903,4067,40
33123625849,33123625854,5,1766,594,40
33127191243,33127191238,-5,942,3700,40
33139474155,33139474165,10,177,1059,40
33140223805,33140223810,5,285,1686,40
33140880710,33140880725,15,316,1917,40
33141653857,33141653851,-6,746,3066,40
33146662687,33146662680,-7,850,3122,40
33157680319,33157680313,-6,1057,2919,40
33169614707,33169614702,-5,1397,3591,40
33170246186,33170246178,-8,1087,3749,40
33176294863,33176294868,5,13662,8513,40
33192961902,33192961897,-5,943,3455,40
33195234156,33195234150,-6,997,3222,40
33195518098,33195518095,-3,993,2147,40
33195678823,33195678805,-18,109,3516,40
33195868781,33195868777,-4,1305,3002,40
33212653917,33212653909,-8,816,3899,40
33212780133,33212780135,2,5,1129,40
33212920079,33212920090,11,417,1323,40
33218871770,33218871764,-6,842,2894,40
33221579919,33221579922,3,9565,8680,40
33223295586,33223295582,-4,1185,4834,40
33227093941,33227093934,-7,1204,5012,40
33228762480,33228762473,-7,870,3820,40
33230678389,33230678384,-5,1123,4003,40
33232844963,33232844958,-5,933,4025,40
33233967029,33233967014,-15,133,771,40
33235636866,33235636861,-5,1079,3720,40
33240880658,33240880652,-6,1293,4230,40
33241274446,33241274448,2,1232,1547,40
33246352824,33246352817,-7,675,3692,40
33253443066,33253443057,-9,668,3921,40
33264168554,33264168547,-7,1156,4447,40
33264237227,33264237226,-1,1226,2033,40
33266579625,33266579619,-6,1200,3941,40
33267885052,33267885073,21,876,2447,40
33268261647,33268261641,-6,1184,4787,40
33271990731,33271990724,-7,1000,4268,40
33273510201,33273510202,1,12659,12684,40
33273827145,33273827138,-7,1309,3715,40
33278985814,33278985808,-6,1147,5432,40
33279789510,33279789501,-9,428,1570,40
33285631834,33285631837,3,1959,1939,40
33290201819,33290201813,-6,1064,5772,40
33293720906,33293720900,-6,41862,18132,40
33299005786,33299005782,-4,2487,5371,40
33303796712,33303796717,5,5620,2964,40
33306082182,33306082175,-7,615,4011,40
33307178078,33307178076,-2,2176,3262,40
33308991861,33308991854,-7,981,3535,40
33312663574,33312663568,-6,1191,3879,40
33320620022,33320620040,18,945,1796,40
33327063505,33327063498,-7,773,3063,40
33328549289,33328549288,-1,1712,2261,40
33329122370,33329122364,-6,1127,3468,40
33330563657,33330563659,2,1928,1457,40
33333091302,33333091297,-5,1183,3570,40
33333249053,33333249070,17,297,1336,40
33335489581,33335489576,-5,955,3804,40
33335667718,33335667710,-8,985,4157,40
33336569851,33336569846,-5,784,3309,40
33337232183,33337232177,-6,1086,2506,40
33347501029,33347501021,-8,611,2789,40
33348351074,33348351072,-2,24717,8891,40
33349335414,33349335419,5,4921,2406,40
33352074568,33352074568,0,1249,1925,40
33352681406,33352681401,-5,1036,3248,40
33356582848,33356582845,-3,1322,2724,40
33369163449,33369163456,7,3119,955,40
33370130430,33370130429,-1,15747,20474,40
33375694599,33375694600,1,319,900,40
33376139654,33376139649,-5,783,2632,40
33382059099,33382059094,-5,1015,1412,40
33382553203,33382553199,-4,804,2585,40
33382690021,33382690032,11,139,1541,40
33397869339,33397869333,-6,1202,3718,40
33399190123,33399190117,-6,848,2759,40
33400546309,33400546302,-7,1206,3475,40
33401541448,33401541443,-5,625,3361,40
33402424299,33402424290,-9,767,2304,40
33404080258,33404080254,-4,1824,4694,40
33417334366,33417334374,8,15474,21286,40
33422497747,33422497741,-6,842,2926,40
33423272401,33423272395,-6,730,2517,40
33428461095,33428461096,1,652,1075,40
33428858887,33428858896,9,759,1394,40
33429212309,33429212302,-7,1442,4455,40
33429802087,33429802082,-5,21641,11359,40
33432983962,33432983966,4,1887,1688,40
33440830673,33440830670,-3,806,3917,40
33441816616,33441816611,-5,887,2867,40
33443864873,33443864866,-7,817,3528,40
33447303669,33447303663,-6,1185,3538,40
33449223771,33449223766,-5,837,2319,40
33449596905,33449596898,-7,996,2988,40
33455722908,33455722902,-6,1098,5294,40
33459014713,33459014706,-7,1558,4487,40
33465300626,33465300608,-18,1332,2979,40
33465631508,33465631523,15,359,1259,40
33469660222,33469660222,0,287,1474,40
33475964078,33475964073,-5,1036,3226,40
33476921798,33476921815,17,742,4626,40
33480460278,33480460274,-4,1227,4685,40
33486285106,33486285098,-8,1507,4396,40
33493124562,33493124558,-4,1207,3415,40
33495998898,33495998894,-4,1258,3134,40
33497274430,33497274425,-5,1093,3623,40
33509044307,33509044301,-6,1054,4076,40
33511131779,33511131774,-5,1459,4451,40
33514127468,33514127486,18,426,1187,40
33516810902,33516810895,-7,1111,4296,40
33517830673,33517830669,-4,927,3706,40
33520733886,33520733882,-4,789,3548,40
33520803905,33520803906,1,1745,1723,40
33522609646,33522609649,3,2842,1956,40
33524105676,33524105670,-6,742,2657,40
33524176942,33524176937,-5,1162,2861,40
33524236485,33524236497,12,5,1210,40
33525674670,33525674662,-8,396,2547,40
33528696295,33528696290,-5,1148,3927,40
33546917642,33546917655,13,356,1295,40
33547796987,33547796989,2,1838,1717,40
33548951756,33548951750,-6,1157,3317,40
33551371969,33551371962,-7,1223,3722,40
33551759799,33551759792,-7,1054,3910,40
33555871306,33555871301,-5,663,2982,40
33556695768,33556695762,-6,1135,4808,40
33560811322,33560811315,-7,1086,3651,40
33561369242,33561369234,-8,1293,5310,40
33571778261,33571778255,-6,1159,3861,40
33572049785,33572049778,-7,862,3869,40
33574827919,33574827903,-16,3200,2538,40
33577950247,33577950242,-5,760,3451,40
33579824165,33579824158,-7,1022,3799,40
33595682397,33595682390,-7,724,4488,40
33598349159,33598349154,-5,1046,4052,40
33602082621,33602082618,-3,1839,1950,40
33607010471,33607010465,-6,1246,3594,40
33608110742,33608110735,-7,1051,3407,40
33622343079,33622343074,-5,1117,3875,40
33622485278,33622485272,-6,951,2448,40
33622957291,33622957286,-5,1079,6572,40
33624908741,33624908737,-4,1022,3055,40
33628611047,33628611041,-6,634,2749,40
33642360343,33642360337,-6,656,3047,40
33647257314,33647257309,-5,991,2987,40
33649668302,33649668296,-6,1198,4756,40
33652817211,33652817206,-5,480,2097,40
33662439614,33662439609,-5,1110,4358,40
33664646503,33664646502,-1,1178,2279,40
33669220597,33669220598,1,1847,3264,40
33670870897,33670870899,2,1774,2276,40
33672338840,33672338837,-3,1640,3117,40
33673704854,33673704849,-5,1285,4905,40
33674432701,33674432722,21,456,2755,40
33678627394,33678627396,2,2319,1561,40
33678778740,33678778733,-7,1189,4072,40
33681367613,33681367606,-7,760,2560,40
33681998741,33681998757,16,955,4804,40
33686000143,33686000147,4,4568,2318,40
33686589638,33686589630,-8,1108,3831,40
33689059160,33689059171,11,12544,19004,40
33692982893,33692982911,18,275,1624,40
33693095595,33693095589,-6,1312,4040,40
33693351311,33693351314,3,189,1249,40
33696238303,33696238301,-2,1211,2374,40
33704436201,33704436197,-4,1064,3976,40
33705768686,33705768692,6,13063,22666,40
33706956501,33706956498,-3,1067,2104,40
33710724604,33710724597,-7,958,4050,40
33712297734,33712297730,-4,1129,2856,40
33716480138,33716480133,-5,902,3724,40
33719405914,33719405905,-9,800,3921,40
33721723801,33721723794,-7,1037,3854,40
33723129810,33723129805,-5,935,3541,40
33729434535,33729434529,-6,1125,3641,40
33738357423,33738357418,-5,1342,3170,40
33739638615,33739638618,3,2517,2336,40
33744769645,33744769638,-7,974,3109,40
33745973662,33745973658,-4,1384,3335,40
33747307298,33747307297,-1,614,1268,40
33751730658,33751730653,-5,1186,2601,40
33751795670,33751795651,-19,1044,4242,40
33756202366,33756202364,-2,2530,4777,40
33761508839,33761508837,-2,982,3104,40
33765989790,33765989785,-5,854,2076,40
33766256887,33766256902,15,715,2227,40
33772059542,33772059538,-4,852,3424,40
33773426487,33773426479,-8,885,4165,40
33773561391,33773561390,-1,310,1181,40
33793038599,33793038593,-6,1168,3666,40
33794360882,33794360875,-7,1095,4381,40
33796446211,33796446210,-1,3677,4966,40
33798565484,33798565471,-13,3439,13975,40
33799317217,33799317211,-6,1151,7577,40
33799445410,33799445404,-6,690,4048,40
33802670698,33802670690,-8,1090,3856,40
33803748077,33803748065,-12,212,1961,40
33816714070,33816714070,0,1459,1977,40
33830816288,33830816295,7,4200,1787,40
33838714682,33838714677,-5,608,3928,40
33845837029,33845837022,-7,751,2957,40
33856420890,33856420885,-5,1026,3640,40
33858178045,33858178041,-4,772,2317,40
33874251139,33874251139,0,620,1462,40
33875180739,33875180733,-6,1121,4435,40
33891988587,33891988582,-5,1067,3220,40
33893773865,33893773857,-8,1294,3683,40
33894172035,33894172028,-7,827,3729,40
33896154692,33896154686,-6,621,2440,40
33898548555,33898548550,-5,788,2811,40
33900127749,33900127742,-7,1370,4661,40
33903581740,33903581729,-11,360,1001,40
33904194843,33904194838,-5,1382,4532,40
33916307771,33916307764,-7,1159,4102,40
33916427310,33916427306,-4,258,1343,40
33917001895,33917001909,14,655,3209,40
33919452810,33919452807,-3,1751,5442,40
33927957172,33927957178,6,1276,963,40
33931456393,33931456385,-8,995,2823,40
33937508730,33937508735,5,2493,885,40
33951376930,33951376926,-4,914,3624,40
33958540591,33958540586,-5,1055,3377,40
33965909550,33965909544,-6,1006,3373,40
33971931091,33971931084,-7,1022,4646,40
33979276730,33979276723,-7,740,3749,40
33980633579,33980633577,-2,1212,2857,40
33982513470,33982513462,-8,1280,5434,40
33982980317,33982980311,-6,1142,3730,40
33983084174,33983084166,-8,845,2822,40
33984654575,33984654568,-7,982,3199,40
33986522535,33986522529,-6,1253,3818,40
33996458159,33996458153,-6,749,4339,40
33997357492,33997357474,-18,127,842,40
33999419983,33999419993,10,216,1171,40
33999470379,33999470374,-5,1108,3039,40
34005961358,34005961351,-7,582,1954,40
34006258071,34006258083,12,879,3695,40
34007546689,34007546695,6,4055,1708,40
34014599063,34014599055,-8,988,4268,40
34014874848,34014874858,10,197,1114,40
34016195661,34016195654,-7,1037,2236,40
34019271213,34019271209,-4,558,2187,40
34020914751,34020914746,-5,1168,3475,40
34031928782,34031928774,-8,1102,3988,40
34034205772,34034205765,-7,1438,4582,40
34039733289,34039733282,-7,1240,3716,40
34040351129,34040351122,-7,1023,3291,40
34040385036,34040385018,-18,31,1399,40
34040749479,34040749492,13,1096,5014,40
34042426415,34042426413,-2,879,2034,40
34056514965,34056514970,5,2220,1516,40
34058555129,34058555122,-7,850,4319,40
34059586994,34059586990,-4,649,2577,40
34065084347,34065084341,-6,819,3687,40
34068406003,34068405997,-6,666,2352,40
34085703243,34085703238,-5,1015,3014,40
34091240172,34091240165,-7,1144,4290,40
34092834751,34092834745,-6,891,3687,40
34093265526,34093265546,20,353,1376,40
34102349527,34102349531,4,1356,1473,40
34105698487,34105698482,-5,1062,3313,40
34107419164,34107419146,-18,235,1374,40
34112012123,34112012118,-5,914,3793,40
34112986122,34112986117,-5,692,2611,40
34113518028,34113518051,23,224,968,40
34118032198,34118032194,-4,974,2455,40
34132669096,34132669090,-6,852,4016,40
34132784760,34132784767,7,2523,844,40
34142098768,34142098760,-8,1268,6677,40
34146182811,34146182804,-7,755,3076,40
34146688752,34146688767,15,274,823,40
34153677304,34153677299,-5,758,2446,40
34153720430,34153720427,-3,319,958,40
34154435102,34154435110,8,37,1066,40
34160527261,34160527267,6,5011,1620,40
34161468033,34161468026,-7,1642,4608,40
34162763376,34162763369,-7,1253,3108,40
34162924246,34162924260,14,683,2854,40
34166710623,34166710618,-5,999,4741,40
34167147734,34167147741,7,118,2095,40
34167445140,34167445133,-7,1050,3183,40
34170535366,34170535362,-4,824,4093,40
34176168541,34176168549,8,5919,1896,40
34176218908,34176218903,-5,1170,2698,40
34180822058,34180822056,-2,1411,1564,40
34182955519,34182955514,-5,474,2726,40
34183268262,34183268258,-4,164,1024,40
34201901489,34201901482,-7,1259,3270,40
34211984751,34211984746,-5,835,2590,40
34216158114,34216158106,-8,776,4171,40
34216212614,34216212626,12,612,4013,40
34218183741,34218183735,-6,984,3079,40
34219911130,34219911124,-6,768,3951,40
34220003550,34220003559,9,182,1467,40
34221494690,34221494686,-4,889,5081,40
34223591045,34223591040,-5,973,2562,40
34226787834,34226787828,-6,1168,4278,40
34227471086,34227471104,18,588,1892,40
34229187655,34229187652,-3,2129,3990,40
34254653144,34254653138,-6,871,3308,40
34263778938,34263778933,-5,1299,3823,40
34269855736,34269855730,-6,937,4324,40
34270016954,34270016949,-5,1195,3483,40
34272550681,34272550676,-5,1196,4382,40
34277656931,34277656925,-6,727,4890,40
34279370354,34279370348,-6,1242,3023,40
34284272967,34284272961,-6,990,3948,40
34286691999,34286691995,-4,916,2419,40
34287431942,34287431961,19,392,799,40
34288307396,34288307392,-4,612,2236,40
34290363897,34290363893,-4,1151,4768,40
34297963054,34297963050,-4,1005,3157,40
34303793603,34303793598,-5,829,3553,40
34307352899,34307352893,-6,852,3191,40
34307379030,34307379045,15,37,1240,40
34310061554,34310061551,-3,810,1120,40
34316556590,34316556586,-4,1101,3966,40
34318269782,34318269798,16,161,1357,40
34320916178,34320916172,-6,1004,3554,40
34322314007,34322313990,-17,185,1472,40
34325723788,34325723782,-6,1436,5088,40
34329065450,34329065445,-5,1299,2648,40
34329845767,34329845762,-5,601,3364,40
34333216114,34333216110,-4,658,1739,40
34333330703,34333330695,-8,722,3468,40
34336202545,34336202539,-6,1238,5070,40
34338166158,34338166153,-5,732,3122,40
34344561234,34344561227,-7,1284,5002,40
34349819707,34349819710,3,2354,1608,40
34354786038,34354786034,-4,892,3974,40
34354959774,34354959769,-5,1030,3342,40
34359568005,34359567999,-6,1019,3733,40
34378607527,34378607530,3,1993,986,40
34389194679,34389194676,-3,905,2748,40
34389417758,34389417775,17,706,2629,40
34393317169,34393317165,-4,781,3345,40
34394305462,34394305449,-13,15,424,40
34396956275,34396956278,3,312,1090,40
34397340254,34397340246,-8,193,1214,40
34398081734,34398081729,-5,1090,4030,40
34400343219,34400343214,-5,630,2437,40
34405834993,34405834994,1,3704,3558,40
34411490069,34411490061,-8,880,3809,40
34411629344,34411629359,15,739,2673,40
34417644874,34417644870,-4,934,3281,40
34419360167,34419360159,-8,463,1203,40
34420426895,34420426914,19,472,2195,40
34422457238,34422457234,-4,687,1988,40
34424342222,34424342218,-4,887,2802,40
34424927398,34424927392,-6,1008,4439,40
34427340959,34427340954,-5,1021,3598,40
34427516758,34427516757,-1,15,1106,40
34433699817,34433699820,3,5386,5558,40
34433867030,34433867050,20,319,1373,40
34437301998,34437302000,2,2604,2119,40
34439838278,34439838276,-2,1155,2124,40
34443455389,34443455383,-6,943,3571,40
34443529528,34443529533,5,207,1446,40
34450993574,34450993570,-4,643,2126,40
34451272431,34451272442,11,404,2112,40
34453858463,34453858459,-4,1364,3476,40
34457029121,34457029117,-4,1045,3573,40
34461284466,34461284482,16,1278,3489,40
34463408399,34463408393,-6,1136,3939,40
34467208029,34467208033,4,2697,1238,40
34473466657,34473466651,-6,783,3799,40
34473741046,34473741065,19,563,2058,40
34477606774,34477606767,-7,1054,3794,40
34479440620,34479440616,-4,890,3203,40
34480175767,34480175770,3,297,1403,40
34480407416,34480407429,13,496,2318,40
34483064570,34483064566,-4,1469,3345,40
34485483977,34485483999,22,1072,1524,40
34485516516,34485516527,11,268,1076,40
34488597503,34488597497,-6,794,3641,40
34490430249,34490430244,-5,931,3887,40
34490823773,34490823785,12,140,1289,40
34491548371,34491548366,-5,1048,2715,40
34505191653,34505191647,-6,872,4025,40
34506041169,34506041161,-8,613,2041,40
34513060710,34513060704,-6,646,3449,40
34515384755,34515384752,-3,924,2258,40
34521165266,34521165270,4,1270,1175,40
34523447895,34523447898,3,2665,1832,40
34543529494,34543529488,-6,874,1896,40
34545020986,34545020979,-7,977,4450,40
34545529084,34545529107,23,469,3602,40
34554713767,34554713763,-4,1017,3062,40
34555204060,34555204042,-18,236,1183,40
34557390341,34557390355,14,248,955,40
34563934010,34563934003,-7,1303,3900,40
34564042848,34564042861,13,215,1643,40
34574513555,34574513550,-5,1203,3028,40
34578131709,34578131701,-8,1337,4666,40
34587249777,34587249785,8,4266,1190,40
34589212745,34589212738,-7,1208,4788,40
34591200151,34591200145,-6,1159,4490,40
34591931430,34591931425,-5,1374,3545,40
34592471548,34592471549,1,375,2380,40
34592938806,34592938796,-10,276,1836,40
34602999858,34602999852,-6,948,3116,40
34612186846,34612186848,2,1946,1703,40
34618191967,34618191961,-6,1621,4695,40
34619713150,34619713142,-8,414,2659,40
34623643242,34623643237,-5,1448,5386,40
34624745918,34624745910,-8,36,1035,40
34626672335,34626672329,-6,689,3288,40
34628708508,34628708502,-6,1099,4350,40
34629317896,34629317915,19,245,1138,40
34629771523,34629771526,3,2478,2413,40
34631186243,34631186238,-5,967,3498,40
34636039546,34636039542,-4,993,2399,40
34637519258,34637519242,-16,119,1273,40
34641471283,34641471277,-6,790,4781,40
34641976233,34641976239,6,2006,1186,40
34643261550,34643261550,0,1542,1549,40
34649875719,34649875713,-6,736,3061,40
34649923503,34649923493,-10,184,1141,40
34650465348,34650465330,-18,157,1851,40
34665898550,34665898559,9,268,1413,40
34666250084,34666250078,-6,1167,3175,40
34671133602,34671133597,-5,784,4199,40
34673987969,34673987965,-4,1214,2977,40
34675341293,34675341292,-1,2019,2481,40
34676212467,34676212461,-6,27074,12273,40
34676800212,34676800206,-6,1042,5156,40
34678261071,34678261065,-6,1477,5341,40
34680512866,34680512859,-7,779,3019,40
34681385919,34681385911,-8,615,3053,40
34682094151,34682094147,-4,980,2169,40
34682416540,34682416559,19,896,3289,40
34684754649,34684754654,5,3436,1596,40
34698624115,34698624109,-6,980,3516,40
34706755720,34706755734,14,105,1025,40
34707257018,34707257013,-5,1311,4089,40
34707726174,34707726169,-5,875,3189,40
34707874423,34707874419,-4,223,1117,40
34710795939,34710795934,-5,641,2312,40
34713385701,34713385705,4,153,762,40
34717181768,34717181758,-10,1021,4026,40
34717953845,34717953845,0,1807,2945,40
34718849439,34718849434,-5,1154,3557,40
34719530211,34719530204,-7,718,4065,40
34720272600,34720272613,13,620,2717,40
34721269151,34721269149,-2,17363,20796,40
34726035650,34726035645,-5,864,2486,40
34726568808,34726568820,12,255,1337,40
34729531642,34729531634,-8,1047,4414,40
34730016014,34730016007,-7,1086,3818,40
34733841802,34733841797,-5,871,3791,40
34739349586,34739349581,-5,748,2846,40
34740189223,34740189205,-18,373,1744,40
34757217560,34757217562,2,1675,1526,40
34761521293,34761521287,-6,1485,4917,40
34763067031,34763067025,-6,1019,4714,40
34765430098,34765430093,-5,1061,3853,40
34766985846,34766985848,2,6491,24391,40
34769981787,34769981781,-6,1450,4498,40
34776249204,34776249203,-1,1488,1630,40
34777324071,34777324064,-7,733,3794,40
34779102103,34779102097,-6,762,2757,40
34779700304,34779700322,18,339,1100,40
34793153464,34793153458,-6,930,3621,40
34793302188,34793302203,15,195,1199,40
34793857215,34793857209,-6,924,3557,40
34794235960,34794235979,19,313,1709,40
34796802343,34796802338,-5,1342,4634,40
34803696414,34803696410,-4,942,4688,40
34803939574,34803939566,-8,706,2887,40
34804146576,34804146582,6,219,1105,40
34807032491,34807032486,-5,923,2740,40
34807216475,34807216477,2,2513,3461,40
34808900021,34808900014,-7,872,4511,40
34809410574,34809410558,-16,79,2495,40
34810223770,34810223766,-4,1324,3351,40
34811959306,34811959298,-8,1203,4387,40
34816042769,34816042763,-6,849,3989,40
34816982966,34816982961,-5,1146,3312,40
34821628571,34821628565,-6,931,3618,40
34823993447,34823993441,-6,807,4020,40
34830291847,34830291843,-4,962,3891,40
34831084736,34831084744,8,300,1245,40
34832178324,34832178325,1,1713,2473,40
34857910450,34857910457,7,5845,2307,40
34868121258,34868121252,-6,863,3687,40
34870488418,34870488416,-2,802,1882,40
34871780865,34871780860,-5,593,1889,40
34883518817,34883518813,-4,1010,3601,40
34883764551,34883764534,-17,1238,2526,40
34901277431,34901277425,-6,1060,4395,40
34901353172,34901353166,-6,875,3598,40
34906221030,34906221022,-8,1162,4907,40
34906673886,34906673901,15,334,1027,40
34914189126,34914189119,-7,1200,5324,40
34914735974,34914735969,-5,785,2626,40
34916721564,34916721552,-12,922,1667,40
34918977211,34918977205,-6,1216,3409,40
34920166699,34920166693,-6,720,2698,40
34925175090,34925175083,-7,619,3531,40
34930081497,34930081494,-3,1412,3086,40
34932096846,34932096842,-4,1015,3016,40
34938004089,34938004085,-4,1195,2337,40
34942855575,34942855572,-3,925,1345,40
34950536297,34950536291,-6,1125,3753,40
34951369914,34951369909,-5,1060,3308,40
34951451246,34951451263,17,516,2989,40
34952693193,34952693190,-3,926,2614,40
34961614154,34961614149,-5,885,3972,40
34966050174,34966050171,-3,1308,2492,40
34967919751,34967919746,-5,820,3558,40
34969847215,34969847209,-6,936,4917,40
34970672126,34970672115,-11,9539,38951,40
34982258977,34982258973,-4,949,3557,40
34986058266,34986058261,-5,1510,4735,40
34986493822,34986493816,-6,1233,3875,40
34992066654,34992066649,-5,1019,3467,40
34996491983,34996491990,7,2725,831,40
35010953163,35010953158,-5,754,3646,40
35011238206,35011238227,21,201,905,40
35024817968,35024817974,6,2255,1095,40
35026762677,35026762673,-4,2142,5460,40
35027873630,35027873624,-6,1078,5605,40
35029445394,35029445389,-5,923,3030,40
35041051986,35041051993,7,5165,2158,40
35041258902,35041258898,-4,1011,3854,40
35043412551,35043412546,-5,689,2362,40
35043591750,35043591743,-7,822,4126,40
35044375657,35044375650,-7,899,3235,40
35046060649,35046060644,-5,1292,2158,40
35046263102,35046263097,-5,971,4092,40
35046891671,35046891669,-2,1818,1917,40
35053371115,35053371108,-7,1461,4530,40
35060451012,35060451006,-6,908,3702,40
35060489533,35060489549,16,271,1462,40
35060560808,35060560825,17,948,3033,40
35062508431,35062508427,-4,875,3183,40
35065135036,35065135032,-4,230,1324,40
35065830293,35065830275,-18,1151,3900,40
35067024189,35067024184,-5,876,3384,40
35074282624,35074282617,-7,1261,3593,40
35075424978,35075424993,15,12027,47404,40
35075494097,35075494091,-6,861,3386,40
35082938553,35082938546,-7,686,3444,40
35102106557,35102106554,-3,988,2509,40
35106711455,35106711447,-8,1135,3027,40
35107115100,35107115108,8,1071,970,40
35111502122,35111502138,16,615,2295,40
35116326993,35116326989,-4,2189,6231,40
35119309590,35119309585,-5,854,3222,40
35119925741,35119925723,-18,180,996,40
35120174864,35120174873,9,143,1329,40
35126014788,35126014784,-4,1132,2473,40
35136687357,35136687363,6,2330,1262,40
35147589178,35147589171,-7,1052,3653,40
35163310226,35163310226,0,1173,1625,40
35164571326,35164571320,-6,1048,2633,40
35167161531,35167161525,-6,877,4701,40
35169755350,35169755350,0,1009,2288,40
35170814443,35170814437,-6,1387,2951,40
35170930045,35170930061,16,37,643,40
35173131706,35173131711,5,2101,1219,40
35186931698,35186931692,-6,1030,3304,40
35187022490,35187022485,-5,1007,3150,40
35189048106,35189048100,-6,1211,5072,40
35193301338,35193301335,-3,1260,2614,40
35197175125,35197175117,-8,1144,4513,40
35205384149,35205384157,8,2250,1096,40
35207021791,35207021787,-4,849,2831,40
35207289989,35207289974,-15,887,3617,40
35207523150,35207523169,19,1001,3105,40
35211558926,35211558921,-5,1014,2878,40
35212128036,35212128030,-6,276,2251,40
35217184822,35217184818,-4,755,3480,40
35219542413,35219542409,-4,1286,3562,40
35222228775,35222228769,-6,1032,2532,40
35225178706,35225178701,-5,1444,5327,40
35234847693,35234847688,-5,1237,4097,40
35235276825,35235276826,1,1155,1176,40
35239852306,35239852301,-5,955,3357,40
35242248484,35242248478,-6,1291,3478,40
35243939808,35243939802,-6,1427,5427,40
35245318966,35245318982,16,234,1821,40
35245568940,35245568951,11,151,993,40
35247556439,35247556437,-2,833,1916,40
35253165897,35253165890,-7,1939,6026,40
35258441878,35258441859,-19,2868,573,40
35266053874,35266053866,-8,1420,4605,40
35288735745,35288735739,-6,962,4007,40
35288944229,35288944218,-11,192,2726,40
35290627904,35290627922,18,243,1483,40
35292147802,35292147797,-5,863,2842,40
35295699339,35295699334,-5,954,3022,40
35296288318,35296288339,21,781,3094,40
35296649553,35296649547,-6,1137,3854,40
35308733942,35308733940,-2,5803,12725,40
35313421534,35313421532,-2,1004,1960,40
35314526698,35314526693,-5,1235,5116,40
35319074080,35319074086,6,6807,3230,40
35325605040,35325605034,-6,1590,3886,40
35327274559,35327274552,-7,849,3844,40
35333729695,35333729691,-4,951,3830,40
35336721275,35336721269,-6,952,2785,40
35341390849,35341390845,-4,954,2813,40
35348275696,35348275693,-3,2311,4421,40
35357573089,35357573097,8,8786,37693,40
35357870670,35357870689,19,1130,3356,40
35358926254,35358926249,-5,1128,3514,40
35359203718,35359203713,-5,290,1053,40
35360360208,35360360201,-7,820,1958,40
35360933878,35360933897,19,984,3351,40
35362797854,35362797849,-5,706,3398,40
35363513463,35363513441,-22,1266,851,40
35368863922,35368863916,-6,786,4346,40
35369131397,35369131390,-7,40,1353,40
35369660321,35369660318,-3,1221,3087,40
35370483205,35370483198,-7,1085,3332,40
35375009834,35375009838,4,1936,1736,40
35375929049,35375929045,-4,1304,2671,40
35376821631,35376821626,-5,969,3647,40
35378655462,35378655454,-8,121,679,40
35383570412,35383570406,-6,1401,4082,40
35386616931,35386616925,-6,1159,4617,40
35387079010,35387079013,3,7237,5632,40
35388859627,35388859622,-5,1318,5100,40
35389603275,35389603269,-6,755,4152,40
35389675869,35389675878,9,241,1036,40
35395110082,35395110077,-5,435,2237,40
35401068910,35401068917,7,3421,1812,40
35402296186,35402296178,-8,785,3184,40
35402478271,35402478289,18,278,1476,40
35405987302,35405987298,-4,1463,3056,40
35407562035,35407562030,-5,876,1945,40
35409967438,35409967434,-4,896,3169,40
35412886761,35412886756,-5,792,2652,40
35414536218,35414536220,2,6302,6446,40
35415038215,35415038218,3,2170,1270,40
35416759218,35416759213,-5,1282,3027,40
35423682953,35423682959,6,2091,1298,40
35425023961,35425023969,8,10571,32312,40
35426664826,35426664826,0,970,1552,40
35427180179,35427180182,3,1249,929,40
35428128740,35428128734,-6,1981,6952,40
35428457367,35428457359,-8,1291,2838,40
35428484029,35428484046,17,642,3119,40
35429179458,35429179454,-4,888,2545,40
35437688166,35437688165,-1,4413,7525,40
35437901047,35437901041,-6,1011,2212,40
35439173449,35439173444,-5,930,2340,40
35439915678,35439915674,-4,794,2747,40
35440886730,35440886725,-5,659,2580,40
35447075715,35447075707,-8,1199,4399,40
35447450711,35447450706,-5,226,1037,40
35460589763,35460589758,-5,1211,4052,40
35465617314,35465617308,-6,688,3282,40
35476215363,35476215358,-5,934,3017,40
35476584679,35476584663,-16,1672,25790,40
35478803780,35478803774,-6,1241,6101,40
35500568171,35500568166,-5,1628,4275,40
35503907733,35503907729,-4,1126,5169,40
35505892569,35505892565,-4,581,1458,40
35510032087,35510032082,-5,1087,3363,40
35510298317,35510298322,5,112,867,40
35511958312,35511958307,-5,964,3435,40
35513330652,35513330646,-6,1360,4538,40
35515010956,35515010949,-7,1242,4428,40
35516496388,35516496387,-1,6047,9072,40
35520544926,35520544933,7,4671,1648,40
35527255082,35527255077,-5,1294,4097,40
35533081401,35533081394,-7,845,4239,40
35540932965,35540932959,-6,1029,4489,40
35557762643,35557762645,2,1675,20902,40
35559442292,35559442280,-12,21229,17034,40
35562419829,35562419821,-8,1661,4403,40
35564258379,35564258374,-5,909,2994,40
35566284038,35566284032,-6,1325,4336,40
35567764362,35567764358,-4,1434,5004,40
35573401147,35573401141,-6,989,3695,40
35577626859,35577626854,-5,1105,1962,40
35581551785,35581551779,-6,1129,3584,40
35581941446,35581941464,18,623,2519,40
35582195274,35582195269,-5,1425,2865,40
35582692511,35582692501,-10,1168,4890,40
35582789637,35582789654,17,224,1524,40
35597641174,35597641170,-4,2774,4959,40
35621074997,35621074992,-5,1365,4386,40
35621220736,35621220730,-6,1104,3484,40
35621363317,35621363333,16,203,1534,40
35622592795,35622592793,-2,918,1087,40
35630932403,35630932397,-6,1106,5205,40
35634469193,35634469186,-7,1138,3837,40
35635486831,35635486826,-5,733,3725,40
35637707982,35637707976,-6,964,3175,40
35638301817,35638301811,-6,1278,2706,40
35640272430,35640272432,2,4830,3548,40
35641378346,35641378340,-6,1057,3181,40
35641717886,35641717881,-5,1230,4661,40
35651456654,35651456646,-8,1353,4683,40
35655931141,35655931152,11,15275,46588,40
35657947285,35657947278,-7,1003,4188,40
35662695030,35662695030,0,1156,2632,40
35666577057,35666577050,-7,1625,5934,40
35672289381,35672289373,-8,893,2685,40
35675773314,35675773307,-7,993,3714,40
35677287540,35677287547,7,35,1206,40
35679568487,35679568478,-9,1154,3700,40
35679850946,35679850940,-6,1379,3544,40
35681038261,35681038256,-5,1985,10697,40
35681652949,35681652943,-6,1098,3786,40
35682303470,35682303452,-18,775,2667,40
35684283335,35684283327,-8,786,3244,40
35686152571,35686152566,-5,901,2863,40
35686332495,35686332478,-17,832,3804,40
35690826262,35690826256,-6,1128,4534,40
35696031078,35696031071,-7,611,2686,40
35700958638,35700958633,-5,1108,3720,40
35702918060,35702918053,-7,972,4134,40
35704214554,35704214551,-3,964,2151,40
35709794467,35709794461,-6,787,4086,40
35720650931,35720650924,-7,1087,4182,40
35725862082,35725862076,-6,928,3069,40
35728961046,35728961042,-4,911,2470,40
35729622353,35729622349,-4,1045,3500,40
35731463317,35731463313,-4,1132,3971,40
35736599342,35736599337,-5,887,4061,40
35745716222,35745716218,-4,489,2305,40
35748611420,35748611412,-8,645,4481,40
35749007782,35749007782,0,22,959,40
35757509327,35757509322,-5,1182,3161,40
35759544067,35759544063,-4,1145,4078,40
35759752006,35759752001,-5,659,3568,40
35770576943,35770576938,-5,812,2833,40
35771270822,35771270814,-8,1148,4448,40
35771560621,35771560632,11,402,1085,40
35779820469,35779820463,-6,812,3201,40
35780359238,35780359231,-7,819,3238,40
35780785167,35780785178,11,211,1171,40
35782890062,35782890059,-3,2366,5984,40
35786785258,35786785253,-5,654,3453,40
35787413551,35787413549,-2,1176,2694,40
35787829158,35787829165,7,193,1013,40
35791062292,35791062285,-7,1454,5697,40
35794153087,35794153081,-6,890,2151,40
35794605639,35794605647,8,4098,1247,40
35803080378,35803080372,-6,1045,4373,40
35818287959,35818287953,-6,867,4538,40
35820176478,35820176471,-7,990,3365,40
35825768957,35825768950,-7,944,4237,40
35826134610,35826134605,-5,1136,3388,40
35835803334,35835803327,-7,1156,4150,40
35836671587,35836671582,-5,1229,3661,40
35844463707,35844463698,-9,879,3352,40
35846208254,35846208247,-7,888,2907,40
35847618614,35847618615,1,259,1420,40
35856393966,35856393960,-6,1802,7277,40
35859793673,35859793666,-7,975,2009,40
35870314206,35870314205,-1,923,2471,40
35870870243,35870870239,-4,807,3293,40
35873032327,35873032321,-6,527,2737,40
35873706223,35873706222,-1,277,1143,40
35873950877,35873950889,12,251,1234,40
35874891733,35874891729,-4,738,2132,40
35875343631,35875343631,0,275,1223,40
35877574736,35877574733,-3,1080,3425,40
35878813639,35878813633,-6,542,1774,40
35880057137,35880057130,-7,1079,3347,40
35882483006,35882483005,-1,186,923,40
35883454692,35883454713,21,819,4357,40
35888724255,35888724249,-6,1145,4118,40
35896086852,35896086871,19,1820,3115,40
35901228807,35901228802,-5,955,2706,40
35901605056,35901605073,17,889,3571,40
35902263546,35902263540,-6,672,2751,40
35904420938,35904420930,-8,519,3528,40
35907288634,35907288628,-6,663,3273,40
35916526296,35916526317,21,805,2906,40
35918344338,35918344340,2,1463,1768,40
35921661759,35921661753,-6,1292,4663,40
35924714810,35924714819,9,214,1811,40
35927078992,35927078986,-6,1333,3802,40
35927507098,35927507092,-6,977,4609,40
35930498120,35930498114,-6,797,3513,40
35938198122,35938198117,-5,953,3789,40
35938441167,35938441163,-4,1254,2455,40
35942423733,35942423736,3,1573,1552,40
35949942769,35949942763,-6,1009,3312,40
35961796688,35961796683,-5,1114,2888,40
35964093897,35964093890,-7,1316,3668,40
35995862478,35995862476,-2,1992,5096,40
35996882762,35996882757,-5,1120,3291,40
36006355901,36006355897,-4,878,2848,40
36020232036,36020232031,-5,979,2170,40
36029392227,36029392218,-9,1115,3602,40
36031781627,36031781622,-5,959,3877,40
36032515285,36032515290,5,1788,803,40
36034272115,36034272110,-5,814,1954,40
36040560590,36040560585,-5,691,3765,40
36041500018,36041500013,-5,1231,1976,40
36045362054,36045362049,-5,673,1776,40
36045786064,36045786078,14,699,1934,40
36049108326,36049108322,-4,970,3432,40
36053500062,36053500056,-6,1125,4361,40
36054634841,36054634835,-6,1070,4600,40
36056157747,36056157742,-5,544,2867,40
36056864363,36056864357,-6,895,3797,40
36060984910,36060984897,-13,4170,1018,40
36068604251,36068604245,-6,943,3663,40
36071433607,36071433602,-5,950,3575,40
36073167143,36073167137,-6,1221,3262,40
36081922144,36081922139,-5,1071,3874,40
36083622370,36083622365,-5,1161,4160,40
36087065174,36087065169,-5,956,3249,40
36095985548,36095985543,-5,1609,3111,40
36099653119,36099653113,-6,974,4770,40
36101622476,36101622469,-7,1247,5505,40
36103081800,36103081782,-18,290,1239,40
36107407577,36107407571,-6,1037,3267,40
36110218337,36110218333,-4,822,3967,40
36118813363,36118813356,-7,581,3183,40
36119115959,36119115953,-6,793,3996,40
36132714885,36132714880,-5,1053,3558,40
36133030460,36133030454,-6,43,930,40
36135937732,36135937726,-6,1476,4253,40
36137580991,36137580992,1,252,2057,40
36144096587,36144096581,-6,1182,3264,40
36147320490,36147320486,-4,1525,6305,40
36149545693,36149545687,-6,995,4113,40
36152760831,36152760826,-5,1092,2899,40
36158136644,36158136637,-7,1193,3880,40
36166527161,36166527175,14,902,2246,40
36173758070,36173758065,-5,1128,3871,40
36180898721,36180898726,5,3238,1202,40
36191235275,36191235282,7,5911,2523,40
36192678590,36192678597,7,16368,16179,40
36192722880,36192722873,-7,496,2290,40
36195986113,36195986105,-8,1251,5104,40
36197904866,36197904861,-5,1120,3177,40
36199918555,36199918549,-6,1333,3314,40
36200944093,36200944086,-7,660,3533,40
36203844810,36203844803,-7,905,2369,40
36203910170,36203910174,4,1587,1151,40
36204597133,36204597126,-7,798,3126,40
36208982199,36208982195,-4,1152,2985,40
36210607206,36210607200,-6,1520,4075,40
36212801549,36212801543,-6,1048,3500,40
36213269388,36213269393,5,9479,4556,40
36214795325,36214795321,-4,680,2987,40
36217097671,36217097663,-8,1124,3593,40
36217168111,36217168125,14,799,2733,40
36217270322,36217270317,-5,1285,4753,40
36217965966,36217965961,-5,624,2677,40
36222227360,36222227346,-14,247,1361,40
36228020092,36228020085,-7,313,2746,40
36228294730,36228294738,8,11127,31908,40
36228767660,36228767654,-6,1246,3976,40
36229964818,36229964812,-6,1151,3090,40
36230709128,36230709109,-19,35,662,40
36238859205,36238859197,-8,884,3774,40
36241770337,36241770330,-7,809,2339,40
36249877763,36249877757,-6,933,2476,40
36251243335,36251243348,13,173,1200,40
36251892607,36251892607,0,938,1643,40
36259999111,36259999105,-6,1241,2938,40
36262741454,36262741459,5,1820,893,40
36263650257,36263650251,-6,865,3006,40
36267704641,36267704635,-6,1168,4406,40
36269995224,36269995218,-6,1493,5227,40
36282128262,36282128263,1,49432,57686,40
36282740874,36282740871,-3,652,2132,40
36283922896,36283922914,18,735,4079,40
36284509703,36284509703,0,2124,1352,40
36287184061,36287184055,-6,1017,2779,40
36288514357,36288514336,-21,194,799,40
36292998581,36292998585,4,1210,1071,40
36300490050,36300490045,-5,1063,2432,40
36305673501,36305673504,3,3474,2543,40
36310338595,36310338590,-5,1358,3650,40
36311653167,36311653169,2,1527,1701,40
36323585011,36323585005,-6,804,3509,40
36334155231,36334155226,-5,710,3402,40
36337016607,36337016600,-7,923,3841,40
36338075263,36338075257,-6,644,4180,40
36338112628,36338112649,21,115,1293,40
36339930268,36339930275,7,2186,1202,40
36340842050,36340842050,0,1485,1920,40
36351641422,36351641417,-5,879,3277,40
36352373038,36352373033,-5,1043,3263,40
36355616639,36355616632,-7,548,4009,40
36355663796,36355663818,22,272,1066,40
36366003866,36366003870,4,3525,1297,40
36370986698,36370986693,-5,1112,3415,40
36383064569,36383064562,-7,1236,3394,40
36383562062,36383562079,17,212,1738,40
36384822164,36384822158,-6,937,4333,40
36387385701,36387385694,-7,797,2209,40
36388640997,36388640997,0,1333,1019,40
36395362786,36395362779,-7,1431,4274,40
36399557906,36399557899,-7,1631,3948,40
36400415273,36400415266,-7,1174,3652,40
36400555552,36400555569,17,1318,2232,40
36402489797,36402489793,-4,1260,2662,40
36402570597,36402570599,2,4536,3419,40
36404111855,36404111850,-5,1121,2665,40
36409266897,36409266892,-5,941,3748,40
36411094614,36411094607,-7,130,707,40
36417609384,36417609375,-9,1522,24495,40
36417753126,36417753129,3,1133,1229,40
36419401443,36419401438,-5,1124,4252,40
36431523188,36431523182,-6,1222,2565,40
36437872726,36437872732,6,2830,1138,40
36441184978,36441184972,-6,1078,4233,40
36445061597,36445061591,-6,746,3884,40
36446622052,36446622048,-4,1713,5227,40
36447026050,36447026042,-8,873,2746,40
36454779667,36454779661,-6,810,3601,40
36459279227,36459279233,6,2430,1409,40
36459962067,36459962074,7,2771,1450,40
36461908878,36461908872,-6,1198,5742,40
36466056720,36466056713,-7,1255,4021,40
36468955275,36468955269,-6,799,3609,40
36469816738,36469816730,-8,1107,4678,40
36473392707,36473392703,-4,1138,3028,40
36474492122,36474492115,-7,677,4131,40
36477459153,36477459146,-7,733,3081,40
36477781590,36477781579,-11,212,1058,40
36479197506,36479197501,-5,1135,5007,40
36479387222,36479387230,8,125,1161,40
36479736695,36479736681,-14,43,1106,40
36480847274,36480847277,3,1483,1745,40
36481841882,36481841877,-5,1215,3684,40
36485616833,36485616827,-6,860,4554,40
36485834875,36485834870,-5,1051,3735,40
36487235348,36487235343,-5,879,3559,40
36490411719,36490411715,-4,1024,3068,40
36494217116,36494217112,-4,535,3719,40
36494244261,36494244241,-20,1436,2352,40
36497016131,36497016125,-6,904,3801,40
36504866300,36504866294,-6,688,3086,40
36505020599,36505020583,-16,139,1232,40
36506733869,36506733863,-6,1224,4599,40
36508489137,36508489131,-6,1412,5428,40
36510923975,36510923968,-7,727,3097,40
36516891055,36516891050,-5,1086,3678,40
36518470905,36518470903,-2,140,722,40
36519405451,36519405446,-5,1398,4077,40
36522938773,36522938766,-7,858,2561,40
36531391013,36531391006,-7,382,1328,40
36531840174,36531840182,8,479,1559,40
36541328906,36541328899,-7,1186,4925,40
36543451724,36543451725,1,1959,1694,40
36544110889,36544110889,0,1616,2099,40
36554525235,36554525230,-5,1115,4885,40
36555191450,36555191454,4,2849,2519,40
36556618155,36556618148,-7,1358,5800,40
36573629011,36573629006,-5,1234,2119,40
36581280263,36581280258,-5,1619,6387,40
36581734942,36581734935,-7,867,3470,40
36582306260,36582306252,-8,1146,3963,40
36582705308,36582705289,-19,72,1138,40
36583563307,36583563302,-5,1145,2478,40
36586622949,36586622944,-5,841,3256,40
36587701006,36587701001,-5,176,853,40
36588212790,36588212799,9,13253,30353,40
36588646155,36588646150,-5,848,2660,40
36591154493,36591154489,-4,1133,4840,40
36591546916,36591546921,5,71,860,40
36592520030,36592520025,-5,1114,2952,40
36593387788,36593387790,2,68935,71146,40
36594814415,36594814408,-7,756,3105,40
36597678755,36597678750,-5,1123,4303,40
36598282655,36598282650,-5,984,3753,40
36601884389,36601884385,-4,1201,2785,40
36602296017,36602296011,-6,1137,3642,40
36602924931,36602924925,-6,569,2666,40
36604085142,36604085149,7,1788,814,40
36607464695,36607464689,-6,840,4562,40
36609781638,36609781633,-5,1221,3129,40
36612171513,36612171517,4,2520,1599,40
36616757758,36616757753,-5,1248,4119,40
36641790746,36641790741,-5,1291,3129,40
36648118239,36648118221,-18,338,1214,40
36658283723,36658283718,-5,959,2516,40
36658396068,36658396061,-7,1349,4588,40
36658694495,36658694496,1,2202,1831,40
36659147739,36659147745,6,3401,1821,40
36663485098,36663485093,-5,1060,3159,40
36667846425,36667846417,-8,955,3637,40
36668421053,36668421058,5,4485,1808,40
36668626785,36668626779,-6,1032,2828,40
36668865174,36668865155,-19,823,3682,40
36671365476,36671365469,-7,2098,10554,40
36681206313,36681206307,-6,900,3059,40
36689293172,36689293166,-6,964,4387,40
36692098999,36692098993,-6,1253,4204,40
36695436013,36695436007,-6,918,4228,40
36700324454,36700324459,5,2612,1455,40
36700777519,36700777515,-4,938,3455,40
36703139959,36703139954,-5,982,3067,40
36707335323,36707335323,0,1629,2131,40
36709368421,36709368414,-7,1282,3370,40
36711223795,36711223792,-3,323,1262,40
36712666138,36712666145,7,4421,1990,40
36713261656,36713261662,6,5113,1935,40
36720869508,36720869501,-7,1176,3939,40
36723412310,36723412311,1,1012,1255,40
36724820910,36724820905,-5,941,4046,40
36726997509,36726997506,-3,4017,7922,40
36728225675,36728225670,-5,954,3079,40
36731202426,36731202429,3,16541,14529,40
36746389716,36746389709,-7,1234,4189,40
36755977387,36755977383,-4,851,2716,40
36759582651,36759582647,-4,1215,3133,40
36761185606,36761185599,-7,541,2419,40
36763349392,36763349376,-16,2103,1435,40
36767256564,36767256558,-6,1075,3726,40
36767844588,36767844589,1,274,1999,40
36778199634,36778199638,4,2823,1441,40
36779488710,36779488705,-5,1322,4908,40
36782298099,36782298091,-8,1129,3664,40
36783683009,36783683003,-6,1100,3906,40
36791785907,36791785898,-9,620,3295,40
36792100950,36792100961,11,104,874,40
36792803840,36792803850,10,709,2571,40
36793650738,36793650734,-4,1337,3179,40
36797076747,36797076742,-5,825,2646,40
36797108592,36797108609,17,624,1615,40
36802088711,36802088705,-6,629,3775,40
36802916319,36802916313,-6,1008,3114,40
36803679061,36803679064,3,2373,1514,40
36803767006,36803767000,-6,1059,4257,40
36812737621,36812737621,0,2068,2071,40
36833159738,36833159731,-7,696,3962,40
36842422182,36842422177,-5,866,3315,40
36847165384,36847165385,1,2050,2165,40
36848236939,36848236941,2,1424,1593,40
36850016817,36850016821,4,24259,39985,40
36860289768,36860289750,-18,1222,3991,40
36861309453,36861309461,8,62,1114,40
36863796430,36863796426,-4,1274,5149,40
36866287691,36866287685,-6,1277,4614,40
36868130017,36868130014,-3,1831,2315,40
36868334992,36868334986,-6,840,3430,40
36879754207,36879754202,-5,756,2060,40
36883178076,36883178070,-6,1385,3803,40
36883368422,36883368423,1,202,604,40
36890458302,36890458297,-5,1325,4418,40
36890903260,36890903247,-13,2683,12520,40
36893502942,36893502937,-5,929,3745,40
36898653447,36898653441,-6,1096,3864,40
36903852154,36903852150,-4,939,2647,40
36907953499,36907953499,0,26239,31961,40
36908850343,36908850336,-7,841,3570,40
36910296496,36910296487,-9,1330,4076,40
36911866022,36911866027,5,2683,1541,40
36913817162,36913817169,7,2781,1322,40
36914102530,36914102525,-5,1093,3796,40
36914251924,36914251910,-14,262,710,40
36920432432,36920432425,-7,740,3081,40
36920984058,36920984063,5,5917,3093,40
36922232183,36922232178,-5,1098,3850,40
36929772202,36929772197,-5,1320,3023,40
36930598598,36930598593,-5,976,2649,40
36937106126,36937106126,0,3301,4191,40
36944720806,36944720803,-3,1519,3193,40
36948335255,36948335249,-6,1083,3980,40
36948392446,36948392438,-8,313,986,40
36951082539,36951082529,-10,252,1099,40
36953774610,36953774606,-4,844,3540,40
36955489042,36955489035,-7,718,3216,40
36958105874,36958105867,-7,1012,3371,40
36958983240,36958983242,2,158,1133,40
36960690823,36960690818,-5,1182,2811,40
36961370749,36961370742,-7,1784,7474,40
36967099686,36967099682,-4,1145,3346,40
36974219455,36974219449,-6,989,3218,40
36974892014,36974892018,4,9715,6113,40
36977022965,36977022969,4,1588,1282,40
36977695390,36977695385,-5,828,4506,40
36978244098,36978244100,2,1726,2352,40
36981904625,36981904617,-8,1028,3992,40
36984694131,36984694125,-6,1002,5018,40
36987792101,36987792097,-4,1141,2231,40
36990184701,36990184698,-3,2392,4521,40
36996744827,36996744822,-5,957,2368,40
36997391380,36997391371,-9,1050,3787,40
36997842078,36997842093,15,125,1342,40
37001504112,37001504105,-7,1318,4956,40
37002140817,37002140822,5,3803,2009,40
37003065242,37003065238,-4,1322,4084,40
37007984754,37007984762,8,7259,26218,40
37008675146,37008675141,-5,1000,2850,40
37008709595,37008709589,-6,1098,2830,40
37009301598,37009301577,-21,905,4133,40
37009365940,37009365934,-6,730,2534,40
37013676842,37013676838,-4,1128,3248,40
37014496815,37014496817,2,236,1215,40
37023879847,37023879841,-6,968,4295,40
37030803269,37030803261,-8,1082,2919,40
37038098032,37038098026,-6,963,5325,40
37038139719,37038139714,-5,864,3348,40
37040373838,37040373833,-5,730,2464,40
37042283259,37042283254,-5,774,2078,40
37042500143,37042500144,1,252,1595,40
37044749318,37044749311,-7,1386,4421,40
37045336056,37045336048,-8,688,2818,40
37045515505,37045515502,-3,1153,4289,40
37047615076,37047615069,-7,1074,5398,40
37057790539,37057790534,-5,961,4505,40
37058851257,37058851263,6,2696,1220,40
37061621003,37061620998,-5,696,3262,40
37065294629,37065294622,-7,922,2716,40
37065563851,37065563844,-7,1095,4586,40
37067324002,37067323997,-5,1666,4010,40
37073697558,37073697550,-8,1265,3825,40
37074169138,37074169131,-7,896,2444,40
37075011462,37075011456,-6,938,3388,40
37080743988,37080743982,-6,1310,4938,40
37082023770,37082023764,-6,1111,3405,40
37085517374,37085517376,2,1349,1542,40
37088646014,37088646008,-6,1054,3314,40
37093256547,37093256547,0,1722,1434,40
37094283558,37094283550,-8,1000,4722,40
37104888212,37104888209,-3,48114,24320,40
37121633993,37121633988,-5,1076,4991,40
37122228012,37122228028,16,336,1901,40
37127662749,37127662742,-7,1118,2822,40
37139361763,37139361770,7,5298,2648,40
37140505882,37140505886,4,3450,1963,40
37142733479,37142733473,-6,1020,3619,40
37148858887,37148858881,-6,1087,2963,40
37149696062,37149696057,-5,1167,4240,40
37151701957,37151701961,4,2251,1294,40
37153237142,37153237135,-7,1266,4488,40
37153379823,37153379810,-13,189,885,40
37159037434,37159037429,-5,1191,2822,40
37161538507,37161538502,-5,864,4312,40
37164380057,37164380060,3,32444,30997,40
37164978352,37164978345,-7,1054,4447,40
37166052948,37166052930,-18,1636,1381,40
37170928574,37170928569,-5,903,2412,40
37172735703,37172735697,-6,944,7269,40
37172976194,37172976202,8,2543,648,40
37173342881,37173342874,-7,1371,5317,40
37177140891,37177140885,-6,1028,1879,40
37179256347,37179256341,-6,1109,4281,40
37179815547,37179815542,-5,1186,3449,40
37187872243,37187872238,-5,889,3614,40
37188857025,37188857019,-6,1100,3037,40
37190380050,37190380043,-7,1210,5005,40
37190602887,37190602897,10,356,1458,40
37191573096,37191573110,14,124,1584,40
37191636703,37191636698,-5,1358,3628,40
37193702734,37193702741,7,3258,1603,40
37197492231,37197492224,-7,1283,3493,40
37198767579,37198767573,-6,1107,2951,40
37203387683,37203387679,-4,1172,1599,40
37203944171,37203944165,-6,798,3032,40
37204230510,37204230523,13,904,3002,40
37208315483,37208315476,-7,1065,4902,40
37210432463,37210432456,-7,1021,5310,40
37211541515,37211541523,8,1145,1885,40
37214372495,37214372487,-8,986,2851,40
37215555117,37215555112,-5,855,3445,40
37217994455,37217994457,2,1853,1263,40
37218674450,37218674444,-6,1086,6218,40
37219161555,37219161548,-7,996,3634,40
37220200582,37220200576,-6,175,1547,40
37224759774,37224759768,-6,947,3553,40
37233512445,37233512447,2,3841,2761,40
37234846073,37234846066,-7,807,2455,40
37236530142,37236530139,-3,445,1592,40
37236633703,37236633707,4,27,1488,40
37245102688,37245102681,-7,934,3820,40
37247626329,37247626322,-7,1234,4600,40
37253238752,37253238746,-6,1441,4715,40
37256830310,37256830306,-4,1019,4717,40
37257324882,37257324877,-5,1153,4026,40
37260110106,37260110099,-7,713,4555,40
37260383870,37260383874,4,215,1212,40
37261716688,37261716703,15,487,1081,40
37262009742,37262009737,-5,1035,3465,40
37265343969,37265343968,-1,24315,37564,40
37267656371,37267656364,-7,760,3298,40
37273994198,37273994190,-8,1449,4880,40
37276916781,37276916794,13,553,2639,40
37278013034,37278013028,-6,685,2891,40
37290811223,37290811217,-6,873,3526,40
37295233246,37295233241,-5,1048,4308,40
37295433576,37295433584,8,281,2086,40
37295784965,37295784961,-4,1128,3361,40
37301109058,37301109054,-4,1019,3226,40
37303442275,37303442270,-5,671,2980,40
37310653108,37310653103,-5,989,3234,40
37312235822,37312235818,-4,2208,5279,40
37316082483,37316082477,-6,921,3047,40
37317541743,37317541738,-5,1050,3076,40
37324851618,37324851613,-5,1476,4931,40
37325440054,37325440035,-19,1236,3917,40
37325521438,37325521454,16,886,3810,40
37328343187,37328343193,6,3920,1030,40
37331165459,37331165453,-6,880,4595,40
37336246822,37336246818,-4,1217,3721,40
37337497920,37337497934,14,852,2502,40
37340244516,37340244513,-3,932,3030,40
37352819052,37352819051,-1,2118,3048,40
37356430290,37356430285,-5,980,3735,40
37357989342,37357989331,-11,719,2632,40
37364311810,37364311804,-6,1325,3856,40
37366505179,37366505174,-5,581,2582,40
37366826322,37366826322,0,2175,2990,40
37369446490,37369446494,4,2819,1906,40
37371809018,37371809013,-5,1055,2851,40
37372124927,37372124905,-22,165,1510,40
37382317329,37382317314,-15,871,3080,40
37386566323,37386566318,-5,1225,3950,40
37389225197,37389225201,4,5615,22857,40
37401544794,37401544789,-5,1231,3185,40
37403183017,37403183011,-6,735,2186,40
37403532249,37403532248,-1,1389,1973,40
37405629560,37405629561,1,1264,1272,40
37415476121,37415476126,5,1466,1213,40
37417957336,37417957344,8,12778,33717,40
37421292633,37421292625,-8,837,2972,40
37422137032,37422137038,6,19487,16604,40
37428874147,37428874167,20,27619,18807,40
37431244351,37431244350,-1,1204,2153,40
37431784458,37431784453,-5,784,3185,40
37431870652,37431870646,-6,1499,4429,40
37436185391,37436185385,-6,1014,4256,40
37437397654,37437397670,16,395,2594,40
37440650789,37440650795,6,6326,2599,40
37441037373,37441037366,-7,995,4118,40
37448387026,37448387022,-4,1070,3940,40
37452453591,37452453585,-6,907,3680,40
37463200657,37463200669,12,15612,7282,40
37475080495,37475080489,-6,732,3314,40
37476523734,37476523726,-8,1077,3849,40
37488587175,37488587176,1,1804,1641,40
37488858231,37488858225,-6,1252,3503,40
37493047094,37493047075,-19,1112,367,40
37494335495,37494335490,-5,923,2492,40
37494657501,37494657500,-1,199,1541,40
37495404789,37495404802,13,425,1418,40
37501471878,37501471871,-7,1085,3182,40
37506933814,37506933809,-5,1058,3763,40
37512287178,37512287172,-6,1038,3651,40
37513532127,37513532108,-19,893,4204,40
37516292653,37516292649,-4,1153,3216,40
37517402330,37517402324,-6,879,4373,40
37518730962,37518730955,-7,682,3111,40
37523186626,37523186627,1,1584,1569,40
37523899212,37523899204,-8,997,3475,40
37523925590,37523925609,19,336,878,40
37524264702,37524264695,-7,891,4996,40
37527381417,37527381410,-7,1162,3282,40
37533293582,37533293578,-4,871,3810,40
37539223893,37539223886,-7,902,3239,40
37539988569,37539988562,-7,877,3333,40
37542733321,37542733317,-4,593,2557,40
37545300297,37545300290,-7,1162,3590,40
37551360581,37551360575,-6,1202,6481,40
37552365102,37552365094,-8,106,1430,40
37553680953,37553680947,-6,1384,3527,40
37554002671,37554002678,7,217,1561,40
37554873910,37554873905,-5,1092,3181,40
37555079184,37555079174,-10,83,1304,40
37555820287,37555820281,-6,1429,5116,40
37562337366,37562337358,-8,1024,4624,40
37564922330,37564922325,-5,946,3428,40
37568914716,37568914710,-6,1210,3521,40
37569337908,37569337894,-14,37,1070,40
37569783374,37569783363,-11,181,1478,40
37569984711,37569984700,-11,644,4108,40
37574180354,37574180355,1,1031,1259,40
37578054919,37578054914,-5,2124,4901,40
37585687893,37585687890,-3,1371,3399,40
37600458101,37600458098,-3,987,2914,40
37600492396,37600492377,-19,16,908,40
37603330322,37603330318,-4,625,805,40
37604726485,37604726479,-6,749,3254,40
37610827727,37610827722,-5,945,3342,40
37620096465,37620096459,-6,1008,3273,40
37621129400,37621129410,10,78,982,40
37621182479,37621182473,-6,752,2971,40
37622093358,37622093363,5,2067,1072,40
37622883769,37622883764,-5,1474,3447,40
37627114702,37627114705,3,2416,1957,40
37634694419,37634694405,-14,112,1198,40
37635003707,37635003713,6,15931,15118,40
37635452750,37635452752,2,4938,18074,40
37636938854,37636938858,4,917,793,40
37645837291,37645837292,1,1616,1666,40
37647026600,37647026594,-6,1311,2551,40
37647321728,37647321706,-22,177,865,40
37653346534,37653346555,21,230,1223,40
37654185541,37654185534,-7,1497,10234,40
37659746451,37659746443,-8,1071,4685,40
37660758725,37660758736,11,234,662,40
37662775959,37662775953,-6,1668,3779,40
37664187412,37664187406,-6,608,2800,40
37664290256,37664290266,10,600,3335,40
37664550979,37664550974,-5,1072,3565,40
37678514964,37678514970,6,5764,2611,40
37681726342,37681726338,-4,841,1831,40
37687817637,37687817632,-5,1130,4331,40
37688607597,37688607614,17,555,1339,40
37691193615,37691193609,-6,1576,3938,40
37698670537,37698670540,3,19534,24791,40
37704554441,37704554435,-6,886,2738,40
37706956106,37706956089,-17,1006,441,40
37711622211,37711622206,-5,830,2871,40
37711690727,37711690737,10,133,1626,40
37727158495,37727158489,-6,833,3703,40
37727225398,37727225393,-5,994,2665,40
37732689502,37732689503,1,983,1325,40
37736034093,37736034088,-5,861,3581,40
37740322670,37740322666,-4,1069,3175,40
37744383301,37744383300,-1,1198,1757,40
37744445486,37744445482,-4,1464,4198,40
37747991993,37747991987,-6,1015,2917,40
37748162604,37748162606,2,183,880,40
37754702346,37754702341,-5,917,2971,40
37769449044,37769449038,-6,865,3755,40
37773091038,37773091045,7,3426,1539,40
37775741066,37775741061,-5,1167,3723,40
37778183936,37778183939,3,1489,25310,40
37782008843,37782008838,-5,1699,4380,40
37782857654,37782857653,-1,3360,3620,40
37783588702,37783588695,-7,1245,3710,40
37784153262,37784153257,-5,924,3608,40
37784760966,37784760971,5,311,1194,40
37787636210,37787636217,7,11005,31197,40
37790404675,37790404669,-6,1320,2549,40
37796710441,37796710434,-7,879,2496,40
37803524155,37803524149,-6,692,4416,40
37809626763,37809626758,-5,1012,3724,40
37816534505,37816534501,-4,1368,3859,40
37818447467,37818447463,-4,768,2876,40
37822161402,37822161397,-5,1347,5336,40
37823955270,37823955266,-4,1036,2855,40
37828709510,37828709502,-8,1257,3463,40
37829437057,37829437051,-6,1220,2855,40
37833830378,37833830373,-5,1303,3845,40
37839985981,37839985976,-5,1400,3266,40
37840692038,37840692018,-20,252,1455,40
37843343540,37843343534,-6,1224,3845,40
37844005213,37844005210,-3,1976,2384,40
37845513830,37845513823,-7,996,5499,40
37856189359,37856189350,-9,909,3531,40
37856891191,37856891195,4,92,1342,40
37859342440,37859342434,-6,974,4150,40
37862546247,37862546239,-8,584,2490,40
37864597811,37864597806,-5,1148,3404,40
37875346882,37875346876,-6,1079,3591,40
37887196893,37887196885,-8,1251,4685,40
37889333655,37889333650,-5,960,3323,40
37892087175,37892087169,-6,986,4092,40
37894402371,37894402362,-9,196,1313,40
37895475327,37895475319,-8,869,2211,40
37898482187,37898482182,-5,990,3815,40
37901944914,37901944917,3,2471,2263,40
37907200477,37907200470,-7,1092,3786,40
37907865733,37907865751,18,144,1258,40
37909698450,37909698445,-5,1060,3824,40
37909818574,37909818569,-5,809,2858,40
37910255448,37910255460,12,950,4240,40
37921294727,37921294721,-6,1254,3798,40
37922043386,37922043378,-8,1014,3579,40
37926051761,37926051766,5,2545,1189,40
37927150348,37927150347,-1,163,1226,40
37927599797,37927599815,18,1183,2835,40
37931873533,37931873530,-3,325,1933,40
37935347407,37935347401,-6,808,2886,40
37935428458,37935428453,-5,751,3913,40
37935465535,37935465534,-1,103,877,40
37940485873,37940485866,-7,1171,3700,40
37940703014,37940703009,-5,1094,4422,40
37943006949,37943006945,-4,1246,4169,40
37946643350,37946643346,-4,858,1458,40
37946834522,37946834518,-4,741,2628,40
37947756622,37947756637,15,702,4716,40
37950329259,37950329253,-6,894,3033,40
37953148273,37953148267,-6,1133,3793,40
37955788045,37955788038,-7,952,3328,40
37956261735,37956261733,-2,318,921,40
37957477640,37957477634,-6,1246,4701,40
37964857186,37964857181,-5,1460,4899,40
37972352195,37972352197,2,1234,1274,40
37973338450,37973338444,-6,1023,4116,40
37973459862,37973459883,21,606,2835,40
37974056044,37974056038,-6,1190,4270,40
37975113832,37975113826,-6,963,3682,40
37982908657,37982908651,-6,915,5562,40
37995049870,37995049865,-5,1201,2967,40
37995236470,37995236464,-6,888,4264,40
37995371805,37995371823,18,200,1364,40
37996061861,37996061854,-7,1236,3407,40
37996118382,37996118398,16,545,1428,40
38009709903,38009709897,-6,982,2720,40
38010280830,38010280823,-7,1344,4124,40
38012173401,38012173397,-4,1116,4266,40
38015626948,38015626941,-7,1211,3826,40
38017892119,38017892122,3,1642,1577,40
38019228515,38019228510,-5,848,3458,40
38033624458,38033624463,5,3365,2146,40
38033847018,38033847014,-4,1217,3882,40
38035743667,38035743673,6,3211,1563,40
38038140817,38038140810,-7,841,3913,40
38038660150,38038660144,-6,1188,4722,40
38042738373,38042738377,4,2691,1526,40
38046269598,38046269594,-4,1728,4563,40
38048841462,38048841456,-6,1185,3970,40
38049183578,38049183573,-5,1381,3527,40
38051057893,38051057890,-3,922,3277,40
38051376022,38051376017,-5,874,2534,40
38051665531,38051665528,-3,1098,3285,40
38070189030,38070189029,-1,1107,1862,40
38075367063,38075367060,-3,980,2128,40
38080635438,38080635433,-5,1273,3243,40
38083026767,38083026760,-7,834,3533,40
38084482414,38084482407,-7,781,3052,40
38084569415,38084569410,-5,1273,2682,40
38089441126,38089441121,-5,1249,5032,40
38091491613,38091491613,0,568,1119,40
38097612186,38097612186,0,1393,1685,40
38103194961,38103194955,-6,927,3689,40
38106185194,38106185192,-2,2141,4312,40
38106591813,38106591815,2,1644,703,40
38108396233,38108396228,-5,484,1186,40
38117353114,38117353109,-5,988,3541,40
38118489458,38118489453,-5,683,2928,40
38119627723,38119627718,-5,1108,4250,40
38120386307,38120386302,-5,871,4167,40
38130913039,38130913034,-5,211,1373,40
38138646402,38138646395,-7,1002,4229,40
38140241233,38140241225,-8,896,3496,40
38151231418,38151231412,-6,988,3902,40
38153164684,38153164673,-11,239,1136,40
38158171660,38158171662,2,2156,1994,40
38160802019,38160802011,-8,1016,4827,40
38161648415,38161648409,-6,1011,3820,40
38161942629,38161942645,16,746,4263,40
38162942422,38162942414,-8,623,1578,40
38164904777,38164904777,0,1029,1583,40
38165249121,38165249114,-7,652,2826,40
38167572643,38167572637,-6,871,4286,40
38167810360,38167810362,2,362,1261,40
38170660183,38170660178,-5,807,3082,40
38174868819,38174868813,-6,1064,3391,40
38184514381,38184514377,-4,909,2474,40
38185531243,38185531238,-5,862,3590,40
38186919606,38186919598,-8,1053,4179,40
38187798211,38187798205,-6,1123,3949,40
38198801003,38198800983,-20,35066,24846,40
38199879901,38199879893,-8,950,2866,40
38201381000,38201380994,-6,811,3377,40
38208236669,38208236662,-7,1274,4633,40
38211185054,38211185041,-13,3066,829,40
38213415790,38213415786,-4,743,2260,40
38223428585,38223428581,-4,1149,3017,40
38223867298,38223867295,-3,868,2768,40
38224050300,38224050293,-7,1421,4801,40
38229581205,38229581198,-7,1056,4129,40
38230017981,38230017964,-17,141,1450,40
38230145126,38230145119,-7,1048,4168,40
38239304313,38239304310,-3,230,897,40
38240294138,38240294141,3,2432,2242,40
38240418506,38240418502,-4,954,1358,40
38244339684,38244339686,2,1625,1088,40
38246830438,38246830434,-4,1940,5752,40
38249235127,38249235121,-6,915,2760,40
38263963654,38263963650,-4,841,2085,40
38264146174,38264146155,-19,1545,7812,40
38265574196,38265574179,-17,142,1545,40
38270155037,38270155030,-7,816,3595,40
38270374424,38270374437,13,347,1334,40
38274858656,38274858650,-6,788,3425,40
38278045491,38278045487,-4,1067,3767,40
38278944522,38278944515,-7,1125,4614,40
38283691681,38283691674,-7,1071,4867,40
38292997404,38292997397,-7,981,4188,40
38299194807,38299194801,-6,732,3305,40
38299770074,38299770073,-1,1416,1974,40
38299896374,38299896369,-5,1129,4557,40
38301448067,38301448062,-5,1793,3568,40
38307534858,38307534853,-5,1291,4322,40
38309958936,38309958933,-3,756,1757,40
38310244896,38310244887,-9,897,4329,40
38320442375,38320442370,-5,1162,3315,40
38326203947,38326203941,-6,1178,3170,40
38330594781,38330594774,-7,1375,3676,40
38331492152,38331492146,-6,893,4350,40
38331517519,38331517505,-14,184,1219,40
38331977573,38331977570,-3,134,1023,40
38332006684,38332006701,17,409,1158,40
38332937686,38332937664,-22,61,942,40
38336854718,38336854711,-7,915,4828,40
38336923525,38336923514,-11,263,1132,40
38338395997,38338396009,12,543,1909,40
38340148797,38340148797,0,765,1294,40
38341265422,38341265416,-6,1065,4713,40
38342427720,38342427714,-6,1223,4119,40
38346254009,38346254012,3,1583,1314,40
38346410714,38346410721,7,2050,1649,40
38346668650,38346668656,6,2787,1095,40
38347484138,38347484132,-6,1092,3278,40
38349323538,38349323540,2,2673,2965,40
38350369126,38350369121,-5,895,3626,40
38352523871,38352523866,-5,1050,3844,40
38356055284,38356055285,1,24680,29508,40
38366777165,38366777150,-15,240,1016,40
38382924750,38382924745,-5,1092,4748,40
38383797943,38383797924,-19,266,1080,40
38385145588,38385145591,3,1283,855,40
38389155243,38389155238,-5,831,5189,40
38389935165,38389935158,-7,764,3955,40
38391080567,38391080578,11,62,847,40
38397295937,38397295931,-6,1058,3374,40
38400692922,38400692931,9,10200,22558,40
38402059052,38402059046,-6,837,3365,40
38403276959,38403276959,0,2157,1929,40
38404700944,38404700947,3,2622,2359,40
38405372814,38405372809,-5,1240,2467,40
38408251191,38408251186,-5,996,2152,40
38412351300,38412351293,-7,750,3291,40
38414107494,38414107501,7,3321,1460,40
38415242451,38415242445,-6,649,3079,40
38415435671,38415435686,15,182,945,40
38421758686,38421758679,-7,1102,3028,40
38422084067,38422084063,-4,1006,3664,40
38422420280,38422420294,14,313,988,40
38425533574,38425533566,-8,1077,3274,40
38426897804,38426897810,6,213,890,40
38427331702,38427331682,-20,1112,4158,40
38434677779,38434677773,-6,1337,5701,40
38437327126,38437327122,-4,854,3361,40
38437853556,38437853558,2,34634,44479,40
38440144426,38440144422,-4,1114,3100,40
38444677360,38444677362,2,3133,3054,40
38447069710,38447069700,-10,20454,16943,40
38447928958,38447928951,-7,962,3576,40
38448154515,38448154509,-6,1234,4316,40
38453434687,38453434681,-6,851,3339,40
38459971331,38459971326,-5,1125,2198,40
38460021647,38460021646,-1,1582,2117,40
38462981678,38462981673,-5,1223,4039,40
38465985703,38465985698,-5,965,3451,40
38468873668,38468873662,-6,644,3055,40
38470238478,38470238457,-21,602,4380,40
38470945556,38470945550,-6,987,3889,40
38473036942,38473036944,2,142,1529,40
38480024619,38480024618,-1,1037,947,40
38482526417,38482526412,-5,972,4047,40
38483391107,38483391102,-5,847,1859,40
38484630724,38484630705,-19,270,1451,40
38485336493,38485336488,-5,241,1253,40
38485413028,38485413009,-19,137,1255,40
38492244430,38492244421,-9,911,3863,40
38497116955,38497116950,-5,1092,3773,40
38497240266,38497240258,-8,778,3918,40
38504540731,38504540733,2,2263,2596,40
38509399431,38509399427,-4,921,3433,40
38509773228,38509773250,22,685,3260,40
38515622454,38515622449,-5,1042,3177,40
38515686848,38515686863,15,133,1439,40
38516192074,38516192066,-8,1119,5014,40
38516302735,38516302746,11,718,3720,40
38518741233,38518741238,5,5137,2567,40
38521433334,38521433328,-6,1176,4722,40
38522351069,38522351061,-8,267,1102,40
38524473436,38524473429,-7,1016,3499,40
38524910177,38524910173,-4,1210,3789,40
38526403238,38526403233,-5,839,2232,40
38526540397,38526540417,20,984,3127,40
38529486341,38529486337,-4,849,3302,40
38529546319,38529546302,-17,5,857,40
38531298872,38531298870,-2,2140,2218,40
38536141225,38536141219,-6,1141,3992,40
38536983423,38536983417,-6,1415,4481,40
38538490017,38538490023,6,3501,1248,40
38540985514,38540985507,-7,1296,3346,40
38542670271,38542670269,-2,1004,2393,40
38546352694,38546352689,-5,1015,3913,40
38548362646,38548362644,-2,1491,2916,40
38548649574,38548649569,-5,1069,3280,40
38549166231,38549166226,-5,2959,6447,40
38551971234,38551971227,-7,1122,3929,40
38555077858,38555077862,4,1561,578,40
38565637099,38565637092,-7,1398,4849,40
38566417053,38566417047,-6,1142,3549,40
38566708248,38566708258,10,700,3760,40
38578644175,38578644171,-4,764,3493,40
38583669486,38583669498,12,2341,1048,40
38589038366,38589038358,-8,486,3390,40
38596115411,38596115404,-7,1103,3102,40
38602814674,38602814674,0,36886,14543,40
38610640593,38610640585,-8,1335,5071,40
38613469953,38613469948,-5,950,3590,40
38614124817,38614124809,-8,955,3583,40
38621191987,38621191980,-7,1282,4634,40
38623712783,38623712778,-5,1030,4602,40
38629679003,38629678996,-7,852,3238,40
38629744832,38629744850,18,699,2451,40
38629847782,38629847774,-8,1580,3645,40
38629989508,38629989502,-6,1096,3522,40
38634999203,38634999198,-5,684,2600,40
38636166592,38636166586,-6,1313,3667,40
38638250515,38638250509,-6,1453,4669,40
38639025258,38639025251,-7,1175,3486,40
38639166686,38639166706,20,126,988,40
38641239587,38641239581,-6,999,3830,40
38648421055,38648421049,-6,958,3627,40
38653339567,38653339565,-2,1423,1810,40
38653752951,38653752954,3,4579,2734,40
38655015502,38655015494,-8,1280,4153,40
38674046771,38674046769,-2,836,1467,40
38674891205,38674891226,21,946,4087,40
38681731528,38681731535,7,5030,27564,40
38683115848,38683115841,-7,917,3594,40
38683286606,38683286622,16,708,2927,40
38689644170,38689644175,5,1767,1099,40
38690561597,38690561590,-7,980,4938,40
38690903480,38690903489,9,190,1320,40
38694756752,38694756746,-6,1163,4639,40
38695547987,38695547982,-5,946,2914,40
38702823573,38702823583,10,2114,6660,40
38711618042,38711618037,-5,1457,4838,40
38713486687,38713486678,-9,1054,3595,40
38714077354,38714077349,-5,1136,3502,40
38714983297,38714983290,-7,1197,4587,40
38717176062,38717176062,0,1556,2253,40
38735684528,38735684522,-6,908,4019,40
38735944230,38735944218,-12,1247,2763,40
38740109923,38740109918,-5,844,3451,40
38740177623,38740177619,-4,270,1124,40
38743465734,38743465728,-6,1334,3764,40
38743763847,38743763841,-6,1452,4379,40
38748041306,38748041301,-5,831,3323,40
38753210030,38753210026,-4,708,3537,40
38770922654,38770922656,2,1852,1789,40
38771254229,38771254221,-8,1066,3361,40
38776787587,38776787568,-19,25015,37677,40
38777418868,38777418862,-6,1596,3412,40
38778621846,38778621838,-8,1805,9360,40
38796002361,38796002354,-7,999,3163,40
38797485592,38797485594,2,2694,1746,40
38810588186,38810588189,3,3406,1961,40
38814180014,38814180007,-7,1355,5947,40
38830873875,38830873868,-7,791,2949,40
38831591590,38831591590,0,1515,1113,40
38832504236,38832504234,-2,241,1596,40
38839507403,38839507397,-6,906,3933,40
38840759798,38840759797,-1,905,1871,40
38841224942,38841224934,-8,255,898,40
38844055423,38844055418,-5,871,4593,40
38848707918,38848707914,-4,1142,1868,40
38851496738,38851496731,-7,854,4372,40
38852414190,38852414185,-5,788,3217,40
38852985654,38852985645,-9,302,1090,40
38853340609,38853340604,-5,1111,4070,40
38853404710,38853404701,-9,956,4439,40
38853681503,38853681501,-2,181,1007,40
38862634256,38862634268,12,246,1122,40
38866434703,38866434697,-6,920,3794,40
38872151126,38872151121,-5,805,3992,40
38874675557,38874675551,-6,1051,3064,40
38878125342,38878125337,-5,758,2856,40
38879522593,38879522586,-7,931,4315,40
38882425265,38882425258,-7,1154,3884,40
38885118945,38885118939,-6,1486,2536,40
38890350626,38890350625,-1,3102,4319,40
38896153652,38896153646,-6,979,3948,40
38897304747,38897304742,-5,971,3456,40
38897329821,38897329823,2,207,815,40
38897343384,38897343384,0,93,37,40
38899905261,38899905270,9,9556,38078,40
38900479957,38900479952,-5,1080,2732,40
38911933902,38911933905,3,3535,4825,40
38917403401,38917403395,-6,999,3308,40
38920336412,38920336405,-7,894,3922,40
38921120863,38921120858,-5,870,3717,40
38926853294,38926853288,-6,797,5066,40
38928342190,38928342196,6,7552,34842,40
38933661049,38933661044,-5,1240,3916,40
38935256184,38935256178,-6,1219,5752,40
38935453628,38935453623,-5,1682,4686,40
38936459401,38936459395,-6,1496,3378,40
38940627990,38940628000,10,9194,40853,40
38941005348,38941005343,-5,85,1217,40
38941872060,38941872083,23,282,1062,40
38949368755,38949368749,-6,677,2190,40
38952090375,38952090390,15,1223,4739,40
38961076886,38961076878,-8,910,3853,40
38965418136,38965418128,-8,580,3651,40
38965446528,38965446541,13,296,922,40
38969437465,38969437461,-4,1127,3729,40
38971786586,38971786580,-6,1015,3515,40
38974154838,38974154831,-7,856,3405,40
38974866558,38974866573,15,242,1298,40
38978973309,38978973302,-7,1322,4898,40
38981827668,38981827661,-7,1478,3904,40
38981855824,38981855836,12,432,1264,40
38989427073,38989427065,-8,1141,3383,40
38990807126,38990807118,-8,1534,5687,40
38990972214,38990972210,-4,1128,2541,40
38994119523,38994119518,-5,981,3576,40
39000907709,39000907702,-7,744,3715,40
39008479722,39008479715,-7,772,5503,40
39021907315,39021907308,-7,1355,5382,40
39023881614,39023881609,-5,924,3744,40
39023949462,39023949482,20,146,1160,40
39033409285,39033409278,-7,824,2636,40
39035242225,39035242231,6,2061,618,40
39037652210,39037652216,6,1669,1222,40
39049808599,39049808600,1,1018,957,40
39050096349,39050096341,-8,774,3988,40
39050622270,39050622266,-4,860,3390,40
39054951734,39054951728,-6,997,2950,40
39057222557,39057222550,-7,652,2581,40
39059665040,39059665058,18,991,3572,40
39061555305,39061555299,-6,1105,3476,40
39070051783,39070051777,-6,1157,3458,40
39070310076,39070310070,-6,1257,4348,40
39074805725,39074805721,-4,1606,5008,40
39078868322,39078868317,-5,1284,3499,40
39082484103,39082484098,-5,2389,6522,40
39083597462,39083597454,-8,1025,3284,40
39085645566,39085645561,-5,883,2848,40
39089876443,39089876438,-5,1034,3289,40
39090780608,39090780601,-7,947,3314,40
39093518378,39093518370,-8,1075,4443,40
39093933890,39093933886,-4,909,3837,40
39096846911,39096846903,-8,644,4167,40
39102295155,39102295151,-4,2128,4628,40
39111692294,39111692287,-7,1048,3242,40
39116399487,39116399486,-1,1757,2375,40
39117579612,39117579614,2,2507,2232,40
39122109330,39122109325,-5,910,3586,40
39125129765,39125129758,-7,1146,2807,40
39126688869,39126688864,-5,912,3134,40
39134354095,39134354089,-6,922,3247,40
39140036415,39140036420,5,508,623,40
39146042222,39146042217,-5,1036,2749,40
39151378956,39151378950,-6,1107,3560,40
39151838150,39151838149,-1,1013,1744,40
39153928346,39153928340,-6,806,4077,40
39165939243,39165939246,3,4074,2769,40
39171733616,39171733616,0,1510,2251,40
39176165917,39176165906,-11,521,4037,40
39176801946,39176801942,-4,1038,2815,40
39179258090,39179258086,-4,605,3388,40
39179408206,39179408218,12,421,2107,40
39180282299,39180282293,-6,707,2812,40
39181247954,39181247949,-5,995,3586,40
39181459366,39181459382,16,566,3066,40
39182005770,39182005765,-5,774,3741,40
39182184733,39182184745,12,345,3848,40
39182248148,39182248154,6,2136,864,40
39192844369,39192844363,-6,903,4278,40
39198536486,39198536479,-7,1188,4900,40
39201043025,39201043019,-6,906,2659,40
39212570428,39212570421,-7,1160,4812,40
39224941065,39224941059,-6,1367,4136,40
39230375607,39230375603,-4,995,1268,40
39230782672,39230782683,11,244,1175,40
39234083590,39234083603,13,2881,1187,40
39234176939,39234176939,0,1427,2236,40
39247198810,39247198804,-6,1526,3848,40
39249962601,39249962599,-2,1204,1966,40
39263371086,39263371082,-4,1194,3928,40
39264446981,39264446962,-19,833,2586,40
39267018924,39267018918,-6,1099,3847,40
39268726549,39268726543,-6,1036,4578,40
39276361047,39276361041,-6,1634,6531,40
39278053079,39278053079,0,1341,1219,40
39278178760,39278178752,-8,1532,5499,40
39285680781,39285680774,-7,1332,3769,40
39292663011,39292663006,-5,792,3186,40
39293490441,39293490445,4,1749,1144,40
39298067881,39298067874,-7,1125,3269,40
39301213000,39301212994,-6,1217,5053,40
39307376079,39307376078,-1,4282,17179,40
39317940028,39317940023,-5,662,2448,40
39319424310,39319424311,1,99,963,40
39320213237,39320213228,-9,184,986,40
39320551903,39320551882,-21,327,2161,40
39330974054,39330974050,-4,940,3439,40
39332685306,39332685305,-1,1348,2016,40
39355877167,39355877159,-8,1156,3735,40
39358703403,39358703398,-5,963,3695,40
39360269016,39360269028,12,973,3075,40
39361690482,39361690476,-6,980,4751,40
39371336842,39371336836,-6,1037,4251,40
39371394317,39371394302,-15,1240,3627,40
39376588843,39376588837,-6,1630,4763,40
39377950078,39377950072,-6,579,2852,40
39378253542,39378253541,-1,1069,2770,40
39379804589,39379804582,-7,948,4285,40
39380216314,39380216307,-7,1613,3296,40
39380981983,39380981977,-6,1015,3816,40
39383978937,39383978931,-6,664,4666,40
39394570150,39394570146,-4,1102,3277,40
39394608046,39394608059,13,213,1244,40
39398110690,39398110685,-5,1128,4176,40
39402257045,39402257038,-7,852,4437,40
39406009239,39406009234,-5,799,4039,40
39408044327,39408044320,-7,1202,5321,40
39408201939,39408201933,-6,1056,4601,40
39408539883,39408539885,2,2233,1329,40
39421264035,39421264038,3,177,871,40
39425218589,39425218583,-6,1025,3873,40
39426113431,39426113415,-16,229,1101,40
39426389537,39426389531,-6,1147,4459,40
39430624338,39430624333,-5,675,3012,40
39431097303,39431097313,10,53,1043,40
39432112766,39432112759,-7,1065,4222,40
39433708278,39433708273,-5,647,3813,40
39436346777,39436346783,6,2546,1032,40
39454755958,39454755953,-5,1217,3885,40
39454993869,39454993890,21,174,646,40
39456109525,39456109520,-5,1584,4863,40
39463329375,39463329371,-4,1030,2730,40
39464248792,39464248786,-6,684,4055,40
39464306413,39464306431,18,445,1944,40
39475203344,39475203338,-6,967,3814,40
39477822764,39477822757,-7,1330,3046,40
39479149799,39479149798,-1,89,340,40
39487755410,39487755405,-5,778,3385,40
39487858855,39487858849,-6,1001,3988,40
39487949740,39487949744,4,166,1239,40
39488383830,39488383850,20,1010,1977,40
39488412493,39488412498,5,2082,1322,40
39489846539,39489846533,-6,615,2345,40
39491213524,39491213518,-6,1162,2919,40
39493807779,39493807777,-2,1186,2101,40
39503464890,39503464885,-5,1309,3326,40
39509574375,39509574370,-5,851,2295,40
39509993506,39509993499,-7,1116,5307,40
39510759173,39510759193,20,146,1035,40
39515530589,39515530589,0,1201,1581,40
39521382061,39521382057,-4,786,4355,40
39521802036,39521802056,20,113,1211,40
39525882266,39525882271,5,1648,1307,40
39527304167,39527304162,-5,966,2139,40
39533743060,39533743065,5,3220,1769,40
39535959811,39535959807,-4,1017,2870,40
39540544167,39540544161,-6,906,3880,40
39544368217,39544368207,-10,50,1301,40
39550864566,39550864559,-7,973,3521,40
39551711072,39551711089,17,203,1581,40
39554851787,39554851781,-6,1062,2861,40
39555003774,39555003783,9,159,1056,40
39561118507,39561118500,-7,808,4091,40
39563562043,39563562038,-5,924,3295,40
39567857504,39567857497,-7,1559,3898,40
39567992109,39567992103,-6,1187,4479,40
39574456487,39574456482,-5,730,2071,40
39585077088,39585077082,-6,1071,3435,40
39589476054,39589476050,-4,904,3270,40
39598029047,39598029041,-6,1416,3287,40
39600608289,39600608286,-3,1784,3131,40
39603480459,39603480453,-6,741,2603,40
39607829015,39607829009,-6,911,5194,40
39618040948,39618040943,-5,1084,3918,40
39622565139,39622565136,-3,359,2792,40
39623074186,39623074190,4,4241,2386,40
39624301126,39624301122,-4,1113,4931,40
39624854685,39624854695,10,275,1309,40
39629804636,39629804630,-6,1177,5035,40
39636805645,39636805640,-5,997,4368,40
39637947389,39637947385,-4,775,3257,40
39638041541,39638041561,20,1200,4258,40
39641752555,39641752549,-6,1178,2520,40
39649168309,39649168303,-6,540,2654,40
39649462623,39649462606,-17,36,765,40
39650546510,39650546531,21,529,3098,40
39653785360,39653785353,-7,1026,2816,40
39653952533,39653952528,-5,1239,3519,40
39656082511,39656082490,-21,319,1574,40
39661202534,39661202533,-1,1320,2791,40
39661911529,39661911523,-6,1504,3855,40
39664380078,39664380070,-8,1161,4180,40
39667568731,39667568726,-5,1133,2884,40
39668285600,39668285594,-6,1101,3390,40
39677335995,39677335999,4,1677,1336,40
39680967867,39680967862,-5,1159,4658,40
39682066319,39682066313,-6,749,2167,40
39692939103,39692939100,-3,921,2621,40
39697961010,39697961004,-6,1072,2781,40
39705651892,39705651887,-5,1517,3547,40
39709942397,39709942394,-3,1444,1601,40
39710255960,39710255962,2,272,1404,40
39710765110,39710765104,-6,787,2136,40
39714287406,39714287413,7,13643,5153,40
39715411844,39715411837,-7,669,3851,40
39718917262,39718917261,-1,947,1985,40
39721890302,39721890298,-4,1481,4600,40
39734698566,39734698561,-5,1254,2680,40
39736870059,39736870052,-7,901,4877,40
39737324754,39737324750,-4,2526,5537,40
39738220229,39738220226,-3,713,2661,40
39738371080,39738371075,-5,1026,3248,40
39743616662,39743616657,-5,1439,4055,40
39744774182,39744774178,-4,1159,2979,40
39746043528,39746043516,-12,934,4017,40
39752819855,39752819859,4,2081,1431,40
39763106691,39763106687,-4,864,3798,40
39777702954,39777702948,-6,1006,2797,40
39781952074,39781952067,-7,1064,2822,40
39785567138,39785567135,-3,1042,2448,40
39787777857,39787777851,-6,769,2532,40
39793149756,39793149750,-6,1491,4762,40
39793315658,39793315664,6,5060,3262,40
39796006805,39796006811,6,4710,1577,40
39802692079,39802692074,-5,776,3212,40
39807217110,39807217105,-5,979,3418,40
39810677557,39810677553,-4,643,2966,40
39818554990,39818554986,-4,955,3294,40
39822686277,39822686281,4,18363,22249,40
39825417299,39825417315,16,152,2569,40
39828396231,39828396229,-2,1069,2289,40
39828548318,39828548338,20,1233,4524,40
39836224898,39836224895,-3,1013,3083,40
39836293140,39836293127,-13,3825,14011,40
39841233069,39841233069,0,1147,2081,40
39842762977,39842762970,-7,772,3677,40
39842896100,39842896085,-15,94,1054,40
39843426432,39843426409,-23,221,1326,40
39847122266,39847122259,-7,1059,3380,40
39852295865,39852295858,-7,961,2667,40
39857782625,39857782619,-6,973,3179,40
39858870998,39858870994,-4,211,1229,40
39863740362,39863740355,-7,1390,4176,40
39867502374,39867502367,-7,902,2784,40
39869412549,39869412545,-4,749,2455,40
39870682913,39870682909,-4,661,2609,40
39871335828,39871335845,17,743,3635,40
39873128590,39873128586,-4,817,3539,40
39873947986,39873947982,-4,1134,2309,40
39875248753,39875248750,-3,926,1831,40
39875353797,39875353806,9,276,1162,40
39878069829,39878069823,-6,1136,4385,40
39878104227,39878104222,-5,946,3261,40
39878450110,39878450104,-6,719,3832,40
39884837755,39884837752,-3,2491,4914,40
39897987848,39897987842,-6,1005,3302,40
39898861955,39898861949,-6,1171,4230,40
39905734194,39905734203,9,73,1089,40
39907211996,39907211990,-6,836,2038,40
39908737934,39908737929,-5,863,3453,40
39910984617,39910984620,3,2083,1374,40
39915793406,39915793399,-7,1134,3087,40
39916948837,39916948849,12,93,1351,40
39917254678,39917254667,-11,36,1087,40
39924410286,39924410280,-6,1256,4486,40
39924763926,39924763930,4,127,1416,40
39927239090,39927239083,-7,1462,4407,40
39931026571,39931026565,-6,832,3077,40
39932053403,39932053396,-7,777,4283,40
39939708570,39939708576,6,2327,1611,40
39943430398,39943430393,-5,1202,3187,40
39944479941,39944479934,-7,1488,5010,40
39945526818,39945526813,-5,1340,3820,40
39946355141,39946355149,8,2634,1163,40
39949721845,39949721840,-5,1126,3319,40
39949770211,39949770207,-4,920,3054,40
39951160432,39951160430,-2,3135,4486,40
39968743134,39968743128,-6,1130,4109,40
39971705090,39971705085,-5,1287,4236,40
39971793140,39971793161,21,544,1637,40
39978513555,39978513549,-6,869,4121,40
39979448530,39979448525,-5,983,1470,40
39981133206,39981133202,-4,1331,5214,40
39989333395,39989333407,12,12249,28403,40
40003006354,40003006349,-5,1105,3878,40
40006402732,40006402749,17,654,3613,40
40009427122,40009427125,3,757,1453,40
40010785520,40010785514,-6,1020,3716,40
40011780535,40011780526,-9,10,1138,40
40015859886,40015859875,-11,416,1465,40
40038370238,40038370233,-5,1053,4540,40
40041952515,40041952508,-7,763,3294,40
40043813922,40043813918,-4,733,2646,40
40044867379,40044867387,8,4577,1574,40
40047316226,40047316218,-8,1046,3296,40
40047934209,40047934203,-6,1032,4401,40
40048399448,40048399446,-2,351,1721,40
40048667164,40048667185,21,942,3480,40
40049658164,40049658180,16,141,1183,40
40051719971,40051719963,-8,680,1877,40
40060118779,40060118774,-5,913,2161,40
40060231213,40060231206,-7,905,3106,40
40063945021,40063945016,-5,789,2269,40
40072736908,40072736904,-4,572,3498,40
40075379998,40075379993,-5,1052,4026,40
40075452467,40075452461,-6,1023,3116,40
40078717874,40078717879,5,1714,678,40
40078976579,40078976573,-6,832,1213,40
40080085333,40080085328,-5,908,3904,40
40083019742,40083019730,-12,115,1605,40
40084274651,40084274653,2,1618,1732,40
40086755331,40086755326,-5,839,3535,40
40087571640,40087571634,-6,1089,3648,40
40096931222,40096931217,-5,1074,4306,40
40101435552,40101435546,-6,937,3228,40
40101559995,40101559987,-8,743,3599,40
40104016028,40104016022,-6,1221,3498,40
40107319017,40107319022,5,3496,1376,40
40108429857,40108429852,-5,1084,3942,40
40110899785,40110899779,-6,912,3521,40
40111228317,40111228338,21,1104,4521,40
40130598026,40130598021,-5,1158,3336,40
40130790716,40130790732,16,363,1957,40
40132438837,40132438858,21,650,2584,40
40139355059,40139355054,-5,1372,2318,40
40141332973,40141332970,-3,940,1119,40
40141440767,40141440762,-5,774,3710,40
40141650407,40141650407,0,35,2155,40
40143200614,40143200605,-9,22793,16495,40
40153053262,40153053256,-6,1278,4875,40
40155813905,40155813902,-3,925,2116,40
40170338951,40170338953,2,1887,1517,40
40172296073,40172296066,-7,851,3525,40
40181051714,40181051709,-5,1117,2846,40
40186100686,40186100691,5,4540,2340,40
40205943274,40205943269,-5,1312,3601,40
40210759170,40210759166,-4,1036,3544,40
40210870798,40210870791,-7,1407,2825,40
40211738599,40211738606,7,2191,1269,40
40223518614,40223518607,-7,1092,4252,40
40226070911,40226070906,-5,423,2837,40
40239430563,40239430557,-6,1146,2885,40
40246150394,40246150386,-8,1169,4857,40
40249878959,40249878953,-6,1084,3796,40
40251430292,40251430287,-5,922,3258,40
40256388817,40256388811,-6,936,4098,40
40260397827,40260397819,-8,762,2277,40
40263588778,40263588771,-7,1266,5173,40
40265675675,40265675669,-6,1012,3717,40
40266589386,40266589381,-5,1012,3811,40
40267838262,40267838256,-6,964,2704,40
40268580402,40268580396,-6,759,3563,40
40270008950,40270008944,-6,848,3599,40
40270289745,40270289737,-8,1338,4706,40
40272525395,40272525396,1,1558,1431,40
40273782757,40273782763,6,1873,891,40
40280352166,40280352163,-3,1079,2505,40
40284608879,40284608885,6,1328,1055,40
40289690572,40289690578,6,4316,1399,40
40295074383,40295074377,-6,730,3359,40
40298851956,40298851949,-7,1090,2790,40
40307600292,40307600286,-6,1345,4515,40
40315231408,40315231402,-6,1468,5263,40
40315633304,40315633297,-7,888,4242,40
40322246258,40322246251,-7,796,5366,40
40329644870,40329644866,-4,677,2747,40
40331658286,40331658282,-4,1031,2383,40
40334468736,40334468730,-6,848,3844,40
40334971846,40334971865,19,513,2653,40
40342672953,40342672946,-7,967,3678,40
40342910341,40342910336,-5,817,3091,40
40343531639,40343531634,-5,1064,4151,40
40344055255,40344055248,-7,922,4990,40
40344732607,40344732610,3,8,1088,40
40350582199,40350582190,-9,1027,5530,40
40353003081,40353003076,-5,1109,4191,40
40354805210,40354805203,-7,604,2789,40
40358770076,40358770070,-6,743,2920,40
40366567042,40366567042,0,1355,2264,40
40366888514,40366888509,-5,802,3325,40
40384104750,40384104745,-5,1365,4145,40
40385717586,40385717579,-7,971,4365,40
40385781194,40385781185,-9,836,3305,40
40402250119,40402250124,5,2758,1941,40
40404965083,40404965083,0,2831,3416,40
40405248735,40405248727,-8,1070,4599,40
40406005046,40406005064,18,407,2246,40
40407140371,40407140362,-9,929,3517,40
40413912437,40413912431,-6,884,3818,40
40414068460,40414068453,-7,199,1578,40
40416921455,40416921451,-4,915,2993,40
40417429748,40417429730,-18,773,3459,40
40418329197,40418329190,-7,969,3153,40
40421769165,40421769159,-6,1458,4446,40
40425480623,40425480616,-7,934,3872,40
40430203653,40430203646,-7,1117,4426,40
40436099422,40436099418,-4,703,2603,40
40436437514,40436437509,-5,977,3253,40
40436649648,40436649661,13,1087,3519,40
40438018565,40438018558,-7,1304,3633,40
40449462190,40449462185,-5,925,2427,40
40451977934,40451977929,-5,644,3502,40
40452192814,40452192810,-4,960,3505,40
40452291862,40452291875,13,537,2971,40
40454170919,40454170914,-5,1005,5604,40
40459892631,40459892628,-3,991,2243,40
40461675190,40461675192,2,2206,1959,40
40471309881,40471309886,5,2613,1626,40
40473047055,40473047047,-8,1456,5275,40
40479011907,40479011902,-5,1170,2890,40
40479642410,40479642404,-6,978,2637,40
40480658242,40480658234,-8,794,4132,40
40481182519,40481182511,-8,39,1219,40
40483616430,40483616425,-5,956,4202,40
40487748187,40487748180,-7,851,4620,40
40489171313,40489171310,-3,1164,2633,40
40489468262,40489468277,15,229,1322,40
40494529949,40494529942,-7,672,3389,40
40495630903,40495630899,-4,260,1319,40
40515344290,40515344285,-5,743,3199,40
40534564602,40534564598,-4,1235,3585,40
40535699163,40535699167,4,3716,3397,40
40540398411,40540398405,-6,992,3515,40
40543359193,40543359185,-8,1380,3688,40
40544795050,40544795046,-4,992,2585,40
40546410462,40546410457,-5,1241,3113,40
40557526839,40557526834,-5,1274,5231,40
40560351184,40560351197,13,1062,5812,40
40561986346,40561986342,-4,732,3020,40
40563998246,40563998267,21,949,3297,40
40564098825,40564098819,-6,1140,3271,40
40569149195,40569149191,-4,979,1441,40
40570396808,40570396813,5,1687,1297,40
40573823841,40573823834,-7,1366,2495,40
40573921735,40573921731,-4,103,431,40
40576860851,40576860838,-13,186,1288,40
40576967862,40576967879,17,200,1467,40
40579411750,40579411766,16,429,1638,40
40580652840,40580652834,-6,1456,4479,40
40584137871,40584137866,-5,700,2458,40
40585999925,40585999919,-6,1324,4289,40
40589183930,40589183922,-8,808,3220,40
40591929929,40591929922,-7,1030,3406,40
40594600935,40594600930,-5,848,1864,40
40601112688,40601112681,-7,955,4298,40
40601630562,40601630556,-6,1222,3984,40
40601966677,40601966679,2,229,962,40
40606353375,40606353370,-5,911,2587,40
40609944631,40609944627,-4,1035,2042,40
40611860077,40611860072,-5,516,3475,40
40612978463,40612978462,-1,538,1250,40
40614325237,40614325231,-6,786,2247,40
40616390416,40616390435,19,1250,3302,40
40618192751,40618192744,-7,1082,4525,40
40618695595,40618695591,-4,1315,2514,40
40620056235,40620056231,-4,752,3344,40
40634266694,40634266693,-1,483,2656,40
40635365034,40635365015,-19,1999,538,40
40635413389,40635413385,-4,713,2567,40
40645246382,40645246383,1,1384,1587,40
40646787412,40646787406,-6,1289,3891,40
40647393430,40647393442,12,242,985,40
40652328645,40652328641,-4,927,2358,40
40652594254,40652594242,-12,936,3300,40
40662436126,40662436128,2,1035,1179,40
40663086782,40663086787,5,2533,1592,40
40668218346,40668218338,-8,1178,4857,40
40670033650,40670033642,-8,1232,5099,40
40673368658,40673368652,-6,1081,2986,40
40674945931,40674945927,-4,781,2302,40
40691410022,40691410028,6,2421,1660,40
40704248011,40704248005,-6,841,3804,40
40705582958,40705582978,20,562,1754,40
40710323989,40710323983,-6,1117,4184,40
40710836799,40710836816,17,747,2812,40
40712471890,40712471886,-4,924,4038,40
40718626138,40718626132,-6,1034,3228,40
40718662589,40718662605,16,871,3804,40
40720038807,40720038801,-6,673,3782,40
40720127173,40720127168,-5,1004,3699,40
40722224575,40722224566,-9,802,3985,40
40723522245,40723522242,-3,903,2261,40
40724477084,40724477074,-10,140,1189,40
40725795070,40725795064,-6,694,3591,40
40733230337,40733230333,-4,642,3013,40
40734540854,40734540833,-21,234,1406,40
40735898081,40735898087,6,3235,2135,40
40747961918,40747961914,-4,1181,2604,40
40748462334,40748462329,-5,1266,4088,40
40749513058,40749513053,-5,969,3195,40
40752447794,40752447785,-9,549,3531,40
40754624806,40754624798,-8,1619,5737,40
40758292084,40758292091,7,4530,1207,40
40761493057,40761493052,-5,845,3420,40
40763759826,40763759822,-4,1123,3167,40
40765039686,40765039681,-5,1331,3227,40
40767171866,40767171860,-6,1019,3320,40
40768731058,40768731050,-8,1087,3759,40
40769475331,40769475323,-8,806,5128,40
40770126315,40770126308,-7,1000,2934,40
40776260266,40776260268,2,1541,1598,40
40782140635,40782140630,-5,1169,3058,40
40782498060,40782498042,-18,171,1175,40
40784968991,40784968986,-5,1273,4297,40
40797067002,40797067013,11,10924,35228,40
40802754567,40802754561,-6,843,2326,40
40803446714,40803446706,-8,1106,5091,40
40811554571,40811554566,-5,662,3651,40
40811588239,40811588242,3,266,1861,40
40816292627,40816292621,-6,1296,3592,40
40816655624,40816655622,-2,1446,2525,40
40817634442,40817634450,8,13059,33062,40
40817792161,40817792157,-4,893,2820,40
40820148513,40820148519,6,2542,1254,40
40822640111,40822640105,-6,899,3773,40
40837984997,40837984991,-6,1147,3499,40
40839157662,40839157647,-15,79,1326,40
40844833909,40844833903,-6,1356,4345,40
40845136974,40845136968,-6,1106,5040,40
40845510090,40845510083,-7,775,3564,40
40849433601,40849433605,4,4266,2923,40
40852589742,40852589737,-5,992,3591,40
40853126791,40853126770,-21,99,1206,40
40854024604,40854024593,-11,770,2880,40
40855285975,40855285994,19,811,2284,40
40855341503,40855341503,0,249,891,40
40860580833,40860580827,-6,1005,2970,40
40865836326,40865836321,-5,1228,3365,40
40868099138,40868099133,-5,1037,3599,40
40871622217,40871622215,-2,1413,1694,40
40872952633,40872952638,5,2573,1226,40
40874434893,40874434888,-5,920,1923,40
40878517732,40878517750,18,346,1513,40
40880723687,40880723682,-5,1081,3188,40
40883222914,40883222910,-4,861,3367,40
40886873662,40886873657,-5,1136,3332,40
40889998888,40889998882,-6,1757,7513,40
40895352809,40895352804,-5,1018,3722,40
40896058867,40896058863,-4,1113,3571,40
40902633453,40902633446,-7,714,1828,40
40903381076,40903381059,-17,769,3676,40
40906970683,40906970678,-5,731,3576,40
40915999145,40915999139,-6,852,3898,40
40924952894,40924952889,-5,957,2637,40
40925540533,40925540522,-11,59,743,40
40925733571,40925733565,-6,1061,3308,40
40926016119,40926016120,1,215,502,40
40928864419,40928864413,-6,1058,4060,40
40931058092,40931058085,-7,785,3712,40
40933656570,40933656563,-7,1314,2871,40
40942777498,40942777494,-4,677,2736,40
40950306467,40950306464,-3,1565,2402,40
40960938711,40960938691,-20,810,4056,40
40961826353,40961826354,1,1411,1824,40
40966823893,40966823886,-7,719,2751,40
40970356523,40970356518,-5,906,3446,40
40971436839,40971436834,-5,1044,3064,40
40973033782,40973033776,-6,1110,2844,40
40975846918,40975846920,2,1672,2905,40
40986327422,40986327417,-5,941,3551,40
40990220881,40990220874,-7,609,4242,40
40990735464,40990735477,13,729,1933,40
40996895987,40996895982,-5,484,114,40
41006833370,41006833365,-5,585,2106,40
41007195597,41007195577,-20,218,1507,40
41008321282,41008321302,20,607,2566,40
41015583346,41015583339,-7,1567,4437,40
41017139217,41017139221,4,19514,25974,40
41022136113,41022136107,-6,976,2493,40
41033340390,41033340385,-5,1169,3357,40
41034438701,41034438723,22,555,3425,40
41041137821,41041137817,-4,1598,2932,40
41041286930,41041286925,-5,945,5262,40
41041825148,41041825148,0,33393,25018,40
41053319750,41053319744,-6,783,2464,40
41066217144,41066217138,-6,1802,5381,40
41067188422,41067188415,-7,1345,3080,40
41067325931,41067325925,-6,1203,5271,40
41069515084,41069515077,-7,970,4542,40
41070513111,41070513106,-5,1107,3210,40
41070613983,41070613989,6,233,786,40
41084438409,41084438405,-4,761,3590,40
41085165522,41085165514,-8,1020,2924,40
41090178698,41090178718,20,169,1450,40
41092195655,41092195651,-4,725,3083,40
41096014835,41096014829,-6,1154,3501,40
41096987631,41096987625,-6,862,4502,40
41100159967,41100159960,-7,821,3702,40
41109655599,41109655592,-7,870,3798,40
41110768043,41110768037,-6,926,3508,40
41126759711,41126759706,-5,1280,3631,40
41127493127,41127493111,-16,1068,3687,40
41128060085,41128060091,6,9493,4910,40
41132610474,41132610466,-8,993,3372,40
41133315382,41133315374,-8,959,3371,40
41133468284,41133468277,-7,846,3794,40
41142470577,41142470571,-6,1375,3819,40
41143729553,41143729536,-17,1379,770,40
41148898762,41148898757,-5,944,3034,40
41160344039,41160344033,-6,792,2746,40
41160373964,41160373981,17,883,3554,40
41164662327,41164662326,-1,1059,1891,40
41165645124,41165645118,-6,1335,4592,40
41170116844,41170116839,-5,1129,2791,40
41171295799,41171295794,-5,1017,3518,40
41172249516,41172249510,-6,1018,3905,40
41172532215,41172532210,-5,1123,4199,40
41176068258,41176068253,-5,921,2551,40
41177575750,41177575747,-3,948,2089,40
41177909565,41177909557,-8,151,714,40
41190400355,41190400347,-8,848,4212,40
41190453798,41190453818,20,944,4013,40
41192387190,41192387184,-6,1340,4158,40
41198768183,41198768178,-5,1461,3805,40
41200560078,41200560074,-4,2564,5097,40
41201100743,41201100738,-5,330,1273,40
41202367854,41202367849,-5,1002,4136,40
41218182326,41218182321,-5,1105,4572,40
41218431824,41218431818,-6,1666,4819,40
41220611232,41220611226,-6,950,4375,40
41225346850,41225346846,-4,1422,4290,40
41227155510,41227155504,-6,930,3882,40
41227705431,41227705425,-6,1155,4672,40
41232755051,41232755046,-5,688,3418,40
41234253987,41234253982,-5,481,2346,40
41234655382,41234655394,12,276,1294,40
41239729303,41239729298,-5,990,2240,40
41239953006,41239953013,7,79,1590,40
41240159292,41240159290,-2,304,1068,40
41242392892,41242392887,-5,677,3400,40
41243723900,41243723894,-6,1101,4927,40
41244321436,41244321429,-7,1081,2759,40
41244425669,41244425673,4,140,1800,40
41260931163,41260931167,4,3394,2113,40
41265630917,41265630911,-6,1117,3624,40
41266425005,41266425013,8,149,1048,40
41267044611,41267044605,-6,1253,5340,40
41267159640,41267159656,16,1057,3493,40
41267984631,41267984626,-5,1286,4996,40
41268553507,41268553499,-8,1066,3894,40
41273896386,41273896390,4,1780,1172,40
41277836326,41277836323,-3,1050,3257,40
41281899115,41281899108,-7,1078,4165,40
41288193543,41288193550,7,1971,1355,40
41289453658,41289453640,-18,200,1362,40
41293977851,41293977842,-9,921,3951,40
41296036979,41296036973,-6,405,1882,40
41298016862,41298016858,-4,544,1977,40
41298227124,41298227138,14,379,807,40
41298725672,41298725689,17,950,3704,40
41302736456,41302736450,-6,1299,3972,40
41309246904,41309246897,-7,1100,4470,40
41310123981,41310123985,4,232,1062,40
41322359973,41322359972,-1,2621,4812,40
41323481645,41323481639,-6,522,1793,40
41323730692,41323730683,-9,140,1094,40
41330309183,41330309189,6,2740,903,40
41331767686,41331767665,-21,999,3275,40
41341953139,41341953133,-6,868,3409,40
41352972305,41352972298,-7,1157,6489,40
41353036887,41353036875,-12,168,1124,40
41355726219,41355726213,-6,538,1881,40
41356720344,41356720337,-7,1204,4223,40
41357721161,41357721155,-6,849,3624,40
41359412777,41359412771,-6,964,2580,40
41360554710,41360554703,-7,1607,4809,40
41363585990,41363585983,-7,625,1678,40
41365623853,41365623837,-16,193,1361,40
41366104591,41366104586,-5,1176,5725,40
41373352110,41373352105,-5,1386,4239,40
41373983069,41373983065,-4,1265,4363,40
41374571744,41374571749,5,5235,2353,40
41374835830,41374835837,7,2957,1302,40
41375405842,41375405835,-7,1348,4437,40
41376041794,41376041790,-4,899,4018,40
41379310187,41379310181,-6,1083,3936,40
41384553929,41384553922,-7,1043,3811,40
41389756793,41389756787,-6,979,4207,40
41390022253,41390022270,17,918,3179,40
41394613590,41394613585,-5,602,2589,40
41403285183,41403285179,-4,804,2977,40
41409553602,41409553596,-6,1235,5640,40
41409614244,41409614266,22,1004,4004,40
41415406541,41415406537,-4,1044,3475,40
41416312742,41416312734,-8,1085,3079,40
41417033965,41417033986,21,235,1590,40
41426570690,41426570685,-5,818,2506,40
41431740515,41431740512,-3,1252,2536,40
41433245559,41433245554,-5,780,3231,40
41434181968,41434181962,-6,1083,3583,40
41441231385,41441231377,-8,915,4931,40
41444115925,41444115922,-3,1628,3322,40
41445936305,41445936300,-5,1015,2937,40
41446077303,41446077318,15,632,1291,40
41451638993,41451638990,-3,1523,3442,40
41453496989,41453496982,-7,1180,3030,40
41453768549,41453768533,-16,1360,4019,40
41454286544,41454286553,9,274,1585,40
41455846418,41455846413,-5,1044,4026,40
41459323295,41459323273,-22,1553,891,40
41464587814,41464587822,8,1730,1188,40
41472481135,41472481147,12,13770,47622,40
41472701469,41472701465,-4,745,1775,40
41473732199,41473732195,-4,913,3448,40
41474117746,41474117741,-5,2233,6734,40
41476776797,41476776794,-3,1126,2134,40
41484157387,41484157382,-5,1216,4801,40
41487764541,41487764537,-4,674,2216,40
41487842565,41487842550,-15,477,3208,40
41491418943,41491418951,8,9871,31608,40
41494092789,41494092790,1,172,738,40
41494808256,41494808257,1,1195,1439,40
41498633358,41498633354,-4,784,3172,40
41499020550,41499020536,-14,125,1477,40
41500948242,41500948239,-3,1370,4658,40
41502392171,41502392168,-3,1029,3867,40
41508151071,41508151065,-6,816,1539,40
41514862398,41514862393,-5,948,3148,40
41515020485,41515020489,4,2302,1421,40
41522514957,41522514955,-2,1268,1616,40
41522979344,41522979338,-6,900,3171,40
41524112022,41524112018,-4,939,2761,40
41526332223,41526332218,-5,719,4143,40
41531659403,41531659398,-5,838,3331,40
41534830666,41534830659,-7,719,2515,40
41534859247,41534859250,3,145,1187,40
41535203447,41535203441,-6,1001,3311,40
41535823084,41535823076,-8,1192,4529,40
41536299556,41536299570,14,424,1645,40
41538036026,41538036020,-6,1022,2852,40
41540756745,41540756743,-2,1029,2122,40
41557830603,41557830596,-7,852,2413,40
41558729751,41558729745,-6,652,3330,40
41560320111,41560320121,10,296,1195,40
41562884855,41562884849,-6,1103,3323,40
41566384368,41566384361,-7,1398,5121,40
41566764452,41566764468,16,164,1191,40
41573752969,41573752962,-7,692,3682,40
41578887610,41578887610,0,1158,2131,40
41580334419,41580334413,-6,695,1808,40
41585316719,41585316714,-5,1351,4120,40
41593098631,41593098626,-5,1033,2805,40
41602266121,41602266117,-4,979,3691,40
41608067058,41608067051,-7,753,3780,40
41608592266,41608592261,-5,1073,3611,40
41610152563,41610152572,9,3850,1746,40
41611739106,41611739099,-7,990,5345,40
41617428869,41617428863,-6,1425,4209,40
41620810345,41620810334,-11,857,6886,40
41622304350,41622304350,0,1261,1487,40
41626341156,41626341149,-7,907,3866,40
41629784469,41629784460,-9,865,3822,40
41631004146,41631004141,-5,1150,3666,40
41636733914,41636733919,5,2644,1388,40
41648364878,41648364873,-5,679,2491,40
41649851911,41649851905,-6,974,2692,40
41654232806,41654232809,3,15354,13437,40
41664318747,41664318739,-8,727,4205,40
41664583200,41664583207,7,99,773,40
41667968458,41667968454,-4,944,2685,40
41668971563,41668971560,-3,844,2326,40
41669897553,41669897545,-8,1120,4922,40
41672012755,41672012748,-7,1064,3022,40
41673513255,41673513249,-6,777,3124,40
41674546621,41674546643,22,261,2309,40
41675043142,41675043137,-5,745,2901,40
41678399589,41678399584,-5,904,3526,40
41681835657,41681835649,-8,1526,4172,40
41686978022,41686978023,1,6356,7495,40
41691122046,41691122040,-6,1131,4933,40
41693596746,41693596738,-8,1180,2950,40
41701026677,41701026670,-7,707,4033,40
41702871727,41702871705,-22,391,1233,40
41703057221,41703057210,-11,281,1296,40
41703862678,41703862671,-7,1102,4217,40
41705342817,41705342819,2,1251,1380,40
41705960574,41705960571,-3,983,3058,40
41707709468,41707709461,-7,1088,3624,40
41715959802,41715959794,-8,1267,4351,40
41717093556,41717093564,8,5419,2055,40
41719714606,41719714598,-8,1026,3898,40
41723507662,41723507658,-4,543,1823,40
41726552747,41726552742,-5,741,2570,40
41727524367,41727524362,-5,1002,3496,40
41729373310,41729373325,15,788,2038,40
41731094013,41731094016,3,2638,2055,40
41732870422,41732870415,-7,776,3951,40
41735452924,41735452917,-7,892,3031,40
41737219238,41737219230,-8,956,3666,40
41741734937,41741734930,-7,958,3485,40
41742150350,41742150367,17,225,1494,40
41744236193,41744236187,-6,1302,3963,40
41744854214,41744854192,-22,360,2662,40
41753742307,41753742308,1,1381,2016,40
41757468037,41757468036,-1,904,1597,40
41764229598,41764229594,-4,985,3336,40
41766899825,41766899821,-4,795,4198,40
41776611009,41776611003,-6,1559,4016,40
41776652552,41776652562,10,2,817,40
41778188282,41778188279,-3,699,1813,40
41782678850,41782678847,-3,1139,1824,40
41783359459,41783359453,-6,1202,3852,40
41784946344,41784946348,4,1482,1695,40
41788209058,41788209051,-7,1388,3920,40
41789740312,41789740312,0,1963,2852,40
41793778139,41793778134,-5,718,2854,40
41799881317,41799881322,5,1693,1405,40
41800435410,41800435403,-7,952,3538,40
41803684454,41803684450,-4,1033,2768,40
41804627566,41804627562,-4,966,3713,40
41806721049,41806721066,17,181,1623,40
41813983474,41813983474,0,2776,3538,40
41818351707,41818351702,-5,1224,3830,40
41829065078,41829065073,-5,1082,3851,40
41829672590,41829672607,17,1395,4100,40
41829798629,41829798650,21,930,4311,40
41832943718,41832943713,-5,1132,2338,40
41834133679,41834133674,-5,1389,3938,40
41866744193,41866744193,0,1155,1844,40
41868420626,41868420618,-8,852,5616,40
41870467570,41870467565,-5,1417,2724,40
41871808181,41871808173,-8,1018,3349,40
41873939923,41873939916,-7,977,4953,40
41876198174,41876198171,-3,760,2759,40
41880667029,41880667035,6,2280,924,40
41888140334,41888140330,-4,1027,3335,40
41888664614,41888664609,-5,143,1244,40
41894425082,41894425076,-6,980,4379,40
41899344386,41899344383,-3,725,1223,40
41900104760,41900104754,-6,571,3293,40
41900770541,41900770537,-4,1362,3665,40
41903922745,41903922739,-6,1002,3660,40
41912632470,41912632465,-5,1141,5966,40
41928673038,41928673051,13,679,3444,40
41928700256,41928700258,2,1630,1376,40
41934088919,41934088913,-6,1322,3711,40
41934340071,41934340065,-6,1124,3429,40
41936729613,41936729606,-7,1348,4581,40
41939097826,41939097825,-1,2454,3827,40
41940284157,41940284155,-2,741,2103,40
41943987350,41943987343,-7,1114,4142,40
41945413213,41945413229,16,308,1509,40
41947045532,41947045530,-2,1122,1379,40
41947771483,41947771478,-5,653,3140,40
41948250685,41948250698,13,152,1487,40
41953102649,41953102644,-5,1147,2281,40
41956314635,41956314631,-4,1148,3634,40
41960535918,41960535913,-5,39025,58318,40
41975274153,41975274145,-8,130,1304,40
41980054146,41980054141,-5,1119,4130,40
41981148371,41981148365,-6,1312,4599,40
41981671637,41981671659,22,243,1765,40
41982108759,41982108751,-8,1170,3120,40
41987837348,41987837351,3,1794,1743,40
41988840543,41988840542,-1,1694,2534,40
41991762466,41991762466,0,831,2452,40
41994026462,41994026458,-4,1462,3184,40
41996587317,41996587312,-5,2395,7054,40
42000457429,42000457422,-7,984,2016,40
42003919068,42003919062,-6,1116,3442,40
42008996017,42008996010,-7,1116,4099,40
42010597174,42010597152,-22,95,712,40
42011965002,42011964998,-4,1005,3551,40
42015717411,42015717405,-6,1261,4094,40
42016003097,42016003090,-7,1341,5444,40
42016125368,42016125361,-7,1067,4434,40
42026383071,42026383066,-5,993,3735,40
42026430037,42026430026,-11,125,788,40
42026978510,42026978522,12,260,829,40
42030862282,42030862276,-6,1247,2779,40
42031356940,42031356945,5,179,1293,40
42031691093,42031691109,16,128,1057,40
42036475593,42036475599,6,4561,2591,40
42036862074,42036862069,-5,1422,2677,40
42039296766,42039296757,-9,1282,5009,40
42045099362,42045099357,-5,1081,3300,40
42052476045,42052476038,-7,1009,3887,40
42057267184,42057267177,-7,545,2818,40
42057947080,42057947075,-5,1383,3413,40
42083196946,42083196939,-7,1278,4541,40
42085911635,42085911630,-5,1627,3231,40
42087642331,42087642325,-6,1023,4359,40
42091486175,42091486168,-7,1110,3381,40
42096993859,42096993853,-6,1444,5302,40
42100168269,42100168273,4,5528,2856,40
42103604437,42103604430,-7,885,3516,40
42104950675,42104950670,-5,1130,3337,40
42106979080,42106979073,-7,1176,4744,40
42107462092,42107462086,-6,1323,2474,40
42108257863,42108257870,7,1840,1292,40
42109949142,42109949150,8,5097,1843,40
42110258309,42110258302,-7,642,2878,40
42111344959,42111344953,-6,362,1417,40
42113075454,42113075449,-5,1118,3352,40
42115829600,42115829612,12,12714,46667,40
42126297899,42126297894,-5,1256,4100,40
42126810370,42126810377,7,4597,1567,40
42127069783,42127069791,8,5497,1400,40
42133933837,42133933844,7,14895,21681,40
42138910529,42138910545,16,1719,6549,40
42139860578,42139860574,-4,1039,2815,40
42143126859,42143126853,-6,806,3396,40
42144252092,42144252110,18,432,2402,40
42146055496,42146055493,-3,1377,3468,40
42146501197,42146501184,-13,1129,3802,40
42147591666,42147591661,-5,1184,3465,40
42147730339,42147730337,-2,1468,3250,40
42151497079,42151497073,-6,1065,3201,40
42151637980,42151637979,-1,94,1098,40
42153199853,42153199872,19,696,2308,40
42154210477,42154210478,1,1403,1858,40
42155211641,42155211634,-7,1148,2356,40
42159592993,42159592999,6,3668,1405,40
42169337049,42169337049,0,208,1041,40
42174611866,42174611871,5,2444,36220,40
42183383803,42183383798,-5,854,2966,40
42187651651,42187651645,-6,892,4495,40
42188222344,42188222363,19,1074,2919,40
42189604692,42189604686,-6,1060,4264,40
42193012485,42193012490,5,1617,1235,40
42193402355,42193402349,-6,1021,4418,40
42197316822,42197316817,-5,1313,5328,40
42206132686,42206132678,-8,1138,3968,40
42206351783,42206351786,3,202,1287,40
42214863613,42214863614,1,1800,1892,40
42215238067,42215238062,-5,1025,3579,40
42216234471,42216234466,-5,1161,3126,40
42217420096,42217420091,-5,1564,7060,40
42217940304,42217940314,10,959,4664,40
42227898955,42227898959,4,1727,1477,40
42229851215,42229851211,-4,908,2366,40
42230661719,42230661698,-21,361,1212,40
42232131891,42232131883,-8,1453,5822,40
42233237926,42233237921,-5,1121,4876,40
42235216158,42235216153,-5,810,2101,40
42236494458,42236494450,-8,763,3361,40
42243137349,42243137344,-5,877,3193,40
42249263839,42249263833,-6,949,2850,40
42257549718,42257549712,-6,999,3175,40
42259928983,42259928977,-6,1048,7982,40
42266845873,42266845868,-5,1146,4070,40
42276085545,42276085541,-4,831,3127,40
42276899165,42276899163,-2,148,1112,40
42278843072,42278843086,14,1103,3335,40
42289239697,42289239700,3,1645,1110,40
42291996722,42291996718,-4,769,3605,40
42297326551,42297326545,-6,681,2597,40
42298102780,42298102797,17,638,4052,40
42312181450,42312181445,-5,1023,3967,40
42318191146,42318191142,-4,688,1697,40
42321853222,42321853215,-7,1092,4536,40
42332300806,42332300803,-3,1437,2963,40
42340718859,42340718864,5,2121,1131,40
42340785666,42340785667,1,1178,1449,40
42350071751,42350071746,-5,1473,4301,40
42358535730,42358535725,-5,908,3098,40
42360424963,42360424957,-6,573,4400,40
42361178174,42361178170,-4,897,2770,40
42363554681,42363554674,-7,2885,12945,40
42364312170,42364312166,-4,965,2857,40
42366926347,42366926343,-4,683,3932,40
42367036319,42367036313,-6,1074,3882,40
42367573514,42367573519,5,2293,1539,40
42368440491,42368440486,-5,983,4479,40
42368598669,42368598688,19,445,2626,40
42368728431,42368728426,-5,880,3818,40
42369752715,42369752709,-6,869,3937,40
42375585350,42375585346,-4,1095,4707,40
42377609838,42377609831,-7,836,4234,40
42377917973,42377917966,-7,1017,3461,40
42386323344,42386323337,-7,938,3495,40
42387217126,42387217127,1,221,674,40
42392675509,42392675503,-6,1326,3626,40
42401882184,42401882179,-5,1374,2984,40
42413204634,42413204629,-5,840,4244,40
42413848336,42413848355,19,132,987,40
42416664331,42416664326,-5,717,2844,40
42425403273,42425403266,-7,780,2369,40
42425430222,42425430202,-20,136,1289,40
42428009938,42428009946,8,10628,26277,40
42428643263,42428643258,-5,1285,3768,40
42431198935,42431198930,-5,550,3255,40
42431276438,42431276431,-7,1135,3218,40
42432866655,42432866650,-5,969,4389,40
42438729587,42438729579,-8,726,4261,40
42441234718,42441234713,-5,689,1829,40
42456682922,42456682922,0,646,1438,40
42456738544,42456738537,-7,1111,3831,40
42463219822,42463219817,-5,1071,4079,40
42463940903,42463940895,-8,134,875,40
42468932390,42468932383,-7,1045,4947,40
42468986702,42468986722,20,1139,3018,40
42472381833,42472381827,-6,1561,5283,40
42473679405,42473679398,-7,1374,3926,40
42478754971,42478754967,-4,1979,5407,40
42482208941,42482208936,-5,1285,2743,40
42482734382,42482734376,-6,943,2858,40
42483065235,42483065226,-9,1275,4069,40
42484592685,42484592680,-5,1173,4853,40
42492756426,42492756421,-5,1080,4380,40
42493379413,42493379407,-6,1430,2830,40
42495630173,42495630166,-7,1358,3410,40
42498823030,42498823026,-4,492,1399,40
42502145150,42502145143,-7,863,4660,40
42502506961,42502506967,6,2924,1395,40
42508909990,42508909988,-2,1177,2389,40
42513055631,42513055630,-1,98959,32644,40
42516509309,42516509304,-5,1237,2486,40
42516941335,42516941325,-10,884,3721,40
42517169167,42517169150,-17,98,662,40
42519066730,42519066726,-4,1379,1667,40
42523078906,42523078899,-7,953,4190,40
42528487978,42528487972,-6,1435,4138,40
42529787357,42529787378,21,260,1214,40
42530930625,42530930625,0,1543,1380,40
42536216800,42536216804,4,11826,24588,40
42540483969,42540483974,5,2304,1649,40
42541682270,42541682264,-6,546,1728,40
42545227470,42545227466,-4,875,4278,40
42545704759,42545704774,15,1063,3685,40
42546705141,42546705135,-6,1427,4218,40
42548820882,42548820878,-4,782,3002,40
42549544838,42549544837,-1,172,1239,40
42550152204,42550152190,-14,1125,3724,40
42558470377,42558470370,-7,749,4013,40
42559189907,42559189902,-5,967,3761,40
42564067829,42564067822,-7,1021,3093,40
42565648158,42565648153,-5,797,3860,40
42577904038,42577904044,6,2061,1354,40
42580395904,42580395899,-5,1109,4702,40
42586482563,42586482557,-6,989,3441,40
42587152229,42587152213,-16,867,3762,40
42590092685,42590092678,-7,1477,6663,40
42591198020,42591198021,1,29633,31578,40
42591308557,42591308550,-7,1140,3795,40
42594926329,42594926326,-3,1026,1745,40
42595463326,42595463318,-8,962,2574,40
42601340649,42601340645,-4,736,3016,40
42602508219,42602508214,-5,755,3198,40
42603081261,42603081242,-19,192,1197,40
42603233493,42603233513,20,200,1305,40
42603664429,42603664430,1,53,1036,40
42606307344,42606307337,-7,1153,4203,40
42607054827,42607054821,-6,588,2373,40
42609576306,42609576299,-7,361,3754,40
42609766884,42609766880,-4,943,2453,40
42610095951,42610095941,-10,814,3120,40
42614322650,42614322646,-4,1148,3036,40
42614676200,42614676193,-7,996,3722,40
42614861980,42614861999,19,882,3950,40
42617966605,42617966600,-5,1322,4116,40
42620660621,42620660623,2,1628,1248,40
42621501871,42621501865,-6,660,3513,40
42626012254,42626012252,-2,797,2797,40
42626297204,42626297190,-14,42,1135,40
42631327005,42631327000,-5,1161,3589,40
42635131538,42635131533,-5,1026,3305,40
42636517762,42636517761,-1,1611,1704,40
42637106943,42637106938,-5,862,3630,40
42637403326,42637403325,-1,1460,1863,40
42637781673,42637781673,0,1326,1309,40
42643027722,42643027723,1,1429,2134,40
42644364909,42644364902,-7,978,3763,40
42652361647,42652361649,2,3135,2454,40
42673912343,42673912337,-6,567,1324,40
42675955861,42675955855,-6,1084,3919,40
42683435622,42683435629,7,5737,2392,40
42697219842,42697219835,-7,716,3102,40
42698338309,42698338307,-2,152,1079,40
42699867626,42699867621,-5,671,1733,40
42704869111,42704869107,-4,941,1080,40
42706770675,42706770669,-6,642,3539,40
42712142805,42712142798,-7,869,3526,40
42712642909,42712642904,-5,1008,3951,40
42713057941,42713057927,-14,872,2813,40
42713402845,42713402854,9,265,921,40
42718520529,42718520522,-7,1115,4034,40
42724129216,42724129210,-6,1048,4421,40
42725838722,42725838717,-5,1183,3284,40
42726229752,42726229755,3,276,1687,40
42726313870,42726313890,20,283,1155,40
42727293418,42727293409,-9,725,3990,40
42728171655,42728171658,3,1702,1040,40
42731862951,42731862957,6,3071,1729,40
42740994762,42740994765,3,1877,1985,40
42742048946,42742048941,-5,1019,2258,40
42742531346,42742531346,0,662,864,40
42744917970,42744917962,-8,1114,3748,40
42748667750,42748667745,-5,1260,4010,40
42751676871,42751676875,4,24256,27364,40
42752736541,42752736541,0,1280,1786,40
42760966105,42760966099,-6,746,2983,40
42763000510,42763000506,-4,1185,3960,40
42775611927,42775611922,-5,822,2308,40
42781267155,42781267150,-5,509,1300,40
42781434477,42781434494,17,197,1452,40
42792291872,42792291865,-7,1256,4142,40
42798226794,42798226790,-4,1055,2552,40
42809870039,42809870039,0,842,1562,40
42812701398,42812701392,-6,1101,2585,40
42816119580,42816119573,-7,1006,3521,40
42817994475,42817994470,-5,1177,3495,40
42818551481,42818551479,-2,1324,1715,40
42821515809,42821515808,-1,1750,2096,40
42822859828,42822859823,-5,871,3351,40
42824500269,42824500262,-7,1323,4530,40
42834627791,42834627786,-5,1410,5161,40
42837091684,42837091685,1,1761,1441,40
42842206155,42842206156,1,1067,1585,40
42843952623,42843952626,3,1987,1411,40
42845145279,42845145274,-5,794,3134,40
42854219138,42854219134,-4,904,2648,40
42857675397,42857675404,7,4633,2361,40
42860052774,42860052769,-5,1145,4773,40
42865162799,42865162793,-6,975,3383,40
42866585370,42866585365,-5,984,3778,40
42869156569,42869156564,-5,1145,3528,40
42869753185,42869753182,-3,522,1870,40
42870933103,42870933097,-6,868,2593,40
42871616311,42871616301,-10,716,2585,40
42875186434,42875186426,-8,1431,4782,40
42881370004,42881369997,-7,979,5018,40
42881985294,42881985277,-17,1420,4397,40
42882157782,42882157791,9,71,1491,40
42887860822,42887860818,-4,921,2342,40
42888983086,42888983082,-4,103,1565,40
42894497980,42894497987,7,2926,1161,40
42899416387,42899416381,-6,1676,4469,40
42908139351,42908139347,-4,505,2005,40
42909849335,42909849339,4,1561,342,40
42911626835,42911626830,-5,967,4139,40
42913926450,42913926445,-5,397,1686,40
42916264172,42916264184,12,498,3762,40
42916305703,42916305696,-7,931,3094,40
42931583472,42931583494,22,370,1178,40
42932411290,42932411285,-5,1689,4636,40
42932548514,42932548509,-5,1155,4020,40
42938194545,42938194560,15,350,2395,40
42941486405,42941486408,3,6968,31011,40
42946156407,42946156401,-6,1105,3017,40
42953882521,42953882515,-6,878,3366,40
42953925502,42953925516,14,1009,3447,40
42954008102,42954008116,14,492,3208,40
42958477011,42958477005,-6,1049,3748,40
42968364193,42968364189,-4,1151,2769,40
42968603474,42968603469,-5,728,2138,40
42971405906,42971405901,-5,645,4344,40
42971738278,42971738299,21,1093,3690,40
42973554686,42973554690,4,2240,1972,40
42976892777,42976892772,-5,849,3264,40
42976984862,42976984882,20,936,3655,40
42977675170,42977675163,-7,935,2672,40
42981008684,42981008688,4,4768,2545,40
42987052035,42987052030,-5,1433,2789,40
42990939350,42990939345,-5,817,2133,40
43001313253,43001313247,-6,1283,4448,40
43002634414,43002634418,4,3707,2985,40
43004088794,43004088786,-8,817,3545,40
43004860222,43004860217,-5,893,3483,40
43010361700,43010361694,-6,1462,3260,40
43015381728,43015381721,-7,1096,3848,40
43015503526,43015503546,20,502,2599,40
43022071508,43022071503,-5,11,687,40
43027306222,43027306215,-7,1004,5112,40
43027359749,43027359757,8,1847,842,40
43030472586,43030472586,0,1220,1300,40
43034401419,43034401414,-5,1350,5257,40
43039890233,43039890227,-6,1184,3667,40
43041246351,43041246345,-6,1228,3772,40
43041434868,43041434863,-5,1133,3349,40
43042298659,43042298654,-5,1400,3889,40
43049955523,43049955518,-5,743,2825,40
43050435461,43050435454,-7,1207,4131,40
43051394730,43051394725,-5,1350,3719,40
43059206057,43059206049,-8,671,2433,40
43062657674,43062657671,-3,1347,3313,40
43067521623,43067521620,-3,1308,2014,40
43078413869,43078413863,-6,1138,3247,40
43093947881,43093947884,3,1855,1171,40
43094716739,43094716733,-6,1128,5115,40
43094793310,43094793311,1,1349,1667,40
43095960867,43095960859,-8,873,3796,40
43096982190,43096982185,-5,1402,2547,40
43101197671,43101197666,-5,1078,3486,40
43101499178,43101499180,2,1703,1672,40
43103096382,43103096377,-5,1213,3644,40
43103905492,43103905508,16,712,3055,40
43121073980,43121073974,-6,1025,2933,40
43125783592,43125783587,-5,1228,3198,40
43127002659,43127002654,-5,1240,3957,40
43128489314,43128489309,-5,852,2987,40
43128953282,43128953277,-5,900,4084,40
43142436742,43142436741,-1,1447,2070,40
43147545321,43147545343,22,54,585,40
43147917080,43147917074,-6,107,1220,40
43150625954,43150625949,-5,1270,3000,40
43150954018,43150954014,-4,791,3264,40
43151053852,43151053846,-6,2188,5332,40
43151798705,43151798700,-5,1078,4330,40
43152011850,43152011854,4,3082,1813,40
43152455102,43152455098,-4,972,2587,40
43152821125,43152821110,-15,90,1320,40
43157987555,43157987548,-7,1197,3935,40
43169478475,43169478469,-6,1072,4484,40
43174117548,43174117541,-7,1025,3979,40
43174476855,43174476871,16,506,2505,40
43178099653,43178099646,-7,1250,3791,40
43182234134,43182234136,2,1847,1854,40
43185092918,43185092913,-5,551,1681,40
43187044618,43187044614,-4,1487,4109,40
43190512034,43190512030,-4,991,2639,40
43190930191,43190930185,-6,797,3596,40
43196185095,43196185089,-6,1254,4330,40
43206295462,43206295458,-4,1044,3864,40
43211581823,43211581817,-6,1321,3677,40
43220408682,43220408676,-6,854,3385,40
43220502829,43220502839,10,86,1244,40
43222370870,43222370865,-5,682,2389,40
43224106958,43224106953,-5,1081,3203,40
43227513235,43227513230,-5,1188,5689,40
43234669855,43234669851,-4,1883,5166,40
43239264855,43239264849,-6,1386,4584,40
43241792915,43241792909,-6,841,3554,40
43243560422,43243560418,-4,999,2869,40
43247499137,43247499125,-12,967,3774,40
43249283268,43249283254,-14,186,811,40
43255190964,43255190958,-6,745,3069,40
43259701897,43259701891,-6,934,3568,40
43259782799,43259782814,15,127,748,40
43261394191,43261394188,-3,777,2144,40
43261426328,43261426346,18,1415,2943,40
43273263515,43273263509,-6,1117,3994,40
43274348899,43274348895,-4,772,4950,40
43276899662,43276899656,-6,1042,2552,40
43280564696,43280564690,-6,1126,5271,40
43282945576,43282945570,-6,1197,3659,40
43287739654,43287739649,-5,1188,3653,40
43295890678,43295890678,0,267,1265,40
43296635967,43296635960,-7,1147,4433,40
43298026311,43298026306,-5,1276,3895,40
43302414751,43302414745,-6,1023,3839,40
43302509093,43302509073,-20,835,3315,40
43306780178,43306780182,4,1961,2763,40
43325564687,43325564694,7,7369,1770,40
43332836166,43332836159,-7,1989,3610,40
43338104938,43338104932,-6,1163,3322,40
43341098356,43341098350,-6,1324,3966,40
43343010038,43343010030,-8,236,1040,40
43345297916,43345297912,-4,1434,3982,40
43345421205,43345421187,-18,65,867,40
43349322098,43349322093,-5,997,2746,40
43351748454,43351748461,7,9729,1487,40
43358784076,43358784075,-1,1663,2774,40
43359867753,43359867747,-6,1185,3487,40
43364590197,43364590191,-6,1378,3312,40
43368452278,43368452261,-17,1136,480,40
43375305297,43375305302,5,3967,1475,40
43380296526,43380296521,-5,1225,3324,40
43384132638,43384132636,-2,1564,2382,40
43386607095,43386607089,-6,1016,2293,40
43387716115,43387716110,-5,1592,3945,40
43387895462,43387895457,-5,1029,3459,40
43391806211,43391806206,-5,1078,3496,40
43393180301,43393180306,5,2153,1400,40
43394684891,43394684893,2,2839,1825,40
43395816179,43395816174,-5,622,3442,40
43402296808,43402296801,-7,1343,3965,40
43402381549,43402381542,-7,185,1214,40
43407143617,43407143610,-7,1168,5516,40
43410187419,43410187413,-6,836,3262,40
43415431994,43415431988,-6,877,3243,40
43417074162,43417074157,-5,599,1943,40
43417387815,43417387822,7,241,973,40
43417664258,43417664252,-6,1456,4850,40
43418986126,43418986119,-7,923,4744,40
43419274318,43419274313,-5,1260,3463,40
43422360582,43422360577,-5,971,3497,40
43429577178,43429577173,-5,1032,2528,40
43430360258,43430360253,-5,1061,3082,40
43430754932,43430754950,18,148,577,40
43437798950,43437798948,-2,1109,2542,40
43448692378,43448692382,4,1813,1188,40
43449171167,43449171160,-7,759,1914,40
43449349414,43449349403,-11,71,686,40
43449462862,43449462882,20,1126,4651,40
43460085414,43460085407,-7,1326,4363,40
43462280770,43462280765,-5,1068,3678,40
43462339735,43462339739,4,1888,1420,40
43462433053,43462433045,-8,978,4977,40
43464668640,43464668646,6,5656,23160,40
43467456591,43467456586,-5,658,2669,40
43468350974,43468350969,-5,859,4984,40
43468868532,43468868549,17,211,1115,40
43475836055,43475836049,-6,1179,5070,40
43489921693,43489921687,-6,1072,3230,40
43490152321,43490152315,-6,877,4044,40
43491148437,43491148430,-7,1102,3978,40
43494091622,43494091617,-5,1204,5207,40
43500242174,43500242170,-4,898,2376,40
43500353124,43500353112,-12,41,1137,40
43519327164,43519327176,12,807,5302,40
43520905183,43520905180,-3,1433,2771,40
43527995534,43527995529,-5,965,2698,40
43528326571,43528326562,-9,939,3984,40
43534481311,43534481306,-5,969,3925,40
43534947098,43534947105,7,4107,1806,40
43535335734,43535335732,-2,599,1848,40
43544428130,43544428133,3,2823,2451,40
43548176458,43548176451,-7,942,5132,40
43553114171,43553114168,-3,1193,3021,40
43555316515,43555316510,-5,459,2519,40
43556198395,43556198390,-5,1002,4474,40
43566101675,43566101670,-5,856,3130,40
43568206007,43568206002,-5,768,2858,40
43579719934,43579719929,-5,1129,5291,40
43582154257,43582154252,-5,824,2950,40
43587513322,43587513314,-8,1190,4484,40
43595314348,43595314353,5,23839,24813,40
43600381698,43600381699,1,1736,3266,40
43602476977,43602476972,-5,979,2855,40
43602975526,43602975514,-12,357,942,40
43605952286,43605952271,-15,1239,18112,40
43608262558,43608262562,4,2782,2131,40
43616990883,43616990878,-5,975,3366,40
43619680972,43619680965,-7,765,4530,40
43622103650,43622103644,-6,648,3217,40
43622970792,43622970800,8,221,834,40
43624129633,43624129627,-6,1339,4566,40
43632706949,43632706941,-8,816,5812,40
43637591120,43637591125,5,2521,1104,40
43650596846,43650596838,-8,1087,3837,40
43650640500,43650640513,13,493,2058,40
43655338972,43655338966,-6,1212,2881,40
43655462261,43655462277,16,473,3370,40
43660295215,43660295212,-3,1163,4706,40
43678359905,43678359897,-8,981,3553,40
43679017863,43679017878,15,727,4209,40
43679332995,43679332995,0,1287,1897,40
43681274369,43681274362,-7,940,3900,40
43693155684,43693155678,-6,646,3544,40
43693237984,43693237998,14,829,3866,40
43709218992,43709218994,2,2269,2515,40
43727968373,43727968365,-8,931,3997,40
43729973721,43729973725,4,1785,1380,40
43740524735,43740524728,-7,1337,4607,40
43749072894,43749072886,-8,868,3907,40
43753483901,43753483894,-7,854,3044,40
43763766519,43763766538,19,2391,1516,40
43772587067,43772587062,-5,896,2615,40
43775665555,43775665549,-6,833,4128,40
43778792801,43778792795,-6,1065,3312,40
43779345159,43779345154,-5,1603,3686,40
43779426409,43779426405,-4,627,4114,40
43780049278,43780049271,-7,163,1314,40
43780717081,43780717081,0,2520,3335,40
43784026599,43784026600,1,15216,1844,40
43788578926,43788578921,-5,1557,3324,40
43789989777,43789989777,0,3332,4486,40
43795823022,43795823018,-4,1022,3629,40
43796784358,43796784353,-5,1600,4282,40
43808176106,43808176102,-4,1093,3054,40
43810102889,43810102883,-6,733,2840,40
43824553678,43824553675,-3,1374,2094,40
43825337471,43825337466,-5,1068,3702,40
43830314451,43830314448,-3,830,1576,40
43830734613,43830734628,15,353,2123,40
43837355638,43837355639,1,1372,2116,40
43838111886,43838111881,-5,902,3046,40
43840771507,43840771503,-4,1573,4592,40
43848028489,43848028483,-6,812,1188,40
43855315009,43855315003,-6,1290,3837,40
43855945851,43855945845,-6,1555,3991,40
43861608527,43861608521,-6,1149,3888,40
43866166695,43866166690,-5,494,2784,40
43867785477,43867785469,-8,875,3742,40
43867891152,43867891170,18,120,1904,40
43868392695,43868392698,3,113,601,40
43869692126,43869692118,-8,1046,3604,40
43870766590,43870766585,-5,1223,4165,40
43875415630,43875415625,-5,660,2641,40
43883353609,43883353602,-7,1289,3996,40
43901181664,43901181657,-7,888,3280,40
43901308105,43901308102,-3,347,1962,40
43901721562,43901721558,-4,1207,4396,40
43910271982,43910271978,-4,725,2614,40
43926100550,43926100543,-7,1031,3775,40
43936218203,43936218198,-5,940,2271,40
43942252873,43942252867,-6,738,3420,40
43950169092,43950169085,-7,991,3379,40
43954662553,43954662563,10,9921,38617,40
43964374038,43964374043,5,2298,1823,40
43966709671,43966709664,-7,1303,3562,40
43975935534,43975935529,-5,1219,4217,40
43981145014,43981145020,6,4246,1656,40
43986323873,43986323871,-2,1580,1836,40
43987045633,43987045629,-4,1263,3951,40
43994679211,43994679204,-7,567,4120,40
43995151587,43995151581,-6,1140,3934,40
43997821658,43997821655,-3,527,3416,40
43999268049,43999268042,-7,1067,3373,40
43999523144,43999523162,18,329,1551,40
44003754568,44003754561,-7,926,3786,40
44009077578,44009077574,-4,997,3637,40
44009288174,44009288177,3,3999,2516,40
44011539558,44011539552,-6,858,4076,40
44012350156,44012350138,-18,257,1136,40
44014023230,44014023222,-8,1297,2878,40
44019474130,44019474109,-21,2405,636,40
44020088893,44020088887,-6,1295,4089,40
44021607508,44021607506,-2,1895,2661,40
44021676748,44021676742,-6,752,4899,40
44024125083,44024125077,-6,1192,3941,40
44038423485,44038423485,0,417,59,40
44046110745,44046110738,-7,541,2958,40
44049088054,44049088049,-5,705,3156,40
44059279962,44059279956,-6,827,3048,40
44059555213,44059555223,10,155,947,40
44059976924,44059976946,22,950,3962,40
44069415606,44069415599,-7,1027,4589,40
44069637881,44069637877,-4,998,2488,40
44080344011,44080344012,1,1187,1430,40
44085635407,44085635398,-9,835,2987,40
44091696214,44091696207,-7,1220,4799,40
44097598669,44097598665,-4,1111,3392,40
44110629186,44110629182,-4,679,1582,40
44111125261,44111125282,21,483,2395,40
44111531070,44111531057,-13,1001,3179,40
44112698214,44112698193,-21,126,1898,40
44113444924,44113444911,-13,335,1146,40
44114152226,44114152221,-5,969,5696,40
44116657771,44116657766,-5,784,4175,40
44118960228,44118960224,-4,860,2637,40
44129140633,44129140626,-7,887,3970,40
44131594511,44131594519,8,295,1488,40
44135622403,44135622398,-5,759,2243,40
44136107798,44136107818,20,942,4067,40
44144099046,44144099041,-5,1159,4614,40
44146182677,44146182671,-6,759,3548,40
44146868957,44146868972,15,250,1052,40
44147983750,44147983770,20,649,1780,40
44159628734,44159628737,3,1465,1196,40
44161524974,44161524969,-5,801,2949,40
44163390729,44163390729,0,1452,2179,40
44166884501,44166884496,-5,999,2208,40
44171540074,44171540069,-5,1214,4440,40
44173701339,44173701334,-5,2013,6913,40
44174874218,44174874200,-18,2089,1296,40
44175685995,44175685988,-7,880,3228,40
44176556160,44176556171,11,992,3398,40
44177749011,44177749007,-4,926,2355,40
44188724334,44188724340,6,2572,1467,40
44195961189,44195961190,1,2449,3125,40
44205361170,44205361165,-5,1035,1821,40
44206205653,44206205658,5,2075,1415,40
44209576609,44209576613,4,1875,1438,40
44210992637,44210992632,-5,1157,4330,40
44215271450,44215271444,-6,801,3466,40
44234346239,44234346234,-5,891,2967,40
44238870694,44238870694,0,11744,13111,40
44241702926,44241702921,-5,1600,5399,40
44241762265,44241762259,-6,870,2970,40
44244943381,44244943377,-4,691,2675,40
44245280323,44245280317,-6,1007,4372,40
44245698900,44245698890,-10,89,743,40
44246082253,44246082267,14,142,1428,40
44256388388,44256388370,-18,4369,3142,40
44270362338,44270362332,-6,1323,4555,40
44272097959,44272097953,-6,528,1597,40
44275087711,44275087706,-5,1112,3570,40
44275386632,44275386650,18,589,1938,40
44276364470,44276364467,-3,7629,38571,40
44280519979,44280519985,6,4136,2207,40
44289509180,44289509181,1,4163,17184,40
44301657181,44301657175,-6,1118,4255,40
44303288691,44303288685,-6,848,3806,40
44306870621,44306870614,-7,704,3449,40
44306915525,44306915542,17,399,3378,40
44307981845,44307981840,-5,1096,4333,40
44310926703,44310926697,-6,1078,3230,40
44311504408,44311504426,18,591,4180,40
44318747710,44318747704,-6,1057,4532,40
44318946127,44318946122,-5,933,2408,40
44321064101,44321064094,-7,1278,3965,40
44325147537,44325147530,-7,772,4792,40
44331072383,44331072383,0,5621,7907,40
44331986827,44331986822,-5,1149,3105,40
44333567827,44333567820,-7,818,2430,40
44334875767,44334875785,18,1198,3517,40
44338507979,44338507986,7,154,1146,40
44343227430,44343227429,-1,1226,1225,40
44344967917,44344967914,-3,2728,5691,40
44345400862,44345400857,-5,1119,4014,40
44347115719,44347115713,-6,766,3656,40
44348804131,44348804135,4,2299,962,40
44353039723,44353039720,-3,1008,1975,40
44358971109,44358971103,-6,922,2994,40
44370802907,44370802901,-6,815,2284,40
44371364380,44371364387,7,313,1425,40
44375668838,44375668830,-8,826,3311,40
44380925222,44380925217,-5,1226,3381,40
44382536905,44382536899,-6,1182,5343,40
44385171971,44385171968,-3,30975,17807,40
44386653554,44386653558,4,1693,1373,40
44395654640,44395654634,-6,1005,3910,40
44398080871,44398080866,-5,1029,3799,40
44407541128,44407541131,3,1725,867,40
44409521354,44409521350,-4,1613,4776,40
44413119675,44413119669,-6,849,2344,40
44416839107,44416839101,-6,817,3170,40
44417263398,44417263419,21,1068,3902,40
44417504549,44417504543,-6,898,3145,40
44417860543,44417860561,18,481,2198,40
44418974747,44418974749,2,1520,1424,40
44421466156,44421466150,-6,976,2414,40
44426100804,44426100827,23,188,927,40
44429248162,44429248157,-5,2010,6803,40
44444988461,44444988468,7,4832,1624,40
44449699442,44449699437,-5,651,1883,40
44452315242,44452315229,-13,574,2966,40
44452754798,44452754777,-21,85,1182,40
44454760222,44454760215,-7,891,4248,40
44468911126,44468911122,-4,1223,4732,40
44469178990,44469179007,17,187,988,40
44470354313,44470354316,3,1758,1512,40
44482296767,44482296761,-6,1406,3905,40
44482405942,44482405949,7,45,1286,40
44492202551,44492202547,-4,1028,3159,40
44499830742,44499830738,-4,1132,3625,40
44501214920,44501214913,-7,1315,4366,40
44501786235,44501786230,-5,1109,3654,40
44511559322,44511559317,-5,574,2500,40
44511646286,44511646283,-3,1220,2874,40
44512057018,44512057026,8,2301,1312,40
44516452359,44516452358,-1,21775,41631,40
44524825170,44524825165,-5,1208,3966,40
44525028280,44525028294,14,249,1782,40
44534878723,44534878718,-5,1234,4762,40
44536756089,44536756085,-4,995,2480,40
44538079331,44538079333,2,1162,1256,40
44545800673,44545800670,-3,1100,2469,40
44547006559,44547006551,-8,846,3430,40
44548074242,44548074247,5,2081,996,40
44548268297,44548268292,-5,1712,5370,40
44549686515,44549686519,4,2028,1635,40
44550441520,44550441541,21,1046,3485,40
44556832721,44556832716,-5,906,3449,40
44560969558,44560969554,-4,1010,3444,40
44563934323,44563934317,-6,1115,4960,40
44571557775,44571557770,-5,931,3876,40
44574919622,44574919618,-4,737,2539,40
44576018683,44576018687,4,145,807,40
44576437077,44576437062,-15,270,2522,40
44582393748,44582393742,-6,1231,4015,40
44582479262,44582479265,3,232,1281,40
44583282757,44583282762,5,3485,1801,40
44588455723,44588455723,0,920,1744,40
44588811516,44588811538,22,320,1395,40
44589522567,44589522565,-2,1580,4117,40
44602929373,44602929366,-7,1343,4599,40
44604874896,44604874890,-6,999,3614,40
44612140038,44612140046,8,3756,1532,40
44614186886,44614186880,-6,1295,4908,40
44616200798,44616200792,-6,556,2470,40
44617278459,44617278453,-6,1126,4318,40
44622509997,44622510005,8,4848,1749,40
44626241262,44626241262,0,1259,1513,40
44626793372,44626793369,-3,2795,4807,40
44628704600,44628704594,-6,1029,4628,40
44628938188,44628938197,9,383,1008,40
44631961498,44631961493,-5,848,2754,40
44632730287,44632730294,7,296,1682,40
44633012047,44633012041,-6,2094,8199,40
44635246169,44635246164,-5,786,3742,40
44637243187,44637243182,-5,1098,4247,40
44640695455,44640695451,-4,1415,4110,40
44644931442,44644931423,-19,1085,3399,40
44645932507,44645932502,-5,934,2982,40
44652884822,44652884818,-4,947,3355,40
44655502683,44655502683,0,1138,1764,40
44658551840,44658551833,-7,1118,3939,40
44661799947,44661799941,-6,1284,2676,40
44664664802,44664664797,-5,1135,3742,40
44671079547,44671079549,2,1326,1438,40
44672082045,44672082041,-4,1187,3117,40
44673351750,44673351749,-1,982,2272,40
44676307903,44676307898,-5,706,1799,40
44676798774,44676798761,-13,950,3121,40
44677487555,44677487549,-6,1022,4322,40
44685533253,44685533247,-6,1258,4114,40
44687759424,44687759417,-7,1120,3786,40
44688958971,44688958966,-5,731,1819,40
44689709759,44689709776,17,480,1735,40
44690658372,44690658373,1,1189,1682,40
44691051277,44691051272,-5,2299,5574,40
44692910986,44692910986,0,1352,1171,40
44693845566,44693845558,-8,894,2457,40
44697762239,44697762232,-7,1568,6074,40
44704136471,44704136466,-5,931,2554,40
44705201710,44705201726,16,223,592,40
44706250435,44706250430,-5,1233,3410,40
44710503132,44710503125,-7,1057,3066,40
44721241996,44721241992,-4,1322,3781,40
44721760085,44721760078,-7,159,1299,40
44724265003,44724264997,-6,508,2263,40
44731106706,44731106700,-6,935,2853,40
44733353065,44733353060,-5,1148,4227,40
44734647121,44734647114,-7,882,3960,40
44738555801,44738555795,-6,1272,4501,40
44738619612,44738619610,-2,198,1309,40
44741750754,44741750748,-6,866,2747,40
44745508826,44745508823,-3,1068,4427,40
44748316166,44748316162,-4,1366,4113,40
44750796502,44750796495,-7,1010,4027,40
44759650562,44759650556,-6,1249,4075,40
44762358219,44762358213,-6,496,1761,40
44762586198,44762586194,-4,1109,4153,40
44763301539,44763301533,-6,1288,3915,40
44763386983,44763386975,-8,985,4911,40
44764413100,44764413096,-4,737,3000,40
44765960405,44765960390,-15,116,995,40
44766701470,44766701465,-5,1087,4137,40
44767833809,44767833803,-6,1912,3416,40
44769353163,44769353143,-20,1061,907,40
44771031251,44771031245,-6,1019,2895,40
44771897847,44771897841,-6,854,3689,40
44772676108,44772676104,-4,24673,18003,40
44775148727,44775148722,-5,972,2070,40
44775773040,44775773057,17,765,2667,40
44779522890,44779522895,5,4675,2496,40
44779768797,44779768803,6,3330,1707,40
44780139378,44780139372,-6,1272,5126,40
44782123246,44782123242,-4,104,1236,40
44790906214,44790906215,1,3907,3113,40
44791212700,44791212694,-6,1177,4633,40
44792955197,44792955191,-6,1074,3332,40
44799885574,44799885577,3,2096,1853,40
44800955986,44800955981,-5,471,2502,40
44805945404,44805945397,-7,1072,4318,40
44806662120,44806662135,15,461,2117,40
44814553517,44814553517,0,11021,13823,40
44816586086,44816586081,-5,767,3255,40
44817459774,44817459770,-4,1109,1998,40
44854262995,44854262987,-8,1011,5249,40
44861752985,44861752982,-3,2698,5422,40
44865104377,44865104383,6,2366,843,40
44866684302,44866684296,-6,906,3338,40
44868658170,44868658172,2,1167,1398,40
44869368362,44869368357,-5,582,1956,40
44869687342,44869687326,-16,965,3584,40
44870902926,44870902922,-4,930,1651,40
44871234961,44871234954,-7,983,2332,40
44871506228,44871506215,-13,172,1593,40
44871618524,44871618545,21,954,4083,40
44872098098,44872098091,-7,1108,2410,40
44872506530,44872506525,-5,850,3787,40
44873130692,44873130675,-17,278,973,40
44877950181,44877950173,-8,967,3340,40
44881538274,44881538267,-7,1451,4158,40
44886094911,44886094904,-7,737,3594,40
44889753942,44889753934,-8,1045,4844,40
44890184546,44890184540,-6,1023,3269,40
44899626106,44899626099,-7,893,2814,40
44903911459,44903911461,2,1850,3426,40
44904611302,44904611298,-4,809,2520,40
44907404270,44907404263,-7,767,2554,40
44910359081,44910359077,-4,1048,3080,40
44911208655,44911208647,-8,346,1504,40
44915325171,44915325165,-6,1029,2715,40
44915449234,44915449229,-5,1045,3917,40
44924799602,44924799598,-4,1373,3582,40
44924926199,44924926177,-22,991,4049,40
44932309275,44932309270,-5,1201,3235,40
44934634894,44934634889,-5,1039,3220,40
44937005322,44937005318,-4,720,2667,40
44941203125,44941203118,-7,1069,2916,40
44941501518,44941501497,-21,1123,2398,40
44946363977,44946363980,3,186,2082,40
44957148085,44957148079,-6,965,3573,40
44957238626,44957238621,-5,698,2328,40
44961191521,44961191516,-5,888,250,40
44969775418,44969775412,-6,987,2126,40
44990456075,44990456057,-18,2042,1361,40
44994608167,44994608161,-6,1469,5064,40
44997336816,44997336810,-6,868,3500,40
45000091127,45000091131,4,239,1022,40
45006134259,45006134257,-2,1239,2236,40
45006211701,45006211713,12,303,1068,40
45011312851,45011312846,-5,1198,4728,40
45011941000,45011941019,19,1100,3994,40
45015170905,45015170898,-7,861,3175,40
45018357341,45018357334,-7,1050,5704,40
45020793815,45020793809,-6,1854,4332,40
45022638739,45022638734,-5,1257,3964,40
45022763269,45022763268,-1,1249,1737,40
45034264118,45034264114,-4,1086,3750,40
45034400652,45034400669,17,439,3338,40
45036300322,45036300305,-17,2810,508,40
45040649298,45040649292,-6,1192,5717,40
45051388622,45051388617,-5,861,2992,40
45054679693,45054679691,-2,2717,5439,40
45058093293,45058093286,-7,1127,3458,40
45066501237,45066501226,-11,406,1026,40
45066788934,45066788940,6,1430,1100,40
45068264058,45068264063,5,1815,1107,40
45075288297,45075288290,-7,1148,4825,40
45075544784,45075544799,15,611,2205,40
45078258691,45078258687,-4,22945,11552,40
45078380179,45078380174,-5,398,1974,40
45080301578,45080301571,-7,782,2500,40
45087064504,45087064517,13,77,1040,40
45092239902,45092239898,-4,970,3547,40
45113061171,45113061168,-3,1101,4786,40
45124994770,45124994766,-4,1089,3887,40
45130250295,45130250275,-20,385,1139,40
45133039508,45133039503,-5,1063,3897,40
45133670871,45133670866,-5,661,2929,40
45134119216,45134119230,14,320,1418,40
45135812564,45135812570,6,3845,1373,40
45137339490,45137339484,-6,1193,5028,40
45146863075,45146863067,-8,1077,4379,40
45147130454,45147130449,-5,945,3611,40
45149592537,45149592533,-4,1020,3851,40
45153311002,45153310995,-7,987,2304,40
45157519290,45157519289,-1,1404,1859,40
45159228044,45159228039,-5,1360,3870,40
45162671731,45162671735,4,3125,1325,40
45167763724,45167763717,-7,1143,4217,40
45167882454,45167882471,17,1117,3143,40
45173802335,45173802330,-5,915,4339,40
45179040449,45179040449,0,1133,1360,40
45179262853,45179262865,12,57,1508,40
45179401607,45179401622,15,1112,3554,40
45182660000,45182659997,-3,1218,3933,40
45186471493,45186471488,-5,1402,4472,40
45187443419,45187443414,-5,1056,3965,40
45189065121,45189065114,-7,1735,4843,40
45195353207,45195353202,-5,1194,3392,40
45207646559,45207646554,-5,959,3595,40
45208231443,45208231437,-6,504,1844,40
45209101367,45209101353,-14,226,1099,40
45210800431,45210800429,-2,1696,2657,40
45220484601,45220484594,-7,1060,4467,40
45221670091,45221670086,-5,943,4029,40
45222792406,45222792399,-7,911,3093,40
45223532062,45223532056,-6,1376,4060,40
45238740935,45238740937,2,2316,2050,40
45239110715,45239110712,-3,1367,1971,40
45239197167,45239197162,-5,1061,3589,40
45240253055,45240253050,-5,916,2339,40
45240433080,45240433096,16,211,4478,40
45240536127,45240536134,7,277,1188,40
45243734393,45243734385,-8,918,2986,40
45244952165,45244952158,-7,834,3718,40
45245168634,45245168629,-5,878,3027,40
45245322542,45245322557,15,415,1401,40
45247078639,45247078633,-6,775,3153,40
45252224059,45252224053,-6,988,3031,40
45253485087,45253485080,-7,664,2899,40
45256492297,45256492296,-1,1488,2471,40
45260945632,45260945634,2,245,1298,40
45262663829,45262663829,0,53290,34116,40
45270785964,45270785958,-6,1184,4195,40
45275319709,45275319713,4,1533,741,40
45276852629,45276852610,-19,121,1395,40
45278812594,45278812588,-6,1445,4555,40
45280890158,45280890153,-5,1453,3749,40
45284335661,45284335657,-4,1124,4237,40
45288259643,45288259638,-5,1119,2916,40
45288506943,45288506941,-2,2641,5081,40
45289120610,45289120613,3,2071,1383,40
45290591399,45290591393,-6,698,4837,40
45295362084,45295362074,-10,902,4723,40
45296318791,45296318786,-5,643,1806,40
45298446316,45298446313,-3,65,999,40
45303386953,45303386946,-7,1195,3737,40
45304662094,45304662088,-6,1072,3905,40
45309153781,45309153774,-7,1007,5265,40
45313686872,45313686871,-1,1774,2264,40
45314797178,45314797177,-1,1270,2097,40
45318916845,45318916842,-3,22346,14654,40
45325241645,45325241639,-6,921,3611,40
45325283877,45325283876,-1,1091,1832,40
45326252501,45326252510,9,2247,1183,40
45333020417,45333020412,-5,1395,3967,40
45333261974,45333261969,-5,402,1814,40
45335002857,45335002850,-7,1053,4304,40
45338223509,45338223503,-6,1316,3558,40
45338376822,45338376818,-4,1124,2668,40
45338828695,45338828690,-5,1537,5005,40
45342326637,45342326631,-6,1397,4495,40
45349372600,45349372594,-6,595,2916,40
45349979118,45349979118,0,1610,3199,40
45372966323,45372966317,-6,1079,4625,40
45376052855,45376052849,-6,1313,4888,40
45379436852,45379436847,-5,1081,3226,40
45387259925,45387259922,-3,952,1764,40
45387978195,45387978189,-6,1054,4844,40
45389100174,45389100166,-8,814,2790,40
45390771101,45390771096,-5,1459,3222,40
45399219829,45399219823,-6,1462,3809,40
45399301837,45399301858,21,492,2594,40
45401909574,45401909567,-7,878,3904,40
45403660497,45403660501,4,2424,1505,40
45404551466,45404551462,-4,1152,2536,40
45405080543,45405080554,11,779,4402,40
45407924753,45407924746,-7,1014,3474,40
45409744407,45409744401,-6,619,1738,40
45409796988,45409797010,22,560,1430,40
45416486940,45416486933,-7,996,4672,40
45416905645,45416905640,-5,593,2899,40
45434216364,45434216372,8,13440,31707,40
45435889155,45435889149,-6,754,3303,40
45436431240,45436431258,18,1051,3053,40
45444515118,45444515110,-8,980,4070,40
45448251521,45448251515,-6,486,2393,40
45454608150,45454608142,-8,986,3528,40
45466175185,45466175179,-6,1357,3502,40
45469204413,45469204409,-4,1271,4429,40
45479730909,45479730905,-4,609,1446,40
45481345358,45481345352,-6,713,2035,40
45484282875,45484282873,-2,923,1935,40
45487016422,45487016417,-5,734,2172,40
45506136739,45506136733,-6,681,2700,40
45510457099,45510457093,-6,1293,2985,40
45510679095,45510679090,-5,663,3149,40
45521270265,45521270249,-16,1238,228,40
45522457731,45522457724,-7,27639,14767,40
45522885345,45522885341,-4,669,3428,40
45524905110,45524905106,-4,1017,882,40
45529365007,45529365002,-5,659,3052,40
45530254650,45530254646,-4,860,3475,40
45532718522,45532718517,-5,1343,4711,40
45534450886,45534450879,-7,870,3954,40
45535248901,45535248894,-7,998,4861,40
45535406128,45535406147,19,2657,4470,40
45537368306,45537368301,-5,949,2211,40
45539635269,45539635287,18,69,717,40
45541966498,45541966494,-4,638,964,40
45556790313,45556790305,-8,632,4568,40
45557421220,45557421217,-3,1181,2832,40
45563750813,45563750816,3,2123,1744,40
45570415828,45570415834,6,3784,2271,40
45572676921,45572676928,7,14208,30063,40
45575925585,45575925580,-5,843,2188,40
45576947726,45576947719,-7,394,2136,40
45582728263,45582728257,-6,923,3001,40
45584054283,45584054278,-5,1281,3666,40
45584651298,45584651293,-5,948,4084,40
45588008906,45588008886,-20,845,1376,40
45601650001,45601649995,-6,832,3044,40
45604292141,45604292136,-5,930,4473,40
45613114611,45613114605,-6,1095,5069,40
45613879846,45613879838,-8,1152,2622,40
45616204741,45616204737,-4,830,2406,40
45616483022,45616483040,18,334,768,40
45618748609,45618748604,-5,946,2833,40
45626131905,45626131903,-2,2196,5238,40
45629972231,45629972225,-6,1336,3821,40
45630946570,45630946563,-7,448,3617,40
45636837105,45636837099,-6,988,3136,40
45637611176,45637611194,18,282,1790,40
45639898761,45639898765,4,4153,3072,40
45645418635,45645418630,-5,870,3892,40
45648919295,45648919289,-6,764,2891,40
45652877054,45652877062,8,3133,1885,40
45658785246,45658785251,5,2543,1445,40
45672825205,45672825207,2,1552,1597,40
45676316116,45676316111,-5,1176,3088,40
45677175918,45677175911,-7,138,559,40
45678683085,45678683080,-5,1583,4276,40
45681849672,45681849664,-8,1180,4500,40
45683071632,45683071650,18,201,1283,40
45691527410,45691527405,-5,971,3578,40
45700817376,45700817369,-7,842,3046,40
45702471083,45702471077,-6,590,2761,40
45704036172,45704036186,14,677,3623,40
45706355606,45706355607,1,1247,1642,40
45706569631,45706569624,-7,684,4011,40
45706944438,45706944435,-3,233,1515,40
45708396679,45708396673,-6,668,2697,40
45721677664,45721677657,-7,1225,5442,40
45722523396,45722523417,21,430,1134,40
45727688295,45727688290,-5,1295,4018,40
45732713975,45732713981,6,2429,973,40
45741966914,45741966914,0,1861,2629,40
45744081620,45744081613,-7,1167,3765,40
45744357418,45744357410,-8,1354,3435,40
45751091544,45751091539,-5,667,3330,40
45754542134,45754542126,-8,728,8068,40
45757044446,45757044448,2,2677,2721,40
45758337807,45758337801,-6,1013,3349,40
45758888294,45758888274,-20,28,942,40
45765354129,45765354122,-7,1151,3505,40
45774771626,45774771632,6,13804,18053,40
45776871875,45776871870,-5,711,3302,40
45776982200,45776982213,13,383,1525,40
45780199319,45780199314,-5,893,2070,40
45780414096,45780414111,15,288,1384,40
45788110957,45788110950,-7,1135,4691,40
45789415735,45789415730,-5,813,2999,40
45798114875,45798114868,-7,1519,3268,40
45798998047,45798998063,16,824,3352,40
45819619318,45819619313,-5,1212,3256,40
45819892795,45819892799,4,506,1370,40
45823162631,45823162626,-5,1164,4812,40
45828476362,45828476356,-6,902,4267,40
45830864606,45830864602,-4,1163,4891,40
45831297783,45831297771,-12,340,2163,40
45831837372,45831837387,15,776,3914,40
45832012769,45832012765,-4,611,3311,40
45832247460,45832247445,-15,141,1401,40
45833239915,45833239909,-6,982,3189,40
45834915743,45834915737,-6,972,3077,40
45835579798,45835579793,-5,710,3505,40
45838342167,45838342161,-6,765,3916,40
45840803985,45840803987,2,1906,1965,40
45845375442,45845375438,-4,1015,3434,40
45845961917,45845961918,1,1402,1678,40
45848408243,45848408258,15,776,2446,40
45856439806,45856439798,-8,1322,4016,40
45864823871,45864823862,-9,741,2353,40
45864878615,45864878609,-6,203,1286,40
45867837278,45867837271,-7,900,4130,40
45869286372,45869286370,-2,151,814,40
45874893149,45874893146,-3,3641,8098,40
45876800803,45876800800,-3,849,2226,40
45883979311,45883979306,-5,1154,4352,40
45888544191,45888544171,-20,1058,756,40
45891562446,45891562441,-5,696,2594,40
45896729163,45896729157,-6,579,3609,40
45897219386,45897219382,-4,871,2318,40
45897825493,45897825486,-7,1042,4300,40
45899007907,45899007899,-8,881,2701,40
45899051316,45899051319,3,258,971,40
45915150371,45915150366,-5,1207,3288,40
45916676582,45916676574,-8,1139,3310,40
45918749069,45918749061,-8,1059,3909,40
45918973259,45918973253,-6,711,2975,40
45923230206,45923230199,-7,835,5812,40
45923918090,45923918088,-2,1058,2133,40
45924524204,45924524186,-18,1113,4736,40
45928356447,45928356451,4,17781,42661,40
45930952589,45930952583,-6,1035,3204,40
45931280502,45931280486,-16,270,1129,40
45934213409,45934213404,-5,1330,4034,40
45937457206,45937457202,-4,1402,2684,40
45948795578,45948795572,-6,1072,4361,40
45948856175,45948856183,8,146,2005,40
45966719734,45966719726,-8,475,1510,40
45973229234,45973229254,20,216,1478,40
45973819076,45973819086,10,3025,1162,40
45976919603,45976919597,-6,808,3255,40
45980191387,45980191384,-3,1055,3420,40
45981119380,45981119387,7,1554,1247,40
45985549904,45985549898,-6,1056,3343,40
45991747717,45991747709,-8,1331,2948,40
45992951847,45992951841,-6,1779,5007,40
45998081071,45998081066,-5,770,3612,40
45998761064,45998761081,17,295,1068,40
46000069458,46000069451,-7,1021,4199,40
46000166438,46000166454,16,501,2018,40
46003610694,46003610686,-8,881,3139,40
46009096565,46009096559,-6,301,1554,40
46013142063,46013142058,-5,520,3220,40
46013268669,46013268661,-8,1163,4137,40
46013379480,46013379493,13,810,3841,40
46013570107,46013570087,-20,26125,25714,40
46018206614,46018206593,-21,2193,1143,40
46018555661,46018555654,-7,958,3099,40
46020485983,46020485975,-8,1306,3265,40
46030785160,46030785156,-4,770,2549,40
46030921501,46030921520,19,166,1202,40
46038906870,46038906866,-4,1091,2766,40
46039858467,46039858474,7,4760,1430,40
46040911013,46040911006,-7,1104,3385,40
46043730391,46043730389,-2,1096,3253,40
46046303688,46046303682,-6,1532,3573,40
46051452062,46051452054,-8,1398,3537,40
46053690995,46053691002,7,13037,20807,40
46056743462,46056743457,-5,735,3921,40
46064082863,46064082857,-6,825,3817,40
46064356248,46064356261,13,271,969,40
46071123772,46071123765,-7,1367,3728,40
46071228018,46071228023,5,2075,1431,40
46089616812,46089616829,17,364,1782,40
46097064527,46097064529,2,1822,1565,40
46098629885,46098629878,-7,664,3424,40
46100740303,46100740298,-5,763,3413,40
46104799342,46104799328,-14,8466,970,40
46106279163,46106279157,-6,788,4769,40
46106491246,46106491267,21,1071,2594,40
46111927287,46111927281,-6,778,2819,40
46112171680,46112171681,1,165,1553,40
46115693434,46115693428,-6,949,3259,40
46119647777,46119647770,-7,1102,5225,40
46122724187,46122724182,-5,742,2997,40
46125275421,46125275417,-4,425,3086,40
46127217522,46127217518,-4,721,3005,40
46127430191,46127430185,-6,1075,3753,40
46130629645,46130629638,-7,893,4585,40
46140852362,46140852355,-7,887,3052,40
46153342532,46153342535,3,2433,1972,40
46166096332,46166096326,-6,1103,3484,40
46166367991,46166368009,18,760,2464,40
46166484333,46166484329,-4,224,779,40
46168070578,46168070568,-10,2191,551,40
46176843686,46176843672,-14,1068,793,40
46178251678,46178251685,7,1965,783,40
46181064178,46181064173,-5,612,1844,40
46181349464,46181349478,14,389,1333,40
46181801805,46181801810,5,4234,1548,40
46182748450,46182748443,-7,738,3845,40
46184842034,46184842027,-7,995,3061,40
46189245462,46189245455,-7,690,2566,40
46189472096,46189472114,18,659,2438,40
46194312930,46194312925,-5,1466,4902,40
46196541852,46196541845,-7,1393,4156,40
46202135282,46202135276,-6,763,2433,40
46203684683,46203684678,-5,891,3991,40
46206149938,46206149934,-4,875,3586,40
46215664839,46215664834,-5,999,5479,40
46221843161,46221843154,-7,1607,4941,40
46223712345,46223712351,6,3750,2107,40
46226767954,46226767958,4,6231,21233,40
46230093434,46230093429,-5,915,2703,40
46230126766,46230126778,12,832,2886,40
46232102002,46232101997,-5,917,3286,40
46233898367,46233898361,-6,947,2992,40
46234202900,46234202898,-2,235,1143,40
46237548342,46237548335,-7,1098,3163,40
46238137564,46238137578,14,47,754,40
46239560347,46239560353,6,1375,790,40
46245677722,46245677721,-1,10455,14506,40
46247829642,46247829636,-6,892,3828,40
46248895886,46248895900,14,502,2770,40
46258320827,46258320822,-5,1227,5040,40
46266195788,46266195781,-7,1032,4319,40
46266872385,46266872378,-7,1603,4401,40
46274341865,46274341862,-3,1004,2610,40
46282298791,46282298786,-5,1300,3925,40
46284333223,46284333218,-5,713,3042,40
46286167026,46286167018,-8,1179,4008,40
46289940281,46289940276,-5,1159,3649,40
46300619870,46300619874,4,1901,1347,40
46302059339,46302059335,-4,919,2798,40
46304288498,46304288492,-6,1222,4494,40
46305881332,46305881331,-1,1156,1978,40
46308020743,46308020739,-4,1081,2840,40
46309859882,46309859882,0,2314,2732,40
46314029711,46314029709,-2,1411,2852,40
46317390813,46317390807,-6,1317,4240,40
46317471863,46317471870,7,323,3359,40
46320236137,46320236131,-6,1120,5223,40
46338451733,46338451729,-4,2047,4158,40
46341850706,46341850726,20,2910,1186,40
46342832666,46342832661,-5,869,1817,40
46347659026,46347659021,-5,991,3893,40
46348271383,46348271360,-23,1414,3748,40
46348680559,46348680541,-18,814,2146,40
46351151264,46351151258,-6,1095,4163,40
46352413598,46352413593,-5,1540,4740,40
46362236545,46362236550,5,9512,6610,40
46379028567,46379028560,-7,1120,4804,40
46382729853,46382729850,-3,1167,1824,40
46386462070,46386462076,6,1628,823,40
46394016975,46394016971,-4,943,2952,40
46397028954,46397028949,-5,989,3366,40
46400350786,46400350789,3,2253,1196,40
46401401366,46401401360,-6,1105,4305,40
46412961427,46412961423,-4,992,3230,40
46415379402,46415379398,-4,1046,2879,40
46416457885,46416457876,-9,231,1027,40
46417547417,46417547422,5,4464,2312,40
46421753887,46421753889,2,1731,1147,40
46423004566,46423004561,-5,1100,2739,40
46423502492,46423502502,10,221,1488,40
46424041085,46424041100,15,468,2565,40
46427849870,46427849865,-5,1232,3884,40
46430089700,46430089697,-3,785,2023,40
46436137418,46436137419,1,4065,19497,40
46446611257,46446611251,-6,1298,4505,40
46448101831,46448101826,-5,1247,4000,40
46460121338,46460121333,-5,1524,4646,40
46461595667,46461595662,-5,1147,4066,40
46461825913,46461825906,-7,1213,4402,40
46461918332,46461918313,-19,197,1455,40
46462420628,46462420645,17,619,4124,40
46465510794,46465510787,-7,28673,14142,40
46466173183,46466173176,-7,1090,2781,40
46471830741,46471830734,-7,1003,3583,40
46474316571,46474316563,-8,824,3238,40
46479511103,46479511103,0,1299,1593,40
46481500867,46481500862,-5,1196,3746,40
46488568222,46488568218,-4,1092,5028,40
46491723840,46491723836,-4,1474,3240,40
46502210561,46502210563,2,1774,1842,40
46514322159,46514322154,-5,704,3274,40
46515088308,46515088311,3,56,1065,40
46519333883,46519333877,-6,1200,4239,40
46529882902,46529882897,-5,1321,5130,40
46533260318,46533260314,-4,1283,3038,40
46534645665,46534645659,-6,1098,3083,40
46536579414,46536579431,17,868,3947,40
46539233826,46539233821,-5,743,2050,40
46543807330,46543807326,-4,1088,3299,40
46558346707,46558346699,-8,1212,5005,40
46563762417,46563762409,-8,707,3695,40
46567662789,46567662786,-3,1125,2730,40
46568473402,46568473398,-4,719,2072,40
46569047357,46569047336,-21,1158,4304,40
46569131696,46569131691,-5,1285,4681,40
46585730214,46585730209,-5,1010,3090,40
46585828023,46585828018,-5,1226,3178,40
46589910638,46589910634,-4,985,2766,40
46590150374,46590150372,-2,622,1091,40
46592057008,46592057002,-6,747,2932,40
46595356486,46595356485,-1,1095,2792,40
46600060229,46600060225,-4,1562,2726,40
46604926154,46604926148,-6,1022,2755,40
46605102478,46605102469,-9,759,3536,40
46606842997,46606843004,7,3498,1601,40
46611075668,46611075661,-7,1453,4699,40
46611413677,46611413678,1,898,1397,40
46611575174,46611575174,0,2087,1799,40
46612672870,46612672864,-6,1451,5014,40
46615705319,46615705315,-4,781,2807,40
46616416639,46616416644,5,4908,2318,40
46619215630,46619215635,5,1188,898,40
46638316445,46638316438,-7,647,3152,40
46638982398,46638982410,12,243,1298,40
46641328321,46641328313,-8,964,5900,40
46642635466,46642635461,-5,1079,4273,40
46642922908,46642922917,9,20,700,40
46643825322,46643825326,4,1531,1005,40
46644513411,46644513406,-5,1191,2238,40
46644584007,46644584003,-4,1021,2897,40
46650314427,46650314421,-6,1040,3288,40
46651609733,46651609735,2,3953,2978,40
46652223666,46652223658,-8,1225,5611,40
46661292948,46661292941,-7,1207,3336,40
46663152662,46663152657,-5,1037,3234,40
46665606098,46665606093,-5,976,3973,40
46670832462,46670832456,-6,649,3641,40
46677485326,46677485320,-6,460,1750,40
46684613105,46684613099,-6,1202,4357,40
46686314565,46686314559,-6,971,4296,40
46686626062,46686626081,19,1125,3386,40
46690016853,46690016847,-6,981,3495,40
46690971837,46690971854,17,720,2593,40
46694719252,46694719246,-6,945,4895,40
46695041071,46695041081,10,157,1096,40
46700261837,46700261833,-4,1169,2868,40
46700374540,46700374534,-6,1104,4007,40
46700965160,46700965168,8,574,2437,40
46701650494,46701650497,3,946,1306,40
46705770103,46705770098,-5,780,3662,40
46706981319,46706981326,7,4595,1817,40
46707745790,46707745785,-5,915,4055,40
46711172394,46711172386,-8,1155,4166,40
46715351454,46715351461,7,1867,948,40
46715378478,46715378478,0,2587,3250,40
46715904910,46715904912,2,2954,3026,40
46716634175,46716634170,-5,1419,4284,40
46717572451,46717572447,-4,906,2194,40
46719987243,46719987237,-6,1517,3241,40
46721467498,46721467492,-6,1285,3724,40
46721725291,46721725283,-8,887,3989,40
46721900464,46721900470,6,71,804,40
46723817969,46723817962,-7,1284,5477,40
46723983752,46723983760,8,2757,2134,40
46725410021,46725410022,1,2237,2633,40
46735884466,46735884463,-3,1652,2937,40
46737076541,46737076534,-7,1009,2508,40
46737832853,46737832858,5,237,1228,40
46740453414,46740453407,-7,1206,3392,40
46742838738,46742838731,-7,1142,5681,40
46742869909,46742869931,22,675,3684,40
46745919551,46745919545,-6,1344,4430,40
46755354561,46755354563,2,1443,1268,40
46755918406,46755918401,-5,898,2978,40
46756758106,46756758099,-7,972,3359,40
46759049393,46759049389,-4,777,2990,40
46759656257,46759656250,-7,1264,3954,40
46765429125,46765429118,-7,1557,4961,40
46773811594,46773811595,1,20603,92262,40
46778532646,46778532640,-6,910,4793,40
46778816398,46778816392,-6,902,4412,40
46788695235,46788695228,-7,828,4089,40
46794856731,46794856725,-6,793,4671,40
46798649976,46798649971,-5,1017,2963,40
46813738951,46813738945,-6,961,3487,40
46817051355,46817051358,3,6973,5712,40
46818113051,46818113046,-5,1435,3734,40
46818892967,46818892962,-5,905,3123,40
46819620724,46819620718,-6,1067,3508,40
46820207087,46820207082,-5,1137,2656,40
46820693110,46820693125,15,211,1359,40
46821482652,46821482658,6,95,643,40
46821873425,46821873426,1,1691,2124,40
46824334011,46824334009,-2,9210,17463,40
46829142669,46829142664,-5,806,2691,40
46829194006,46829194018,12,639,2454,40
46838243482,46838243469,-13,3112,13172,40
46839535356,46839535365,9,17119,22899,40
46839860313,46839860314,1,2013,1864,40
46843067456,46843067469,13,130,1607,40
46844713846,46844713864,18,735,2999,40
46845539537,46845539533,-4,1151,3857,40
46849494835,46849494829,-6,917,3779,40
46851363371,46851363366,-5,1188,3158,40
46853777447,46853777441,-6,909,3154,40
46858914273,46858914265,-8,809,3156,40
46859467110,46859467127,17,299,1189,40
46859937177,46859937171,-6,980,3217,40
46869032451,46869032444,-7,1133,3990,40
46873144819,46873144814,-5,1036,2442,40
46879967642,46879967642,0,1251,1552,40
46883751611,46883751621,10,11040,41792,40
46885014171,46885014163,-8,819,3919,40
46888699293,46888699286,-7,1109,3260,40
46889765828,46889765822,-6,917,3338,40
46890225742,46890225734,-8,1124,3141,40
46897114941,46897114935,-6,932,3653,40
46897857192,46897857198,6,102,1212,40
46899822006,46899822027,21,44,614,40
46900298974,46900298994,20,74,856,40
46906469359,46906469351,-8,841,2161,40
46906711733,46906711717,-16,128,899,40
46906780356,46906780351,-5,897,2589,40
46916702058,46916702053,-5,1132,4508,40
46921567393,46921567387,-6,1062,4629,40
46923008338,46923008334,-4,1127,3241,40
46923721476,46923721470,-6,1151,5036,40
46923874051,46923874046,-5,504,3411,40
46923956054,46923956050,-4,1248,2558,40
46924292936,46924292933,-3,1039,3360,40
46928150986,46928150970,-16,4238,2676,40
46932893245,46932893244,-1,2810,4092,40
46939850517,46939850529,12,2475,1756,40
46943680700,46943680692,-8,953,6057,40
46946131282,46946131295,13,14336,49002,40
46950717467,46950717461,-6,814,3721,40
46952051303,46952051294,-9,306,1560,40
46956013127,46956013122,-5,896,3358,40
46956400219,46956400214,-5,1386,3749,40
46957973553,46957973549,-4,844,2338,40
46960511085,46960511079,-6,664,3554,40
46963410091,46963410086,-5,900,3066,40
46968027831,46968027824,-7,933,3367,40
46970923812,46970923807,-5,726,2666,40
46972329969,46972329965,-4,628,3019,40
46972374390,46972374408,18,779,2491,40
46974076866,46974076858,-8,1215,3536,40
46978088999,46978088995,-4,879,2943,40
46979951246,46979951242,-4,936,3198,40
46980062007,46980062026,19,116,772,40
46988411031,46988411032,1,858,1313,40
46990930626,46990930619,-7,1079,3694,40
46991373460,46991373465,5,934,1164,40
46993811150,46993811154,4,1697,1911,40
47012523139,47012523141,2,3319,3366,40
47016112030,47016112023,-7,709,3988,40
47017069281,47017069274,-7,1106,3622,40
47017149412,47017149394,-18,693,2819,40
47017438129,47017438122,-7,824,3872,40
47017494262,47017494279,17,344,830,40
47025183523,47025183517,-6,931,2886,40
47026751359,47026751354,-5,588,1034,40
47034880998,47034880993,-5,1165,4833,40
47037099538,47037099554,16,290,1510,40
47041826755,47041826750,-5,958,3707,40
47045080430,47045080425,-5,1012,4554,40
47050486532,47050486526,-6,1210,3801,40
47050913159,47050913164,5,2113,1575,40
47054104079,47054104071,-8,955,4424,40
47055659474,47055659466,-8,961,4275,40
47077089210,47077089206,-4,1098,2900,40
47082734939,47082734933,-6,999,4076,40
47086662798,47086662794,-4,1238,3341,40
47086922227,47086922226,-1,1923,2370,40
47090079974,47090079967,-7,635,3401,40
47101671613,47101671609,-4,938,3615,40
47105230982,47105230975,-7,1287,3920,40
47105734796,47105734801,5,3732,1527,40
47111424919,47111424914,-5,1043,2762,40
47119540944,47119540938,-6,1083,3842,40
47121280004,47121280025,21,641,3404,40
47122503712,47122503712,0,1349,1292,40
47138462317,47138462324,7,4088,1420,40
47150917010,47150917003,-7,1136,3383,40
47153210682,47153210675,-7,967,3867,40
47155462267,47155462269,2,3200,2540,40
47155973399,47155973393,-6,769,3410,40
47176076030,47176076026,-4,1015,1762,40
47185926307,47185926302,-5,1038,3191,40
47191739269,47191739269,0,822,2139,40
47191987691,47191987685,-6,1234,5013,40
47194836991,47194836988,-3,986,2117,40
47197440642,47197440647,5,2334,1505,40
47206924143,47206924147,4,672,715,40
47214093421,47214093432,11,11077,47404,40
47219523358,47219523351,-7,625,3280,40
47221515812,47221515794,-18,1054,4521,40
47222794811,47222794807,-4,1015,2693,40
47223413714,47223413709,-5,809,3376,40
47224479429,47224479423,-6,83,1081,40
47226830318,47226830310,-8,1326,5645,40
47228216669,47228216663,-6,1270,3945,40
47234971723,47234971715,-8,661,2610,40
47235435424,47235435410,-14,245,1279,40
47240331505,47240331498,-7,828,4084,40
47241662875,47241662869,-6,989,3867,40
47254502606,47254502615,9,12979,22486,40
47261101470,47261101465,-5,864,3116,40
47261974459,47261974453,-6,1259,4102,40
47268732623,47268732618,-5,1255,4023,40
47270532717,47270532719,2,1771,1986,40
47277481382,47277481375,-7,991,4556,40
47278439586,47278439581,-5,777,3372,40
47278799606,47278799622,16,58,633,40
47285582267,47285582260,-7,1209,3620,40
47288666675,47288666669,-6,1427,4467,40
47288790103,47288790109,6,229,1129,40
47289382528,47289382522,-6,1115,3499,40
47290397466,47290397459,-7,1481,4926,40
47293369437,47293369437,0,1544,1834,40
47293852752,47293852745,-7,1015,3344,40
47295322632,47295322649,17,489,3341,40
47300477903,47300477899,-4,1211,2079,40
47301377110,47301377130,20,924,3579,40
47301876552,47301876546,-6,1159,4378,40
47308005673,47308005666,-7,922,3608,40
47309110811,47309110806,-5,789,4105,40
47314196690,47314196686,-4,944,3342,40
47316496692,47316496695,3,2320,1383,40
47321998829,47321998832,3,2121,1623,40
47324130207,47324130205,-2,1886,3926,40
47332169106,47332169100,-6,1010,3920,40
47332427510,47332427526,16,581,1265,40
47335405035,47335405030,-5,1511,5769,40
47335735823,47335735830,7,4038,1825,40
47337913339,47337913333,-6,974,4996,40
47344207322,47344207318,-4,1085,3336,40
47344324278,47344324274,-4,811,2234,40
47347060596,47347060599,3,1619,1018,40
47348046289,47348046283,-6,840,3590,40
47348268884,47348268890,6,371,1236,40
47357409578,47357409574,-4,1182,3064,40
47358509222,47358509217,-5,1371,4880,40
47363502261,47363502251,-10,1068,5557,40
47367334575,47367334579,4,1259,1206,40
47372877251,47372877245,-6,977,4297,40
47377324443,47377324437,-6,853,3307,40
47377782717,47377782738,21,551,2287,40
47379818609,47379818608,-1,1214,2345,40
47381141814,47381141813,-1,886,2721,40
47384318986,47384318980,-6,1318,4549,40
47385004349,47385004371,22,326,1622,40
47385041061,47385041063,2,1737,1655,40
47388733220,47388733214,-6,909,3074,40
47396158905,47396158898,-7,1263,4990,40
47398144004,47398143997,-7,1226,3707,40
47399519386,47399519380,-6,1381,4915,40
47399715433,47399715427,-6,833,3612,40
47402989431,47402989426,-5,454,2222,40
47410400750,47410400743,-7,772,2987,40
47417232882,47417232878,-4,905,3199,40
47419224034,47419224026,-8,650,4355,40
47420831671,47420831674,3,4890,3020,40
47425742800,47425742794,-6,1027,4281,40
47428666821,47428666815,-6,951,4100,40
47431541107,47431541098,-9,689,2799,40
47432364339,47432364334,-5,971,3864,40
47432836822,47432836834,12,235,1220,40
47440087508,47440087504,-4,973,2242,40
47448603263,47448603268,5,4752,2245,40
47450677038,47450677042,4,1421,624,40
47465167719,47465167711,-8,1258,4140,40
47466987983,47466987978,-5,909,3815,40
47469221790,47469221786,-4,608,2571,40
47470478215,47470478234,19,492,1224,40
47471303626,47471303620,-6,1248,4438,40
47472030045,47472030042,-3,1194,2923,40
47474101365,47474101386,21,964,3694,40
47476701310,47476701303,-7,1330,3806,40
47477419858,47477419854,-4,1335,3658,40
47479233871,47479233865,-6,1135,4849,40
47480554953,47480554948,-5,1324,4927,40
47482408387,47482408382,-5,741,3512,40
47486440434,47486440429,-5,1148,3463,40
47488473878,47488473897,19,677,2675,40
47488912362,47488912357,-5,1037,3526,40
47501040739,47501040733,-6,836,3153,40
47501712018,47501712010,-8,1003,4349,40
47505328513,47505328506,-7,1123,4505,40
47506649735,47506649723,-12,319,996,40
47513708413,47513708419,6,1745,954,40
47515873611,47515873605,-6,742,3113,40
47517971987,47517971991,4,1177,798,40
47519538673,47519538665,-8,1128,5104,40
47520312552,47520312570,18,603,2134,40
47520450826,47520450819,-7,413,3001,40
47520967490,47520967491,1,1186,1478,40
47524615212,47524615204,-8,949,3976,40
47526920002,47526919995,-7,1141,4060,40
47527000710,47527000714,4,2972,1132,40
47531352477,47531352472,-5,1410,5303,40
47531590053,47531590039,-14,138,1322,40
47532943139,47532943118,-21,269,1227,40
47536153047,47536153042,-5,1477,3410,40
47538190985,47538190979,-6,865,3611,40
47539704458,47539704453,-5,867,3137,40
47540540928,47540540941,13,181,1859,40
47545008661,47545008662,1,1557,1857,40
47555885174,47555885170,-4,1023,3135,40
47556792218,47556792214,-4,1321,2633,40
47562023590,47562023585,-5,992,3014,40
47567273543,47567273537,-6,939,3242,40
47570712415,47570712411,-4,1014,2853,40
47574290543,47574290542,-1,845,1469,40
47577927925,47577927927,2,2229,1625,40
47584030243,47584030238,-5,638,2040,40
47584855286,47584855286,0,139,1037,40
47585629679,47585629677,-2,1796,2795,40
47585939334,47585939328,-6,879,2334,40
47587843838,47587843832,-6,1097,2835,40
47595877350,47595877347,-3,1458,2672,40
47597952911,47597952905,-6,1097,3588,40
47601573077,47601573073,-4,833,3072,40
47605639258,47605639253,-5,738,3153,40
47605762397,47605762387,-10,160,1150,40
47608650336,47608650330,-6,660,2944,40
47609116966,47609116960,-6,254,1605,40
47609978972,47609978992,20,153,978,40
47611927360,47611927353,-7,1075,3280,40
47618955049,47618955043,-6,743,2993,40
47619395180,47619395165,-15,172,1056,40
47623929956,47623929960,4,2303,1329,40
47624787220,47624787226,6,250,937,40
47625246293,47625246288,-5,1007,4037,40
47631074271,47631074263,-8,959,3498,40
47633988149,47633988143,-6,734,3068,40
47634790636,47634790637,1,187,1185,40
47644281475,47644281469,-6,891,2880,40
47648460025,47648460026,1,12977,15867,40
47649062143,47649062136,-7,805,2342,40
47653916034,47653916031,-3,1179,2788,40
47654009135,47654009129,-6,1084,3672,40
47658313126,47658313130,4,2833,1511,40
47658767878,47658767873,-5,1032,4443,40
47659630593,47659630598,5,10971,21103,40
47665092678,47665092682,4,1677,1102,40
47666449003,47666448997,-6,1291,4079,40
47666653919,47666653913,-6,1066,3996,40
47666762324,47666762304,-20,694,2032,40
47670691047,47670691043,-4,503,1680,40
47670790860,47670790878,18,96,1086,40
47674770775,47674770778,3,2058,1512,40
47674929925,47674929930,5,4801,2052,40
47685123034,47685123039,5,25607,20635,40
47686323215,47686323210,-5,1118,2692,40
47687310402,47687310395,-7,827,2941,40
47699496724,47699496717,-7,877,3576,40
47708661371,47708661366,-5,775,3143,40
47711330554,47711330549,-5,968,3949,40
47713395859,47713395853,-6,975,2148,40
47714230025,47714230030,5,1124,953,40
47717987493,47717987493,0,1591,1619,40
47725493322,47725493328,6,2959,1991,40
47726351534,47726351528,-6,991,4202,40
47739241025,47739241017,-8,890,2965,40
47748419355,47748419350,-5,715,2491,40
47757746066,47757746059,-7,797,3159,40
47762723970,47762723969,-1,1238,2144,40
47763907574,47763907569,-5,961,3230,40
47766401374,47766401377,3,1052,1550,40
47767996259,47767996253,-6,977,3053,40
47771643649,47771643642,-7,1029,4238,40
47773749066,47773749061,-5,838,3165,40
47774859302,47774859297,-5,1260,5231,40
47776599886,47776599878,-8,961,3387,40
47777982021,47777982041,20,856,3518,40
47780579411,47780579405,-6,682,4405,40
47795098863,47795098857,-6,998,3469,40
47804700455,47804700449,-6,681,3709,40
47804839965,47804839953,-12,38,1117,40
47814858105,47814858100,-5,856,4367,40
47817383762,47817383757,-5,858,2171,40
47818169244,47818169236,-8,1126,3598,40
47819573110,47819573126,16,15879,31713,40
47821900302,47821900295,-7,1180,3789,40
47825477729,47825477730,1,1403,1600,40
47827929423,47827929417,-6,1041,3321,40
47830677814,47830677807,-7,837,3094,40
47834482569,47834482565,-4,1346,2631,40
47837746093,47837746085,-8,1121,2941,40
47838440583,47838440602,19,366,3602,40
47841150047,47841150045,-2,1231,1878,40
47842108422,47842108417,-5,944,3402,40
47845873622,47845873629,7,5685,2252,40
47848331464,47848331457,-7,1349,4371,40
47849191948,47849191954,6,5625,2047,40
47850981203,47850981198,-5,713,2292,40
47858973977,47858973971,-6,922,4337,40
47859267279,47859267286,7,181,1243,40
47859683038,47859683032,-6,663,1591,40
47861721177,47861721172,-5,1077,2199,40
47864317152,47864317146,-6,755,4004,40
47872875353,47872875348,-5,1091,3712,40
47873053068,47873053054,-14,239,1987,40
47874731415,47874731410,-5,616,1971,40
47875854546,47875854553,7,5993,2698,40
47876948755,47876948749,-6,960,3166,40
47877252317,47877252312,-5,645,3643,40
47878348668,47878348669,1,3304,2565,40
47878862276,47878862270,-6,761,1862,40
47878943422,47878943441,19,263,894,40
47886799791,47886799784,-7,1010,3402,40
47892405841,47892405835,-6,900,3160,40
47893421628,47893421622,-6,1160,4055,40
47894315700,47894315680,-20,224,1482,40
47895753028,47895753035,7,2854,1097,40
47900612698,47900612694,-4,808,3248,40
47902425607,47902425608,1,2613,2654,40
47909005683,47909005686,3,32387,34822,40
47913575182,47913575178,-4,17654,15369,40
47916975583,47916975575,-8,736,2646,40
47917916181,47917916178,-3,1028,2322,40
47919374122,47919374125,3,3278,3101,40
47926750342,47926750338,-4,1218,2734,40
47930006301,47930006295,-6,697,2768,40
47940421766,47940421774,8,2817,1354,40
47943336994,47943336993,-1,1985,3726,40
47948783255,47948783248,-7,996,4241,40
47949258370,47949258365,-5,955,3521,40
47954349302,47954349297,-5,1860,6125,40
47958237214,47958237209,-5,646,2483,40
47959008166,47959008185,19,903,3447,40
47959088696,47959088690,-6,1196,4183,40
47962893679,47962893674,-5,905,2834,40
47970805543,47970805537,-6,1278,4913,40
47975182840,47975182834,-6,1067,3752,40
47977046869,47977046862,-7,1091,3250,40
47977329325,47977329306,-19,147,1303,40
47977492068,47977492053,-15,122,1070,40
47983546678,47983546671,-7,1491,5980,40
47985222589,47985222582,-7,815,4033,40
47985964794,47985964788,-6,1138,3737,40
47988888366,47988888360,-6,1170,3428,40
47988979974,47988979980,6,96,692,40
47989518221,47989518221,0,2019,1802,40
47992451954,47992451962,8,2743,1249,40
48002444331,48002444326,-5,1416,4289,40
48011799404,48011799407,3,16477,34436,40
48012429815,48012429808,-7,1285,3509,40
48013443451,48013443449,-2,8949,14781,40
48013797975,48013797969,-6,1252,3825,40
48014324066,48014324061,-5,489,2722,40
48014523668,48014523661,-7,96,1375,40
48024051011,48024051005,-6,946,4228,40
48024151253,48024151264,11,239,1162,40
48035995853,48035995845,-8,905,2689,40
48044613479,48044613474,-5,534,1657,40
48044687614,48044687599,-15,735,2468,40
48048126730,48048126724,-6,782,3785,40
48048657727,48048657713,-14,153,904,40
48059696789,48059696794,5,1957,1275,40
48082582514,48082582508,-6,987,3600,40
48083161358,48083161350,-8,673,2737,40
48083732695,48083732698,3,2157,1928,40
48085695178,48085695193,15,452,3055,40
48096085312,48096085306,-6,955,2658,40
48098602258,48098602260,2,3988,4493,40
48103619259,48103619253,-6,1920,5981,40
48106037870,48106037865,-5,999,3051,40
48107523845,48107523851,6,5240,2789,40
48107957137,48107957134,-3,1373,2276,40
48110929613,48110929606,-7,1170,3473,40
48111880949,48111880931,-18,322,1121,40
48121968049,48121968050,1,1014,1938,40
48122848294,48122848288,-6,785,3398,40
48123569578,48123569574,-4,937,2575,40
48124317055,48124317062,7,46,973,40
48124714984,48124714998,14,476,3456,40
48135397511,48135397505,-6,996,3605,40
48136162221,48136162241,20,120,2093,40
48148647425,48148647418,-7,1214,4660,40
48153727860,48153727853,-7,818,2709,40
48158620009,48158620001,-8,852,2895,40
48163932672,48163932668,-4,977,3103,40
48171683145,48171683139,-6,1889,8267,40
48171962890,48171962884,-6,871,3905,40
48172131772,48172131794,22,259,1165,40
48173829131,48173829150,19,753,247,40
48175490333,48175490326,-7,948,2571,40
48177192799,48177192790,-9,931,3927,40
48180619489,48180619497,8,2810,1078,40
48180763775,48180763770,-5,1513,4062,40
48180842234,48180842227,-7,984,3068,40
48185779094,48185779087,-7,1096,3829,40
48187673102,48187673095,-7,1156,4025,40
48188055163,48188055167,4,1225,1075,40
48197826337,48197826354,17,811,3456,40
48202496133,48202496126,-7,982,2889,40
48206528357,48206528359,2,1602,1361,40
48215873295,48215873291,-4,1293,3697,40
48218499807,48218499811,4,2875,1843,40
48219021561,48219021558,-3,1413,2395,40
48227389581,48227389574,-7,1079,4035,40
48229835623,48229835618,-5,925,2974,40
48232774761,48232774756,-5,843,2502,40
48233256247,48233256242,-5,1250,2336,40
48234147751,48234147745,-6,1018,3000,40
48237264042,48237264036,-6,884,3909,40
48237455964,48237455969,5,248,1325,40
48242585228,48242585247,19,1026,3316,40
48243680207,48243680201,-6,826,2921,40
48249288212,48249288218,6,2716,905,40
48253950743,48253950747,4,3146,1536,40
48258755258,48258755275,17,261,1352,40
48259956085,48259956080,-5,1323,3638,40
48261668542,48261668544,2,1842,1662,40
48261942214,48261942210,-4,973,3060,40
48270218499,48270218494,-5,1120,3353,40
48271373902,48271373899,-3,1212,3543,40
48272988216,48272988207,-9,32,697,40
48278688270,48278688265,-5,984,3157,40
48278739268,48278739287,19,506,2213,40
48282219106,48282219097,-9,753,4178,40
48288353538,48288353533,-5,1055,3732,40
48289367991,48289367985,-6,119,1674,40
48290229950,48290229963,13,239,1182,40
48296663517,48296663510,-7,774,4340,40
48297412678,48297412670,-8,878,3575,40
48298513638,48298513632,-6,1483,4425,40
48299003504,48299003519,15,940,4516,40
48302536058,48302536050,-8,1302,4772,40
48308729806,48308729801,-5,1305,5331,40
48318445046,48318445039,-7,1538,5055,40
48322149491,48322149483,-8,1462,4481,40
48329380841,48329380839,-2,893,1098,40
48334720190,48334720183,-7,807,4447,40
48340407236,48340407240,4,2117,1414,40
48340603934,48340603928,-6,913,3466,40
48348719279,48348719273,-6,865,3599,40
48348829654,48348829651,-3,175,1929,40
48351643206,48351643202,-4,866,3193,40
48355942017,48355942010,-7,1045,3755,40
48356618011,48356618006,-5,1120,3446,40
48356948559,48356948562,3,9,1779,40
48357072710,48357072726,16,884,2921,40
48361292495,48361292489,-6,1010,3091,40
48361402054,48361402045,-9,229,1225,40
48365264627,48365264621,-6,867,4409,40
48365653181,48365653171,-10,1298,4468,40
48367749736,48367749735,-1,2492,3567,40
48368818850,48368818843,-7,1249,3534,40
48378956389,48378956370,-19,3,760,40
48379420358,48379420349,-9,26,1872,40
48379584160,48379584167,7,161,1229,40
48382213177,48382213171,-6,607,1498,40
48382341263,48382341278,15,322,1082,40
48388791352,48388791346,-6,724,2568,40
48392392394,48392392389,-5,1532,5174,40
48393997213,48393997207,-6,1024,4340,40
48394038229,48394038242,13,363,1612,40
48394147110,48394147113,3,2038,1425,40
48424920355,48424920349,-6,769,2323,40
48426604150,48426604145,-5,955,3833,40
48427289709,48427289730,21,995,3693,40
48434170430,48434170424,-6,982,3739,40
48441574862,48441574857,-5,885,3534,40
48452053779,48452053774,-5,987,3019,40
48460379835,48460379838,3,1651,986,40
48463002066,48463002060,-6,787,4598,40
48463963207,48463963201,-6,833,4124,40
48464825494,48464825488,-6,731,2269,40
48466162241,48466162237,-4,2238,5533,40
48469640313,48469640308,-5,1082,3984,40
48475812297,48475812291,-6,923,4297,40
48476383995,48476383991,-4,746,4415,40
48476864446,48476864464,18,140,825,40
48481001286,48481001279,-7,1254,3879,40
48481506001,48481505994,-7,1241,4675,40
48486486964,48486486959,-5,702,2522,40
48486790688,48486790703,15,671,3191,40
48487281429,48487281443,14,87,684,40
48491062801,48491062795,-6,1307,3706,40
48493180561,48493180556,-5,799,4256,40
48493303333,48493303326,-7,758,6917,40
48493439968,48493439950,-18,195,1432,40
48494028191,48494028185,-6,1031,3363,40
48496084869,48496084874,5,2162,1254,40
48497409250,48497409245,-5,912,3360,40
48505259427,48505259435,8,2964,1243,40
48505941993,48505942009,16,611,2596,40
48513726421,48513726415,-6,944,2733,40
48520136065,48520136058,-7,1215,2962,40
48522539874,48522539869,-5,1103,4417,40
48534122966,48534122959,-7,811,3990,40
48534644414,48534644430,16,152,1680,40
48543459353,48543459347,-6,1041,3981,40
48547296507,48547296503,-4,833,1302,40
48551294680,48551294674,-6,904,4171,40
48554233058,48554233057,-1,1175,1810,40
48554440354,48554440360,6,4835,2380,40
48563200377,48563200373,-4,814,2769,40
48564392729,48564392722,-7,724,4814,40
48564701822,48564701836,14,123,1630,40
48564947286,48564947296,10,388,1401,40
48565853746,48565853741,-5,511,3148,40
48566479456,48566479450,-6,971,3967,40
48568579013,48568579008,-5,1058,4080,40
48574968538,48574968533,-5,774,3687,40
48576432407,48576432400,-7,1274,4890,40
48578943848,48578943841,-7,845,2186,40
48579662893,48579662886,-7,1170,2840,40
48581122990,48581122985,-5,668,1867,40
48591684035,48591684030,-5,658,3243,40
48599522792,48599522786,-6,881,4648,40
48602036255,48602036250,-5,1171,3589,40
48606729109,48606729118,9,17081,21767,40
48608112545,48608112541,-4,1186,2538,40
48608609750,48608609742,-8,205,854,40
48609501014,48609501028,14,241,1455,40
48612571447,48612571454,7,3155,1641,40
48616002335,48616002334,-1,144,1336,40
48618236071,48618236066,-5,1197,4137,40
48620522731,48620522725,-6,1023,4083,40
48621148959,48621148979,20,285,834,40
48622656656,48622656650,-6,784,2953,40
48625157466,48625157459,-7,855,3850,40
48625411309,48625411330,21,780,4085,40
48631748781,48631748774,-7,1164,4458,40
48633535358,48633535366,8,3571,1343,40
48635938829,48635938825,-4,1170,2889,40
48638639328,48638639330,2,15256,15460,40
48644429379,48644429395,16,14112,48400,40
48650155862,48650155857,-5,942,3832,40
48650402107,48650402101,-6,796,3394,40
48674344882,48674344877,-5,1345,4114,40
48679338841,48679338838,-3,1019,1409,40
48685295866,48685295871,5,2045,1108,40
48695395251,48695395254,3,2422,1705,40
48701016102,48701016108,6,3902,1983,40
48702646106,48702646102,-4,821,2699,40
48703244735,48703244755,20,67,955,40
48704672209,48704672203,-6,1274,4587,40
48706292749,48706292759,10,10586,29377,40
48708485929,48708485950,21,98,596,40
48709255029,48709255032,3,1491,1818,40
48714904531,48714904525,-6,1579,3814,40
48716405097,48716405090,-7,754,2355,40
48717795543,48717795541,-2,29536,51001,40
48722833488,48722833481,-7,1127,2945,40
48727421946,48727421940,-6,1691,3152,40
48727834191,48727834186,-5,94,1151,40
48733630206,48733630203,-3,5690,11868,40
48735402577,48735402569,-8,818,3455,40
48736388762,48736388758,-4,23989,12584,40
48748982206,48748982198,-8,954,2639,40
48767642850,48767642855,5,1148,1111,40
48768726237,48768726259,22,712,4341,40
48778950051,48778950045,-6,748,3703,40
48780623998,48780623993,-5,1238,5614,40
48784022714,48784022708,-6,1287,3350,40
48785644639,48785644633,-6,308,1973,40
48787193562,48787193556,-6,909,2811,40
48787889002,48787889007,5,26793,130688,40
48788054930,48788054934,4,1825,1580,40
48796680466,48796680461,-5,980,3015,40
48796794920,48796794938,18,1028,5671,40
48799207579,48799207574,-5,1172,3266,40
48807215965,48807215959,-6,1435,3898,40
48808048119,48808048124,5,45,1254,40
48812433292,48812433283,-9,1116,3092,40
48812482997,48812483006,9,262,1275,40
48816851798,48816851791,-7,1166,5581,40
48817012045,48817012065,20,505,2266,40
48819386806,48819386801,-5,830,3013,40
48820581276,48820581269,-7,1032,4160,40
48821388352,48821388347,-5,849,2739,40
48822332772,48822332795,23,516,1237,40
48825507713,48825507708,-5,1374,3487,40
48830098946,48830098939,-7,1167,4075,40
48830142551,48830142546,-5,838,3523,40
48837401936,48837401932,-4,628,2664,40
48838421661,48838421658,-3,1628,3047,40
48840326333,48840326327,-6,1240,2956,40
48853444871,48853444864,-7,724,3181,40
48853672274,48853672273,-1,1160,2165,40
48862024155,48862024150,-5,1041,3029,40
48862185068,48862185086,18,1003,4105,40
48862912710,48862912713,3,1998,1721,40
48866052281,48866052274,-7,1157,4018,40
48866706492,48866706509,17,889,5285,40
48868255062,48868255070,8,243,1124,40
48871190510,48871190503,-7,1072,3691,40
48872740421,48872740413,-8,1337,5486,40
48877249730,48877249729,-1,948,2803,40
48886513046,48886513040,-6,916,2711,40
48886565631,48886565619,-12,1520,4846,40
48887826734,48887826729,-5,1574,3683,40
48892230370,48892230386,16,269,911,40
48908171078,48908171073,-5,765,3566,40
48911267733,48911267734,1,1574,1136,40
48912327839,48912327833,-6,800,3130,40
48918920385,48918920381,-4,666,3948,40
48928028891,48928028885,-6,1115,5869,40
48935046750,48935046744,-6,1627,2500,40
48940788634,48940788628,-6,1293,8250,40
48942037609,48942037603,-6,865,3434,40
48944108997,48944109002,5,4086,1281,40
48948805796,48948805790,-6,839,4176,40
48949824286,48949824283,-3,1450,3560,40
48953926695,48953926689,-6,1134,3535,40
48954118015,48954118007,-8,1385,5224,40
48954425813,48954425794,-19,242,1728,40
48961256773,48961256793,20,241,1773,40
48963882883,48963882881,-2,1032,2044,40
48964284758,48964284774,16,305,1157,40
48965535433,48965535426,-7,977,3966,40
48975380046,48975380044,-2,460,2155,40
48980953275,48980953270,-5,1206,4272,40
48985754934,48985754929,-5,1092,3083,40
48989904686,48989904678,-8,1508,4509,40
48992823279,48992823269,-10,935,3204,40
48992904997,48992905015,18,407,1109,40
48996024946,48996024941,-5,1263,156,40
48999178846,48999178861,15,298,2155,40
49002945147,49002945142,-5,615,2881,40
49003320093,49003320082,-11,276,1025,40
49003452166,49003452165,-1,220,1096,40
49012189425,49012189419,-6,780,2801,40
49012739626,49012739622,-4,1306,3356,40
49016172031,49016172029,-2,1129,1525,40
49016793702,49016793698,-4,983,4029,40
49017822845,49017822866,21,84,847,40
49026123559,49026123558,-1,1316,2294,40
49029231359,49029231360,1,3010,3388,40
49029322204,49029322203,-1,1921,2057,40
49032022636,49032022630,-6,1457,3623,40
49041859851,49041859846,-5,1479,5135,40
49042344685,49042344685,0,1519,1712,40
49048981957,49048981950,-7,602,1832,40
49051606820,49051606814,-6,2099,5080,40
49054826369,49054826363,-6,1122,2393,40
49055424662,49055424678,16,231,2608,40
49061020405,49061020400,-5,947,4496,40
49061396086,49061396081,-5,1143,5364,40
49061657852,49061657846,-6,60,1331,40
49062450834,49062450834,0,1785,1768,40
49062523211,49062523203,-8,1144,4405,40
49062798366,49062798361,-5,819,3842,40
49062878741,49062878751,10,192,587,40
49066727813,49066727806,-7,846,3513,40
49066778478,49066778486,8,187,938,40
49069125709,49069125705,-4,998,3570,40
49074572615,49074572607,-8,877,3340,40
49075596056,49075596058,2,4007,3533,40
49077401822,49077401817,-5,835,2688,40
49083593491,49083593484,-7,1272,5127,40
49094078273,49094078265,-8,1363,3467,40
49099784787,49099784781,-6,731,3163,40
49100087302,49100087318,16,237,566,40
49104268430,49104268425,-5,1326,3151,40
49108447768,49108447770,2,3493,3367,40
49114866206,49114866200,-6,902,3879,40
49122319467,49122319463,-4,623,2719,40
49124093898,49124093892,-6,876,4326,40
49128478114,49128478110,-4,577,3494,40
49128512936,49128512955,19,1091,4059,40
49132802261,49132802255,-6,982,3175,40
49135271368,49135271361,-7,1007,4737,40
49141266258,49141266251,-7,1429,3820,40
49143897898,49143897903,5,1827,1571,40
49144793941,49144793935,-6,1047,2750,40
49145124640,49145124652,12,540,1725,40
49149734637,49149734631,-6,976,3942,40
49150445361,49150445354,-7,1150,4557,40
49151288595,49151288589,-6,1011,2581,40
49151895048,49151895027,-21,1047,3841,40
49154217103,49154217097,-6,1514,3959,40
49154708359,49154708357,-2,37,746,40
49158663964,49158663966,2,16085,14578,40
49161727371,49161727358,-13,84,1253,40
49162130300,49162130313,13,153,1094,40
49162339448,49162339466,18,801,3569,40
49167555850,49167555842,-8,1288,4721,40
49174667513,49174667508,-5,708,4627,40
49174804864,49174804882,18,383,2248,40
49176532226,49176532219,-7,790,1956,40
49186892150,49186892144,-6,833,3350,40
49189453675,49189453669,-6,1032,4014,40
49189721985,49189721978,-7,675,3197,40
49199745930,49199745925,-5,1385,4550,40
49200491438,49200491423,-15,315,1239,40
49203138167,49203138162,-5,896,3081,40
49211525762,49211525754,-8,1275,3698,40
49212816122,49212816118,-4,862,3301,40
49221353780,49221353756,-24,23,519,40
49222932458,49222932453,-5,1169,4463,40
49230740451,49230740446,-5,705,2485,40
49230878904,49230878923,19,117,1057,40
49235304211,49235304205,-6,1058,3298,40
49235951320,49235951338,18,185,842,40
49244020347,49244020349,2,1813,1250,40
49247887654,49247887649,-5,1365,3530,40
49248939472,49248939466,-6,1394,2615,40
49250129266,49250129262,-4,812,2806,40
49256470211,49256470206,-5,1038,4309,40
49257733038,49257733026,-12,1089,3462,40
49259825969,49259825963,-6,882,5139,40
49259933176,49259933188,12,1157,4343,40
49262054367,49262054363,-4,1052,3846,40
49265990266,49265990259,-7,680,3435,40
49266364109,49266364098,-11,300,2697,40
49274263912,49274263917,5,25554,23324,40
49287634841,49287634833,-8,1050,4804,40
49289508871,49289508891,20,177,1994,40
49293093818,49293093817,-1,1035,3309,40
49296458929,49296458922,-7,1186,3351,40
49301622979,49301622973,-6,726,3266,40
49302243784,49302243799,15,226,990,40
49305043998,49305044018,20,198,760,40
49307217725,49307217718,-7,1037,3722,40
49314512143,49314512138,-5,964,3005,40
49317357259,49317357254,-5,897,2621,40
49318099117,49318099138,21,1225,5453,40
49323253422,49323253417,-5,1453,4214,40
49325414967,49325414962,-5,859,3669,40
49325889278,49325889291,13,332,1742,40
49334915167,49334915161,-6,1833,6225,40
49342197622,49342197618,-4,917,3169,40
49347950047,49347950042,-5,1422,4213,40
49347980718,49347980710,-8,856,3433,40
49354681775,49354681770,-5,910,4373,40
49354741799,49354741787,-12,784,3034,40
49354870796,49354870813,17,183,755,40
49357727706,49357727701,-5,1234,3377,40
49361749755,49361749756,1,987,1440,40
49362051358,49362051352,-6,1037,3431,40
49378858165,49378858158,-7,1162,4147,40
49380715186,49380715179,-7,1013,3773,40
49389611188,49389611182,-6,1060,4947,40
49391194542,49391194536,-6,858,3784,40
49395767333,49395767327,-6,1213,4096,40
49399890578,49399890581,3,1549,1293,40
49404118171,49404118167,-4,765,1897,40
49407033269,49407033261,-8,1634,4726,40
49408534029,49408534022,-7,1215,4557,40
49413756086,49413756079,-7,649,2924,40
49415101867,49415101860,-7,1085,3376,40
49419471899,49419471893,-6,1426,5762,40
49420815343,49420815338,-5,1084,4459,40
49423437826,49423437822,-4,969,1864,40
49427541179,49427541174,-5,1245,2732,40
49433659585,49433659584,-1,1798,2220,40
49435246018,49435246013,-5,509,1858,40
49435641079,49435641093,14,538,1530,40
49448019693,49448019687,-6,1363,3810,40
49458347142,49458347136,-6,928,3391,40
49459597708,49459597701,-7,958,3659,40
49462292095,49462292089,-6,1219,4303,40
49465623015,49465623010,-5,967,3048,40
49479231102,49479231097,-5,967,3998,40
49479736579,49479736573,-6,1309,4436,40
49481683818,49481683822,4,3254,3012,40
49483938198,49483938206,8,190,1124,40
49485055919,49485055912,-7,1089,3979,40
49486659117,49486659111,-6,934,3822,40
49494454525,49494454530,5,1902,1164,40
49495804143,49495804137,-6,1176,2746,40
49503493881,49503493876,-5,781,3573,40
49506127234,49506127229,-5,643,970,40
49519509781,49519509775,-6,989,4195,40
49522861310,49522861313,3,793,2886,40
49523274036,49523274018,-18,282,905,40
49524087875,49524087870,-5,647,3107,40
49525258663,49525258676,13,530,1225,40
49536604325,49536604342,17,439,1442,40
49539009632,49539009626,-6,759,4112,40
49541412517,49541412510,-7,1015,6342,40
49542074678,49542074673,-5,1141,3904,40
49542699758,49542699778,20,250,1042,40
49543270710,49543270730,20,868,1783,40
49545834597,49545834590,-7,765,4642,40
49550291096,49550291089,-7,900,3337,40
49554047695,49554047690,-5,1247,3862,40
49567343834,49567343828,-6,608,3219,40
49567663118,49567663113,-5,1156,4730,40
49568878458,49568878453,-5,840,4855,40
49570053469,49570053462,-7,822,3066,40
49571022595,49571022590,-5,725,3252,40
49573050200,49573050195,-5,173,858,40
49597065232,49597065227,-5,1088,3384,40
49601154274,49601154278,4,1252,1129,40
49618870299,49618870294,-5,882,4151,40
49619768910,49619768905,-5,1080,2981,40
49626098091,49626098086,-5,1456,3291,40
49627410295,49627410290,-5,760,3687,40
49631132175,49631132169,-6,645,1202,40
49634959485,49634959480,-5,1307,4215,40
49650185240,49650185234,-6,1483,2975,40
49660830057,49660830054,-3,6200,17564,40
49662398519,49662398514,-5,887,2355,40
49665333362,49665333357,-5,1254,5114,40
49671625031,49671625025,-6,733,2299,40
49672973630,49672973635,5,5933,2934,40
49680787143,49680787137,-6,1628,4297,40
49682463108,49682463108,0,1682,2519,40
49682825987,49682825983,-4,46861,18421,40
49687909225,49687909220,-5,1040,4141,40
49688562974,49688562974,0,1578,2260,40
49689493722,49689493717,-5,1003,2575,40
49701487406,49701487399,-7,1089,4028,40
49707737010,49707737011,1,2912,3318,40
49709550363,49709550346,-17,181,1245,40
49712785309,49712785302,-7,1491,3962,40
49713965002,49713964998,-4,977,2465,40
49714004333,49714004342,9,196,704,40
49715328014,49715328035,21,138,731,40
49716140553,49716140552,-1,26865,5477,40
49718376870,49718376863,-7,826,4228,40
49718790078,49718790092,14,1451,5471,40
49721778381,49721778374,-7,879,3004,40
49722139723,49722139716,-7,1129,4939,40
49722409063,49722409060,-3,1372,1889,40
49727130258,49727130255,-3,1764,3990,40
49743835715,49743835710,-5,964,3056,40
49747656866,49747656861,-5,1248,5063,40
49750876088,49750876082,-6,1231,3900,40
49754303075,49754303069,-6,731,2952,40
49756334450,49756334444,-6,989,3537,40
49756610750,49756610744,-6,1227,3544,40
49770675438,49770675433,-5,1261,4499,40
49773102268,49773102263,-5,1260,2626,40
49777334353,49777334348,-5,400,1531,40
49784828086,49784828081,-5,985,2101,40
49785603165,49785603158,-7,33,1200,40
49786838173,49786838166,-7,1029,3111,40
49788419665,49788419661,-4,787,2792,40
49788858935,49788858931,-4,1166,2503,40
49789305548,49789305562,14,287,1584,40
49794909321,49794909340,19,369,1214,40
49795710932,49795710916,-16,3031,1098,40
49797703690,49797703709,19,208,1762,40
49799860442,49799860437,-5,1129,3186,40
49801932238,49801932231,-7,785,2691,40
49811622741,49811622741,0,2484,2291,40
49813225110,49813225106,-4,1240,2974,40
49816516167,49816516164,-3,1372,2291,40
49818806942,49818806937,-5,654,2081,40
49824139128,49824139133,5,1848,1220,40
49827978407,49827978406,-1,1486,3361,40
49828940082,49828940077,-5,899,2829,40
49829513464,49829513480,16,163,1232,40
49832497042,49832497041,-1,170,1511,40
49836060258,49836060253,-5,1434,4087,40
49840767175,49840767169,-6,770,3193,40
49840997168,49840997186,18,79,1708,40
49841895254,49841895252,-2,1282,1637,40
49845790628,49845790622,-6,1000,3889,40
49857192671,49857192666,-5,1069,4775,40
49861611361,49861611356,-5,1006,3513,40
49862906437,49862906431,-6,1304,4369,40
49863249373,49863249362,-11,167,1431,40
49865520516,49865520534,18,350,1490,40
49867378042,49867378039,-3,407,927,40
49867421742,49867421763,21,714,2659,40
49869319430,49869319424,-6,945,4026,40
49873789739,49873789733,-6,835,3792,40
49873952524,49873952541,17,1121,3823,40
49875690774,49875690773,-1,2099,4809,40
49877618418,49877618414,-4,743,3382,40
49905132735,49905132729,-6,1507,4631,40
49905318937,49905318930,-7,997,3897,40
49907233854,49907233858,4,2467,1106,40
49908674238,49908674233,-5,835,3524,40
49915852650,49915852655,5,2756,1211,40
49938399294,49938399286,-8,667,3096,40
49939023957,49939023953,-4,1223,2885,40
49939182382,49939182399,17,207,945,40
49939981022,49939981042,20,294,2276,40
49945997273,49945997269,-4,716,2116,40
49947783650,49947783645,-5,1180,2832,40
49949542794,49949542789,-5,958,3863,40
49950123039,49950123017,-22,220,1402,40
49951462410,49951462406,-4,1343,3945,40
49951663311,49951663297,-14,141,1294,40
49951864932,49951864914,-18,31,903,40
49952899405,49952899390,-15,150,1154,40
49954363092,49954363095,3,3050,1732,40
49957127460,49957127455,-5,1400,5032,40
49965205422,49965205416,-6,894,3337,40
49967207745,49967207737,-8,1305,4879,40
49982615814,49982615809,-5,53335,124177,40
49984314154,49984314150,-4,972,2966,40
49986637851,49986637845,-6,1268,3611,40
49986671278,49986671290,12,321,1707,40
49987635511,49987635505,-6,1173,3656,40
49994893671,49994893665,-6,958,4235,40
49996194068,49996194089,21,626,4420,40
49998663656,49998663649,-7,796,4459,40
49999079597,49999079585,-12,449,1103,40
50002170341,50002170335,-6,1283,4660,40
50004113257,50004113254,-3,1013,1425,40
50011611616,50011611616,0,26820,24299,40
50016770730,50016770725,-5,835,3225,40
50023921870,50023921864,-6,959,3994,40
50025046785,50025046778,-7,850,3447,40
50025451973,50025451971,-2,216,1370,40
50029175091,50029175083,-8,886,3794,40
50032374825,50032374830,5,10122,24238,40
50045790891,50045790893,2,1386,1183,40
50048570613,50048570606,-7,797,2931,40
50048965340,50048965363,23,144,771,40
50049180951,50049180970,19,539,4060,40
50050401779,50050401773,-6,1046,2686,40
50052759411,50052759406,-5,1266,4400,40
50053201558,50053201579,21,796,2924,40
50056245477,50056245471,-6,937,3510,40
50057580833,50057580826,-7,1714,8916,40
50067256100,50067256095,-5,774,2752,40
50068308764,50068308746,-18,1373,2068,40
50068782851,50068782844,-7,1083,3638,40
50069042167,50069042182,15,255,1478,40
50076323391,50076323388,-3,1274,3080,40
50082421291,50082421286,-5,821,2937,40
50083516815,50083516806,-9,217,927,40
50093696891,50093696885,-6,683,3522,40
50095841834,50095841834,0,2073,2301,40
50109231127,50109231121,-6,811,3382,40
50109574701,50109574696,-5,1363,4322,40
50110141605,50110141587,-18,1430,2218,40
50117846673,50117846687,14,17696,40562,40
50118349665,50118349658,-7,2088,7322,40
50127547743,50127547738,-5,650,2656,40
50143336410,50143336406,-4,801,4161,40
50150335982,50150335975,-7,1044,3720,40
50151070460,50151070453,-7,1097,4619,40
50161172571,50161172565,-6,1324,4862,40
50165344902,50165344894,-8,559,39,40
50165795383,50165795370,-13,203,990,40
50171173060,50171173074,14,167,968,40
50177169390,50177169374,-16,1187,592,40
50182267299,50182267294,-5,1300,3284,40
50183598811,50183598805,-6,828,3036,40
50197786417,50197786419,2,1560,1560,40
50205395829,50205395821,-8,737,2617,40
50205699743,50205699730,-13,52,1009,40
50213544054,50213544054,0,1263,1259,40
50218371579,50218371574,-5,1121,3207,40
50219259840,50219259833,-7,26,888,40
50225189855,50225189860,5,3170,2317,40
50234031323,50234031317,-6,966,2165,40
50234707084,50234707101,17,791,2714,40
50237016290,50237016293,3,947,1079,40
50242715139,50242715133,-6,1079,4902,40
50247304023,50247304019,-4,1047,3579,40
50248565705,50248565698,-7,1278,3829,40
50249094790,50249094786,-4,931,3484,40
50250176814,50250176809,-5,826,5893,40
50250305716,50250305730,14,518,2535,40
50251387883,50251387879,-4,906,3055,40
50251660688,50251660699,11,243,1440,40
50252974367,50252974362,-5,963,3469,40
50253834121,50253834139,18,607,1015,40
50255708981,50255708975,-6,1167,3231,40
50255984479,50255984471,-8,952,3203,40
50256520257,50256520259,2,1297,839,40
50258877982,50258877982,0,902,1902,40
50260687515,50260687506,-9,1328,4622,40
50262834576,50262834570,-6,847,3104,40
50263906362,50263906356,-6,1530,4457,40
50265911316,50265911334,18,859,3383,40
50271369598,50271369592,-6,829,4031,40
50272257994,50272258000,6,4695,2839,40
50273237128,50273237122,-6,953,2772,40
50273927677,50273927692,15,312,1253,40
50277611123,50277611118,-5,1060,3360,40
50279815768,50279815761,-7,967,3431,40
50281334762,50281334757,-5,1047,4003,40
50282350361,50282350356,-5,761,2843,40
50286969881,50286969878,-3,1071,2751,40
50295401010,50295401004,-6,908,3633,40
50300319262,50300319255,-7,326,847,40
50302643045,50302643045,0,1204,1748,40
50305477392,50305477391,-1,1649,1433,40
50313215974,50313215968,-6,1211,5896,40
50317120073,50317120076,3,12179,20959,40
50320346673,50320346686,13,15418,50154,40
50330596169,50330596164,-5,901,2502,40
50331015373,50331015386,13,125,688,40
50338185270,50338185277,7,3669,1409,40
50340566005,50340565999,-6,888,4897,40
50341093070,50341093090,20,128,1427,40
50349232318,50349232313,-5,1083,3351,40
50356079328,50356079323,-5,1381,2840,40
50358652393,50358652389,-4,548,3298,40
50363071642,50363071636,-6,1115,3230,40
50370110875,50370110869,-6,1534,3336,40
50372191678,50372191656,-22,1829,786,40
50377937281,50377937275,-6,1368,4769,40
50380593233,50380593227,-6,1326,2302,40
50386388250,50386388242,-8,871,4060,40
50386636528,50386636531,3,107,1144,40
50387160449,50387160446,-3,1159,2374,40
50391498915,50391498908,-7,680,4148,40
50392199399,50392199404,5,3379,2264,40
50394354979,50394354974,-5,1043,2408,40
50395102261,50395102274,13,106,747,40
50395456510,50395456530,20,1034,3197,40
50403500090,50403500084,-6,1000,4136,40
50405320913,50405320893,-20,1456,1049,40
50414905354,50414905349,-5,1585,4817,40
50416074410,50416074405,-5,1144,3978,40
50422909650,50422909645,-5,1187,3647,40
50424084772,50424084774,2,1313,1197,40
50432756957,50432756952,-5,1352,4232,40
50437361615,50437361609,-6,998,5601,40
50442880721,50442880714,-7,742,1991,40
50444680851,50444680849,-2,795,1729,40
50451921778,50451921771,-7,936,3589,40
50452978873,50452978876,3,3063,1998,40
50453412028,50453412022,-6,734,4466,40
50456747940,50456747941,1,48,1000,40
50458037243,50458037236,-7,644,4097,40
50461604945,50461604939,-6,782,3040,40
50462038884,50462038906,22,106,1624,40
50462478470,50462478465,-5,624,1982,40
50470381491,50470381493,2,1784,1524,40
50470731403,50470731397,-6,644,4269,40
50471123436,50471123458,22,658,2621,40
50472006682,50472006677,-5,564,2923,40
50474421595,50474421590,-5,896,3460,40
50478090351,50478090346,-5,876,3317,40
50490477817,50490477809,-8,1139,3958,40
50490927164,50490927181,17,284,2244,40
50492348247,50492348262,15,612,1677,40
50495250109,50495250106,-3,659,2971,40
50495362550,50495362546,-4,412,1102,40
50500468132,50500468127,-5,931,3348,40
50505157047,50505157061,14,16293,24854,40
50517770006,50517770018,12,145,743,40
50518184053,50518184038,-15,4541,1436,40
50525331750,50525331744,-6,929,3619,40
50530761115,50530761109,-6,687,3100,40
50533857382,50533857376,-6,1078,3479,40
50535969230,50535969222,-8,692,3195,40
50538764866,50538764859,-7,613,2422,40
50539052883,50539052878,-5,1020,3725,40
50541224042,50541224037,-5,1326,4707,40
50541345783,50541345778,-5,907,1579,40
50541965894,50541965889,-5,711,4312,40
50546104010,50546104006,-4,662,2583,40
50546322796,50546322790,-6,1146,4259,40
50572540693,50572540687,-6,464,3447,40
50572860750,50572860754,4,1111,1355,40
50581088619,50581088614,-5,1066,3085,40
50582725974,50582725969,-5,1177,3755,40
50589665314,50589665309,-5,872,3378,40
50592435999,50592435994,-5,1155,2974,40
50593209408,50593209413,5,4133,2139,40
50595799540,50595799533,-7,914,4454,40
50596678611,50596678605,-6,750,3099,40
50596932215,50596932209,-6,147,1137,40
50596977119,50596977139,20,1542,3777,40
50598202368,50598202362,-6,983,2934,40
50598301989,50598302011,22,858,3096,40
50603734678,50603734672,-6,1064,4092,40
50604648013,50604648007,-6,1081,3783,40
50609151363,50609151357,-6,732,3290,40
50626959422,50626959416,-6,1339,3760,40
50627042824,50627042840,16,321,1694,40
50631676373,50631676376,3,3693,2952,40
50633980645,50633980640,-5,972,4850,40
50635022452,50635022457,5,1814,1023,40
50637198014,50637198012,-2,1570,3026,40
50641937949,50641937943,-6,1208,3900,40
50671123063,50671123057,-6,1041,3695,40
50673735553,50673735550,-3,1191,3869,40
50674765103,50674765097,-6,1313,3700,40
50675334753,50675334746,-7,901,3156,40
50676785741,50676785746,5,2795,1181,40
50681442321,50681442316,-5,987,4092,40
50685114282,50685114275,-7,822,3505,40
50686608592,50686608606,14,806,3982,40
50692483353,50692483351,-2,970,1621,40
50695988116,50695988109,-7,792,4300,40
50696156203,50696156197,-6,889,2414,40
50697073166,50697073182,16,944,3995,40
50703063729,50703063726,-3,869,2787,40
50703103551,50703103544,-7,969,3323,40
50704847878,50704847875,-3,695,1743,40
50708591550,50708591544,-6,703,2912,40
50710134595,50710134590,-5,834,2020,40
50722682563,50722682557,-6,857,5119,40
50722752951,50722752933,-18,288,1515,40
50724013887,50724013901,14,1177,4819,40
50724668517,50724668523,6,3597,1218,40
50725625999,50725625993,-6,750,2770,40
50727250097,50727250089,-8,660,2720,40
50731115117,50731115110,-7,914,4231,40
50731857478,50731857478,0,1781,2082,40
50734013625,50734013621,-4,598,1784,40
50734152432,50734152425,-7,1034,4648,40
50736179066,50736179069,3,1571,1393,40
50740436795,50740436790,-5,661,2758,40
50740926460,50740926446,-14,799,1486,40
50740955141,50740955162,21,443,1648,40
50744766853,50744766847,-6,1286,3656,40
50746159860,50746159869,9,14459,42133,40
50749340131,50749340125,-6,827,2768,40
50755039136,50755039131,-5,1181,4729,40
50757225487,50757225479,-8,941,3448,40
50774050550,50774050544,-6,565,3067,40
50774105436,50774105453,17,795,3259,40
50774471488,50774471483,-5,903,3107,40
50775337827,50775337822,-5,1163,3276,40
50779539858,50779539850,-8,1270,5026,40
50781855719,50781855714,-5,642,2975,40
50784714973,50784714973,0,1031,1482,40
50788151103,50788151097,-6,1444,4550,40
50798973722,50798973714,-8,1165,4304,40
50799138817,50799138820,3,1844,1238,40
50800170886,50800170880,-6,866,3259,40
50805058658,50805058653,-5,910,4579,40
50807016301,50807016302,1,1631,1783,40
50808460195,50808460186,-9,1103,4073,40
50813270664,50813270656,-8,1305,3568,40
50815413343,50815413338,-5,1094,3623,40
50815781048,50815781058,10,696,2880,40
50820373978,50820373973,-5,1172,3485,40
50823823528,50823823525,-3,1169,1882,40
50828317119,50828317114,-5,1073,3120,40
50828356696,50828356712,16,879,3501,40
50836946359,50836946353,-6,927,2886,40
50841626674,50841626670,-4,912,3244,40
50846200526,50846200521,-5,1382,3054,40
50847619485,50847619466,-19,97,1673,40
50850437228,50850437222,-6,1124,2772,40
50853742334,50853742326,-8,723,3245,40
50858890014,50858890015,1,1754,1597,40
50866178734,50866178733,-1,34790,59218,40
50870669084,50870669079,-5,907,3470,40
50870698917,50870698910,-7,355,681,40
50871066672,50871066678,6,155,1170,40
50873715934,50873715926,-8,1023,4055,40
50878849735,50878849729,-6,669,3079,40
50880416535,50880416528,-7,982,3968,40
50882432511,50882432530,19,783,4999,40
50883621123,50883621118,-5,1062,3803,40
50886155843,50886155837,-6,968,4118,40
50890620992,50890620985,-7,963,3089,40
50891510042,50891510036,-6,1104,4472,40
50902750118,50902750111,-7,847,2822,40
50906438094,50906438088,-6,1141,4292,40
50907491616,50907491610,-6,1016,3819,40
50908542866,50908542858,-8,693,3344,40
50910481028,50910481022,-6,1303,3855,40
50910684812,50910684804,-8,1259,2746,40
50915641935,50915641938,3,1772,1019,40
50917379957,50917379963,6,2002,1154,40
50919860935,50919860934,-1,994,3037,40
50920725302,50920725298,-4,890,3351,40
50922399085,50922399082,-3,1142,3288,40
50922547049,50922547041,-8,1085,3526,40
50936491825,50936491818,-7,1138,3017,40
50936874951,50936874947,-4,564,2238,40
50937068910,50937068922,12,217,1063,40
50941848990,50941848997,7,4969,2115,40
50942054154,50942054147,-7,744,2916,40
50942170632,50942170629,-3,1282,2823,40
50948587947,50948587945,-2,1266,1506,40
50949450717,50949450726,9,168,830,40
50950235286,50950235281,-5,239,1044,40
50951249087,50951249081,-6,1054,3302,40
50952676126,50952676120,-6,1091,3502,40
50954201631,50954201626,-5,1097,4447,40
50955796218,50955796210,-8,763,1989,40
50956289919,50956289925,6,138,1127,40
50956936471,50956936466,-5,1270,2774,40
50957966716,50957966721,5,2609,1279,40
50960739138,50960739132,-6,945,3737,40
50966667818,50966667811,-7,1461,3792,40
50967106412,50967106403,-9,272,1197,40
50967661511,50967661502,-9,985,3137,40
50971830299,50971830294,-5,1021,3756,40
50982550548,50982550540,-8,1577,3669,40
50986704342,50986704334,-8,1198,5574,40
50987296112,50987296119,7,112,889,40
50991688402,50991688394,-8,737,2131,40
50997372187,50997372179,-8,1083,3711,40
50999382393,50999382391,-2,4735,9689,40
51006942453,51006942445,-8,1179,3863,40
51015598437,51015598449,12,12924,47166,40
51018710510,51018710505,-5,605,3179,40
51019529462,51019529483,21,1348,4273,40
51024982948,51024982943,-5,986,4091,40
51033203433,51033203425,-8,669,3780,40
51040101087,51040101083,-4,604,1218,40
51042580725,51042580719,-6,997,4033,40
51043524907,51043524901,-6,1052,3856,40
51044440613,51044440606,-7,1413,5031,40
51053992636,51053992631,-5,959,3247,40
51061262851,51061262846,-5,1255,4031,40
51063620763,51063620767,4,1978,1043,40
51063778043,51063778043,0,2129,3961,40
51069570164,51069570157,-7,814,2178,40
51071865265,51071865272,7,1811,1036,40
51086605945,51086605942,-3,1220,1498,40
51090219431,51090219424,-7,939,2608,40
51096889818,51096889813,-5,1044,3532,40
51097424270,51097424278,8,286,1478,40
51104185263,51104185257,-6,1108,3266,40
51105982315,51105982308,-7,931,2163,40
51107033198,51107033193,-5,1193,2787,40
51107461488,51107461482,-6,1191,5430,40
51110247334,51110247326,-8,1222,4252,40
51116460912,51116460907,-5,735,3366,40
51121254197,51121254191,-6,723,2184,40
51121493551,51121493569,18,297,1132,40
51122250603,51122250602,-1,1359,2624,40
51125454026,51125454018,-8,872,3147,40
51125489948,51125489958,10,174,1311,40
51125899952,51125899963,11,579,2373,40
51129200634,51129200628,-6,778,3502,40
51129492223,51129492218,-5,879,5107,40
51133318210,51133318206,-4,721,3360,40
51133410388,51133410382,-6,260,1584,40
51133640816,51133640832,16,685,2167,40
51138845261,51138845261,0,1735,3318,40
51139376885,51139376865,-20,832,2746,40
51139413199,51139413189,-10,129,1559,40
51139684135,51139684126,-9,757,4446,40
51139799023,51139799009,-14,1964,7026,40
51141089501,51141089494,-7,1078,3416,40
51146138157,51146138158,1,1529,1620,40
51147137662,51147137663,1,2216,1858,40
51149061374,51149061379,5,1950,1213,40
51150642113,51150642107,-6,817,4396,40
51152633917,51152633920,3,3124,1436,40
51157997723,51157997718,-5,1234,2873,40
51158253082,51158253077,-5,878,5391,40
51159122432,51159122449,17,306,2028,40
51172903179,51172903173,-6,1306,4282,40
51173753047,51173753042,-5,1619,4107,40
51173812478,51173812473,-5,1026,4055,40
51174022845,51174022839,-6,666,2817,40
51174307175,51174307182,7,219,1394,40
51175588865,51175588857,-8,873,4418,40
51176057737,51176057741,4,2519,1459,40
51183247151,51183247145,-6,891,3492,40
51183950460,51183950455,-5,1198,2548,40
51189745542,51189745535,-7,1168,2594,40
51191833755,51191833749,-6,1004,2956,40
51194650626,51194650619,-7,735,3236,40
51194839638,51194839632,-6,1134,4726,40
51199971506,51199971497,-9,638,1991,40
51205199625,51205199618,-7,851,4288,40
51211193603,51211193586,-17,164,908,40
51217597160,51217597154,-6,1038,3285,40
51219169164,51219169158,-6,1189,4256,40
51221850290,51221850283,-7,291,1213,40
51227701737,51227701741,4,1759,1039,40
51232496853,51232496848,-5,942,3768,40
51233882899,51233882895,-4,1959,5886,40
51234830614,51234830608,-6,854,4044,40
51242405156,51242405168,12,810,3662,40
51247883582,51247883577,-5,933,3887,40
51247912266,51247912260,-6,915,5373,40
51253469582,51253469582,0,2339,4774,40
51253987494,51253987488,-6,1060,2716,40
51254047159,51254047153,-6,2765,10534,40
51254212707,51254212702,-5,1003,3573,40
51254902055,51254902073,18,298,1316,40
51257727899,51257727894,-5,927,3690,40
51257909039,51257909033,-6,928,3170,40
51258860487,51258860482,-5,506,2011,40
51270715782,51270715777,-5,1012,3371,40
51279308475,51279308467,-8,975,4103,40
51281191113,51281191116,3,2630,2972,40
51281290262,51281290257,-5,699,2092,40
51281592031,51281592022,-9,684,1830,40
51282165701,51282165694,-7,212,820,40
51282869695,51282869696,1,142,1582,40
51283445760,51283445754,-6,1023,3198,40
51285389630,51285389624,-6,870,2374,40
51285932327,51285932322,-5,1407,5249,40
51286227995,51286227989,-6,1122,2030,40
51287560823,51287560817,-6,972,3144,40
51295755347,51295755342,-5,897,3203,40
51295908101,51295908115,14,150,1347,40
51296020774,51296020779,5,5178,3099,40
51303994958,51303994955,-3,609,1145,40
51310348766,51310348761,-5,101,1438,40
51317010470,51317010463,-7,984,3079,40
51317720029,51317720015,-14,797,4077,40
51321043438,51321043435,-3,1624,3608,40
51325334727,51325334743,16,1068,1064,40
51332701591,51332701585,-6,1433,5557,40
51339236506,51339236499,-7,689,2613,40
51341572257,51341572250,-7,1504,4233,40
51342764179,51342764173,-6,1008,3991,40
51350211390,51350211383,-7,1199,4475,40
51350406142,51350406135,-7,1187,3567,40
51360026068,51360026071,3,51,986,40
51362130159,51362130153,-6,788,2714,40
51365321469,51365321462,-7,1130,3769,40
51365545511,51365545506,-5,612,2762,40
51366070131,51366070126,-5,881,2516,40
51367753411,51367753406,-5,911,3713,40
51368205805,51368205798,-7,872,4115,40
51376950839,51376950832,-7,983,3549,40
51377641116,51377641121,5,257,1524,40
51377941626,51377941631,5,4847,2214,40
51380308615,51380308609,-6,1145,4333,40
51386625926,51386625920,-6,1159,4346,40
51392881343,51392881336,-7,1208,4257,40
51394023572,51394023558,-14,764,3093,40
51394168151,51394168145,-6,549,2802,40
51395282829,51395282813,-16,193,1624,40
51396576131,51396576122,-9,784,3105,40
51398385017,51398385010,-7,1372,3557,40
51398827838,51398827829,-9,296,929,40
51405472987,51405472981,-6,849,4866,40
51416215387,51416215381,-6,589,2008,40
51416457772,51416457774,2,1961,1523,40
51416912255,51416912251,-4,1094,4768,40
51416961670,51416961658,-12,368,1283,40
51418304733,51418304734,1,294,1108,40
51418387270,51418387289,19,626,2472,40
51429176701,51429176693,-8,809,3356,40
51429344967,51429344961,-6,1027,3657,40
51443454522,51443454522,0,921,1165,40
51448277174,51448277168,-6,758,4082,40
51455419123,51455419116,-7,665,2530,40
51456187239,51456187258,19,208,793,40
51460725540,51460725533,-7,1487,3864,40
51464439614,51464439607,-7,1155,3390,40
51464683785,51464683779,-6,496,1197,40
51464873119,51464873135,16,193,1289,40
51469550098,51469550093,-5,922,3838,40
51469689173,51469689154,-19,122,615,40
51469859669,51469859650,-19,8,1431,40
51486824430,51486824424,-6,42958,4057,40
51499078245,51499078238,-7,1070,3409,40
51499130505,51499130511,6,4499,1558,40
51501158538,51501158542,4,2848,1632,40
51505202792,51505202794,2,2986,1778,40
51513962908,51513962910,2,1442,1280,40
51514809391,51514809382,-9,1171,3672,40
51526750483,51526750477,-6,893,3369,40
51533003955,51533003948,-7,1254,4536,40
51533982381,51533982377,-4,848,3050,40
51534685466,51534685460,-6,710,2838,40
51546536926,51546536921,-5,1005,4100,40
51547531191,51547531178,-13,10679,42517,40
51549352767,51549352762,-5,1324,3201,40
51549409286,51549409303,17,485,1683,40
51549450818,51549450814,-4,635,2089,40
51549526582,51549526600,18,95,1123,40
51551105643,51551105637,-6,1047,3919,40
51551877690,51551877684,-6,901,2901,40
51553956423,51553956418,-5,1061,2728,40
51556172850,51556172846,-4,863,4122,40
51563611506,51563611500,-6,1271,2315,40
51564201794,51564201789,-5,818,3280,40
51566565184,51566565179,-5,843,2656,40
51569136658,51569136662,4,3081,1396,40
51570785089,51570785091,2,1715,1165,40
51573499231,51573499227,-4,1492,2942,40
51576397077,51576397076,-1,1708,2883,40
51588236914,51588236909,-5,996,3435,40
51589132806,51589132797,-9,257,1151,40
51598701488,51598701485,-3,1457,3722,40
51601696000,51601695994,-6,1174,4958,40
51606562460,51606562454,-6,779,3399,40
51612958366,51612958363,-3,1264,2373,40
51616188262,51616188256,-6,582,2638,40
51620865509,51620865510,1,1449,1843,40
51634379851,51634379845,-6,783,2506,40
51635614153,51635614152,-1,1598,2611,40
51637295710,51637295702,-8,833,3590,40
51637761960,51637761972,12,170,1243,40
51637920733,51637920749,16,1329,2963,40
51637946983,51637946974,-9,926,3329,40
51638678494,51638678486,-8,521,1959,40
51639956359,51639956359,0,860,1097,40
51642539742,51642539737,-5,797,2434,40
51642705412,51642705399,-13,133,997,40
51644150814,51644150797,-17,73,1229,40
51645472534,51645472530,-4,1037,4809,40
51655783334,51655783327,-7,957,4059,40
51657007164,51657007160,-4,197,1217,40
51657531494,51657531482,-12,175,946,40
51665735963,51665735957,-6,875,3787,40
51675528474,51675528470,-4,768,2451,40
51680861991,51680861991,0,788,1196,40
51689280698,51689280693,-5,1080,3341,40
51708718925,51708718919,-6,791,2710,40
51709272247,51709272267,20,937,4227,40
51709371263,51709371242,-21,78,1418,40
51709487445,51709487462,17,575,2326,40
51715652333,51715652329,-4,892,3871,40
51717895468,51717895464,-4,1141,2964,40
51720318670,51720318665,-5,1032,4546,40
51720537143,51720537130,-13,178,1359,40
51728262430,51728262426,-4,945,3717,40
51729961807,51729961799,-8,980,4406,40
51730504070,51730504065,-5,1004,4711,40
51740419992,51740420003,11,359,1299,40
51745605678,51745605698,20,963,3188,40
51746961765,51746961766,1,3403,3485,40
51750623426,51750623418,-8,1025,4154,40
51750896421,51750896413,-8,1160,4710,40
51751820089,51751820082,-7,1314,3696,40
51757415633,51757415631,-2,1580,2811,40
51759676210,51759676222,12,106,867,40
51761984130,51761984130,0,1333,1731,40
51768333234,51768333229,-5,826,3500,40
51774456699,51774456694,-5,742,2244,40
51779742867,51779742862,-5,1117,3140,40
51779999499,51779999494,-5,986,3476,40
51785473510,51785473505,-5,883,2838,40
51793214836,51793214830,-6,1163,4363,40
51799406539,51799406534,-5,857,3504,40
51811747598,51811747594,-4,1367,4102,40
51816403417,51816403410,-7,1088,5181,40
51818205590,51818205585,-5,1006,4275,40
51818754783,51818754781,-2,176,1078,40
51820413114,51820413109,-5,1003,4114,40
51836589716,51836589710,-6,892,3944,40
51839492278,51839492274,-4,748,1573,40
51840180619,51840180615,-4,856,2391,40
51840433182,51840433175,-7,412,1840,40
51845823804,51845823790,-14,1508,414,40
51847822305,51847822298,-7,1149,4013,40
51847935415,51847935406,-9,123,1161,40
51861413830,51861413825,-5,1158,3725,40
51872546314,51872546308,-6,977,3884,40
51873124381,51873124374,-7,826,4337,40
51876400935,51876400940,5,3069,1348,40
51880056442,51880056449,7,2925,1805,40
51887995855,51887995849,-6,1046,4837,40
51889465455,51889465456,1,956,1395,40
51898627473,51898627466,-7,1096,3955,40
51899734235,51899734230,-5,963,4071,40
51910952066,51910952061,-5,870,3329,40
51914066953,51914066949,-4,888,2747,40
51914748641,51914748639,-2,1679,1751,40
51915708667,51915708661,-6,695,6226,40
51916325758,51916325754,-4,1176,5328,40
51919023022,51919023016,-6,20722,17814,40
51922498490,51922498480,-10,199,1211,40
51932028642,51932028637,-5,977,4028,40
51932699702,51932699720,18,358,1719,40
51933557557,51933557556,-1,2549,4546,40
51938359329,51938359323,-6,817,2705,40
51939100614,51939100630,16,427,1556,40
51942616194,51942616188,-6,1098,4116,40
51947239550,51947239546,-4,687,2153,40
51956653589,51956653583,-6,475,3131,40
51956734352,51956734349,-3,189,1102,40
51956958197,51956958219,22,269,1134,40
51962676790,51962676786,-4,681,2023,40
51964424082,51964424077,-5,1199,3665,40
51964932950,51964932940,-10,1252,4523,40
51965287503,51965287516,13,549,1776,40
51966431099,51966431094,-5,984,2946,40
51969655243,51969655238,-5,1557,4745,40
51971287218,51971287213,-5,900,2934,40
51971421593,51971421589,-4,1216,2595,40
51973210382,51973210402,20,402,3875,40
51975533938,51975533931,-7,1537,4947,40
51975700801,51975700795,-6,769,2890,40
51983855218,51983855213,-5,793,3288,40
51996325085,51996325080,-5,1273,4960,40
51997651821,51997651818,-3,1486,1693,40
52005056851,52005056845,-6,1341,4167,40
52005337619,52005337614,-5,1147,2817,40
52010112406,52010112399,-7,1044,5230,40
52011122128,52011122122,-6,1183,3346,40
52013801849,52013801842,-7,1165,4672,40
52015818956,52015818951,-5,1129,3536,40
52021448109,52021448104,-5,1515,4270,40
52021641019,52021641013,-6,1008,3389,40
52025471717,52025471713,-4,900,2849,40
52027582764,52027582758,-6,1236,3988,40
52027652987,52027653004,17,4939,1357,40
52029491813,52029491807,-6,851,2822,40
52030750241,52030750237,-4,742,2165,40
52032006132,52032006125,-7,963,5955,40
52034320309,52034320303,-6,1014,4830,40
52036606155,52036606151,-4,447,2009,40
52036743262,52036743241,-21,105,984,40
52038101305,52038101299,-6,832,3560,40
52040619922,52040619917,-5,892,3490,40
52040934113,52040934114,1,947,1235,40
52044447753,52044447748,-5,750,2756,40
52045355573,52045355579,6,20366,46114,40
52050767744,52050767739,-5,1263,2190,40
52051119894,52051119891,-3,206,847,40
52059380414,52059380409,-5,943,4172,40
52059808721,52059808714,-7,776,3336,40
52061567077,52061567080,3,58,993,40
52069410938,52069410934,-4,1238,3891,40
52072997187,52072997181,-6,810,2140,40
52073990622,52073990627,5,3878,2021,40
52077391190,52077391186,-4,810,2494,40
52079824315,52079824309,-6,1012,3742,40
52080733935,52080733946,11,516,1890,40
52081581806,52081581800,-6,972,3069,40
52081642888,52081642902,14,165,1101,40
52095360339,52095360333,-6,31704,14631,40
52096285766,52096285761,-5,1448,2774,40
52096542942,52096542939,-3,4595,8993,40
52103256655,52103256656,1,6045,24827,40
52108018286,52108018277,-9,921,2218,40
52110840269,52110840274,5,1780,1150,40
52112937816,52112937810,-6,806,3824,40
52123965752,52123965745,-7,1315,3742,40
52126965325,52126965322,-3,20006,2281,40
52128804362,52128804358,-4,1248,3938,40
52128896975,52128896978,3,197,1326,40
52130553371,52130553365,-6,953,3870,40
52131487372,52131487366,-6,816,2884,40
52133869311,52133869303,-8,1154,4935,40
52133941382,52133941379,-3,60,1417,40
52138301481,52138301481,0,1960,1476,40
52140148354,52140148351,-3,1175,2409,40
52143065170,52143065166,-4,1033,3976,40
52145484646,52145484638,-8,1245,5542,40
52146212181,52146212174,-7,1487,5920,40
52147969758,52147969754,-4,1043,3283,40
52154850681,52154850675,-6,809,2395,40
52157358554,52157358549,-5,911,2207,40
52159159058,52159159077,19,267,719,40
52160364469,52160364469,0,1145,1908,40
52162260004,52162259998,-6,1195,4346,40
52171271005,52171270997,-8,1003,4193,40
52171358046,52171358046,0,2647,2892,40
52172325183,52172325178,-5,835,4264,40
52172930931,52172930926,-5,1239,3332,40
52181224791,52181224783,-8,847,3042,40
52184826690,52184826683,-7,360,3155,40
52185246023,52185246039,16,544,2024,40
52193502266,52193502261,-5,952,3168,40
52194740919,52194740913,-6,649,3514,40
52200518507,52200518501,-6,750,2735,40
52203903743,52203903737,-6,1120,2459,40
52205083616,52205083609,-7,908,4755,40
52206050204,52206050198,-6,858,3046,40
52207059261,52207059255,-6,998,5223,40
52207446120,52207446137,17,303,2696,40
52208473625,52208473619,-6,1139,3319,40
52215634286,52215634284,-2,1186,2492,40
52226218287,52226218281,-6,805,2683,40
52228171505,52228171500,-5,830,3506,40
52233770079,52233770073,-6,989,3415,40
52243731145,52243731138,-7,766,3227,40
52251915418,52251915411,-7,1178,3347,40
52252305126,52252305146,20,1183,3810,40
52254657991,52254657985,-6,1590,4595,40
52258224682,52258224677,-5,1134,3645,40
52268744716,52268744709,-7,757,3223,40
52269463638,52269463625,-13,1010,4729,40
52270620415,52270620420,5,270,863,40
52274293176,52274293170,-6,1341,2692,40
52274387852,52274387871,19,322,1139,40
52282769983,52282769986,3,1312,1111,40
52284236998,52284236991,-7,921,3774,40
52284340414,52284340434,20,324,1597,40
52284524186,52284524180,-6,1234,4483,40
52285507451,52285507445,-6,2425,8130,40
52301328905,52301328922,17,16528,41115,40
52313759684,52313759701,17,503,2682,40
52318147911,52318147905,-6,900,3070,40
52320336526,52320336519,-7,885,4475,40
52321088826,52321088818,-8,1207,4018,40
52325009359,52325009351,-8,1508,4549,40
52328509429,52328509424,-5,544,2580,40
52328646794,52328646786,-8,1203,4820,40
52328920334,52328920329,-5,1142,3854,40
52329575705,52329575699,-6,874,3685,40
52331020575,52331020569,-6,1212,2701,40
52348992785,52348992780,-5,573,1615,40
52350148719,52350148718,-1,185,2089,40
52350797991,52350797970,-21,3,799,40
52351116941,52351116935,-6,1221,3923,40
52351521999,52351521993,-6,748,1716,40
52352784885,52352784885,0,2219,2065,40
52356821807,52356821807,0,984,1119,40
52361594606,52361594599,-7,955,4839,40
52365696299,52365696305,6,83156,37724,40
52369156771,52369156765,-6,1167,4415,40
52373067770,52373067764,-6,774,2747,40
52380443847,52380443841,-6,1137,3022,40
52386700714,52386700709,-5,1196,3325,40
52387958190,52387958204,14,714,4056,40
52391984661,52391984657,-4,1231,3692,40
52392533690,52392533683,-7,830,2517,40
52395664182,52395664176,-6,974,3335,40
52396359154,52396359149,-5,1396,3682,40
52402011892,52402011885,-7,868,3819,40
52409473406,52409473401,-5,1208,4061,40
52410356294,52410356313,19,811,2881,40
52420454217,52420454209,-8,817,3814,40
52421699822,52421699815,-7,422,2378,40
52427776381,52427776374,-7,686,2225,40
52428246344,52428246350,6,4361,964,40
52429699660,52429699658,-2,2995,4802,40
52431212326,52431212321,-5,22304,13559,40
52433063900,52433063895,-5,915,3985,40
52437040266,52437040260,-6,959,3514,40
52438602168,52438602162,-6,1024,2736,40
52438864270,52438864287,17,161,1577,40
52440558322,52440558315,-7,751,3231,40
52440685498,52440685493,-5,1708,5148,40
52442036374,52442036368,-6,1136,3789,40
52442368730,52442368724,-6,1180,4284,40
52446955622,52446955617,-5,1366,3742,40
52447240768,52447240783,15,276,1325,40
52451090801,52451090795,-6,955,4482,40
52451164406,52451164424,18,298,1502,40
52451345046,52451345041,-5,635,3026,40
52452216606,52452216595,-11,14,1260,40
52471651253,52471651246,-7,776,2768,40
52474420029,52474420022,-7,878,3683,40
52474553735,52474553714,-21,4,1048,40
52474931136,52474931154,18,412,1418,40
52476613874,52476613874,0,1234,1154,40
52481102423,52481102420,-3,2238,5940,40
52482866599,52482866596,-3,748,3386,40
52483055358,52483055355,-3,303,1106,40
52485664789,52485664782,-7,939,3453,40
52503746517,52503746511,-6,861,2307,40
52506536275,52506536269,-6,1590,3391,40
52508404733,52508404727,-6,1319,4295,40
52509066781,52509066779,-2,1218,3328,40
52511120294,52511120289,-5,942,3504,40
52512241502,52512241498,-4,918,1444,40
52514620326,52514620317,-9,1355,4322,40
52517429794,52517429773,-21,1224,4885,40
52520605097,52520605092,-5,651,3955,40
52523242954,52523242933,-21,2420,1337,40
52537424719,52537424713,-6,801,2497,40
52538002760,52538002775,15,450,1540,40
52539268862,52539268878,16,271,1066,40
52544779655,52544779656,1,177,801,40
52545236976,52545236987,11,387,1632,40
52546287429,52546287423,-6,944,3484,40
52554976614,52554976605,-9,942,3498,40
52555316394,52555316392,-2,1912,2706,40
52555964282,52555964277,-5,1073,3876,40
52557634370,52557634365,-5,747,2476,40
52558247589,52558247607,18,848,4260,40
52559875427,52559875421,-6,835,2995,40
52560414788,52560414782,-6,1273,4574,40
52565685338,52565685330,-8,546,2749,40
52566469079,52566469078,-1,2967,3643,40
52571420806,52571420800,-6,858,2429,40
52571556526,52571556547,21,990,1135,40
52572321109,52572321129,20,476,2620,40
52572998127,52572998121,-6,915,4268,40
52575604082,52575604077,-5,1038,2611,40
52580999516,52580999510,-6,906,4088,40
52581265942,52581265955,13,650,2728,40
52584573230,52584573222,-8,740,4211,40
52585990886,52585990902,16,648,2134,40
52591784888,52591784882,-6,1350,3107,40
52596060003,52596059998,-5,695,5332,40
52596787023,52596787016,-7,1798,6262,40
52598723806,52598723798,-8,1092,5983,40
52603543814,52603543808,-6,763,2993,40
52610439700,52610439694,-6,963,3262,40
52611119215,52611119230,15,949,3652,40
52616853149,52616853154,5,2927,1468,40
52618980030,52618980029,-1,3174,4186,40
52619607307,52619607301,-6,1100,5659,40
52633089980,52633089978,-2,1236,2958,40
52637027801,52637027794,-7,1027,4364,40
52637590915,52637590912,-3,2345,5329,40
52644927529,52644927530,1,1169,838,40
52646985318,52646985322,4,3604,2840,40
52649302973,52649302968,-5,1149,2542,40
52651042186,52651042181,-5,1035,3253,40
52652392222,52652392214,-8,607,3794,40
52652530294,52652530281,-13,1101,3751,40
52652857438,52652857427,-11,1032,4393,40
52652940885,52652940905,20,893,3295,40
52654012316,52654012303,-13,243,1324,40
52661397968,52661397962,-6,1204,4704,40
52677503033,52677503025,-8,811,4364,40
52680140807,52680140802,-5,918,2402,40
52680586272,52680586285,13,141,1361,40
52681803047,52681803041,-6,1026,4362,40
52686509514,52686509509,-5,985,4085,40
52688054749,52688054761,12,308,1520,40
52693904867,52693904862,-5,1227,2791,40
52694409548,52694409544,-4,1130,4652,40
52706264023,52706264017,-6,1069,2064,40
52712267543,52712267537,-6,1234,4517,40
52712536703,52712536680,-23,195,1046,40
52713910298,52713910291,-7,1133,4790,40
52716171041,52716171035,-6,976,2903,40
52724681135,52724681142,7,3004,1470,40
52726928370,52726928373,3,867,1395,40
52729758021,52729758018,-3,1430,2138,40
52733689343,52733689337,-6,489,4245,40
52734087192,52734087210,18,951,3387,40
52736046745,52736046750,5,1437,1061,40
52737310578,52737310573,-5,1104,4779,40
52739596967,52739596962,-5,1104,4137,40
52740349152,52740349163,11,433,3278,40
52743101303,52743101298,-5,931,2240,40
52743316126,52743316115,-11,176,905,40
52748026370,52748026364,-6,1137,4279,40
52748063762,52748063758,-4,959,2821,40
52748253428,52748253423,-5,205,998,40
52750592722,52750592716,-6,806,3063,40
52754596909,52754596905,-4,1166,3725,40
52754819413,52754819426,13,244,1317,40
52759939434,52759939430,-4,595,1825,40
52760656284,52760656285,1,1388,2020,40
52770208100,52770208088,-12,5716,16300,40
52772853800,52772853797,-3,1070,3299,40
52780955700,52780955692,-8,1377,4455,40
52781643802,52781643802,0,2905,3637,40
52785243106,52785243101,-5,930,4791,40
52786807142,52786807135,-7,880,3159,40
52792319469,52792319463,-6,869,4039,40
52797744660,52797744655,-5,798,3200,40
52798778365,52798778385,20,396,2231,40
52799177068,52799177062,-6,1046,3475,40
52804175722,52804175728,6,41834,19208,40
52809190734,52809190729,-5,1301,4041,40
52814311758,52814311752,-6,1193,4017,40
52820830786,52820830781,-5,1076,4109,40
52822511931,52822511925,-6,1066,4344,40
52823545741,52823545733,-8,1185,3215,40
52830136432,52830136426,-6,1350,5458,40
52830620491,52830620485,-6,1137,2936,40
52841954001,52841953997,-4,558,2340,40
52842600200,52842600215,15,63,1012,40
52844393069,52844393086,17,773,4457,40
52850326017,52850326009,-8,423,3001,40
52850919174,52850919185,11,703,3692,40
52859992757,52859992751,-6,1510,4499,40
52861942898,52861942895,-3,2002,4685,40
52870761905,52870761906,1,2885,3907,40
52882528949,52882528942,-7,462,1901,40
52883064813,52883064815,2,1868,1372,40
52884738365,52884738359,-6,826,4370,40
52885721490,52885721469,-21,1063,4448,40
52886279820,52886279814,-6,1408,4732,40
52891251105,52891251101,-4,810,3910,40
52892464810,52892464806,-4,1016,3022,40
52903134702,52903134698,-4,879,2646,40
52903402372,52903402391,19,473,2207,40
52904083060,52904083054,-6,1137,1895,40
52909109575,52909109570,-5,734,3043,40
52909442802,52909442806,4,2769,1448,40
52913790678,52913790673,-5,678,2373,40
52915296295,52915296301,6,2510,1716,40
52924218682,52924218682,0,13143,50013,40
52931165130,52931165123,-7,988,4012,40
52932304480,52932304494,14,182,1228,40
52932787674,52932787667,-7,1217,3354,40
52933992059,52933992054,-5,664,2923,40
52940172651,52940172651,0,1265,1428,40
52941876126,52941876121,-5,764,3430,40
52943381524,52943381506,-18,160,1029,40
52944634379,52944634373,-6,1238,3499,40
52945223651,52945223646,-5,874,2367,40
52956217498,52956217503,5,2012,1371,40
52956985847,52956985841,-6,940,3575,40
52957723787,52957723782,-5,654,2494,40
52959437219,52959437211,-8,201,1814,40
52959635480,52959635493,13,154,1385,40
52966416958,52966416951,-7,654,3151,40
52967117805,52967117812,7,4942,3659,40
52968755111,52968755106,-5,955,3644,40
52973464433,52973464427,-6,878,3572,40
52974013240,52974013253,13,497,3586,40
52978610381,52978610375,-6,925,3713,40
52983157145,52983157149,4,1886,1636,40
52985387462,52985387459,-3,2733,5353,40
52988511563,52988511567,4,25189,27540,40
52989812574,52989812568,-6,997,2627,40
52992552999,52992552993,-6,815,4075,40
52998832935,52998832930,-5,1208,4107,40
53006738533,53006738525,-8,1035,5238,40
53014436707,53014436702,-5,609,1622,40
53026381947,53026381944,-3,1086,3509,40
53026501390,53026501410,20,110,978,40
53030546595,53030546605,10,16438,8354,40
53032083087,53032083085,-2,1089,3435,40
53036299791,53036299786,-5,946,3121,40
53037058261,53037058242,-19,232,1414,40
53037372593,53037372587,-6,855,4088,40
53037708807,53037708810,3,260,2811,40
53038191567,53038191551,-16,1103,4373,40
53038844676,53038844670,-6,277,1326,40
53039577135,53039577135,0,228,1326,40
53042528031,53042528024,-7,1158,4469,40
53044822229,53044822222,-7,1172,3090,40
53045573710,53045573704,-6,664,2909,40
53048993639,53048993633,-6,1031,4816,40
53055927107,53055927093,-14,181,1351,40
53057761085,53057761084,-1,575,1889,40
53059829074,53059829069,-5,887,3545,40
53066816329,53066816324,-5,1116,4810,40
53068321870,53068321863,-7,957,2791,40
53068442903,53068442887,-16,210,1466,40
53068516318,53068516331,13,367,1053,40
53071018012,53071018006,-6,718,3217,40
53072054084,53072054085,1,1863,2047,40
53075018916,53075018909,-7,916,2900,40
53075678224,53075678242,18,581,2407,40
53082053042,53082053054,12,1025,3439,40
53088883340,53088883333,-7,925,2881,40
53093109014,53093109007,-7,1295,2915,40
53105358190,53105358186,-4,808,1986,40
53116171414,53116171410,-4,1059,4628,40
53124797447,53124797441,-6,1787,5861,40
53137371965,53137371958,-7,1067,4161,40
53138411562,53138411558,-4,877,3301,40
53138961134,53138961150,16,205,967,40
53140400068,53140400059,-9,777,2468,40
53152326735,53152326730,-5,965,3425,40
53152937512,53152937521,9,266,1028,40
53160754693,53160754715,22,383,2042,40
53163560707,53163560702,-5,1036,4242,40
53167253467,53167253461,-6,788,5706,40
53171430182,53171430177,-5,793,3959,40
53175598978,53175598970,-8,469,1544,40
53181082617,53181082611,-6,901,3089,40
53185859398,53185859391,-7,1000,4151,40
53186217165,53186217158,-7,940,3672,40
53187238937,53187238930,-7,1298,2820,40
53192262145,53192262138,-7,1151,5455,40
53193457844,53193457866,22,532,871,40
53193704518,53193704518,0,2119,2537,40
53199960664,53199960656,-8,1368,3288,40
53200358350,53200358343,-7,1005,4511,40
53204069329,53204069325,-4,578,2156,40
53204362691,53204362686,-5,1227,3744,40
53206519359,53206519356,-3,1330,2465,40
53208198073,53208198090,17,4076,1525,40
53212444058,53212444054,-4,710,2392,40
53219678954,53219678946,-8,1409,4992,40
53220532174,53220532184,10,484,3303,40
53229092786,53229092782,-4,992,2850,40
53238647103,53238647099,-4,699,3256,40
53238870806,53238870824,18,413,2760,40
53240924051,53240924046,-5,1185,3186,40
53246154386,53246154378,-8,1473,5069,40
53246776439,53246776437,-2,172,946,40
53248891773,53248891767,-6,2296,7027,40
53250153874,53250153868,-6,1046,4093,40
53250336629,53250336638,9,202,815,40
53255532241,53255532234,-7,646,2997,40
53255607910,53255607902,-8,731,2212,40
53255991559,53255991555,-4,1187,4332,40
53257686843,53257686837,-6,1083,3440,40
53261372331,53261372323,-8,900,3096,40
53261651434,53261651429,-5,1750,3913,40
53269871353,53269871353,0,32415,21866,40
53270985039,53270985033,-6,1173,5599,40
53276085762,53276085767,5,3600,3373,40
53281953729,53281953723,-6,1160,4251,40
53282063476,53282063461,-15,21,1152,40
53283107988,53283107982,-6,1023,2869,40
53284600752,53284600753,1,26061,35387,40
53289559618,53289559611,-7,1231,4092,40
53294415328,53294415323,-5,1044,3303,40
53295577867,53295577861,-6,1176,4740,40
53298207151,53298207155,4,5539,3310,40
53304708890,53304708886,-4,718,2936,40
53307683986,53307683981,-5,1128,5154,40
53309257689,53309257683,-6,1145,4753,40
53309742847,53309742843,-4,1176,3158,40
53320290923,53320290926,3,2758,1478,40
53322107377,53322107399,22,641,2589,40
53326262725,53326262719,-6,1366,4977,40
53326567646,53326567666,20,324,1065,40
53329756247,53329756246,-1,1671,1738,40
53330182325,53330182333,8,4347,1325,40
53330773814,53330773807,-7,862,2061,40
53331545645,53331545638,-7,1111,3146,40
53341465804,53341465798,-6,1156,4550,40
53341847435,53341847442,7,5296,2997,40
53343106265,53343106260,-5,1502,4037,40
53345793726,53345793719,-7,881,4063,40
53348230790,53348230783,-7,736,2302,40
53350389677,53350389673,-4,847,3157,40
53363040034,53363040030,-4,1079,3638,40
53365023794,53365023794,0,1857,2129,40
53366203274,53366203270,-4,1093,3140,40
53371179008,53371179002,-6,967,3563,40
53371333492,53371333513,21,430,1950,40
53373363773,53373363768,-5,923,3593,40
53373608943,53373608936,-7,757,2677,40
53373794870,53373794886,16,169,1245,40
53374520092,53374520081,-11,1227,3542,40
53377213268,53377213261,-7,996,3835,40
53379786801,53379786797,-4,993,2459,40
53380253623,53380253622,-1,266,1325,40
53385734002,53385734006,4,1511,1524,40
53389854398,53389854397,-1,1519,2384,40
53390512356,53390512355,-1,1013,1981,40
53393296801,53393296794,-7,1042,4230,40
53398279072,53398279066,-6,903,3467,40
53399812949,53399812946,-3,1291,2544,40
53401368893,53401368908,15,350,1256,40
53406414663,53406414659,-4,810,1878,40
53406607117,53406607113,-4,38,1257,40
53407646207,53407646201,-6,718,3321,40
53407688087,53407688078,-9,267,864,40
53413457994,53413457990,-4,1217,2341,40
53413747840,53413747855,15,886,1731,40
53416698628,53416698622,-6,1200,3943,40
53422304032,53422304027,-5,1473,4206,40
53429583894,53429583890,-4,1245,2497,40
53430717854,53430717848,-6,780,3614,40
53436229090,53436229085,-5,910,3444,40
53437814833,53437814829,-4,1200,2666,40
53438068745,53438068749,4,6831,3891,40
53449648411,53449648405,-6,767,2563,40
53450348365,53450348374,9,178,1116,40
53451035997,53451035976,-21,177,1566,40
53459988585,53459988578,-7,1110,1771,40
53463372847,53463372842,-5,1034,3838,40
53464453139,53464453142,3,2289,36996,40
53466518783,53466518777,-6,1407,5033,40
53466624744,53466624754,10,245,1491,40
53478997011,53478997006,-5,746,2354,40
53480567026,53480567021,-5,803,3772,40
53481996719,53481996713,-6,571,4092,40
53487464207,53487464205,-2,594,1473,40
53487540359,53487540340,-19,1162,4469,40
53490010173,53490010169,-4,588,3244,40
53493984254,53493984247,-7,887,3662,40
53496114227,53496114221,-6,765,2573,40
53497785522,53497785522,0,1035,1649,40
53505100913,53505100909,-4,1090,2721,40
53506141284,53506141270,-14,1179,3536,40
53507706448,53507706465,17,1075,3831,40
53511423517,53511423513,-4,1019,3917,40
53514706371,53514706368,-3,20675,19845,40
53516107385,53516107381,-4,829,2999,40
53520570094,53520570090,-4,1076,3573,40
53530559066,53530559061,-5,920,3436,40
53531562620,53531562601,-19,439,1756,40
53532065030,53532065022,-8,724,2643,40
53532583794,53532583787,-7,1256,4112,40
53542770346,53542770351,5,4992,1495,40
53544211914,53544211895,-19,960,5679,40
53544481032,53544481045,13,656,3905,40
53550205259,53550205253,-6,1036,4485,40
53551780713,53551780706,-7,778,3470,40
53553703158,53553703153,-5,1045,3253,40
53560274131,53560274124,-7,1150,3572,40
53560490581,53560490599,18,217,1206,40
53567699993,53567699990,-3,1412,2883,40
53569993115,53569993110,-5,1035,3053,40
53574144086,53574144078,-8,959,4417,40
53574177229,53574177250,21,246,2181,40
53576668416,53576668410,-6,1123,3789,40
53576791604,53576791595,-9,161,732,40
53588296962,53588296962,0,8467,9288,40
53596238857,53596238850,-7,1094,3586,40
53596780127,53596780121,-6,1042,3595,40
53607111091,53607111086,-5,840,3185,40
53610165078,53610165074,-4,676,2214,40
53611285660,53611285644,-16,124,1067,40
53613964926,53613964919,-7,1097,2399,40
53615436283,53615436288,5,5392,2454,40
53616035367,53616035359,-8,2894,4512,40
53632323158,53632323150,-8,690,3710,40
53633786351,53633786347,-4,1386,3500,40
53634790595,53634790589,-6,730,3412,40
53636247235,53636247230,-5,1083,2874,40
53636741415,53636741427,12,369,1053,40
53647567035,53647567030,-5,1150,3834,40
53647649084,53647649078,-6,207,1199,40
53649032173,53649032167,-6,1331,3101,40
53651852030,53651852021,-9,916,4642,40
53652266578,53652266574,-4,797,1758,40
53653135986,53653135979,-7,1053,3539,40
53658352298,53658352293,-5,1022,3509,40
53662332785,53662332779,-6,1051,5406,40
53662377060,53662377076,16,385,1403,40
53666384822,53666384842,20,685,2507,40
53666614058,53666614052,-6,923,2213,40
53667834918,53667834925,7,4737,1852,40
53673547331,53673547326,-5,999,3042,40
53674928111,53674928117,6,45932,64828,40
53675860533,53675860526,-7,615,3175,40
53676261310,53676261305,-5,1378,3093,40
53676403224,53676403237,13,1120,3649,40
53678446845,53678446841,-4,994,2899,40
53681602061,53681602069,8,13666,36331,40
53688938838,53688938834,-4,1265,1539,40
53690740294,53690740289,-5,1517,4745,40
53692796970,53692796965,-5,692,1259,40
53700422305,53700422319,14,8990,42536,40
53716135313,53716135306,-7,1564,3615,40
53718141458,53718141437,-21,1529,4721,40
53725062249,53725062243,-6,1433,4115,40
53730321021,53730321015,-6,675,3360,40
53730389794,53730389801,7,2857,1973,40
53730476153,53730476145,-8,1156,6283,40
53734378193,53734378188,-5,949,3512,40
53734620389,53734620386,-3,1158,3354,40
53738287850,53738287841,-9,630,2079,40
53738967935,53738967951,16,243,1103,40
53740097569,53740097564,-5,1485,2616,40
53745966294,53745966302,8,3602,1427,40
53751137326,53751137319,-7,1209,3443,40
53754267587,53754267599,12,740,4146,40
53754441914,53754441910,-4,967,2572,40
53755745937,53755745929,-8,1081,3284,40
53759835325,53759835338,13,14584,31879,40
53761434719,53761434722,3,1716,1003,40
53769727932,53769727926,-6,1231,3076,40
53771620063,53771620062,-1,2099,4216,40
53773274918,53773274903,-15,910,2993,40
53793967835,53793967829,-6,888,4866,40
53803688017,53803688010,-7,906,3612,40
53804501066,53804501064,-2,1585,2951,40
53808938908,53808938907,-1,18521,14800,40
53809206786,53809206791,5,2126,1372,40
53813641977,53813641981,4,2570,1934,40
53825746379,53825746374,-5,853,3973,40
53826992598,53826992591,-7,661,3353,40
53827472189,53827472203,14,324,1001,40
53830413147,53830413143,-4,1103,2896,40
53831015150,53831015145,-5,1527,4593,40
53833745643,53833745637,-6,1114,3099,40
53834339614,53834339613,-1,1273,1758,40
53837857512,53837857506,-6,979,4184,40
53841410646,53841410641,-5,1213,1377,40
53844000767,53844000776,9,14057,34970,40
53844241733,53844241727,-6,542,2418,40
53844684270,53844684270,0,1435,1266,40
53848190739,53848190740,1,1669,1307,40
53854428346,53854428342,-4,858,3533,40
53856721157,53856721162,5,3138,1403,40
53858386279,53858386273,-6,1009,4943,40
53858466662,53858466656,-6,649,2916,40
53862124128,53862124123,-5,1116,4310,40
53867408467,53867408462,-5,1052,3491,40
53867527011,53867527004,-7,829,3972,40
53867726519,53867726537,18,563,2244,40
53872372658,53872372654,-4,1058,3155,40
53879435362,53879435356,-6,1392,4599,40
53880788595,53880788590,-5,932,4886,40
53882525752,53882525740,-12,928,4072,40
53890496712,53890496714,2,1939,1621,40
53895629699,53895629694,-5,1133,3746,40
53897195255,53897195254,-1,1052,2652,40
53899782951,53899782946,-5,1190,3531,40
53902914683,53902914677,-6,1088,3819,40
53904651429,53904651422,-7,1258,4382,40
53918007830,53918007825,-5,965,4615,40
53925813092,53925813085,-7,1032,4358,40
53926840614,53926840605,-9,1073,5216,40
53927414381,53927414403,22,532,2983,40
53929713411,53929713405,-6,882,4092,40
53939621898,53939621892,-6,1030,3864,40
53940014463,53940014443,-20,1081,3756,40
53946239673,53946239685,12,11551,42603,40
53953500056,53953500050,-6,1192,2884,40
53955783685,53955783681,-4,1332,3171,40
53956269448,53956269441,-7,933,3658,40
53963275083,53963275077,-6,1250,4717,40
53966024125,53966024142,17,205,1545,40
53967081978,53967081970,-8,928,3205,40
53975220989,53975220995,6,23791,43089,40
53980844533,53980844527,-6,705,3545,40
53981488961,53981488957,-4,1093,3106,40
53981930150,53981930166,16,231,1712,40
53984826474,53984826469,-5,1327,3909,40
53990405313,53990405306,-7,860,3446,40
53992613950,53992613944,-6,1127,3575,40
53993169018,53993169011,-7,1267,2985,40
53993611253,53993611251,-2,2195,4060,40
53995282344,53995282351,7,2357,1304,40
53996877277,53996877273,-4,1390,2045,40
53998129370,53998129366,-4,1044,3361,40
53999055375,53999055369,-6,1856,4379,40
54003591338,54003591332,-6,1302,3637,40
54005222576,54005222570,-6,820,1780,40
54005319029,54005319050,21,1002,2550,40
54008897474,54008897468,-6,764,2440,40
54009160245,54009160266,21,595,1535,40
54015156405,54015156400,-5,1067,4866,40
54016001621,54016001614,-7,682,4476,40
54021371562,54021371556,-6,1333,2710,40
54021666666,54021666660,-6,826,2544,40
54023530019,54023530011,-8,793,2503,40
54034238601,54034238595,-6,1590,4695,40
54044687874,54044687870,-4,1332,2767,40
54049008942,54049008937,-5,869,3595,40
54053143049,54053143045,-4,978,1987,40
54053574686,54053574698,12,623,2552,40
54081884162,54081884157,-5,772,4388,40
54085457913,54085457906,-7,892,3315,40
54086532846,54086532837,-9,304,932,40
54091182806,54091182798,-8,878,5072,40
54103964831,54103964825,-6,1089,3400,40
54105109989,54105109997,8,250,1731,40
54105633081,54105633077,-4,855,4441,40
54105784399,54105784414,15,753,2726,40
54107940358,54107940354,-4,1179,3831,40
54108046966,54108046960,-6,933,2497,40
54109166600,54109166594,-6,1007,3456,40
54109533838,54109533832,-6,1019,3688,40
54109719861,54109719879,18,352,1051,40
54114604915,54114604908,-7,853,4026,40
54115725348,54115725364,16,453,2620,40
54120944719,54120944713,-6,963,3146,40
54121676646,54121676665,19,743,2196,40
54127641146,54127641142,-4,1345,5327,40
54131458199,54131458195,-4,1380,2989,40
54148370641,54148370637,-4,923,3690,40
54155209523,54155209517,-6,575,3145,40
54158499690,54158499686,-4,1579,3810,40
54162754464,54162754458,-6,1085,5391,40
54172452422,54172452416,-6,1171,3442,40
54176051593,54176051593,0,2559,2405,40
54176771167,54176771173,6,4782,2465,40
54178317746,54178317739,-7,2356,9108,40
54181749762,54181749765,3,1490,1383,40
54182455311,54182455305,-6,1055,3939,40
54186553535,54186553529,-6,1678,5112,40
54186683042,54186683035,-7,1234,3638,40
54191716866,54191716860,-6,1229,3583,40
54202073051,54202073045,-6,1218,3208,40
54206955701,54206955695,-6,892,3603,40
54218606313,54218606305,-8,894,2850,40
54220904619,54220904614,-5,1627,3764,40
54222544739,54222544732,-7,757,2721,40
54229689929,54229689937,8,3031,1095,40
54233941063,54233941057,-6,978,3720,40
54238120039,54238120033,-6,947,3441,40
54238171181,54238171203,22,545,6064,40
54250532848,54250532842,-6,1138,5006,40
54252020379,54252020374,-5,1233,3795,40
54253253710,54253253702,-8,438,2531,40
54253425621,54253425612,-9,155,939,40
54255440544,54255440537,-7,1072,4889,40
54260484655,54260484650,-5,1394,4648,40
54264172446,54264172442,-4,845,2051,40
54264344695,54264344673,-22,76,1281,40
54268275658,54268275655,-3,2157,3663,40
54269171606,54269171600,-6,634,3950,40
54285961263,54285961258,-5,1076,3876,40
54297564217,54297564208,-9,994,2342,40
54310982446,54310982440,-6,1646,4484,40
54315545071,54315545065,-6,1012,4749,40
54316547054,54316547049,-5,1409,4439,40
54316596471,54316596465,-6,451,2152,40
54316645550,54316645534,-16,1053,2998,40
54317628627,54317628618,-9,953,4262,40
54319490204,54319490197,-7,782,2397,40
54323385877,54323385881,4,1937,1071,40
54330547726,54330547719,-7,1086,3237,40
54333932246,54333932240,-6,797,3180,40
54336086847,54336086853,6,203,1154,40
54340759629,54340759622,-7,953,3153,40
54345235017,54345235010,-7,811,3947,40
54346975470,54346975464,-6,1000,3212,40
54349689629,54349689633,4,5969,29703,40
54349981384,54349981388,4,2016,2138,40
54350344624,54350344618,-6,754,4197,40
54356859306,54356859300,-6,1186,3631,40
54357199826,54357199820,-6,476,1308,40
54360523323,54360523318,-5,614,1972,40
54362307930,54362307910,-20,92,883,40
54363537204,54363537211,7,154,793,40
54365500643,54365500636,-7,811,3492,40
54373471363,54373471366,3,2378,2933,40
54375771871,54375771864,-7,727,1985,40
54389638979,54389638965,-14,3953,1876,40
54395132954,54395132948,-6,886,3177,40
54400190398,54400190390,-8,1021,3055,40
54414019807,54414019810,3,164,1114,40
54414492708,54414492701,-7,1140,5273,40
54417135595,54417135594,-1,1837,3727,40
54432152499,54432152493,-6,976,4560,40
54434873324,54434873319,-5,1434,4416,40
54439051058,54439051056,-2,1202,2544,40
54446009435,54446009430,-5,955,2395,40
54446783887,54446783869,-18,239,1151,40
54447604255,54447604270,15,642,3522,40
54453384569,54453384570,1,2438,2013,40
54460235955,54460235946,-9,1100,3965,40
54461489035,54461489029,-6,867,3443,40
54464562122,54464562139,17,367,2157,40
54470203622,54470203617,-5,1237,4180,40
54480420495,54480420511,16,938,2199,40
54481376827,54481376826,-1,1460,1602,40
54483270217,54483270212,-5,1105,3068,40
54488771751,54488771746,-5,877,3673,40
54489010050,54489010043,-7,961,2756,40
54491324283,54491324286,3,1551,1563,40
54495531061,54495531061,0,1916,2416,40
54495590087,54495590081,-6,1045,4312,40
54497995254,54497995253,-1,1026,1271,40
54509761256,54509761250,-6,1124,4896,40
54510011520,54510011513,-7,1053,2909,40
54514727880,54514727874,-6,1321,4388,40
54515069084,54515069104,20,177,1610,40
54516763000,54516762998,-2,1239,2073,40
54520339886,54520339880,-6,970,3661,40
54522827827,54522827821,-6,1294,5074,40
54528621139,54528621138,-1,2204,2318,40
54533686400,54533686395,-5,1409,3837,40
54538062350,54538062346,-4,1273,3846,40
54539111796,54539111789,-7,716,3472,40
54542056084,54542056079,-5,773,3940,40
54543109134,54543109152,18,1307,3780,40
54551904321,54551904314,-7,1000,5246,40
54553034226,54553034221,-5,1114,2210,40
54559943164,54559943159,-5,911,3498,40
54561057402,54561057397,-5,720,4167,40
54561325945,54561325938,-7,1163,2978,40
54561671519,54561671502,-17,881,3286,40
54562160036,54562160046,10,188,1461,40
54564734006,54564733999,-7,767,4299,40
54565516634,54565516630,-4,887,3272,40
54565816786,54565816781,-5,1136,5707,40
54566009480,54566009498,18,648,2694,40
54566476395,54566476389,-6,1381,4491,40
54566663516,54566663506,-10,204,1016,40
54569757746,54569757741,-5,1390,3595,40
54570583656,54570583669,13,172,1415,40
54580463693,54580463694,1,1469,1330,40
54585137612,54585137605,-7,1034,4245,40
54585263928,54585263945,17,1031,3036,40
54613910971,54613910965,-6,1156,4371,40
54624592662,54624592654,-8,1088,4062,40
54625834295,54625834290,-5,703,2925,40
54626966758,54626966752,-6,833,3013,40
54629623985,54629623979,-6,1378,4026,40
54630915998,54630915993,-5,973,3475,40
54636368898,54636368894,-4,940,2959,40
54640347503,54640347496,-7,846,3814,40
54644152753,54644152745,-8,2423,9534,40
54650964351,54650964345,-6,760,4056,40
54651499821,54651499826,5,4137,2368,40
54655661861,54655661879,18,598,2540,40
54663665631,54663665625,-6,1114,4463,40
54670590802,54670590802,0,869,1620,40
54676706765,54676706759,-6,1277,3874,40
54679688346,54679688340,-6,1149,4943,40
54680525965,54680525956,-9,1007,3254,40
54687618511,54687618506,-5,698,1217,40
54696424205,54696424199,-6,1039,4309,40
54697473207,54697473201,-6,740,2654,40
54707749167,54707749162,-5,710,2604,40
54709879882,54709879877,-5,1289,1468,40
54712186850,54712186845,-5,1124,3696,40
54714455846,54714455839,-7,1088,3474,40
54714560419,54714560413,-6,1152,4345,40
54717367302,54717367296,-6,1146,3824,40
54718187599,54718187595,-4,1193,3017,40
54723668383,54723668379,-4,1101,3796,40
54729509186,54729509182,-4,1151,2408,40
54730355323,54730355318,-5,1087,3635,40
54731498705,54731498705,0,2198,1952,40
54732519472,54732519492,20,643,2512,40
54734841418,54734841414,-4,1226,5038,40
54737130062,54737130063,1,2200,2463,40
54740437954,54740437949,-5,681,3964,40
54740706006,54740706007,1,355,2665,40
54746065029,54746065023,-6,1226,4025,40
54746597086,54746597106,20,395,1862,40
54747872112,54747872119,7,7075,31272,40
54749744646,54749744639,-7,1285,6317,40
54751967019,54751967014,-5,1047,4088,40
54752369614,54752369607,-7,780,3467,40
54753049107,54753049101,-6,800,4439,40
54754239286,54754239279,-7,156,1741,40
54755633918,54755633913,-5,1183,3262,40
54756049191,54756049168,-23,1017,3404,40
54756409020,54756409034,14,599,2794,40
54757645949,54757645941,-8,771,4094,40
54760079045,54760079044,-1,977,1787,40
54760313599,54760313602,3,200,1231,40
54762043755,54762043751,-4,936,3738,40
54764943581,54764943574,-7,1283,3273,40
54770307991,54770307982,-9,1037,3768,40
54776777487,54776777493,6,4276,2296,40
54777068576,54777068569,-7,1078,5603,40
54777398022,54777398011,-11,137,1114,40
54781082518,54781082513,-5,781,4510,40
54784805722,54784805717,-5,1161,4155,40
54789020746,54789020741,-5,787,3036,40
54791172194,54791172194,0,1002,1061,40
54799723826,54799723826,0,2840,2968,40
54805077926,54805077920,-6,1187,3918,40
54813225047,54813225055,8,7899,2657,40
54816922263,54816922257,-6,932,3660,40
54817102381,54817102370,-11,1034,2898,40
54817463653,54817463662,9,185,1343,40
54821546811,54821546805,-6,1122,5932,40
54822413374,54822413368,-6,1244,3889,40
54822501045,54822501053,8,83,2134,40
54823564086,54823564070,-16,156,1133,40
54829566496,54829566487,-9,4023,24981,40
54830012275,54830012270,-5,1157,5195,40
54838362126,54838362124,-2,19975,15128,40
54840215441,54840215439,-2,1887,4739,40
54842408457,54842408462,5,2210,1980,40
54842966618,54842966612,-6,842,4602,40
54843901914,54843901919,5,4949,2492,40
54849038749,54849038754,5,4658,2786,40
54850428745,54850428742,-3,1527,3197,40
54851533150,54851533143,-7,1076,3883,40
54853701068,54853701062,-6,1159,2878,40
54859085889,54859085883,-6,768,4077,40
54865608203,54865608198,-5,858,2834,40
54866265343,54866265350,7,289,1354,40
54866505398,54866505398,0,186,945,40
54867289799,54867289794,-5,1362,3868,40
54875718630,54875718625,-5,1241,5878,40
54883790378,54883790373,-5,1116,5236,40
54887652707,54887652701,-6,1166,3923,40
54894041894,54894041899,5,2057,1259,40
54900819173,54900819166,-7,1064,3489,40
54901018207,54901018205,-2,250,1184,40
54904556201,54904556198,-3,1268,3508,40
54909816844,54909816837,-7,1244,3635,40
54909958553,54909958546,-7,1107,3040,40
54910129166,54910129145,-21,641,2902,40
54917422778,54917422773,-5,1184,3555,40
54919181737,54919181741,4,11819,25232,40
54921480216,54921480212,-4,805,2779,40
54923107719,54923107731,12,450,2436,40
54924766470,54924766466,-4,1777,4876,40
54926138879,54926138872,-7,1130,3697,40
54926351542,54926351527,-15,1080,2901,40
54927214137,54927214141,4,16681,14541,40
54938237098,54938237093,-5,1302,4080,40
54939449802,54939449797,-5,849,3170,40
54947384981,54947384975,-6,389,1973,40
54957160473,54957160474,1,14029,14713,40
54960802822,54960802816,-6,1133,3484,40
54960984767,54960984785,18,320,993,40
54961164510,54961164504,-6,983,3203,40
54962202026,54962202019,-7,1176,5410,40
54963682643,54963682647,4,189,977,40
54975793677,54975793674,-3,603,2914,40
54982894158,54982894154,-4,954,3746,40
54985336900,54985336894,-6,1360,3911,40
54988809595,54988809590,-5,604,2275,40
54997231129,54997231135,6,3898,1521,40
54999598488,54999598482,-6,571,3511,40
55000250505,55000250500,-5,1498,4724,40
55004886511,55004886506,-5,883,3790,40
55005045896,55005045914,18,102,1051,40
55005104301,55005104323,22,635,2813,40
55009973691,55009973697,6,3088,1521,40
55012903581,55012903576,-5,1249,4966,40
55013056627,55013056621,-6,987,2648,40
55022269570,55022269577,7,1935,1442,40
55023356243,55023356240,-3,758,3083,40
55024035950,55024035945,-5,977,3479,40
55026710967,55026710975,8,163,785,40
55027688544,55027688562,18,1348,3354,40
55029539390,55029539386,-4,1104,2617,40
55029750622,55029750618,-4,1211,3825,40
55029976516,55029976511,-5,1511,3199,40
55045729018,55045729014,-4,844,1932,40
55048677780,55048677783,3,1717,1535,40
55052512405,55052512397,-8,1138,3965,40
55053272821,55053272828,7,3806,1336,40
55056447150,55056447144,-6,1118,4877,40
55056996171,55056996166,-5,995,2955,40
55057177054,55057177050,-4,903,4373,40
55060295071,55060295065,-6,721,2393,40
55060895048,55060895058,10,593,3519,40
55068837454,55068837449,-5,805,3797,40
55069453319,55069453319,0,3605,17457,40
55075036729,55075036726,-3,1301,4818,40
55075790063,55075790049,-14,554,3007,40
55077255418,55077255413,-5,690,4276,40
55081587414,55081587406,-8,944,4420,40
55087257985,55087257986,1,1438,1470,40
55092750043,55092750043,0,992,1521,40
55093908949,55093908944,-5,814,3704,40
55095873509,55095873509,0,3160,4109,40
55099317095,55099317102,7,2892,1431,40
55099808378,55099808374,-4,617,2787,40
55100355836,55100355854,18,705,2946,40
55100616796,55100616790,-6,1722,3540,40
55102474951,55102474945,-6,1207,3300,40
55107332328,55107332322,-6,1118,3531,40
55108300636,55108300630,-6,1946,7648,40
55111302445,55111302438,-7,1237,4325,40
55131146193,55131146186,-7,991,4136,40
55132863019,55132863015,-4,776,2999,40
55133509130,55133509126,-4,692,2805,40
55133735957,55133735950,-7,1097,4696,40
55135222171,55135222164,-7,1158,4381,40
55136654810,55136654803,-7,842,3096,40
55144406238,55144406232,-6,1434,4567,40
55148270965,55148270963,-2,540,2458,40
55148703141,55148703135,-6,1241,3054,40
55149045740,55149045761,21,195,1287,40
55151363655,55151363650,-5,1024,3770,40
55151838399,55151838415,16,539,2698,40
55152559283,55152559275,-8,870,3735,40
55155993889,55155993881,-8,1059,3294,40
55157567342,55157567349,7,5749,2741,40
55170418695,55170418690,-5,1065,3302,40
55173191885,55173191879,-6,706,2916,40
55178240635,55178240630,-5,755,3136,40
55180386324,55180386317,-7,905,3580,40
55180664989,55180664971,-18,139,1077,40
55196081734,55196081727,-7,1264,4617,40
55198210022,55198210017,-5,873,3762,40
55198362095,55198362090,-5,1167,3542,40
55198877254,55198877247,-7,1137,3394,40
55202255871,55202255865,-6,1092,4922,40
55203665918,55203665913,-5,798,2733,40
55204364056,55204364071,15,910,3395,40
55204528969,55204528968,-1,24531,26117,40
55207807811,55207807805,-6,550,3429,40
55214865382,55214865377,-5,1123,2731,40
55219131178,55219131173,-5,786,2520,40
55228298286,55228298280,-6,947,3757,40
55228695268,55228695254,-14,136,1084,40
55230395153,55230395147,-6,1205,3009,40
55247217106,55247217105,-1,820,2134,40
55258410250,55258410242,-8,1241,4700,40
55259195104,55259195099,-5,1764,4628,40
55267657618,55267657625,7,15010,8571,40
55270051797,55270051792,-5,727,1839,40
55282735769,55282735762,-7,1181,2475,40
55283259966,55283259973,7,3459,1158,40
55285146951,55285146947,-4,1500,3882,40
55298548814,55298548807,-7,997,5423,40
55301389699,55301389691,-8,770,3792,40
55303259184,55303259178,-6,478,2140,40
55316627632,55316627626,-6,1573,3566,40
55321077765,55321077765,0,31796,49062,40
55326359642,55326359641,-1,224,1412,40
55328541617,55328541610,-7,2407,8868,40
55330081754,55330081749,-5,551,2241,40
55332522833,55332522834,1,1659,2178,40
55337472051,55337472046,-5,1157,3488,40
55339307382,55339307376,-6,1066,4960,40
55348064551,55348064546,-5,1003,3245,40
55349997587,55349997580,-7,1122,3265,40
55357228542,55357228537,-5,1018,3666,40
55357256790,55357256806,16,1177,3942,40
55361630138,55361630133,-5,1577,4502,40
55364264960,55364264956,-4,2112,5412,40
55368880479,55368880474,-5,946,3662,40
55369146039,55369146023,-16,635,2856,40
55372211621,55372211614,-7,1311,3183,40
55373447019,55373447013,-6,929,3473,40
55373888061,55373888048,-13,576,2991,40
55374174360,55374174373,13,352,1462,40
55383170174,55383170169,-5,710,3737,40
55384549279,55384549272,-7,429,3267,40
55396775435,55396775429,-6,841,2655,40
55402697061,55402697068,7,3491,1669,40
55405342515,55405342509,-6,1255,5394,40
55406578246,55406578267,21,1681,3018,40
55407621263,55407621258,-5,804,2761,40
55408846171,55408846165,-6,1345,4489,40
55411750575,55411750569,-6,1285,4563,40
55418034998,55418034993,-5,756,3683,40
55421933075,55421933070,-5,1527,5222,40
55425410875,55425410871,-4,770,3026,40
55434342163,55434342156,-7,705,3289,40
55434854023,55434854022,-1,1694,2435,40
55436351933,55436351925,-8,853,3879,40
55436460488,55436460471,-17,37,641,40
55440235071,55440235072,1,1164,1369,40
55440901500,55440901518,18,1043,3512,40
55446399849,55446399855,6,2953,1469,40
55448115725,55448115722,-3,1175,2182,40
55450146202,55450146194,-8,1411,5494,40
55450980839,55450980832,-7,854,2483,40
55451161724,55451161745,21,829,3520,40
55453572238,55453572232,-6,1143,4141,40
55455441323,55455441316,-7,591,1976,40
55456607364,55456607358,-6,1019,3256,40
55467924425,55467924418,-7,1360,6791,40
55469428766,55469428782,16,66,881,40
55473651423,55473651418,-5,584,2465,40
55478540464,55478540458,-6,713,3893,40
55486178006,55486178002,-4,751,1312,40
55489804908,55489804890,-18,2372,989,40
55495632955,55495632949,-6,988,3598,40
55500701442,55500701436,-6,1017,3509,40
55508562095,55508562090,-5,1054,2354,40
55508783210,55508783204,-6,945,3438,40
55509111811,55509111804,-7,904,3166,40
55510507511,55510507506,-5,1082,2733,40
55517678889,55517678882,-7,578,2651,40
55517982750,55517982742,-8,339,975,40
55524791819,55524791813,-6,1062,3660,40
55525336348,55525336365,17,310,1393,40
55528310882,55528310877,-5,1370,3322,40
55536440993,55536440988,-5,1279,5026,40
55539654080,55539654074,-6,1396,4605,40
55539734214,55539734210,-4,96,1408,40
55542319256,55542319257,1,367,1211,40
55543131479,55543131473,-6,632,2899,40
55553057931,55553057926,-5,1406,4643,40
55556737291,55556737285,-6,896,4400,40
55562639738,55562639733,-5,995,3336,40
55563862314,55563862303,-11,1033,3789,40
55564120572,55564120566,-6,288,1186,40
55571684265,55571684259,-6,1157,3147,40
55572160146,55572160141,-5,1262,3665,40
55574126018,55574126012,-6,1336,3558,40
55574206185,55574206183,-2,1133,1821,40
55575044909,55575044922,13,101,1258,40
55582387655,55582387651,-4,1014,2080,40
55585444287,55585444281,-6,1106,5026,40
55585721344,55585721338,-6,1632,4673,40
55586349301,55586349317,16,789,4091,40
55588926457,55588926453,-4,906,2987,40
55592458196,55592458191,-5,1650,4944,40
55596945801,55596945795,-6,1437,5231,40
55614520758,55614520763,5,2019,791,40
55615518605,55615518589,-16,928,3132,40
55622071026,55622071023,-3,990,2876,40
55622297992,55622298005,13,209,1885,40
55625254520,55625254513,-7,1124,4791,40
55625913408,55625913403,-5,1333,3359,40
55626770566,55626770554,-12,288,923,40
55627154781,55627154773,-8,260,1398,40
55627502565,55627502582,17,116,1336,40
55634429806,55634429801,-5,842,3048,40
55640818517,55640818507,-10,1070,2921,40
55641418639,55641418627,-12,127,1211,40
55650519442,55650519437,-5,1027,3367,40
55650989428,55650989451,23,417,3366,40
55652206783,55652206778,-5,949,4037,40
55658858988,55658859002,14,354,771,40
55680701354,55680701348,-6,546,1718,40
55683125474,55683125478,4,2019,982,40
55692621769,55692621763,-6,1131,4168,40
55692969116,55692969102,-14,1057,3304,40
55721564135,55721564138,3,1934,1119,40
55723279935,55723279926,-9,1208,4257,40
55727723382,55727723385,3,1290,1503,40
55728237150,55728237160,10,68,919,40
55728330973,55728330978,5,258,1119,40
55733808361,55733808355,-6,740,4037,40
55734398346,55734398339,-7,891,2848,40
55737466202,55737466199,-3,2742,6502,40
55738237837,55738237833,-4,921,4217,40
55744526923,55744526926,3,2898,1308,40
55752152934,55752152930,-4,1138,3224,40
55752973007,55752972999,-8,1308,3726,40
55753067445,55753067463,18,411,1360,40
55755389357,55755389350,-7,1069,4735,40
55755523839,55755523832,-7,1087,3362,40
55757203770,55757203766,-4,901,3361,40
55774032796,55774032812,16,170,736,40
55777084775,55777084795,20,332,1050,40
55778942533,55778942526,-7,947,4424,40
55782794951,55782794953,2,1452,1973,40
55787339867,55787339870,3,1282,1348,40
55791087558,55791087551,-7,956,5667,40
55796014006,55796013998,-8,950,5029,40
55800593873,55800593868,-5,759,2703,40
55800698200,55800698214,14,235,1290,40
55801916442,55801916435,-7,968,2996,40
55804675302,55804675294,-8,949,3617,40
55808356253,55808356258,5,2645,1275,40
55809986225,55809986222,-3,1555,2333,40
55811330965,55811330958,-7,1000,3718,40
55813368782,55813368777,-5,1186,3709,40
55815484547,55815484540,-7,658,2970,40
55820803038,55820803031,-7,1093,3854,40
55821151559,55821151551,-8,1054,3510,40
55823103255,55823103250,-5,1236,2771,40
55829631013,55829631007,-6,1149,3739,40
55846851149,55846851144,-5,730,3030,40
55849084111,55849084112,1,14371,18222,40
55853133946,55853133941,-5,546,4146,40
55857799503,55857799497,-6,2019,6397,40
55862331648,55862331642,-6,1029,2510,40
55866713389,55866713383,-6,1346,4059,40
55871005778,55871005774,-4,926,3251,40
55871806295,55871806311,16,376,1222,40
55873350267,55873350262,-5,263,1447,40
55878067837,55878067832,-5,754,2769,40
55879117782,55879117774,-8,807,3112,40
55881662162,55881662157,-5,1038,4357,40
55883468219,55883468214,-5,1166,3093,40
55893379183,55893379182,-1,3622,4877,40
55900479042,55900479037,-5,1010,2743,40
55902617801,55902617794,-7,1026,3758,40
55907253946,55907253940,-6,1326,2916,40
55913471391,55913471395,4,3704,2987,40
55914472162,55914472162,0,2286,3550,40
55916278118,55916278114,-4,879,1781,40
55917458511,55917458505,-6,961,3918,40
55918419139,55918419135,-4,968,4428,40
55918828027,55918828029,2,1543,1832,40
55931015108,55931015113,5,1672,696,40
55932530299,55932530293,-6,743,3226,40
55934721778,55934721771,-7,975,3088,40
55937599855,55937599850,-5,744,2396,40
55943014899,55943014893,-6,937,3577,40
55947013557,55947013549,-8,1345,4378,40
55947763722,55947763715,-7,997,3189,40
55952361207,55952361201,-6,968,4168,40
55953924453,55953924447,-6,1054,3711,40
55959795614,55959795610,-4,812,3557,40
55961051166,55961051159,-7,1182,3272,40
55964385504,55964385517,13,792,2817,40
55965610878,55965610871,-7,649,2739,40
55965959192,55965959206,14,586,2421,40
55974456662,55974456655,-7,929,4070,40
55976890524,55976890519,-5,1160,4091,40
55979981256,55979981258,2,1911,1905,40
55986139539,55986139533,-6,1051,3998,40
55988206805,55988206798,-7,944,3650,40
55989594478,55989594483,5,2819,1872,40
55999410317,55999410310,-7,1133,3656,40
55999653463,55999653483,20,166,1030,40
56005247307,56005247289,-18,665,198,40
56005317549,56005317569,20,73,660,40
56020331366,56020331362,-4,1699,3103,40
56020482618,56020482619,1,1138,878,40
56032807558,56032807554,-4,1260,3959,40
56035944952,56035944946,-6,970,3440,40
56036017744,56036017757,13,225,1114,40
56037068513,56037068507,-6,874,4638,40
56038065750,56038065742,-8,1488,4509,40
56038398751,56038398746,-5,972,3850,40
56038846903,56038846897,-6,629,2700,40
56040771725,56040771720,-5,762,3099,40
56040921560,56040921545,-15,138,1468,40
56041221054,56041221068,14,244,877,40
56042931063,56042931070,7,3475,1582,40
56044139849,56044139850,1,833,1661,40
56046363827,56046363822,-5,954,5147,40
56049127559,56049127553,-6,1291,4205,40
56053530935,56053530930,-5,915,3923,40
56054002238,56054002234,-4,862,2355,40
56054648630,56054648624,-6,884,2874,40
56055807737,56055807731,-6,869,2325,40
56056742029,56056742022,-7,1308,3588,40
56057573661,56057573657,-4,932,3480,40
56061496059,56061496053,-6,1018,3677,40
56064355790,56064355782,-8,1056,6328,40
56067663087,56067663089,2,1915,2009,40
56074977036,56074977030,-6,985,3656,40
56075655158,56075655170,12,785,4257,40
56079611440,56079611433,-7,1216,4569,40
56079663109,56079663122,13,681,2987,40
56080211646,56080211640,-6,1232,5078,40
56089970765,56089970758,-7,790,4574,40
56093437823,56093437818,-5,902,3803,40
56103294471,56103294469,-2,1197,2355,40
56104629912,56104629905,-7,1293,4155,40
56115639074,56115639066,-8,1233,4560,40
56116674186,56116674179,-7,1361,2846,40
56122917967,56122917965,-2,1299,2380,40
56125591461,56125591456,-5,1397,2585,40
56126159806,56126159818,12,1013,3421,40
56126269239,56126269234,-5,618,1874,40
56127004958,56127004973,15,693,3578,40
56130205353,56130205348,-5,1114,3225,40
56134996565,56134996560,-5,937,3361,40
56143799585,56143799587,2,1933,1500,40
56146009410,56146009405,-5,1970,5883,40
56148355318,56148355316,-2,1778,4117,40
56152561198,56152561194,-4,827,4019,40
56158599465,56158599475,10,21652,51856,40
56158857240,56158857234,-6,555,2703,40
56160244076,56160244071,-5,252,1169,40
56165450286,56165450281,-5,1853,6463,40
56168435553,56168435546,-7,905,4260,40
56170855719,56170855721,2,5267,21704,40
56171061748,56171061752,4,3575,1999,40
56172196133,56172196130,-3,1082,2712,40
56172493900,56172493893,-7,271,1468,40
56179815203,56179815195,-8,912,3235,40
56181251571,56181251565,-6,804,1967,40
56181645393,56181645388,-5,1374,5456,40
56185816486,56185816478,-8,836,3314,40
56189746438,56189746433,-5,1119,4228,40
56195621895,56195621887,-8,1019,3982,40
56198147866,56198147870,4,3005,1445,40
56207475412,56207475409,-3,1198,2359,40
56210217727,56210217722,-5,1326,4438,40
56211471970,56211471965,-5,1421,2606,40
56211935528,56211935534,6,111,1229,40
56220570129,56220570121,-8,1537,5272,40
56225746783,56225746777,-6,785,3147,40
56226782842,56226782835,-7,968,4282,40
56228067110,56228067101,-9,875,3642,40
56228835760,56228835769,9,180,1068,40
56232623461,56232623482,21,1215,3517,40
56237541549,56237541543,-6,985,2794,40
56240892202,56240892197,-5,1035,3992,40
56241966754,56241966749,-5,794,2342,40
56247993934,56247993928,-6,798,3674,40
56256577733,56256577747,14,656,3595,40
56264339009,56264339002,-7,1638,5267,40
56266406198,56266406193,-5,812,2815,40
56266764019,56266764013,-6,1244,4150,40
56270079818,56270079812,-6,889,3701,40
56271013056,56271013050,-6,74,1150,40
56273013741,56273013741,0,1317,2173,40
56284142035,56284142039,4,3556,1899,40
56301503419,56301503409,-10,43681,13151,40
56304923002,56304923009,7,3538,1951,40
56305686346,56305686352,6,2813,1192,40
56309667306,56309667303,-3,861,2540,40
56310234506,56310234499,-7,1214,5782,40
56313603445,56313603439,-6,1023,2919,40
56318666731,56318666726,-5,953,3630,40
56324342407,56324342401,-6,1481,5407,40
56329464304,56329464308,4,12969,2525,40
56330767178,56330767183,5,3629,3186,40
56347058606,56347058602,-4,940,3845,40
56347103126,56347103141,15,227,1637,40
56351282916,56351282919,3,2936,1472,40
56355841072,56355841071,-1,1448,1960,40
56361462175,56361462170,-5,958,2664,40
56363847259,56363847253,-6,814,2467,40
56363927437,56363927450,13,246,2471,40
56365140375,56365140370,-5,1025,5523,40
56365391982,56365391978,-4,867,2925,40
56369032275,56369032269,-6,923,4790,40
56369948554,56369948548,-6,988,4621,40
56371125911,56371125906,-5,1433,4534,40
56371444751,56371444751,0,147,838,40
56371538111,56371538130,19,257,844,40
56380960842,56380960839,-3,1022,2115,40
56388673489,56388673480,-9,1212,4026,40
56388711432,56388711445,13,926,4401,40
56395880575,56395880569,-6,1617,4397,40
56397146209,56397146210,1,2206,1654,40
56399887625,56399887625,0,459,1180,40
56405220349,56405220346,-3,954,2421,40
56405490807,56405490787,-20,515,3841,40
56406025821,56406025819,-2,1132,2870,40
56409413776,56409413770,-6,1310,4820,40
56411289976,56411289973,-3,1634,2760,40
56415213686,56415213679,-7,1176,4582,40
56417122371,56417122367,-4,1103,3058,40
56421215562,56421215557,-5,934,3832,40
56429123834,56429123828,-6,803,3370,40
56439443545,56439443539,-6,978,2943,40
56442809318,56442809310,-8,1184,5524,40
56455967038,56455967031,-7,1171,3228,40
56460769523,56460769523,0,2906,4499,40
56460860906,56460860899,-7,970,3756,40
56460964126,56460964121,-5,243,1231,40
56473662562,56473662557,-5,843,2843,40
56474174068,56474174075,7,138,695,40
56481170053,56481170047,-6,1086,5302,40
56484219056,56484219062,6,5438,1545,40
56486066099,56486066093,-6,1211,4128,40
56489692678,56489692673,-5,517,1392,40
56490834909,56490834911,2,891,1164,40
56493602411,56493602405,-6,854,3921,40
56501516062,56501516058,-4,1187,2498,40
56505440062,56505440057,-5,648,3644,40
56505504371,56505504367,-4,918,3506,40
56506946022,56506946028,6,142,849,40
56514048847,56514048840,-7,1145,2872,40
56514464035,56514464028,-7,713,2069,40
56518688527,56518688531,4,1194,1285,40
56518744339,56518744331,-8,1121,3551,40
56519936323,56519936317,-6,1253,2695,40
56520148454,56520148457,3,178,1194,40
56521662233,56521662228,-5,1129,4064,40
56531300222,56531300215,-7,864,4401,40
56534721167,56534721164,-3,870,1814,40
56535053446,56535053465,19,445,1416,40
56536271107,56536271100,-7,773,4386,40
56538515455,56538515453,-2,539,1358,40
56540046548,56540046541,-7,1274,5523,40
56551073842,56551073837,-5,704,2480,40
56552769550,56552769544,-6,685,3239,40
56557790325,56557790318,-7,1317,4389,40
56560248439,56560248435,-4,1128,2079,40
56561177207,56561177200,-7,1141,3289,40
56561238095,56561238111,16,184,1586,40
56564932211,56564932206,-5,628,2667,40
56565325348,56565325362,14,229,688,40
56569648168,56569648163,-5,1063,4085,40
56569754892,56569754906,14,901,2452,40
56571256956,56571256962,6,2570,1585,40
56572997574,56572997578,4,1673,1776,40
56573296903,56573296896,-7,842,3204,40
56573340124,56573340146,22,1300,2993,40
56575875007,56575875001,-6,935,3361,40
56580943290,56580943283,-7,870,2602,40
56580984493,56580984515,22,711,3194,40
56581639553,56581639547,-6,918,4344,40
56590010891,56590010886,-5,923,3172,40
56590432663,56590432658,-5,827,2644,40
56592415487,56592415482,-5,838,3807,40
56593575778,56593575773,-5,879,3639,40
56605056024,56605056020,-4,867,2950,40
56606279198,56606279195,-3,981,1188,40
56607012830,56607012817,-13,159,897,40
56609169121,56609169118,-3,789,3064,40
56610157211,56610157206,-5,1352,4378,40
56611215642,56611215635,-7,899,3358,40
56614376972,56614376973,1,1233,1246,40
56616135214,56616135209,-5,900,2825,40
56616277558,56616277539,-19,121,1237,40
56618245455,56618245459,4,2029,1229,40
56621870875,56621870869,-6,1141,4371,40
56628087382,56628087377,-5,1265,4551,40
56632618763,56632618757,-6,1052,3152,40
56636249867,56636249862,-5,1205,3745,40
56643871666,56643871674,8,3384,1211,40
56647465567,56647465562,-5,1145,3771,40
56648045382,56648045398,16,1149,3134,40
56648797868,56648797889,21,588,2547,40
56661348675,56661348669,-6,1037,4931,40
56666288414,56666288409,-5,851,4492,40
56672974124,56672974118,-6,1068,5883,40
56676110824,56676110818,-6,1205,4422,40
56676535650,56676535644,-6,988,4234,40
56677053301,56677053291,-10,200,1013,40
56677931104,56677931110,6,187,859,40
56680535348,56680535353,5,2862,1519,40
56683755010,56683755007,-3,1272,4008,40
56685954973,56685954966,-7,1160,3476,40
56686148485,56686148470,-15,1185,3127,40
56689328145,56689328141,-4,945,2837,40
56692658727,56692658722,-5,1192,4263,40
56693052498,56693052492,-6,779,3179,40
56696333150,56696333145,-5,750,2409,40
56696477460,56696477477,17,311,1743,40
56697122812,56697122802,-10,906,2291,40
56708607513,56708607509,-4,862,3880,40
56710381087,56710381082,-5,892,3765,40
56710790990,56710790985,-5,1033,4386,40
56713255893,56713255885,-8,1131,2986,40
56717344236,56717344230,-6,870,4745,40
56721840847,56721840865,18,28497,24624,40
56727139926,56727139922,-4,927,3726,40
56727166877,56727166882,5,2943,1508,40
56732585982,56732585975,-7,730,3727,40
56738232750,56738232743,-7,813,4283,40
56739081220,56739081238,18,792,3484,40
56742790324,56742790318,-6,1197,4590,40
56743402208,56743402227,19,10,1113,40
56752387164,56752387157,-7,1061,4279,40
56755178182,56755178177,-5,1218,4562,40
56763778946,56763778939,-7,1038,4498,40
56764786958,56764786954,-4,1083,4770,40
56767388018,56767388012,-6,1489,5601,40
56767579159,56767579154,-5,1010,3562,40
56767635436,56767635454,18,982,4157,40
56771889936,56771889932,-4,966,2046,40
56775119629,56775119637,8,3370,1502,40
56780160196,56780160189,-7,1061,3647,40
56794147650,56794147643,-7,1220,4248,40
56794258118,56794258139,21,366,2071,40
56796854666,56796854659,-7,1060,4817,40
56798959741,56798959740,-1,1144,1777,40
56800959887,56800959882,-5,1195,3408,40
56803195929,56803195922,-7,1110,3682,40
56803351564,56803351577,13,241,1873,40
56803676007,56803676019,12,672,2324,40
56804868812,56804868807,-5,929,2884,40
56805149492,56805149514,22,1242,3050,40
56810973373,56810973366,-7,879,2364,40
56812093041,56812093034,-7,977,4532,40
56812387638,56812387636,-2,278,1434,40
56813079823,56813079818,-5,1064,2345,40
56814230746,56814230739,-7,1235,4911,40
56814925281,56814925293,12,2648,1926,40
56818696415,56818696410,-5,1062,3673,40
56827794802,56827794806,4,1927,1310,40
56831886102,56831886094,-8,633,3751,40
56831950590,56831950602,12,639,1173,40
56836563449,56836563449,0,1877,2545,40
56837893195,56837893190,-5,1128,4102,40
56840860890,56840860882,-8,995,6005,40
56845907876,56845907870,-6,1118,5126,40
56848879342,56848879334,-8,681,1975,40
56853080678,56853080671,-7,1165,4685,40
56856534351,56856534346,-5,989,5530,40
56857773444,56857773439,-5,45,685,40
56860929887,56860929890,3,3538,3134,40
56861483952,56861483950,-2,918,1569,40
56870971300,56870971295,-5,982,2837,40
56871257646,56871257665,19,386,2481,40
56874510312,56874510311,-1,3735,17434,40
56874916923,56874916917,-6,1008,3408,40
56876009676,56876009691,15,334,928,40
56878469028,56878469021,-7,1036,3724,40
56880023917,56880023938,21,567,904,40
56883418994,56883418988,-6,1295,4325,40
56883448735,56883448728,-7,903,3494,40
56884286404,56884286398,-6,720,2492,40
56886900065,56886900072,7,4253,1330,40
56897021927,56897021929,2,1003,1077,40
56898139821,56898139834,13,396,1382,40
56899888473,56899888472,-1,1829,3413,40
56900533941,56900533934,-7,573,3514,40
56902471078,56902471071,-7,735,3044,40
56902691647,56902691645,-2,557,1985,40
56902978662,56902978678,16,399,1442,40
56905741329,56905741323,-6,935,2847,40
56909157679,56909157677,-2,1410,2665,40
56909725287,56909725290,3,17687,49487,40
56919055704,56919055696,-8,459,3942,40
56920534686,56920534680,-6,887,3017,40
56928258094,56928258088,-6,1411,4228,40
56945910861,56945910857,-4,924,2832,40
56947539879,56947539873,-6,1455,4206,40
56950080224,56950080217,-7,982,4456,40
56954121950,56954121950,0,1292,1604,40
56958214738,56958214732,-6,680,2759,40
56964588550,56964588544,-6,625,2381,40
56964821807,56964821826,19,1066,3266,40
56970986989,56970986984,-5,1142,2824,40
56971136929,56971136923,-6,1319,4552,40
56978839476,56978839471,-5,1206,3927,40
56979516082,56979516076,-6,1178,3441,40
56981540024,56981540035,11,9822,37905,40
56981754486,56981754480,-6,1506,4932,40
56983487888,56983487879,-9,302,1213,40
56984596214,56984596206,-8,706,3308,40
56997261021,56997261016,-5,789,2770,40
56999625414,56999625407,-7,930,5290,40
57001573490,57001573484,-6,943,3145,40
57004110710,57004110706,-4,879,2291,40
57008786895,57008786889,-6,963,3112,40
57010631108,57010631101,-7,1334,6964,40
57011204503,57011204495,-8,1042,4339,40
57011481659,57011481654,-5,959,4610,40
57014886854,57014886849,-5,817,3065,40
57019125586,57019125580,-6,1229,4935,40
57022738390,57022738383,-7,970,4074,40
57028980802,57028980796,-6,480,2986,40
57035899657,57035899651,-6,868,4221,40
57036694894,57036694895,1,240,850,40
57036962925,57036962926,1,49,980,40
57039835348,57039835349,1,2591,2941,40
57041892087,57041892081,-6,1335,3949,40
57042585490,57042585490,0,1941,2304,40
57052407443,57052407441,-2,1247,2115,40
57054790341,57054790334,-7,1094,4683,40
57056755050,57056755054,4,1947,1209,40
57060417890,57060417883,-7,992,3338,40
57061646370,57061646365,-5,971,3889,40
57062756831,57062756826,-5,1054,3151,40
57066818874,57066818871,-3,984,2066,40
57068749181,57068749180,-1,1160,1494,40
57069609562,57069609557,-5,788,3439,40
57076006575,57076006568,-7,754,2325,40
57076751722,57076751714,-8,1011,4088,40
57082469907,57082469901,-6,1340,4660,40
57085656997,57085656999,2,14883,14317,40
57112810982,57112810976,-6,1109,4766,40
57115041093,57115041085,-8,1182,5262,40
57119264502,57119264505,3,3362,2928,40
57120061642,57120061642,0,1312,2051,40
57121527183,57121527184,1,10184,19478,40
57143365055,57143365049,-6,1010,3024,40
57145447351,57145447345,-6,836,2533,40
57146425209,57146425207,-2,1132,2602,40
57148085866,57148085861,-5,1338,4023,40
57152375724,57152375716,-8,1313,3793,40
57168276547,57168276533,-14,953,223,40
57170308627,57170308621,-6,866,3676,40
57171405187,57171405183,-4,1271,4111,40
57174567315,57174567306,-9,922,10114,40
57191438679,57191438673,-6,972,2078,40
57193128250,57193128246,-4,695,2805,40
57193396444,57193396461,17,43,1552,40
57194195801,57194195794,-7,1445,4435,40
57198066123,57198066118,-5,1003,2993,40
57206576227,57206576221,-6,768,3244,40
57209514258,57209514251,-7,883,4512,40
57214319607,57214319601,-6,1044,4051,40
57214722639,57214722658,19,959,2840,40
57217341967,57217341979,12,2201,1743,40
57225861731,57225861725,-6,1169,2790,40
57226320775,57226320761,-14,1048,4391,40
57227486623,57227486615,-8,84,1206,40
57232638935,57232638930,-5,1346,3972,40
57233278854,57233278847,-7,1085,3829,40
57236103656,57236103660,4,11542,24766,40
57239004959,57239004954,-5,783,3590,40
57243182123,57243182120,-3,2206,5524,40
57244714067,57244714064,-3,1552,3938,40
57253812691,57253812685,-6,718,3566,40
57256231575,57256231570,-5,1055,4798,40
57257863417,57257863411,-6,1353,3752,40
57260773999,57260773995,-4,829,3245,40
57260850719,57260850723,4,1502,1017,40
57264391746,57264391741,-5,1221,3296,40
57266886366,57266886363,-3,112,777,40
57268134237,57268134231,-6,693,2785,40
57273974536,57273974531,-5,1035,2503,40
57274655784,57274655790,6,5460,2289,40
57275913624,57275913618,-6,415,2020,40
57278021962,57278021955,-7,1337,4941,40
57278067313,57278067307,-6,998,2784,40
57291589102,57291589110,8,15312,13084,40
57294224394,57294224389,-5,1193,4240,40
57295964645,57295964640,-5,1037,3388,40
57296129165,57296129184,19,912,3140,40
57296328179,57296328184,5,2880,2066,40
57299491828,57299491821,-7,1043,5254,40
57299659042,57299659037,-5,1298,4876,40
57302347549,57302347544,-5,1078,4241,40
57310435582,57310435575,-7,538,1828,40
57311170532,57311170533,1,6,763,40
57319515179,57319515175,-4,1174,4219,40
57320225699,57320225694,-5,1014,3244,40
57325533730,57325533725,-5,997,2117,40
57329411527,57329411523,-4,466,953,40
57337389418,57337389418,0,2346,3906,40
57337621641,57337621633,-8,652,1431,40
57339300429,57339300430,1,8830,9213,40
57340244492,57340244508,16,482,1715,40
57342321000,57342320997,-3,1287,3210,40
57344347714,57344347708,-6,797,2297,40
57345926046,57345926038,-8,995,2877,40
57346321826,57346321818,-8,1135,4141,40
57346898179,57346898173,-6,770,3573,40
57347802758,57347802752,-6,1138,3677,40
57348691125,57348691119,-6,1221,3406,40
57353313204,57353313201,-3,1684,4707,40
57357956070,57357956069,-1,1224,1330,40
57368653607,57368653603,-4,786,3308,40
57370628672,57370628665,-7,901,3221,40
57370822388,57370822383,-5,1275,4254,40
57373645862,57373645857,-5,1343,4423,40
57377272995,57377273003,8,2532,872,40
57385833854,57385833849,-5,927,4093,40
57388155527,57388155519,-8,909,3306,40
57389263049,57389263051,2,1775,1498,40
57390799890,57390799883,-7,938,4906,40
57395306697,57395306685,-12,117,1950,40
57401858523,57401858539,16,472,2438,40
57408598994,57408598988,-6,1035,3424,40
57409841007,57409841002,-5,1067,3498,40
57410037063,57410037069,6,126,743,40
57412072779,57412072773,-6,896,3567,40
57412519148,57412519146,-2,39907,20782,40
57414213746,57414213741,-5,1477,6733,40
57414886712,57414886705,-7,1019,5294,40
57415183422,57415183401,-21,174,1172,40
57422849149,57422849141,-8,1130,4643,40
57432913886,57432913880,-6,1491,3934,40
57435591562,57435591557,-5,1064,3958,40
57435634733,57435634742,9,295,1837,40
57436735194,57436735189,-5,933,3342,40
57438323484,57438323473,-11,718,3220,40
57438419655,57438419653,-2,243,1339,40
57439907187,57439907181,-6,1117,3347,40
57441039173,57441039168,-5,907,3424,40
57441122112,57441122107,-5,1386,4321,40
57443088473,57443088469,-4,659,3037,40
57452115229,57452115222,-7,850,3605,40
57455298350,57455298354,4,3274,1842,40
57464549334,57464549328,-6,1070,4561,40
57465890342,57465890342,0,282,888,40
57476293518,57476293529,11,266,1212,40
57476712855,57476712848,-7,568,2915,40
57478237981,57478237978,-3,91,936,40
57478879688,57478879682,-6,802,2860,40
57479424531,57479424525,-6,888,3800,40
57479711303,57479711306,3,194,951,40
57482815438,57482815422,-16,176,1237,40
57483497555,57483497549,-6,1044,3751,40
57483851382,57483851401,19,1066,2836,40
57491280518,57491280513,-5,1064,4959,40
57492980834,57492980830,-4,1015,4607,40
57494515574,57494515569,-5,765,2047,40
57495806438,57495806451,13,245,812,40
57500902458,57500902445,-13,44,1258,40
57502890868,57502890862,-6,1126,4347,40
57507496123,57507496117,-6,955,3228,40
57508964878,57508964874,-4,815,3237,40
57521988791,57521988785,-6,620,3680,40
57522176063,57522176063,0,124,1019,40
57525031808,57525031815,7,1595,890,40
57531620991,57531620985,-6,923,4097,40
57541227071,57541227066,-5,1263,3632,40
57542643551,57542643545,-6,862,3086,40
57550312901,57550312895,-6,1125,4074,40
57550802045,57550802051,6,178,1278,40
57551190869,57551190851,-18,201,1175,40
57552128373,57552128366,-7,925,3921,40
57552648910,57552648906,-4,268,1249,40
57554421450,57554421446,-4,851,3064,40
57554708270,57554708251,-19,1012,3469,40
57558174359,57558174354,-5,966,4639,40
57558728349,57558728369,20,622,3630,40
57558970637,57558970632,-5,836,2912,40
57561893341,57561893341,0,2413,3189,40
57562274050,57562274043,-7,1297,3960,40
57562749796,57562749777,-19,183,1434,40
57562972588,57562972581,-7,229,1580,40
57573327850,57573327846,-4,785,3636,40
57574685137,57574685133,-4,1097,3221,40
57574757773,57574757780,7,2744,1392,40
57575163270,57575163265,-5,826,3218,40
57578361558,57578361553,-5,891,3838,40
57578505100,57578505103,3,212,1562,40
57591037548,57591037542,-6,1000,3973,40
57594849174,57594849169,-5,1307,5414,40
57595459757,57595459773,16,622,3539,40
57601475381,57601475376,-5,899,3327,40
57601821823,57601821837,14,398,1778,40
57602806275,57602806289,14,691,2568,40
57603778538,57603778532,-6,706,4424,40
57608056769,57608056762,-7,719,2635,40
57608498677,57608498678,1,260,1790,40
57611232877,57611232872,-5,17236,17058,40
57616149856,57616149874,18,229,1218,40
57624923846,57624923850,4,2299,2628,40
57626674947,57626674941,-6,1032,2680,40
57628912837,57628912832,-5,986,3089,40
57630258734,57630258717,-17,142,1407,40
57632242972,57632242966,-6,1224,4922,40
57632587495,57632587497,2,143,1666,40
57634712184,57634712179,-5,1079,3655,40
57636812208,57636812201,-7,975,3224,40
57642773502,57642773510,8,3867,1132,40
57647289867,57647289862,-5,1035,3851,40
57647844891,57647844882,-9,937,3867,40
57651445699,57651445693,-6,1216,4507,40
57655563671,57655563666,-5,1141,3692,40
57659820620,57659820614,-6,1366,3327,40
57661107047,57661107061,14,680,5125,40
57661932054,57661932048,-6,1269,4073,40
57673309512,57673309507,-5,1243,3050,40
57675481703,57675481698,-5,806,2955,40
57680775819,57680775813,-6,665,2614,40
57683182450,57683182445,-5,734,2935,40
57683396886,57683396879,-7,80,1058,40
57687480253,57687480249,-4,652,3692,40
57687714088,57687714097,9,227,850,40
57689447921,57689447914,-7,891,3009,40
57715536263,57715536263,0,738,1706,40
57717535490,57717535485,-5,1360,3933,40
57719241985,57719241979,-6,1322,5062,40
57720088558,57720088551,-7,1005,2826,40
57720195477,57720195493,16,218,3151,40
57724914086,57724914082,-4,730,2333,40
57727019378,57727019375,-3,673,2231,40
57729195271,57729195266,-5,1063,4077,40
57730484571,57730484566,-5,902,3934,40
57731045288,57731045307,19,205,1115,40
57732543952,57732543947,-5,977,4506,40
57738404221,57738404235,14,170,721,40
57741199103,57741199097,-6,551,3918,40
57749131961,57749131953,-8,1135,5441,40
57760920195,57760920188,-7,974,3009,40
57762472301,57762472298,-3,935,2562,40
57766120610,57766120613,3,1595,1601,40
57768810414,57768810408,-6,556,3379,40
57768901255,57768901237,-18,2122,6144,40
57769632700,57769632721,21,608,2916,40
57770555742,57770555735,-7,750,2961,40
57773262185,57773262186,1,3074,3093,40
57775145623,57775145620,-3,1128,1902,40
57780290094,57780290093,-1,1471,1835,40
57780648197,57780648182,-15,996,3122,40
57788591070,57788591076,6,4453,2250,40
57793637690,57793637684,-6,777,2031,40
57794365870,57794365876,6,191,1001,40
57796163202,57796163197,-5,885,1918,40
57801056894,57801056886,-8,1188,4039,40
57804143078,57804143071,-7,1131,4441,40
57806782192,57806782186,-6,1671,6572,40
57810609098,57810609093,-5,1064,2921,40
57812538563,57812538558,-5,383,3084,40
57812890709,57812890690,-19,198,956,40
57821170610,57821170603,-7,1252,3113,40
57827018954,57827018951,-3,1169,3396,40
57829071282,57829071285,3,2363,1480,40
57833622502,57833622503,1,2411,2429,40
57834595310,57834595302,-8,901,2700,40
57834734728,57834734722,-6,798,4534,40
57836800698,57836800693,-5,1696,6687,40
57838575146,57838575138,-8,1063,3770,40
57839194910,57839194905,-5,831,3761,40
57842607694,57842607686,-8,1383,5320,40
57843499541,57843499537,-4,1072,2069,40
57843982591,57843982601,10,344,1719,40
57846043844,57846043839,-5,1135,3538,40
57846172846,57846172830,-16,77,1103,40
57848930559,57848930553,-6,1276,3158,40
57854956198,57854956194,-4,290,1493,40
57858175265,57858175263,-2,58494,29539,40
57859853107,57859853099,-8,647,7290,40
57860160296,57860160287,-9,797,5432,40
57860382796,57860382817,21,1064,3257,40
57862282839,57862282833,-6,1058,3600,40
57873983003,57873983014,11,9943,40044,40
57878946270,57878946265,-5,910,2697,40
57879111509,57879111526,17,120,705,40
57883106704,57883106698,-6,990,5479,40
57886706566,57886706577,11,11747,50663,40
57895755581,57895755576,-5,906,2779,40
57896630504,57896630483,-21,1062,2929,40
57897686957,57897686942,-15,720,1662,40
57903614247,57903614242,-5,957,3838,40
57904579591,57904579586,-5,1019,4778,40
57912126375,57912126368,-7,814,2943,40
57916668079,57916668073,-6,1301,4263,40
57924417067,57924417061,-6,1318,3259,40
57926679379,57926679369,-10,498,1269,40
57930153607,57930153614,7,2241,848,40
57935197850,57935197843,-7,798,4046,40
57942848186,57942848178,-8,675,3250,40
57943451326,57943451319,-7,199,1100,40
57945558111,57945558106,-5,830,3975,40
57948681521,57948681518,-3,1016,2999,40
57948764053,57948764034,-19,118,1146,40
57951753799,57951753793,-6,1174,4282,40
57952235328,57952235321,-7,1386,4185,40
57954175459,57954175453,-6,1425,3991,40
57955152905,57955152899,-6,1226,2499,40
57957186870,57957186864,-6,1104,5524,40
57958644230,57958644223,-7,1321,2770,40
57960572241,57960572237,-4,1157,2906,40
57960734357,57960734359,2,131,1189,40
57964616869,57964616862,-7,908,3887,40
57965282318,57965282306,-12,1156,3862,40
57968966939,57968966936,-3,1171,4046,40
57969211754,57969211747,-7,833,3945,40
57971115629,57971115623,-6,708,1974,40
57973741142,57973741140,-2,1081,3849,40
57978229095,57978229094,-1,26427,20776,40
57983266317,57983266321,4,2069,1427,40
57986771574,57986771581,7,3630,1871,40
57988305885,57988305889,4,1959,1361,40
57989756084,57989756078,-6,1327,4567,40
57992039726,57992039722,-4,1195,3638,40
57992763301,57992763296,-5,584,1581,40
57995681487,57995681483,-4,623,2331,40
57996275654,57996275666,12,410,1864,40
58001023762,58001023758,-4,785,3949,40
58001982352,58001982360,8,323,904,40
58003465513,58003465506,-7,696,2442,40
58003619759,58003619737,-22,209,1159,40
58004519565,58004519558,-7,1595,4337,40
58008340133,58008340129,-4,1209,3183,40
58010752023,58010752019,-4,865,3034,40
58016730262,58016730258,-4,711,2585,40
58020488133,58020488126,-7,862,2929,40
58020672526,58020672547,21,204,999,40
58022288127,58022288120,-7,1250,3198,40
58037208382,58037208378,-4,1890,3532,40
58046442542,58046442537,-5,1278,3897,40
58051577250,58051577230,-20,2494,1226,40
58056539350,58056539342,-8,775,2916,40
58056633648,58056633662,14,13,1279,40
58062549185,58062549182,-3,383,1101,40
58064133483,58064133478,-5,880,3253,40
58065608862,58065608857,-5,1136,3438,40
58065854885,58065854870,-15,344,1276,40
58066374508,58066374491,-17,813,2792,40
58067637518,58067637514,-4,1255,3773,40
58071981698,58071981693,-5,1205,3944,40
58074238076,58074238077,1,41523,45298,40
58088394777,58088394770,-7,988,2825,40
58095156417,58095156412,-5,1261,3638,40
58096806082,58096806077,-5,1171,4489,40
58100458856,58100458851,-5,961,3852,40
58103967027,58103967021,-6,1082,3502,40
58104702614,58104702609,-5,761,3815,40
58119704442,58119704437,-5,1009,2851,40
58120330528,58120330539,11,776,3323,40
58120617007,58120617001,-6,1019,3935,40
58125789203,58125789198,-5,732,2805,40
58132164461,58132164455,-6,941,4982,40
58133393347,58133393341,-6,943,4351,40
58139789762,58139789756,-6,1181,5199,40
58140205023,58140205018,-5,1283,3642,40
58140450421,58140450426,5,1933,1089,40
58140648516,58140648510,-6,573,2855,40
58142478300,58142478302,2,321,1141,40
58146517450,58146517443,-7,1107,3881,40
58146837485,58146837478,-7,77,1225,40
58147510903,58147510918,15,113,1270,40
58148610405,58148610402,-3,955,3449,40
58159105887,58159105882,-5,933,3877,40
58163792647,58163792650,3,1256,1288,40
58174023754,58174023762,8,1930,1172,40
58176088741,58176088739,-2,1962,2648,40
58176330277,58176330273,-4,895,3534,40
58176461104,58176461117,13,237,1579,40
58177105599,58177105594,-5,1199,4169,40
58178775747,58178775742,-5,961,2702,40
58178976886,58178976871,-15,961,704,40
58181765781,58181765776,-5,984,2493,40
58191981437,58191981432,-5,882,3309,40
58193962790,58193962795,5,399,848,40
58195139082,58195139075,-7,1128,3437,40
58197557983,58197557977,-6,827,2296,40
58197645439,58197645437,-2,1497,2424,40
58215138586,58215138582,-4,1040,2901,40
58215934273,58215934274,1,1525,1759,40
58219891729,58219891722,-7,1005,4018,40
58221504285,58221504278,-7,1303,4292,40
58225872407,58225872401,-6,668,4058,40
58232756097,58232756090,-7,1462,4359,40
58234029193,58234029186,-7,863,3182,40
58234294271,58234294286,15,68,1307,40
58238757677,58238757672,-5,1287,4087,40
58240566855,58240566849,-6,1320,4788,40
58243886888,58243886882,-6,1075,4593,40
58244091965,58244091949,-16,855,4800,40
58244957570,58244957563,-7,887,3699,40
58250011593,58250011603,10,9770,35666,40
58250155496,58250155490,-6,617,2191,40
58254633719,58254633714,-5,1197,4665,40
58255738366,58255738385,19,529,1239,40
58259508436,58259508428,-8,1453,5806,40
58260138636,58260138629,-7,709,4146,40
58262584963,58262584958,-5,685,1570,40
58266356863,58266356858,-5,1090,2150,40
58269085894,58269085889,-5,1514,4214,40
58270635014,58270635006,-8,960,4564,40
58274255883,58274255878,-5,1081,3857,40
58274400190,58274400189,-1,154,1229,40
58276041434,58276041427,-7,942,2672,40
58280396061,58280396056,-5,983,2645,40
58288200442,58288200449,7,2627,1063,40
58291475777,58291475772,-5,1036,3867,40
58300558294,58300558288,-6,906,3496,40
58305722342,58305722360,18,662,2873,40
58308179615,58308179610,-5,1079,5001,40
58308824461,58308824456,-5,896,3470,40
58311937399,58311937393,-6,1150,3542,40
58321497384,58321497388,4,2694,1451,40
58323120802,58323120796,-6,928,3984,40
58328059667,58328059661,-6,1393,4889,40
58332138928,58332138921,-7,950,2356,40
58332712023,58332712017,-6,175,1977,40
58347681862,58347681857,-5,1662,4606,40
58359445737,58359445737,0,1568,2425,40
58370788191,58370788185,-6,1085,4639,40
58381323410,58381323403,-7,1409,4607,40
58381904211,58381904205,-6,1232,3956,40
58390161326,58390161319,-7,398,1176,40
58398808475,58398808486,11,275,1169,40
58400423579,58400423574,-5,1213,3952,40
58405950351,58405950345,-6,981,3044,40
58418807334,58418807341,7,2219,963,40
58419812944,58419812938,-6,1012,3165,40
58425164601,58425164594,-7,979,3021,40
58425514916,58425514912,-4,1606,2715,40
58429430390,58429430385,-5,1223,4518,40
58430935073,58430935069,-4,1150,4654,40
58436452139,58436452133,-6,1240,6934,40
58436515389,58436515406,17,721,2619,40
58442297703,58442297698,-5,1186,4445,40
58443541011,58443541005,-6,1110,4244,40
58444070212,58444070208,-4,946,2567,40
58444671150,58444671162,12,167,802,40
58448065051,58448065047,-4,1540,4307,40
58449937602,58449937599,-3,1040,3292,40
58452285723,58452285718,-5,805,2266,40
58455171638,58455171631,-7,842,2673,40
58458054510,58458054506,-4,930,2203,40
58458095239,58458095257,18,424,1535,40
58458934115,58458934110,-5,1303,2941,40
58460518313,58460518324,11,12743,43540,40
58463610482,58463610483,1,1514,1598,40
58467375623,58467375618,-5,732,3804,40
58469557575,58469557569,-6,648,2547,40
58475058734,58475058734,0,1519,2514,40
58482853648,58482853641,-7,1125,4233,40
58483942358,58483942375,17,862,3111,40
58484475807,58484475802,-5,716,1150,40
58491480007,58491480005,-2,1101,2573,40
58493540993,58493540989,-4,1160,3282,40
58494094407,58494094390,-17,179,3268,40
58509959330,58509959323,-7,725,3286,40
58519432509,58519432530,21,1193,1531,40
58520003135,58520003129,-6,930,3182,40
58520816914,58520816910,-4,846,2520,40
58525443893,58525443888,-5,1051,4252,40
58526008430,58526008425,-5,938,4017,40
58529222786,58529222781,-5,918,4486,40
58531763262,58531763267,5,4349,2276,40
58534908427,58534908422,-5,1401,5341,40
58536742514,58536742509,-5,993,3198,40
58547919382,58547919377,-5,778,3091,40
58557451022,58557451016,-6,954,1794,40
58568576480,58568576478,-2,3165,4230,40
58583024591,58583024587,-4,401,980,40
58584312063,58584312056,-7,1133,4570,40
58585619577,58585619574,-3,1234,1987,40
58588175950,58588175944,-6,1008,2469,40
58595917578,58595917585,7,9697,3277,40
58600649615,58600649610,-5,1036,3401,40
58601963686,58601963705,19,96,1296,40
58605156732,58605156725,-7,1148,3492,40
58607075029,58607075022,-7,1677,8436,40
58613793010,58613793007,-3,1076,2876,40
58617032382,58617032375,-7,1129,5109,40
58617230476,58617230469,-7,1259,3124,40
58617444462,58617444470,8,9048,18846,40
58619159511,58619159509,-2,1407,2620,40
58620119870,58620119863,-7,621,2574,40
58620414327,58620414343,16,1108,2687,40
58621981135,58621981150,15,161,936,40
58626610983,58626610978,-5,947,2642,40
58627205197,58627205212,15,183,1191,40
58628952381,58628952375,-6,939,3814,40
58630662721,58630662725,4,912,635,40
58632611047,58632611041,-6,982,4264,40
58639098784,58639098777,-7,1462,3547,40
58642559865,58642559845,-20,1819,926,40
58647501131,58647501126,-5,1021,2869,40
58654784101,58654784093,-8,934,4056,40
58658150669,58658150662,-7,1208,3444,40
58665449699,58665449693,-6,941,3918,40
58665993666,58665993662,-4,1021,4651,40
58666501189,58666501207,18,324,1434,40
58670567639,58670567633,-6,1012,3473,40
58670833965,58670833978,13,267,1319,40
58672198810,58672198803,-7,1031,3575,40
58675058227,58675058224,-3,1225,2803,40
58676038263,58676038270,7,111,665,40
58677970839,58677970832,-7,29428,13917,40
58678475751,58678475744,-7,972,4631,40
58681475104,58681475099,-5,1065,2745,40
58682714774,58682714770,-4,324,1196,40
58686679334,58686679328,-6,625,1890,40
58686778762,58686778757,-5,1400,4585,40
58687133405,58687133420,15,609,1834,40
58691677172,58691677166,-6,1099,2613,40
58695278047,58695278041,-6,860,3620,40
58695386837,58695386830,-7,281,1164,40
58696272327,58696272323,-4,726,2419,40
58696363118,58696363130,12,301,1210,40
58701338418,58701338411,-7,804,2819,40
58701469573,58701469569,-4,223,1079,40
58702130577,58702130582,5,2311,1354,40
58703449383,58703449378,-5,503,1732,40
58703737168,58703737180,12,152,1174,40
58706208643,58706208637,-6,975,3284,40
58709524007,58709524001,-6,785,2226,40
58712562661,58712562653,-8,1207,4039,40
58723602280,58723602273,-7,946,5576,40
58731028663,58731028658,-5,1153,3398,40
58731079998,58731079976,-22,146,743,40
58739437309,58739437302,-7,1680,4418,40
58752306969,58752306961,-8,533,1623,40
58769080407,58769080401,-6,1119,3442,40
58771270069,58771270062,-7,738,3362,40
58776777398,58776777389,-9,556,5342,40
58786217409,58786217404,-5,1360,3635,40
58789279913,58789279919,6,1273,715,40
58795116078,58795116073,-5,1094,4893,40
58807792043,58807792037,-6,974,3271,40
58808143228,58808143226,-2,1070,1365,40
58810215388,58810215378,-10,131,546,40
58810466693,58810466713,20,611,2291,40
58810800543,58810800538,-5,1124,3493,40
58813839736,58813839729,-7,963,3454,40
58813905085,58813905074,-11,791,4091,40
58817704551,58817704545,-6,965,3769,40
58820729190,58820729184,-6,1496,3678,40
58822564002,58822563995,-7,970,3223,40
58831086970,58831086966,-4,1057,3187,40
58831322623,58831322627,4,162,1009,40
58831999383,58831999377,-6,808,3179,40
58834793820,58834793814,-6,1246,3415,40
58834958583,58834958581,-2,143,1060,40
58835219951,58835219946,-5,1481,5291,40
58840583123,58840583117,-6,1111,3307,40
58843798142,58843798136,-6,684,4668,40
58849602872,58849602870,-2,901,1625,40
58854060435,58854060430,-5,1165,3350,40
58856263840,58856263841,1,11080,13092,40
58860093846,58860093839,-7,902,5043,40
58860316591,58860316570,-21,1006,3732,40
58865631729,58865631724,-5,1375,3820,40
58867073226,58867073218,-8,908,3041,40
58867421366,58867421360,-6,1032,2628,40
58867597692,58867597712,20,298,1031,40
58871623484,58871623477,-7,1017,3005,40
58878715553,58878715551,-2,226,643,40
58878977846,58878977849,3,65,1042,40
58881967141,58881967135,-6,985,3697,40
58882502158,58882502153,-5,1265,4004,40
58893574774,58893574773,-1,2996,16629,40
58894753186,58894753178,-8,1215,3960,40
58895758050,58895758042,-8,797,4323,40
58899695764,58899695758,-6,889,4116,40
58900606816,58900606810,-6,1469,5249,40
58900808014,58900808009,-5,954,3691,40
58901433573,58901433591,18,715,8693,40
58902433083,58902433090,7,2483,1348,40
58903041578,58903041578,0,1397,2380,40
58903071022,58903071013,-9,8,2217,40
58903336233,58903336224,-9,978,4915,40
58903425054,58903425061,7,219,1475,40
58904649386,58904649378,-8,869,3299,40
58916434777,58916434780,3,2042,1670,40
58923262029,58923262024,-5,630,1979,40
58929775061,58929775054,-7,848,3862,40
58930274815,58930274825,10,331,1298,40
58932715437,58932715431,-6,827,2863,40
58932766403,58932766399,-4,853,2836,40
58938315886,58938315881,-5,1121,4084,40
58939326269,58939326268,-1,1091,1984,40
58941239430,58941239417,-13,160,607,40
58951735685,58951735683,-2,1084,2401,40
58954021063,58954021057,-6,1058,3508,40
58954557964,58954557983,19,515,1549,40
58955167559,58955167554,-5,1241,3662,40
58955601308,58955601326,18,358,984,40
58956205326,58956205321,-5,1358,3372,40
58960686151,58960686149,-2,1179,1041,40
58963454243,58963454236,-7,1208,4570,40
58971966370,58971966365,-5,1289,4344,40
58972522881,58972522874,-7,891,2850,40
58977942116,58977942109,-7,1084,4232,40
58978037159,58978037153,-6,762,3397,40
58981604019,58981604014,-5,1405,4570,40
58985643031,58985643025,-6,1047,4501,40
58987726462,58987726462,0,732,1345,40
58987766420,58987766415,-5,98,703,40
58989471170,58989471176,6,17776,28214,40
58990124926,58990124922,-4,621,2207,40
59001562054,59001562049,-5,1007,2962,40
59009426170,59009426163,-7,1181,4630,40
59012217947,59012217939,-8,908,3380,40
59013124014,59013124026,12,876,4277,40
59015311046,59015311038,-8,715,3832,40
59025247397,59025247391,-6,1080,3388,40
59027931047,59027931039,-8,835,2729,40
59029816057,59029816051,-6,672,4257,40
59030730038,59030730037,-1,1049,2036,40
59035084506,59035084501,-5,772,2966,40
59036816250,59036816251,1,1365,2045,40
59039435057,59039435063,6,1927,1095,40
59040464422,59040464417,-5,1244,3771,40
59040782637,59040782637,0,228,1355,40
59049666821,59049666816,-5,1165,2760,40
59052423158,59052423153,-5,716,1550,40
59053819427,59053819421,-6,1161,4405,40
59056107847,59056107841,-6,1241,4372,40
59056914383,59056914392,9,24762,57920,40
59058691698,59058691694,-4,932,3316,40
59059688897,59059688890,-7,1129,4028,40
59059872422,59059872441,19,222,1782,40
59067800576,59067800570,-6,1315,4747,40
59068108277,59068108296,19,1019,2588,40
59068661679,59068661673,-6,1248,5331,40
59081125014,59081125007,-7,754,4672,40
59081502320,59081502314,-6,614,2794,40
59082146261,59082146266,5,100,616,40
59084766294,59084766288,-6,794,3052,40
59085087797,59085087792,-5,929,3701,40
59085752142,59085752123,-19,357,1234,40
59086499652,59086499665,13,12485,50919,40
59092970556,59092970564,8,12413,27695,40
59105519850,59105519845,-5,652,2002,40
59105862500,59105862494,-6,932,3876,40
59107368742,59107368737,-5,1072,2736,40
59111208829,59111208821,-8,1026,3444,40
59113715206,59113715201,-5,787,3188,40
59114163406,59114163398,-8,205,775,40
59114301237,59114301258,21,748,3314,40
59115248065,59115248059,-6,867,3773,40
59115490450,59115490444,-6,25938,14079,40
59116749357,59116749351,-6,879,2979,40
59118204650,59118204645,-5,950,2912,40
59118752494,59118752490,-4,158,1295,40
59125225856,59125225849,-7,1088,3964,40
59127214665,59127214659,-6,761,2538,40
59133568537,59133568530,-7,1181,4199,40
59135776820,59135776812,-8,607,3766,40
59135817982,59135817961,-21,109,1235,40
59139078013,59139078007,-6,1126,4059,40
59140151658,59140151651,-7,1447,5991,40
59141107374,59141107367,-7,1015,4289,40
59141939644,59141939649,5,2404,1187,40
59149073766,59149073761,-5,933,3573,40
59149835214,59149835206,-8,712,5039,40
59155810831,59155810828,-3,1372,2814,40
59161861834,59161861830,-4,1181,2323,40
59164787686,59164787684,-2,1084,1963,40
59165242561,59165242565,4,2054,1112,40
59165899402,59165899393,-9,1064,4414,40
59168812470,59168812463,-7,2074,4665,40
59174393783,59174393778,-5,1341,2764,40
59174476372,59174476370,-2,20581,87012,40
59179818401,59179818395,-6,1094,3699,40
59184710703,59184710698,-5,1190,4422,40
59186225266,59186225261,-5,1273,5135,40
59187388180,59187388191,11,106,1467,40
59190354141,59190354134,-7,992,3902,40
59193038111,59193038104,-7,1011,4351,40
59193082199,59193082215,16,6,866,40
59194366046,59194366041,-5,904,4031,40
59197183940,59197183937,-3,1338,2393,40
59198496958,59198496953,-5,662,2389,40
59209508352,59209508346,-6,906,2998,40
59215674211,59215674205,-6,803,2343,40
59215852020,59215852002,-18,512,1357,40
59227107243,59227107236,-7,1213,3804,40
59228651971,59228651966,-5,1478,4852,40
59229012033,59229012027,-6,840,2283,40
59231234337,59231234332,-5,1188,3721,40
59231393190,59231393196,6,436,1225,40
59232169093,59232169087,-6,699,3854,40
59234112416,59234112407,-9,829,9748,40
59234527974,59234527966,-8,1056,3635,40
59235154684,59235154702,18,504,2625,40
59236660591,59236660583,-8,842,3199,40
59238124158,59238124153,-5,955,3354,40
59240386107,59240386100,-7,915,3342,40
59241829175,59241829169,-6,541,2492,40
59253011206,59253011202,-4,1199,3917,40
59258793037,59258793031,-6,596,2169,40
59271066489,59271066494,5,3639,1232,40
59271625055,59271625049,-6,1319,4255,40
59277661208,59277661200,-8,1061,4950,40
59279898001,59279897997,-4,1293,3527,40
59280727800,59280727817,17,615,1928,40
59292406492,59292406486,-6,618,1097,40
59298779909,59298779904,-5,341,2475,40
59298872279,59298872274,-5,777,4329,40
59299843966,59299843962,-4,397,2195,40
59300693116,59300693112,-4,2438,5970,40
59304892802,59304892795,-7,911,3657,40
59307089445,59307089438,-7,466,2261,40
59308142188,59308142183,-5,906,2569,40
59314215018,59314215014,-4,1098,2669,40
59314496667,59314496661,-6,1263,3680,40
59316336819,59316336815,-4,1074,3940,40
59330982218,59330982222,4,1271,1212,40
59331191938,59331191934,-4,841,4238,40
59335407706,59335407702,-4,1055,4569,40
59335456720,59335456714,-6,975,3472,40
59335863304,59335863287,-17,154,1074,40
59338221645,59338221642,-3,1011,3870,40
59340588726,59340588722,-4,1051,4154,40
59341214145,59341214138,-7,910,2023,40
59341791097,59341791093,-4,1064,2231,40
59342407726,59342407729,3,258,1213,40
59344521613,59344521607,-6,1046,4700,40
59345322185,59345322180,-5,967,3810,40
59352179480,59352179474,-6,1042,3679,40
59353436031,59353436024,-7,868,4498,40
59355549342,59355549336,-6,1039,3986,40
59355845051,59355845044,-7,880,2845,40
59359396690,59359396683,-7,1012,3763,40
59359727863,59359727869,6,185,1516,40
59360358806,59360358822,16,412,2032,40
59361424286,59361424282,-4,847,3554,40
59362021309,59362021309,0,2156,2864,40
59369770599,59369770598,-1,1406,2532,40
59372276046,59372276039,-7,2026,7144,40
59398262169,59398262164,-5,1144,3845,40
59399319810,59399319804,-6,663,2381,40
59400711054,59400711049,-5,1097,4575,40
59400985252,59400985273,21,974,3327,40
59401745121,59401745126,5,3677,1575,40
59410237115,59410237109,-6,1065,5090,40
59415118598,59415118599,1,2396,2314,40
59418596248,59418596241,-7,825,3152,40
59418713919,59418713914,-5,925,3432,40
59422515821,59422515839,18,1714,2167,40
59428375700,59428375694,-6,1125,3586,40
59430372175,59430372169,-6,1626,4665,40
59452781202,59452781196,-6,1234,3749,40
59455288917,59455288923,6,1694,1333,40
59457795626,59457795618,-8,910,5253,40
59461670874,59461670868,-6,1276,3417,40
59466481808,59466481802,-6,1249,4544,40
59466984066,59466984061,-5,1708,7479,40
59467344251,59467344246,-5,1231,2187,40
59472450513,59472450515,2,896,1040,40
59473729379,59473729373,-6,1277,5894,40
59476816681,59476816678,-3,758,2948,40
59478231747,59478231738,-9,911,3470,40
59478802101,59478802095,-6,122,1064,40
59478878174,59478878169,-5,279,1704,40
59479461006,59479461010,4,1896,571,40
59483461083,59483461078,-5,656,2284,40
59484361100,59484361096,-4,186,1466,40
59484409892,59484409903,11,208,1226,40
59489991116,59489991109,-7,914,4195,40
59490122230,59490122245,15,456,1493,40
59490495614,59490495608,-6,973,4611,40
59497486846,59497486840,-6,950,2976,40
59497946280,59497946278,-2,70,1180,40
59501001326,59501001342,16,387,1247,40
59511651717,59511651713,-4,1220,3452,40
59512277134,59512277154,20,974,3616,40
59513152487,59513152481,-6,953,4104,40
59518458187,59518458181,-6,861,3794,40
59522179343,59522179334,-9,1001,4402,40
59523413204,59523413198,-6,1130,4896,40
59525090522,59525090516,-6,1007,3574,40
59530271068,59530271072,4,12304,23865,40
59533985876,59533985861,-15,1046,422,40
59535224891,59535224884,-7,1188,4660,40
59535793676,59535793680,4,3193,2545,40
59537912463,59537912457,-6,779,2874,40
59549785938,59549785933,-5,991,4681,40
59550250042,59550250035,-7,706,3192,40
59550416815,59550416817,2,249,1422,40
59551206282,59551206287,5,1648,1610,40
59556475894,59556475889,-5,538,1481,40
59556547920,59556547925,5,134,1803,40
59556804463,59556804463,0,182,1064,40
59557910453,59557910445,-8,945,2644,40
59559347040,59559347035,-5,986,3114,40
59559956086,59559956067,-19,70,963,40
59563680535,59563680528,-7,1501,3564,40
59565177671,59565177662,-9,1417,20655,40
59569981954,59569981947,-7,1030,3911,40
59571765503,59571765498,-5,1032,2891,40
59572456054,59572456037,-17,975,3838,40
59572597869,59572597878,9,185,1290,40
59577072619,59577072613,-6,1099,4106,40
59578038458,59578038460,2,1257,1569,40
59580012241,59580012237,-4,1049,4202,40
59589694685,59589694678,-7,3619,90281,40
59590270750,59590270750,0,1288,2363,40
59595061708,59595061702,-6,1468,4264,40
59596716866,59596716861,-5,877,3255,40
59597956822,59597956816,-6,939,3069,40
59600601813,59600601833,20,730,2978,40
59605872398,59605872393,-5,1152,4148,40
59609073569,59609073565,-4,847,3091,40
59609692740,59609692757,17,707,3007,40
59610642943,59610642939,-4,181,994,40
59611595404,59611595391,-13,1198,3720,40
59613452697,59613452692,-5,730,2168,40
59621258231,59621258225,-6,1210,5366,40
59628273333,59628273338,5,3080,1336,40
59628459782,59628459776,-6,847,2732,40
59631872168,59631872161,-7,1114,4742,40
59634312077,59634312079,2,1476,1634,40
59647186935,59647186930,-5,619,2690,40
59648119419,59648119414,-5,1026,4474,40
59654051907,59654051901,-6,1534,4186,40
59654631990,59654631982,-8,1158,3799,40
59659529786,59659529792,6,15779,31702,40
59662124673,59662124666,-7,848,3569,40
59662266340,59662266342,2,312,1343,40
59666064437,59666064430,-7,1218,3423,40
59667167659,59667167661,2,2149,1694,40
59667619624,59667619619,-5,851,3400,40
59667660208,59667660219,11,810,4017,40
59677145311,59677145317,6,3292,1330,40
59683347091,59683347093,2,969,1309,40
59687676056,59687676050,-6,1009,2344,40
59688956106,59688956102,-4,758,2760,40
59699609802,59699609797,-5,1096,4056,40
59699936617,59699936610,-7,734,3639,40
59710005386,59710005381,-5,540,1163,40
59718316006,59718316001,-5,1245,4294,40
59723750951,59723750945,-6,1250,4424,40
59723915878,59723915870,-8,833,4400,40
59731202504,59731202499,-5,953,3041,40
59731589021,59731589020,-1,39,934,40
59735033289,59735033290,1,1582,1739,40
59738013234,59738013237,3,3396,2406,40
59739204291,59739204286,-5,815,3090,40
59740247718,59740247723,5,2387,1284,40
59741383352,59741383346,-6,1077,4266,40
59742033631,59742033627,-4,189,944,40
59748012877,59748012880,3,2160,1686,40
59748522714,59748522706,-8,1074,4746,40
59748966880,59748966899,19,158,689,40
59768779098,59768779093,-5,1261,4170,40
59770044615,59770044618,3,205,1294,40
59770816520,59770816514,-6,1098,2911,40
59771008828,59771008829,1,369,2901,40
59779277518,59779277521,3,34420,27859,40
59784317447,59784317443,-4,1100,3008,40
59784804138,59784804133,-5,985,4331,40
59789266610,59789266605,-5,1082,2545,40
59790564378,59790564373,-5,682,3604,40
59790726409,59790726405,-4,1192,2625,40
59791765149,59791765134,-15,252,1015,40
59794488379,59794488383,4,1059,402,40
59800457155,59800457141,-14,405,2000,40
59802250969,59802250962,-7,1302,2896,40
59814393535,59814393527,-8,1055,4359,40
59824360930,59824360926,-4,1183,3475,40
59825086222,59825086217,-5,1087,3391,40
59825800481,59825800487,6,4603,1977,40
59831497128,59831497121,-7,1026,4033,40
59833839553,59833839547,-6,1019,3574,40
59836935444,59836935449,5,9828,6709,40
59837690431,59837690425,-6,919,3762,40
59838524989,59838524985,-4,1133,2943,40
59839095534,59839095541,7,2904,1536,40
59839454709,59839454703,-6,1060,4354,40
59839977791,59839977775,-16,1381,1578,40
59840203172,59840203193,21,492,2174,40
59847141155,59847141147,-8,782,4374,40
59847621333,59847621326,-7,934,3319,40
59849238286,59849238286,0,1123,1149,40
59856110460,59856110457,-3,1074,3320,40
59857337200,59857337206,6,55,1117,40
59866714115,59866714110,-5,1030,3432,40
59870570071,59870570091,20,684,3600,40
59886566125,59886566127,2,179,1197,40
59886702734,59886702731,-3,74,1262,40
59887504534,59887504527,-7,774,2193,40
59887935549,59887935562,13,77,992,40
59890955299,59890955295,-4,856,3559,40
59893512697,59893512702,5,3411,1387,40
59902153318,59902153305,-13,329,1155,40
59902326764,59902326778,14,104,1117,40
59903417100,59903417101,1,1264,435,40
59914936185,59914936178,-7,700,5876,40
59918503396,59918503390,-6,1144,3912,40
59920214883,59920214882,-1,2161,2243,40
59925779951,59925779947,-4,1798,3408,40
59926407926,59926407920,-6,927,3795,40
59933662430,59933662422,-8,1088,3008,40
59936365447,59936365441,-6,950,3180,40
59936537100,59936537101,1,298,1147,40
59938262735,59938262730,-5,1173,3344,40
59941531992,59941531985,-7,1921,4685,40
59941777765,59941777770,5,4816,2462,40
59948053911,59948053907,-4,1004,3967,40
59948383990,59948383995,5,1119,1115,40
59951721932,59951721921,-11,198,1602,40
59951896487,59951896473,-14,674,2919,40
59953614984,59953614978,-6,1383,3173,40
59956629286,59956629279,-7,1017,2712,40
59961382114,59961382107,-7,971,3827,40
59963056279,59963056266,-13,1551,2284,40
59963234380,59963234388,8,244,1634,40
59964429766,59964429760,-6,1271,4963,40
59977625799,59977625793,-6,1061,3109,40
59979035248,59979035266,18,230,1336,40
59979631758,59979631738,-20,86,915,40
59984997082,59984997077,-5,1299,3879,40
59985288440,59985288434,-6,1089,4152,40
59987958392,59987958384,-8,1425,4722,40
60001032785,60001032780,-5,1149,3548,40
60020060895,60020060889,-6,1307,4641,40
60028815713,60028815707,-6,809,3051,40
60030476487,60030476481,-6,248,1654,40
60030654065,60030654065,0,620,1182,40
60031813102,60031813106,4,2335,2085,40
60032888630,60032888623,-7,900,3464,40
60036224829,60036224827,-2,1178,1901,40
60040275447,60040275442,-5,922,2842,40
60047127441,60047127434,-7,1294,3751,40
60055261087,60055261081,-6,686,3858,40
60058612298,60058612302,4,3051,1509,40
60063681349,60063681350,1,1937,2379,40
60068162118,60068162110,-8,1035,3181,40
60073358085,60073358086,1,1034,1351,40
60074088957,60074088977,20,233,1264,40
60078019465,60078019458,-7,1209,3002,40
60083979738,60083979732,-6,965,3123,40
60085377046,60085377040,-6,1247,3562,40
60086294211,60086294207,-4,1263,4970,40
60089387534,60089387529,-5,1095,4567,40
60090640274,60090640282,8,3756,1288,40
60099736053,60099736060,7,4191,1071,40
60106292129,60106292122,-7,1507,4551,40
60106646133,60106646128,-5,985,4328,40
60107214498,60107214497,-1,31490,16981,40
60108382819,60108382812,-7,1150,3807,40
60108844071,60108844086,15,843,3356,40
60109596437,60109596433,-4,1424,4445,40
60117332661,60117332672,11,12778,45707,40
60120402397,60120402390,-7,682,3520,40
60122051967,60122051963,-4,673,3527,40
60125332414,60125332406,-8,1016,2630,40
60125928751,60125928746,-5,1273,3195,40
60126026471,60126026466,-5,910,4331,40
60128620480,60128620480,0,1759,2575,40
60130508401,60130508394,-7,890,2937,40
60130593000,60130593014,14,170,1160,40
60130988165,60130988161,-4,1012,4251,40
60131737326,60131737322,-4,1239,2997,40
60134996631,60134996626,-5,973,3006,40
60146102742,60146102734,-8,897,6072,40
60146347232,60146347248,16,906,2787,40
60148963830,60148963825,-5,456,1499,40
60150607756,60150607741,-15,234,1180,40
60151443672,60151443666,-6,991,4604,40
60151703710,60151703722,12,227,1352,40
60154249730,60154249724,-6,681,3200,40
60158526378,60158526374,-4,774,3785,40
60171470949,60171470943,-6,1106,3230,40
60173639398,60173639393,-5,843,2767,40
60174909819,60174909814,-5,1049,3572,40
60177474843,60177474840,-3,31582,24385,40
60178535595,60178535590,-5,883,3158,40
60188185122,60188185115,-7,1007,4778,40
60190424945,60190424938,-7,1162,3420,40
60193402774,60193402768,-6,879,3488,40
60193519150,60193519166,16,278,1169,40
60193648455,60193648469,14,612,1803,40
60196572494,60196572488,-6,1024,3517,40
60206468873,60206468867,-6,754,4576,40
60212142938,60212142933,-5,803,4159,40
60217225043,60217225038,-5,786,2426,40
60230574034,60230574027,-7,1326,3869,40
60231356884,60231356878,-6,1115,1593,40
60238412890,60238412884,-6,894,3177,40
60240678431,60240678427,-4,1188,2961,40
60241041335,60241041321,-14,350,1410,40
60243166178,60243166170,-8,1512,4287,40
60246311135,60246311129,-6,1037,3895,40
60263399589,60263399604,15,580,3321,40
60266393622,60266393614,-8,1273,7624,40
60269984806,60269984804,-2,858,3029,40
60273226613,60273226605,-8,754,2805,40
60277198723,60277198722,-1,3268,6006,40
60282352642,60282352637,-5,971,4433,40
60285240222,60285240216,-6,1381,4802,40
60291236246,60291236241,-5,823,2640,40
60291296959,60291296953,-6,848,3210,40
60299531211,60299531219,8,55593,2326,40
60302266093,60302266089,-4,1122,4468,40
60302727026,60302727021,-5,1044,5115,40
60303294646,60303294667,21,279,2384,40
60303824503,60303824499,-4,1042,2659,40
60304642091,60304642084,-7,708,3853,40
60308822079,60308822081,2,1560,1857,40
60311982083,60311982076,-7,304,1715,40
60313826303,60313826294,-9,1061,7530,40
60313858245,60313858239,-6,1260,4117,40
60317600387,60317600382,-5,1172,3755,40
60319633591,60319633581,-10,774,5370,40
60321242626,60321242620,-6,1296,4181,40
60325142492,60325142489,-3,1099,3289,40
60325325062,60325325059,-3,135,931,40
60334737366,60334737360,-6,1250,5041,40
60345115253,60345115247,-6,1304,2738,40
60345435987,60345435982,-5,859,2714,40
60348821085,60348821079,-6,870,3108,40
60350448459,60350448454,-5,1398,3752,40
60351421582,60351421601,19,468,2243,40
60355359798,60355359798,0,1344,2303,40
60357724187,60357724181,-6,1198,3673,40
60359110196,60359110189,-7,770,4413,40
60360083517,60360083506,-11,223,1528,40
60360706967,60360706978,11,193,1017,40
60367772567,60367772559,-8,1155,3787,40
60372658768,60372658765,-3,1099,2407,40
60372760451,60372760453,2,40203,24194,40
60399436943,60399436943,0,1078,1822,40
60399651766,60399651761,-5,307,2937,40
60400033676,60400033670,-6,63,908,40
60406134465,60406134458,-7,990,2361,40
60406524245,60406524227,-18,156,879,40
60406694479,60406694483,4,199,1121,40
60411133925,60411133921,-4,821,2105,40
60420487831,60420487824,-7,953,3486,40
60421214824,60421214818,-6,821,3376,40
60430007467,60430007470,3,1844,1281,40
60434566399,60434566402,3,2208,1892,40
60444469751,60444469743,-8,1260,4632,40
60451467151,60451467147,-4,772,2914,40
60457661950,60457661945,-5,1418,4391,40
60458400677,60458400669,-8,1338,3839,40
60459599847,60459599839,-8,818,3453,40
60460733147,60460733145,-2,1377,2085,40
60462230697,60462230691,-6,1019,3519,40
60462959798,60462959790,-8,1128,6420,40
60466018527,60466018522,-5,1117,3038,40
60467328190,60467328185,-5,1188,4933,40
60468417670,60468417665,-5,810,3218,40
60468630960,60468630967,7,141,806,40
60473323174,60473323175,1,2183,2321,40
60481734923,60481734918,-5,1163,4387,40
60486887810,60486887805,-5,1390,4826,40
60489030088,60489030084,-4,1559,5526,40
60489841320,60489841317,-3,1350,3647,40
60492016351,60492016348,-3,1090,3506,40
60495705202,60495705194,-8,830,5343,40
60507798128,60507798131,3,2001,1369,40
60515946167,60515946163,-4,1441,3502,40
60522011801,60522011796,-5,913,2844,40
60522645324,60522645340,16,148,1152,40
60522888101,60522888118,17,455,2141,40
60525397680,60525397678,-2,1286,2619,40
60525667199,60525667194,-5,1241,4219,40
60537524589,60537524593,4,4055,3049,40
60539070627,60539070622,-5,902,3668,40
60547778712,60547778706,-6,1052,3915,40
60548022219,60548022214,-5,1014,2267,40
60548220238,60548220255,17,889,3780,40
60549460767,60549460762,-5,1028,3745,40
60550345190,60550345182,-8,301,1483,40
60550688379,60550688373,-6,867,3475,40
60550798511,60550798502,-9,606,2809,40
60550994754,60550994761,7,3559,1102,40
60552470802,60552470794,-8,981,5073,40
60553494462,60553494456,-6,720,3092,40
60555486247,60555486247,0,2232,1942,40
60555820111,60555820118,7,4020,1065,40
60557878221,60557878214,-7,1038,4152,40
60558462743,60558462762,19,716,3812,40
60560762147,60560762143,-4,967,2061,40
60561217206,60561217193,-13,239,1552,40
60561676108,60561676094,-14,1,834,40
60561822798,60561822815,17,179,679,40
60567409756,60567409754,-2,853,909,40
60575305678,60575305670,-8,982,3138,40
60583899719,60583899713,-6,1100,4042,40
60588329163,60588329157,-6,1001,3684,40
60595448556,60595448552,-4,1916,6699,40
60597074385,60597074379,-6,784,4852,40
60597266597,60597266614,17,227,1398,40
60598242346,60598242341,-5,702,2553,40
60598585579,60598585571,-8,984,3737,40
60607254565,60607254560,-5,555,1963,40
60613724214,60613724209,-5,1167,4943,40
60627134083,60627134077,-6,1434,3943,40
60627535249,60627535242,-7,886,3954,40
60627674760,60627674743,-17,3,2069,40
60634244322,60634244328,6,3118,997,40
60638227158,60638227153,-5,846,2943,40
60639252558,60639252577,19,876,3640,40
60645434387,60645434381,-6,952,3700,40
60646834618,60646834615,-3,1296,2471,40
60647047894,60647047889,-5,1049,2805,40
60647748051,60647748045,-6,1222,2800,40
60648428498,60648428490,-8,644,4212,40
60649793365,60649793359,-6,1134,3765,40
60650453463,60650453456,-7,1125,5483,40
60650683013,60650683029,16,615,2106,40
60653111578,60653111573,-5,1274,5114,40
60653413532,60653413523,-9,748,2644,40
60658126190,60658126186,-4,1713,4064,40
60661445409,60661445403,-6,958,245,40
60669948975,60669948969,-6,624,1897,40
60672280954,60672280940,-14,65,816,40
60675846170,60675846164,-6,1272,4516,40
60676770670,60676770668,-2,982,2408,40
60681686034,60681686032,-2,1253,2455,40
60691944251,60691944243,-8,741,3711,40
60701060993,60701060988,-5,1207,3172,40
60701233237,60701233258,21,494,1449,40
60705453870,60705453863,-7,957,3225,40
60710585439,60710585437,-2,515,1867,40
60711877670,60711877681,11,158,1108,40
60712477541,60712477536,-5,789,3719,40
60717568149,60717568142,-7,751,3304,40
60717708334,60717708339,5,76,745,40
60723531380,60723531373,-7,1573,4209,40
60726210936,60726210930,-6,1287,3660,40
60726393692,60726393698,6,313,1196,40
60733546963,60733546957,-6,902,4189,40
60734017767,60734017777,10,345,842,40
60739678730,60739678725,-5,1095,4074,40
60740546321,60740546314,-7,923,2704,40
60752596513,60752596508,-5,1486,4039,40
60755901910,60755901923,13,391,2239,40
60756247479,60756247475,-4,1019,3698,40
60757669465,60757669458,-7,614,3306,40
60762800035,60762800029,-6,852,3545,40
60763024644,60763024660,16,902,4160,40
60769942309,60769942306,-3,1064,2256,40
60770134767,60770134783,16,270,1321,40
60772553873,60772553869,-4,918,3626,40
60779281995,60779281995,0,1466,1480,40
60781125832,60781125828,-4,1029,3158,40
60786560691,60786560685,-6,515,3131,40
60786690022,60786690037,15,751,3287,40
60788827763,60788827758,-5,863,2922,40
60798760438,60798760434,-4,729,3234,40
60801394953,60801394949,-4,1086,2427,40
60808289027,60808289022,-5,885,3121,40
60818131553,60818131547,-6,1124,3893,40
60818336882,60818336878,-4,1106,3422,40
60820375498,60820375494,-4,1139,2893,40
60830643382,60830643376,-6,1273,3951,40
60830962462,60830962475,13,179,1185,40
60832157502,60832157520,18,597,3793,40
60845925647,60845925651,4,1585,1231,40
60852004048,60852004041,-7,995,3447,40
60852378039,60852378045,6,2378,1484,40
60868708705,60868708698,-7,1074,4723,40
60879637207,60879637210,3,1378,1221,40
60880848574,60880848574,0,1670,1877,40
60888451271,60888451267,-4,656,2064,40
60888657212,60888657204,-8,214,1167,40
60891097362,60891097358,-4,1145,3608,40
60891453057,60891453051,-6,2009,7162,40
60894032569,60894032563,-6,877,4165,40
60901744856,60901744852,-4,22766,12427,40
60904729009,60904729005,-4,1097,2878,40
60904879219,60904879214,-5,894,2913,40
60907456131,60907456126,-5,995,3335,40
60920522361,60920522378,17,605,1860,40
60920797278,60920797273,-5,868,3818,40
60921553298,60921553292,-6,1257,2071,40
60923338517,60923338510,-7,954,3377,40
60927703812,60927703800,-12,13189,6309,40
60930964913,60930964909,-4,1070,3050,40
60932668250,60932668244,-6,1113,3367,40
60933847655,60933847649,-6,1358,4757,40
60935281974,60935281966,-8,805,3844,40
60936081727,60936081722,-5,77,1419,40
60938135514,60938135509,-5,1468,4481,40
60945641207,60945641201,-6,953,3514,40
60946411725,60946411742,17,209,1338,40
60949292307,60949292301,-6,1294,4255,40
60951891386,60951891379,-7,946,4715,40
60952303965,60952303982,17,341,795,40
60970177239,60970177245,6,2542,1286,40
60970427357,60970427360,3,4573,3353,40
60979158715,60979158709,-6,1069,2897,40
60979898719,60979898712,-7,836,3574,40
60989215973,60989215970,-3,858,2212,40
60992537597,60992537610,13,185,1113,40
60995659185,60995659180,-5,1462,3415,40
60995930215,60995930205,-10,792,3428,40
61001971864,61001971858,-6,1786,4333,40
61010040896,61010040894,-2,1102,2025,40
61015412362,61015412356,-6,930,3933,40
61016870875,61016870869,-6,976,3758,40
61038436681,61038436674,-7,1308,3635,40
61038578830,61038578851,21,1136,4821,40
61043067067,61043067061,-6,1091,3261,40
61050087214,61050087207,-7,792,2174,40
61057894663,61057894657,-6,1095,2805,40
61058108429,61058108425,-4,188,2459,40
61058228118,61058228113,-5,292,1023,40
61058416829,61058416849,20,879,3071,40
61063900685,61063900682,-3,7,803,40
61074840277,61074840271,-6,1070,3794,40
61075479230,61075479251,21,221,696,40
61075702227,61075702222,-5,1062,3765,40
61076772917,61076772910,-7,1070,3949,40
61079051255,61079051248,-7,942,3381,40
61079267868,61079267870,2,4267,3493,40
61081026513,61081026506,-7,1260,4487,40
61081583704,61081583698,-6,814,2281,40
61087293569,61087293561,-8,653,1831,40
61090383229,61090383221,-8,754,3491,40
61090667307,61090667301,-6,1279,3505,40
61090818719,61090818713,-6,1163,3201,40
61091309053,61091309047,-6,1125,3443,40
61092495159,61092495147,-12,243,1390,40
61096255337,61096255332,-5,1210,2914,40
61096353324,61096353339,15,88,1174,40
61098268098,61098268093,-5,1398,4175,40
61098642399,61098642402,3,2464,1346,40
61101958132,61101958126,-6,1195,4136,40
61105627326,61105627321,-5,1157,3389,40
61105747437,61105747432,-5,794,3063,40
61106065769,61106065772,3,2036,1858,40
61107470603,61107470602,-1,1477,1492,40
61110201467,61110201462,-5,987,3468,40
61115299681,61115299671,-10,410,3181,40
61121003087,61121003082,-5,699,1826,40
61125069949,61125069942,-7,1161,4329,40
61125487023,61125487018,-5,961,2214,40
61127195107,61127195102,-5,1154,5150,40
61127371239,61127371255,16,74,993,40
61129666135,61129666130,-5,936,4084,40
61129931626,61129931622,-4,1337,6090,40
61130455500,61130455506,6,3397,2241,40
61130735143,61130735134,-9,987,3580,40
61136860243,61136860242,-1,1078,2254,40
61141669694,61141669701,7,3720,2121,40
61148464198,61148464193,-5,1108,5054,40
61152156255,61152156247,-8,796,4137,40
61160889375,61160889375,0,1019,1862,40
61160922516,61160922536,20,683,4351,40
61169841118,61169841112,-6,870,3171,40
61172306138,61172306132,-6,942,3135,40
61179583731,61179583725,-6,747,2925,40
61179706593,61179706590,-3,2429,4828,40
61183384441,61183384437,-4,1013,2379,40
61183488191,61183488194,3,263,1440,40
61185043167,61185043162,-5,994,3605,40
61185687396,61185687411,15,227,986,40
61191849185,61191849185,0,2168,1951,40
61199088078,61199088078,0,2879,3850,40
61200561902,61200561894,-8,911,4229,40
61200748408,61200748419,11,34,779,40
61204889914,61204889908,-6,945,3227,40
61205034174,61205034167,-7,1299,3949,40
61205494326,61205494322,-4,72,970,40
61211477125,61211477119,-6,1317,4662,40
61212564970,61212564965,-5,1073,3758,40
61212757834,61212757831,-3,1165,2377,40
61214467621,61214467615,-6,1406,3976,40
61216801321,61216801314,-7,1145,4127,40
61220322438,61220322433,-5,942,3801,40
61220403012,61220403006,-6,978,3855,40
61220813869,61220813869,0,398,1960,40
61220947864,61220947864,0,109,901,40
61233455835,61233455828,-7,824,2831,40
61235937369,61235937365,-4,679,2940,40
61236378158,61236378163,5,11291,7027,40
61243978563,61243978558,-5,905,3515,40
61244964582,61244964575,-7,776,3219,40
61246006689,61246006685,-4,932,4994,40
61247808729,61247808737,8,4090,1170,40
61250199164,61250199158,-6,1136,3155,40
61251721938,61251721934,-4,959,3903,40
61254182941,61254182937,-4,1029,2464,40
61260486254,61260486254,0,954,1345,40
61267099789,61267099783,-6,702,3648,40
61270252884,61270252877,-7,1262,3196,40
61274380103,61274380107,4,2067,1490,40
61281075014,61281075005,-9,1048,3890,40
61281754814,61281754810,-4,89,1117,40
61281864629,61281864625,-4,613,3712,40
61282240925,61282240910,-15,598,1308,40
61285333950,61285333947,-3,45478,19818,40
61286317879,61286317869,-10,840,6388,40
61286447504,61286447522,18,111,726,40
61289772039,61289772038,-1,1812,2208,40
61293268221,61293268215,-6,1335,3771,40
61294982602,61294982598,-4,940,3677,40
61299106033,61299106029,-4,984,2568,40
61300694810,61300694804,-6,857,3476,40
61303687475,61303687471,-4,1008,3300,40
61306367545,61306367542,-3,822,2237,40
61307204541,61307204534,-7,1095,4111,40
61310245943,61310245936,-7,940,4241,40
61311785819,61311785810,-9,771,2857,40
61312275727,61312275735,8,138,1093,40
61314787930,61314787923,-7,1094,4994,40
61317189666,61317189659,-7,911,4143,40
61317303589,61317303577,-12,290,2219,40
61325604731,61325604725,-6,988,3795,40
61326169970,61326169964,-6,1062,3458,40
61327358133,61327358150,17,194,2436,40
61330577859,61330577854,-5,775,3601,40
61331518872,61331518891,19,1137,3330,40
61335650785,61335650778,-7,1130,3241,40
61337639974,61337639991,17,434,2194,40
61341063661,61341063654,-7,1182,3648,40
61341212823,61341212806,-17,28,807,40
61341880724,61341880719,-5,1204,4086,40
61344578610,61344578631,21,1335,1281,40
61349962835,61349962842,7,6990,2039,40
61357515407,61357515401,-6,713,1925,40
61361739821,61361739815,-6,999,3714,40
61367437315,61367437309,-6,1010,3764,40
61367606965,61367606965,0,150,888,40
61378754977,61378754970,-7,1084,3892,40
61384985356,61384985350,-6,1075,2747,40
61385282312,61385282328,16,1003,5905,40
61386489084,61386489077,-7,1083,4567,40
61391883669,61391883665,-4,1249,4621,40
61392889227,61392889233,6,3903,886,40
61396700687,61396700682,-5,1051,5847,40
61397776142,61397776135,-7,1452,6192,40
61403194929,61403194923,-6,1075,3814,40
61405109187,61405109181,-6,972,4457,40
61407231889,61407231882,-7,1042,3910,40
61407394966,61407394950,-16,156,2895,40
61407805294,61407805305,11,857,2274,40
61409060905,61409060899,-6,790,3777,40
61410759025,61410759019,-6,912,3988,40
61411295303,61411295322,19,1037,3213,40
61415127711,61415127705,-6,914,3419,40
61417227529,61417227523,-6,1368,4912,40
61423542971,61423542965,-6,894,4395,40
61426071680,61426071673,-7,1131,4420,40
61426327064,61426327070,6,289,1580,40
61434933929,61434933922,-7,1285,3844,40
61436960809,61436960814,5,1110,773,40
61443564454,61443564448,-6,1235,3701,40
61443604749,61443604759,10,271,1188,40
61453519423,61453519417,-6,890,3596,40
61453913954,61453913951,-3,670,2377,40
61455272516,61455272510,-6,1349,4993,40
61474924562,61474924557,-5,1034,2309,40
61475047654,61475047675,21,1364,1706,40
61476725897,61476725902,5,3534,1254,40
61477621763,61477621757,-6,1019,3787,40
61477852327,61477852345,18,1795,3421,40
61484793655,61484793649,-6,1345,3811,40
61486285292,61486285306,14,278,1367,40
61486338191,61486338186,-5,1073,2602,40
61491591563,61491591558,-5,1080,3461,40
61491936701,61491936713,12,391,1278,40
61497133462,61497133456,-6,1326,3779,40
61497190991,61497190985,-6,332,2898,40
61499654104,61499654098,-6,916,3512,40
61505155696,61505155689,-7,629,2438,40
61506624913,61506624922,9,12216,42270,40
61511252367,61511252361,-6,664,3816,40
61511442536,61511442530,-6,751,3642,40
61519935891,61519935884,-7,927,3687,40
61520119895,61520119911,16,448,1423,40
61521872427,61521872429,2,1441,1333,40
61521918707,61521918701,-6,1197,3888,40
61525022605,61525022598,-7,792,4245,40
61532141436,61532141432,-4,1570,3300,40
61542609240,61542609234,-6,1069,4204,40
61544381922,61544381916,-6,1238,3460,40
61544953263,61544953256,-7,851,3535,40
61545653460,61545653458,-2,82,1173,40
61546339237,61546339259,22,262,2808,40
61548418202,61548418197,-5,1045,3780,40
61550426427,61550426419,-8,1071,3729,40
61556418410,61556418403,-7,914,3759,40
61556662276,61556662271,-5,1377,5678,40
61556705454,61556705434,-20,809,3181,40
61559674943,61559674937,-6,606,3112,40
61561975762,61561975758,-4,812,3330,40
61563192580,61563192574,-6,73,1101,40
61563351653,61563351667,14,908,2843,40
61565300990,61565300981,-9,765,3403,40
61565369558,61565369545,-13,1413,4086,40
61568201918,61568201909,-9,1355,3851,40
61575550941,61575550945,4,1621,1010,40
61575889402,61575889396,-6,1132,5268,40
61586212661,61586212656,-5,1129,3081,40
61603384645,61603384641,-4,1129,3925,40
61606338718,61606338712,-6,1345,4835,40
61616491433,61616491426,-7,887,4085,40
61616576702,61616576710,8,123,1212,40
61617394819,61617394814,-5,422,2477,40
61622424118,61622424115,-3,1006,3167,40
61624879446,61624879439,-7,943,3627,40
61625263668,61625263662,-6,553,2817,40
61635193682,61635193676,-6,287,1242,40
61640385823,61640385817,-6,1254,4495,40
61642035621,61642035618,-3,864,3249,40
61644463194,61644463187,-7,633,3066,40
61649409657,61649409640,-17,945,4368,40
61656544558,61656544552,-6,961,2859,40
61656684425,61656684418,-7,833,3758,40
61662684561,61662684558,-3,538,1410,40
61675904469,61675904462,-7,1164,3720,40
61677867179,61677867173,-6,766,2608,40
61678402397,61678402391,-6,1086,4895,40
61683081663,61683081657,-6,805,2056,40
61683706742,61683706758,16,346,2189,40
61689655626,61689655618,-8,1240,3926,40
61697976447,61697976442,-5,750,2409,40
61703928487,61703928482,-5,1019,3289,40
61706323022,61706323017,-5,667,3021,40
61706552725,61706552747,22,373,1120,40
61709991895,61709991890,-5,975,4858,40
61713252328,61713252325,-3,2989,8207,40
61730314772,61730314767,-5,956,3765,40
61733567038,61733567030,-8,833,4189,40
61736953298,61736953290,-8,1111,3928,40
61744140966,61744140970,4,2470,1642,40
61748911658,61748911653,-5,1120,3657,40
61753238803,61753238794,-9,1214,5122,40
61754993402,61754993397,-5,1079,3432,40
61769085607,61769085602,-5,666,3563,40
61770048221,61770048219,-2,898,1560,40
61770937063,61770937047,-16,182,839,40
61772414889,61772414893,4,1983,831,40
61774532598,61774532592,-6,859,2651,40
61774718141,61774718162,21,710,2856,40
61777520951,61777520942,-9,1288,4702,40
61780003571,61780003570,-1,265,1382,40
61780981053,61780981051,-2,1297,1156,40
61781677619,61781677614,-5,622,2007,40
61787082939,61787082938,-1,820,1559,40
61791971182,61791971186,4,3272,2005,40
61797557911,61797557918,7,12503,4276,40
61801305890,61801305884,-6,484,1451,40
61805280584,61805280580,-4,689,2586,40
61809284611,61809284606,-5,879,4662,40
61818692336,61818692355,19,512,1287,40
61821022095,61821022089,-6,1076,3036,40
61821381829,61821381849,20,746,3031,40
61822764563,61822764556,-7,900,3567,40
61825478050,61825478043,-7,864,4400,40
61829540085,61829540082,-3,1078,2150,40
61830136326,61830136321,-5,1099,4174,40
61832359711,61832359705,-6,1043,3865,40
61833897874,61833897874,0,1351,1630,40
61836486099,61836486094,-5,1013,3421,40
61836927457,61836927453,-4,782,2534,40
61842223106,61842223100,-6,1487,5143,40
61845132305,61845132303,-2,1990,3180,40
61846874282,61846874287,5,2173,1215,40
61849205526,61849205518,-8,791,3529,40
61851417122,61851417117,-5,834,2859,40
61851658150,61851658167,17,380,2116,40
61861715866,61861715867,1,1170,1556,40
61862333769,61862333762,-7,1226,5717,40
61863136156,61863136139,-17,186,1879,40
61866725418,61866725410,-8,1276,3910,40
61866981036,61866981055,19,330,1003,40
61869324683,61869324678,-5,1125,4938,40
61892524138,61892524130,-8,878,5278,40
61898862851,61898862844,-7,1018,3137,40
61901038958,61901038952,-6,692,3249,40
61902620581,61902620589,8,68,1021,40
61907067707,61907067711,4,2673,2188,40
61908047978,61908047982,4,2375,1335,40
61916866965,61916866961,-4,686,3389,40
61916902895,61916902872,-23,221,1120,40
61922856366,61922856366,0,2717,4186,40
61928238461,61928238462,1,3539,3789,40
61933703746,61933703739,-7,1172,3848,40
61947187619,61947187614,-5,581,3154,40
61949373030,61949373028,-2,1699,2500,40
61951309014,61951309019,5,5545,3352,40
61953631005,61953630998,-7,659,2239,40
61963284692,61963284686,-6,1247,5347,40
61966202367,61966202362,-5,1254,3154,40
61968149470,61968149466,-4,780,3282,40
61969176118,61969176137,19,835,3773,40
61971744554,61971744549,-5,724,3541,40
61972115997,61972115990,-7,212,1596,40
61972175138,61972175133,-5,1181,3649,40
61973286359,61973286355,-4,534,2185,40
61974020336,61974020330,-6,1343,4792,40
61986533173,61986533166,-7,773,4656,40
61987291578,61987291572,-6,1596,3385,40
61988196562,61988196556,-6,780,2374,40
61990027619,61990027614,-5,1004,3350,40
61991118919,61991118934,15,34,1201,40
61993645547,61993645539,-8,1437,5297,40
61997650473,61997650475,2,14,723,40
62003027108,62003027100,-8,862,4623,40
62003473278,62003473273,-5,1140,5269,40
62004701083,62004701083,0,988,1208,40
62012455912,62012455906,-6,725,2842,40
62012848575,62012848577,2,120,1117,40
62015160931,62015160926,-5,895,3600,40
62018432802,62018432806,4,1548,810,40
62020885193,62020885186,-7,891,4127,40
62023975442,62023975437,-5,928,3413,40
62025532152,62025532146,-6,1598,5299,40
62026970784,62026970778,-6,905,4109,40
62028374574,62028374556,-18,7161,3110,40
62030929665,62030929677,12,1337,1624,40
62036097641,62036097647,6,238,1417,40
62036802142,62036802146,4,2955,1774,40
62037171316,62037171309,-7,947,3895,40
62038015525,62038015531,6,2502,1348,40
62040077905,62040077898,-7,1299,4331,40
62040664958,62040664954,-4,856,2704,40
62040747217,62040747211,-6,851,4295,40
62041914534,62041914526,-8,1024,2312,40
62042029662,62042029641,-21,606,1490,40
62042266085,62042266083,-2,1250,2474,40
62042388991,62042389007,16,291,1078,40
62043373580,62043373565,-15,811,3340,40
62043931599,62043931594,-5,935,3028,40
62047927587,62047927581,-6,980,3766,40
62048708068,62048708063,-5,933,3258,40
62054249478,62054249483,5,2272,1433,40
62057930617,62057930612,-5,1311,4981,40
62059010983,62059010977,-6,1076,4193,40
62064945982,62064945976,-6,1012,3364,40
62065339599,62065339593,-6,1323,4521,40
62065543623,62065543606,-17,1105,5206,40
62065722156,62065722173,17,1166,3895,40
62066303032,62066303026,-6,982,4367,40
62070549342,62070549336,-6,1141,3360,40
62071273689,62071273684,-5,1495,3261,40
62074203686,62074203680,-6,909,2792,40
62077647606,62077647601,-5,988,3450,40
62079549922,62079549917,-5,952,2734,40
62084907543,62084907538,-5,25287,15142,40
62090150887,62090150878,-9,907,3335,40
62090487799,62090487792,-7,1243,3899,40
62090869943,62090869941,-2,1072,2210,40
62093154063,62093154057,-6,1196,4194,40
62099487532,62099487526,-6,1338,4466,40
62101002106,62101002101,-5,1159,3235,40
62101200574,62101200569,-5,979,3275,40
62102762338,62102762333,-5,848,3205,40
62106136300,62106136305,5,216,1397,40
62118215151,62118215146,-5,1292,4649,40
62118591316,62118591306,-10,885,3124,40
62125270607,62125270601,-6,908,3156,40
62127007274,62127007268,-6,752,2805,40
62139470919,62139470913,-6,1218,3879,40
62140517953,62140517946,-7,1204,3521,40
62143356309,62143356314,5,5643,2534,40
62147778498,62147778493,-5,486,2752,40
62161760877,62161760870,-7,1138,4636,40
62169298531,62169298525,-6,1137,3597,40
62169954922,62169954929,7,2096,1017,40
62172483182,62172483177,-5,1133,3777,40
62179804623,62179804617,-6,1303,4826,40
62181297283,62181297278,-5,778,2777,40
62187765233,62187765225,-8,996,4335,40
62190071323,62190071318,-5,1200,2201,40
62191602421,62191602426,5,39507,23532,40
62193949653,62193949648,-5,1119,2937,40
62194691947,62194691940,-7,1105,5827,40
62196041914,62196041909,-5,680,3394,40
62196240422,62196240419,-3,21737,12719,40
62214482770,62214482769,-1,2758,3998,40
62215164919,62215164914,-5,797,2255,40
62216154709,62216154704,-5,1219,3392,40
62223370167,62223370171,4,2750,2003,40
62225959127,62225959122,-5,955,4041,40
62229603986,62229603980,-6,651,3615,40
62232696990,62232696986,-4,1325,3058,40
62234297371,62234297365,-6,782,2958,40
62234862854,62234862849,-5,1016,5648,40
62239960570,62239960561,-9,1272,3685,40
62240479871,62240479865,-6,973,3039,40
62242649734,62242649745,11,286,2810,40
62254266599,62254266594,-5,28832,13940,40
62256555505,62256555509,4,2346,1484,40
62261038501,62261038494,-7,1621,4372,40
62261911916,62261911910,-6,1144,4642,40
62263199502,62263199497,-5,963,2814,40
62265686641,62265686645,4,2066,1519,40
62266046241,62266046236,-5,858,2854,40
62266987064,62266987069,5,379,1375,40
62268033451,62268033445,-6,862,4892,40
62274734494,62274734488,-6,1043,2963,40
62278100185,62278100179,-6,1255,3996,40
62280498046,62280498041,-5,1009,4018,40
62280588259,62280588254,-5,686,1913,40
62285594237,62285594231,-6,963,3665,40
62286179638,62286179633,-5,886,3888,40
62288098499,62288098494,-5,1202,4026,40
62294513631,62294513627,-4,925,3655,40
62295048679,62295048674,-5,1033,4203,40
62297535351,62297535345,-6,1213,3221,40
62301458142,62301458135,-7,877,3013,40
62301834724,62301834741,17,618,3679,40
62311754679,62311754673,-6,613,1792,40
62313810223,62313810223,0,1171,1743,40
62315466926,62315466917,-9,1352,4145,40
62322379563,62322379566,3,1456,1591,40
62324182393,62324182389,-4,1284,4072,40
62330069764,62330069759,-5,1070,3262,40
62335872713,62335872707,-6,1106,3633,40
62337521056,62337521049,-7,1339,5393,40
62338144723,62338144719,-4,1410,2266,40
62341554045,62341554039,-6,1057,3823,40
62342653677,62342653672,-5,1159,4194,40
62347146115,62347146110,-5,940,4400,40
62347916869,62347916889,20,741,2884,40
62349157490,62349157485,-5,516,2083,40
62351084253,62351084248,-5,56786,35610,40
62356516621,62356516617,-4,765,2390,40
62357920235,62357920237,2,976,1578,40
62361469398,62361469393,-5,821,3935,40
62369208714,62369208706,-8,1252,3870,40
62369590786,62369590782,-4,1857,3901,40
62370071868,62370071877,9,4300,1546,40
62370829231,62370829235,4,1784,912,40
62373032151,62373032145,-6,978,3482,40
62373314149,62373314142,-7,919,3382,40
62374239996,62374239987,-9,177,1604,40
62375899423,62375899429,6,1064,500,40
62377485122,62377485115,-7,1073,4840,40
62385341298,62385341292,-6,1232,4258,40
62410453822,62410453816,-6,1435,9676,40
62411123536,62411123534,-2,101733,47680,40
62412799054,62412799048,-6,872,3943,40
62414564885,62414564894,9,11597,30418,40
62416972786,62416972782,-4,1256,4263,40
62418117465,62418117458,-7,1095,4367,40
62418333822,62418333807,-15,115,911,40
62419555430,62419555425,-5,922,3324,40
62429973643,62429973636,-7,809,3404,40
62430629248,62430629249,1,57,1161,40
62432270047,62432270041,-6,1025,2647,40
62432385893,62432385913,20,400,908,40
62432430131,62432430140,9,683,400,40
62439697313,62439697307,-6,1518,3965,40
62439732759,62439732774,15,128,1290,40
62443580602,62443580597,-5,1005,4387,40
62457642590,62457642585,-5,875,2674,40
62457819160,62457819162,2,112,1065,40
62459184271,62459184265,-6,1213,3096,40
62459294645,62459294658,13,194,1158,40
62461364106,62461364110,4,6266,5552,40
62463679241,62463679237,-4,644,2092,40
62464553191,62464553183,-8,836,4477,40
62467285786,62467285780,-6,1137,3024,40
62469283786,62469283781,-5,1031,4018,40
62471876938,62471876932,-6,1263,4148,40
62475035322,62475035317,-5,1140,3384,40
62476242915,62476242910,-5,1014,3900,40
62477491688,62477491681,-7,752,3195,40
62486673088,62486673082,-6,1241,4719,40
62489223103,62489223099,-4,746,2831,40
62495150436,62495150435,-1,2196,3216,40
62509220191,62509220185,-6,1001,4478,40
62516997111,62516997105,-6,768,4255,40
62524718373,62524718386,13,453,2522,40
62525568542,62525568537,-5,1203,4836,40
62529903315,62529903309,-6,605,1784,40
62530118873,62530118865,-8,1407,5291,40
62536821112,62536821115,3,3382,2787,40
62540736223,62540736218,-5,732,3062,40
62545379783,62545379778,-5,964,4324,40
62545732080,62545732093,13,618,2404,40
62545829871,62545829867,-4,1250,2667,40
62547821926,62547821919,-7,1515,5397,40
62559709910,62559709906,-4,968,1097,40
62561562502,62561562494,-8,781,7063,40
62562202821,62562202814,-7,845,2428,40
62562933126,62562933121,-5,1078,3060,40
62565836382,62565836378,-4,623,3117,40
62568934634,62568934627,-7,948,5056,40
62570929613,62570929613,0,1372,1677,40
62576445843,62576445845,2,3558,3045,40
62580012029,62580012021,-8,925,3699,40
62580134790,62580134809,19,846,3350,40
62582568131,62582568125,-6,1105,3667,40
62587820798,62587820792,-6,1151,4084,40
62587859231,62587859226,-5,1252,2603,40
62590917719,62590917714,-5,963,3283,40
62591030015,62591030004,-11,213,5332,40
62594602936,62594602931,-5,1135,2837,40
62595161582,62595161572,-10,155,1122,40
62602596134,62602596127,-7,780,3339,40
62603306373,62603306366,-7,1202,6441,40
62608745994,62608745991,-3,2254,4948,40
62621060750,62621060743,-7,1006,3379,40
62632008202,62632008197,-5,1247,3718,40
62637151456,62637151450,-6,1348,3644,40
62638050855,62638050850,-5,786,2408,40
62638940829,62638940830,1,1542,1588,40
62653395379,62653395374,-5,1496,3831,40
62654409104,62654409127,23,133,1481,40
62654893086,62654893103,17,553,3198,40
62666945218,62666945226,8,2883,1451,40
62693789067,62693789061,-6,814,2529,40
62694376587,62694376589,2,1096,1040,40
62694574234,62694574228,-6,915,3595,40
62695000142,62695000135,-7,804,2711,40
62696216822,62696216820,-2,144,1914,40
62696681224,62696681239,15,279,2637,40
62698885552,62698885545,-7,648,2773,40
62699042066,62699042062,-4,1183,3953,40
62700362470,62700362483,13,293,1387,40
62701229102,62701229095,-7,1040,3444,40
62703555839,62703555833,-6,736,4123,40
62705723946,62705723938,-8,679,4077,40
62713826954,62713826949,-5,1145,3535,40
62714009998,62714010019,21,330,1291,40
62715145429,62715145445,16,82,992,40
62716127299,62716127296,-3,1819,1895,40
62721467982,62721467978,-4,1112,3412,40
62721969601,62721969596,-5,1249,4331,40
62729104630,62729104625,-5,836,3561,40
62729346958,62729346939,-19,357,1188,40
62731147670,62731147656,-14,934,238,40
62735155343,62735155337,-6,866,2084,40
62740774685,62740774681,-4,932,3194,40
62742928126,62742928120,-6,951,4152,40
62743752486,62743752489,3,5361,17775,40
62745808268,62745808261,-7,580,2438,40
62747059923,62747059918,-5,726,2481,40
62747246385,62747246388,3,2384,1751,40
62749075687,62749075681,-6,1114,3587,40
62755465898,62755465893,-5,1028,3203,40
62756571022,62756571002,-20,115,873,40
62757189473,62757189469,-4,1145,4539,40
62765409910,62765409904,-6,1179,4251,40
62766883625,62766883619,-6,1100,4206,40
62767422215,62767422208,-7,1475,4591,40
62768237577,62768237574,-3,2025,5040,40
62770662077,62770662070,-7,870,2350,40
62770734993,62770734986,-7,1007,2956,40
62771711453,62771711452,-1,1254,1935,40
62774136635,62774136629,-6,972,3426,40
62776169058,62776169053,-5,958,3706,40
62781700834,62781700828,-6,934,3681,40
62785286053,62785286045,-8,1035,3309,40
62789883408,62789883425,17,320,1072,40
62790807131,62790807126,-5,463,2379,40
62798747969,62798747963,-6,1062,3592,40
62806458158,62806458158,0,2709,2882,40
62809004767,62809004761,-6,774,4308,40
62809280262,62809280252,-10,1247,4578,40
62809817934,62809817953,19,1213,2496,40
62809991974,62809991970,-4,979,3208,40
62811174391,62811174385,-6,1085,3488,40
62813235134,62813235126,-8,1009,3199,40
62815719820,62815719814,-6,1080,4409,40
62817103697,62817103690,-7,935,4337,40
62818156546,62818156539,-7,723,4002,40
62825665006,62825664999,-7,902,4814,40
62835024445,62835024459,14,191,1505,40
62837439179,62837439173,-6,1280,4709,40
62840767742,62840767735,-7,995,4296,40
62841248980,62841248974,-6,1209,3614,40
62843607913,62843607906,-7,1124,1882,40
62844133054,62844133051,-3,136,933,40
62850577317,62850577312,-5,1203,4452,40
62864575124,62864575121,-3,919,1721,40
62865851855,62865851869,14,747,3992,40
62866942922,62866942919,-3,1432,3861,40
62876201982,62876201978,-4,993,3542,40
62877086682,62877086677,-5,955,3355,40
62877345136,62877345131,-5,79,1054,40
62877379189,62877379178,-11,41,1134,40
62885318326,62885318318,-8,1465,4649,40
62885379111,62885379103,-8,1217,2933,40
62892836855,62892836861,6,3672,1731,40
62894179954,62894179949,-5,1083,3482,40
62904316281,62904316274,-7,1034,4507,40
62908056336,62908056330,-6,1040,1742,40
62919791407,62919791402,-5,1214,4995,40
62920858089,62920858082,-7,935,3392,40
62921383691,62921383685,-6,936,3672,40
62930586616,62930586609,-7,1353,3918,40
62931221632,62931221637,5,30,1121,40
62934877883,62934877876,-7,1634,3814,40
62936268684,62936268678,-6,1019,4039,40
62941944877,62941944877,0,1716,1965,40
62943281094,62943281090,-4,1065,4576,40
62943848486,62943848480,-6,660,3022,40
62944132333,62944132353,20,451,2413,40
62944564183,62944564171,-12,80,1164,40
62944995919,62944995897,-22,90,1496,40
62945389324,62945389347,23,420,2409,40
62950521970,62950521963,-7,1379,3882,40
62951552017,62951552012,-5,1201,4203,40
62965509711,62965509706,-5,665,4014,40
62965617784,62965617798,14,196,899,40
62968366623,62968366622,-1,31540,24126,40
62976205158,62976205163,5,5376,2893,40
62977767091,62977767102,11,447,1975,40
62979423478,62979423469,-9,554,4675,40
62986687975,62986687969,-6,1181,4230,40
62988304073,62988304066,-7,1070,3501,40
62998130862,62998130857,-5,826,5249,40
62998208501,62998208503,2,2154,2546,40
62999550350,62999550361,11,1009,1304,40
63001071406,63001071401,-5,851,2845,40
63004967849,63004967844,-5,1247,4140,40
63011334603,63011334599,-4,847,2493,40
63015396209,63015396201,-8,958,4024,40
63020489979,63020489972,-7,886,3448,40
63026018727,63026018722,-5,848,4347,40
63027144186,63027144179,-7,814,4545,40
63029334474,63029334472,-2,1078,2174,40
63034729965,63034729958,-7,842,3900,40
63036229876,63036229894,18,266,1009,40
63037090053,63037090049,-4,723,2004,40
63039014997,63039014991,-6,1452,3973,40
63039910012,63039910006,-6,1183,3714,40
63042584174,63042584166,-8,1355,5040,40
63043394014,63043394022,8,287,2211,40
63043797052,63043797033,-19,175,1210,40
63046640546,63046640542,-4,1155,3594,40
63050886534,63050886513,-21,2874,1550,40
63052578489,63052578485,-4,1407,3623,40
63055032029,63055032027,-2,1014,2754,40
63058138546,63058138541,-5,866,3640,40
63061813836,63061813829,-7,857,3190,40
63065634010,63065634014,4,2122,1482,40
63068616209,63068616204,-5,751,3289,40
63071953972,63071953966,-6,1082,4200,40
63073231883,63073231878,-5,1176,4641,40
63076253573,63076253566,-7,861,3101,40
63092275105,63092275098,-7,1347,3586,40
63096516161,63096516159,-2,1077,2185,40
63100305608,63100305603,-5,977,3770,40
63104344922,63104344917,-5,812,2546,40
63105782410,63105782404,-6,1254,3769,40
63110842068,63110842067,-1,1329,1936,40
63111617901,63111617895,-6,521,4704,40
63113995356,63113995359,3,2352,1273,40
63116340405,63116340406,1,2099,2385,40
63122688851,63122688846,-5,1462,4460,40
63127482510,63127482515,5,2815,1081,40
63127776946,63127776950,4,2972,1346,40
63128711903,63128711898,-5,609,3169,40
63144062646,63144062641,-5,954,3577,40
63148093818,63148093811,-7,1399,4546,40
63154308702,63154308697,-5,894,3512,40
63157108537,63157108531,-6,1256,5382,40
63160983491,63160983483,-8,718,2291,40
63163849335,63163849330,-5,1294,3100,40
63168642599,63168642593,-6,1037,3891,40
63170160099,63170160089,-10,1159,5557,40
63172753065,63172753068,3,2951,1734,40
63177820664,63177820657,-7,1046,4278,40
63186479155,63186479149,-6,1023,4210,40
63195860229,63195860223,-6,957,4556,40
63198079056,63198079075,19,997,3731,40
63198219003,63198218996,-7,926,2865,40
63202391041,63202391035,-6,1342,4963,40
63209606396,63209606392,-4,47719,23943,40
63213715890,63213715884,-6,804,2785,40
63216945338,63216945334,-4,924,4444,40
63217813629,63217813634,5,2591,1484,40
63225806737,63225806733,-4,1238,2841,40
63228033186,63228033179,-7,594,4274,40
63228584056,63228584069,13,454,2111,40
63233041226,63233041220,-6,1264,4009,40
63233483538,63233483532,-6,1114,3603,40
63240593529,63240593523,-6,1029,3970,40
63251359974,63251359975,1,774,1316,40
63251974887,63251974881,-6,841,2169,40
63252349072,63252349086,14,212,1340,40
63254110354,63254110348,-6,942,4147,40
63259303654,63259303655,1,1247,1449,40
63269368039,63269368030,-9,1086,4177,40
63271896855,63271896849,-6,1273,3948,40
63277383819,63277383814,-5,1086,2990,40
63282539529,63282539523,-6,736,4445,40
63283629683,63283629689,6,10798,3488,40
63286444198,63286444205,7,12268,40736,40
63288880944,63288880938,-6,703,3313,40
63289008072,63289008086,14,977,4665,40
63291387619,63291387614,-5,691,2701,40
63301101339,63301101336,-3,863,3138,40
63301385806,63301385799,-7,178,904,40
63302182155,63302182149,-6,590,2014,40
63302242943,63302242958,15,439,1299,40
63304679211,63304679206,-5,626,4239,40
63313328489,63313328483,-6,1095,3450,40
63314667760,63314667754,-6,1077,4792,40
63315800679,63315800693,14,758,2854,40
63317158999,63317158993,-6,783,3462,40
63321563378,63321563373,-5,1164,3532,40
63330595354,63330595351,-3,995,1826,40
63334648493,63334648493,0,1859,2338,40
63338127150,63338127145,-5,1127,2646,40
63342481187,63342481181,-6,870,3714,40
63351857601,63351857594,-7,1385,4068,40
63352595109,63352595090,-19,363,933,40
63353704824,63353704841,17,656,4894,40
63354408710,63354408705,-5,1181,4038,40
63358330695,63358330689,-6,1041,3614,40
63367024550,63367024553,3,10153,24448,40
63368987014,63368987006,-8,851,3419,40
63372458581,63372458576,-5,1059,3632,40
63374141483,63374141477,-6,1193,2772,40
63375603218,63375603217,-1,2720,4645,40
63377656666,63377656658,-8,809,2837,40
63387900805,63387900809,4,46152,34048,40
63388675889,63388675882,-7,1200,5354,40
63389542888,63389542902,14,776,1848,40
63391120822,63391120818,-4,1098,2534,40
63393710974,63393710968,-6,1200,5184,40
63394388373,63394388369,-4,994,1183,40
63394758864,63394758879,15,309,1399,40
63397115982,63397115976,-6,904,3087,40
63398110359,63398110358,-1,1060,1910,40
63398366456,63398366451,-5,792,1670,40
63400772699,63400772695,-4,903,2695,40
63422480170,63422480163,-7,1289,5301,40
63422927629,63422927635,6,5749,2111,40
63425622521,63425622514,-7,1119,4195,40
63428880510,63428880503,-7,644,1910,40
63433085814,63433085821,7,3506,1274,40
63433386720,63433386714,-6,1202,3511,40
63436622447,63436622443,-4,957,3530,40
63437252876,63437252871,-5,646,2591,40
63439291128,63439291122,-6,1147,3830,40
63439743119,63439743122,3,160,806,40
63446792361,63446792354,-7,1265,5557,40
63447619067,63447619061,-6,867,5137,40
63448959181,63448959174,-7,934,4560,40
63449217110,63449217126,16,22,1191,40
63450149419,63450149413,-6,1003,2758,40
63455886150,63455886143,-7,923,3491,40
63456329068,63456329056,-12,262,931,40
63457815422,63457815417,-5,1069,3946,40
63458735941,63458735962,21,1208,1717,40
63460686409,63460686404,-5,1321,3630,40
63468821999,63468821997,-2,878,2425,40
63469937857,63469937854,-3,1515,2677,40
63472209441,63472209436,-5,918,3035,40
63473428471,63473428486,15,474,2127,40
63480387145,63480387151,6,5131,2901,40
63488046055,63488046050,-5,873,4120,40
63499297623,63499297617,-6,982,2797,40
63505100255,63505100249,-6,1075,4150,40
63507011733,63507011732,-1,1055,1579,40
63510862980,63510862974,-6,822,3385,40
63512363473,63512363474,1,1126,915,40
63519030694,63519030690,-4,1179,4032,40
63519675361,63519675361,0,1905,2720,40
63525115176,63525115186,10,480,2141,40
63525340242,63525340237,-5,1195,4057,40
63538263674,63538263668,-6,295,1380,40
63547726999,63547727003,4,2333,1366,40
63552595921,63552595914,-7,2123,7400,40
63557659609,63557659602,-7,1811,7063,40
63566264867,63566264862,-5,864,3854,40
63569179159,63569179153,-6,869,4494,40
63571260870,63571260867,-3,653,2854,40
63574394763,63574394757,-6,1346,4185,40
63579033499,63579033495,-4,1256,1968,40
63583139617,63583139612,-5,967,3129,40
63583394245,63583394240,-5,942,3900,40
63584585941,63584585934,-7,1545,4414,40
63586940513,63586940516,3,19412,16176,40
63589054134,63589054129,-5,1266,3112,40
63589680414,63589680409,-5,1060,2872,40
63589947286,63589947282,-4,901,2847,40
63595731498,63595731498,0,26825,31040,40
63596449553,63596449550,-3,1317,3110,40
63602920145,63602920143,-2,1986,1792,40
63607104599,63607104594,-5,1035,4040,40
63608591335,63608591333,-2,39842,19069,40
63610411380,63610411373,-7,923,3217,40
63612586806,63612586802,-4,700,3883,40
63613669325,63613669325,0,2665,4204,40
63614493473,63614493469,-4,1017,3694,40
63615819392,63615819402,10,229,1312,40
63616993739,63616993733,-6,1447,4611,40
63618887510,63618887503,-7,827,3688,40
63620162370,63620162362,-8,729,3400,40
63642868707,63642868701,-6,1081,5165,40
63646264953,63646264932,-21,6113,2092,40
63651294190,63651294183,-7,1028,3388,40
63655135457,63655135454,-3,948,996,40
63659475041,63659475041,0,971,2028,40
63661733496,63661733490,-6,1269,3759,40
63661822220,63661822234,14,421,879,40
63663358100,63663358093,-7,710,4004,40
63665090895,63665090890,-5,641,3975,40
63665314310,63665314326,16,211,867,40
63685241811,63685241815,4,4666,2811,40
63686624739,63686624745,6,2914,1643,40
63692846462,63692846458,-4,742,1670,40
63695878157,63695878158,1,4311,4793,40
63702079063,63702079059,-4,1133,3088,40
63704566099,63704566090,-9,950,3860,40
63706873875,63706873862,-13,830,2493,40
63706992362,63706992356,-6,784,3372,40
63709527578,63709527572,-6,1175,4095,40
63711110018,63711110010,-8,1390,5271,40
63711442782,63711442775,-7,1235,5713,40
63714224626,63714224627,1,1015,1329,40
63731819825,63731819820,-5,1248,3099,40
63732157199,63732157194,-5,1065,3851,40
63732382726,63732382743,17,223,1008,40
63733313135,63733313129,-6,1069,7019,40
63735283871,63735283866,-5,1519,4668,40
63735395545,63735395539,-6,1114,4378,40
63742207279,63742207275,-4,1123,2481,40
63744893442,63744893450,8,3035,1183,40
63760092708,63760092703,-5,3252,7511,40
63771606197,63771606196,-1,391,159,40
63783044417,63783044409,-8,794,2855,40
63783113831,63783113818,-13,45910,17172,40
63784028669,63784028661,-8,1013,3612,40
63786880464,63786880458,-6,555,2551,40
63788123191,63788123187,-4,870,1608,40
63788437882,63788437877,-5,1323,4773,40
63790628433,63790628427,-6,1003,3341,40
63791695494,63791695477,-17,85,1161,40
63791881278,63791881265,-13,1328,3496,40
63799804788,63799804796,8,17474,18749,40
63800507455,63800507450,-5,1169,3355,40
63801056909,63801056905,-4,1422,4359,40
63807213817,63807213809,-8,973,4844,40
63808280481,63808280489,8,77671,31891,40
63811092119,63811092113,-6,1126,4246,40
63811747703,63811747698,-5,708,3271,40
63811836623,63811836609,-14,592,2355,40
63811899190,63811899205,15,724,4467,40
63816747106,63816747101,-5,929,2380,40
63819839088,63819839081,-7,1424,5795,40
63820845921,63820845914,-7,1166,4687,40
63828077759,63828077766,7,133,1147,40
63830467024,63830467027,3,3133,3066,40
63836550082,63836550078,-4,778,2464,40
63837103829,63837103846,17,598,2076,40
63841051422,63841051416,-6,1049,3204,40
63847411075,63847411069,-6,1222,4308,40
63854567548,63854567541,-7,1144,3822,40
63855089093,63855089089,-4,1356,5049,40
63856413678,63856413673,-5,751,1909,40
63878297339,63878297334,-5,1128,3357,40
63890392223,63890392218,-5,1000,3914,40
63893095101,63893095097,-4,1101,2848,40
63893720579,63893720573,-6,1101,4467,40
63894067783,63894067792,9,537,13240,40
63895143636,63895143634,-2,107,1306,40
63895534815,63895534793,-22,269,3369,40
63928485446,63928485441,-5,1037,3184,40
63929176093,63929176081,-12,46,1437,40
63929878452,63929878442,-10,95,1193,40
63931929926,63931929922,-4,874,3218,40
63933588326,63933588326,0,36105,16962,40
63951796546,63951796540,-6,1127,3862,40
63956996667,63956996675,8,425,1179,40
63957462599,63957462594,-5,1032,3997,40
63957501903,63957501897,-6,975,3702,40
63973211545,63973211537,-8,1211,3121,40
63976515946,63976515943,-3,1814,5050,40
63976561343,63976561338,-5,1321,3461,40
63976607688,63976607698,10,825,2334,40
63984485402,63984485406,4,1693,1147,40
63986550778,63986550773,-5,1041,3748,40
63986642958,63986642969,11,247,1372,40
63992263651,63992263644,-7,1111,4270,40
63992323044,63992323046,2,153,1242,40
63995487726,63995487718,-8,656,2691,40
63995569928,63995569941,13,1161,5476,40
63995844408,63995844413,5,2867,1608,40
64005675635,64005675627,-8,887,4622,40
64007817176,64007817171,-5,716,2581,40
64012330063,64012330056,-7,794,4388,40
64012540084,64012540102,18,522,1521,40
64015120824,64015120818,-6,976,4245,40
64020754219,64020754213,-6,442,1204,40
64021383159,64021383166,7,61,1054,40
64025358838,64025358834,-4,331,2964,40
64026108191,64026108206,15,754,3381,40
64038892055,64038892049,-6,975,4111,40
64040891670,64040891666,-4,406,1386,40
64056644305,64056644298,-7,1117,4258,40
64057004159,64057004153,-6,999,3880,40
64057630237,64057630231,-6,949,3119,40
64060919545,64060919539,-6,930,4239,40
64061478575,64061478593,18,708,3558,40
64063485817,64063485812,-5,778,2771,40
64065231260,64065231279,19,486,2694,40
64072127097,64072127093,-4,952,3868,40
64081436055,64081436049,-6,1154,4424,40
64082942701,64082942685,-16,869,4030,40
64083987302,64083987282,-20,289,1178,40
64085346274,64085346269,-5,898,3446,40
64105688489,64105688484,-5,1009,2369,40
64106152627,64106152622,-5,995,4523,40
64106994478,64106994473,-5,845,2676,40
64107347676,64107347670,-6,905,2406,40
64113288005,64113287999,-6,1272,2811,40
64115019716,64115019713,-3,1137,3789,40
64117766525,64117766519,-6,1351,4250,40
64118823410,64118823402,-8,695,2304,40
64119078214,64119078214,0,182,771,40
64120088278,64120088294,16,437,1048,40
64120203871,64120203870,-1,1347,1876,40
64122341800,64122341815,15,116,1161,40
64123576279,64123576273,-6,676,4289,40
64124231072,64124231083,11,124,683,40
64124641045,64124641065,20,419,1113,40
64136493574,64136493570,-4,1385,3940,40
64137072434,64137072430,-4,1237,3977,40
64140914358,64140914352,-6,978,3491,40
64148215646,64148215640,-6,990,3155,40
64148815767,64148815766,-1,226,1508,40
64148941406,64148941390,-16,1027,3229,40
64149346841,64149346837,-4,779,3581,40
64149379261,64149379271,10,296,535,40
64156575055,64156575051,-4,1101,2915,40
64157067892,64157067878,-14,1221,5313,40
64158541431,64158541425,-6,616,2814,40
64158803582,64158803596,14,880,3646,40
64159106555,64159106563,8,6767,3054,40
64163292443,64163292438,-5,1225,3029,40
64165055954,64165055946,-8,1150,4942,40
64170291582,64170291577,-5,718,2568,40
64180773721,64180773715,-6,993,2785,40
64182210882,64182210887,5,6511,25993,40
64183692134,64183692130,-4,531,2231,40
64184120331,64184120328,-3,516,1810,40
64184219614,64184219629,15,718,2904,40
64184537917,64184537918,1,1700,1365,40
64192730400,64192730393,-7,958,3332,40
64193633631,64193633623,-8,954,2677,40
64195593403,64195593399,-4,1190,3325,40
64199543342,64199543336,-6,1404,5632,40
64205633961,64205633954,-7,1018,3720,40
64207246626,64207246621,-5,911,3460,40
64207666292,64207666295,3,950,900,40
64211471123,64211471118,-5,882,3909,40
64211691546,64211691552,6,17692,20050,40
64212573495,64212573490,-5,1377,1853,40
64225506651,64225506643,-8,949,3719,40
64228109866,64228109858,-8,686,3024,40
64238796844,64238796838,-6,958,2765,40
64247423571,64247423566,-5,707,2548,40
64248133989,64248134005,16,193,1372,40
64253687482,64253687477,-5,1174,4395,40
64254170735,64254170729,-6,921,3486,40
64254542614,64254542626,12,398,1325,40
64255710985,64255710983,-2,125,1090,40
64256460019,64256460014,-5,931,3127,40
64256559736,64256559754,18,788,2801,40
64256674566,64256674562,-4,785,3450,40
64257361350,64257361350,0,1586,1862,40
64257872098,64257872092,-6,1042,3242,40
64257927991,64257927982,-9,57,623,40
64260476182,64260476187,5,21163,20539,40
64262218520,64262218515,-5,943,3307,40
64262864437,64262864430,-7,633,4111,40
64271496333,64271496325,-8,1321,3380,40
64273030970,64273030964,-6,1249,4056,40
64273359214,64273359201,-13,314,1400,40
64283412671,64283412666,-5,1096,3069,40
64284481378,64284481373,-5,1623,3537,40
64290346627,64290346622,-5,1029,4183,40
64307164239,64307164233,-6,848,3815,40
64307252629,64307252650,21,951,3577,40
64314980095,64314980078,-17,483,1835,40
64315121093,64315121075,-18,245,1294,40
64326433886,64326433881,-5,633,3233,40
64328477539,64328477547,8,1666,592,40
64328977509,64328977503,-6,936,3184,40
64329040271,64329040290,19,817,2723,40
64329745284,64329745298,14,330,1090,40
64335266590,64335266596,6,2945,1386,40
64337535615,64337535619,4,20889,23530,40
64337901591,64337901586,-5,778,3330,40
64338296490,64338296482,-8,544,3727,40
64352487543,64352487538,-5,968,3549,40
64353332387,64353332393,6,4297,2005,40
64354701159,64354701153,-6,889,4036,40
64354852336,64354852338,2,168,1085,40
64357711763,64357711757,-6,1145,4711,40
64364130112,64364130119,7,7690,953,40
64377166002,64377165997,-5,937,3441,40
64378935637,64378935633,-4,1035,3636,40
64386977752,64386977747,-5,735,2663,40
64395598834,64395598830,-4,595,3101,40
64397442170,64397442165,-5,1284,4399,40
64403720455,64403720450,-5,1427,3316,40
64408055230,64408055224,-6,1365,4499,40
64411012981,64411012985,4,2669,2385,40
64417522021,64417522017,-4,1203,4590,40
64425633738,64425633733,-5,868,4145,40
64426602293,64426602274,-19,300,1077,40
64430862567,64430862562,-5,1098,4063,40
64432597273,64432597268,-5,1197,3360,40
64433650469,64433650462,-7,789,3670,40
64434320365,64434320357,-8,1064,7795,40
64438836971,64438836965,-6,893,3329,40
64438941814,64438941806,-8,1178,6263,40
64446943205,64446943201,-4,992,3664,40
64447523505,64447523498,-7,1184,3543,40
64452878075,64452878068,-7,828,3260,40
64453383776,64453383787,11,812,4034,40
64454852641,64454852645,4,2313,1578,40
64456003569,64456003571,2,5752,4577,40
64456460799,64456460790,-9,809,3529,40
64456811671,64456811663,-8,684,2274,40
64464937466,64464937460,-6,783,2436,40
64468256906,64468256898,-8,1051,4316,40
64469373027,64469373022,-5,932,4475,40
64469494053,64469494069,16,3,1311,40
64471673868,64471673865,-3,958,2051,40
64472187819,64472187814,-5,936,2395,40
64480106744,64480106740,-4,728,3390,40
64480584604,64480584597,-7,1202,1732,40
64480649044,64480649065,21,469,1827,40
64488096889,64488096883,-6,933,3190,40
64488987518,64488987511,-7,509,1301,40
64490498531,64490498525,-6,574,2018,40
64491132958,64491132953,-5,580,3287,40
64494529045,64494529039,-6,1448,5121,40
64499200638,64499200643,5,1806,1027,40
64513727655,64513727650,-5,846,3177,40
64518357834,64518357828,-6,890,4099,40
64527159002,64527159002,0,1474,1403,40
64532582554,64532582546,-8,1499,3928,40
64542712085,64542712081,-4,900,3537,40
64543281563,64543281557,-6,928,2823,40
64545098883,64545098878,-5,1033,3891,40
64549141295,64549141289,-6,610,2259,40
64552697478,64552697479,1,3600,3393,40
64556406527,64556406519,-8,849,5833,40
64561652066,64561652061,-5,1193,4157,40
64563278706,64563278700,-6,836,4814,40
64567921326,64567921319,-7,661,2872,40
64568132261,64568132278,17,305,1099,40
64571241795,64571241791,-4,1180,4409,40
64573519182,64573519178,-4,1158,4425,40
64576167091,64576167086,-5,571,2576,40
64579762519,64579762514,-5,606,4722,40
64586641152,64586641147,-5,1237,4007,40
64589139768,64589139786,18,509,2866,40
64591121959,64591121954,-5,781,2099,40
64591251052,64591251056,4,197,812,40
64593490037,64593490032,-5,1204,4723,40
64595770200,64595770193,-7,1077,4053,40
64598389119,64598389111,-8,886,3168,40
64599074304,64599074298,-6,1075,2879,40
64601550922,64601550917,-5,813,3941,40
64602356143,64602356134,-9,266,1161,40
64602964734,64602964727,-7,18,1071,40
64603346840,64603346857,17,204,905,40
64605426113,64605426108,-5,793,4327,40
64605532214,64605532193,-21,243,730,40
64608586553,64608586545,-8,902,5212,40
64615104167,64615104161,-6,1269,4385,40
64615870031,64615870046,15,1035,3848,40
64617285862,64617285857,-5,988,3883,40
64619693415,64619693410,-5,604,2333,40
64620248210,64620248203,-7,961,3703,40
64626588462,64626588457,-5,891,5315,40
64627230728,64627230734,6,83,1255,40
64634888411,64634888410,-1,1873,2723,40
64635629382,64635629377,-5,705,3654,40
64637180660,64637180654,-6,1317,4023,40
64638798954,64638798952,-2,1915,3943,40
64640642870,64640642864,-6,1051,3759,40
64646865750,64646865743,-7,995,2756,40
64646936050,64646936044,-6,1249,3857,40
64647095190,64647095168,-22,172,1207,40
64647580934,64647580927,-7,1010,3326,40
64653654753,64653654746,-7,830,1960,40
64656052450,64656052444,-6,745,3430,40
64658220249,64658220242,-7,1047,3031,40
64658974254,64658974268,14,745,1831,40
64659103043,64659103037,-6,781,3158,40
64665900389,64665900395,6,3025,863,40
64673444842,64673444835,-7,1566,5859,40
64682028466,64682028461,-5,876,2014,40
64683054506,64683054499,-7,1180,3142,40
64686890365,64686890360,-5,1142,3046,40
64690299703,64690299694,-9,941,4223,40
64693136931,64693136926,-5,847,3915,40
64694734234,64694734227,-7,840,3358,40
64698591350,64698591349,-1,1610,1990,40
64698961982,64698961977,-5,926,3355,40
64710074070,64710074062,-8,1268,3295,40
64715044967,64715044963,-4,484,3195,40
64716155444,64716155437,-7,801,3478,40
64717134121,64717134123,2,3259,2448,40
64718527617,64718527613,-4,953,4591,40
64719418587,64719418580,-7,23154,17100,40
64721105187,64721105182,-5,635,3547,40
64721564430,64721564426,-4,782,1892,40
64721668374,64721668361,-13,58,1019,40
64722577803,64722577804,1,1225,1432,40
64725901666,64725901665,-1,1237,2559,40
64728763942,64728763937,-5,846,3841,40
64728804575,64728804585,10,181,1421,40
64739988010,64739988005,-5,827,3409,40
64740301759,64740301771,12,522,2970,40
64741626977,64741626971,-6,739,2963,40
64753077811,64753077805,-6,1295,4173,40
64758885431,64758885426,-5,1383,3763,40
64764626875,64764626869,-6,1106,4560,40
64770525637,64770525633,-4,1355,4098,40
64770632031,64770632024,-7,1290,4442,40
64770869314,64770869309,-5,517,1781,40
64772306472,64772306466,-6,861,2773,40
64772633082,64772633074,-8,830,3432,40
64772755309,64772755307,-2,25,1222,40
64776105852,64776105845,-7,1006,3716,40
64777647738,64777647722,-16,1865,998,40
64779194991,64779194985,-6,805,5012,40
64779290824,64779290841,17,165,1377,40
64779917694,64779917708,14,91,1293,40
64782091261,64782091254,-7,1104,4741,40
64789709916,64789709911,-5,1184,4283,40
64790327317,64790327297,-20,163,1664,40
64793075201,64793075197,-4,996,2655,40
64793404791,64793404810,19,790,4213,40
64794181655,64794181654,-1,1749,1790,40
64803787040,64803787036,-4,993,3222,40
64821491975,64821491969,-6,946,4196,40
64823805962,64823805965,3,1168,1311,40
64825022354,64825022360,6,5826,1627,40
64825878886,64825878901,15,899,3724,40
64829319110,64829319115,5,13485,6516,40
64830144644,64830144639,-5,1098,2764,40
64830327695,64830327705,10,488,1321,40
64831738363,64831738358,-5,1017,2902,40
64834976479,64834976474,-5,766,2589,40
64844559058,64844559053,-5,1364,4007,40
64848356321,64848356316,-5,991,3839,40
64848728246,64848728241,-5,834,2940,40
64849696678,64849696673,-5,535,2324,40
64850479429,64850479422,-7,971,3912,40
64853912049,64853912043,-6,1199,3375,40
64854892324,64854892343,19,113,966,40
64858296241,64858296234,-7,1144,3681,40
64861307706,64861307698,-8,1154,5368,40
64861856367,64861856360,-7,46810,22002,40
64861970290,64861970285,-5,1087,4316,40
64863065877,64863065869,-8,1557,4332,40
64864630054,64864630048,-6,1032,3585,40
64866761262,64866761256,-6,1383,3890,40
64869305858,64869305853,-5,862,4453,40
64871062473,64871062466,-7,1407,4509,40
64878396744,64878396741,-3,20027,16423,40
64880069145,64880069126,-19,211,1205,40
64880649725,64880649743,18,643,2433,40
64892144334,64892144327,-7,1068,3738,40
64904081964,64904081958,-6,917,2415,40
64904699079,64904699098,19,319,838,40
64913296064,64913296057,-7,1163,3392,40
64917062087,64917062081,-6,1176,2868,40
64917831020,64917831002,-18,177,755,40
64920006888,64920006907,19,147,1425,40
64921552598,64921552596,-2,621,1500,40
64921866938,64921866933,-5,1491,5714,40
64927210253,64927210248,-5,1238,2994,40
64927682600,64927682618,18,583,1383,40
64928803590,64928803587,-3,845,3714,40
64929232781,64929232776,-5,825,4057,40
64930647943,64930647938,-5,1075,2796,40
64933472455,64933472450,-5,804,2473,40
64934484832,64934484833,1,2107,4044,40
64934929810,64934929804,-6,1223,3776,40
64935018682,64935018679,-3,1064,1834,40
64935433675,64935433669,-6,1073,4521,40
64938296410,64938296406,-4,1009,3699,40
64938836335,64938836353,18,405,1251,40
64940912051,64940912056,5,4702,2611,40
64945886676,64945886674,-2,1400,2027,40
64947338487,64947338479,-8,723,2110,40
64963571571,64963571566,-5,822,3379,40
64963611237,64963611253,16,218,1711,40
64971251178,64971251178,0,1242,1264,40
64979097375,64979097375,0,1628,1484,40
64980690470,64980690465,-5,654,2479,40
64985232023,64985232018,-5,1000,3108,40
64986899252,64986899254,2,1179,1400,40
64991027242,64991027242,0,1200,1991,40
64991520599,64991520595,-4,395,1179,40
64997540779,64997540774,-5,1027,4404,40
64998192539,64998192534,-5,890,4097,40
65001020374,65001020368,-6,974,4498,40
65005524004,65005524000,-4,1971,5416,40
65007047755,65007047750,-5,832,4384,40
65008334585,65008334579,-6,1013,2893,40
65010501855,65010501850,-5,1538,7254,40
65015046391,65015046385,-6,835,5315,40
65027645578,65027645570,-8,1580,5271,40
65029068313,65029068306,-7,915,4098,40
65029840316,65029840332,16,412,1342,40
65036074027,65036074017,-10,589,1977,40
65036893027,65036893021,-6,1553,4462,40
65048140760,65048140748,-12,8337,365,40
65052250340,65052250334,-6,1188,4104,40
65053219916,65053219922,6,5940,22400,40
65065444851,65065444846,-5,898,4199,40
65070208411,65070208404,-7,1183,3225,40
65072288890,65072288886,-4,1137,4534,40
65081457899,65081457893,-6,1003,4064,40
65087588378,65087588370,-8,893,4722,40
65087677053,65087677070,17,897,3966,40
65089968776,65089968767,-9,791,4112,40
65095300119,65095300114,-5,1154,1922,40
65099393830,65099393822,-8,1315,4010,40
65102756520,65102756511,-9,997,3835,40
65107460725,65107460721,-4,732,2945,40
65111787079,65111787074,-5,1201,3263,40
65115477198,65115477196,-2,1830,2420,40
65120569166,65120569159,-7,999,4815,40
65120953756,65120953750,-6,877,3534,40
65130252326,65130252320,-6,981,3153,40
65132194549,65132194552,3,4179,17301,40
65133098110,65133098105,-5,1219,3987,40
65134622054,65134622057,3,4590,3208,40
65144781527,65144781521,-6,704,3244,40
65152222238,65152222232,-6,1293,4335,40
65152564551,65152564555,4,24829,24778,40
65159962827,65159962821,-6,1368,4214,40
65161114855,65161114859,4,2071,1433,40
65162447216,65162447222,6,53997,24098,40
65163163797,65163163790,-7,1194,3888,40
65164032478,65164032478,0,2244,3375,40
65171360062,65171360070,8,10096,33227,40
65171970134,65171970133,-1,3529,4112,40
65175671998,65175671991,-7,1087,4603,40
65176245621,65176245634,13,249,1348,40
65179878105,65179878104,-1,528,2890,40
65180783287,65180783286,-1,1720,2194,40
65187184010,65187184002,-8,1180,2904,40
65187746645,65187746641,-4,849,3744,40
65189530055,65189530050,-5,883,2651,40
65192955618,65192955612,-6,934,3388,40
65195122959,65195122952,-7,752,3989,40
65195243085,65195243080,-5,1433,4360,40
65196515534,65196515529,-5,1338,3942,40
65208690288,65208690283,-5,1195,3931,40
65211253251,65211253251,0,1382,1864,40
65211579732,65211579726,-6,1414,3259,40
65212056252,65212056240,-12,1305,4566,40
65215701167,65215701161,-6,821,3289,40
65232413139,65232413134,-5,1023,3539,40
65234412048,65234412044,-4,3537,8461,40
65242271908,65242271902,-6,1198,3602,40
65245893562,65245893554,-8,1070,3812,40
65247501091,65247501086,-5,962,3384,40
65255014971,65255014966,-5,1160,4210,40
65255860506,65255860509,3,2031,1845,40
65257098486,65257098490,4,2551,1020,40
65264739416,65264739419,3,1098,967,40
65265759164,65265759160,-4,597,910,40
65266511530,65266511525,-5,490,1542,40
65271515638,65271515632,-6,1009,3771,40
65272790147,65272790145,-2,1527,2016,40
65273381429,65273381450,21,637,3641,40
65281274847,65281274842,-5,531,2884,40
65283498290,65283498285,-5,1294,4070,40
65285424387,65285424378,-9,814,3854,40
65286923754,65286923749,-5,939,3928,40
65289677697,65289677692,-5,1127,3161,40
65292105943,65292105945,2,1400,1842,40
65295722092,65295722086,-6,1242,4112,40
65297796560,65297796555,-5,1176,3370,40
65304195121,65304195114,-7,1063,4331,40
65305586155,65305586150,-5,964,3135,40
65307414739,65307414742,3,2501,2469,40
65307642231,65307642225,-6,1121,3960,40
65308379437,65308379449,12,237,2022,40
65310520080,65310520074,-6,1511,2795,40
65312800206,65312800200,-6,927,3302,40
65313653718,65313653710,-8,300,931,40
65322054563,65322054558,-5,1076,3686,40
65334404340,65334404330,-10,938,2772,40
65335183502,65335183493,-9,123,1191,40
65340226394,65340226389,-5,1033,4611,40
65352181761,65352181753,-8,907,4867,40
65354194179,65354194183,4,1237,1053,40
65359747942,65359747937,-5,1071,3513,40
65359875698,65359875692,-6,1109,3405,40
65361469363,65361469357,-6,1402,4577,40
65369486840,65369486833,-7,384,2485,40
65371117183,65371117174,-9,266,883,40
65372424565,65372424560,-5,1110,3956,40
65372487638,65372487637,-1,1358,2028,40
65373726208,65373726202,-6,1088,3871,40
65381623946,65381623941,-5,626,2037,40
65388630345,65388630340,-5,723,2719,40
65391567703,65391567697,-6,1084,3119,40
65392359102,65392359115,13,713,2764,40
65393037100,65393037094,-6,969,3220,40
65396221949,65396221970,21,654,3339,40
65400023245,65400023238,-7,866,1396,40
65400428104,65400428118,14,721,3032,40
65400969171,65400969165,-6,942,2804,40
65401145877,65401145894,17,622,1858,40
65401353962,65401353958,-4,1238,2175,40
65402274404,65402274398,-6,1038,4616,40
65405441496,65405441490,-6,782,2742,40
65419183735,65419183729,-6,1080,3359,40
65419379882,65419379877,-5,815,4889,40
65420942400,65420942417,17,125,1867,40
65422785463,65422785457,-6,1646,3925,40
65427494466,65427494461,-5,877,4382,40
65431686663,65431686658,-5,1307,3746,40
65432908162,65432908157,-5,949,3259,40
65435669756,65435669749,-7,1101,2781,40
65437620947,65437620939,-8,1025,3865,40
65437764823,65437764806,-17,558,3123,40
65445033452,65445033450,-2,1657,1785,40
65448786567,65448786562,-5,883,3528,40
65449788382,65449788377,-5,995,3229,40
65454911914,65454911909,-5,915,3292,40
65456429414,65456429408,-6,958,3070,40
65456656863,65456656876,13,684,3745,40
65457355419,65457355413,-6,1168,5018,40
65459615371,65459615366,-5,813,3478,40
65466187538,65466187525,-13,988,548,40
65474025591,65474025586,-5,1403,2102,40
65480996600,65480996597,-3,1588,1896,40
65486224447,65486224446,-1,2224,4292,40
65489084154,65489084154,0,1396,2289,40
65491093822,65491093817,-5,1138,3670,40
65495054350,65495054346,-4,935,2449,40
65498207911,65498207904,-7,874,4473,40
65498885455,65498885473,18,911,2965,40
65508084144,65508084139,-5,899,3416,40
65521736889,65521736885,-4,624,3763,40
65523233838,65523233833,-5,1338,5348,40
65523275188,65523275190,2,102,1150,40
65526593791,65526593786,-5,806,2284,40
65527300123,65527300115,-8,1476,4325,40
65528005188,65528005186,-2,567,1382,40
65532480980,65532480975,-5,833,1719,40
65532659014,65532659011,-3,884,2591,40
65537614692,65537614687,-5,1202,3180,40
65548438998,65548438997,-1,1481,2416,40
65550540043,65550540037,-6,931,2587,40
65562183718,65562183713,-5,808,2345,40
65569519277,65569519270,-7,1066,3808,40
65574404163,65574404157,-6,723,4232,40
65577250477,65577250471,-6,825,3698,40
65578626325,65578626318,-7,1171,3483,40
65581299570,65581299562,-8,968,2815,40
65581519429,65581519425,-4,645,2107,40
65586801055,65586801046,-9,719,3295,40
65598082546,65598082537,-9,700,4150,40
65605907910,65605907909,-1,1192,2686,40
65610571573,65610571565,-8,731,3551,40
65612231942,65612231937,-5,1000,2698,40
65612440141,65612440151,10,220,1181,40
65619703881,65619703875,-6,621,2149,40
65619756844,65619756858,14,10,1097,40
65620342226,65620342221,-5,1264,2800,40
65625781186,65625781191,5,20104,23909,40
65630285483,65630285479,-4,987,2828,40
65632359387,65632359387,0,1885,1742,40
65636966708,65636966711,3,17162,12982,40
65655534121,65655534104,-17,5989,1668,40
65658028693,65658028686,-7,1278,4568,40
65661777735,65661777728,-7,1013,4764,40
65664779822,65664779817,-5,886,3105,40
65665356922,65665356918,-4,1296,2851,40
65667165032,65667165028,-4,1090,2777,40
65668135949,65668135954,5,137,1181,40
65673675518,65673675513,-5,1079,3445,40
65677635097,65677635091,-6,985,3195,40
65680704233,65680704237,4,2713,1791,40
65682814439,65682814434,-5,471,1100,40
65695340962,65695340961,-1,2414,4255,40
65700566418,65700566412,-6,1208,4344,40
65701896335,65701896329,-6,1167,3171,40
65702458920,65702458938,18,1071,3319,40
65704149595,65704149600,5,4009,2380,40
65706494906,65706494901,-5,1093,4543,40
65710688583,65710688589,6,4117,1915,40
65715263055,65715263050,-5,850,3557,40
65716164308,65716164302,-6,1071,4376,40
65716780694,65716780689,-5,971,4146,40
65723979942,65723979937,-5,1073,3862,40
65724315196,65724315206,10,182,943,40
65726185007,65726185001,-6,1464,4819,40
65727626429,65727626422,-7,1002,3090,40
65728033495,65728033495,0,80,938,40
65728466693,65728466699,6,261,3401,40
65728683498,65728683493,-5,1113,3155,40
65736030902,65736030895,-7,820,3060,40
65737247965,65737247950,-15,385,1049,40
65738625474,65738625467,-7,696,3126,40
65741595121,65741595116,-5,1165,3828,40
65743060471,65743060466,-5,960,2952,40
65743151173,65743151182,9,11236,25406,40
65743242966,65743242960,-6,1217,3352,40
65746284857,65746284862,5,2677,1532,40
65747682425,65747682419,-6,1499,4999,40
65756796987,65756796981,-6,1264,5294,40
65757235750,65757235744,-6,1090,4612,40
65759175191,65759175186,-5,1305,2721,40
65760906896,65760906891,-5,1502,4485,40
65766269405,65766269401,-4,979,2415,40
65766947346,65766947339,-7,1230,3568,40
65773679415,65773679418,3,1203,1085,40
65787534025,65787534021,-4,655,2882,40
65788959714,65788959709,-5,1020,3758,40
65807418115,65807418110,-5,765,3936,40
65807473001,65807472998,-3,1144,1963,40
65807581159,65807581153,-6,1073,3904,40
65808764320,65808764326,6,1859,1229,40
65816632642,65816632634,-8,869,1398,40
65818432890,65818432886,-4,977,3232,40
65818996910,65818996931,21,233,1091,40
65822213450,65822213442,-8,1028,3505,40
65828771893,65828771888,-5,1339,3158,40
65830189014,65830189007,-7,1025,3560,40
65835492651,65835492646,-5,1143,3736,40
65837796815,65837796818,3,1658,1293,40
65842804873,65842804866,-7,877,4320,40
65858590059,65858590053,-6,1363,4853,40
65864167678,65864167673,-5,1055,3553,40
65868527640,65868527634,-6,791,3027,40
65869991282,65869991286,4,2231,1528,40
65883061853,65883061846,-7,1397,4143,40
65885297510,65885297503,-7,936,6589,40
65888532984,65888532986,2,15642,14701,40
65890364993,65890364988,-5,1359,3605,40
65897606438,65897606433,-5,635,3579,40
65902958559,65902958552,-7,841,3206,40
65916577759,65916577753,-6,1017,3512,40
65916915606,65916915625,19,279,1513,40
65919390934,65919390931,-3,1098,1377,40
65920544067,65920544062,-5,971,2939,40
65931427778,65931427772,-6,907,2480,40
65932366621,65932366617,-4,853,2817,40
65939951594,65939951591,-3,1454,3188,40
65944407350,65944407345,-5,2131,7441,40
65954047137,65954047142,5,3286,1593,40
65964480298,65964480294,-4,952,2006,40
65973147049,65973147045,-4,934,2512,40
65976013499,65976013507,8,9962,25470,40
65978543370,65978543365,-5,917,4204,40
65980570774,65980570770,-4,1174,3114,40
65988300941,65988300937,-4,1043,3447,40
65988453078,65988453095,17,303,3056,40
65989845631,65989845625,-6,982,1964,40
65993088638,65993088648,10,4858,1773,40
65993378498,65993378493,-5,837,2386,40
65996982383,65996982378,-5,1578,4616,40
66006250141,66006250136,-5,991,2888,40
66006405780,66006405775,-5,119,1184,40
66006957564,66006957554,-10,225,1001,40
66007101925,66007101926,1,369,1202,40
66008090139,66008090141,2,1596,1145,40
66008781385,66008781381,-4,1152,5112,40
66013433622,66013433618,-4,874,2521,40
66014076077,66014076082,5,71,634,40
66016168262,66016168255,-7,999,3547,40
66026214337,66026214331,-6,1045,4977,40
66026672804,66026672798,-6,238,1054,40
66028673502,66028673496,-6,1292,5039,40
66034503691,66034503683,-8,2106,6952,40
66034781357,66034781362,5,2863,1422,40
66035723470,66035723465,-5,1359,4656,40
66038097122,66038097117,-5,801,2588,40
66038145909,66038145931,22,305,1364,40
66042459643,66042459638,-5,1037,3459,40
66046724729,66046724725,-4,1055,2983,40
66047023386,66047023380,-6,1231,3161,40
66047377311,66047377317,6,61,1149,40
66048253584,66048253603,19,934,3815,40
66050030826,66050030822,-4,781,3479,40
66051514400,66051514394,-6,1058,4308,40
66052168675,66052168669,-6,1035,3558,40
66061212302,66061212303,1,1505,1770,40
66064789534,66064789527,-7,1379,4937,40
66078064410,66078064404,-6,1094,3487,40
66091823518,66091823511,-7,800,2830,40
66092641700,66092641692,-8,921,3475,40
66093623657,66093623678,21,301,1228,40
66094814245,66094814242,-3,37,1032,40
66096965057,66096965060,3,8611,27139,40
66102015422,66102015417,-5,784,3059,40
66118804146,66118804150,4,3772,3294,40
66122997585,66122997581,-4,1241,5314,40
66123298480,66123298474,-6,928,3455,40
66125636198,66125636192,-6,1066,4679,40
66128808327,66128808322,-5,976,4108,40
66135362634,66135362626,-8,809,3407,40
66154733949,66154733945,-4,1262,3659,40
66154803476,66154803493,17,754,3676,40
66155541087,66155541078,-9,929,1861,40
66156525976,66156525994,18,84,1322,40
66158234851,66158234845,-6,767,2349,40
66164195022,66164195017,-5,1244,3025,40
66164240983,66164241003,20,1049,4418,40
66165019925,66165019921,-4,948,2593,40
66166075594,66166075589,-5,1208,4220,40
66167179424,66167179418,-6,791,3763,40
66169321579,66169321578,-1,799,1717,40
66182755812,66182755806,-6,1016,3579,40
66185436661,66185436664,3,1377,1167,40
66188696318,66188696313,-5,624,2289,40
66189751527,66189751520,-7,945,3830,40
66190490126,66190490143,17,418,3389,40
66191171024,66191171018,-6,1072,4089,40
66194606491,66194606485,-6,724,3600,40
66194639543,66194639541,-2,1375,3136,40
66204035820,66204035814,-6,865,2402,40
66204829864,66204829854,-10,880,4426,40
66210675726,66210675720,-6,709,2298,40
66216195465,66216195462,-3,1072,4339,40
66218493899,66218493895,-4,987,4729,40
66222571758,66222571753,-5,973,3251,40
66225691722,66225691726,4,1151,1219,40
66225959941,66225959941,0,1804,1513,40
66230793361,66230793357,-4,1248,4305,40
66231482983,66231482977,-6,1025,2820,40
66231579726,66231579739,13,464,2359,40
66233510973,66233510967,-6,1327,4391,40
66234572203,66234572197,-6,1012,3154,40
66234820526,66234820543,17,929,3149,40
66235720296,66235720290,-6,1276,4309,40
66248675567,66248675561,-6,977,2503,40
66249648618,66249648610,-8,811,5469,40
66249712576,66249712582,6,55,1208,40
66260194442,66260194437,-5,918,3127,40
66264077154,66264077148,-6,568,2066,40
66272217599,66272217599,0,2781,4619,40
66276945815,66276945810,-5,947,3530,40
66277727970,66277727962,-8,1168,5155,40
66277870903,66277870897,-6,1247,3895,40
66280717399,66280717394,-5,978,3934,40
66295136859,66295136853,-6,1110,4216,40
66295705872,66295705878,6,215,1952,40
66295811023,66295811007,-16,146,1512,40
66299228138,66299228134,-4,640,2014,40
66301278783,66301278778,-5,939,3317,40
66303612457,66303612436,-21,1402,291,40
66304320631,66304320626,-5,938,3248,40
66307238510,66307238504,-6,698,3217,40
66307480501,66307480521,20,1041,5414,40
66314213417,66314213410,-7,1102,4502,40
66314257453,66314257449,-4,110,1169,40
66314595840,66314595834,-6,881,4401,40
66317733714,66317733709,-5,1112,3878,40
66318441079,66318441085,6,12605,5832,40
66319422285,66319422279,-6,946,3585,40
66323082127,66323082122,-5,1141,3744,40
66323131274,66323131283,9,10245,24752,40
66331987143,66331987147,4,2404,1226,40
66333715502,66333715495,-7,1171,6333,40
66334036118,66334036113,-5,787,3356,40
66334701038,66334701052,14,764,3196,40
66337364880,66337364872,-8,847,4107,40
66337579799,66337579811,12,99,1209,40
66338479323,66338479316,-7,1132,3223,40
66339573051,66339573051,0,1197,1515,40
66342602623,66342602617,-6,341,2124,40
66351236038,66351236034,-4,980,2535,40
66359360419,66359360414,-5,669,4132,40
66359616711,66359616703,-8,1700,1411,40
66359901709,66359901689,-20,262,1929,40
66373983446,66373983441,-5,1006,3896,40
66376870345,66376870342,-3,1773,3636,40
66377125680,66377125691,11,312,1142,40
66377179623,66377179618,-5,967,3775,40
66378591982,66378591977,-5,1076,3328,40
66382426921,66382426915,-6,898,3090,40
66392299880,66392299874,-6,668,2922,40
66392557621,66392557615,-6,900,3713,40
66397481775,66397481778,3,1618,1600,40
66401060630,66401060625,-5,1180,4362,40
66411272814,66411272809,-5,1090,4013,40
66416310637,66416310631,-6,1454,4536,40
66419156805,66419156807,2,1781,2151,40
66419949114,66419949109,-5,648,2782,40
66422376211,66422376204,-7,1162,1488,40
66423702377,66423702376,-1,905,1518,40
66424543814,66424543830,16,586,1162,40
66425281318,66425281311,-7,1121,4426,40
66428828661,66428828654,-7,792,4555,40
66438977646,66438977644,-2,906,1440,40
66444240687,66444240682,-5,25921,18370,40
66448176785,66448176779,-6,1700,5264,40
66448796874,66448796870,-4,935,3341,40
66449337548,66449337539,-9,877,3430,40
66455910007,66455910000,-7,1392,3848,40
66460944387,66460944381,-6,822,2790,40
66461000518,66461000520,2,198,1305,40
66461722672,66461722667,-5,665,1646,40
66466976542,66466976536,-6,903,4249,40
66470917233,66470917229,-4,1068,3778,40
66472295606,66472295602,-4,1089,3301,40
66476095790,66476095795,5,675,653,40
66479295274,66479295270,-4,1302,3925,40
66483114926,66483114922,-4,820,3061,40
66483754383,66483754378,-5,1089,3637,40
66484216754,66484216760,6,2616,1371,40
66487394116,66487394109,-7,1109,4332,40
66488402722,66488402721,-1,8343,16147,40
66490843204,66490843198,-6,592,3690,40
66498035187,66498035179,-8,623,3501,40
66498929156,66498929171,15,676,2452,40
66508912883,66508912877,-6,827,3352,40
66515511830,66515511827,-3,1149,3170,40
66515613469,66515613459,-10,16,943,40
66519654144,66519654148,4,3694,1301,40
66525881273,66525881269,-4,1331,3655,40
66527367963,66527367966,3,19770,34160,40
66528124814,66528124806,-8,920,3352,40
66528715956,66528715975,19,244,1169,40
66529860479,66529860473,-6,892,4526,40
66530162184,66530162167,-17,270,1159,40
66531237599,66531237590,-9,257,1600,40
66532956131,66532956127,-4,1459,4011,40
66540584001,66540583994,-7,1352,4646,40
66548848571,66548848589,18,350,1200,40
66552348978,66552348974,-4,1108,3963,40
66562809387,66562809379,-8,757,3224,40
66567121168,66567121162,-6,661,2800,40
66570995047,66570995051,4,1116,1406,40
66573785682,66573785677,-5,978,4158,40
66574272614,66574272633,19,728,2714,40
66577912230,66577912224,-6,1057,4168,40
66583945402,66583945398,-4,663,2798,40
66587313491,66587313485,-6,840,4378,40
66587679609,66587679608,-1,1527,2760,40
66588926331,66588926325,-6,1540,3190,40
66591684811,66591684805,-6,492,2058,40
66592340366,66592340371,5,227,1126,40
66592411573,66592411567,-6,141,490,40
66594378483,66594378478,-5,1071,3739,40
66594466487,66594466466,-21,311,964,40
66596913845,66596913826,-19,183,1104,40
66599947648,66599947644,-4,1430,4111,40
66600603855,66600603852,-3,714,2175,40
66602443237,66602443229,-8,1138,3870,40
66606481750,66606481745,-5,1072,3104,40
66615867067,66615867061,-6,968,3084,40
66615963919,66615963918,-1,1019,1861,40
66618009960,66618009953,-7,1194,4133,40
66627465632,66627465630,-2,331,582,40
66634092095,66634092089,-6,979,3086,40
66636290857,66636290850,-7,1247,4830,40
66640274657,66640274650,-7,1205,3095,40
66641727076,66641727074,-2,402,1019,40
66648112165,66648112159,-6,1155,4673,40
66648186483,66648186477,-6,681,2678,40
66662124700,66662124694,-6,1010,3414,40
66663115142,66663115138,-4,1053,2995,40
66677485906,66677485918,12,415,1012,40
66682258522,66682258517,-5,460,3444,40
66691591665,66691591665,0,1305,2444,40
66699175285,66699175306,21,660,1498,40
66705266147,66705266141,-6,1176,3309,40
66710666031,66710666026,-5,1361,3869,40
66715827075,66715827067,-8,751,3456,40
66718247506,66718247501,-5,1047,3424,40
66719465989,66719465982,-7,1008,3403,40
66720346576,66720346587,11,455,2042,40
66723205938,66723205933,-5,881,2500,40
66724242756,66724242762,6,199,734,40
66725988460,66725988454,-6,699,4400,40
66729995795,66729995790,-5,949,3386,40
66730856207,66730856204,-3,972,1953,40
66733310258,66733310253,-5,1139,2818,40
66733772153,66733772157,4,34253,23236,40
66737798478,66737798469,-9,552,2319,40
66738724998,66738725013,15,389,1887,40
66739146910,66739146905,-5,787,3125,40
66740208196,66740208189,-7,1371,3307,40
66747570951,66747570953,2,1633,1512,40
66750528443,66750528443,0,1713,1387,40
66752219511,66752219506,-5,1155,4041,40
66752246806,66752246811,5,3300,1215,40
66755458110,66755458106,-4,1019,3519,40
66755815110,66755815130,20,264,932,40
66755993062,66755993057,-5,788,3697,40
66762017320,66762017315,-5,1076,5096,40
66776067031,66776067026,-5,802,4599,40
66790035386,66790035395,9,97,1387,40
66790641859,66790641853,-6,966,3868,40
66790798932,66790798949,17,190,1517,40
66790929135,66790929127,-8,679,3153,40
66791461766,66791461782,16,419,1987,40
66793703534,66793703529,-5,1373,3593,40
66797443492,66797443485,-7,727,3989,40
66800102185,66800102180,-5,878,3288,40
66805846113,66805846116,3,4306,2658,40
66807279781,66807279776,-5,1075,4600,40
66808043676,66808043662,-14,212,1239,40
66808115512,66808115525,13,419,3498,40
66811006385,66811006381,-4,1635,5201,40
66811927270,66811927266,-4,887,3525,40
66811976879,66811976883,4,27474,15296,40
66812650340,66812650325,-15,189,851,40
66814501557,66814501574,17,310,784,40
66818842148,66818842141,-7,1118,3804,40
66820642397,66820642391,-6,1430,3127,40
66825342566,66825342561,-5,639,2714,40
66826545909,66826545914,5,3424,1239,40
66843572367,66843572361,-6,1106,3669,40
66847662430,66847662426,-4,1087,3332,40
66849273062,66849273057,-5,746,2867,40
66855392181,66855392175,-6,1239,4519,40
66856165947,66856165939,-8,522,2414,40
66856801567,66856801561,-6,1017,4584,40
66876027927,66876027929,2,1012,1141,40
66877377092,66877377085,-7,861,2770,40
66880106956,66880106958,2,1836,1841,40
66883648015,66883648009,-6,983,4092,40
66894114786,66894114781,-5,1155,2731,40
66894337969,66894337963,-6,809,3555,40
66896456206,66896456211,5,2582,1733,40
66897052495,66897052494,-1,1490,2176,40
66919256771,66919256765,-6,816,2676,40
66919400937,66919400934,-3,754,3873,40
66922069168,66922069163,-5,1202,3558,40
66922489509,66922489503,-6,951,3428,40
66926078182,66926078177,-5,780,2864,40
66926294638,66926294658,20,726,2578,40
66932073335,66932073329,-6,573,1609,40
66932689149,66932689135,-14,114,1192,40
66939674910,66939674905,-5,1444,4526,40
66940128430,66940128430,0,2839,3719,40
66943664631,66943664626,-5,1057,4068,40
66949687235,66949687229,-6,882,2548,40
66955355626,66955355619,-7,1083,4482,40
66975817397,66975817389,-8,1132,4400,40
66976939521,66976939514,-7,1293,4092,40
66978121479,66978121473,-6,1692,4183,40
66978968602,66978968596,-6,1122,6210,40
66984603646,66984603653,7,3678,1898,40
66990529754,66990529757,3,1484,1854,40
66995733507,66995733511,4,2755,741,40
67003283426,67003283421,-5,1087,3025,40
67003737299,67003737295,-4,1756,2640,40
67015962123,67015962117,-6,1264,5997,40
67017683192,67017683187,-5,1014,2994,40
67019943159,67019943155,-4,1174,3065,40
67027726967,67027726961,-6,1137,4134,40
67032270308,67032270314,6,3474,1791,40
67043362031,67043362025,-6,2183,5115,40
67045332546,67045332543,-3,978,2618,40
67047658842,67047658837,-5,935,2352,40
67049825834,67049825827,-7,1063,3181,40
67049867326,67049867306,-20,300,943,40
67051344797,67051344790,-7,723,1386,40
67052643751,67052643746,-5,1299,4767,40
67057585776,67057585771,-5,931,3702,40
67058560832,67058560825,-7,1107,6347,40
67063152277,67063152271,-6,891,2933,40
67068853755,67068853750,-5,965,2835,40
67069357632,67069357627,-5,104,1325,40
67069833024,67069833037,13,159,1011,40
67071222942,67071222937,-5,1027,3872,40
67073455129,67073455118,-11,782,3786,40
67085950398,67085950392,-6,1071,3845,40
67101009199,67101009195,-4,1138,4033,40
67104513106,67104513101,-5,941,3444,40
67105188363,67105188357,-6,1090,4252,40
67110527401,67110527395,-6,807,2451,40
67113136717,67113136713,-4,1636,3996,40
67113758109,67113758103,-6,1029,2719,40
67117525838,67117525841,3,10207,7727,40
67119873815,67119873809,-6,1067,2646,40
67122463901,67122463897,-4,1287,4568,40
67126944066,67126944063,-3,1242,2638,40
67128730154,67128730150,-4,846,2191,40
67130030766,67130030761,-5,1011,3347,40
67131727923,67131727916,-7,1017,3935,40
67134508339,67134508343,4,6449,20586,40
67140365618,67140365611,-7,793,2507,40
67145817521,67145817520,-1,32198,44932,40
67147611730,67147611729,-1,2675,15843,40
67152769318,67152769321,3,1467,551,40
67161065521,67161065517,-4,997,3118,40
67162477973,67162477981,8,5561,1700,40
67168505917,67168505910,-7,763,4401,40
67171870633,67171870627,-6,1198,4528,40
67179406455,67179406473,18,851,3115,40
67182675232,67182675229,-3,1004,1951,40
67184562574,67184562568,-6,790,2327,40
67184657953,67184657945,-8,1086,2977,40
67184828326,67184828338,12,390,1012,40
67194437285,67194437278,-7,1659,5760,40
67194990941,67194990938,-3,171,1020,40
67195163334,67195163338,4,403,648,40
67207922019,67207922012,-7,1089,3786,40
67210950472,67210950466,-6,462,3366,40
67211909583,67211909573,-10,906,2422,40
67212487140,67212487156,16,284,1008,40
67218285404,67218285397,-7,1236,4012,40
67218329303,67218329305,2,354,1288,40
67221000420,67221000413,-7,980,3079,40
67221222493,67221222491,-2,145,833,40
67225358255,67225358247,-8,1075,3685,40
67225721363,67225721357,-6,799,3783,40
67232070586,67232070584,-2,1254,2248,40
67247676862,67247676857,-5,1170,3478,40
67247892695,67247892681,-14,305,1102,40
67251892150,67251892145,-5,1119,4962,40
67252264463,67252264458,-5,931,2700,40
67254851102,67254851097,-5,1252,6205,40
67256209142,67256209136,-6,1623,3579,40
67257425463,67257425457,-6,1254,4182,40
67264526027,67264526021,-6,1331,4131,40
67283151093,67283151086,-7,1090,3400,40
67291141490,67291141494,4,3707,1663,40
67291268398,67291268393,-5,1279,3480,40
67292086599,67292086593,-6,1327,3878,40
67298191391,67298191385,-6,820,3685,40
67298371558,67298371543,-15,115,866,40
67300861446,67300861438,-8,750,2642,40
67301605275,67301605271,-4,1066,3893,40
67301634599,67301634594,-5,1174,4358,40
67303335691,67303335688,-3,757,3892,40
67304126798,67304126783,-15,201,936,40
67305819299,67305819293,-6,869,2394,40
67310236558,67310236553,-5,918,3322,40
67310867397,67310867381,-16,860,2320,40
67312346873,67312346870,-3,1022,2214,40
67312559100,67312559093,-7,1362,3612,40
67315565306,67315565300,-6,1039,3549,40
67319173039,67319173046,7,2333,912,40
67324849568,67324849561,-7,985,5423,40
67325141775,67325141770,-5,954,1934,40
67326820058,67326820053,-5,1104,2919,40
67331833367,67331833362,-5,1155,3870,40
67336173846,67336173851,5,2077,1294,40
67343555437,67343555430,-7,1040,3989,40
67346003170,67346003164,-6,898,4507,40
67346323234,67346323229,-5,342,2383,40
67346630597,67346630616,19,717,999,40
67350500158,67350500150,-8,1068,4205,40
67353611601,67353611594,-7,1306,3177,40
67356981986,67356981980,-6,1180,3229,40
67357720707,67357720700,-7,711,2517,40
67357914646,67357914638,-8,835,3248,40
67358413730,67358413724,-6,699,3070,40
67358798361,67358798354,-7,940,4651,40
67361175254,67361175248,-6,1050,3380,40
67364342220,67364342214,-6,668,4346,40
67376538098,67376538103,5,1826,1046,40
67379044436,67379044430,-6,1223,4670,40
67385579662,67385579655,-7,1412,5635,40
67388977562,67388977557,-5,1008,3674,40
67397178830,67397178825,-5,1013,4485,40
67400956494,67400956502,8,11069,19912,40
67402744909,67402744919,10,214,967,40
67405187105,67405187098,-7,1427,4705,40
67406262049,67406262055,6,3944,1215,40
67406739038,67406739031,-7,1519,3013,40
67415423750,67415423745,-5,1377,4225,40
67415449754,67415449748,-6,750,4106,40
67416266118,67416266110,-8,1342,3570,40
67417890324,67417890317,-7,800,3215,40
67419949503,67419949497,-6,636,1677,40
67421883114,67421883113,-1,1503,2775,40
67429040325,67429040320,-5,1823,4101,40
67433968925,67433968924,-1,843,2507,40
67434969134,67434969130,-4,480,1045,40
67440340574,67440340574,0,1065,1758,40
67442197993,67442197987,-6,914,2471,40
67445184719,67445184713,-6,810,3767,40
67445251283,67445251277,-6,908,3437,40
67456524034,67456524030,-4,1312,4780,40
67461949995,67461949995,0,1065,2351,40
67472015914,67472015906,-8,1009,5133,40
67472803565,67472803549,-16,1455,1762,40
67480452367,67480452360,-7,717,3011,40
67482250025,67482250021,-4,1009,3265,40
67490983809,67490983806,-3,1136,2608,40
67501593611,67501593610,-1,1097,2223,40
67501647104,67501647116,12,781,3885,40
67523424683,67523424677,-6,1124,3038,40
67523815135,67523815126,-9,131,1575,40
67534397329,67534397322,-7,1403,3933,40
67544902453,67544902462,9,219,1290,40
67545066118,67545066103,-15,208,1497,40
67550840723,67550840718,-5,1300,4022,40
67552247487,67552247488,1,861,1397,40
67558268058,67558268066,8,2509,1249,40
67560734071,67560734059,-12,13520,27072,40
67564008896,67564008888,-8,639,2459,40
67564896841,67564896835,-6,766,2778,40
67565168638,67565168657,19,908,3454,40
67565707344,67565707330,-14,230,1296,40
67583296326,67583296321,-5,1098,3510,40
67585316389,67585316386,-3,872,2083,40
67585795311,67585795331,20,183,983,40
67586683076,67586683080,4,3078,1702,40
67590773226,67590773218,-8,842,3387,40
67594748678,67594748681,3,1515,1173,40
67603115775,67603115769,-6,612,1475,40
67603677790,67603677785,-5,959,4447,40
67604156470,67604156486,16,1619,9511,40
67604858584,67604858576,-8,3467,11936,40
67610481390,67610481386,-4,1167,2796,40
67611915491,67611915485,-6,1099,2614,40
67615285111,67615285105,-6,1433,4246,40
67618981412,67618981410,-2,1084,1620,40
67619201245,67619201239,-6,1414,5474,40
67619808726,67619808721,-5,1161,4595,40
67625364922,67625364914,-8,1250,3875,40
67625630572,67625630553,-19,137,864,40
67625955607,67625955612,5,101,1115,40
67626325134,67626325135,1,1803,1569,40
67627885103,67627885111,8,228,1236,40
67629149935,67629149929,-6,720,3726,40
67631168046,67631168046,0,2859,3627,40
67632170119,67632170115,-4,815,3230,40
67635901673,67635901667,-6,821,3864,40
67641066466,67641066461,-5,784,2425,40
67642037033,67642037025,-8,708,10737,40
67644243230,67644243225,-5,813,2737,40
67644600477,67644600470,-7,943,3392,40
67646278559,67646278557,-2,1098,3074,40
67648136290,67648136283,-7,745,2039,40
67649922795,67649922789,-6,667,4026,40
67650493410,67650493411,1,1516,1428,40
67657879746,67657879739,-7,1206,4691,40
67663689297,67663689291,-6,1222,3108,40
67671496681,67671496677,-4,1600,3537,40
67671682879,67671682872,-7,1025,3477,40
67672851139,67672851132,-7,755,2529,40
67677664838,67677664838,0,1960,2513,40
67679061837,67679061833,-4,771,2156,40
67679315638,67679315643,5,294,904,40
67681494386,67681494381,-5,855,4023,40
67683079438,67683079443,5,2973,2275,40
67684035312,67684035306,-6,1571,6028,40
67687173143,67687173137,-6,1294,2988,40
67693974568,67693974560,-8,1165,4495,40
67698316079,67698316075,-4,989,2745,40
67698859935,67698859930,-5,964,3501,40
67704979194,67704979189,-5,1084,4230,40
67705161467,67705161462,-5,1088,3527,40
67712725006,67712725002,-4,1153,4089,40
67714399764,67714399757,-7,1279,4117,40
67720962454,67720962449,-5,683,2689,40
67724237777,67724237771,-6,1134,4192,40
67730148155,67730148148,-7,1048,2676,40
67735628470,67735628475,5,2399,1673,40
67737107262,67737107269,7,4803,1247,40
67746948716,67746948712,-4,1093,3332,40
67757714045,67757714038,-7,878,4543,40
67758821702,67758821696,-6,884,3232,40
67765319515,67765319508,-7,1008,4080,40
67783448604,67783448605,1,1394,1086,40
67786182838,67786182834,-4,707,2304,40
67793250850,67793250845,-5,774,3648,40
67794813838,67794813832,-6,967,3759,40
67797953676,67797953671,-5,1069,2103,40
67798986084,67798986074,-10,10,1162,40
67805348663,67805348657,-6,1057,3722,40
67808605894,67808605888,-6,829,4415,40
67812968121,67812968117,-4,676,3756,40
67828940426,67828940420,-6,1064,4275,40
67829900397,67829900418,21,545,2405,40
67836006784,67836006784,0,3036,3569,40
67839528907,67839528902,-5,1069,2403,40
67841482869,67841482862,-7,1102,2769,40
67842996314,67842996308,-6,940,4529,40
67845821224,67845821227,3,2232,1683,40
67847151014,67847151009,-5,1018,3747,40
67851419350,67851419355,5,5597,3484,40
67853181780,67853181777,-3,962,3179,40
67853750416,67853750430,14,171,1368,40
67856138350,67856138343,-7,684,3044,40
67859144454,67859144457,3,698,1322,40
67866620867,67866620861,-6,754,2116,40
67868524708,67868524689,-19,56,522,40
67869539518,67869539499,-19,187,696,40
67874443013,67874443009,-4,1597,4327,40
67881066811,67881066813,2,4640,22714,40
67885249929,67885249922,-7,1203,5437,40
67892422809,67892422804,-5,1197,3783,40
67900301831,67900301824,-7,733,3046,40
67904022094,67904022087,-7,497,1994,40
67906193326,67906193318,-8,1257,4900,40
67916240396,67916240390,-6,1313,4592,40
67916297303,67916297284,-19,844,2606,40
67923744995,67923744990,-5,969,2491,40
67927961012,67927961007,-5,1014,3334,40
67932555170,67932555165,-5,1113,3652,40
67933895493,67933895488,-5,790,3395,40
67934321421,67934321437,16,287,1661,40
67939708898,67939708893,-5,2346,9790,40
67952250932,67952250928,-4,1130,2668,40
67954571627,67954571621,-6,778,3075,40
67956771117,67956771110,-7,1169,3980,40
67957464357,67957464377,20,893,3541,40
67958768145,67958768141,-4,989,4197,40
67959933131,67959933124,-7,681,2859,40
67960052094,67960052109,15,425,4183,40
67961542062,67961542057,-5,943,3174,40
67965085607,67965085601,-6,663,2096,40
67965335661,67965335657,-4,187,1972,40
67965950670,67965950665,-5,925,4527,40
67966507444,67966507463,19,392,2755,40
67968334614,67968334610,-4,634,3865,40
67968693138,67968693139,1,1660,918,40
67971147148,67971147144,-4,920,3177,40
67971268280,67971268298,18,574,2497,40
67992113695,67992113692,-3,1052,2096,40
67995487308,67995487301,-7,1123,4758,40
68000570789,68000570784,-5,1065,3079,40
68010860217,68010860213,-4,850,2916,40
68010914909,68010914902,-7,308,1510,40
68011081162,68011081158,-4,1499,3933,40
68011307742,68011307761,19,528,2316,40
68014300138,68014300135,-3,881,2452,40
68014576636,68014576659,23,638,2921,40
68018060165,68018060159,-6,854,4133,40
68018966238,68018966239,1,101,708,40
68022099366,68022099362,-4,923,2781,40
68022187612,68022187630,18,905,3651,40
68022966517,68022966510,-7,2167,9937,40
68029505343,68029505338,-5,909,3501,40
68038875482,68038875477,-5,1193,3604,40
68042014530,68042014523,-7,1241,2649,40
68043427243,68043427239,-4,1009,1788,40
68044847710,68044847705,-5,951,5086,40
68048934251,68048934245,-6,930,2566,40
68052295915,68052295911,-4,997,3482,40
68054669920,68054669914,-6,978,4408,40
68060975257,68060975253,-4,798,3999,40
68061313344,68061313351,7,417,3170,40
68062707075,68062707081,6,2305,1142,40
68063661827,68063661824,-3,2206,4347,40
68064666251,68064666245,-6,959,3335,40
68070254431,68070254423,-8,1193,3421,40
68072968215,68072968207,-8,1277,4332,40
68075066207,68075066201,-6,903,4168,40
68078007107,68078007101,-6,1099,4088,40
68081499110,68081499102,-8,1087,4787,40
68087475152,68087475142,-10,913,3718,40
68087710855,68087710843,-12,879,3466,40
68092626618,68092626625,7,2788,1599,40
68093772147,68093772141,-6,1184,4578,40
68096782263,68096782257,-6,801,3243,40
68097067936,68097067945,9,10140,42623,40
68098044946,68098044941,-5,833,2562,40
68098102862,68098102858,-4,818,2753,40
68099490930,68099490925,-5,1352,3822,40
68104367597,68104367593,-4,919,3260,40
68104515751,68104515746,-5,273,2718,40
68106393214,68106393209,-5,1021,3153,40
68106471239,68106471225,-14,129,1949,40
68109148626,68109148618,-8,1453,5580,40
68116369250,68116369249,-1,985,1602,40
68121708896,68121708890,-6,693,3321,40
68130603885,68130603882,-3,1407,3233,40
68132530340,68132530363,23,699,3639,40
68138389665,68138389659,-6,870,2590,40
68139012967,68139012957,-10,1098,1338,40
68139136500,68139136494,-6,1075,2938,40
68147947886,68147947893,7,5248,1284,40
68157016310,68157016305,-5,977,3691,40
68161246463,68161246454,-9,881,2615,40
68161605799,68161605802,3,2556,1634,40
68163094076,68163094073,-3,726,2842,40
68169576663,68169576658,-5,800,3907,40
68171229897,68171229892,-5,1324,3127,40
68178588033,68178588029,-4,723,2965,40
68188401759,68188401753,-6,1391,4719,40
68193184998,68193184993,-5,724,1884,40
68193770406,68193770407,1,33883,19444,40
68193884573,68193884566,-7,1070,3871,40
68195258241,68195258234,-7,1437,4798,40
68195608757,68195608753,-4,215,1680,40
68195731249,68195731253,4,2406,1391,40
68196612285,68196612280,-5,1133,3895,40
68196836957,68196836950,-7,1518,4986,40
68199950566,68199950579,13,13549,48341,40
68200328192,68200328184,-8,1020,4489,40
68204342703,68204342707,4,2014,1342,40
68205951143,68205951138,-5,947,2849,40
68207698041,68207698035,-6,958,3577,40
68207863517,68207863511,-6,873,3017,40
68211252263,68211252258,-5,1061,5012,40
68214665367,68214665360,-7,1453,4041,40
68219483588,68219483589,1,1705,1612,40
68231573797,68231573787,-10,21856,13725,40
68233785362,68233785358,-4,725,2059,40
68236639734,68236639728,-6,807,3362,40
68243733420,68243733425,5,1603,1453,40
68247987344,68247987341,-3,2816,9336,40
68251043246,68251043239,-7,909,3906,40
68252815478,68252815472,-6,1106,3515,40
68254564570,68254564570,0,1508,1643,40
68254727356,68254727345,-11,878,3149,40
68261296414,68261296406,-8,942,4499,40
68263954805,68263954811,6,6057,1592,40
68264935427,68264935421,-6,1076,3938,40
68265674709,68265674702,-7,1198,3513,40
68269321045,68269321042,-3,1307,1679,40
68270939235,68270939242,7,4774,2617,40
68272310818,68272310833,15,185,925,40
68275542140,68275542125,-15,181,1166,40
68278559650,68278559646,-4,1212,5185,40
68279329665,68279329660,-5,1030,2663,40
68279569062,68279569040,-22,297,1227,40
68282730963,68282730955,-8,889,4345,40
68286276230,68286276230,0,2196,2498,40
68288216130,68288216135,5,6354,2676,40
68288394735,68288394729,-6,859,3006,40
68290646618,68290646612,-6,667,2660,40
68290711487,68290711505,18,84,1155,40
68290887636,68290887652,16,236,1513,40
68293062833,68293062826,-7,930,3133,40
68297190470,68297190465,-5,1176,4215,40
68297872186,68297872194,8,2280,993,40
68303712958,68303712953,-5,892,3640,40
68304538990,68304538986,-4,1153,3848,40
68308977626,68308977626,0,2447,2602,40
68312486931,68312486926,-5,1259,4006,40
68314737106,68314737101,-5,1224,4527,40
68314842100,68314842081,-19,93,1408,40
68315913289,68315913282,-7,636,2889,40
68318303955,68318303949,-6,1174,3000,40
68319665158,68319665178,20,901,3565,40
68320924841,68320924836,-5,1025,3180,40
68321453289,68321453283,-6,1319,4885,40
68322489288,68322489283,-5,980,2832,40
68326113565,68326113564,-1,1210,1960,40
68326680306,68326680301,-5,1521,3095,40
68329002286,68329002282,-4,1279,3504,40
68330737713,68330737709,-4,872,2566,40
68331036438,68331036450,12,535,3230,40
68332512382,68332512377,-5,1035,3650,40
68352136901,68352136895,-6,1056,4483,40
68357009472,68357009466,-6,1016,4852,40
68363083814,68363083805,-9,1395,3399,40
68363668093,68363668108,15,1205,4313,40
68370418782,68370418774,-8,168,807,40
68371125753,68371125746,-7,554,1937,40
68379088441,68379088441,0,769,1526,40
68379757203,68379757191,-12,1174,386,40
68382829431,68382829426,-5,1206,2857,40
68386561229,68386561222,-7,970,2514,40
68386843363,68386843357,-6,830,2159,40
68387088902,68387088922,20,109,1202,40
68387277846,68387277830,-16,223,1022,40
68403322654,68403322649,-5,932,4021,40
68404070197,68404070189,-8,943,5571,40
68405102806,68405102798,-8,685,3568,40
68406627635,68406627630,-5,1226,4168,40
68410943619,68410943610,-9,1160,5390,40
68412334581,68412334574,-7,1851,4391,40
68413994489,68413994493,4,1003,967,40
68414365498,68414365507,9,14095,29107,40
68418534934,68418534929,-5,1056,3447,40
68418748943,68418748923,-20,39,1213,40
68420159005,68420158998,-7,1160,2945,40
68429180021,68429180014,-7,861,3532,40
68429546912,68429546926,14,429,1289,40
68430297126,68430297124,-2,1567,2824,40
68431448831,68431448822,-9,25229,15871,40
68434673613,68434673619,6,4290,1521,40
68440896507,68440896502,-5,922,2056,40
68446872353,68446872347,-6,1049,4090,40
68450768835,68450768830,-5,544,2981,40
68452023224,68452023220,-4,1067,2950,40
68452311370,68452311374,4,11943,9437,40
68456361318,68456361312,-6,959,3708,40
68460743498,68460743490,-8,1454,4511,40
68463032521,68463032515,-6,585,3351,40
68465509017,68465509011,-6,1060,5453,40
68468609261,68468609255,-6,878,3580,40
68472723770,68472723765,-5,789,3304,40
68473529737,68473529737,0,3364,4794,40
68474456745,68474456750,5,2212,1214,40
68477674769,68477674765,-4,786,2787,40
68485315335,68485315334,-1,1219,3254,40
68488809803,68488809797,-6,606,3059,40
68497174814,68497174817,3,1218,1739,40
68497266575,68497266562,-13,49092,9602,40
68500206082,68500206101,19,161,1429,40
68506142546,68506142545,-1,1272,2770,40
68506374853,68506374853,0,1357,1878,40
68506699022,68506699038,16,487,954,40
68512658974,68512658969,-5,770,3671,40
68512953954,68512953947,-7,1462,4108,40
68515411993,68515411995,2,1649,1696,40
68520079462,68520079464,2,2575,2120,40
68525390994,68525390997,3,2862,1776,40
68533278830,68533278828,-2,48769,17232,40
68535380371,68535380366,-5,1099,2814,40
68538847798,68538847793,-5,1459,5496,40
68550411427,68550411421,-6,1060,3956,40
68550970404,68550970417,13,618,2479,40
68553728314,68553728307,-7,1264,4295,40
68556878644,68556878638,-6,1063,3497,40
68564264331,68564264337,6,2663,1382,40
68572578326,68572578321,-5,1248,4508,40
68572614976,68572614970,-6,1209,4428,40
68573161577,68573161569,-8,46,1030,40
68574078445,68574078430,-15,804,4096,40
68574240949,68574240953,4,92,931,40
68574276590,68574276604,14,243,885,40
68576088427,68576088421,-6,2839,5420,40
68582685867,68582685862,-5,1496,3184,40
68586166566,68586166561,-5,926,4280,40
68591873749,68591873742,-7,699,2599,40
68597117237,68597117229,-8,1066,3233,40
68597351936,68597351945,9,446,1164,40
68598234311,68598234308,-3,1254,2721,40
68600612806,68600612801,-5,1153,4246,40
68604376807,68604376801,-6,1118,3584,40
68604423822,68604423804,-18,265,1204,40
68605930765,68605930757,-8,1277,4628,40
68606384484,68606384502,18,456,1218,40
68609725246,68609725242,-4,1231,3623,40
68610237985,68610237979,-6,1137,4277,40
68613178538,68613178534,-4,1192,3262,40
68613571245,68613571239,-6,825,2398,40
68614535888,68614535893,5,14427,9415,40
68615148987,68615148989,2,2009,1777,40
68618414686,68618414682,-4,1002,2929,40
68618926833,68618926835,2,1642,1567,40
68622117018,68622117014,-4,814,2401,40
68625534258,68625534251,-7,1194,3710,40
68630213473,68630213470,-3,1264,2481,40
68630359126,68630359127,1,3,1194,40
68633264638,68633264630,-8,659,4185,40
68633467605,68633467597,-8,158,1147,40
68636230884,68636230893,9,56,1171,40
68640046782,68640046777,-5,1057,2853,40
68642379187,68642379185,-2,1386,2669,40
68643268143,68643268139,-4,1346,2293,40
68645470460,68645470457,-3,1551,746,40
68657350714,68657350707,-7,609,4147,40
68662725550,68662725543,-7,792,3057,40
68662853831,68662853822,-9,116,1049,40
68663842488,68663842499,11,742,3489,40
68667304372,68667304364,-8,19131,15305,40
68673210268,68673210262,-6,1168,4336,40
68673422598,68673422592,-6,195,1485,40
68679469879,68679469875,-4,2311,6106,40
68679756912,68679756906,-6,1106,3651,40
68680899766,68680899785,19,1021,3188,40
68681257128,68681257121,-7,1104,3376,40
68683522311,68683522303,-8,758,4540,40
68686035483,68686035479,-4,794,1094,40
68687464469,68687464473,4,1561,884,40
68693945162,68693945154,-8,1210,4391,40
68695949174,68695949172,-2,1133,2883,40
68700340047,68700340042,-5,785,2290,40
68700972932,68700972925,-7,1018,2507,40
68704267662,68704267658,-4,655,3354,40
68706203899,68706203894,-5,1085,3486,40
68715047108,68715047114,6,11006,4191,40
68723215881,68723215875,-6,1149,2796,40
68727403386,68727403381,-5,1259,3022,40
68737257346,68737257341,-5,1150,4045,40
68737728975,68737728969,-6,775,3663,40
68740414266,68740414258,-8,1036,4876,40
68741009882,68741009876,-6,1191,4162,40
68741051662,68741051667,5,14,700,40
68741351661,68741351682,21,926,3565,40
68745225022,68745225034,12,15459,35532,40
68749477416,68749477430,14,233,1198,40
68756271014,68756271008,-6,624,3432,40
68758133053,68758133046,-7,1453,5104,40
68758825950,68758825948,-2,1072,1649,40
68770343639,68770343632,-7,1483,3374,40
68772001768,68772001773,5,2125,1028,40
68772872618,68772872614,-4,937,4066,40
68779269509,68779269505,-4,741,2901,40
68780840826,68780840821,-5,687,2743,40
68782502210,68782502210,0,892,1050,40
68793322191,68793322199,8,2878,1483,40
68803377835,68803377829,-6,1002,4896,40
68809646867,68809646861,-6,721,3104,40
68809962437,68809962418,-19,70,1351,40
68815169241,68815169237,-4,885,2714,40
68815473437,68815473432,-5,192,1240,40
68816758037,68816758054,17,705,2816,40
68816890932,68816890926,-6,817,3051,40
68817625199,68817625194,-5,992,3411,40
68818599406,68818599411,5,3123,1460,40
68824316527,68824316530,3,603,968,40
68824361477,68824361471,-6,197,1271,40
68826725885,68826725881,-4,934,4118,40
68827976476,68827976478,2,11057,7973,40
68829191654,68829191646,-8,1086,3924,40
68831112836,68831112837,1,2408,4012,40
68836412673,68836412670,-3,3086,3394,40
68837507183,68837507174,-9,1023,4972,40
68839019977,68839019970,-7,862,3034,40
68839083167,68839083161,-6,876,2697,40
68839584981,68839584962,-19,272,825,40
68846782121,68846782114,-7,1210,4978,40
68847690590,68847690582,-8,112,1153,40
68848492567,68848492562,-5,1211,3047,40
68853624685,68853624682,-3,2076,2416,40
68856120672,68856120667,-5,715,3102,40
68856278232,68856278250,18,286,954,40
68857293488,68857293482,-6,871,2785,40
68858464317,68858464321,4,3674,2123,40
68871759386,68871759378,-8,1125,3497,40
68871823079,68871823073,-6,838,3254,40
68871877918,68871877922,4,112,1527,40
68872030582,68872030563,-19,815,2925,40
68872923358,68872923378,20,518,1862,40
68886891874,68886891866,-8,1006,5189,40
68887317719,68887317714,-5,1135,2794,40
68887890140,68887890150,10,187,1615,40
68896555057,68896555050,-7,771,3186,40
68897317088,68897317083,-5,1013,2922,40
68899652331,68899652325,-6,1062,3413,40
68900105424,68900105430,6,33,1053,40
68900694294,68900694289,-5,999,4708,40
68903356685,68903356678,-7,1597,8505,40
68903435960,68903435978,18,699,2934,40
68904261494,68904261491,-3,1466,2537,40
68915843283,68915843280,-3,760,1989,40
68917077907,68917077902,-5,1269,3503,40
68926787580,68926787574,-6,975,4285,40
68931300059,68931300054,-5,1105,3401,40
68933904515,68933904515,0,2236,1594,40
68934307954,68934307950,-4,586,3344,40
68938542207,68938542200,-7,1188,3081,40
68938695444,68938695461,17,70,915,40
68944624319,68944624314,-5,631,2392,40
68945582807,68945582792,-15,1190,4260,40
68946431566,68946431550,-16,193,1600,40
68950286411,68950286405,-6,2581,8319,40
68961535532,68961535526,-6,803,3576,40
68965689378,68965689379,1,3150,3484,40
68971921113,68971921119,6,2861,40774,40
68973832310,68973832305,-5,786,4177,40
68974922787,68974922782,-5,952,4138,40
68977431729,68977431724,-5,1094,3565,40
68978049009,68978049002,-7,969,6405,40
68978289894,68978289889,-5,866,2914,40
68979730877,68979730858,-19,172,1433,40
68980875931,68980875924,-7,868,3151,40
68983430326,68983430323,-3,2240,5409,40
68985858958,68985858950,-8,1138,4061,40
68987187675,68987187669,-6,1089,3080,40
68994617967,68994617963,-4,1145,4810,40
69001362140,69001362133,-7,1225,3627,40
69002480767,69002480762,-5,830,3106,40
69005280864,69005280871,7,2224,1695,40
69010575230,69010575225,-5,1248,4914,40
69014467782,69014467788,6,3341,1595,40
69015828697,69015828700,3,1637,1608,40
69016608290,69016608284,-6,1250,5428,40
69026755276,69026755270,-6,811,4028,40
69053677383,69053677378,-5,912,2967,40
69054635271,69054635265,-6,663,2765,40
69057010381,69057010377,-4,1153,4831,40
69057919927,69057919941,14,581,3263,40
69058469254,69058469249,-5,1360,5048,40
69061975643,69061975638,-5,1220,3453,40
69062763623,69062763626,3,2826,2248,40
69063987046,69063987057,11,171,1064,40
69073611259,69073611254,-5,837,3343,40
69074223289,69074223282,-7,1002,4321,40
69074882445,69074882462,17,302,1634,40
69078626029,69078626022,-7,1098,4187,40
69079986181,69079986176,-5,848,2641,40
69081188598,69081188603,5,2224,1743,40
69084439475,69084439469,-6,1504,3959,40
69088967678,69088967673,-5,1019,3123,40
69089963081,69089963075,-6,1089,3924,40
69090334334,69090334350,16,270,1270,40
69093516261,69093516255,-6,1003,3537,40
69099276569,69099276569,0,2286,3098,40
69099962077,69099962095,18,687,2765,40
69106481059,69106481053,-6,944,4079,40
69108149375,69108149371,-4,961,4441,40
69109365317,69109365312,-5,1093,3258,40
69109463216,69109463226,10,29,837,40
69110548494,69110548490,-4,1138,3547,40
69117997974,69117997975,1,19258,5338,40
69122667003,69122666998,-5,1093,3618,40
69123181100,69123181100,0,335,990,40
69123736389,69123736388,-1,1661,3014,40
69126937564,69126937567,3,2387,1340,40
69129252358,69129252353,-5,1121,3862,40
69134346925,69134346930,5,23528,18034,40
69138405752,69138405745,-7,1163,4137,40
69141510109,69141510105,-4,969,2582,40
69145043330,69145043339,9,11560,31854,40
69163410613,69163410611,-2,943,1099,40
69163941984,69163941977,-7,928,2937,40
69169910294,69169910289,-5,1196,3036,40
69189199223,69189199217,-6,858,3698,40
69189224639,69189224636,-3,102,1466,40
69195740385,69195740390,5,3093,1175,40
69196266127,69196266120,-7,637,4322,40
69204861186,69204861186,0,1234,1831,40
69218271473,69218271466,-7,31958,12785,40
69219791420,69219791406,-14,129,954,40
69220173064,69220173061,-3,1099,2591,40
69231562937,69231562934,-3,1012,3287,40
69237246763,69237246757,-6,1333,4217,40
69241073500,69241073523,23,1208,2603,40
69242084141,69242084134,-7,531,3355,40
69244924718,69244924714,-4,1205,3240,40
69245056838,69245056832,-6,916,2361,40
69248276071,69248276064,-7,978,2706,40
69248414044,69248414034,-10,184,1015,40
69248652056,69248652065,9,209,1235,40
69249677741,69249677734,-7,978,4373,40
69250267463,69250267457,-6,1063,4065,40
69251454919,69251454910,-9,998,3937,40
69255174155,69255174159,4,1114,930,40
69258249373,69258249367,-6,854,3518,40
69261140768,69261140771,3,1885,1702,40
69266543102,69266543094,-8,769,4800,40
69271237118,69271237113,-5,1126,3183,40
69272894398,69272894393,-5,883,3143,40
69274892099,69274892102,3,1252,1208,40
69275623961,69275623956,-5,1379,3431,40
69276875141,69276875157,16,321,989,40
69280090692,69280090688,-4,1084,2987,40
69282713225,69282713226,1,1321,1287,40
69290091663,69290091677,14,808,1382,40
69291379414,69291379411,-3,20267,2242,40
69292861311,69292861306,-5,946,2159,40
69295397643,69295397636,-7,924,4230,40
69304326901,69304326896,-5,772,3269,40
69309391846,69309391841,-5,1147,2895,40
69320311805,69320311798,-7,1311,3358,40
69322233082,69322233074,-8,1039,4558,40
69322418494,69322418491,-3,1056,2021,40
69322612484,69322612469,-15,229,789,40
69323584078,69323584075,-3,59,1319,40
69324365421,69324365438,17,271,886,40
69324701448,69324701444,-4,370,1233,40
69330635234,69330635230,-4,822,2743,40
69331839947,69331839941,-6,685,2526,40
69332127583,69332127586,3,101,842,40
69334789134,69334789130,-4,951,3365,40
69335313622,69335313615,-7,1156,3844,40
69340469375,69340469369,-6,687,3501,40
69343615296,69343615290,-6,1035,3966,40
69343856708,69343856710,2,177,1029,40
69345638534,69345638529,-5,1029,2699,40
69351182878,69351182872,-6,1222,4450,40
69351642130,69351642126,-4,1326,2599,40
69352550668,69352550662,-6,973,3279,40
69354106622,69354106617,-5,667,2379,40
69354282290,69354282284,-6,1138,3675,40
69357254753,69357254747,-6,1211,4064,40
69358738199,69358738193,-6,1118,3785,40
69359417565,69359417567,2,51,1118,40
69369369151,69369369142,-9,856,3675,40
69372785343,69372785337,-6,891,3445,40
69372861538,69372861531,-7,2233,5370,40
69373862547,69373862542,-5,971,4534,40
69374133430,69374133411,-19,554,2144,40
69375995046,69375995042,-4,1016,3921,40
69377477549,69377477542,-7,920,5238,40
69384909414,69384909413,-1,1285,2039,40
69386289158,69386289151,-7,1072,3427,40
69386756209,69386756212,3,2125,1793,40
69399870250,69399870254,4,2881,2309,40
69400575582,69400575578,-4,798,2969,40
69401873399,69401873393,-6,893,3435,40
69404989579,69404989573,-6,1016,4947,40
69405861902,69405861905,3,32,1106,40
69411257580,69411257586,6,48170,42881,40
69413439173,69413439166,-7,1421,4045,40
69416492354,69416492365,11,246,1193,40
69419420987,69419420981,-6,1086,5113,40
69428717518,69428717512,-6,1307,2650,40
69430189366,69430189365,-1,1479,2491,40
69431575720,69431575714,-6,999,4197,40
69431694446,69431694445,-1,80,1176,40
69443592726,69443592718,-8,1242,3216,40
69449639521,69449639522,1,2266,2381,40
69453095795,69453095789,-6,962,3520,40
69460130861,69460130854,-7,967,2807,40
69461473911,69461473905,-6,1253,3905,40
69465167099,69465167098,-1,629,1688,40
69468670099,69468670093,-6,452,1706,40
69469211518,69469211510,-8,884,2755,40
69469843670,69469843669,-1,878,1203,40
69478487247,69478487241,-6,826,3829,40
69479434142,69479434136,-6,676,3394,40
69485317378,69485317373,-5,980,3923,40
69486966267,69486966261,-6,1084,3475,40
69492829218,69492829213,-5,1049,3915,40
69493025082,69493025074,-8,946,3634,40
69493290544,69493290537,-7,1302,4412,40
69494953640,69494953635,-5,896,1339,40
69503894497,69503894490,-7,637,2448,40
69513499007,69513499002,-5,1254,3620,40
69514197600,69514197594,-6,1023,4293,40
69517488102,69517488100,-2,839,1995,40
69524815946,69524815950,4,3289,2657,40
69530550649,69530550644,-5,1265,4062,40
69538006821,69538006827,6,10966,31320,40
69543898038,69543898033,-5,1120,4709,40
69544520182,69544520161,-21,2016,1160,40
69557116593,69557116589,-4,956,3417,40
69560418389,69560418382,-7,1004,2667,40
69561914495,69561914489,-6,1094,3967,40
69572727962,69572727971,9,2234,606,40
69573017545,69573017538,-7,839,5100,40
69580117195,69580117190,-5,831,2597,40
69583441625,69583441626,1,1502,1570,40
69584257655,69584257650,-5,905,3810,40
69584609831,69584609826,-5,276,1692,40
69587919874,69587919858,-16,1914,1022,40
69589732351,69589732344,-7,896,4247,40
69589977029,69589977011,-18,94,958,40
69592496362,69592496354,-8,741,4686,40
69592530800,69592530807,7,331,1117,40
69593518392,69593518385,-7,1172,4299,40
69597646634,69597646628,-6,834,2149,40
69598339274,69598339269,-5,1014,3320,40
69598413981,69598413973,-8,180,964,40
69604705811,69604705803,-8,672,3499,40
69604739047,69604739051,4,1879,915,40
69611808072,69611808066,-6,1175,4805,40
69618301826,69618301827,1,194,1270,40
69618935855,69618935866,11,127,1260,40
69619994481,69619994477,-4,369,1142,40
69642291903,69642291898,-5,1473,3789,40
69646256128,69646256124,-4,1265,2551,40
69650240750,69650240749,-1,446,1929,40
69652353986,69652353993,7,2274,1384,40
69653558438,69653558443,5,2980,1885,40
69655287531,69655287526,-5,1154,3948,40
69655520205,69655520206,1,1790,2117,40
69662854159,69662854153,-6,965,4001,40
69663245298,69663245292,-6,1287,4270,40
69666478932,69666478927,-5,1042,3930,40
69675962254,69675962246,-8,1035,3412,40
69681548573,69681548567,-6,1024,2207,40
69684357386,69684357379,-7,1447,3801,40
69709669625,69709669620,-5,1299,3420,40
69711219055,69711219050,-5,1197,4184,40
69720702431,69720702424,-7,1062,4839,40
69722838999,69722838994,-5,1138,2918,40
69724722942,69724722939,-3,1066,2782,40
69725163172,69725163180,8,206,1267,40
69725812287,69725812269,-18,237,1310,40
69731164191,69731164186,-5,1601,3959,40
69732115059,69732115054,-5,932,3659,40
69737994151,69737994145,-6,756,2918,40
69739155738,69739155734,-4,1185,3055,40
69750824157,69750824151,-6,1004,4815,40
69754844021,69754844027,6,2210,1065,40
69759392610,69759392603,-7,1171,4021,40
69760920429,69760920423,-6,967,3807,40
69770462050,69770462045,-5,1079,2862,40
69774877653,69774877646,-7,830,3797,40
69785462437,69785462434,-3,1511,2964,40
69789264520,69789264513,-7,874,2818,40
69789921001,69789921004,3,3599,2495,40
69790629257,69790629259,2,114,917,40
69791780838,69791780843,5,1050,920,40
69809267282,69809267277,-5,791,2237,40
69813673591,69813673587,-4,930,3692,40
69814340415,69814340406,-9,1119,3978,40
69816194189,69816194184,-5,963,3179,40
69818674041,69818674037,-4,995,3668,40
69831370877,69831370871,-6,907,3721,40
69831668789,69831668802,13,185,1127,40
69831835286,69831835266,-20,423,3451,40
69832206398,69832206412,14,274,1297,40
69836415502,69836415497,-5,914,3616,40
69843218075,69843218068,-7,1498,3192,40
69844406180,69844406186,6,2833,1369,40
69847920735,69847920729,-6,604,2727,40
69852009905,69852009898,-7,858,3575,40
69863496814,69863496810,-4,1023,1774,40
69881903709,69881903702,-7,766,2617,40
69884629692,69884629695,3,4080,2591,40
69897574134,69897574126,-8,780,3246,40
69897834942,69897834935,-7,130,545,40
69903821621,69903821614,-7,847,3093,40
69906982286,69906982283,-3,1089,2272,40
69910827276,69910827274,-2,1356,2516,40
69912328425,69912328420,-5,957,3511,40
69917995393,69917995393,0,1369,2178,40
69921928249,69921928245,-4,907,3773,40
69922017838,69922017857,19,987,3284,40
69925886246,69925886242,-4,834,3105,40
69928204819,69928204813,-6,816,3262,40
69931585266,69931585261,-5,1015,4333,40
69931898438,69931898451,13,490,1684,40
69938771761,69938771762,1,1240,1359,40
69940907606,69940907602,-4,1027,3038,40
69944125229,69944125234,5,5313,1952,40
69945663103,69945663097,-6,971,4024,40
69947499703,69947499697,-6,1137,4011,40
69950236711,69950236709,-2,654,1322,40
69951122047,69951122061,14,794,1581,40
69952901561,69952901576,15,988,239,40
69953130811,69953130803,-8,1257,3775,40
69961288383,69961288377,-6,1121,3586,40
69965556660,69965556654,-6,1088,3534,40
69967539659,69967539653,-6,1337,3161,40
69980910542,69980910536,-6,1091,2907,40
69981956402,69981956389,-13,981,3259,40
69991539718,69991539700,-18,328,1937,40
70001006508,70001006510,2,1430,1799,40
70002483111,70002483094,-17,785,2760,40
70002517936,70002517955,19,599,3576,40
70002607897,70002607899,2,1105,2364,40
70002912812,70002912806,-6,1411,2377,40
70003688756,70003688750,-6,104,1019,40
70006865026,70006865021,-5,877,2494,40
70006961879,70006961878,-1,1476,2596,40
70008295522,70008295518,-4,1115,3058,40
70014035737,70014035747,10,417,1060,40
70016470437,70016470433,-4,1113,2130,40
70016604346,70016604341,-5,1308,2988,40
70021367936,70021367932,-4,1160,4082,40
70022106938,70022106930,-8,832,4576,40
70035191083,70035191077,-6,879,2477,40
70035332701,70035332717,16,654,4754,40
70040045701,70040045697,-4,944,2592,40
70040910160,70040910174,14,674,3285,40
70042062729,70042062723,-6,1473,3528,40
70043523535,70043523529,-6,759,3162,40
70044816515,70044816514,-1,554,1094,40
70058527638,70058527633,-5,775,5241,40
70063605159,70063605154,-5,1066,3264,40
70073929071,70073929070,-1,1502,3162,40
70074320279,70074320273,-6,793,3567,40
70076662359,70076662354,-5,1197,3978,40
70077485467,70077485462,-5,851,2340,40
70078270402,70078270396,-6,819,3567,40
70082913179,70082913174,-5,1019,4223,40
70091066003,70091065986,-17,1350,3414,40
70098465874,70098465880,6,2665,1502,40
70101747638,70101747631,-7,668,3128,40
70109101810,70109101815,5,1334,888,40
70111319307,70111319303,-4,944,3235,40
70114879884,70114879866,-18,815,2110,40
70123178807,70123178813,6,2407,1207,40
70124125474,70124125469,-5,973,3269,40
70124205895,70124205884,-11,1116,3825,40
70124972143,70124972133,-10,1072,3071,40
70126701256,70126701249,-7,607,3237,40
70127447534,70127447550,16,207,1574,40
70129392984,70129392982,-2,3295,3626,40
70129731551,70129731545,-6,1192,4304,40
70130298455,70130298439,-16,269,989,40
70134289355,70134289349,-6,849,2943,40
70134655750,70134655743,-7,907,3458,40
70136664295,70136664289,-6,1238,5576,40
70147328767,70147328761,-6,894,4489,40
70147392054,70147392038,-16,223,817,40
70153387491,70153387486,-5,1018,3438,40
70163245905,70163245900,-5,1172,3458,40
70167032093,70167032089,-4,1075,2098,40
70169032500,70169032493,-7,1163,3150,40
70169595634,70169595628,-6,1009,3098,40
70175267506,70175267500,-6,1058,3570,40
70199717491,70199717485,-6,1313,4232,40
70202908389,70202908382,-7,1426,3683,40
70204130158,70204130150,-8,218,1732,40
70204176081,70204176075,-6,1558,4193,40
70205174638,70205174634,-4,791,3711,40
70207183566,70207183559,-7,864,3800,40
70207737318,70207737314,-4,974,2188,40
70210861263,70210861258,-5,1059,3218,40
70215959258,70215959255,-3,925,3918,40
70216145279,70216145277,-2,218,1307,40
70219229898,70219229892,-6,437,2621,40
70219825921,70219825915,-6,1037,2844,40
70222525379,70222525373,-6,791,2286,40
70223445253,70223445246,-7,723,3051,40
70227668489,70227668486,-3,7875,16852,40
70228706735,70228706729,-6,823,2481,40
70229716651,70229716647,-4,2586,8243,40
70230850973,70230850981,8,2749,1737,40
70245314945,70245314948,3,1321,1063,40
70251196028,70251196023,-5,1022,2755,40
70254646402,70254646395,-7,711,3721,40
70259141850,70259141845,-5,773,3652,40
70265293997,70265293993,-4,753,2924,40
70265591960,70265591973,13,611,3827,40
70268998330,70268998325,-5,1150,4097,40
70278195577,70278195572,-5,869,2912,40
70284557310,70284557306,-4,5581,12403,40
70288340677,70288340670,-7,1076,3455,40
70289830048,70289830043,-5,1740,2032,40
70291218516,70291218539,23,579,1651,40
70300168182,70300168190,8,3765,1350,40
70302430826,70302430820,-6,1320,2259,40
70305164266,70305164258,-8,970,5074,40
70308824842,70308824844,2,2307,1517,40
70316407161,70316407155,-6,1145,3754,40
70316595965,70316595986,21,194,1314,40
70320911273,70320911266,-7,1163,3050,40
70321053952,70321053970,18,295,933,40
70332754253,70332754249,-4,790,3940,40
70339293945,70339293939,-6,948,3849,40
70344492095,70344492096,1,6762,18782,40
70350147355,70350147347,-8,1116,2653,40
70358012647,70358012641,-6,1163,3352,40
70359257586,70359257582,-4,1028,3247,40
70359570278,70359570293,15,945,3591,40
70375212085,70375212081,-4,1125,3993,40
70387942031,70387942025,-6,774,3274,40
70393339189,70393339183,-6,1009,2879,40
70393566832,70393566845,13,453,4302,40
70394836251,70394836246,-5,898,2123,40
70401879843,70401879838,-5,1146,3756,40
70402279220,70402279238,18,281,958,40
70408089210,70408089205,-5,795,3746,40
70408564078,70408564077,-1,967,1862,40
70413950936,70413950930,-6,1283,4336,40
70418896393,70418896386,-7,1150,4153,40
70431209614,70431209608,-6,1325,5374,40
70433233886,70433233886,0,1108,1717,40
70436804858,70436804858,0,920,1472,40
70436987180,70436987174,-6,130,948,40
70437819333,70437819333,0,181,804,40
70438809577,70438809571,-6,851,3390,40
70438888220,70438888201,-19,214,1044,40
70439334140,70439334159,19,1152,4090,40
70441390679,70441390674,-5,709,3240,40
70444384642,70444384638,-4,1305,3590,40
70448315347,70448315342,-5,1055,2830,40
70448384495,70448384490,-5,947,2067,40
70453043965,70453043965,0,1334,2054,40
70458389897,70458389893,-4,1943,3366,40
70469507900,70469507894,-6,1066,2396,40
70469536392,70469536407,15,127,1155,40
70470010981,70470011001,20,1192,4557,40
70471156850,70471156845,-5,1041,3185,40
70473017074,70473017069,-5,1251,4189,40
70473096629,70473096628,-1,97,957,40
70477433291,70477433286,-5,848,2899,40
70478052006,70478052003,-3,49069,23914,40
70478228029,70478228025,-4,835,3297,40
70478482570,70478482564,-6,953,4135,40
70480145793,70480145789,-4,1042,4092,40
70480732950,70480732962,12,237,1119,40
70481833697,70481833692,-5,1548,4842,40
70481999798,70481999813,15,234,1879,40
70492009885,70492009881,-4,1059,3179,40
70501772780,70501772773,-7,1216,4078,40
70521132973,70521132965,-8,911,3928,40
70535017135,70535017140,5,20668,57906,40
70539032372,70539032364,-8,821,4161,40
70540235194,70540235186,-8,866,3258,40
70545396991,70545396985,-6,900,2230,40
70555507034,70555507033,-1,1839,1796,40
70558368385,70558368380,-5,1052,2704,40
70565108237,70565108239,2,2625,2627,40
70568311434,70568311429,-5,972,3830,40
70592125437,70592125432,-5,1146,3108,40
70597947517,70597947512,-5,839,3617,40
70602738871,70602738867,-4,992,3360,40
70603907575,70603907569,-6,1394,5183,40
70606025458,70606025451,-7,1034,4017,40
70608131615,70608131610,-5,852,1937,40
70609241686,70609241701,15,780,2357,40
70616916493,70616916493,0,2390,2967,40
70622842161,70622842155,-6,705,3105,40
70623353970,70623353970,0,122,776,40
70625802769,70625802770,1,989,1225,40
70631923978,70631923977,-1,1394,2758,40
70632303724,70632303714,-10,257,1015,40
70633138461,70633138465,4,2897,1609,40
70634243134,70634243129,-5,1031,3501,40
70635709492,70635709487,-5,1058,4532,40
70636519095,70636519089,-6,697,2261,40
70637674451,70637674445,-6,974,4852,40
70640774397,70640774410,13,15640,9802,40
70642235440,70642235434,-6,1269,3521,40
70642303812,70642303803,-9,167,1017,40
70652843947,70652843941,-6,1157,3343,40
70654203614,70654203627,13,251,834,40
70654701323,70654701317,-6,792,3433,40
70656153231,70656153225,-6,1065,4877,40
70657658653,70657658656,3,888,1025,40
70659547647,70659547641,-6,1022,3919,40
70660630455,70660630467,12,45,483,40
70666095201,70666095207,6,1344,1038,40
70669048538,70669048532,-6,826,3895,40
70670595337,70670595330,-7,704,2943,40
70670691234,70670691214,-20,1593,497,40
70677478673,70677478670,-3,1166,2136,40
70677689810,70677689805,-5,886,3065,40
70683858434,70683858429,-5,1073,3100,40
70684264581,70684264566,-15,169,1075,40
70685434743,70685434736,-7,1076,3379,40
70687161129,70687161112,-17,2259,1133,40
70689785313,70689785309,-4,716,3129,40
70689944034,70689944033,-1,861,2040,40
70690599351,70690599330,-21,282,1381,40
70691054943,70691054929,-14,216,792,40
70693895130,70693895125,-5,952,1834,40
70695838144,70695838157,13,649,1799,40
70700174485,70700174473,-12,1011,3473,40
70706630450,70706630445,-5,1040,2837,40
70718330566,70718330556,-10,8591,15960,40
70718905683,70718905674,-9,1174,3849,40
70720945167,70720945156,-11,25527,20140,40
70725322375,70725322374,-1,1070,1444,40
70725463279,70725463277,-2,985,2757,40
70726044025,70726044020,-5,1198,3644,40
70728751044,70728751039,-5,1123,3572,40
70728795567,70728795569,2,327,1495,40
70729677732,70729677732,0,1577,2164,40
70731820980,70731820974,-6,1046,5017,40
70735333081,70735333078,-3,1373,3989,40
70737906251,70737906246,-5,636,2777,40
70738049549,70738049533,-16,49,1386,40
70739178797,70739178801,4,2706,1779,40
70754492773,70754492768,-5,963,3372,40
70754977414,70754977408,-6,1113,3914,40
70755023631,70755023626,-5,1129,3893,40
70759812833,70759812826,-7,1400,5804,40
70763858650,70763858647,-3,2353,6224,40
70764969945,70764969939,-6,844,4093,40
70765059680,70765059673,-7,1202,2399,40
70765337188,70765337182,-6,334,1266,40
70765854221,70765854230,9,79,1465,40
70769798582,70769798577,-5,605,1335,40
70770018085,70770018106,21,1014,2664,40
70770158949,70770158943,-6,1301,2582,40
70774031865,70774031858,-7,1188,4536,40
70781890410,70781890418,8,3624,1404,40
70782855707,70782855703,-4,887,2242,40
70796041118,70796041111,-7,1050,3316,40
70796151207,70796151216,9,260,1580,40
70803623743,70803623737,-6,900,3944,40
70807031934,70807031938,4,16139,54218,40
70815664127,70815664123,-4,1416,4248,40
70818562139,70818562134,-5,676,2021,40
70818775144,70818775137,-7,1210,3263,40
70823314089,70823314085,-4,1067,3480,40
70833057553,70833057546,-7,778,4509,40
70833654887,70833654903,16,515,1534,40
70834439962,70834439968,6,3004,1606,40
70835518443,70835518442,-1,852,1472,40
70838094039,70838094032,-7,859,3233,40
70846666613,70846666608,-5,1645,3373,40
70849482303,70849482296,-7,667,3013,40
70850721209,70850721216,7,1630,702,40
70856653446,70856653438,-8,1460,4643,40
70857230860,70857230842,-18,1123,5596,40
70868093194,70868093188,-6,1376,3917,40
70876301181,70876301176,-5,1168,2864,40
70880129234,70880129225,-9,32319,18636,40
70881909618,70881909614,-4,1455,3324,40
70882982845,70882982840,-5,863,3492,40
70885772531,70885772525,-6,826,5188,40
70887388403,70887388396,-7,826,2431,40
70887497334,70887497346,12,288,1580,40
70896263773,70896263765,-8,645,2755,40
70896758817,70896758809,-8,815,4960,40
70903276945,70903276937,-8,1089,3771,40
70904801486,70904801481,-5,911,3911,40
70907436798,70907436793,-5,970,3631,40
70911631485,70911631478,-7,1023,3544,40
70911995204,70911995225,21,505,650,40
70916569764,70916569761,-3,1120,2391,40
70918507791,70918507785,-6,908,3456,40
70919654005,70919653998,-7,199,958,40
70923711843,70923711838,-5,990,3684,40
70924812882,70924812878,-4,804,3337,40
70926500477,70926500472,-5,870,4665,40
70926868568,70926868574,6,142,1368,40
70927447154,70927447153,-1,1645,1443,40
70929985975,70929985966,-9,1049,4533,40
70930061327,70930061321,-6,771,1801,40
70933878385,70933878378,-7,781,1995,40
70939302580,70939302581,1,1200,790,40
70939820094,70939820115,21,32,945,40
70951375798,70951375792,-6,674,2848,40
70953632330,70953632325,-5,1210,4368,40
70956486014,70956486005,-9,863,10490,40
70956677635,70956677629,-6,929,3831,40
70957860200,70957860195,-5,1066,2427,40
70960971861,70960971854,-7,981,3487,40
70961237628,70961237623,-5,1023,3362,40
70971946593,70971946588,-5,852,4760,40
70972615520,70972615520,0,818,1740,40
70975630102,70975630106,4,1243,1695,40
70977141528,70977141521,-7,670,3127,40
70989297737,70989297730,-7,992,2978,40
70991983475,70991983474,-1,1255,2133,40
70995538507,70995538505,-2,965,1897,40
70998318656,70998318649,-7,1108,3557,40
70998448174,70998448168,-6,1071,5160,40
70998789873,70998789867,-6,1036,3343,40
71009102993,71009102993,0,1337,1537,40
71012757135,71012757134,-1,346,1358,40
71015847154,71015847149,-5,766,3512,40
71017072277,71017072270,-7,1465,4993,40
71018711077,71018711071,-6,1215,2340,40
71019649605,71019649601,-4,942,3062,40
71028331922,71028331914,-8,997,3992,40
71030867284,71030867278,-6,1137,4580,40
71036429069,71036429066,-3,710,2287,40
71037377564,71037377561,-3,701,2551,40
71041823603,71041823598,-5,806,4873,40
71043859446,71043859440,-6,748,3364,40
71046562675,71046562670,-5,540,2411,40
71050045981,71050045973,-8,809,3627,40
71052942894,71052942891,-3,1010,2908,40
71055513542,71055513536,-6,852,4399,40
71056000786,71056000778,-8,547,3128,40
71056153206,71056153221,15,846,1867,40
71058694505,71058694499,-6,918,2902,40
71059028366,71059028374,8,124,1007,40
71059880698,71059880693,-5,720,1948,40
71060025392,71060025383,-9,106,1041,40
71060143350,71060143365,15,1336,4944,40
71061719546,71061719541,-5,807,4242,40
71067399661,71067399655,-6,1120,3650,40
71069752055,71069752053,-2,1622,3031,40
71070586764,71070586774,10,13931,23592,40
71071966519,71071966516,-3,1080,2501,40
71072584253,71072584254,1,153,1067,40
71082743450,71082743443,-7,2057,5760,40
71090167264,71090167249,-15,2994,1260,40
71091825077,71091825071,-6,989,2983,40
71092888348,71092888362,14,671,1844,40
71093345791,71093345785,-6,823,3646,40
71093500390,71093500408,18,579,2594,40
71100317733,71100317726,-7,896,2369,40
71103353305,71103353301,-4,1065,3085,40
71112102065,71112102059,-6,916,2820,40
71112519014,71112519035,21,129,1006,40
71112721086,71112721081,-5,641,2406,40
71114952312,71114952307,-5,436,1595,40
71115001342,71115001329,-13,985,3791,40
71115226583,71115226571,-12,274,1006,40
71116110758,71116110753,-5,1035,3592,40
71117100750,71117100745,-5,954,3917,40
71120020880,71120020875,-5,671,2402,40
71122577520,71122577513,-7,1118,3241,40
71124926100,71124926098,-2,957,3268,40
71125351626,71125351622,-4,1016,3144,40
71127301026,71127301018,-8,1090,3868,40
71129747232,71129747225,-7,915,4314,40
71131901443,71131901437,-6,583,3234,40
71133344440,71133344422,-18,335,733,40
71135384519,71135384521,2,1880,2096,40
71136748431,71136748425,-6,736,3638,40
71138341450,71138341445,-5,835,2999,40
71153602323,71153602319,-4,792,3973,40
71157081088,71157081081,-7,1306,4167,40
71159095488,71159095487,-1,108,885,40
71162192922,71162192918,-4,732,2565,40
71164887363,71164887357,-6,1209,4766,40
71167003684,71167003681,-3,1571,3156,40
71168374544,71168374559,15,35,678,40
71169647698,71169647691,-7,1158,4987,40
71171105935,71171105935,0,1946,3405,40
71172006486,71172006470,-16,1661,888,40
71172479497,71172479492,-5,697,2735,40
71178319894,71178319888,-6,684,3017,40
71178907083,71178907081,-2,1103,2642,40
71186490074,71186490081,7,2696,1349,40
71190668499,71190668493,-6,902,4147,40
71190816358,71190816375,17,941,3545,40
71197924910,71197924906,-4,1009,4561,40
71209517130,71209517128,-2,1086,1677,40
71210162721,71210162726,5,2841,1625,40
71222678041,71222678062,21,84,706,40
71232212906,71232212901,-5,1604,3328,40
71235896269,71235896272,3,3623,2582,40
71248176763,71248176758,-5,722,3067,40
71252881963,71252881958,-5,779,3064,40
71261483727,71261483720,-7,984,3162,40
71274522498,71274522494,-4,869,2565,40
71279687584,71279687578,-6,938,2476,40
71280887123,71280887115,-8,1147,3603,40
71283749193,71283749186,-7,1282,4559,40
71285161422,71285161416,-6,1222,3168,40
71285266520,71285266501,-19,133,1489,40
71285505533,71285505550,17,493,2175,40
71286942055,71286942050,-5,831,2974,40
71287245343,71287245331,-12,960,2624,40
71297904450,71297904445,-5,946,4728,40
71299143091,71299143078,-13,8564,39828,40
71309713005,71309713000,-5,1085,2942,40
71311069106,71311069099,-7,790,2472,40
71317396371,71317396386,15,802,2338,40
71318336909,71318336903,-6,1167,4320,40
71318943566,71318943557,-9,802,5083,40
71320752863,71320752858,-5,646,2650,40
71322263718,71322263712,-6,876,3350,40
71324164910,71324164905,-5,896,3150,40
71325336050,71325336049,-1,794,2078,40
71330237666,71330237662,-4,913,3339,40
71331651539,71331651533,-6,1146,2834,40
71345202088,71345202093,5,32844,51435,40
71347875254,71347875249,-5,1261,2990,40
71349377778,71349377772,-6,682,2245,40
71349499231,71349499225,-6,1220,2968,40
71350861170,71350861163,-7,2363,6992,40
71351150547,71351150547,0,1666,2627,40
71352804628,71352804623,-5,1047,4089,40
71357571247,71357571242,-5,1061,3821,40
71358432711,71358432706,-5,714,3450,40
71359533352,71359533367,15,1146,3748,40
71361341929,71361341934,5,1879,1297,40
71365326970,71365326966,-4,1368,3621,40
71370535901,71370535894,-7,766,2929,40
71374035263,71374035257,-6,948,2785,40
71375257798,71375257798,0,269,951,40
71378328966,71378328961,-5,1285,5049,40
71378866107,71378866101,-6,957,2698,40
71383538942,71383538935,-7,1060,2814,40
71383932829,71383932825,-4,1774,4185,40
71400263066,71400263062,-4,1155,4952,40
71400764623,71400764618,-5,1156,4883,40
71401527810,71401527810,0,947,1596,40
71402805262,71402805255,-7,801,2522,40
71405842865,71405842860,-5,1054,2910,40
71413177246,71413177242,-4,922,3762,40
71419125721,71419125710,-11,805,2781,40
71420621807,71420621798,-9,642,3220,40
71422300962,71422300962,0,18315,7247,40
71423745240,71423745233,-7,1191,5289,40
71423810742,71423810738,-4,1832,4966,40
71429066565,71429066559,-6,599,2544,40
71441481146,71441481144,-2,1080,2292,40
71446323495,71446323487,-8,1187,3646,40
71464521233,71464521239,6,5112,2455,40
71476692170,71476692165,-5,994,4561,40
71481579330,71481579322,-8,1355,4210,40
71481743271,71481743264,-7,1042,3832,40
71483223266,71483223261,-5,1318,3327,40
71485080426,71485080427,1,1876,2818,40
71491832594,71491832589,-5,1163,3908,40
71491935101,71491935095,-6,899,3131,40
71492097989,71492097979,-10,204,960,40
71492340750,71492340757,7,115,1524,40
71492373900,71492373918,18,931,2973,40
71492629357,71492629351,-6,1126,3643,40
71496728047,71496728043,-4,1758,3918,40
71497869056,71497869049,-7,1159,3857,40
71510783898,71510783893,-5,835,2845,40
71514390099,71514390093,-6,1102,4603,40
71518175318,71518175314,-4,1197,2223,40
71520437956,71520437951,-5,1014,2503,40
71521736702,71521736694,-8,1178,5420,40
71525554558,71525554555,-3,1142,2538,40
71527078783,71527078793,10,13669,29934,40
71530550179,71530550178,-1,640,1532,40
71531015581,71531015576,-5,709,3057,40
71533023582,71533023576,-6,722,2529,40
71538005925,71538005914,-11,856,2762,40
71545505185,71545505178,-7,788,3836,40
71545980946,71545980941,-5,942,2939,40
71546061666,71546061661,-5,1230,4166,40
71546862853,71546862838,-15,147,1412,40
71547023405,71547023402,-3,2498,4746,40
71547621571,71547621565,-6,1082,5103,40
71551425292,71551425292,0,1152,1959,40
71552020228,71552020224,-4,221,785,40
71552742883,71552742877,-6,918,3130,40
71556941723,71556941721,-2,1285,2286,40
71559770587,71559770582,-5,1140,3580,40
71561455743,71561455738,-5,821,3607,40
71561576366,71561576361,-5,1279,3525,40
71562983569,71562983564,-5,1179,3114,40
71563556087,71563556095,8,377,1640,40
71566828078,71566828073,-5,653,3093,40
71567131449,71567131438,-11,15615,41766,40
71577922250,71577922245,-5,793,2276,40
71578669388,71578669391,3,302,1268,40
71587270388,71587270381,-7,767,5182,40
71589851595,71589851589,-6,992,2863,40
71600787746,71600787741,-5,1063,3721,40
71602370202,71602370197,-5,1393,4408,40
71603314525,71603314518,-7,898,4115,40
71604385150,71604385147,-3,629,1076,40
71605725003,71605724995,-8,861,4156,40
71612255634,71612255629,-5,451,3473,40
71618075582,71618075578,-4,1714,4788,40
71620445632,71620445626,-6,911,3638,40
71620510166,71620510185,19,790,3918,40
71628895611,71628895605,-6,1258,3451,40
71633897450,71633897444,-6,786,3079,40
71634408582,71634408575,-7,866,4042,40
71642986287,71642986281,-6,1040,3516,40
71645950292,71645950286,-6,1210,4035,40
71646227519,71646227523,4,261,1219,40
71651138755,71651138749,-6,995,2624,40
71661916663,71661916657,-6,875,3360,40
71677590807,71677590805,-2,635,1390,40
71678663321,71678663315,-6,888,3992,40
71689164476,71689164470,-6,528,2349,40
71689714154,71689714149,-5,944,3410,40
71695197287,71695197281,-6,1194,5803,40
71705169981,71705169974,-7,1020,3501,40
71705488678,71705488694,16,1094,4129,40
71705625875,71705625869,-6,756,3714,40
71714128231,71714128223,-8,964,6688,40
71714289967,71714289953,-14,1164,4022,40
71716902894,71716902901,7,5188,1551,40
71717600782,71717600779,-3,936,1632,40
71719599000,71719598998,-2,1266,2235,40
71724648010,71724648002,-8,1032,3220,40
71726277462,71726277454,-8,1002,3578,40
71729198842,71729198845,3,1470,940,40
71732007186,71732007183,-3,752,3432,40
71733284137,71733284130,-7,783,3600,40
71735327006,71735327001,-5,972,4017,40
71736249156,71736249141,-15,149,1599,40
71743367310,71743367304,-6,1032,3429,40
71753029298,71753029307,9,13266,24217,40
71753954241,71753954234,-7,973,4147,40
71757682271,71757682263,-8,927,3122,40
71757851199,71757851194,-5,837,3696,40
71758372937,71758372934,-3,935,2578,40
71760000177,71760000171,-6,962,4435,40
71760169902,71760169910,8,4151,1202,40
71761558954,71761558956,2,18061,14955,40
71763854843,71763854835,-8,1110,2524,40
71769001685,71769001681,-4,1180,3855,40
71769205950,71769205948,-2,115,1104,40
71770022936,71770022946,10,221,1075,40
71771260624,71771260618,-6,1257,4300,40
71773125098,71773125093,-5,1004,3757,40
71777343438,71777343430,-8,755,3798,40
71777485798,71777485791,-7,1013,3335,40
71781970710,71781970717,7,3266,1551,40
71783145339,71783145333,-6,1168,3581,40
71785421325,71785421319,-6,1214,3181,40
71785527956,71785527959,3,176,1189,40
71785951293,71785951278,-15,110,1425,40
71797500040,71797500037,-3,853,2992,40
71804395674,71804395692,18,1116,3574,40
71808362024,71808362018,-6,1157,4632,40
71814493227,71814493222,-5,974,3075,40
71818278895,71818278888,-7,672,3282,40
71826235717,71826235725,8,14982,28082,40
71826676765,71826676758,-7,1172,2779,40
71837323061,71837323057,-4,1234,5415,40
71840088834,71840088828,-6,1117,3572,40
71840281207,71840281199,-8,707,5070,40
71847711216,71847711210,-6,1218,4935,40
71856622367,71856622363,-4,953,3404,40
71856832561,71856832565,4,36861,104848,40
71857313688,71857313682,-6,1230,4153,40
71859161583,71859161586,3,2414,1320,40
71862416830,71862416823,-7,1008,2717,40
71863777512,71863777517,5,208,1182,40
71864491925,71864491943,18,211,896,40
71878804255,71878804249,-6,630,3173,40
71879461270,71879461266,-4,939,3185,40
71882582013,71882582006,-7,918,3406,40
71885583098,71885583102,4,2568,2163,40
71887120064,71887120057,-7,1107,5380,40
71887225688,71887225700,12,727,3137,40
71888254587,71888254586,-1,1001,1179,40
71894526383,71894526377,-6,849,3903,40
71903568515,71903568519,4,30395,36713,40
71904760678,71904760694,16,33,1220,40
71907475330,71907475323,-7,879,3745,40
71907760183,71907760202,19,610,4158,40
71909063739,71909063736,-3,879,2130,40
71910453452,71910453446,-6,929,2695,40
71913601346,71913601354,8,98,594,40
71915912629,71915912629,0,1135,2207,40
71921221956,71921221950,-6,1257,3965,40
71922571771,71922571765,-6,740,2894,40
71925138042,71925138041,-1,1067,1543,40
71925965677,71925965694,17,449,3259,40
71928501198,71928501193,-5,845,4230,40
71930242302,71930242299,-3,700,2655,40
71947719319,71947719314,-5,869,2884,40
71948688306,71948688302,-4,954,3424,40
71952521525,71952521519,-6,652,2840,40
71955288200,71955288196,-4,1431,2746,40
71961314323,71961314318,-5,1036,2102,40
71965373788,71965373781,-7,853,2999,40
71965630283,71965630278,-5,1002,1269,40
71966122055,71966122048,-7,1433,3943,40
71970878263,71970878250,-13,1343,320,40
71972517937,71972517932,-5,1132,2979,40
71973137745,71973137743,-2,1297,2481,40
71977379143,71977379138,-5,1280,5352,40
71977416812,71977416805,-7,829,4990,40
71978286974,71978286969,-5,1118,3170,40
71979684022,71979684027,5,3279,1288,40
71980235603,71980235598,-5,1438,3712,40
71984217954,71984217947,-7,1183,4912,40
71984340585,71984340581,-4,1129,3474,40
71988270563,71988270558,-5,636,2221,40
71988369652,71988369674,22,115,1625,40
71989024800,71989024810,10,272,1693,40
71990806992,71990807006,14,71,1404,40
72001974420,72001974427,7,262,1274,40
72010367510,72010367506,-4,1955,4907,40
72011395214,72011395207,-7,1174,3699,40
72011852123,72011852104,-19,1106,2170,40
72015776282,72015776276,-6,1289,4939,40
72029521370,72029521365,-5,987,3212,40
72029688524,72029688522,-2,105,1125,40
72035194958,72035194953,-5,795,3360,40
72037320259,72037320253,-6,1000,4813,40
72041125116,72041125109,-7,1181,4333,40
72049969189,72049969182,-7,1141,3177,40
72052824987,72052824983,-4,1047,4040,40
72055176219,72055176215,-4,971,2461,40
72055506135,72055506130,-5,1678,4443,40
72055881908,72055881902,-6,842,4505,40
72059687333,72059687327,-6,999,3169,40
72060733567,72060733559,-8,841,4342,40
72067273941,72067273934,-7,1322,5183,40
72071469382,72071469375,-7,1766,3832,40
72075775824,72075775817,-7,1122,3280,40
72078399683,72078399681,-2,1345,2951,40
72079978086,72079978085,-1,4001,21059,40
72087106988,72087106982,-6,1097,5384,40
72087401252,72087401248,-4,179,867,40
72088770190,72088770190,0,175,1477,40
72090769414,72090769408,-6,1297,2884,40
72092197869,72092197863,-6,166,807,40
72093131949,72093131942,-7,762,3311,40
72093323650,72093323647,-3,903,3080,40
72093534355,72093534350,-5,603,1703,40
72093853476,72093853497,21,118,985,40
72101476382,72101476377,-5,909,2763,40
72104447647,72104447641,-6,1908,4641,40
72108835689,72108835682,-7,1312,4795,40
72113225262,72113225255,-7,1322,4667,40
72118706690,72118706686,-4,959,2803,40
72119754176,72119754169,-7,1418,4404,40
72120714758,72120714751,-7,931,4952,40
72125523683,72125523688,5,3983,3469,40
72132725474,72132725475,1,1435,1934,40
72136636535,72136636529,-6,862,3349,40
72141013926,72141013921,-5,1006,3785,40
72145808534,72145808529,-5,471,3627,40
72157201763,72157201757,-6,1003,4637,40
72157762034,72157762029,-5,1242,4764,40
72159907939,72159907934,-5,1094,2383,40
72165171726,72165171721,-5,763,4033,40
72165223254,72165223270,16,179,903,40
72165681215,72165681218,3,1,944,40
72172803503,72172803506,3,952,1526,40
72173811010,72173811005,-5,619,4065,40
72176192395,72176192390,-5,829,3650,40
72179413587,72179413578,-9,741,3662,40
72179978232,72179978246,14,822,3444,40
72180555278,72180555274,-4,1002,3482,40
72180612424,72180612442,18,443,1524,40
72182066056,72182066050,-6,938,3467,40
72190726431,72190726425,-6,1395,4797,40
72193630802,72193630797,-5,793,3156,40
72195477660,72195477653,-7,887,2977,40
72201717731,72201717735,4,1084,1376,40
72203294739,72203294733,-6,1138,4610,40
72203939895,72203939891,-4,964,3021,40
72204123854,72204123868,14,921,3095,40
72205605504,72205605497,-7,1127,3348,40
72212077437,72212077433,-4,6347,15242,40
72213659498,72213659502,4,1652,1398,40
72221979901,72221979894,-7,895,4301,40
72222664394,72222664389,-5,1100,3774,40
72223092574,72223092587,13,192,888,40
72225732727,72225732720,-7,1707,5438,40
72228370574,72228370570,-4,725,3428,40
72229777902,72229777896,-6,1053,3702,40
72231695774,72231695791,17,865,3321,40
72236768738,72236768733,-5,768,2515,40
72237413602,72237413596,-6,1178,4906,40
72237851293,72237851288,-5,426,3595,40
72238085176,72238085193,17,477,926,40
72242297213,72242297206,-7,1079,2912,40
72244385446,72244385441,-5,1370,3381,40
72245910432,72245910430,-2,861,1695,40
72247785762,72247785782,20,409,1585,40
72249792596,72249792590,-6,878,3708,40
72250217757,72250217779,22,787,3068,40
72255713517,72255713513,-4,942,2280,40
72255781222,72255781237,15,314,1288,40
72262966904,72262966899,-5,1262,3305,40
72269515237,72269515250,13,14619,41996,40
72271159008,72271159015,7,15205,7372,40
72271245441,72271245435,-6,655,2888,40
72272007365,72272007383,18,311,1655,40
72273749068,72273749062,-6,912,2461,40
72278788725,72278788720,-5,944,4000,40
72279339502,72279339488,-14,99,565,40
72281165047,72281165041,-6,651,1844,40
72287898587,72287898591,4,1644,1193,40
72292681444,72292681440,-4,1015,1792,40
72298093290,72298093283,-7,973,4244,40
72299123032,72299123026,-6,1244,4242,40
72299269933,72299269945,12,661,3749,40
72301156217,72301156209,-8,846,4619,40
72302709381,72302709375,-6,944,3563,40
72303259578,72303259571,-7,707,2841,40
72307438011,72307438004,-7,922,5037,40
72313473257,72313473264,7,1608,853,40
72319099106,72319099109,3,15,678,40
72319714282,72319714277,-5,1131,3383,40
72323332683,72323332674,-9,1003,4251,40
72326168321,72326168326,5,2128,1504,40
72326655788,72326655781,-7,1421,3798,40
72333730735,72333730739,4,4209,3492,40
72337159677,72337159672,-5,754,3012,40
72337624982,72337624980,-2,1698,4498,40
72343984739,72343984734,-5,607,2419,40
72346718542,72346718537,-5,1123,2705,40
72348282269,72348282286,17,621,1952,40
72357649028,72357649023,-5,901,2827,40
72357811101,72357811095,-6,198,892,40
72365051875,72365051867,-8,1080,6215,40
72373530519,72373530510,-9,1171,3223,40
72376129261,72376129254,-7,215,987,40
72377409373,72377409369,-4,1420,3153,40
72377958757,72377958776,19,499,1835,40
72381120995,72381120989,-6,1007,3775,40
72382187263,72382187257,-6,663,2844,40
72383354147,72383354157,10,13223,30413,40
72384640181,72384640175,-6,1180,3240,40
72406709189,72406709185,-4,842,1727,40
72410083691,72410083686,-5,1740,7083,40
72412586866,72412586859,-7,1031,4655,40
72421051551,72421051544,-7,926,4052,40
72421341783,72421341762,-21,231,1133,40
72433468554,72433468568,14,223,888,40
72444935411,72444935405,-6,883,3507,40
72445303169,72445303165,-4,1264,2533,40
72451042439,72451042431,-8,848,5926,40
72453906905,72453906898,-7,1086,4563,40
72454340368,72454340386,18,668,2917,40
72455978395,72455978390,-5,613,2362,40
72459799510,72459799505,-5,822,3324,40
72460450799,72460450792,-7,116,1420,40
72462002898,72462002890,-8,444,1970,40
72470883691,72470883686,-5,849,3355,40
72471077917,72471077902,-15,821,3474,40
72475046129,72475046130,1,1084,1226,40
72478646398,72478646403,5,1123,1865,40
72478764983,72478764971,-12,173,1195,40
72480530515,72480530512,-3,917,2510,40
72482402460,72482402454,-6,1247,4597,40
72493363714,72493363716,2,2351,1644,40
72500065031,72500065025,-6,931,3248,40
72500645093,72500645098,5,2008,1431,40
72506747182,72506747175,-7,765,2514,40
72509978378,72509978372,-6,821,2914,40
72511606639,72511606631,-8,638,2915,40
72511633157,72511633175,18,235,1816,40
72515639367,72515639358,-9,1015,2958,40
72517030575,72517030574,-1,53,2338,40
72523006215,72523006210,-5,1080,4371,40
72523064358,72523064354,-4,1117,3295,40
72524796850,72524796842,-8,837,2247,40
72528879641,72528879658,17,15205,53839,40
72530262933,72530262927,-6,1027,4421,40
72532251624,72532251617,-7,1512,4643,40
72532516270,72532516284,14,1144,2838,40
72548562648,72548562641,-7,997,2582,40
72554547959,72554547954,-5,1251,4004,40
72560363874,72560363869,-5,916,3465,40
72570170134,72570170129,-5,1184,3142,40
72578373750,72578373756,6,5212,2257,40
72581287342,72581287346,4,2716,1577,40
72590404371,72590404365,-6,979,4240,40
72596421594,72596421589,-5,838,3020,40
72601933650,72601933636,-14,20632,16944,40
72602883946,72602883941,-5,1295,4018,40
72603881753,72603881747,-6,944,3606,40
72604404866,72604404858,-8,1256,4707,40
72609540354,72609540348,-6,1202,4807,40
72610445227,72610445220,-7,1152,4543,40
72618428276,72618428278,2,2048,2004,40
72621604490,72621604483,-7,1007,3313,40
72623600121,72623600126,5,2148,1818,40
72625766857,72625766851,-6,1306,4034,40
72630583435,72630583428,-7,1136,3658,40
72641760699,72641760694,-5,887,2441,40
72644053062,72644053069,7,3933,1055,40
72649589703,72649589694,-9,861,2361,40
72651302659,72651302653,-6,928,2697,40
72652672107,72652672100,-7,1174,3504,40
72654145002,72654144999,-3,829,2145,40
72654975470,72654975463,-7,1170,2197,40
72662334538,72662334535,-3,1718,2948,40
72662864166,72662864161,-5,755,2684,40
72669728101,72669728095,-6,1368,4713,40
72670860119,72670860112,-7,1291,2582,40
72682589038,72682589033,-5,817,3556,40
72685275378,72685275373,-5,752,3243,40
72687299653,72687299648,-5,1131,3797,40
72687607950,72687607949,-1,829,1966,40
72687676197,72687676192,-5,1029,3626,40
72689091313,72689091297,-16,138,1367,40
72695257014,72695257009,-5,1102,3899,40
72700039178,72700039174,-4,841,2302,40
72701218920,72701218913,-7,875,3077,40
72702241236,72702241230,-6,1273,2879,40
72702345421,72702345438,17,661,2506,40
72702998932,72702998951,19,20366,14799,40
72706562691,72706562684,-7,1496,7397,40
72710403178,72710403173,-5,1349,3931,40
72715797096,72715797118,22,631,3516,40
72720861425,72720861418,-7,923,3861,40
72720941753,72720941748,-5,1067,2677,40
72722164169,72722164166,-3,1632,3880,40
72724895421,72724895414,-7,545,2401,40
72736029130,72736029124,-6,1112,4379,40
72737317245,72737317239,-6,1243,4857,40
72737937281,72737937284,3,3460,3233,40
72744600693,72744600687,-6,941,4263,40
72747090331,72747090325,-6,967,3815,40
72760202501,72760202494,-7,1067,3822,40
72764795131,72764795126,-5,802,4339,40
72769911215,72769911209,-6,931,4146,40
72773110697,72773110691,-6,1609,5557,40
72774076465,72774076463,-2,1702,2062,40
72774184484,72774184479,-5,807,3926,40
72783604734,72783604726,-8,937,4359,40
72784562457,72784562462,5,1513,1342,40
72793467131,72793467126,-5,1276,4361,40
72793495087,72793495105,18,229,1019,40
72798901760,72798901753,-7,1451,4925,40
72799303411,72799303405,-6,812,3650,40
72799518900,72799518921,21,346,1231,40
72800856614,72800856606,-8,815,5228,40
72806044305,72806044310,5,3651,2146,40
72807605807,72807605801,-6,1022,4924,40
72809398447,72809398441,-6,950,3940,40
72818521892,72818521887,-5,1124,4213,40
72820789214,72820789209,-5,890,3920,40
72821028318,72821028300,-18,3225,1379,40
72821151281,72821151276,-5,446,2216,40
72824672222,72824672225,3,2116,2156,40
72828011563,72828011556,-7,1503,6268,40
72835362067,72835362061,-6,1083,4186,40
72835526475,72835526470,-5,21921,55758,40
72837645701,72837645704,3,2228,1113,40
72838108290,72838108293,3,1616,1832,40
72844408622,72844408618,-4,1344,3412,40
72854657584,72854657577,-7,840,4131,40
72857105139,72857105134,-5,1135,6864,40
72860694705,72860694710,5,3822,2448,40
72868838227,72868838222,-5,1010,3271,40
72874537530,72874537525,-5,889,2532,40
72876504538,72876504532,-6,1091,2908,40
72878404557,72878404549,-8,1208,5813,40
72878703381,72878703402,21,197,1604,40
72881282173,72881282177,4,11357,21324,40
72883028302,72883028296,-6,1656,4685,40
72888422221,72888422215,-6,930,3720,40
72901759178,72901759170,-8,748,2717,40
72904748074,72904748078,4,1943,1071,40
72906268278,72906268274,-4,845,3765,40
72907798281,72907798273,-8,2003,7851,40
72910920757,72910920750,-7,1379,5349,40
72921241013,72921241006,-7,720,3994,40
72921409085,72921409081,-4,203,1326,40
72921437911,72921437897,-14,647,2495,40
72923330839,72923330821,-18,116,955,40
72923947230,72923947230,0,2117,1965,40
72935079727,72935079719,-8,1012,2750,40
72935254324,72935254317,-7,181,1273,40
72941098934,72941098934,0,32191,37544,40
72943012684,72943012679,-5,964,3192,40
72946448361,72946448365,4,49744,29679,40
72947748482,72947748484,2,14485,17203,40
72959654131,72959654123,-8,1847,7032,40
72969633499,72969633493,-6,942,3347,40
72974752384,72974752378,-6,742,2851,40
72989199214,72989199208,-6,989,4027,40
72989387642,72989387637,-5,820,3615,40
72997121127,72997121122,-5,1354,3817,40
72999190883,72999190878,-5,818,2707,40
73000238686,73000238680,-6,845,2075,40
73002476830,73002476828,-2,1341,2987,40
73004880818,73004880813,-5,750,3831,40
73011477114,73011477106,-8,849,2714,40
73020136979,73020136978,-1,2751,2778,40
73024499454,73024499448,-6,867,4237,40
73025018838,73025018837,-1,2047,2866,40
73028421766,73028421777,11,14565,6827,40
73030785950,73030785945,-5,1032,3404,40
73033867970,73033867964,-6,1318,3104,40
73047538358,73047538351,-7,1039,3221,40
73051134824,73051134827,3,2273,1204,40
73059677078,73059677074,-4,1404,4236,40
73062075730,73062075730,0,1631,1706,40
73063491340,73063491334,-6,921,2311,40
73071743983,73071743978,-5,841,3809,40
73071811158,73071811174,16,494,3639,40
73072570386,73072570381,-5,874,3179,40
73073848118,73073848122,4,2687,2038,40
73074010306,73074010318,12,306,513,40
73075746669,73075746663,-6,936,2670,40
73076869373,73076869366,-7,1197,3754,40
73083837794,73083837795,1,1577,1395,40
73087803034,73087803034,0,908,1405,40
73090370348,73090370342,-6,509,2740,40
73103445206,73103445201,-5,1156,4043,40
73108089859,73108089858,-1,887,2093,40
73108767445,73108767458,13,249,1240,40
73110848649,73110848665,16,218,1790,40
73112956881,73112956875,-6,605,3461,40
73113344723,73113344716,-7,932,2898,40
73113976759,73113976750,-9,797,3781,40
73115423787,73115423781,-6,1263,5457,40
73128786698,73128786692,-6,1175,4644,40
73130167007,73130167002,-5,1353,5270,40
73142287737,73142287741,4,1782,877,40
73159985686,73159985680,-6,938,4575,40
73166381382,73166381374,-8,1292,4464,40
73169565114,73169565109,-5,462,2800,40
73170990791,73170990785,-6,985,3938,40
73174812356,73174812357,1,53022,49540,40
73175791728,73175791722,-6,847,3868,40
73188969058,73188969052,-6,1541,4699,40
73201300839,73201300832,-7,629,3544,40
73203107269,73203107262,-7,1162,4540,40
73203638463,73203638459,-4,81,709,40
73204527925,73204527942,17,265,1795,40
73204942877,73204942856,-21,294,1222,40
73217130735,73217130727,-8,344,935,40
73218453098,73218453094,-4,1163,3289,40
73219871349,73219871343,-6,982,3315,40
73223958022,73223958017,-5,1376,3556,40
73226031324,73226031318,-6,1150,3643,40
73227440977,73227440981,4,6022,2615,40
73232531330,73232531334,4,842,277,40
73234797179,73234797176,-3,1110,1935,40
73236594882,73236594883,1,1065,1177,40
73238499666,73238499662,-4,1043,1813,40
73239868591,73239868585,-6,849,1898,40
73241650786,73241650781,-5,993,3496,40
73244869810,73244869802,-8,837,4201,40
73245328903,73245328884,-19,814,2682,40
73250694124,73250694118,-6,840,2667,40
73252506682,73252506677,-5,857,2945,40
73255179763,73255179761,-2,1326,1945,40
73255410377,73255410370,-7,902,3447,40
73267069341,73267069335,-6,1184,3493,40
73281952036,73281952033,-3,2004,4916,40
73282587188,73282587181,-7,734,3810,40
73285439482,73285439477,-5,848,3631,40
73294887968,73294887962,-6,1180,4387,40
73304144134,73304144135,1,1268,1501,40
73306886994,73306886989,-5,976,4550,40
73310683744,73310683738,-6,1340,3649,40
73312500829,73312500834,5,2036,1939,40
73315768946,73315768948,2,1621,1540,40
73315965512,73315965523,11,69,1341,40
73319616122,73319616121,-1,648,1824,40
73320219260,73320219246,-14,956,2196,40
73324728830,73324728824,-6,753,3657,40
73327242823,73327242819,-4,1365,3833,40
73332831056,73332831050,-6,1114,3438,40
73334311350,73334311342,-8,1002,3376,40
73339045785,73339045777,-8,1465,4100,40
73339497861,73339497863,2,1834,1503,40
73340856266,73340856268,2,2128,1939,40
73344716467,73344716459,-8,1159,4026,40
73352702290,73352702286,-4,1262,2500,40
73352970581,73352970571,-10,79,1103,40
73361827609,73361827603,-6,2101,4357,40
73364889015,73364889016,1,981,1427,40
73374399763,73374399755,-8,1229,3799,40
73378812619,73378812597,-22,1531,900,40
73378954532,73378954524,-8,992,4884,40
73380096787,73380096781,-6,1419,5017,40
73382097622,73382097614,-8,1220,4947,40
73392168942,73392168936,-6,449,3170,40
73397310251,73397310246,-5,1367,3341,40
73399951413,73399951409,-4,1049,3213,40
73400723541,73400723534,-7,1078,3837,40
73408043351,73408043344,-7,1010,4274,40
73410998455,73410998449,-6,848,4395,40
73413150461,73413150455,-6,1432,4811,40
73422325863,73422325871,8,297,1575,40
73436711395,73436711402,7,7494,2347,40
73441434696,73441434690,-6,607,3788,40
73442411822,73442411817,-5,994,3978,40
73444643782,73444643775,-7,904,4022,40
73447637339,73447637333,-6,1025,3983,40
73451707078,73451707071,-7,194,439,40
73452751503,73452751483,-20,1346,3616,40
73470477038,73470477046,8,13400,6846,40
73476331023,73476331017,-6,1174,4051,40
73477452260,73477452253,-7,622,4294,40
73478024396,73478024402,6,167,874,40
73485142600,73485142594,-6,574,3463,40
73486770399,73486770405,6,89,1192,40
73492052374,73492052366,-8,1302,4554,40
73494929837,73494929835,-2,1960,2318,40
73495438847,73495438842,-5,934,3975,40
73504878055,73504878049,-6,1024,4744,40
73505075598,73505075586,-12,20,1047,40
73507248071,73507248065,-6,1268,4580,40
73509096993,73509096986,-7,1616,5082,40
73512081366,73512081375,9,6245,1822,40
73520281718,73520281714,-4,1030,3359,40
73523930049,73523930045,-4,591,3238,40
73524590311,73524590313,2,294,1390,40
73525394678,73525394670,-8,794,3981,40
73525514608,73525514618,10,395,1182,40
73540772418,73540772397,-21,3159,1010,40
73542205499,73542205493,-6,1024,2799,40
73552336842,73552336835,-7,1295,3596,40
73553189761,73553189757,-4,956,3593,40
73554349773,73554349765,-8,1018,4077,40
73558206446,73558206442,-4,533,1167,40
73560497892,73560497883,-9,968,2103,40
73571490727,73571490731,4,1750,989,40
73573941199,73573941194,-5,1182,2760,40
73576460197,73576460202,5,3023,1574,40
73576582768,73576582762,-6,956,2754,40
73588419061,73588419057,-4,1374,4471,40
73589922686,73589922678,-8,878,3957,40
73591196902,73591196921,19,136,1108,40
73591421253,73591421253,0,778,1474,40
73598727665,73598727662,-3,1005,2388,40
73599695661,73599695654,-7,1013,4007,40
73607412018,73607412013,-5,450,1969,40
73610475790,73610475790,0,1233,1372,40
73611267436,73611267429,-7,970,3267,40
73621936935,73621936938,3,2915,2233,40
73623109877,73623109873,-4,479,2967,40
73623319430,73623319434,4,4242,3165,40
73624343147,73624343141,-6,959,5032,40
73624598431,73624598443,12,62,737,40
73629890926,73629890922,-4,1252,3321,40
73633759734,73633759727,-7,799,2937,40
73636045074,73636045070,-4,1170,4011,40
73638300653,73638300646,-7,1043,5238,40
73644620423,73644620418,-5,654,2623,40
73648228058,73648228053,-5,1562,4535,40
73649081320,73649081316,-4,819,2930,40
73649931320,73649931313,-7,939,2974,40
73663483146,73663483137,-9,1457,6030,40
73664550782,73664550778,-4,1019,2896,40
73665039046,73665039041,-5,813,2615,40
73665295150,73665295128,-22,25,1705,40
73670486046,73670486040,-6,782,4096,40
73670539880,73670539895,15,17,930,40
73672169266,73672169266,0,2548,4048,40
73672225818,73672225821,3,3388,2551,40
73673568025,73673568019,-6,1082,4141,40
73675162830,73675162823,-7,929,3312,40
73681389646,73681389642,-4,897,1343,40
73684239629,73684239624,-5,1020,2417,40
73685073846,73685073840,-6,891,3699,40
73701530799,73701530793,-6,1079,3996,40
73702657645,73702657637,-8,895,3591,40
73703713854,73703713849,-5,1512,3759,40
73704255267,73704255259,-8,974,2923,40
73704285000,73704285018,18,939,4854,40
73710334895,73710334889,-6,1047,3401,40
73713418900,73713418899,-1,66,1546,40
73713776019,73713776014,-5,869,3427,40
73714545236,73714545242,6,37356,14651,40
73717008862,73717008857,-5,445,1463,40
73717177407,73717177402,-5,1142,3586,40
73723866546,73723866541,-5,946,2184,40
73723967654,73723967670,16,463,1171,40
73724795317,73724795314,-3,1204,2582,40
73728559891,73728559886,-5,1195,5017,40
73736243174,73736243169,-5,1310,3792,40
73743982330,73743982325,-5,665,2528,40
73744315718,73744315712,-6,1193,4653,40
73745373717,73745373712,-5,1004,3704,40
73749751903,73749751896,-7,704,6748,40
73750253285,73750253267,-18,25,1023,40
73752998779,73752998771,-8,1330,4775,40
73759853429,73759853409,-20,890,3748,40
73770853550,73770853542,-8,2148,10097,40
73772204663,73772204662,-1,3681,6950,40
73779115992,73779115988,-4,1052,2798,40
73780780926,73780780920,-6,991,3592,40
73785554630,73785554625,-5,943,3844,40
73786411981,73786411973,-8,839,3938,40
73786454436,73786454420,-16,788,4256,40
73793661809,73793661803,-6,902,2487,40
73794378900,73794378918,18,260,835,40
73797012062,73797012056,-6,1290,4319,40
73799134906,73799134899,-7,672,3999,40
73800503922,73800503914,-8,951,4463,40
73804507982,73804508000,18,527,2333,40
73805487538,73805487529,-9,770,4262,40
73813242805,73813242806,1,1726,1630,40
73820963951,73820963945,-6,990,3769,40
73830697328,73830697322,-6,1006,2720,40
73831010021,73831010017,-4,337,1261,40
73836195598,73836195590,-8,1256,4316,40
73839258784,73839258779,-5,968,3703,40
73839297434,73839297428,-6,648,3686,40
73844395562,73844395557,-5,1114,4305,40
73844445884,73844445905,21,394,3761,40
73847480177,73847480175,-2,1266,2640,40
73848970862,73848970854,-8,807,3086,40
73852126443,73852126438,-5,1452,4462,40
73852555710,73852555704,-6,1173,5476,40
73852776437,73852776442,5,103,885,40
73853768332,73853768338,6,123,817,40
73857458915,73857458906,-9,898,3556,40
73858736998,73858736995,-3,1102,4170,40
73859748866,73859748858,-8,1285,3530,40
73860819378,73860819381,3,17521,13165,40
73863055074,73863055068,-6,1239,3532,40
73869090803,73869090799,-4,981,3394,40
73876190574,73876190567,-7,1425,3741,40
73877701659,73877701659,0,1258,1520,40
73878532689,73878532685,-4,818,2816,40
73882143829,73882143836,7,2073,1091,40
73883464267,73883464261,-6,640,4883,40
73896636190,73896636205,15,15754,42175,40
73904364091,73904364085,-6,973,3142,40
73910669166,73910669160,-6,1449,3884,40
73919682777,73919682769,-8,1783,4346,40
73920372150,73920372145,-5,1160,2679,40
73933330587,73933330581,-6,770,3180,40
73940972859,73940972854,-5,1276,4895,40
73941064414,73941064420,6,267,1292,40
73941883849,73941883844,-5,799,2341,40
73944265597,73944265587,-10,88,1305,40
73944838667,73944838661,-6,1244,3803,40
73945031453,73945031470,17,166,1617,40
73948273907,73948273899,-8,1295,4289,40
73951892273,73951892278,5,9584,1513,40
73952405376,73952405388,12,792,2966,40
73953424404,73953424426,22,602,2538,40
73956286369,73956286363,-6,969,3153,40
73959222049,73959222046,-3,831,1818,40
73959342990,73959342986,-4,1250,2781,40
73962997266,73962997262,-4,628,2366,40
73965232241,73965232238,-3,803,3305,40
73967504026,73967504021,-5,1130,3873,40
73970980474,73970980469,-5,962,3242,40
73974548651,73974548644,-7,1214,3588,40
73976698954,73976698945,-9,1078,4481,40
73979182434,73979182428,-6,932,4478,40
73981641831,73981641814,-17,185,2883,40
73981820845,73981820861,16,886,3722,40
73983152113,73983152108,-5,725,4414,40
73995165453,73995165449,-4,904,3849,40
73999571632,73999571630,-2,1067,2409,40
74006624052,74006624045,-7,1142,4670,40
74013126692,74013126687,-5,965,3022,40
74014471965,74014471959,-6,148,1318,40
74018053266,74018053265,-1,963,1463,40
74019504175,74019504174,-1,906,1368,40
74022122728,74022122728,0,1495,1241,40
74024753259,74024753252,-7,1184,3768,40
74025676462,74025676483,21,338,1110,40
74032559298,74032559290,-8,899,3834,40
74033078860,74033078855,-5,1207,2589,40
74039628030,74039628023,-7,1440,4604,40
74040538954,74040538959,5,1967,891,40
74044819267,74044819262,-5,1096,4670,40
74044853941,74044853963,22,804,3811,40
74053601177,74053601171,-6,1154,2577,40
74054169009,74054169003,-6,973,2000,40
74054208487,74054208471,-16,268,1029,40
74056402801,74056402798,-3,988,3984,40
74060788460,74060788454,-6,1422,4361,40
74064394835,74064394830,-5,539,3063,40
74075342820,74075342814,-6,1689,4721,40
74075542191,74075542181,-10,329,1171,40
74077898773,74077898768,-5,763,4233,40
74080030538,74080030530,-8,1729,6495,40
74080251791,74080251805,14,599,3082,40
74080404672,74080404664,-8,1563,4624,40
74083282527,74083282518,-9,1344,5012,40
74083899734,74083899753,19,691,2871,40
74089824786,74089824781,-5,1080,2934,40
74092485270,74092485265,-5,941,3842,40
74096114323,74096114322,-1,840,2054,40
74101409446,74101409441,-5,916,4473,40
74104536457,74104536452,-5,920,2336,40
74105167554,74105167547,-7,1386,4821,40
74105951819,74105951814,-5,938,2477,40
74107016013,74107016007,-6,1149,4283,40
74109917385,74109917378,-7,703,2181,40
74111535074,74111535071,-3,11,960,40
74113370070,74113370076,6,4682,1671,40
74121283883,74121283877,-6,1067,4530,40
74129834346,74129834339,-7,1016,2846,40
74130139597,74130139619,22,174,1220,40
74131252890,74131252885,-5,969,5160,40
74135750187,74135750183,-4,1201,2372,40
74136534993,74136534997,4,1972,1291,40
74140552441,74140552436,-5,1253,4230,40
74140682590,74140682588,-2,93,1524,40
74141224164,74141224157,-7,1270,3560,40
74141717597,74141717601,4,4077,3467,40
74145325319,74145325318,-1,1859,2269,40
74153626265,74153626263,-2,2395,4332,40
74156020131,74156020130,-1,687,1090,40
74156170081,74156170085,4,2121,1611,40
74156661473,74156661491,18,1624,865,40
74160300119,74160300121,2,2012,2071,40
74162368163,74162368157,-6,951,4185,40
74163472578,74163472573,-5,824,3816,40
74163716150,74163716158,8,236,1008,40
74166643590,74166643585,-5,1182,3020,40
74169381406,74169381397,-9,960,6235,40
74176898019,74176898018,-1,827,1763,40
74185704122,74185704117,-5,1059,4410,40
74193321845,74193321839,-6,878,3386,40
74193912516,74193912521,5,9278,32413,40
74194060241,74194060236,-5,1056,3103,40
74196464875,74196464870,-5,863,3829,40
74201131983,74201131978,-5,1281,2764,40
74201705128,74201705135,7,142,1215,40
74203237662,74203237657,-5,1109,4039,40
74203806244,74203806242,-2,247,816,40
74205017898,74205017892,-6,1132,2821,40
74210677739,74210677731,-8,1370,4115,40
74210946634,74210946630,-4,1341,2480,40
74212668742,74212668738,-4,1135,3362,40
74213236796,74213236785,-11,100,1045,40
74220372986,74220372981,-5,875,3312,40
74221276848,74221276861,13,1121,2941,40
74230715937,74230715931,-6,1327,3301,40
74237532109,74237532102,-7,825,2953,40
74237834294,74237834281,-13,199,857,40
74239674384,74239674387,3,1809,1689,40
74243681500,74243681509,9,473,2072,40
74243749604,74243749598,-6,1049,2826,40
74244275469,74244275481,12,201,1224,40
74251095941,74251095945,4,37916,28403,40
74252634273,74252634278,5,2976,1020,40
74259769318,74259769313,-5,1013,3143,40
74260118557,74260118549,-8,1243,4556,40
74269042805,74269042810,5,1850,1146,40
74269648330,74269648325,-5,1148,3949,40
74273191875,74273191870,-5,1113,4372,40
74273346073,74273346068,-5,1557,4028,40
74274303696,74274303714,18,468,1718,40
74276288858,74276288851,-7,1141,4010,40
74278560807,74278560806,-1,1767,2662,40
74278797159,74278797154,-5,731,3076,40
74281550529,74281550525,-4,653,2925,40
74285831551,74285831546,-5,1188,2394,40
74287816141,74287816143,2,1075,1043,40
74289452485,74289452480,-5,914,3132,40
74290699062,74290699040,-22,1310,930,40
74291739989,74291740003,14,14,532,40
74295852410,74295852416,6,2528,1068,40
74297808096,74297808090,-6,957,3998,40
74299477602,74299477602,0,2586,4155,40
74305503764,74305503761,-3,310,1830,40
74313062979,74313062972,-7,1263,3952,40
74314282747,74314282741,-6,1188,3663,40
74317609804,74317609800,-4,919,3752,40
74318405347,74318405366,19,1120,888,40
74322181279,74322181274,-5,742,1832,40
74322591997,74322591999,2,1125,2166,40
74323667130,74323667122,-8,1226,4245,40
74323961054,74323961033,-21,76,1688,40
74324636917,74324636925,8,194,1221,40
74326561823,74326561822,-1,816,1315,40
74328014145,74328014145,0,3020,3704,40
74331350687,74331350680,-7,836,2554,40
74337099734,74337099722,-12,31594,13880,40
74338581069,74338581065,-4,1094,2138,40
74340321143,74340321121,-22,64,1363,40
74343603546,74343603538,-8,1227,4417,40
74348622381,74348622391,10,13720,35047,40
74350797823,74350797824,1,1498,2114,40
74356984694,74356984688,-6,1079,4641,40
74360871494,74360871502,8,2874,959,40
74365411690,74365411685,-5,1004,3571,40
74369322730,74369322726,-4,1050,3680,40
74371506833,74371506836,3,36289,98244,40
74373739045,74373739046,1,1741,2171,40
74374036889,74374036893,4,13430,10822,40
74377402890,74377402883,-7,447,1715,40
74387297311,74387297315,4,1431,1215,40
74390604795,74390604787,-8,1141,4930,40
74390735903,74390735923,20,870,2092,40
74391692973,74391692968,-5,1553,3953,40
74399316113,74399316107,-6,1257,4682,40
74418362378,74418362385,7,7566,39133,40
74418999575,74418999571,-4,822,2808,40
74430850210,74430850203,-7,1017,4916,40
74430953860,74430953854,-6,21,1132,40
74431382670,74431382666,-4,190,927,40
74433069096,74433069090,-6,1654,4228,40
74433331868,74433331886,18,867,4059,40
74433896083,74433896078,-5,1347,3082,40
74448546833,74448546837,4,1452,1487,40
74457789239,74457789234,-5,967,2100,40
74464441809,74464441802,-7,1124,3641,40
74467914850,74467914842,-8,1044,5808,40
74478047766,74478047762,-4,1314,2433,40
74480335533,74480335529,-4,929,3848,40
74485244991,74485244998,7,10882,21044,40
74486632949,74486632942,-7,1390,5487,40
74489007322,74489007314,-8,1062,4056,40
74489414343,74489414335,-8,1177,3149,40
74493649679,74493649682,3,1450,1519,40
74494742763,74494742756,-7,665,2344,40
74495097843,74495097837,-6,712,2743,40
74495365083,74495365081,-2,1665,2353,40
74512857123,74512857117,-6,1098,3788,40
74514119155,74514119156,1,33087,36810,40
74524954194,74524954174,-20,3628,1421,40
74531189577,74531189570,-7,1371,6064,40
74531544797,74531544818,21,260,1819,40
74534046740,74534046734,-6,1007,3089,40
74534099181,74534099202,21,52,1247,40
74537939554,74537939549,-5,706,1953,40
74539089750,74539089747,-3,785,2041,40
74540381388,74540381402,14,682,2800,40
74540881295,74540881287,-8,107,1215,40
74543466766,74543466758,-8,905,3002,40
74543791002,74543790996,-6,682,3639,40
74545721966,74545721961,-5,1056,3109,40
74551712089,74551712083,-6,498,1267,40
74557430692,74557430686,-6,1545,4692,40
74557909515,74557909509,-6,1053,5389,40
74564341723,74564341717,-6,775,4701,40
74564553757,74564553754,-3,147,1139,40
74568377855,74568377849,-6,990,3557,40
74575218522,74575218517,-5,1027,2973,40
74575982125,74575982122,-3,109,364,40
74580350842,74580350837,-5,835,4092,40
74590298573,74590298569,-4,952,3397,40
74590912902,74590912921,19,664,2698,40
74593944759,74593944753,-6,844,3624,40
74596666629,74596666622,-7,854,4344,40
74597870791,74597870785,-6,1048,3503,40
74605137351,74605137347,-4,1308,3192,40
74608548581,74608548577,-4,805,3168,40
74610647919,74610647913,-6,1157,3438,40
74610686103,74610686114,11,345,1958,40
74614685308,74614685298,-10,933,3795,40
74615692735,74615692729,-6,972,4569,40
74619420659,74619420653,-6,1138,4472,40
74619557959,74619557943,-16,261,819,40
74621304416,74621304410,-6,968,4498,40
74622280115,74622280109,-6,1037,4680,40
74622816041,74622816043,2,1885,1776,40
74627132315,74627132308,-7,1425,3500,40
74630972010,74630972004,-6,636,2845,40
74633902715,74633902708,-7,1476,5218,40
74640916043,74640916038,-5,1341,2649,40
74642852090,74642852081,-9,783,3805,40
74643338976,74643338975,-1,33,802,40
74645413934,74645413929,-5,1507,4025,40
74648082468,74648082462,-6,1286,3835,40
74648957138,74648957130,-8,341,1149,40
74651169249,74651169251,2,3237,3479,40
74651947907,74651947901,-6,1108,3276,40
74658123451,74658123446,-5,851,3420,40
74659112463,74659112483,20,655,4786,40
74668891846,74668891849,3,1791,1307,40
74669430918,74669430917,-1,967,1562,40
74669931669,74669931665,-4,971,3075,40
74670730094,74670730093,-1,765,2356,40
74672110555,74672110550,-5,856,4495,40
74680093675,74680093673,-2,8236,13921,40
74684095563,74684095557,-6,1019,3528,40
74684145032,74684145027,-5,532,1614,40
74695726739,74695726732,-7,788,3681,40
74710459215,74710459218,3,2048,1605,40
74710816153,74710816154,1,3327,3472,40
74712318713,74712318706,-7,935,3220,40
74714699522,74714699514,-8,1214,4467,40
74719216285,74719216280,-5,1264,3771,40
74724268713,74724268708,-5,1244,3884,40
74726530974,74726530967,-7,841,3618,40
74726753452,74726753458,6,3199,1495,40
74727019271,74727019265,-6,1090,3543,40
74732093757,74732093749,-8,670,4237,40
74732802744,74732802763,19,285,678,40
74738570538,74738570531,-7,1162,5294,40
74739327670,74739327681,11,288,1527,40
74741500221,74741500215,-6,1016,3261,40
74745647729,74745647722,-7,1290,4758,40
74747750659,74747750653,-6,312,830,40
74752487507,74752487501,-6,950,4662,40
74752642086,74752642104,18,284,1089,40
74754066437,74754066430,-7,809,3654,40
74756145588,74756145582,-6,1244,3813,40
74764588123,74764588119,-4,1038,4725,40
74766190400,74766190393,-7,917,3424,40
74769208299,74769208302,3,1704,1697,40
74772663626,74772663621,-5,1320,4387,40
74772845584,74772845577,-7,1012,4029,40
74773090887,74773090869,-18,177,799,40
74774230654,74774230648,-6,2443,9024,40
74778522629,74778522634,5,2085,1239,40
74779294347,74779294341,-6,970,4109,40
74779992240,74779992222,-18,32,926,40
74781333918,74781333923,5,2557,965,40
74789321274,74789321267,-7,660,4249,40
74789664688,74789664689,1,1611,1416,40
74792455294,74792455291,-3,58460,35748,40
74804762333,74804762328,-5,991,2317,40
74809942972,74809942966,-6,1377,4923,40
74814956050,74814956054,4,1483,1584,40
74823316339,74823316331,-8,880,2687,40
74827728906,74827728901,-5,926,3210,40
74834634371,74834634365,-6,992,3730,40
74835531848,74835531856,8,230,1250,40
74837745321,74837745314,-7,1732,5227,40
74838709607,74838709587,-20,2133,919,40
74845017322,74845017316,-6,1260,4649,40
74845093852,74845093843,-9,76,1020,40
74845583333,74845583341,8,128,1284,40
74846835790,74846835784,-6,1048,3298,40
74852678951,74852678944,-7,671,3491,40
74853445390,74853445394,4,247,1283,40
74865090749,74865090742,-7,932,4175,40
74867077310,74867077309,-1,2936,4506,40
74885508491,74885508476,-15,1672,366,40
74885964065,74885964059,-6,1055,3556,40
74886039637,74886039641,4,247,1401,40
74888774723,74888774719,-4,1359,3757,40
74891279550,74891279545,-5,2756,8881,40
74898694527,74898694520,-7,569,2736,40
74902375218,74902375213,-5,972,3582,40
74904131578,74904131573,-5,1087,5201,40
74904659044,74904659038,-6,1160,3628,40
74906692500,74906692494,-6,1296,7800,40
74919032189,74919032182,-7,1478,4794,40
74923285486,74923285482,-4,646,3210,40
74931028088,74931028082,-6,1589,5191,40
74931113792,74931113797,5,159,837,40
74936694514,74936694507,-7,939,5489,40
74938560102,74938560096,-6,987,5170,40
74940741830,74940741825,-5,1163,4299,40
74941335127,74941335121,-6,679,2744,40
74941792273,74941792267,-6,779,4011,40
74941978582,74941978603,21,222,871,40
74954924930,74954924928,-2,1087,1884,40
74956004439,74956004434,-5,1173,4804,40
74965952659,74965952654,-5,743,3721,40
74966009317,74966009335,18,610,3156,40
74968900829,74968900823,-6,955,2770,40
74970494236,74970494230,-6,1325,4476,40
74973038082,74973038081,-1,1303,2042,40
74975140875,74975140870,-5,881,2791,40
74976545710,74976545705,-5,265,1817,40
74977340610,74977340603,-7,1128,4594,40
74983061798,74983061793,-5,1298,4621,40
74985387742,74985387739,-3,1339,2339,40
74989460387,74989460381,-6,1164,2722,40
74989938388,74989938397,9,192,1087,40
75000953226,75000953217,-9,510,2375,40
75002277822,75002277814,-8,1126,3101,40
75003552730,75003552726,-4,1091,3638,40
75003966795,75003966788,-7,1229,4995,40
75027677266,75027677260,-6,953,3883,40
75027774822,75027774801,-21,846,3114,40
75036075613,75036075606,-7,1076,3842,40
75036431141,75036431135,-6,652,1950,40
75037921506,75037921507,1,1025,1479,40
75039793661,75039793655,-6,1183,3646,40
75046921452,75046921446,-6,1166,4615,40
75061425148,75061425162,14,15373,46705,40
75072115654,75072115650,-4,1257,4668,40
75074736974,75074736975,1,1563,1338,40
75076384526,75076384521,-5,996,2798,40
75080063762,75080063769,7,4923,1764,40
75086358707,75086358702,-5,695,3182,40
75095125228,75095125218,-10,674,3164,40
75098039129,75098039125,-4,887,3684,40
75098271852,75098271875,23,2977,3568,40
75101102311,75101102306,-5,1300,4965,40
75103233554,75103233548,-6,819,3533,40
75103372431,75103372425,-6,1510,5438,40
75105955690,75105955685,-5,1037,4988,40
75107406082,75107406077,-5,792,3708,40
75113675751,75113675746,-5,827,2987,40
75119114786,75119114782,-4,1327,3739,40
75119377224,75119377241,17,580,2207,40
75121112377,75121112370,-7,463,4123,40
75121355135,75121355149,14,603,2270,40
75123628045,75123628045,0,1681,2572,40
75124225433,75124225428,-5,922,2814,40
75126401373,75126401366,-7,1120,3304,40
75132727067,75132727061,-6,856,4370,40
75133925183,75133925179,-4,1227,3015,40
75136181347,75136181341,-6,940,3255,40
75139361631,75139361635,4,2299,1650,40
75146044234,75146044230,-4,1115,2982,40
75148489030,75148489025,-5,1214,3033,40
75150313415,75150313409,-6,1152,4373,40
75160036332,75160036337,5,4472,1783,40
75171651794,75171651794,0,1588,2427,40
75181652315,75181652311,-4,751,1858,40
75184393202,75184393205,3,10538,7947,40
75191180502,75191180499,-3,1153,2933,40
75191229455,75191229449,-6,812,3401,40
75193910962,75193910956,-6,777,3958,40
75199029073,75199029066,-7,1067,3537,40
75203807331,75203807327,-4,814,1668,40
75204083777,75204083774,-3,2789,4741,40
75214376173,75214376168,-5,1180,2264,40
75215327223,75215327228,5,143,1243,40
75218499346,75218499348,2,15880,15252,40
75220639626,75220639621,-5,1336,5084,40
75221597803,75221597795,-8,735,4147,40
75223929038,75223929034,-4,939,2835,40
75224282200,75224282206,6,235,760,40
75226526451,75226526447,-4,734,2019,40
75226576293,75226576301,8,73,1626,40
75237126031,75237126026,-5,984,4006,40
75237531809,75237531804,-5,613,3174,40
75247938036,75247938032,-4,977,2913,40
75255612673,75255612665,-8,1088,2929,40
75264379772,75264379772,0,2046,2914,40
75264421851,75264421845,-6,955,2617,40
75276201371,75276201366,-5,650,2231,40
75277243390,75277243393,3,1822,1294,40
75278421843,75278421837,-6,1141,3206,40
75281664331,75281664326,-5,782,3372,40
75291121395,75291121390,-5,744,2569,40
75292577733,75292577741,8,76,1132,40
75299110473,75299110467,-6,1053,3158,40
75303016097,75303016090,-7,773,3869,40
75303115191,75303115205,14,853,2831,40
75303640095,75303640091,-4,732,3726,40
75303987400,75303987406,6,129,1144,40
75306736513,75306736519,6,2859,1426,40
75307890333,75307890326,-7,773,3985,40
75311045421,75311045414,-7,805,2744,40
75313825334,75313825342,8,3607,2043,40
75318163761,75318163754,-7,764,3415,40
75318957988,75318957994,6,139,1190,40
75329212223,75329212217,-6,838,3214,40
75329584055,75329584070,15,424,1519,40
75330317599,75330317592,-7,936,2008,40
75330429032,75330429044,12,185,1084,40
75330696040,75330696058,18,454,1813,40
75339680971,75339680963,-8,1125,4122,40
75342240363,75342240366,3,1842,1315,40
75347480974,75347480969,-5,799,2535,40
75357504449,75357504456,7,4159,2115,40
75358435762,75358435757,-5,1234,3250,40
75377480827,75377480823,-4,1193,2624,40
75378958919,75378958916,-3,1175,3931,40
75379538838,75379538833,-5,994,4027,40
75380130316,75380130321,5,289,1241,40
75381049778,75381049775,-3,1724,2840,40
75385364944,75385364937,-7,903,3291,40
75395740838,75395740831,-7,1024,3252,40
75399164643,75399164641,-2,861,2028,40
75400566598,75400566614,16,397,1729,40
75401193544,75401193538,-6,1551,5718,40
75409785764,75409785760,-4,941,2692,40
75411297268,75411297262,-6,1447,4105,40
75411392489,75411392485,-4,1287,3869,40
75415484825,75415484822,-3,870,2702,40
75416077672,75416077681,9,3744,1232,40
75417997325,75417997333,8,287,1240,40
75418989130,75418989125,-5,624,3243,40
75419697734,75419697727,-7,1066,3617,40
75419755310,75419755327,17,619,2352,40
75421745126,75421745121,-5,1060,4215,40
75423870338,75423870334,-4,1062,3881,40
75438317030,75438317025,-5,1062,3965,40
75440534805,75440534798,-7,1220,5268,40
75442795262,75442795256,-6,973,3978,40
75446827735,75446827734,-1,1254,2403,40
75447912106,75447912101,-5,1378,3337,40
75450899450,75450899451,1,939,1637,40
75455487942,75455487937,-5,554,1662,40
75457147470,75457147465,-5,1079,5976,40
75459282103,75459282094,-9,1025,6558,40
75459955094,75459955089,-5,1170,3435,40
75461307425,75461307419,-6,1064,2983,40
75461791576,75461791590,14,641,3300,40
75461980919,75461980913,-6,958,3768,40
75467900434,75467900427,-7,869,2222,40
75474644267,75474644264,-3,736,2628,40
75476274175,75476274169,-6,990,3170,40
75480491579,75480491573,-6,938,3038,40
75481938570,75481938564,-6,1145,3031,40
75483199313,75483199308,-5,1066,3409,40
75483593665,75483593658,-7,1001,4391,40
75483888360,75483888369,9,262,1232,40
75484049213,75484049217,4,220,1133,40
75486068990,75486068985,-5,930,4538,40
75491284979,75491284973,-6,1205,4200,40
75492273798,75492273792,-6,1042,4152,40
75493770082,75493770075,-7,652,2036,40
75496578468,75496578463,-5,1093,4333,40
75496655296,75496655312,16,323,959,40
75499400047,75499400041,-6,963,3517,40
75500256489,75500256484,-5,745,2957,40
75503725339,75503725333,-6,1087,5007,40
75504371436,75504371455,19,204,1675,40
75504503421,75504503414,-7,963,4181,40
75504603863,75504603860,-3,92,1348,40
75506704466,75506704467,1,3473,2753,40
75514623937,75514623938,1,2063,1932,40
75523136007,75523136001,-6,925,3655,40
75526700582,75526700578,-4,1283,2232,40
75528236134,75528236129,-5,763,3823,40
75529560526,75529560509,-17,83,1391,40
75534194479,75534194474,-5,956,3826,40
75536460787,75536460782,-5,708,3239,40
75541886444,75541886439,-5,1482,2572,40
75545339817,75545339809,-8,1951,4553,40
75549226641,75549226633,-8,444,2888,40
75555843834,75555843827,-7,794,2328,40
75558635019,75558635015,-4,780,3577,40
75561661761,75561661774,13,445,1630,40
75562828129,75562828123,-6,945,3347,40
75567407139,75567407137,-2,798,1617,40
75570410792,75570410798,6,3242,1161,40
75572181413,75572181406,-7,1434,5195,40
75576666410,75576666410,0,1549,1409,40
75583459187,75583459193,6,2868,1204,40
75585602442,75585602450,8,2793,1522,40
75587181806,75587181808,2,968,1293,40
75590178000,75590177996,-4,754,2694,40
75590442167,75590442154,-13,114,1388,40
75593239280,75593239274,-6,806,3015,40
75593265892,75593265915,23,674,3913,40
75594829959,75594829951,-8,686,2774,40
75599768505,75599768505,0,3249,4116,40
75607286417,75607286411,-6,761,4435,40
75610037987,75610037982,-5,1408,3067,40
75612515833,75612515833,0,46487,22016,40
75614284986,75614284979,-7,1704,4182,40
75619764994,75619764999,5,2063,1266,40
75624120067,75624120062,-5,784,4252,40
75627036629,75627036624,-5,1126,3405,40
75650998438,75650998432,-6,1110,4722,40
75651555690,75651555683,-7,1124,4214,40
75654574381,75654574377,-4,1090,4246,40
75659621050,75659621053,3,1409,1245,40
75664201272,75664201265,-7,1158,3133,40
75666909079,75666909074,-5,628,3933,40
75668646320,75668646334,14,22,1131,40
75670723567,75670723561,-6,753,3954,40
75671660600,75671660617,17,1083,3984,40
75672884746,75672884740,-6,1293,4641,40
75679296097,75679296090,-7,1109,4787,40
75684402263,75684402257,-6,1271,4386,40
75684658470,75684658463,-7,1139,4168,40
75687040162,75687040157,-5,1287,3513,40
75689924002,75689923995,-7,1121,4161,40
75690380691,75690380691,0,1666,3331,40
75693318974,75693318968,-6,1530,5945,40
75696588085,75696588090,5,6053,1119,40
75697710979,75697710974,-5,1386,2870,40
75700672068,75700672062,-6,967,3213,40
75707102005,75707101999,-6,990,4722,40
75709991009,75709991002,-7,1023,4768,40
75710601637,75710601649,12,150,1163,40
75711583418,75711583427,9,2560,1102,40
75714619478,75714619488,10,3183,2184,40
75722828574,75722828566,-8,1274,3593,40
75724020762,75724020757,-5,819,2909,40
75725964781,75725964775,-6,895,2352,40
75728224066,75728224060,-6,1141,3635,40
75728845069,75728845065,-4,865,1567,40
75729582471,75729582489,18,43,1409,40
75741613774,75741613770,-4,837,2786,40
75742757181,75742757174,-7,1061,3811,40
75743021274,75743021268,-6,1103,2932,40
75750667907,75750667899,-8,647,3505,40
75757295659,75757295658,-1,1924,2088,40
75760570307,75760570302,-5,971,3831,40
75764393390,75764393380,-10,841,2810,40
75764793446,75764793436,-10,891,4672,40
75768156381,75768156375,-6,770,4713,40
75773895187,75773895181,-6,1249,4626,40
75789806270,75789806270,0,2922,4009,40
75794370831,75794370834,3,149,608,40
75795216640,75795216634,-6,1042,3787,40
75801785718,75801785714,-4,1013,3796,40
75803600871,75803600866,-5,1202,2605,40
75806787543,75806787538,-5,850,2644,40
75807681006,75807681000,-6,1081,4023,40
75812553130,75812553124,-6,1082,4111,40
75814133026,75814133018,-8,875,4142,40
75814269556,75814269577,21,235,1025,40
75814618405,75814618385,-20,255,1226,40
75817785178,75817785180,2,1587,1369,40
75824695827,75824695821,-6,949,3729,40
75828976003,75828975995,-8,966,3717,40
75829360984,75829360997,13,224,2366,40
75834303803,75834303797,-6,1254,5979,40
75835195427,75835195421,-6,940,3753,40
75839729790,75839729800,10,1060,1732,40
75840805311,75840805304,-7,783,3968,40
75840975592,75840975605,13,471,2090,40
75853679239,75853679234,-5,857,2578,40
75855281404,75855281399,-5,654,3052,40
75855661792,75855661793,1,1956,2627,40
75857651616,75857651611,-5,1099,3025,40
75867000602,75867000607,5,20805,20974,40
75867295088,75867295082,-6,518,2263,40
75868804323,75868804318,-5,2189,6167,40
75871222283,75871222278,-5,1105,3842,40
75871677286,75871677278,-8,1164,5289,40
75879059411,75879059404,-7,1306,5311,40
75886889977,75886889983,6,3166,1526,40
75889506985,75889506997,12,11553,47751,40
75893062303,75893062306,3,2001,1464,40
75899248932,75899248949,17,621,1400,40
75901028567,75901028562,-5,1101,5251,40
75911296826,75911296817,-9,884,3794,40
75911608316,75911608338,22,103,1159,40
75911790230,75911790244,14,274,1479,40
75916949819,75916949815,-4,1002,2525,40
75917098158,75917098152,-6,752,2868,40
75918301837,75918301841,4,2461,1047,40
75920913227,75920913222,-5,1176,5905,40
75923589770,75923589760,-10,903,4962,40
75926113229,75926113224,-5,796,5073,40
75928056739,75928056734,-5,698,4494,40
75932177031,75932177026,-5,1106,3408,40
75933054542,75933054561,19,558,2040,40
75933160282,75933160274,-8,965,3782,40
75933367440,75933367434,-6,856,2437,40
75939014263,75939014258,-5,781,2879,40
75939161454,75939161438,-16,946,4420,40
75948282021,75948282017,-4,1495,6010,40
75956004097,75956004101,4,922,1046,40
75959282374,75959282387,13,823,3396,40
75961328060,75961328054,-6,754,2060,40
75961619398,75961619395,-3,362,1338,40
75962197886,75962197879,-7,1049,4573,40
75964241290,75964241285,-5,1112,3778,40
75970333762,75970333755,-7,505,4645,40
75974805622,75974805617,-5,833,2799,40
75986246645,75986246658,13,176,997,40
75988614723,75988614727,4,1240,1112,40
75990432398,75990432393,-5,1478,3750,40
75999168806,75999168802,-4,818,3241,40
75999289698,75999289703,5,2629,1335,40
75999855450,75999855450,0,5413,5968,40
76000300383,76000300377,-6,1014,4698,40
76000407973,76000407994,21,467,2784,40
76003622578,76003622574,-4,1193,3138,40
76008529742,76008529742,0,2957,4199,40
76009772134,76009772130,-4,1387,2239,40
76015544729,76015544723,-6,1255,5207,40
76020450917,76020450911,-6,966,3457,40
76021951851,76021951846,-5,1354,4308,40
76028944223,76028944217,-6,980,3234,40
76029418200,76029418211,11,463,1763,40
76029466278,76029466274,-4,697,1775,40
76034919762,76034919757,-5,583,3947,40
76035929415,76035929420,5,212,1061,40
76049772629,76049772623,-6,1193,4929,40
76051403974,76051403968,-6,721,3582,40
76051440430,76051440411,-19,131,838,40
76051520759,76051520776,17,651,3513,40
76054012083,76054012077,-6,1074,3939,40
76057088253,76057088250,-3,346,3353,40
76058537995,76058537990,-5,650,3126,40
76063848098,76063848093,-5,970,3299,40
76064276759,76064276738,-21,1007,4206,40
76064353823,76064353839,16,413,918,40
76069437857,76069437856,-1,1376,2370,40
76076666171,76076666165,-6,1728,2793,40
76084556229,76084556227,-2,475,901,40
76090058958,76090058952,-6,1271,4254,40
76090092583,76090092585,2,207,958,40
76103038742,76103038737,-5,838,3004,40
76113066985,76113066979,-6,895,4119,40
76113105792,76113105777,-15,91,1223,40
76115592057,76115592053,-4,1109,3329,40
76119549817,76119549810,-7,980,3819,40
76119977033,76119977026,-7,1275,3397,40
76125540194,76125540187,-7,609,3687,40
76126581679,76126581673,-6,1087,4219,40
76126902535,76126902534,-1,37,659,40
76132750057,76132750050,-7,1417,5297,40
76133929180,76133929175,-5,1301,2839,40
76134252189,76134252183,-6,1353,3944,40
76148801322,76148801341,19,1271,3468,40
76156028758,76156028760,2,1363,1063,40
76159824975,76159824971,-4,1147,3234,40
76160353767,76160353774,7,149,1110,40
76160695845,76160695824,-21,684,4373,40
76160792167,76160792162,-5,966,3398,40
76179685639,76179685634,-5,1442,4279,40
76188836038,76188836031,-7,990,3599,40
76190648686,76190648706,20,375,1295,40
76191242491,76191242490,-1,778,1773,40
76195702033,76195702026,-7,871,2990,40
76196015638,76196015654,16,245,1357,40
76206746831,76206746835,4,1235,917,40
76207250629,76207250625,-4,1086,3177,40
76209343426,76209343420,-6,640,3132,40
76210978587,76210978581,-6,897,4454,40
76211971322,76211971315,-7,1234,3846,40
76212167056,76212167052,-4,1208,3289,40
76213115147,76213115141,-6,503,2626,40
76213347678,76213347694,16,73,1350,40
76218558557,76218558550,-7,1539,4955,40
76220369953,76220369947,-6,877,3445,40
76222556907,76222556903,-4,803,1825,40
76222794096,76222794086,-10,114,1241,40
76227483178,76227483174,-4,414,2700,40
76227834841,76227834834,-7,762,3644,40
76229380774,76229380768,-6,1726,4863,40
76231252371,76231252365,-6,1247,3986,40
76239319790,76239319785,-5,696,3451,40
76241386888,76241386882,-6,836,3538,40
76241443694,76241443681,-13,118,1161,40
76266950800,76266950805,5,3477,1769,40
76269916645,76269916641,-4,1305,3824,40
76273149208,76273149207,-1,1539,2226,40
76276540082,76276540075,-7,863,2860,40
76285423341,76285423334,-7,818,3863,40
76288858755,76288858749,-6,1097,4231,40
76290417379,76290417374,-5,799,2854,40
76299268454,76299268455,1,2253,1623,40
76307207555,76307207549,-6,853,3609,40
76307915053,76307915060,7,13261,2217,40
76308776010,76308776012,2,2313,2251,40
76313931065,76313931061,-4,1091,2198,40
76314601454,76314601434,-20,235,1170,40
76323668947,76323668942,-5,1091,2834,40
76327552459,76327552452,-7,264,3184,40
76328894413,76328894429,16,509,2289,40
76335872859,76335872852,-7,1133,3928,40
76336739767,76336739761,-6,1024,2624,40
76337909114,76337909108,-6,927,3465,40
76340639809,76340639803,-6,1385,3159,40
76341057142,76341057146,4,73,1185,40
76347998529,76347998522,-7,777,3712,40
76348253862,76348253881,19,374,1437,40
76352710782,76352710768,-14,2469,9892,40
76355128220,76355128213,-7,1113,4036,40
76361742995,76361742989,-6,1415,6369,40
76363838385,76363838380,-5,1114,3778,40
76365466667,76365466666,-1,1067,1915,40
76366783921,76366783915,-6,1022,3456,40
76368885762,76368885755,-7,1014,4349,40
76372998826,76372998819,-7,1373,4742,40
76373510383,76373510377,-6,1002,2997,40
76379994194,76379994189,-5,813,1880,40
76383154170,76383154177,7,28136,55668,40
76388619361,76388619363,2,1302,1642,40
76392789919,76392789913,-6,1321,3945,40
76396186202,76396186198,-4,921,1391,40
76405547088,76405547091,3,2659,1551,40
76406724938,76406724934,-4,784,4285,40
76408641310,76408641306,-4,748,2532,40
76408931110,76408931126,16,129,883,40
76416638863,76416638858,-5,1024,3001,40
76417260070,76417260065,-5,754,3179,40
76424598303,76424598298,-5,1066,2526,40
76424679594,76424679589,-5,1048,3804,40
76429287762,76429287757,-5,1028,2853,40
76429353972,76429353995,23,493,1839,40
76434406006,76434406000,-6,1400,4764,40
76441715563,76441715562,-1,1494,2751,40
76452345114,76452345109,-5,798,3005,40
76467729899,76467729893,-6,615,2083,40
76467784543,76467784562,19,339,1114,40
76474331449,76474331443,-6,907,3014,40
76474667422,76474667407,-15,1000,3048,40
76477955190,76477955182,-8,637,3435,40
76478209439,76478209434,-5,1273,4653,40
76483783559,76483783549,-10,198,1020,40
76489713181,76489713176,-5,1141,3502,40
76491383173,76491383167,-6,1057,3484,40
76491599236,76491599229,-7,700,4196,40
76494996320,76494996313,-7,656,3999,40
76495762610,76495762605,-5,1070,2754,40
76498205473,76498205469,-4,5036,9722,40
76503698458,76503698454,-4,558,2388,40
76504137527,76504137531,4,928,853,40
76505808989,76505808981,-8,1152,4067,40
76506264883,76506264882,-1,1591,1723,40
76508371206,76508371201,-5,623,3582,40
76515165242,76515165236,-6,1053,3187,40
76518936575,76518936568,-7,1019,3881,40
76523486791,76523486786,-5,1035,4383,40
76523579788,76523579799,11,171,883,40
76527889001,76527889007,6,2484,1331,40
76529995107,76529995099,-8,829,2066,40
76542797378,76542797380,2,1726,1626,40
76546971330,76546971325,-5,1013,3186,40
76547004951,76547004969,18,258,1227,40
76552339015,76552339009,-6,851,4685,40
76558535753,76558535748,-5,1006,3363,40
76559756365,76559756382,17,126,1085,40
76563656098,76563656093,-5,1340,4526,40
76564718294,76564718286,-8,1021,3615,40
76565198558,76565198572,14,287,763,40
76565529975,76565529969,-6,1149,3177,40
76577361717,76577361716,-1,2039,1953,40
76578427835,76578427834,-1,1149,1389,40
76579555951,76579555968,17,409,1149,40
76582846911,76582846905,-6,937,2782,40
76583994101,76583994094,-7,875,4453,40
76584643326,76584643335,9,79,1125,40
76589773834,76589773839,5,2387,906,40
76598936068,76598936064,-4,733,2570,40
76599330415,76599330430,15,1121,2904,40
76599693288,76599693298,10,399,1492,40
76609494558,76609494559,1,2790,3239,40
76610424093,76610424098,5,2304,1221,40
76621572483,76621572478,-5,969,3650,40
76621651557,76621651554,-3,79,1755,40
76622495139,76622495134,-5,1097,3173,40
76627980961,76627980955,-6,1059,1246,40
76631380567,76631380562,-5,379,2463,40
76633752799,76633752802,3,1124,1324,40
76635604102,76635604098,-4,1530,3417,40
76637345854,76637345857,3,2467,2613,40
76648543474,76648543474,0,1607,2229,40
76649020881,76649020874,-7,1086,4566,40
76651983187,76651983184,-3,796,2715,40
76655476302,76655476297,-5,991,3184,40
76656211974,76656211978,4,420,2096,40
76669773482,76669773477,-5,852,3838,40
76670332275,76670332267,-8,833,3473,40
76673172548,76673172555,7,70,1135,40
76680719923,76680719919,-4,977,2032,40
76684842030,76684842025,-5,310,1969,40
76687880294,76687880292,-2,944,3359,40
76690526659,76690526654,-5,905,2599,40
76690825335,76690825318,-17,172,1013,40
76696164872,76696164866,-6,700,4526,40
76702182172,76702182165,-7,1329,4661,40
76702833158,76702833150,-8,914,4048,40
76703343407,76703343402,-5,1113,4257,40
76704978047,76704978040,-7,950,2470,40
76707946246,76707946240,-6,1163,4486,40
76727573316,76727573322,6,2995,882,40
76734906202,76734906195,-7,952,4556,40
76740759107,76740759101,-6,292,3283,40
76744584585,76744584591,6,5026,1508,40
76752194180,76752194173,-7,684,3463,40
76754300706,76754300701,-5,661,3230,40
76755814600,76755814606,6,20195,30764,40
76758299933,76758299931,-2,1651,3184,40
76761502975,76761502970,-5,768,2509,40
76762069646,76762069640,-6,1374,3633,40
76768519109,76768519103,-6,825,2897,40
76771337921,76771337918,-3,835,2795,40
76771636551,76771636567,16,928,4972,40
76776663572,76776663566,-6,1189,2438,40
76784819166,76784819145,-21,247,770,40
76795557577,76795557570,-7,1609,6869,40
76800411230,76800411222,-8,823,4345,40
76802757600,76802757596,-4,1422,2777,40
76802840996,76802841010,14,23,849,40
76814929910,76814929916,6,16697,25212,40
76820928517,76820928514,-3,826,3515,40
76826735827,76826735823,-4,535,2701,40
76830415082,76830415076,-6,689,3796,40
76833357832,76833357830,-2,781,1212,40
76834751769,76834751763,-6,898,2560,40
76835073824,76835073835,11,615,2414,40
76837966381,76837966378,-3,714,2200,40
76838520442,76838520437,-5,1188,4909,40
76840051068,76840051063,-5,1071,3148,40
76840098805,76840098810,5,7351,2015,40
76842480479,76842480472,-7,1223,4817,40
76845571234,76845571229,-5,1124,3492,40
76846153686,76846153666,-20,1015,3372,40
76846498636,76846498636,0,117,1738,40
76848523451,76848523443,-8,759,3542,40
76853874813,76853874806,-7,1100,3054,40
76853924088,76853924103,15,1138,3773,40
76857206341,76857206341,0,1280,1442,40
76867412152,76867412151,-1,1365,2470,40
76876806974,76876806966,-8,796,2924,40
76876924379,76876924374,-5,736,2210,40
76881662565,76881662563,-2,848,1775,40
76881786013,76881786006,-7,764,3276,40
76882312595,76882312590,-5,767,3110,40
76890759939,76890759933,-6,975,3044,40
76891233589,76891233596,7,5937,2395,40
76893202614,76893202609,-5,1135,3799,40
76893869165,76893869177,12,342,1200,40
76903971217,76903971210,-7,792,3177,40
76906615351,76906615348,-3,1541,4561,40
76909189704,76909189699,-5,1077,2971,40
76910955122,76910955117,-5,1291,3611,40
76912399439,76912399433,-6,1287,3637,40
76916928856,76916928852,-4,1302,3452,40
76919777485,76919777478,-7,1011,4398,40
76920759385,76920759379,-6,869,1598,40
76921745664,76921745677,13,839,2026,40
76925269591,76925269586,-5,996,3334,40
76928877881,76928877874,-7,981,3585,40
76929043261,76929043279,18,287,1389,40
76933793990,76933793987,-3,887,2376,40
76935150446,76935150450,4,211,1135,40
76936623790,76936623785,-5,905,3892,40
76942683687,76942683686,-1,1463,2280,40
76943074191,76943074187,-4,1168,3165,40
76954224623,76954224620,-3,891,1857,40
76957779042,76957779035,-7,1087,4683,40
76961014964,76961014949,-15,282,729,40
76962144931,76962144927,-4,1495,3720,40
76967420175,76967420166,-9,1369,2943,40
76968278317,76968278311,-6,825,3019,40
76973794880,76973794874,-6,1001,3280,40
76979547745,76979547737,-8,1239,5261,40
76989795741,76989795736,-5,1118,3672,40
76989993285,76989993302,17,741,2788,40
76993191426,76993191421,-5,1000,3062,40
76995386897,76995386903,6,11405,7618,40
77006414501,77006414495,-6,1428,3636,40
77007650917,77007650910,-7,923,3370,40
77013920715,77013920711,-4,1107,3948,40
77016071095,77016071089,-6,808,3691,40
77020500290,77020500282,-8,738,2858,40
77026047648,77026047650,2,2135,1863,40
77026387530,77026387542,12,11221,42832,40
77026559793,77026559791,-2,2089,3795,40
77033060658,77033060652,-6,1173,3785,40
77048698392,77048698386,-6,893,3488,40
77051874591,77051874585,-6,1290,4923,40
77062068251,77062068243,-8,1061,4375,40
77068541882,77068541885,3,2671,2461,40
77070329894,77070329886,-8,1134,4958,40
77075445735,77075445739,4,971,1155,40
77077701807,77077701810,3,1266,1405,40
77078954723,77078954718,-5,1398,4238,40
77080938294,77080938289,-5,1085,2659,40
77082735482,77082735478,-4,1068,3051,40
77084347945,77084347949,4,4773,2725,40
77085649466,77085649461,-5,1264,3966,40
77085987512,77085987506,-6,1106,3833,40
77086302078,77086302077,-1,156,1744,40
77093440302,77093440297,-5,820,2580,40
77093557590,77093557605,15,273,1338,40
77101216471,77101216485,14,900,3514,40
77102798810,77102798806,-4,849,2820,40
77108769345,77108769338,-7,1091,3389,40
77121033393,77121033387,-6,1234,3123,40
77124458259,77124458253,-6,1111,5488,40
77130917686,77130917689,3,4335,2663,40
77131319290,77131319285,-5,768,2357,40
77131516636,77131516654,18,852,3747,40
77133686463,77133686458,-5,1178,4149,40
77138690124,77138690118,-6,1385,4017,40
77139996977,77139996970,-7,1327,3490,40
77142775461,77142775458,-3,987,2000,40
77142967533,77142967553,20,785,2970,40
77145131167,77145131160,-7,772,3268,40
77146942987,77146942981,-6,924,2895,40
77150661821,77150661813,-8,1273,3118,40
77150960844,77150960838,-6,834,3314,40
77152254662,77152254669,7,249,1178,40
77154741235,77154741225,-10,920,2790,40
77157624755,77157624749,-6,688,3196,40
77159235114,77159235109,-5,863,3720,40
77165123587,77165123582,-5,1263,3504,40
77167917839,77167917833,-6,1449,4006,40
77173399209,77173399202,-7,1068,3745,40
77178984318,77178984318,0,1349,2019,40
77186327988,77186327982,-6,1054,4701,40
77191172410,77191172405,-5,788,2257,40
77191207709,77191207731,22,318,1316,40
77193112755,77193112749,-6,679,3285,40
77195580329,77195580323,-6,830,2554,40
77199191290,77199191284,-6,1132,5320,40
77204564708,77204564702,-6,975,2433,40
77207133662,77207133654,-8,778,4595,40
77211733940,77211733937,-3,1356,2534,40
77213309876,77213309870,-6,780,4362,40
77213456245,77213456249,4,1084,1002,40
77215176846,77215176841,-5,702,2997,40
77216786668,77216786664,-4,938,3599,40
77216951058,77216951051,-7,920,3034,40
77220064707,77220064700,-7,1188,4114,40
77220757670,77220757669,-1,4005,19132,40
77222290807,77222290803,-4,894,3593,40
77223014572,77223014595,23,206,1100,40
77223045720,77223045738,18,240,1156,40
77224616645,77224616640,-5,756,3153,40
77228667938,77228667935,-3,1445,3513,40
77230398585,77230398585,0,1306,2179,40
77231189387,77231189382,-5,864,3124,40
77232236662,77232236656,-6,774,3306,40
77234109498,77234109491,-7,1352,4641,40
77238583494,77238583488,-6,1340,5584,40
77246098989,77246098991,2,2342,19899,40
77249426317,77249426311,-6,871,2152,40
77250061843,77250061837,-6,870,4103,40
77251057436,77251057440,4,2142,1536,40
77251656279,77251656274,-5,843,2928,40
77251955597,77251955590,-7,928,4094,40
77256024048,77256024051,3,3322,2779,40
77261273148,77261273166,18,939,3849,40
77262738042,77262738036,-6,1618,4851,40
77284272739,77284272741,2,625,1180,40
77286707072,77286707066,-6,917,4141,40
77286774486,77286774487,1,301,1878,40
77287392583,77287392573,-10,711,2585,40
77287915084,77287915089,5,135,851,40
77288054597,77288054585,-12,2799,41426,40
77294890953,77294890947,-6,792,2592,40
77295192961,77295192954,-7,674,3615,40
77296464988,77296464982,-6,1121,3909,40
77302089088,77302089082,-6,1130,4044,40
77305142077,77305142074,-3,1659,4637,40
77310541921,77310541914,-7,947,3469,40
77313045733,77313045728,-5,853,3394,40
77318500914,77318500909,-5,775,2522,40
77318644980,77318644977,-3,16,1070,40
77319179949,77319179951,2,1690,1364,40
77320412350,77320412345,-5,1135,2942,40
77323111358,77323111353,-5,834,3278,40
77325035389,77325035383,-6,894,3797,40
77326899198,77326899193,-5,849,3815,40
77328107381,77328107403,22,646,3835,40
77328139686,77328139680,-6,1312,3503,40
77329340192,77329340194,2,122,979,40
77330210110,77330210106,-4,665,3868,40
77334962830,77334962823,-7,936,4143,40
77340822887,77340822882,-5,803,2382,40
77341423693,77341423686,-7,1361,5763,40
77347563511,77347563505,-6,1121,3659,40
77347650655,77347650652,-3,173,1034,40
77353935430,77353935423,-7,1347,3295,40
77354310219,77354310213,-6,973,4714,40
77361496676,77361496695,19,411,2918,40
77366561910,77366561905,-5,815,4304,40
77368567864,77368567870,6,941,1479,40
77379521299,77379521291,-8,1178,5137,40
77385890135,77385890130,-5,998,4199,40
77387826759,77387826754,-5,847,2756,40
77389238127,77389238123,-4,793,2108,40
77395521207,77395521203,-4,1546,4447,40
77396206135,77396206132,-3,1076,2571,40
77396369981,77396369976,-5,1003,2437,40
77400704593,77400704586,-7,735,4081,40
77411594834,77411594828,-6,1124,3552,40
77415101152,77415101146,-6,1427,4078,40
77415145531,77415145526,-5,1192,3651,40
77418103481,77418103487,6,6074,2241,40
77418753418,77418753413,-5,1296,4156,40
77422671553,77422671558,5,2308,704,40
77435235470,77435235459,-11,165,1535,40
77438960740,77438960734,-6,952,3309,40
77439108671,77439108666,-5,1351,4645,40
77440205432,77440205426,-6,842,3947,40
77449494256,77449494249,-7,2266,9997,40
77452493776,77452493772,-4,828,3431,40
77455265386,77455265383,-3,689,1528,40
77456277004,77456277000,-4,177,1202,40
77456844135,77456844129,-6,1186,1591,40
77458268170,77458268163,-7,871,3280,40
77460754107,77460754103,-4,1474,3868,40
77463760144,77463760165,21,344,1646,40
77465035079,77465035083,4,8662,19237,40
77467352625,77467352618,-7,860,4441,40
77477479260,77477479253,-7,988,2840,40
77477925638,77477925623,-15,68,1059,40
77480376684,77480376678,-6,1155,3510,40
77481446343,77481446338,-5,1180,4442,40
77482303030,77482303031,1,1988,1909,40
77485479519,77485479513,-6,555,1971,40
77486123213,77486123207,-6,975,3230,40
77491585050,77491585046,-4,534,3578,40
77491788822,77491788817,-5,851,2898,40
77505227281,77505227281,0,2885,3870,40
77507696701,77507696698,-3,964,2794,40
77511380097,77511380098,1,3471,3321,40
77513745825,77513745821,-4,1232,2782,40
77516505524,77516505514,-10,731,4112,40
77525790144,77525790137,-7,1768,13013,40
77532694194,77532694189,-5,2655,9126,40
77533962542,77533962536,-6,941,3018,40
77538297857,77538297853,-4,1109,3635,40
77549061353,77549061345,-8,1069,3265,40
77550611411,77550611405,-6,915,3691,40
77550660724,77550660718,-6,154,1297,40
77552117068,77552117054,-14,629,3008,40
77553544718,77553544714,-4,626,2635,40
77554563640,77554563627,-13,672,2343,40
77558106578,77558106571,-7,1173,4795,40
77559147715,77559147708,-7,909,3877,40
77559779174,77559779186,12,619,3441,40
77563486667,77563486663,-4,1162,2932,40
77564473026,77564473020,-6,976,4328,40
77564912574,77564912578,4,2648,1383,40
77568361393,77568361386,-7,1452,6848,40
77578411198,77578411203,5,17102,49833,40
77579967259,77579967252,-7,965,4593,40
77581018166,77581018160,-6,1074,5467,40
77581408044,77581408061,17,764,4653,40
77589286714,77589286709,-5,1012,3525,40
77594307154,77594307149,-5,2066,6696,40
77607453494,77607453488,-6,804,2437,40
77607563484,77607563494,10,300,1022,40
77607991974,77607991966,-8,976,3177,40
77617667431,77617667427,-4,967,1563,40
77618023095,77618023090,-5,1020,2663,40
77627601745,77627601739,-6,1509,3803,40
77636198750,77636198745,-5,905,3386,40
77641600527,77641600522,-5,1171,3403,40
77647628189,77647628185,-4,1009,2396,40
77647848470,77647848462,-8,862,6322,40
77656276318,77656276313,-5,961,2949,40
77661570143,77661570145,2,1237,1300,40
77666031105,77666031101,-4,669,3472,40
77674689168,77674689174,6,6356,2652,40
77676084382,77676084376,-6,810,2757,40
77676778128,77676778122,-6,908,3429,40
77686583693,77686583689,-4,1256,4564,40
77687561140,77687561157,17,559,2118,40
77687749142,77687749137,-5,1022,2812,40
77688478368,77688478363,-5,1103,3683,40
77692292159,77692292151,-8,590,2963,40
77694883310,77694883302,-8,869,3316,40
77696279499,77696279505,6,3073,1485,40
77702100057,77702100062,5,1831,1078,40
77703200757,77703200752,-5,1057,2904,40
77707328979,77707328973,-6,941,3069,40
77711529034,77711529027,-7,711,3991,40
77714906652,77714906645,-7,1127,3859,40
77715128577,77715128572,-5,1007,2942,40
77715186199,77715186218,19,339,927,40
77716514746,77716514741,-5,1273,3233,40
77734126286,77734126289,3,2171,2507,40
77736586240,77736586233,-7,980,4349,40
77736646122,77736646117,-5,1148,3816,40
77739041636,77739041634,-2,2058,3373,40
77743581180,77743581173,-7,1260,3307,40
77752447982,77752447977,-5,827,4492,40
77752799413,77752799428,15,251,1994,40
77754522490,77754522484,-6,1107,3091,40
77755475347,77755475340,-7,1157,4284,40
77757157999,77757157994,-5,1362,4600,40
77758574615,77758574620,5,2861,1606,40
77759170919,77759170912,-7,1008,3197,40
77761280540,77761280531,-9,834,3719,40
77763862635,77763862629,-6,1137,4896,40
77766334031,77766334027,-4,1299,3766,40
77767154813,77767154805,-8,935,2642,40
77779158027,77779158006,-21,1953,1010,40
77781389589,77781389585,-4,1448,3562,40
77783335125,77783335118,-7,1197,4791,40
77784850355,77784850349,-6,757,3583,40
77785334743,77785334730,-13,264,1320,40
77786456947,77786456942,-5,1331,3283,40
77786524261,77786524283,22,472,3447,40
77789683519,77789683517,-2,1000,2213,40
77803457522,77803457517,-5,998,4034,40
77810117243,77810117238,-5,900,3025,40
77811132368,77811132384,16,1254,4751,40
77812804970,77812804965,-5,1246,4033,40
77813521311,77813521306,-5,955,4560,40
77817804420,77817804439,19,273,1399,40
77824803872,77824803865,-7,1076,5498,40
77827588387,77827588377,-10,827,3884,40
77827694770,77827694769,-1,31211,53550,40
77830023490,77830023483,-7,630,2286,40
77830513298,77830513301,3,23589,18033,40
77831473738,77831473734,-4,951,1977,40
77833076482,77833076475,-7,592,3741,40
77837898631,77837898626,-5,1071,4190,40
77844219418,77844219413,-5,1263,2835,40
77845887632,77845887650,18,824,3477,40
77873052638,77873052638,0,2281,2599,40
77874453578,77874453573,-5,787,4719,40
77875189534,77875189526,-8,1325,3549,40
77877346262,77877346254,-8,1157,3448,40
77892012549,77892012544,-5,629,3408,40
77892570764,77892570753,-11,221,975,40
77896556621,77896556617,-4,1369,4252,40
77897672067,77897672062,-5,1084,3558,40
77899141330,77899141335,5,2697,1335,40
77905619450,77905619448,-2,2740,3895,40
77908651123,77908651117,-6,1453,4311,40
77909108805,77909108798,-7,725,3137,40
77909495807,77909495798,-9,115,1139,40
77911517654,77911517647,-7,874,4016,40
77911688139,77911688136,-3,1145,3000,40
77912826051,77912826045,-6,1073,4386,40
77913885982,77913885976,-6,801,3337,40
77914015607,77914015619,12,237,1179,40
77919638301,77919638282,-19,13953,24161,40
77919850111,77919850114,3,1778,1898,40
77920365203,77920365195,-8,912,4443,40
77921816258,77921816253,-5,728,4303,40
77922063767,77922063776,9,90,925,40
77934395454,77934395455,1,1293,1439,40
77936634842,77936634859,17,317,1431,40
77946292361,77946292354,-7,1656,2247,40
77949335693,77949335686,-7,800,2953,40
77949448301,77949448295,-6,1264,5320,40
77949761719,77949761702,-17,353,2312,40
77952937834,77952937829,-5,1369,3794,40
77954734522,77954734514,-8,694,3776,40
77955410187,77955410181,-6,1400,4471,40
77958472186,77958472181,-5,654,3270,40
77962280071,77962280066,-5,765,3374,40
77963405591,77963405594,3,3555,2499,40
77963498527,77963498520,-7,1476,4798,40
77964830958,77964830955,-3,900,4513,40
77968930905,77968930899,-6,1251,4552,40
77972986542,77972986538,-4,796,2120,40
77976474085,77976474081,-4,909,2623,40
77991167202,77991167195,-7,1229,3945,40
77991558150,77991558142,-8,867,2996,40
78004022238,78004022233,-5,1382,4579,40
78005755774,78005755770,-4,1148,3750,40
78020455814,78020455806,-8,1232,4351,40
78025194275,78025194270,-5,536,3004,40
78025314296,78025314276,-20,740,1968,40
78025358867,78025358862,-5,907,4437,40
78026176425,78026176417,-8,1109,3519,40
78026562606,78026562611,5,138,1422,40
78029124414,78029124407,-7,1463,4778,40
78036058918,78036058913,-5,754,2594,40
78036805918,78036805902,-16,76,1288,40
78038302307,78038302301,-6,930,1717,40
78041338287,78041338282,-5,1419,4253,40
78043004730,78043004726,-4,1340,2269,40
78047742218,78047742211,-7,793,3602,40
78047844221,78047844214,-7,1028,3543,40
78067099317,78067099310,-7,1296,4516,40
78067840948,78067840942,-6,1224,5435,40
78076664700,78076664694,-6,1001,4206,40
78078194235,78078194230,-5,1572,4170,40
78084454338,78084454332,-6,1053,3734,40
78094062938,78094062933,-5,1486,4458,40
78098870297,78098870278,-19,694,105,40
78104594431,78104594425,-6,1118,2625,40
78131103373,78131103368,-5,807,2072,40
78131227526,78131227523,-3,325,1608,40
78131335646,78131335661,15,723,2964,40
78134129553,78134129546,-7,1007,4039,40
78140282630,78140282626,-4,30759,12561,40
78141265193,78141265194,1,1011,1258,40
78144273541,78144273537,-4,451,1820,40
78147775415,78147775410,-5,2131,6536,40
78153225702,78153225694,-8,724,2375,40
78154295982,78154295996,14,11710,53354,40
78158060670,78158060664,-6,715,2060,40
78166090330,78166090326,-4,922,3876,40
78173533109,78173533106,-3,1153,2138,40
78188241429,78188241425,-4,1160,2602,40
78188887052,78188887046,-6,1276,3417,40
78194183206,78194183210,4,3744,1667,40
78196204111,78196204106,-5,1168,3230,40
78197156261,78197156254,-7,1333,3188,40
78198248516,78198248510,-6,791,3324,40
78202536762,78202536757,-5,1151,4851,40
78204516339,78204516333,-6,1053,3585,40
78214224383,78214224377,-6,837,2998,40
78225208047,78225208041,-6,1029,3722,40
78226975990,78226975986,-4,946,3527,40
78227478692,78227478686,-6,1423,3481,40
78232525465,78232525460,-5,964,2331,40
78234291260,78234291254,-6,882,3838,40
78234352918,78234352902,-16,246,1185,40
78244248736,78244248731,-5,1007,3270,40
78251675263,78251675258,-5,917,4662,40
78258374105,78258374104,-1,1299,2446,40
78264674393,78264674388,-5,1245,3686,40
78265271162,78265271169,7,2928,825,40
78265631582,78265631576,-6,1211,3754,40
78277874537,78277874530,-7,946,2287,40
78278435918,78278435937,19,410,1058,40
78290694495,78290694489,-6,1087,3484,40
78290816017,78290816012,-5,1488,3413,40
78291821566,78291821575,9,6762,1803,40
78292678805,78292678799,-6,1217,3685,40
78295242507,78295242501,-6,647,3079,40
78299072984,78299072989,5,1283,1298,40
78305943413,78305943408,-5,978,3637,40
78311934916,78311934910,-6,1239,5215,40
78315392078,78315392071,-7,2425,8345,40
78315449855,78315449850,-5,939,4097,40
78317312853,78317312866,13,16023,34671,40
78318095835,78318095839,4,2130,2384,40
78319373741,78319373734,-7,730,2679,40
78322128633,78322128627,-6,1012,3326,40
78325433902,78325433906,4,1666,1580,40
78326091750,78326091751,1,5019,5659,40
78330005519,78330005517,-2,2238,4322,40
78330386117,78330386112,-5,1177,3571,40
78331621567,78331621570,3,1049,1365,40
78336566699,78336566693,-6,599,2404,40
78336595230,78336595226,-4,145,1017,40
78343018338,78343018332,-6,1135,3384,40
78353535445,78353535438,-7,1116,4738,40
78355537509,78355537503,-6,1154,2369,40
78355725356,78355725349,-7,275,822,40
78360110266,78360110267,1,1736,1318,40
78361031339,78361031334,-5,1016,4115,40
78368830066,78368830062,-4,937,3521,40
78369261558,78369261562,4,1816,1676,40
78374793778,78374793794,16,318,1255,40
78379032769,78379032765,-4,760,2697,40
78384029258,78384029250,-8,1128,4305,40
78388907662,78388907663,1,1665,1733,40
78390730802,78390730798,-4,1657,3213,40
78396704797,78396704790,-7,1067,3629,40
78403486687,78403486678,-9,834,3228,40
78415894582,78415894575,-7,1128,6594,40
78416895281,78416895277,-4,1150,4334,40
78419096099,78419096089,-10,673,3154,40
78419178534,78419178530,-4,379,2766,40
78427990171,78427990166,-5,1355,3816,40
78429463898,78429463903,5,906,843,40
78429678483,78429678490,7,5322,1706,40
78430252514,78430252508,-6,1346,3528,40
78436192797,78436192792,-5,938,3364,40
78439981384,78439981376,-8,1027,3381,40
78440864214,78440864209,-5,828,3339,40
78441348749,78441348731,-18,756,2170,40
78442689460,78442689459,-1,88,1236,40
78446646153,78446646147,-6,829,4427,40
78451002575,78451002579,4,2025,1522,40
78451248883,78451248878,-5,1690,3919,40
78463608546,78463608540,-6,1174,3130,40
78464827719,78464827705,-14,88,857,40
78466474935,78466474948,13,1261,3753,40
78479938846,78479938843,-3,1090,3194,40
78481506367,78481506364,-3,971,1668,40
78484090733,78484090730,-3,1200,2435,40
78484288997,78484289012,15,266,1873,40
78498351697,78498351691,-6,1273,5310,40
78500181004,78500180997,-7,1126,4061,40
78501175636,78501175630,-6,975,4860,40
78504611586,78504611579,-7,884,4730,40
78507967246,78507967246,0,1532,1271,40
78508422412,78508422409,-3,30969,12891,40
78516655635,78516655629,-6,1122,4170,40
78520752319,78520752314,-5,852,4248,40
78525091480,78525091477,-3,1270,3048,40
78527567305,78527567302,-3,995,2164,40
78532315531,78532315535,4,1263,1636,40
78533065420,78533065414,-6,518,1884,40
78537546843,78537546838,-5,1027,3057,40
78538696663,78538696656,-7,627,1892,40
78539294958,78539294975,17,281,1058,40
78539884151,78539884130,-21,747,3174,40
78544391202,78544391195,-7,1222,3422,40
78553381323,78553381318,-5,1371,3227,40
78559316731,78559316725,-6,1170,2994,40
78561688117,78561688109,-8,747,3702,40
78562028604,78562028598,-6,70,888,40
78562335423,78562335420,-3,276,1261,40
78562491352,78562491365,13,780,2878,40
78563986411,78563986403,-8,1048,3698,40
78564133888,78564133901,13,324,997,40
78564534970,78564534966,-4,1502,3689,40
78566402642,78566402637,-5,793,3406,40
78567087478,78567087497,19,437,1106,40
78568164064,78568164058,-6,1236,3826,40
78574621540,78574621533,-7,1057,3976,40
78575809790,78575809789,-1,2016,3629,40
78580914026,78580914022,-4,1093,3902,40
78582741318,78582741313,-5,544,1629,40
78585390887,78585390883,-4,881,2064,40
78585771932,78585771953,21,1157,3921,40
78587279287,78587279287,0,17799,19034,40
78589235869,78589235870,1,2626,3868,40
78594949089,78594949085,-4,1334,3323,40
78595739343,78595739337,-6,1205,5649,40
78608296914,78608296910,-4,778,2071,40
78613493134,78613493154,20,46706,21330,40
78618857278,78618857274,-4,963,3006,40
78620299312,78620299307,-5,1413,4427,40
78621470210,78621470207,-3,2213,4808,40
78621996707,78621996705,-2,8487,17870,40
78622500438,78622500449,11,325,1538,40
78629400508,78629400502,-6,1134,5302,40
78633580410,78633580405,-5,1076,3901,40
78637580995,78637580991,-4,767,2274,40
78639880955,78639880951,-4,1115,3343,40
78642490914,78642490915,1,1019,1271,40
78643591446,78643591439,-7,1121,3587,40
78647207215,78647207209,-6,1270,4013,40
78650947222,78650947224,2,904,951,40
78656094095,78656094090,-5,643,3555,40
78663871991,78663871983,-8,1123,3808,40
78665386351,78665386353,2,164,891,40
78666517403,78666517395,-8,1314,4018,40
78673950009,78673950002,-7,1262,3658,40
78674713794,78674713787,-7,984,3850,40
78679619168,78679619165,-3,259,672,40
78680446059,78680446052,-7,1052,4978,40
78681389786,78681389798,12,14467,15853,40
78694681271,78694681276,5,3637,1721,40
78695178191,78695178189,-2,1160,2014,40
78698945237,78698945230,-7,1321,5375,40
78699824431,78699824435,4,461,1269,40
78702553435,78702553437,2,2552,1926,40
78705373212,78705373220,8,3189,1049,40
78708563711,78708563705,-6,1037,4290,40
78710706789,78710706785,-4,1234,3026,40
78714123817,78714123811,-6,1209,4502,40
78716382973,78716382967,-6,65,865,40
78725274040,78725274052,12,17717,55822,40
78728615314,78728615307,-7,1008,5442,40
78736967146,78736967140,-6,1337,5029,40
78739018959,78739018955,-4,182,1130,40
78744215091,78744215086,-5,759,4300,40
78747304486,78747304482,-4,1174,3814,40
78749597950,78749597958,8,10614,30785,40
78750594461,78750594454,-7,687,2800,40
78750641480,78750641491,11,111,1153,40
78755494701,78755494722,21,476,1843,40
78759271360,78759271364,4,5011,1928,40
78759543759,78759543752,-7,1130,4540,40
78765833195,78765833189,-6,804,3545,40
78768784989,78768784983,-6,1119,4006,40
78770020902,78770020895,-7,1256,4255,40
78770116047,78770116038,-9,460,2785,40
78776948378,78776948383,5,1929,1142,40
78781478311,78781478293,-18,1222,4526,40
78784465317,78784465310,-7,1080,2902,40
78784701598,78784701612,14,718,3414,40
78787479874,78787479869,-5,979,3626,40
78793372947,78793372943,-4,1014,1872,40
78794501031,78794501023,-8,1011,4421,40
78794837735,78794837728,-7,1133,2564,40
78795409979,78795409981,2,1925,1721,40
78799554941,78799554938,-3,1429,2487,40
78804627748,78804627744,-4,1213,2643,40
78805188364,78805188379,15,330,820,40
78810174574,78810174568,-6,1258,3560,40
78810926903,78810926919,16,159,1429,40
78811201418,78811201421,3,2686,2207,40
78814585842,78814585837,-5,993,2719,40
78816057373,78816057378,5,1758,932,40
78818043262,78818043261,-1,1046,2219,40
78820674405,78820674422,17,1113,4607,40
78821451951,78821451945,-6,574,2030,40
78824173889,78824173884,-5,539,3580,40
78828769152,78828769147,-5,1307,2760,40
78829964330,78829964324,-6,689,2931,40
78832635744,78832635743,-1,1574,1577,40
78833723563,78833723562,-1,975,1795,40
78834532026,78834532021,-5,1063,4719,40
78836339363,78836339354,-9,1098,4208,40
78842445439,78842445437,-2,2209,3454,40
78842961886,78842961886,0,2138,3431,40
78846206219,78846206214,-5,798,2514,40
78847080511,78847080495,-16,153,1338,40
78850234273,78850234268,-5,1324,3950,40
78851845223,78851845202,-21,68,933,40
78854965119,78854965111,-8,1176,5548,40
78855534461,78855534457,-4,1089,3493,40
78856235780,78856235772,-8,977,3690,40
78856397578,78856397573,-5,478,1937,40
78857257758,78857257773,15,141,1215,40
78868444827,78868444820,-7,480,1756,40
78869860224,78869860217,-7,787,2871,40
78875432884,78875432877,-7,933,6011,40
78876523774,78876523771,-3,619,991,40
78886259762,78886259763,1,1025,1343,40
78887495241,78887495235,-6,1301,4013,40
78890766329,78890766325,-4,889,4783,40
78891072255,78891072249,-6,1111,3572,40
78893394600,78893394595,-5,713,2316,40
78898510619,78898510620,1,943,1334,40
78903338471,78903338465,-6,904,2653,40
78904942254,78904942249,-5,1201,3017,40
78905854126,78905854144,18,593,3098,40
78908181985,78908181981,-4,1124,3141,40
78908534735,78908534718,-17,1377,695,40
78917427835,78917427828,-7,979,4105,40
78919709114,78919709109,-5,1183,3174,40
78919953215,78919953225,10,318,1449,40
78927883167,78927883165,-2,1139,2054,40
78928387096,78928387097,1,1449,1814,40
78928459743,78928459743,0,311,890,40
78929655395,78929655389,-6,1316,4607,40
78931482106,78931482098,-8,1108,3130,40
78933028327,78933028320,-7,871,3369,40
78942837650,78942837642,-8,877,3335,40
78947438053,78947438045,-8,1195,3970,40
78947899462,78947899462,0,3089,3271,40
78953833126,78953833122,-4,1144,3049,40
78965708238,78965708233,-5,927,2463,40
78969882117,78969882131,14,404,1221,40
78973129274,78973129276,2,538,1862,40
78976838911,78976838913,2,2022,1739,40
78981504061,78981504059,-2,3433,3919,40
78987124928,78987124924,-4,22006,13703,40
78993086298,78993086289,-9,1077,3739,40
78998734662,78998734657,-5,1163,4228,40
79001025075,79001025070,-5,886,3847,40
79001726969,79001726962,-7,1247,3580,40
79005132023,79005132019,-4,820,3262,40
79014427956,79014427949,-7,845,3837,40
79014789882,79014789876,-6,975,4727,40
79017528613,79017528608,-5,1097,2519,40
79018149010,79018149012,2,2603,2707,40
79018293855,79018293851,-4,1014,3078,40
79021642763,79021642757,-6,784,5444,40
79022866015,79022866001,-14,977,3141,40
79023019878,79023019873,-5,727,4547,40
79025645489,79025645482,-7,1187,4106,40
79025764169,79025764164,-5,939,5022,40
79028303614,79028303607,-7,1218,3005,40
79028685884,79028685878,-6,726,2527,40
79028803462,79028803483,21,309,1295,40
79030015814,79030015810,-4,820,3453,40
79030766587,79030766581,-6,899,3139,40
79032529221,79032529215,-6,1168,2919,40
79034623705,79034623702,-3,1070,3049,40
79035018908,79035018901,-7,1111,4223,40
79035114837,79035114857,20,224,1002,40
79035883367,79035883361,-6,2332,7677,40
79036496945,79036496939,-6,833,4332,40
79036857075,79036857070,-5,1002,2930,40
79036941661,79036941667,6,3230,1395,40
79039147579,79039147573,-6,782,3009,40
79039684848,79039684841,-7,958,3245,40
79042680885,79042680901,16,607,3755,40
79045294034,79045294028,-6,771,3956,40
79045386884,79045386865,-19,14,1171,40
79057970947,79057970942,-5,1263,3497,40
79062970679,79062970672,-7,786,4317,40
79073459379,79073459374,-5,978,2745,40
79086326694,79086326689,-5,1160,4314,40
79087854066,79087854058,-8,934,9077,40
79090693326,79090693325,-1,2132,2085,40
79092302842,79092302852,10,138,2054,40
79093453967,79093453961,-6,986,2886,40
79094280438,79094280432,-6,965,3777,40
79097420227,79097420222,-5,801,2859,40
79099366661,79099366653,-8,1016,2738,40
79107054269,79107054262,-7,1148,3253,40
79107530002,79107529995,-7,893,4335,40
79109467783,79109467774,-9,734,3384,40
79111112315,79111112310,-5,1239,4408,40
79111794548,79111794540,-8,755,3440,40
79112632458,79112632452,-6,1010,4600,40
79114232368,79114232366,-2,1369,2650,40
79116059557,79116059552,-5,886,3366,40
79116861158,79116861161,3,3019,19898,40
79119726874,79119726871,-3,1127,2559,40
79120057519,79120057510,-9,54,1417,40
79120153542,79120153549,7,88,854,40
79121375077,79121375063,-14,1204,3651,40
79129471046,79129471041,-5,1073,2930,40
79129872894,79129872892,-2,1259,1803,40
79131750943,79131750936,-7,846,4680,40
79138871609,79138871602,-7,898,4536,40
79141512790,79141512786,-4,1197,2690,40
79147340698,79147340692,-6,1125,4350,40
79148739233,79148739227,-6,788,3620,40
79149686318,79149686313,-5,997,3810,40
79150028583,79150028564,-19,1315,5197,40
79150736715,79150736717,2,115,710,40
79158534249,79158534242,-7,796,4135,40
79159818834,79159818827,-7,760,2165,40
79160688641,79160688636,-5,1138,3095,40
79161113373,79161113365,-8,1048,4684,40
79161146134,79161146113,-21,41,1347,40
79161633929,79161633923,-6,1084,3432,40
79161905437,79161905427,-10,199,753,40
79162743141,79162743134,-7,1086,3096,40
79165797859,79165797853,-6,680,2884,40
79166845237,79166845253,16,662,3631,40
79168527283,79168527277,-6,899,3501,40
79168965110,79168965089,-21,236,1117,40
79169167356,79169167371,15,144,1138,40
79169546911,79169546905,-6,999,3578,40
79169602037,79169602024,-13,1235,3027,40
79170100016,79170100031,15,510,2807,40
79176255493,79176255487,-6,860,3548,40
79178540853,79178540849,-4,937,3027,40
79180542518,79180542513,-5,526,2469,40
79186196872,79186196866,-6,1022,2387,40
79186785136,79186785149,13,319,954,40
79193770191,79193770189,-2,914,2952,40
79194436068,79194436090,22,100,1444,40
79196137418,79196137413,-5,1123,3901,40
79199194215,79199194209,-6,890,3246,40
79200684352,79200684348,-4,946,3710,40
79204298922,79204298915,-7,1172,3091,40
79206034290,79206034287,-3,662,2593,40
79206365076,79206365058,-18,1035,4286,40
79206941169,79206941163,-6,1234,4530,40
79211614417,79211614413,-4,1103,3506,40
79211740347,79211740341,-6,1231,4258,40
79220026009,79220026002,-7,1115,4017,40
79220402158,79220402170,12,352,2118,40
79221328354,79221328358,4,2824,2261,40
79222265775,79222265767,-8,724,2902,40
79222311732,79222311712,-20,1037,4598,40
79225795250,79225795254,4,1213,1181,40
79231927277,79231927273,-4,1154,2506,40
79232104902,79232104921,19,340,1888,40
79234950941,79234950937,-4,1069,4126,40
79236840126,79236840120,-6,738,3012,40
79236910230,79236910243,13,459,2065,40
79237309007,79237309001,-6,1259,4242,40
79240901894,79240901888,-6,1626,2662,40
79242359908,79242359902,-6,563,2084,40
79256478522,79256478519,-3,2018,2965,40
79256960686,79256960678,-8,989,4203,40
79257738370,79257738364,-6,616,3253,40
79257928468,79257928487,19,230,880,40
79258213141,79258213133,-8,1385,13004,40
79259130798,79259130795,-3,1346,1761,40
79260085695,79260085688,-7,848,5321,40
79264677494,79264677490,-4,1752,5703,40
79265592282,79265592297,15,12289,44883,40
79277762407,79277762406,-1,1236,1398,40
79280093848,79280093843,-5,435,1941,40
79280304111,79280304128,17,431,1378,40
79282649955,79282649949,-6,713,3556,40
79284948181,79284948177,-4,921,2261,40
79285668350,79285668363,13,328,1130,40
79288455307,79288455301,-6,798,2980,40
79288916994,79288916988,-6,444,2150,40
79291895724,79291895717,-7,1080,4160,40
79292819032,79292819046,14,705,3174,40
79297253385,79297253381,-4,1165,2958,40
79298396566,79298396561,-5,1550,5080,40
79305405290,79305405282,-8,693,4712,40
79307021564,79307021579,15,9,535,40
79320154290,79320154291,1,24646,17121,40
79320211293,79320211286,-7,666,3578,40
79323402781,79323402776,-5,858,4086,40
79324303333,79324303351,18,1148,2851,40
79324621567,79324621550,-17,169,2537,40
79324884103,79324884085,-18,984,1871,40
79325013392,79325013407,15,90,762,40
79328173414,79328173407,-7,1467,5832,40
79328883983,79328883978,-5,1064,3200,40
79335922329,79335922322,-7,1035,3793,40
79337421590,79337421591,1,2049,1876,40
79338429402,79338429408,6,3479,1891,40
79343411147,79343411141,-6,1378,5138,40
79344048087,79344048094,7,3157,1099,40
79345673033,79345673025,-8,896,3662,40
79346317999,79346318008,9,11331,32410,40
79346746036,79346746030,-6,1176,4822,40
79347713516,79347713512,-4,807,2154,40
79361433282,79361433277,-5,830,2574,40
79362921202,79362921194,-8,1135,3697,40
79365700364,79365700366,2,2448,2499,40
79367488069,79367488062,-7,729,2552,40
79369348752,79369348746,-6,1452,4397,40
79369630055,79369630051,-4,56,874,40
79372005332,79372005337,5,7892,4209,40
79372754733,79372754731,-2,1883,3019,40
79374210438,79374210443,5,5492,20243,40
79383905036,79383905053,17,881,3633,40
79384634005,79384633994,-11,258,1483,40
79385360283,79385360278,-5,701,2648,40
79385760769,79385760764,-5,1152,3010,40
79386014328,79386014342,14,158,909,40
79386994169,79386994162,-7,930,3347,40
79396519150,79396519138,-12,12827,39462,40
79397060097,79397060089,-8,551,1783,40
79407291714,79407291708,-6,846,2798,40
79423098286,79423098282,-4,636,2229,40
79423926280,79423926274,-6,1084,2502,40
79424526458,79424526452,-6,602,2885,40
79424991069,79424991089,20,869,3892,40
79427253171,79427253164,-7,773,4088,40
79435556619,79435556613,-6,1071,3996,40
79442641350,79442641345,-5,1424,3582,40
79442849978,79442849974,-4,1236,3761,40
79444179430,79444179431,1,1215,2363,40
79451893627,79451893622,-5,898,3255,40
79454944383,79454944378,-5,1148,3306,40
79462800818,79462800812,-6,1075,4591,40
79468145752,79468145746,-6,767,3992,40
79468295008,79468295026,18,421,3201,40
79470068046,79470068041,-5,967,3225,40
79475985738,79475985734,-4,516,1640,40
79490255258,79490255252,-6,677,1999,40
79491295198,79491295205,7,127,831,40
79493442661,79493442658,-3,1242,3068,40
79495863974,79495863968,-6,669,4419,40
79516028441,79516028441,0,1076,1510,40
79519527043,79519527037,-6,869,2090,40
79519997399,79519997393,-6,1043,3814,40
79520491677,79520491670,-7,885,4305,40
79524647230,79524647225,-5,889,3415,40
79524706830,79524706825,-5,1213,4869,40
79529047322,79529047317,-5,813,3196,40
79529307412,79529307405,-7,706,2832,40
79530253718,79530253713,-5,959,5400,40
79533776473,79533776460,-13,1046,3676,40
79538157694,79538157686,-8,1224,4200,40
79539843471,79539843466,-5,828,1948,40
79541140798,79541140794,-4,1195,3351,40
79544478323,79544478317,-6,1126,3533,40
79544629070,79544629066,-4,1199,3686,40
79549522650,79549522646,-4,1311,4381,40
79560217640,79560217641,1,3412,3499,40
79563046111,79563046104,-7,1371,4413,40
79565618973,79565618967,-6,1081,2953,40
79571749031,79571749028,-3,871,2614,40
79578172196,79578172200,4,2411,1966,40
79579725471,79579725465,-6,555,2155,40
79582342518,79582342512,-6,785,3311,40
79583572266,79583572261,-5,1089,3637,40
79583727378,79583727373,-5,1064,3242,40
79584170513,79584170505,-8,1058,3212,40
79584435020,79584435014,-6,630,4318,40
79584993960,79584993975,15,892,3529,40
79585910109,79585910103,-6,1085,4297,40
79586194774,79586194786,12,67,1153,40
79590639506,79590639502,-4,1217,3909,40
79592956950,79592956944,-6,973,3571,40
79605109627,79605109621,-6,813,2412,40
79606299470,79606299462,-8,1185,3935,40
79606355044,79606355037,-7,1355,3629,40
79613252801,79613252807,6,14248,6540,40
79629446315,79629446309,-6,1376,4395,40
79632793878,79632793873,-5,1114,2494,40
79634795542,79634795550,8,4405,1787,40
79638401826,79638401830,4,3279,1133,40
79639056567,79639056562,-5,991,3029,40
79639737218,79639737225,7,3125,1398,40
79640771150,79640771150,0,9398,10932,40
79640852462,79640852482,20,520,3095,40
79651904803,79651904798,-5,944,3848,40
79658549594,79658549589,-5,1018,3169,40
79660457138,79660457132,-6,1003,3402,40
79661497364,79661497370,6,256,1538,40
79662687451,79662687446,-5,897,3491,40
79666244622,79666244617,-5,922,3094,40
79674534414,79674534407,-7,562,2393,40
79674919156,79674919177,21,201,1213,40
79678408685,79678408685,0,907,1005,40
79681387975,79681387969,-6,1302,2938,40
79681876054,79681876072,18,2114,1340,40
79690975834,79690975829,-5,785,4050,40
79695376663,79695376658,-5,1012,2846,40
79695735506,79695735501,-5,1245,5077,40
79697741156,79697741160,4,2604,2102,40
79710143702,79710143706,4,2382,2230,40
79713381109,79713381102,-7,1210,4085,40
79719921666,79719921661,-5,1276,3484,40
79726416182,79726416186,4,1642,1526,40
79745504639,79745504633,-6,617,3620,40
79755652945,79755652939,-6,843,2604,40
79759007166,79759007162,-4,857,1659,40
79764520283,79764520277,-6,751,3508,40
79770233017,79770233011,-6,999,3599,40
79772947198,79772947219,21,354,1333,40
79774939606,79774939600,-6,1437,3980,40
79775985043,79775985038,-5,715,2637,40
79776039396,79776039378,-18,786,4519,40
79785047883,79785047877,-6,852,4425,40
79793310365,79793310359,-6,1143,4676,40
79794253834,79794253827,-7,881,4779,40
79797425579,79797425575,-4,1169,3201,40
79797909391,79797909368,-23,272,1368,40
79800396015,79800396017,2,898,1251,40
79802352493,79802352486,-7,1047,4422,40
79803551883,79803551877,-6,899,4860,40
79807116236,79807116241,5,61,885,40
79807753408,79807753420,12,12998,41816,40
79808367735,79808367730,-5,1316,4261,40
79810607599,79810607593,-6,1148,4551,40
79819280083,79819280077,-6,1126,4055,40
79819507572,79819507591,19,76,1116,40
79825037973,79825037966,-7,1116,3982,40
79825367721,79825367728,7,9287,2588,40
79825541751,79825541745,-6,1296,3910,40
79828483283,79828483276,-7,1089,3245,40
79828512103,79828512115,12,317,1402,40
79828635686,79828635702,16,47,1318,40
79829223558,79829223570,12,59,1120,40
79832322741,79832322739,-2,1485,2105,40
79832908827,79832908822,-5,774,2055,40
79836244508,79836244502,-6,958,3091,40
79840259725,79840259721,-4,1291,4269,40
79843354879,79843354873,-6,898,3616,40
79843432326,79843432317,-9,656,3432,40
79846280206,79846280212,6,4600,1335,40
79847002307,79847002301,-6,947,4427,40
79848289124,79848289121,-3,906,2003,40
79850773326,79850773322,-4,979,4049,40
79853062539,79853062528,-11,861,3788,40
79854215087,79854215082,-5,831,3589,40
79855163590,79855163610,20,1381,5168,40
79855498375,79855498370,-5,579,1165,40
79858404439,79858404431,-8,1203,3047,40
79860788411,79860788407,-4,866,314,40
79864016025,79864016017,-8,704,3929,40
79868691054,79868691048,-6,1293,4034,40
79868969926,79868969918,-8,219,1942,40
79874269873,79874269870,-3,821,2761,40
79881857583,79881857581,-2,1270,1184,40
79892232590,79892232584,-6,957,2661,40
79892759294,79892759288,-6,229,1196,40
79901174565,79901174558,-7,815,4131,40
79908469387,79908469381,-6,1131,3165,40
79911548986,79911548981,-5,879,2632,40
79911645101,79911645118,17,790,3580,40
79914882027,79914882019,-8,1325,4728,40
79915453008,79915453002,-6,1459,4208,40
79918006068,79918006063,-5,1321,5103,40
79918172893,79918172886,-7,1396,4866,40
79930768518,79930768513,-5,942,4510,40
79931243695,79931243698,3,3347,2833,40
79932355286,79932355281,-5,801,4760,40
79932659438,79932659421,-17,1101,4288,40
79937038547,79937038540,-7,625,3009,40
79937716902,79937716897,-5,1073,4439,40
79940351574,79940351571,-3,1118,2238,40
79942055444,79942055438,-6,805,2747,40
79943760475,79943760471,-4,1051,4970,40
79944987170,79944987164,-6,772,1894,40
79946273771,79946273770,-1,710,2123,40
79946694316,79946694335,19,260,1283,40
79947386313,79947386293,-20,1341,3833,40
79950650195,79950650191,-4,844,3607,40
79955611370,79955611365,-5,626,2651,40
79956029586,79956029583,-3,1987,3805,40
79959342482,79959342476,-6,803,2786,40
79964359714,79964359714,0,1306,1351,40
79967458120,79967458126,6,340,1292,40
79968833426,79968833420,-6,923,2691,40
79971950377,79971950374,-3,1131,1962,40
79983869353,79983869348,-5,875,3949,40
79988079421,79988079415,-6,664,3415,40
80018267363,80018267357,-6,1191,3860,40
80023706835,80023706830,-5,1189,2549,40
80027400634,80027400629,-5,577,1883,40
80030441585,80030441578,-7,1180,4734,40
80031360823,80031360818,-5,1163,4218,40
80039025327,80039025319,-8,952,7243,40
80044868171,80044868170,-1,1120,2010,40
80047624439,80047624437,-2,1178,3102,40
80047969369,80047969374,5,1471,755,40
80054235070,80054235072,2,3199,3445,40
80056395381,80056395373,-8,1146,4121,40
80056947740,80056947722,-18,913,2939,40
80063465294,80063465289,-5,908,2747,40
80063694564,80063694585,21,280,1385,40
80068981862,80068981856,-6,590,3051,40
80076509404,80076509397,-7,1024,3482,40
80077287198,80077287191,-7,1404,4677,40
80078251087,80078251080,-7,523,2833,40
80078506950,80078506958,8,146,1103,40
80078963655,80078963641,-14,856,4400,40
80080063110,80080063104,-6,1243,4815,40
80081385631,80081385623,-8,944,3920,40
80082128054,80082128054,0,1658,2332,40
80084694419,80084694413,-6,1043,4050,40
80089075450,80089075445,-5,954,2685,40
80090268713,80090268706,-7,949,3904,40
80091913598,80091913594,-4,950,3648,40
80092894932,80092894950,18,125,1216,40
80095518347,80095518341,-6,755,2456,40
80104968913,80104968906,-7,1019,2563,40
80105512846,80105512843,-3,1643,5019,40
80115905263,80115905258,-5,753,4436,40
80116605413,80116605407,-6,107,1331,40
80117646998,80117646993,-5,1017,3341,40
80126158705,80126158698,-7,1029,3815,40
80137745701,80137745713,12,711,3178,40
80139145472,80139145469,-3,1076,3112,40
80140156717,80140156710,-7,958,3890,40
80141410327,80141410320,-7,904,2792,40
80146631827,80146631822,-5,760,3017,40
80150627320,80150627320,0,18849,20333,40
80160297825,80160297818,-7,1207,6053,40
80167541458,80167541452,-6,1392,6396,40
80170786792,80170786787,-5,1378,3503,40
80170830877,80170830871,-6,1289,3069,40
80171844813,80171844809,-4,977,2641,40
80172293606,80172293599,-7,875,3218,40
80173570285,80173570269,-16,86,1063,40
80185375503,80185375498,-5,1287,4473,40
80190438665,80190438660,-5,1176,3400,40
80190901934,80190901950,16,527,2228,40
80208950943,80208950938,-5,1117,2998,40
80215126218,80215126214,-4,826,2745,40
80215980181,80215980180,-1,2419,3595,40
80219830341,80219830335,-6,1200,3426,40
80220924967,80220924962,-5,1044,3844,40
80222562008,80222562002,-6,1205,4605,40
80222693460,80222693454,-6,1207,3188,40
80223336417,80223336410,-7,25219,14236,40
80223986425,80223986422,-3,23872,11128,40
80228807699,80228807718,19,448,1874,40
80235339362,80235339357,-5,654,3162,40
80237503441,80237503438,-3,899,2694,40
80239981132,80239981126,-6,1330,4740,40
80240502150,80240502166,16,203,908,40
80241980177,80241980173,-4,877,3604,40
80242165875,80242165869,-6,1187,3942,40
80243568687,80243568664,-23,664,437,40
80247278519,80247278514,-5,1145,4082,40
80251480901,80251480895,-6,918,4511,40
80253966075,80253966069,-6,1116,4305,40
80257187065,80257187065,0,2187,2325,40
80263118734,80263118723,-11,1029,5639,40
80266171644,80266171640,-4,835,3482,40
80272357362,80272357358,-4,1342,3233,40
80274035941,80274035938,-3,1066,2212,40
80275120646,80275120641,-5,1215,4220,40
80276270774,80276270768,-6,1039,3606,40
80277361687,80277361691,4,3533,2744,40
80278071091,80278071085,-6,903,3683,40
80279722978,80279722972,-6,1330,3898,40
80287863060,80287863058,-2,2470,3474,40
80291590814,80291590809,-5,802,2605,40
80295240418,80295240417,-1,1510,2723,40
80299856307,80299856301,-6,881,4020,40
80305571613,80305571627,14,14146,28595,40
80311645847,80311645843,-4,1366,2315,40
80331086698,80331086691,-7,1250,3408,40
80333685766,80333685762,-4,1013,2939,40
80338228321,80338228314,-7,733,3128,40
80339459586,80339459592,6,1465,1372,40
80360697373,80360697376,3,4860,19754,40
80361096831,80361096831,0,31348,19171,40
80364521702,80364521695,-7,915,3394,40
80374475100,80374475098,-2,55202,27958,40
80382600994,80382600986,-8,891,3151,40
80384463777,80384463783,6,6210,2096,40
80394194475,80394194469,-6,682,4593,40
80395090081,80395090075,-6,1190,3952,40
80396113821,80396113822,1,6460,6924,40
80398655306,80398655301,-5,1322,3202,40
80403631346,80403631339,-7,1241,4588,40
80407603957,80407603958,1,4559,47562,40
80411554177,80411554170,-7,495,1441,40
80412935734,80412935714,-20,72,1550,40
80413857504,80413857515,11,323,770,40
80415623103,80415623097,-6,1109,3343,40
80416240742,80416240755,13,276,1395,40
80420633006,80420633002,-4,1812,3316,40
80422181646,80422181630,-16,5,1299,40
80429522033,80429522026,-7,1079,3483,40
80443543505,80443543497,-8,708,2362,40
80459362422,80459362413,-9,850,2725,40
80466517825,80466517820,-5,1185,4428,40
80466614615,80466614627,12,202,1148,40
80471574825,80471574821,-4,788,2979,40
80471654334,80471654313,-21,709,3208,40
80474503511,80474503505,-6,696,3792,40
80480949719,80480949709,-10,779,1600,40
80482266527,80482266521,-6,718,3137,40
80482693639,80482693632,-7,1155,2963,40
80498997319,80498997320,1,1352,1656,40
80500403592,80500403586,-6,1423,4637,40
80500601863,80500601858,-5,836,2949,40
80502488100,80502488095,-5,1278,3572,40
80510902287,80510902282,-5,822,3676,40
80529715178,80529715173,-5,1023,2090,40
80543390318,80543390314,-4,1050,4161,40
80546238273,80546238275,2,1281,1264,40
80558851589,80558851583,-6,1228,4079,40
80569155107,80569155102,-5,1021,3258,40
80572888430,80572888424,-6,967,3128,40
80577658376,80577658378,2,3775,21583,40
80579667774,80579667773,-1,1874,1992,40
80581796479,80581796473,-6,1167,3690,40
80582385798,80582385812,14,299,1306,40
80583312906,80583312898,-8,1056,3905,40
80584095324,80584095341,17,101,2000,40
80590646956,80590646951,-5,985,3527,40
80593498139,80593498133,-6,1352,3610,40
80598291483,80598291477,-6,1008,4032,40
80601094792,80601094787,-5,924,3633,40
80602091191,80602091183,-8,835,3814,40
80602812704,80602812697,-7,812,4363,40
80607574126,80607574121,-5,1597,4302,40
80608802843,80608802842,-1,1699,1551,40
80610209835,80610209831,-4,901,3024,40
80613214402,80613214397,-5,1110,4221,40
80613435412,80613435396,-16,289,1191,40
80618921642,80618921636,-6,1420,3582,40
80619716542,80619716537,-5,911,2750,40
80619897094,80619897086,-8,111,837,40
80620799544,80620799525,-19,668,2913,40
80621165325,80621165346,21,374,767,40
80625300184,80625300178,-6,1026,4101,40
80626160909,80626160914,5,30270,16090,40
80626754268,80626754262,-6,622,2053,40
80634007354,80634007334,-20,979,1112,40
80639062241,80639062234,-7,1415,5039,40
80645489239,80645489231,-8,1412,5161,40
80647555926,80647555938,12,553,2478,40
80651105819,80651105815,-4,2351,7705,40
80654183198,80654183193,-5,1398,4035,40
80663618345,80663618338,-7,890,2431,40
80663828347,80663828341,-6,1181,3755,40
80670557253,80670557253,0,2338,2955,40
80674929089,80674929083,-6,917,3053,40
80676487601,80676487595,-6,1109,3318,40
80677551587,80677551581,-6,1042,3514,40
80685399643,80685399642,-1,1502,2344,40
80687171715,80687171709,-6,808,3886,40
80689909586,80689909582,-4,798,2919,40
80710734172,80710734177,5,2559,1399,40
80711186002,80711186016,14,1679,657,40
80727731495,80727731491,-4,976,2943,40
80728986158,80728986152,-6,926,4651,40
80730296052,80730296050,-2,1132,1928,40
80734511855,80734511847,-8,757,6506,40
80740611662,80740611656,-6,970,4830,40
80743919831,80743919826,-5,1041,3815,40
80745255722,80745255719,-3,20423,8517,40
80745713427,80745713430,3,5145,18907,40
80748424812,80748424805,-7,1206,4740,40
80753053527,80753053531,4,1785,895,40
80757253346,80757253341,-5,913,2519,40
80764481599,80764481594,-5,839,3578,40
80767373663,80767373656,-7,606,2614,40
80775066202,80775066197,-5,1040,3220,40
80777696050,80777696037,-13,264,2074,40
80788334186,80788334181,-5,840,3881,40
80791157046,80791157038,-8,1370,3893,40
80794346222,80794346214,-8,1231,3966,40
80796326874,80796326873,-1,367,848,40
80798388956,80798388950,-6,715,4151,40
80801142033,80801142023,-10,550,4520,40
80801242783,80801242790,7,4212,2074,40
80804517795,80804517787,-8,897,4895,40
80806947326,80806947320,-6,1084,2451,40
80813643039,80813643039,0,921,1091,40
80819585846,80819585838,-8,1247,3554,40
80830343318,80830343312,-6,1177,3560,40
80834676110,80834676105,-5,985,3337,40
80842150478,80842150487,9,9360,36372,40
80848427307,80848427302,-5,703,2557,40
80848544444,80848544433,-11,44,1548,40
80852447723,80852447723,0,2885,3561,40
80855298752,80855298774,22,406,1143,40
80862291975,80862291972,-3,1070,3492,40
80873007525,80873007519,-6,734,3270,40
80873078346,80873078341,-5,935,4049,40
80874938575,80874938570,-5,1188,4773,40
80875153352,80875153366,14,424,1430,40
80876166900,80876166902,2,1633,1065,40
80900493824,80900493841,17,305,2404,40
80903702811,80903702806,-5,1940,8407,40
80909422847,80909422842,-5,758,3895,40
80910025960,80910025954,-6,840,2915,40
80910071391,80910071402,11,275,817,40
80915742272,80915742267,-5,1066,3838,40
80916617380,80916617366,-14,861,3521,40
80917776080,80917776074,-6,1253,2834,40
80917939109,80917939106,-3,3,1386,40
80929327719,80929327714,-5,1008,4118,40
80929595004,80929594991,-13,233,1509,40
80931165994,80931165988,-6,1242,4638,40
80931442445,80931442467,22,1031,3427,40
80931503582,80931503577,-5,756,3878,40
80939874676,80939874671,-5,1080,4963,40
80940000511,80940000513,2,98,1260,40
80944589751,80944589745,-6,1110,2892,40
80951265509,80951265503,-6,1261,4185,40
80953547011,80953547015,4,29513,26848,40
80967713065,80967713059,-6,1033,3354,40
80969380039,80969380033,-6,1271,2584,40
80969515326,80969515321,-5,830,3874,40
80977667320,80977667311,-9,1223,3564,40
80979694826,80979694833,7,8489,1904,40
80986085077,80986085069,-8,1124,4992,40
80986702511,80986702506,-5,1253,4330,40
80987494005,80987494002,-3,155,1269,40
80993443771,80993443768,-3,1036,1567,40
81000956895,81000956889,-6,973,3464,40
81002025533,81002025526,-7,1130,3941,40
81002999786,81002999782,-4,1236,3816,40
81010359526,81010359521,-5,1210,3452,40
81011062607,81011062601,-6,1155,3242,40
81011739594,81011739589,-5,1010,2854,40
81013284308,81013284292,-16,1175,4043,40
81020876123,81020876118,-5,1017,2886,40
81021300843,81021300825,-18,2810,1281,40
81026710382,81026710376,-6,830,3075,40
81035210601,81035210603,2,2106,1570,40
81037133550,81037133556,6,6621,2796,40
81039561333,81039561332,-1,1663,1107,40
81040816026,81040816021,-5,687,2267,40
81043598089,81043598085,-4,1606,5129,40
81045079254,81045079249,-5,917,2613,40
81051225611,81051225605,-6,865,2980,40
81052366010,81052366006,-4,773,3140,40
81054401876,81054401869,-7,991,3391,40
81062263333,81062263327,-6,1077,2309,40
81062584711,81062584707,-4,1479,3788,40
81071012161,81071012156,-5,1176,4108,40
81071127178,81071127173,-5,968,3250,40
81074752886,81074752879,-7,1210,4589,40
81077944107,81077944103,-4,1073,2867,40
81079316271,81079316267,-4,1191,3940,40
81080280516,81080280539,23,178,986,40
81082277279,81082277281,2,966,1353,40
81093918365,81093918360,-5,676,3893,40
81098197894,81098197901,7,1290,1145,40
81102534574,81102534566,-8,1116,4651,40
81107906861,81107906854,-7,880,3746,40
81108468965,81108468981,16,307,1007,40
81108792277,81108792272,-5,1143,3640,40
81111771784,81111771777,-7,2357,6031,40
81114022334,81114022354,20,29,629,40
81114675367,81114675363,-4,451,1901,40
81115069853,81115069866,13,720,2559,40
81129690546,81129690541,-5,782,4667,40
81151129866,81151129873,7,28099,3497,40
81151655742,81151655741,-1,979,2268,40
81151777687,81151777707,20,913,4540,40
81151960591,81151960586,-5,982,3123,40
81154814862,81154814855,-7,926,3685,40
81154918686,81154918690,4,3500,1532,40
81157643581,81157643574,-7,1090,4647,40
81158935834,81158935830,-4,1094,3108,40
81165100349,81165100340,-9,347,3063,40
81165204583,81165204571,-12,81,1083,40
81172384470,81172384465,-5,932,2949,40
81172496430,81172496437,7,100,1079,40
81172538943,81172538925,-18,264,1185,40
81177040794,81177040805,11,15551,36637,40
81179503502,81179503499,-3,991,2944,40
81181960329,81181960324,-5,1075,3756,40
81184948882,81184948878,-4,421,1506,40
81185776931,81185776926,-5,789,2131,40
81189183506,81189183500,-6,1334,4034,40
81195028546,81195028562,16,759,3288,40
81196867510,81196867506,-4,1208,2423,40
81198367551,81198367546,-5,930,3172,40
81213308618,81213308614,-4,608,2556,40
81217649226,81217649220,-6,1172,4429,40
81218020780,81218020775,-5,1287,2859,40
81219639569,81219639562,-7,1153,3815,40
81225986211,81225986198,-13,2196,783,40
81229740407,81229740403,-4,1414,3679,40
81236820935,81236820930,-5,1083,3809,40
81236994574,81236994591,17,1112,1735,40
81239631267,81239631273,6,2628,1193,40
81244911199,81244911195,-4,874,2762,40
81248984222,81248984217,-5,792,4353,40
81249217190,81249217210,20,696,2301,40
81267099490,81267099490,0,1507,1175,40
81270831884,81270831882,-2,1194,1979,40
81273780990,81273780985,-5,3836,10339,40
81277605896,81277605901,5,3288,1898,40
81290551218,81290551226,8,7963,3353,40
81290928823,81290928815,-8,648,1874,40
81295902859,81295902853,-6,1535,3997,40
81299069884,81299069905,21,1118,3427,40
81301915955,81301915948,-7,958,2928,40
81303601842,81303601854,12,200,939,40
81307948146,81307948149,3,2327,1225,40
81307998496,81307998490,-6,997,1781,40
81315308862,81315308857,-5,1160,3964,40
81319983981,81319984002,21,2790,1672,40
81321400454,81321400449,-5,935,5062,40
81326140444,81326140438,-6,1499,3837,40
81331199734,81331199728,-6,1276,3678,40
81332625404,81332625427,23,154,945,40
81335117839,81335117829,-10,706,2907,40
81337600263,81337600257,-6,1252,3537,40
81338242574,81338242570,-4,58,1094,40
81344542978,81344542972,-6,955,4318,40
81357635097,81357635091,-6,867,3755,40
81359556943,81359556930,-13,285,1448,40
81366574694,81366574693,-1,730,1141,40
81369318218,81369318216,-2,1543,2977,40
81369755918,81369755911,-7,812,3234,40
81370952047,81370952041,-6,946,3296,40
81372375475,81372375470,-5,1436,4593,40
81372727898,81372727901,3,987,1124,40
81380339518,81380339512,-6,935,4624,40
81380445285,81380445304,19,1294,5132,40
81381511218,81381511218,0,1980,1276,40
81384556410,81384556405,-5,1024,2804,40
81386622600,81386622593,-7,1193,3894,40
81392917707,81392917698,-9,609,2895,40
81395440822,81395440814,-8,884,4314,40
81398406833,81398406828,-5,1237,4229,40
81410034473,81410034461,-12,29747,16219,40
81411993301,81411993294,-7,1532,4370,40
81412139245,81412139226,-19,262,1123,40
81415023174,81415023171,-3,845,1641,40
81415301212,81415301197,-15,190,1405,40
81418408578,81418408580,2,1469,1981,40
81420277089,81420277111,22,368,1499,40
81427402403,81427402397,-6,880,2412,40
81432791566,81432791561,-5,985,2748,40
81435375384,81435375401,17,877,2854,40
81448756421,81448756416,-5,1062,3675,40
81454015034,81454015029,-5,1101,2809,40
81454185288,81454185283,-5,19534,70632,40
81456898273,81456898266,-7,961,4228,40
81457257236,81457257221,-15,1108,4960,40
81467624602,81467624601,-1,2028,2934,40
81468915719,81468915709,-10,303,1295,40
81469641406,81469641411,5,244,2872,40
81482317785,81482317779,-6,1223,3865,40
81494010218,81494010213,-5,935,4650,40
81501194082,81501194075,-7,929,3649,40
81501617855,81501617849,-6,1093,4406,40
81503582426,81503582419,-7,1184,3208,40
81506369403,81506369397,-6,1038,3904,40
81508205060,81508205054,-6,1234,4168,40
81515089487,81515089481,-6,1421,5497,40
81522125080,81522125089,9,14516,25362,40
81525109875,81525109873,-2,1167,2342,40
81527177856,81527177850,-6,1200,3041,40
81530673851,81530673852,1,8101,9114,40
81531172014,81531172010,-4,1744,3755,40
81536866559,81536866552,-7,1238,4865,40
81541919170,81541919161,-9,1082,6408,40
81546081916,81546081910,-6,213,1544,40
81548408870,81548408865,-5,1321,5457,40
81561267418,81561267411,-7,776,4034,40
81562346143,81562346133,-10,621,2723,40
81566590585,81566590592,7,5001,2746,40
81575647075,81575647070,-5,742,3143,40
81580090185,81580090178,-7,537,2062,40
81585410750,81585410746,-4,1958,6196,40
81587216657,81587216651,-6,737,2307,40
81589114340,81589114334,-6,1075,3612,40
81590000206,81590000194,-12,762,3232,40
81592337999,81592337995,-4,907,4020,40
81593957519,81593957515,-4,861,2522,40
81594050280,81594050294,14,816,5353,40
81594765739,81594765734,-5,1109,3607,40
81595039567,81595039560,-7,841,3948,40
81596744834,81596744830,-4,467,2227,40
81605636129,81605636124,-5,1094,3415,40
81612292158,81612292177,19,1087,3171,40
81613849174,81613849186,12,941,4987,40
81618460203,81618460197,-6,990,3224,40
81627499541,81627499534,-7,2376,7318,40
81641044141,81641044134,-7,745,2756,40
81644146020,81644146014,-6,1012,3790,40
81649283971,81649283966,-5,885,2888,40
81652042148,81652042142,-6,1402,4808,40
81659048440,81659048434,-6,991,3738,40
81659809287,81659809280,-7,958,4453,40
81660316095,81660316086,-9,116,874,40
81668036425,81668036419,-6,896,3628,40
81669763050,81669763059,9,12614,28888,40
81674112598,81674112592,-6,632,2539,40
81679903512,81679903508,-4,512,3280,40
81680055694,81680055678,-16,1261,5217,40
81687029533,81687029527,-6,983,4083,40
81699246838,81699246834,-4,952,3180,40
81704389615,81704389610,-5,799,3382,40
81713822640,81713822639,-1,2781,3824,40
81715480720,81715480725,5,4651,2070,40
81716218945,81716218939,-6,1114,3380,40
81716475354,81716475350,-4,738,1301,40
81718087234,81718087240,6,2780,1055,40
81719363382,81719363376,-6,785,2596,40
81720905976,81720905956,-20,5464,3744,40
81723882090,81723882086,-4,1335,2477,40
81727670404,81727670396,-8,1080,3305,40
81734225006,81734225000,-6,831,2615,40
81737788733,81737788734,1,2452,1580,40
81738176018,81738176025,7,4595,1824,40
81742952942,81742952936,-6,1262,3185,40
81743494190,81743494186,-4,1016,3833,40
81749877188,81749877193,5,5933,2999,40
81753931461,81753931457,-4,735,2967,40
81754703710,81754703718,8,341,1694,40
81762725887,81762725882,-5,1164,4012,40
81766264897,81766264903,6,5996,1883,40
81768670347,81768670329,-18,988,2222,40
81779029742,81779029737,-5,1190,3889,40
81782554318,81782554313,-5,1014,1941,40
81783538196,81783538176,-20,656,4016,40
81795554782,81795554778,-4,1008,3019,40
81796571452,81796571459,7,2449,1104,40
81802622446,81802622441,-5,918,2947,40
81804822090,81804822082,-8,1037,3095,40
81804977197,81804977181,-16,288,1123,40
81805349740,81805349734,-6,1514,3692,40
81812086167,81812086178,11,470,1378,40
81816121051,81816121045,-6,902,2645,40
81816596126,81816596146,20,323,1368,40
81822256379,81822256373,-6,1293,2940,40
81826473858,81826473855,-3,607,2270,40
81828694046,81828694040,-6,1337,8580,40
81833601487,81833601481,-6,899,4579,40
81835021722,81835021721,-1,1601,2220,40
81838814562,81838814557,-5,1113,2430,40
81839802518,81839802525,7,3,1246,40
81843839782,81843839778,-4,971,2907,40
81849817958,81849817951,-7,1331,2950,40
81858626621,81858626627,6,1959,1040,40
81860931629,81860931625,-4,1412,4743,40
81867375771,81867375766,-5,1394,4507,40
81869967306,81869967300,-6,894,3081,40
81871297694,81871297706,12,155,1311,40
81877928033,81877928029,-4,1257,5863,40
81879056845,81879056852,7,4294,1989,40
81885481850,81885481845,-5,1220,4574,40
81890949690,81890949685,-5,976,2779,40
81891529022,81891529043,21,290,1593,40
81893889727,81893889721,-6,825,3117,40
81894614421,81894614418,-3,1052,2397,40
81894919638,81894919631,-7,1431,4455,40
81895045904,81895045914,10,537,2733,40
81898269914,81898269910,-4,1340,2924,40
81899603323,81899603330,7,1544,18647,40
81911871526,81911871522,-4,795,3357,40
81913425962,81913425956,-6,1312,4076,40
81913960932,81913960926,-6,751,3252,40
81919294509,81919294511,2,2103,1716,40
81919433342,81919433346,4,2843,1904,40
81921546070,81921546064,-6,1301,3213,40
81922628866,81922628862,-4,667,2741,40
81923141815,81923141833,18,572,2788,40
81923960656,81923960659,3,1196,1144,40
81924271863,81924271846,-17,1219,4995,40
81925121054,81925121042,-12,284,842,40
81925575190,81925575185,-5,1243,2846,40
81927220269,81927220265,-4,970,3654,40
81928171582,81928171576,-6,1002,3299,40
81928264632,81928264646,14,240,1222,40
81933344946,81933344938,-8,922,3392,40
81933857510,81933857528,18,462,1758,40
81945232958,81945232957,-1,1068,1720,40
81945375199,81945375216,17,15378,45825,40
81948946530,81948946530,0,2011,2662,40
81951628822,81951628829,7,5262,1965,40
81953710767,81953710762,-5,824,3281,40
81959669927,81959669921,-6,1066,3615,40
81963719441,81963719437,-4,1201,4236,40
81965894566,81965894561,-5,1579,4701,40
81966173900,81966173890,-10,340,789,40
81966373485,81966373506,21,474,1584,40
81974647306,81974647310,4,2610,1508,40
81976298202,81976298195,-7,2873,10809,40
81977324742,81977324737,-5,1128,3655,40
81987093703,81987093702,-1,2513,4485,40
81988642131,81988642125,-6,705,2466,40
81988972534,81988972514,-20,85,1151,40
81990606263,81990606261,-2,1154,2367,40
81992936026,81992936029,3,3163,2613,40
81993179205,81993179202,-3,1017,2235,40
81993954814,81993954805,-9,1370,3525,40
81995309157,81995309171,14,509,2016,40
81998403675,81998403670,-5,738,2455,40
82002773291,82002773283,-8,371,2832,40
82004115078,82004115061,-17,174,812,40
82005313614,82005313614,0,1548,2957,40
82006484075,82006484069,-6,927,4089,40
82007527458,82007527452,-6,1240,4220,40
82008067812,82008067826,14,28,895,40
82009626499,82009626498,-1,903,1569,40
82009796103,82009796087,-16,210,723,40
82013597540,82013597533,-7,839,3536,40
82016100663,82016100663,0,1399,1496,40
82023460474,82023460470,-4,1057,2324,40
82029141914,82029141906,-8,1508,4055,40
82029631934,82029631933,-1,1381,2452,40
82032673911,82032673905,-6,694,2780,40
82033978751,82033978732,-19,1744,1083,40
82040160358,82040160352,-6,907,3618,40
82041817591,82041817586,-5,781,4097,40
82051544438,82051544432,-6,1206,3853,40
82053747538,82053747533,-5,624,3157,40
82054850394,82054850389,-5,1285,5019,40
82054955534,82054955545,11,748,2902,40
82059536766,82059536759,-7,1014,3578,40
82061878181,82061878175,-6,1211,3979,40
82069269977,82069269969,-8,876,4508,40
82071933093,82071933089,-4,1755,4095,40
82085965978,82085965971,-7,1427,3784,40
82088388774,82088388768,-6,865,5222,40
82092480491,82092480486,-5,852,2007,40
82094359457,82094359450,-7,837,4596,40
82094929012,82094929006,-6,1436,4549,40
82102765191,82102765186,-5,927,2732,40
82103898685,82103898696,11,121,1134,40
82109309034,82109309037,3,1969,1281,40
82118754206,82118754199,-7,784,3307,40
82118981363,82118981357,-6,863,3178,40
82120963994,82120963990,-4,418,1365,40
82121812062,82121812057,-5,762,2967,40
82121893877,82121893858,-19,101,1467,40
82123645694,82123645690,-4,969,4375,40
82128661761,82128661756,-5,933,3374,40
82129299651,82129299646,-5,902,3297,40
82132843125,82132843131,6,2194,1131,40
82133229078,82133229082,4,35337,18492,40
82135319889,82135319884,-5,1582,4912,40
82137820917,82137820910,-7,991,4130,40
82141180970,82141180964,-6,1351,4775,40
82144270206,82144270201,-5,1371,4706,40
82147841503,82147841496,-7,1139,4534,40
82157247982,82157247975,-7,877,3720,40
82160708671,82160708664,-7,757,4064,40
82162929670,82162929665,-5,1026,4143,40
82173172350,82173172351,1,1291,1276,40
82174047069,82174047063,-6,763,3584,40
82175822279,82175822274,-5,1107,5103,40
82187442478,82187442473,-5,1136,4127,40
82187669540,82187669537,-3,209,1071,40
82194821298,82194821292,-6,997,3350,40
82195303938,82195303944,6,2129,1021,40
82195698324,82195698334,10,1409,130,40
82210267530,82210267524,-6,770,2798,40
82216249658,82216249663,5,394,1149,40
82222367313,82222367318,5,3013,1533,40
82232090656,82232090648,-8,463,2113,40
82232285032,82232285037,5,60,843,40
82236952086,82236952078,-8,1148,5651,40
82237207566,82237207581,15,329,1840,40
82239387309,82239387305,-4,1452,4102,40
82243400081,82243400075,-6,1615,3819,40
82249121347,82249121342,-5,814,2832,40
82250435173,82250435187,14,186,1148,40
82259962638,82259962634,-4,1100,2807,40
82262680081,82262680075,-6,670,3713,40
82264041209,82264041202,-7,1048,4299,40
82264932910,82264932901,-9,888,3960,40
82265091863,82265091882,19,908,2787,40
82272798698,82272798702,4,1246,728,40
82277776884,82277776876,-8,1216,5262,40
82278005108,82278005101,-7,694,3913,40
82282941400,82282941393,-7,985,3435,40
82283457909,82283457902,-7,1147,3533,40
82284203662,82284203657,-5,781,3389,40
82286683582,82286683586,4,2082,1580,40
82288671595,82288671589,-6,769,4537,40
82307389013,82307389006,-7,688,3486,40
82309769189,82309769190,1,1327,1480,40
82311850156,82311850150,-6,1133,3464,40
82322644563,82322644558,-5,759,2038,40
82323497925,82323497945,20,809,3541,40
82335856693,82335856687,-6,1203,4154,40
82336370854,82336370868,14,16323,39970,40
82339987518,82339987511,-7,1571,4637,40
82340543720,82340543714,-6,1545,4187,40
82347979794,82347979791,-3,1209,2229,40
82350000214,82350000207,-7,965,3010,40
82352797338,82352797340,2,1356,1732,40
82354308155,82354308150,-5,1193,2953,40
82366395612,82366395627,15,960,4044,40
82367629205,82367629205,0,1531,2676,40
82371340139,82371340133,-6,1042,3332,40
82375712818,82375712812,-6,756,2431,40
82375738518,82375738534,16,1076,3686,40
82385307858,82385307850,-8,938,3918,40
82392317087,82392317082,-5,1390,5458,40
82403574526,82403574522,-4,1128,3367,40
82410397665,82410397659,-6,821,2710,40
82410797285,82410797269,-16,111,1396,40
82414263762,82414263765,3,2259,2374,40
82423983590,82423983584,-6,1151,4450,40
82424420145,82424420139,-6,892,3339,40
82426890242,82426890248,6,1569,926,40
82430848766,82430848758,-8,705,1680,40
82431896870,82431896864,-6,1217,4097,40
82442171773,82442171774,1,1092,1433,40
82442472617,82442472611,-6,1019,3031,40
82443673022,82443673016,-6,754,2850,40
82445629747,82445629742,-5,753,2782,40
82446263557,82446263574,17,438,2077,40
82446838718,82446838713,-5,1128,3405,40
82458644695,82458644688,-7,933,2797,40
82458753005,82458753022,17,1731,4251,40
82461367462,82461367469,7,3702,1594,40
82462696050,82462696045,-5,1067,3513,40
82471160774,82471160769,-5,949,3369,40
82476833031,82476833023,-8,1101,4790,40
82487356182,82487356178,-4,946,3448,40
82490951301,82490951300,-1,1953,2270,40
82492228088,82492228096,8,18769,20065,40
82492441693,82492441698,5,2537,1699,40
82497235577,82497235572,-5,699,2485,40
82497407811,82497407806,-5,1046,3898,40
82497508343,82497508321,-22,652,3725,40
82502091056,82502091074,18,874,2583,40
82510677510,82510677515,5,4158,1838,40
82514302738,82514302733,-5,1092,3956,40
82515724358,82515724365,7,4917,1874,40
82530560620,82530560624,4,24697,20778,40
82536576987,82536576984,-3,711,3471,40
82538083290,82538083298,8,13624,28199,40
82539074313,82539074307,-6,725,3392,40
82539649086,82539649093,7,47,738,40
82544266313,82544266319,6,2749,1466,40
82544741634,82544741629,-5,1047,3632,40
82546445231,82546445226,-5,956,2699,40
82549898648,82549898642,-6,571,2565,40
82553009749,82553009742,-7,2188,9236,40
82560103508,82560103502,-6,1258,3812,40
82560540047,82560540026,-21,379,1483,40
82560768471,82560768465,-6,1340,5469,40
82564826335,82564826330,-5,1021,3971,40
82568588818,82568588813,-5,963,3258,40
82569093671,82569093668,-3,750,2354,40
82582500241,82582500236,-5,690,3613,40
82593954022,82593954019,-3,1360,3247,40
82600272202,82600272198,-4,829,2679,40
82603325706,82603325698,-8,1140,3817,40
82605904403,82605904397,-6,1225,3763,40
82608056939,82608056931,-8,638,3038,40
82612438771,82612438766,-5,1087,4291,40
82615013531,82615013527,-4,886,2716,40
82621401171,82621401166,-5,797,2972,40
82627676899,82627676903,4,2779,1288,40
82632227872,82632227878,6,3458,1010,40
82634898683,82634898678,-5,988,2297,40
82635785274,82635785269,-5,849,2180,40
82636042672,82636042690,18,962,3052,40
82645782107,82645782113,6,2398,1475,40
82649444231,82649444247,16,388,1642,40
82651911101,82651911096,-5,859,4536,40
82662605146,82662605140,-6,865,3068,40
82663039277,82663039258,-19,1131,4003,40
82665430946,82665430941,-5,1037,2755,40
82665637894,82665637882,-12,146,1605,40
82665813840,82665813859,19,209,1066,40
82667086455,82667086438,-17,153,1249,40
82667460737,82667460730,-7,875,4093,40
82669089542,82669089535,-7,1139,4325,40
82678213002,82678212995,-7,785,3193,40
82678363098,82678363092,-6,1014,3092,40
82682298629,82682298623,-6,1491,4204,40
82688613195,82688613193,-2,1543,3161,40
82693484396,82693484402,6,3591,2302,40
82695591143,82695591134,-9,980,3751,40
82702813981,82702813976,-5,1046,3451,40
82719176456,82719176462,6,131,2048,40
82719987559,82719987553,-6,1218,3363,40
82721806832,82721806827,-5,1012,3981,40
82726845678,82726845682,4,4893,2218,40
82727750717,82727750717,0,1964,2289,40
82729328805,82729328785,-20,90,1011,40
82735072867,82735072886,19,660,3437,40
82739368931,82739368926,-5,1161,4513,40
82742499181,82742499174,-7,209,1296,40
82742902526,82742902520,-6,746,2698,40
82749722215,82749722209,-6,1121,4230,40
82761040771,82761040766,-5,982,2426,40
82764656898,82764656893,-5,886,3089,40
82766264918,82766264911,-7,972,3950,40
82768112203,82768112197,-6,837,3935,40
82773744646,82773744647,1,1564,1953,40
82774372610,82774372604,-6,1306,3748,40
82774771557,82774771574,17,456,1176,40
82778040869,82778040863,-6,1262,4083,40
82781129555,82781129546,-9,766,4048,40
82786798951,82786798943,-8,793,5637,40
82786946768,82786946786,18,900,2690,40
82788414110,82788414102,-8,702,4756,40
82788934550,82788934565,15,693,2647,40
82792214382,82792214390,8,1380,732,40
82792474934,82792474931,-3,1066,3207,40
82807193350,82807193347,-3,1287,1692,40
82807839037,82807839039,2,1670,1341,40
82810422844,82810422838,-6,905,4505,40
82810610262,82810610251,-11,62,1037,40
82815336206,82815336201,-5,1031,3061,40
82815567986,82815567980,-6,1078,3714,40
82818646982,82818646975,-7,1404,5915,40
82820225188,82820225183,-5,1015,3156,40
82825825790,82825825782,-8,921,3647,40
82827861589,82827861584,-5,938,2502,40
82835007313,82835007318,5,4580,2228,40
82839238959,82839238954,-5,957,2750,40
82841675621,82841675622,1,5631,7429,40
82846247955,82846247949,-6,711,3261,40
82846942822,82846942802,-20,810,3359,40
82849406799,82849406793,-6,1356,3950,40
82849731817,82849731812,-5,416,1044,40
82849867536,82849867530,-6,911,3412,40
82856062450,82856062442,-8,824,3795,40
82864572451,82864572443,-8,851,3493,40
82864701492,82864701478,-14,665,2487,40
82868132715,82868132709,-6,1223,2505,40
82868735221,82868735213,-8,780,3292,40
82869348438,82869348439,1,21939,94868,40
82869446451,82869446447,-4,779,2668,40
82874799050,82874799045,-5,836,2434,40
82875320962,82875320957,-5,1377,3789,40
82876309011,82876309013,2,1308,1539,40
82878484151,82878484147,-4,790,3716,40
82879308765,82879308745,-20,702,4086,40
82879716455,82879716458,3,466,1733,40
82880902831,82880902825,-6,1089,3768,40
82882431331,82882431329,-2,1306,2388,40
82884261728,82884261734,6,4830,2113,40
82887635791,82887635784,-7,1323,6525,40
82896871459,82896871454,-5,941,3070,40
82897072840,82897072853,13,402,1890,40
82903402929,82903402923,-6,762,3779,40
82905200836,82905200851,15,657,5033,40
82910285085,82910285079,-6,1025,4867,40
82913556828,82913556822,-6,774,1711,40
82915355792,82915355785,-7,1042,4496,40
82917989440,82917989448,8,16043,23475,40
82923712270,82923712266,-4,736,2546,40
82932268590,82932268585,-5,807,3310,40
82934149021,82934149014,-7,1381,4066,40
82934392600,82934392616,16,291,1598,40
82934482709,82934482702,-7,1084,4298,40
82937043772,82937043766,-6,729,2151,40
82940366850,82940366844,-6,825,4378,40
82941831252,82941831246,-6,1230,4728,40
82944765087,82944765083,-4,719,3380,40
82944823142,82944823121,-21,143,980,40
82945649691,82945649687,-4,795,1348,40
82950412641,82950412634,-7,883,2940,40
82957535723,82957535717,-6,684,2143,40
82957700086,82957700088,2,1392,1776,40
82959206988,82959206982,-6,1259,4399,40
82960036263,82960036267,4,203,583,40
82960313390,82960313383,-7,96,1289,40
82962341219,82962341215,-4,1003,3145,40
82969079319,82969079313,-6,1014,3344,40
82969612383,82969612360,-23,228,1934,40
82969878326,82969878320,-6,316,1508,40
82970423295,82970423283,-12,73,955,40
82973256821,82973256815,-6,145,1065,40
82976161202,82976161194,-8,967,4000,40
82990242551,82990242545,-6,1007,3298,40
82996316818,82996316813,-5,688,4141,40
83005441657,83005441649,-8,46036,13415,40
83017804154,83017804148,-6,1114,5012,40
83021499530,83021499522,-8,1247,4122,40
83023512636,83023512629,-7,1138,3903,40
83027118818,83027118818,0,987,1714,40
83031427192,83031427199,7,2889,1096,40
83041601671,83041601666,-5,856,3907,40
83044948603,83044948597,-6,1260,5060,40
83046124695,83046124690,-5,735,3087,40
83046405952,83046405965,13,611,2469,40
83051624082,83051624077,-5,776,2268,40
83055034680,83055034673,-7,963,5018,40
83061253706,83061253701,-5,1229,4151,40
83062206059,83062206053,-6,979,3314,40
83068016304,83068016299,-5,890,2363,40
83072000210,83072000207,-3,1852,2967,40
83074482886,83074482880,-6,1371,4332,40
83074658207,83074658222,15,202,1120,40
83083431393,83083431388,-5,1022,2649,40
83084234164,83084234149,-15,1123,2428,40
83084684814,83084684835,21,1716,1941,40
83087761697,83087761693,-4,1113,3094,40
83088294665,83088294657,-8,37877,15348,40
83088586722,83088586719,-3,1633,2296,40
83096903390,83096903386,-4,994,4693,40
83100487062,83100487056,-6,1250,3532,40
83103992870,83103992865,-5,1249,2975,40
83107404639,83107404653,14,812,3095,40
83111475030,83111475024,-6,885,3954,40
83112674438,83112674449,11,908,1218,40
83117080766,83117080772,6,2395,1285,40
83121608881,83121608887,6,2520,1305,40
83127958785,83127958780,-5,1212,4079,40
83128228086,83128228101,15,608,2048,40
83131124077,83131124077,0,1447,3006,40
83133650649,83133650642,-7,1045,3774,40
83133704432,83133704451,19,739,2428,40
83134156261,83134156257,-4,1250,3217,40
83143144270,83143144265,-5,1235,3712,40
83147348646,83147348638,-8,1154,4614,40
83152385662,83152385658,-4,893,3598,40
83152834100,83152834082,-18,1079,2967,40
83152933438,83152933458,20,524,2567,40
83155199659,83155199654,-5,697,2662,40
83155317806,83155317786,-20,1258,3865,40
83171817116,83171817109,-7,1085,4001,40
83174954505,83174954498,-7,859,4303,40
83182189795,83182189790,-5,900,3784,40
83184467773,83184467785,12,180,947,40
83185907039,83185907026,-13,70,1152,40
83187498589,83187498585,-4,905,3832,40
83188151170,83188151166,-4,1112,3399,40
83200628525,83200628528,3,3137,3484,40
83204665810,83204665811,1,4955,4696,40
83214396596,83214396590,-6,1551,6034,40
83214693082,83214693078,-4,1216,2921,40
83233834742,83233834737,-5,820,2680,40
83234131306,83234131298,-8,881,2747,40
83243350022,83243350018,-4,1130,2408,40
83243923838,83243923821,-17,193,1381,40
83250335429,83250335423,-6,1278,4189,40
83265038639,83265038633,-6,749,4550,40
83266339695,83266339689,-6,941,3079,40
83268816069,83268816062,-7,959,4178,40
83275760538,83275760534,-4,1234,3326,40
83276679182,83276679168,-14,157,1114,40
83278815157,83278815170,13,1107,4485,40
83279732769,83279732764,-5,967,3256,40
83283911650,83283911638,-12,902,561,40
83284537783,83284537801,18,485,2922,40
83288502298,83288502292,-6,829,3706,40
83289217661,83289217674,13,450,2127,40
83293219207,83293219202,-5,950,3800,40
83294202078,83294202077,-1,2890,3705,40
83297041419,83297041411,-8,683,2663,40
83299986628,83299986632,4,1830,1587,40
83306488510,83306488506,-4,835,3751,40
83317085033,83317085028,-5,230,1019,40
83317915690,83317915693,3,1243,1255,40
83318779315,83318779310,-5,614,2430,40
83320374811,83320374805,-6,655,3676,40
83320981551,83320981530,-21,265,957,40
83322639830,83322639838,8,240,1202,40
83324718250,83324718244,-6,1028,4232,40
83331317166,83331317162,-4,1209,3293,40
83338892123,83338892117,-6,568,945,40
83344873899,83344873892,-7,712,2268,40
83350354599,83350354594,-5,866,3140,40
83350548303,83350548291,-12,307,1018,40
83352654938,83352654933,-5,1265,3210,40
83352950014,83352950026,12,350,1540,40
83353521479,83353521472,-7,1128,4477,40
83364011962,83364011957,-5,1086,3271,40
83364682159,83364682143,-16,330,1173,40
83369670599,83369670594,-5,1255,3021,40
83376985567,83376985562,-5,1158,3701,40
83390824333,83390824327,-6,1088,3929,40
83395447390,83395447384,-6,709,3437,40
83395527380,83395527398,18,760,3515,40
83399889893,83399889894,1,2328,2304,40
83407797978,83407797971,-7,742,2856,40
83417185302,83417185297,-5,1141,4322,40
83417705959,83417705953,-6,933,4216,40
83426302156,83426302149,-7,1214,4009,40
83431518250,83431518242,-8,1059,4599,40
83434428380,83434428374,-6,1418,5347,40
83434910385,83434910377,-8,1572,4266,40
83442863775,83442863768,-7,835,2421,40
83444908420,83444908423,3,2122,1614,40
83445439108,83445439119,11,271,1122,40
83451572508,83451572502,-6,983,4351,40
83452370919,83452370911,-8,229,1081,40
83457909026,83457909019,-7,974,3151,40
83459912122,83459912141,19,564,3051,40
83460084355,83460084348,-7,905,3017,40
83461084634,83461084627,-7,1212,4755,40
83461889998,83461890011,13,602,2170,40
83462242827,83462242821,-6,1043,3390,40
83462796594,83462796589,-5,890,3905,40
83466865395,83466865389,-6,914,3920,40
83474535628,83474535622,-6,762,2222,40
83477009965,83477009959,-6,1134,4668,40
83477762823,83477762817,-6,1768,5546,40
83479294014,83479294013,-1,940,1764,40
83486958519,83486958513,-6,938,2957,40
83492029305,83492029296,-9,945,3734,40
83498096335,83498096340,5,2332,1611,40
83498666498,83498666506,8,1730,1126,40
83505341031,83505341025,-6,976,4037,40
83509000037,83509000031,-6,1093,3875,40
83509774735,83509774734,-1,921,1343,40
83511310615,83511310610,-5,1241,3947,40
83511360749,83511360743,-6,282,1204,40
83518837466,83518837460,-6,866,3438,40
83519043358,83519043373,15,944,2240,40
83521332303,83521332298,-5,1080,4082,40
83531860814,83531860807,-7,1014,4625,40
83535849946,83535849953,7,5242,2773,40
83540405730,83540405725,-5,857,3636,40
83548342003,83548341997,-6,1054,3980,40
83548521396,83548521383,-13,225,1338,40
83549674265,83549674258,-7,926,3508,40
83553317337,83553317330,-7,1290,3765,40
83553772850,83553772844,-6,685,2763,40
83560844750,83560844745,-5,1238,4042,40
83561466709,83561466696,-13,14,1126,40
83562431250,83562431245,-5,760,2660,40
83563258408,83563258406,-2,46,1190,40
83567070207,83567070201,-6,1009,3723,40
83572622251,83572622245,-6,1275,4577,40
83574514746,83574514742,-4,917,3075,40
83574866605,83574866598,-7,830,5567,40
83576000008,83576000021,13,533,1843,40
83576454369,83576454369,0,1149,2021,40
83578959986,83578959979,-7,1119,4735,40
83581341578,83581341574,-4,1135,4518,40
83590968998,83590968993,-5,1209,3785,40
83590994127,83590994115,-12,159,1106,40
83591007686,83591007686,0,188,115,40
83592965461,83592965467,6,3390,1701,40
83607059646,83607059641,-5,1118,3335,40
83608645583,83608645578,-5,877,1858,40
83609604693,83609604703,10,219,714,40
83619901835,83619901830,-5,1113,2822,40
83623934344,83623934338,-6,812,3557,40
83624586829,83624586837,8,131,874,40
83625071421,83625071434,13,74,1413,40
83625869794,83625869789,-5,1033,4159,40
83634699977,83634699971,-6,705,4364,40
83637344297,83637344289,-8,718,4097,40
83645868679,83645868674,-5,914,2405,40
83650986190,83650986185,-5,1516,4287,40
83655632434,83655632426,-8,941,1855,40
83657022707,83657022713,6,2922,1251,40
83657764506,83657764501,-5,1365,5059,40
83661926349,83661926341,-8,953,3188,40
83667652650,83667652642,-8,1226,3069,40
83670524882,83670524880,-2,1011,2697,40
83670768719,83670768713,-6,791,2650,40
83670956278,83670956278,0,182,810,40
83671170358,83671170376,18,449,2557,40
83671960083,83671960077,-6,685,2894,40
83682814985,83682814990,5,3848,1603,40
83689997874,83689997868,-6,1159,4482,40
83697391828,83697391837,9,136,1432,40
83698348358,83698348379,21,814,3189,40
83707724311,83707724305,-6,921,3935,40
83709286798,83709286792,-6,1080,5088,40
83712771103,83712771096,-7,1126,2935,40
83713258489,83713258482,-7,1345,5745,40
83715532096,83715532089,-7,728,3513,40
83715862215,83715862225,10,269,1809,40
83718853960,83718853954,-6,1052,4612,40
83722981054,83722981046,-8,1228,5033,40
83729333003,83729333002,-1,1035,2051,40
83729708095,83729708097,2,152,932,40
83732374256,83732374249,-7,1183,4541,40
83736373014,83736373009,-5,1216,4018,40
83737122951,83737122946,-5,808,3602,40
83738771687,83738771705,18,521,1786,40
83740999546,83740999541,-5,1325,3588,40
83742443454,83742443470,16,922,2881,40
83745520567,83745520567,0,32956,31808,40
83745782186,83745782189,3,3420,3328,40
83755872144,83755872158,14,15741,5896,40
83760402842,83760402835,-7,1074,3976,40
83765627029,83765627023,-6,947,2889,40
83774582802,83774582797,-5,1181,4735,40
83775390062,83775390059,-3,1456,1634,40
83779518762,83779518757,-5,961,3820,40
83780417056,83780417064,8,246,1327,40
83785045147,83785045142,-5,1049,2458,40
83785523725,83785523714,-11,1072,4130,40
83786619409,83786619422,13,16975,7537,40
83787896701,83787896696,-5,687,2468,40
83795747795,83795747789,-6,1193,5536,40
83808942056,83808942052,-4,2130,4384,40
83828031720,83828031716,-4,19193,14027,40
83832690602,83832690597,-5,1026,2964,40
83834424957,83834424965,8,1316,981,40
83839312522,83839312514,-8,705,3707,40
83840926734,83840926729,-5,1060,3137,40
83842682734,83842682727,-7,848,2693,40
83842921556,83842921570,14,552,2487,40
83843292423,83843292424,1,2360,2029,40
83845759224,83845759221,-3,1265,2795,40
83846334334,83846334346,12,643,2795,40
83846469601,83846469595,-6,896,3870,40
83846893558,83846893547,-11,71,953,40
83849596334,83849596329,-5,1089,3220,40
83849704452,83849704472,20,1023,3320,40
83849803138,83849803134,-4,351,1599,40
83850514626,83850514622,-4,987,2406,40
83851409317,83851409306,-11,161,1269,40
83855509128,83855509122,-6,2706,6636,40
83856280362,83856280358,-4,771,2776,40
83864368860,83864368854,-6,1016,3479,40
83864469589,83864469570,-19,256,1070,40
83864538688,83864538694,6,57,1317,40
83867357162,83867357157,-5,1339,6636,40
83867576714,83867576709,-5,914,4057,40
83871060271,83871060267,-4,759,3138,40
83871143201,83871143195,-6,996,2969,40
83873238710,83873238725,15,999,2973,40
83885280477,83885280472,-5,747,2832,40
83894270801,83894270797,-4,1352,5147,40
83896485444,83896485447,3,237,1129,40
83896671328,83896671323,-5,1117,3503,40
83902850670,83902850663,-7,1724,4331,40
83907143301,83907143296,-5,1274,3789,40
83907195791,83907195786,-5,740,2919,40
83908040534,83908040528,-6,1013,5283,40
83908099696,83908099706,10,442,3068,40
83912266331,83912266328,-3,19952,22870,40
83916758293,83916758310,17,132,1153,40
83927087366,83927087361,-5,1046,3583,40
83927752780,83927752774,-6,1329,2973,40
83930168893,83930168887,-6,864,2644,40
83931498098,83931498091,-7,1067,4349,40
83934312490,83934312482,-8,1612,4515,40
83935626003,83935625998,-5,1273,3672,40
83935964454,83935964448,-6,1022,3515,40
83936145533,83936145551,18,532,2818,40
83937965184,83937965182,-2,795,1358,40
83946032854,83946032850,-4,1073,2961,40
83946641303,83946641297,-6,729,2737,40
83950618807,83950618800,-7,1127,4155,40
83952877742,83952877736,-6,841,3752,40
83962961405,83962961398,-7,1182,3841,40
83964300535,83964300526,-9,652,3259,40
83978300914,83978300912,-2,24295,21678,40
83981693963,83981693956,-7,1364,3851,40
83991450237,83991450234,-3,865,3457,40
83998545064,83998545066,2,3926,3721,40
84003914924,84003914919,-5,1978,6265,40
84009912498,84009912495,-3,711,2795,40
84010947210,84010947205,-5,1088,3763,40
84020508643,84020508638,-5,940,3728,40
84025622737,84025622731,-6,1237,5458,40
84025980775,84025980770,-5,944,4188,40
84027990639,84027990633,-6,756,4127,40
84028135863,84028135881,18,900,4354,40
84040003253,84040003249,-4,1083,4338,40
84042513786,84042513780,-6,993,3204,40
84045151706,84045151701,-5,1107,3917,40
84046925507,84046925501,-6,757,4146,40
84050301756,84050301750,-6,1050,3883,40
84050616854,84050616864,10,267,1168,40
84055612967,84055612961,-6,1137,2834,40
84057571919,84057571923,4,6438,60614,40
84059331245,84059331238,-7,871,4182,40
84060858694,84060858687,-7,912,3787,40
84065404807,84065404799,-8,1167,3263,40
84066716094,84066716107,13,86,1141,40
84071571050,84071571060,10,15543,40502,40
84073263403,84073263404,1,1973,1682,40
84073484610,84073484604,-6,1898,5216,40
84079446177,84079446170,-7,1780,3904,40
84080181707,84080181701,-6,1233,4486,40
84082181201,84082181194,-7,1425,5525,40
84082822082,84082822077,-5,971,2993,40
84083071370,84083071365,-5,901,3799,40
84087204336,84087204330,-6,1235,4107,40
84088149801,84088149797,-4,1049,2247,40
84092080178,84092080173,-5,1349,4099,40
84093583325,84093583320,-5,945,3016,40
84094213784,84094213802,18,586,3118,40
84095219373,84095219366,-7,988,7799,40
84096498918,84096498913,-5,932,2813,40
84101720846,84101720839,-7,558,2789,40
84108634155,84108634148,-7,1304,4966,40
84118831373,84118831366,-7,782,2866,40
84119727904,84119727897,-7,940,3508,40
84120211573,84120211594,21,531,3268,40
84131859167,84131859160,-7,1059,4336,40
84132480459,84132480454,-5,903,2687,40
84142158004,84142157997,-7,936,3110,40
84149705973,84149705967,-6,976,4283,40
84154294561,84154294561,0,1848,2602,40
84159262936,84159262931,-5,503,1639,40
84164520716,84164520709,-7,758,3426,40
84166416654,84166416648,-6,1145,5119,40
84169319804,84169319799,-5,1455,3739,40
84173021980,84173021993,13,969,3422,40
84177744015,84177744019,4,1162,640,40
84181358014,84181358008,-6,831,3369,40
84185786743,84185786737,-6,1503,6911,40
84191959187,84191959180,-7,1629,4354,40
84198311061,84198311053,-8,1438,4421,40
84201229057,84201229052,-5,1328,2793,40
84207230227,84207230224,-3,1183,3048,40
84209053445,84209053438,-7,994,3985,40
84213477119,84213477123,4,160,1496,40
84214030607,84214030622,15,941,4078,40
84217945804,84217945798,-6,1498,4083,40
84218058868,84218058878,10,76,667,40
84220500581,84220500575,-6,1092,4721,40
84232302698,84232302693,-5,1627,2606,40
84233187792,84233187807,15,127,1838,40
84234755803,84234755797,-6,958,3137,40
84240183049,84240183043,-6,2120,8428,40
84246312290,84246312286,-4,1151,3457,40
84247274084,84247274101,17,1093,4307,40
84247797710,84247797731,21,474,2355,40
84250815186,84250815180,-6,1043,3666,40
84252091694,84252091689,-5,922,4078,40
84253367524,84253367517,-7,1076,3709,40
84256957605,84256957599,-6,1545,5018,40
84258956657,84258956651,-6,851,4394,40
84261643951,84261643967,16,357,1360,40
84269966581,84269966575,-6,650,4172,40
84271401764,84271401760,-4,602,2414,40
84274390282,84274390277,-5,1153,3128,40
84275185853,84275185875,22,237,1008,40
84277112117,84277112127,10,10366,42383,40
84290315753,84290315754,1,2777,12113,40
84296185712,84296185706,-6,1185,4274,40
84297623298,84297623293,-5,1094,3630,40
84304022590,84304022585,-5,659,2158,40
84310308650,84310308645,-5,1806,4446,40
84312736461,84312736454,-7,2503,10023,40
84320730230,84320730222,-8,1056,3090,40
84320831919,84320831914,-5,46,919,40
84321332483,84321332477,-6,1153,4431,40
84323266637,84323266632,-5,561,2685,40
84327773526,84327773518,-8,810,4825,40
84327815024,84327815042,18,414,1160,40
84331118530,84331118525,-5,608,2252,40
84339128947,84339128941,-6,1066,4209,40
84339678466,84339678462,-4,1332,3249,40
84342221679,84342221674,-5,1002,4204,40
84344025587,84344025582,-5,543,2021,40
84348603997,84348603992,-5,923,3495,40
84348834065,84348834058,-7,1479,3170,40
84349968132,84349968118,-14,193,1410,40
84356656173,84356656166,-7,781,3114,40
84359715851,84359715848,-3,1069,1957,40
84362373131,84362373124,-7,1037,3752,40
84363201140,84363201153,13,274,1332,40
84365497847,84365497841,-6,1247,4507,40
84373115202,84373115198,-4,967,2276,40
84380911047,84380911042,-5,1027,4657,40
84381802883,84381802878,-5,1185,3038,40
84384104714,84384104707,-7,1065,4666,40
84384472029,84384472042,13,242,3790,40
84385968918,84385968928,10,12108,47568,40
84398318442,84398318434,-8,676,2650,40
84402334015,84402334006,-9,1138,3246,40
84406789100,84406789094,-6,1025,2293,40
84411752897,84411752893,-4,1136,3405,40
84413921211,84413921208,-3,1328,3959,40
84417695017,84417695021,4,2832,1669,40
84421050998,84421050995,-3,935,2969,40
84422274060,84422274065,5,4112,2708,40
84422606822,84422606819,-3,1341,2304,40
84425886510,84425886503,-7,1149,3524,40
84427143411,84427143410,-1,1123,1667,40
84427361061,84427361078,17,256,1029,40
84427434599,84427434595,-4,1157,3025,40
84427857809,84427857805,-4,1278,2406,40
84429185570,84429185575,5,7358,26488,40
84438658273,84438658266,-7,1050,3404,40
84439704502,84439704510,8,59,1079,40
84449456719,84449456716,-3,1287,1957,40
84461731966,84461731960,-6,1220,3957,40
84462055557,84462055551,-6,91,529,40
84462199629,84462199629,0,147,1347,40
84462386807,84462386823,16,253,1425,40
84467756353,84467756349,-4,848,2982,40
84469447470,84469447477,7,4541,1510,40
84470857879,84470857873,-6,1109,4283,40
84475210630,84475210625,-5,1380,3436,40
84475658897,84475658901,4,2542,1039,40
84476633144,84476633139,-5,564,1027,40
84478602099,84478602094,-5,1148,3817,40
84479534962,84479534956,-6,856,2761,40
84479721559,84479721558,-1,123,1241,40
84479839540,84479839535,-5,15,672,40
84482100266,84482100260,-6,933,3347,40
84484876495,84484876489,-6,1155,4739,40
84496268162,84496268154,-8,965,4825,40
84499815095,84499815090,-5,774,3175,40
84500731822,84500731843,21,406,1366,40
84502286250,84502286246,-4,1005,3638,40
84515597571,84515597566,-5,661,1939,40
84515947364,84515947379,15,976,3281,40
84518649240,84518649233,-7,1096,3944,40
84524553539,84524553533,-6,482,2237,40
84524872805,84524872818,13,334,2433,40
84525381190,84525381185,-5,955,3264,40
84532818915,84532818911,-4,1029,3226,40
84535348524,84535348527,3,1959,1151,40
84541249681,84541249674,-7,850,4472,40
84543318458,84543318453,-5,1176,4378,40
84547819626,84547819625,-1,1053,1423,40
84548534031,84548534032,1,175,1301,40
84560541702,84560541697,-5,981,3742,40
84567664523,84567664517,-6,669,3608,40
84569426982,84569426977,-5,809,3150,40
84571064849,84571064844,-5,1415,3488,40
84573343018,84573343016,-2,2105,4816,40
84573992418,84573992423,5,2659,1494,40
84580451895,84580451890,-5,823,2845,40
84588959042,84588959036,-6,908,3935,40
84592496154,84592496148,-6,866,3698,40
84595319646,84595319654,8,5720,1718,40
84604417329,84604417325,-4,1388,3859,40
84606034118,84606034112,-6,1219,3574,40
84617381229,84617381222,-7,1114,3322,40
84618227254,84618227273,19,1350,3141,40
84619648328,84619648334,6,18715,39253,40
84622466255,84622466251,-4,890,2439,40
84624860935,84624860930,-5,1004,5327,40
84626815728,84626815732,4,3401,1878,40
84628753909,84628753902,-7,1792,8080,40
84630164531,84630164525,-6,865,2109,40
84630190192,84630190200,8,15310,5636,40
84631563895,84631563889,-6,1062,3560,40
84631898766,84631898761,-5,811,3154,40
84634977371,84634977374,3,1984,1608,40
84638739251,84638739245,-6,1207,3410,40
84645722170,84645722171,1,1027,1594,40
84646508637,84646508633,-4,955,3043,40
84649183810,84649183806,-4,1287,3047,40
84651059945,84651059951,6,14865,5260,40
84661974178,84661974173,-5,679,4064,40
84664185485,84664185479,-6,1126,2923,40
84665315385,84665315379,-6,647,3691,40
84666477853,84666477849,-4,1074,2938,40
84674359288,84674359282,-6,969,3232,40
84674879910,84674879904,-6,731,5698,40
84677819394,84677819388,-6,580,1988,40
84683575429,84683575434,5,3638,1691,40
84692564257,84692564251,-6,1066,3926,40
84692652454,84692652470,16,254,1279,40
84694085555,84694085549,-6,1341,4453,40
84695280493,84695280487,-6,1095,3194,40
84696528529,84696528551,22,129,722,40
84699394934,84699394929,-5,818,2025,40
84699628668,84699628691,23,225,1508,40
84702568489,84702568486,-3,26012,15247,40
84703532574,84703532568,-6,967,4173,40
84716207775,84716207769,-6,1288,4468,40
84717388754,84717388750,-4,973,3410,40
84717454580,84717454575,-5,215,1376,40
84719192718,84719192710,-8,693,3894,40
84727250926,84727250921,-5,958,3510,40
84727559494,84727559489,-5,859,3239,40
84727713504,84727713510,6,208,1839,40
84728431030,84728431025,-5,912,3984,40
84728576735,84728576740,5,148,1537,40
84728740949,84728740971,22,348,1096,40
84729350223,84729350217,-6,1398,3835,40
84732440343,84732440337,-6,657,2659,40
84739453946,84739453941,-5,956,4367,40
84739487517,84739487539,22,419,1576,40
84740189847,84740189837,-10,1104,3964,40
84741706745,84741706739,-6,1182,3696,40
84741743198,84741743218,20,529,3374,40
84743642518,84743642513,-5,1197,3422,40
84746418334,84746418312,-22,3540,1757,40
84749099046,84749099042,-4,1001,3120,40
84749511822,84749511821,-1,991,1788,40
84750385927,84750385922,-5,1314,3294,40
84751808443,84751808437,-6,741,3497,40
84752016976,84752016995,19,204,751,40
84752507140,84752507120,-20,866,2246,40
84758508651,84758508646,-5,1348,4015,40
84761120208,84761120202,-6,1045,3504,40
84774832911,84774832905,-6,1065,3790,40
84780607066,84780607061,-5,1160,4634,40
84781274238,84781274239,1,210,785,40
84787346137,84787346141,4,1810,1433,40
84798562262,84798562269,7,3939,1739,40
84801265727,84801265721,-6,585,4769,40
84802031974,84802031978,4,148,1107,40
84803259246,84803259240,-6,957,3348,40
84803936727,84803936721,-6,1138,3178,40
84804224637,84804224631,-6,739,2829,40
84812736076,84812736070,-6,1067,4405,40
84816177678,84816177670,-8,1044,4882,40
84823201274,84823201274,0,970,1642,40
84827781209,84827781203,-6,1337,3150,40
84828221569,84828221562,-7,991,4340,40
84828293109,84828293102,-7,61,927,40
84835561415,84835561413,-2,629,1144,40
84846516144,84846516139,-5,1405,4501,40
84847043793,84847043787,-6,1073,4160,40
84850742251,84850742246,-5,777,2317,40
84857290728,84857290734,6,5585,2146,40
84861344766,84861344765,-1,1054,962,40
84877299489,84877299483,-6,1365,3695,40
84881476197,84881476190,-7,773,3367,40
84881962432,84881962426,-6,1150,3687,40
84882158582,84882158569,-13,63,1083,40
84883733726,84883733747,21,294,1385,40
84889281455,84889281453,-2,1837,2768,40
84891318967,84891318959,-8,1007,4140,40
84892074330,84892074325,-5,731,4584,40
84892173519,84892173519,0,144,1342,40
84897646803,84897646816,13,765,3313,40
84899706503,84899706499,-4,845,3484,40
84902243966,84902243962,-4,447,1404,40
84902387128,84902387142,14,635,3232,40
84902584309,84902584303,-6,778,2473,40
84910152458,84910152454,-4,1182,3700,40
84911739798,84911739793,-5,1014,3512,40
84913345942,84913345938,-4,673,1347,40
84919922186,84919922182,-4,1989,5023,40
84922677730,84922677725,-5,1126,5145,40
84922764679,84922764673,-6,179,998,40
84929655746,84929655752,6,4069,1646,40
84929907999,84929907995,-4,1032,3011,40
84930750937,84930750934,-3,860,2236,40
84930812398,84930812389,-9,627,1819,40
84936496013,84936496007,-6,822,3334,40
84939103450,84939103443,-7,717,3951,40
84941539755,84941539750,-5,864,3515,40
84941780208,84941780224,16,930,3887,40
84943967760,84943967754,-6,1229,4308,40
84950589349,84950589341,-8,1315,5456,40
84953164379,84953164375,-4,812,2355,40
84955043806,84955043794,-12,715,4081,40
84955109784,84955109802,18,1274,3795,40
84955305756,84955305778,22,214,1168,40
84960375854,84960375850,-4,1358,2754,40
84960872786,84960872781,-5,955,2998,40
84961157205,84961157202,-3,1661,1828,40
84961305595,84961305590,-5,834,2935,40
84962293675,84962293669,-6,1075,3758,40
84962574926,84962574923,-3,213,1210,40
84965889261,84965889254,-7,1073,3674,40
84969165157,84969165152,-5,1073,3468,40
84971000574,84971000569,-5,499,2980,40
84971398982,84971398975,-7,1078,3034,40
84972040574,84972040554,-20,1339,4587,40
84972485991,84972486002,11,569,7111,40
84977146023,84977146016,-7,1062,4140,40
84977557079,84977557073,-6,1213,3467,40
84980053731,84980053725,-6,1149,6352,40
84986039231,84986039224,-7,1231,4665,40
84987191318,84987191310,-8,1038,4184,40
84988553966,84988553964,-2,1178,2484,40
84989944589,84989944584,-5,823,3589,40
84993849641,84993849635,-6,1067,5358,40
84999903975,84999903969,-6,868,3112,40
85002113477,85002113469,-8,1231,4731,40
85006562734,85006562736,2,1102,1333,40
85016067014,85016067006,-8,1307,4394,40
85017637351,85017637345,-6,984,2093,40
85019653674,85019653679,5,2274,1246,40
85021478162,85021478166,4,2021,1208,40
85030698794,85030698786,-8,799,3594,40
85031044174,85031044190,16,954,3635,40
85038984539,85038984530,-9,825,2020,40
85039167056,85039167065,9,315,1173,40
85039899897,85039899891,-6,863,5655,40
85047578362,85047578357,-5,1310,4393,40
85048145284,85048145278,-6,1095,3454,40
85050045042,85050045035,-7,500,4060,40
85056016721,85056016720,-1,1197,1301,40
85061683953,85061683946,-7,1070,5177,40
85061903668,85061903679,11,335,1420,40
85077898387,85077898381,-6,781,2732,40
85081383231,85081383230,-1,6289,10615,40
85084990659,85084990658,-1,791,2348,40
85085415956,85085415952,-4,323,3846,40
85086745994,85086745992,-2,1033,2232,40
85093249196,85093249189,-7,864,3040,40
85093465942,85093465920,-22,339,2261,40
85095284588,85095284607,19,145,1122,40
85103438146,85103438140,-6,952,3671,40
85109075969,85109075962,-7,1003,3437,40
85112713129,85112713130,1,1459,1131,40
85114420987,85114420981,-6,1269,4591,40
85114957699,85114957693,-6,808,3869,40
85118290107,85118290101,-6,954,3447,40
85122337026,85122337022,-4,840,4002,40
85122367574,85122367594,20,71,902,40
85131585120,85131585113,-7,566,2234,40
85132055063,85132055081,18,704,1844,40
85140863203,85140863198,-5,1092,4142,40
85143203519,85143203514,-5,1185,2896,40
85146505756,85146505750,-6,1086,4506,40
85152157014,85152157006,-8,1229,3775,40
85152946491,85152946486,-5,964,4624,40
85153592207,85153592227,20,253,1272,40
85162386177,85162386170,-7,1042,2676,40
85162667299,85162667293,-6,927,3171,40
85167832661,85167832657,-4,983,2553,40
85168165931,85168165926,-5,796,3468,40
85168620894,85168620906,12,621,2966,40
85169642367,85169642359,-8,1503,3694,40
85170443838,85170443832,-6,1076,4892,40
85174914790,85174914785,-5,1123,3259,40
85175589134,85175589131,-3,1200,2608,40
85176846460,85176846454,-6,884,4236,40
85178431573,85178431566,-7,768,3169,40
85180390133,85180390127,-6,1141,4353,40
85180575854,85180575849,-5,1240,3611,40
85183139858,85183139853,-5,834,4058,40
85185028911,85185028911,0,1511,2641,40
85196384009,85196384007,-2,1280,2279,40
85198068094,85198068086,-8,1159,4137,40
85198629733,85198629740,7,6170,2976,40
85202038919,85202038912,-7,1128,3827,40
85202425677,85202425661,-16,990,2443,40
85202516132,85202516121,-11,1051,3326,40
85205649845,85205649841,-4,1883,4562,40
85214027651,85214027646,-5,475,1932,40
85214084850,85214084845,-5,1384,3088,40
85219806131,85219806123,-8,834,4576,40
85222308738,85222308731,-7,1399,4059,40
85230715036,85230715035,-1,712,929,40
85232702902,85232702897,-5,910,2972,40
85234428619,85234428614,-5,784,3164,40
85234659627,85234659621,-6,1185,3748,40
85236866050,85236866043,-7,956,3925,40
85238559603,85238559597,-6,829,2536,40
85249796414,85249796409,-5,1229,4363,40
85251028194,85251028187,-7,702,2824,40
85253062186,85253062179,-7,1072,3169,40
85253088366,85253088383,17,473,2908,40
85255198602,85255198594,-8,1218,4873,40
85255267932,85255267953,21,78,1249,40
85257684114,85257684104,-10,757,3278,40
85262509945,85262509939,-6,944,2641,40
85263310321,85263310333,12,235,1106,40
85271447191,85271447197,6,5132,2222,40
85272788953,85272788952,-1,935,1686,40
85273628518,85273628531,13,377,876,40
85274213093,85274213086,-7,956,3480,40
85274872919,85274872922,3,64,1002,40
85276661720,85276661726,6,6006,1794,40
85279721909,85279721902,-7,1293,4096,40
85280605998,85280606014,16,336,1487,40
85284165825,85284165818,-7,2285,6501,40
85286614703,85286614707,4,2879,2127,40
85290046071,85290046054,-17,907,2977,40
85291006825,85291006820,-5,803,3039,40
85300301495,85300301490,-5,2103,6602,40
85303368282,85303368275,-7,1026,4326,40
85303746446,85303746462,16,732,2298,40
85306304803,85306304798,-5,1456,3879,40
85307015075,85307015070,-5,755,2392,40
85309367287,85309367303,16,995,4090,40
85315034285,85315034278,-7,1043,5737,40
85316422078,85316422074,-4,978,3140,40
85317616288,85317616281,-7,1389,4105,40
85319486041,85319486036,-5,1033,2601,40
85320452361,85320452354,-7,717,3159,40
85324198623,85324198617,-6,1409,4023,40
85331348170,85331348165,-5,1078,4195,40
85332952602,85332952596,-6,1092,4734,40
85333805628,85333805625,-3,289,1111,40
85335512189,85335512185,-4,538,1162,40
85335889051,85335889044,-7,817,3263,40
85336977594,85336977590,-4,710,2289,40
85338341082,85338341077,-5,1221,3570,40
85340548985,85340548981,-4,855,2718,40
85342561098,85342561093,-5,1364,5118,40
85360782147,85360782146,-1,1323,2189,40
85362942262,85362942259,-3,1273,1638,40
85364086941,85364086937,-4,1612,3231,40
85366460542,85366460557,15,345,1330,40
85375902664,85375902658,-6,1923,9253,40
85377775619,85377775616,-3,3005,5106,40
85379550725,85379550718,-7,1001,3101,40
85383786062,85383786057,-5,1206,3344,40
85385859002,85385858995,-7,1111,4795,40
85398895794,85398895786,-8,1122,2954,40
85399039049,85399039044,-5,960,3410,40
85399131660,85399131682,22,1157,4008,40
85399605738,85399605733,-5,1045,3442,40
85407616625,85407616618,-7,717,3588,40
85412533048,85412533065,17,733,1535,40
85425351609,85425351602,-7,1129,5073,40
85428885271,85428885252,-19,223,1583,40
85429046430,85429046426,-4,1279,4020,40
85431582538,85431582542,4,2924,1654,40
85431941139,85431941134,-5,756,2246,40
85433261997,85433261991,-6,863,3626,40
85436397543,85436397535,-8,941,3227,40
85437219422,85437219438,16,110,1439,40
85437840593,85437840586,-7,606,2856,40
85438008216,85438008210,-6,892,2846,40
85438067471,85438067490,19,1216,3880,40
85441242800,85441242793,-7,1610,5979,40
85446511773,85446511767,-6,1524,5463,40
85446567650,85446567644,-6,1213,4278,40
85448006141,85448006135,-6,1010,4037,40
85452799622,85452799618,-4,959,2610,40
85453501885,85453501898,13,168,1285,40
85457208762,85457208762,0,3768,3616,40
85460199391,85460199386,-5,1427,4629,40
85460479576,85460479571,-5,1384,4132,40
85461035535,85461035523,-12,244,832,40
85464402291,85464402285,-6,1171,3528,40
85464587331,85464587325,-6,945,3652,40
85465697100,85465697094,-6,888,3269,40
85494149081,85494149075,-6,936,2508,40
85499270878,85499270873,-5,1328,4550,40
85499758198,85499758214,16,892,3607,40
85504564510,85504564506,-4,830,2495,40
85507138979,85507138972,-7,771,3796,40
85508484965,85508484978,13,296,926,40
85516368913,85516368908,-5,799,4254,40
85523799531,85523799526,-5,1079,3722,40
85528313931,85528313925,-6,1127,2915,40
85528613661,85528613677,16,381,1147,40
85537528441,85537528435,-6,1016,2937,40
85537695678,85537695675,-3,1530,2990,40
85539479186,85539479187,1,5836,5307,40
85545765042,85545765047,5,2844,1427,40
85548917526,85548917518,-8,1158,5031,40
85549474110,85549474119,9,239,758,40
85549603363,85549603357,-6,1094,3307,40
85552142731,85552142724,-7,637,2694,40
85565176917,85565176913,-4,973,3003,40
85565280476,85565280497,21,904,3379,40
85565443766,85565443786,20,27,969,40
85566876686,85566876686,0,25858,28243,40
85572347614,85572347608,-6,1328,4115,40
85577417814,85577417808,-6,1222,4742,40
85577672175,85577672168,-7,1003,5133,40
85579370187,85579370185,-2,796,1673,40
85580346469,85580346465,-4,1681,3830,40
85582520585,85582520581,-4,831,3790,40
85585699112,85585699106,-6,1266,3417,40
85585856335,85585856340,5,72,1361,40
85588036309,85588036303,-6,1262,4263,40
85591880566,85591880563,-3,1061,2168,40
85599084341,85599084346,5,4427,3065,40
85600638474,85600638469,-5,969,4950,40
85608130027,85608130025,-2,1147,2711,40
85613221402,85613221400,-2,4397,18308,40
85617269533,85617269528,-5,1152,4634,40
85617315828,85617315843,15,228,1420,40
85617905208,85617905226,18,307,813,40
85618275958,85618275950,-8,699,2845,40
85619423949,85619423933,-16,147,1462,40
85623268426,85623268421,-5,583,2204,40
85623419165,85623419185,20,42,1085,40
85624359545,85624359539,-6,945,2915,40
85634322562,85634322554,-8,1237,3865,40
85657120094,85657120089,-5,1402,4822,40
85665948386,85665948380,-6,776,3397,40
85672766010,85672765989,-21,487,436,40
85673222751,85673222766,15,408,702,40
85673723854,85673723849,-5,1043,2968,40
85676689383,85676689380,-3,983,2364,40
85679722675,85679722670,-5,887,3803,40
85686972422,85686972420,-2,1076,1613,40
85689456951,85689456945,-6,1208,4171,40
85691511383,85691511378,-5,1711,6247,40
85697113194,85697113189,-5,772,3660,40
85699527548,85699527543,-5,626,2517,40
85699604612,85699604634,22,402,1208,40
85701807370,85701807365,-5,1174,2975,40
85703981057,85703981053,-4,825,3530,40
85705184506,85705184501,-5,977,2483,40
85710297825,85710297823,-2,754,1647,40
85721920401,85721920407,6,5957,2360,40
85729172413,85729172406,-7,957,4154,40
85729619373,85729619366,-7,978,4888,40
85733535680,85733535673,-7,1144,4463,40
85733779871,85733779866,-5,850,3378,40
85733888228,85733888213,-15,942,3692,40
85735994001,85735993993,-8,1511,4522,40
85736276215,85736276209,-6,1023,5810,40
85736758191,85736758185,-6,684,1757,40
85738919845,85738919837,-8,985,3421,40
85739312509,85739312493,-16,862,2612,40
85740647102,85740647099,-3,1640,3259,40
85747783433,85747783427,-6,788,2525,40
85748920925,85748920924,-1,1225,2612,40
85753156234,85753156228,-6,870,4526,40
85753351903,85753351893,-10,335,1320,40
85754831354,85754831349,-5,953,3647,40
85755004316,85755004300,-16,123,998,40
85759777831,85759777827,-4,1372,2886,40
85768427218,85768427202,-16,155,1058,40
85771571918,85771571913,-5,597,1690,40
85777276565,85777276558,-7,1293,4100,40
85785942882,85785942877,-5,970,4176,40
85787435082,85787435075,-7,1068,3530,40
85788578766,85788578761,-5,1322,3468,40
85796410220,85796410213,-7,1343,5090,40
85796674916,85796674938,22,343,1234,40
85798271197,85798271197,0,1101,1643,40
85801242515,85801242507,-8,1074,4415,40
85804210849,85804210843,-6,1138,3935,40
85805177401,85805177394,-7,1227,3940,40
85816170051,85816170045,-6,745,2142,40
85816416694,85816416681,-13,165,1555,40
85823225428,85823225422,-6,970,4074,40
85831034454,85831034446,-8,934,3833,40
85832562638,85832562632,-6,1431,4851,40
85833208735,85833208730,-5,1045,3374,40
85833714619,85833714616,-3,1200,2433,40
85840958662,85840958657,-5,779,3219,40
85841969855,85841969841,-14,31768,16962,40
85853402195,85853402193,-2,1426,13225,40
85868559850,85868559854,4,1236,1088,40
85869891491,85869891497,6,3948,1165,40
85871167479,85871167473,-6,1317,5277,40
85881810536,85881810530,-6,706,2527,40
85881890236,85881890229,-7,203,862,40
85882245440,85882245458,18,808,2971,40
85883456098,85883456093,-5,1020,3691,40
85885357646,85885357638,-8,1295,3408,40
85888776226,85888776219,-7,855,4157,40
85890379542,85890379538,-4,1012,4213,40
85899728609,85899728606,-3,1845,2774,40
85900396018,85900396011,-7,1303,3644,40
85900704775,85900704794,19,363,1395,40
85905804294,85905804289,-5,998,2918,40
85906899906,85906899900,-6,925,4174,40
85920635764,85920635762,-2,27665,12239,40
85923428886,85923428881,-5,847,2962,40
85923867117,85923867111,-6,1656,3732,40
85927247425,85927247421,-4,807,4104,40
85929578065,85929578066,1,1979,1361,40
85933064988,85933064981,-7,767,2716,40
85943334067,85943334061,-6,1427,3820,40
85944648852,85944648875,23,839,3412,40
85944848207,85944848202,-5,1005,3546,40
85946278621,85946278614,-7,918,3674,40
85962675342,85962675338,-4,1065,2121,40
85972916451,85972916445,-6,652,3196,40
85975254973,85975254966,-7,1174,4116,40
85980524173,85980524169,-4,1043,2682,40
85983495150,85983495145,-5,1126,2995,40
85983629763,85983629756,-7,1249,3707,40
85986835950,85986835942,-8,1076,4354,40
86002837329,86002837325,-4,1029,2411,40
86022463987,86022463983,-4,677,1489,40
86022598309,86022598311,2,81,1187,40
86029335813,86029335807,-6,666,1994,40
86030981687,86030981682,-5,691,3115,40
86034176432,86034176426,-6,824,3601,40
86041352451,86041352446,-5,1202,2833,40
86041696258,86041696252,-6,563,3049,40
86042125562,86042125559,-3,1558,2812,40
86043501006,86043501000,-6,827,1991,40
86044464294,86044464314,20,240,1688,40
86049420267,86049420261,-6,975,3346,40
86049873441,86049873434,-7,1334,5553,40
86052739226,86052739222,-4,666,2425,40
86053218299,86053218295,-4,968,3412,40
86053426063,86053426042,-21,409,1349,40
86054930282,86054930277,-5,1080,2936,40
86062265039,86062265034,-5,496,1098,40
86068479207,86068479205,-2,1546,2492,40
86076156985,86076156978,-7,1173,4545,40
86076605132,86076605121,-11,168,986,40
86077097247,86077097241,-6,762,2133,40
86078306851,86078306846,-5,1164,3742,40
86085039354,86085039351,-3,1365,3067,40
86088102660,86088102654,-6,1258,3463,40
86089559906,86089559901,-5,1477,3451,40
86092265026,86092265021,-5,1020,2288,40
86094409210,86094409205,-5,1106,3276,40
86095611533,86095611550,17,913,3308,40
86095639799,86095639779,-20,112,994,40
86096176007,86096176006,-1,363,1530,40
86097874701,86097874704,3,4036,2674,40
86098345817,86098345810,-7,1262,3621,40
86104392997,86104392990,-7,1817,6227,40
86107142117,86107142122,5,1878,822,40
86108848847,86108848849,2,21217,23581,40
86111094350,86111094342,-8,1024,3823,40
86111566742,86111566758,16,335,1448,40
86116100227,86116100221,-6,854,2814,40
86120761453,86120761450,-3,1317,1891,40
86120825271,86120825275,4,360,1423,40
86121958063,86121958058,-5,987,3138,40
86122167749,86122167767,18,217,1057,40
86126635494,86126635486,-8,943,4882,40
86134907457,86134907452,-5,1200,4378,40
86134975254,86134975249,-5,118,963,40
86136606124,86136606113,-11,1140,3370,40
86141562234,86141562229,-5,846,3563,40
86143162790,86143162794,4,3853,3459,40
86144945493,86144945505,12,15040,32602,40
86145457568,86145457589,21,381,2414,40
86146762633,86146762626,-7,1051,4379,40
86150728730,86150728734,4,10016,5469,40
86151282920,86151282938,18,785,3500,40
86166180199,86166180194,-5,977,3217,40
86166647764,86166647779,15,214,313,40
86182570918,86182570915,-3,488,1136,40
86186902309,86186902315,6,4812,1426,40
86193308230,86193308226,-4,703,2673,40
86195139297,86195139294,-3,2495,6335,40
86203325597,86203325593,-4,805,2715,40
86209604206,86209604200,-6,1082,3893,40
86210783224,86210783217,-7,1842,5890,40
86214399699,86214399698,-1,723,1788,40
86219641862,86219641855,-7,1146,5077,40
86222037654,86222037650,-4,1028,3561,40
86223104723,86223104717,-6,1184,2790,40
86223835926,86223835942,16,691,1773,40
86227613528,86227613522,-6,1205,4848,40
86227720348,86227720333,-15,254,1191,40
86228652589,86228652604,15,15066,42838,40
86232702374,86232702367,-7,916,3534,40
86239642707,86239642697,-10,1245,3821,40
86243480996,86243481002,6,1011,584,40
86245976538,86245976532,-6,1362,6976,40
86251610438,86251610443,5,6072,2504,40
86256229355,86256229362,7,3579,2146,40
86258243178,86258243172,-6,869,3044,40
86258353501,86258353510,9,129,1065,40
86259517466,86259517460,-6,767,3260,40
86259572349,86259572349,0,187,969,40
86261398303,86261398297,-6,918,3723,40
86261861430,86261861445,15,501,2203,40
86266287877,86266287873,-4,880,2747,40
86271753210,86271753200,-10,1297,3655,40
86273401116,86273401129,13,508,3929,40
86282485762,86282485760,-2,23045,20953,40
86291783963,86291783958,-5,1330,4411,40
86294357681,86294357675,-6,1305,4048,40
86296838305,86296838307,2,4994,17849,40
86299520137,86299520118,-19,9083,6307,40
86300764842,86300764835,-7,1064,4311,40
86304336089,86304336082,-7,915,3120,40
86309195319,86309195313,-6,2279,6125,40
86309971687,86309971687,0,1618,1999,40
86311584564,86311584579,15,399,1971,40
86317119098,86317119093,-5,1115,4902,40
86317327057,86317327053,-4,523,1519,40
86319036078,86319036077,-1,1244,2017,40
86319546678,86319546670,-8,891,3753,40
86321378106,86321378098,-8,1249,4241,40
86321595901,86321595896,-5,745,3300,40
86321901303,86321901310,7,297,998,40
86322923778,86322923774,-4,763,3025,40
86323100392,86323100410,18,394,1841,40
86325674138,86325674138,0,863,1388,40
86329952855,86329952851,-4,609,1509,40
86338810092,86338810086,-6,1092,4154,40
86345271772,86345271776,4,2473,1977,40
86348523218,86348523213,-5,826,3325,40
86350048107,86350048100,-7,665,4833,40
86350915438,86350915459,21,605,3463,40
86351263418,86351263413,-5,820,3947,40
86359181639,86359181633,-6,1432,4084,40
86368073906,86368073911,5,2578,1349,40
86374737550,86374737554,4,21236,16877,40
86383153615,86383153610,-5,716,3802,40
86383425781,86383425777,-4,953,3612,40
86384129920,86384129936,16,294,1460,40
86385486958,86385486954,-4,1570,2804,40
86385520022,86385520017,-5,884,4213,40
86387214299,86387214295,-4,883,3481,40
86387810137,86387810131,-6,1332,5815,40
86388221231,86388221245,14,386,1182,40
86394432945,86394432950,5,3395,2351,40
86394510594,86394510589,-5,876,4151,40
86404434767,86404434761,-6,1042,3935,40
86404514277,86404514278,1,176,1214,40
86404810464,86404810477,13,912,3981,40
86406371342,86406371347,5,3621,2705,40
86409640824,86409640818,-6,801,3780,40
86410558718,86410558714,-4,921,4442,40
86410845448,86410845465,17,756,2468,40
86412648615,86412648610,-5,1243,2707,40
86416769009,86416769005,-4,746,1442,40
86416816455,86416816454,-1,178,1396,40
86417053839,86417053852,13,303,1521,40
86423340910,86423340905,-5,1015,3151,40
86430663902,86430663915,13,145,1598,40
86431001462,86431001455,-7,994,4558,40
86431110876,86431110875,-1,214,1263,40
86431797805,86431797790,-15,82,1056,40
86436868300,86436868297,-3,1368,3256,40
86437051494,86437051483,-11,215,1433,40
86437606155,86437606150,-5,878,3110,40
86437927227,86437927221,-6,1062,2954,40
86446591001,86446590994,-7,783,3091,40
86446923855,86446923846,-9,51,1094,40
86451833658,86451833654,-4,1064,3541,40
86457349219,86457349217,-2,1151,3056,40
86466453604,86466453598,-6,1012,3410,40
86477763249,86477763251,2,1400,1457,40
86479984412,86479984409,-3,1417,3962,40
86480747209,86480747216,7,5539,1446,40
86481342381,86481342389,8,17742,22215,40
86484066521,86484066514,-7,982,4977,40
86484806749,86484806739,-10,166,942,40
86488657571,86488657564,-7,604,3971,40
86489324597,86489324613,16,334,1236,40
86490600676,86490600672,-4,911,1997,40
86493352758,86493352753,-5,834,4783,40
86494594304,86494594318,14,219,3001,40
86503123609,86503123602,-7,1100,3378,40
86503976991,86503977007,16,13621,43033,40
86506188735,86506188735,0,1738,2071,40
86515241809,86515241810,1,1599,1856,40
86516223431,86516223423,-8,104,1379,40
86516318541,86516318562,21,428,1615,40
86517271478,86517271494,16,895,3991,40
86521245339,86521245333,-6,934,3926,40
86521294701,86521294685,-16,144,1253,40
86524069378,86524069373,-5,1656,4038,40
86525212192,86525212207,15,72,1656,40
86549211471,86549211469,-2,714,2022,40
86551198347,86551198342,-5,923,5060,40
86553699721,86553699720,-1,1259,1978,40
86556424497,86556424502,5,3022,1293,40
86557186305,86557186298,-7,1407,4501,40
86557950437,86557950455,18,491,1269,40
86573090116,86573090121,5,7038,1113,40
86580738752,86580738758,6,8011,28099,40
86586425400,86586425394,-6,1372,4596,40
86589990807,86589990800,-7,1010,3633,40
86590221087,86590221066,-21,34,1089,40
86595862695,86595862689,-6,987,3629,40
86597000944,86597000950,6,210,1109,40
86599592885,86599592878,-7,1129,3827,40
86600090011,86600090006,-5,1121,3525,40
86603699665,86603699660,-5,848,3744,40
86605211060,86605211050,-10,227,1152,40
86612197862,86612197854,-8,1368,4772,40
86613894686,86613894680,-6,1026,3717,40
86614042164,86614042184,20,838,4598,40
86614736493,86614736487,-6,745,4903,40
86615375637,86615375623,-14,1445,3594,40
86618450118,86618450113,-5,1046,4691,40
86620347342,86620347354,12,211,1135,40
86623371471,86623371468,-3,791,2247,40
86624135532,86624135542,10,15371,17782,40
86632155527,86632155522,-5,1099,3656,40
86643194458,86643194451,-7,665,3115,40
86655709870,86655709866,-4,788,3290,40
86657155822,86657155817,-5,1054,3467,40
86658441979,86658441974,-5,1004,3758,40
86662897879,86662897865,-14,244,1029,40
86663496460,86663496477,17,394,1435,40
86666251438,86666251433,-5,905,3415,40
86667058665,86667058658,-7,612,3017,40
86667424252,86667424275,23,1087,3957,40
86668558244,86668558239,-5,1081,3859,40
86669023322,86669023325,3,3904,2990,40
86671772910,86671772903,-7,859,3921,40
86678764810,86678764805,-5,894,3081,40
86679335700,86679335693,-7,1566,3482,40
86679639181,86679639193,12,184,1045,40
86687886684,86687886684,0,730,1301,40
86689401350,86689401344,-6,1297,4442,40
86691132705,86691132698,-7,851,4200,40
86694225701,86694225695,-6,1352,5650,40
86697115067,86697115062,-5,783,2982,40
86702448755,86702448750,-5,600,3201,40
86702718436,86702718437,1,106,783,40
86703640377,86703640371,-6,963,3518,40
86703847470,86703847463,-7,1105,4797,40
86705269718,86705269712,-6,859,4281,40
86705807816,86705807810,-6,907,3490,40
86706156259,86706156253,-6,1089,2554,40
86710993024,86710993015,-9,45494,8864,40
86711626320,86711626313,-7,1107,5089,40
86714896062,86714896057,-5,865,2329,40
86718671659,86718671653,-6,886,4622,40
86719220368,86719220386,18,802,2456,40
86719505096,86719505107,11,343,889,40
86720405257,86720405252,-5,578,4039,40
86720997405,86720997425,20,23,1303,40
86724744741,86724744737,-4,1135,2671,40
86728067520,86728067518,-2,1232,2577,40
86728418569,86728418567,-2,2364,3618,40
86733064235,86733064228,-7,589,3118,40
86733336796,86733336806,10,15,1027,40
86740078999,86740078993,-6,1462,4397,40
86740765006,86740764999,-7,734,2839,40
86741719830,86741719829,-1,1079,2654,40
86742349900,86742349923,23,82,1010,40
86744168207,86744168221,14,78,1629,40
86752276333,86752276333,0,1381,2227,40
86757426186,86757426185,-1,1032,2005,40
86757667202,86757667195,-7,1187,3977,40
86759527003,86759526998,-5,1044,4341,40
86761157827,86761157822,-5,662,1157,40
86765555869,86765555862,-7,1204,4808,40
86769800713,86769800709,-4,772,1743,40
86777351381,86777351377,-4,1116,3489,40
86779060086,86779060078,-8,991,5107,40
86779647784,86779647778,-6,1317,2829,40
86780224191,86780224178,-13,150,1138,40
86785650917,86785650910,-7,1217,3514,40
86788136246,86788136239,-7,985,3161,40
86788624109,86788624102,-7,1203,4835,40
86795128516,86795128512,-4,881,3491,40
86798236918,86798236913,-5,999,3756,40
86799383623,86799383617,-6,1029,3755,40
86800019888,86800019902,14,563,2734,40
86802333466,86802333463,-3,1095,3238,40
86805025651,86805025646,-5,889,3006,40
86820221725,86820221718,-7,1019,2602,40
86822847995,86822847986,-9,288,755,40
86823812351,86823812346,-5,924,3050,40
86824655358,86824655353,-5,1226,3161,40
86824902197,86824902192,-5,1207,2463,40
86825341660,86825341670,10,306,1947,40
86827528335,86827528339,4,53,1192,40
86837498707,86837498702,-5,791,4347,40
86838260248,86838260242,-6,1256,3816,40
86838524319,86838524327,8,139,1464,40
86841023059,86841023056,-3,896,3793,40
86850481747,86850481738,-9,1149,3000,40
86853942994,86853942988,-6,1165,4492,40
86853996774,86853996777,3,2556,1378,40
86854598159,86854598152,-7,1061,3940,40
86857638844,86857638838,-6,1265,4462,40
86859529653,86859529650,-3,1162,3153,40
86863080420,86863080413,-7,819,5252,40
86863993058,86863993054,-4,1368,2909,40
86872305128,86872305128,0,1814,3513,40
86873202127,86873202137,10,346,1293,40
86873449951,86873449945,-6,807,3793,40
86876779489,86876779485,-4,1299,4205,40
86877401567,86877401561,-6,959,3200,40
86877569156,86877569170,14,208,974,40
86885083276,86885083270,-6,882,3708,40
86886441499,86886441498,-1,9045,14083,40
86891927855,86891927854,-1,1012,1551,40
86892974613,86892974599,-14,763,3257,40
86893295949,86893295964,15,802,3868,40
86916083218,86916083215,-3,871,2118,40
86920949731,86920949725,-6,740,3492,40
86923363687,86923363681,-6,847,4178,40
86935428803,86935428795,-8,1303,4575,40
86937006009,86937006003,-6,707,2918,40
86942407798,86942407793,-5,845,3492,40
86942533824,86942533836,12,802,3537,40
86948833255,86948833249,-6,738,3714,40
86950071743,86950071736,-7,647,3118,40
86950817057,86950817050,-7,949,2987,40
86953090529,86953090524,-5,696,4201,40
86955768963,86955768964,1,1962,1788,40
86958015583,86958015576,-7,1157,3929,40
86961648801,86961648794,-7,1364,5417,40
86969287057,86969287056,-1,592,1312,40
86969585455,86969585450,-5,1383,4917,40
86974235086,86974235080,-6,860,3452,40
86980272833,86980272826,-7,783,2647,40
86980496582,86980496598,16,53,1646,40
86985030611,86985030606,-5,959,3086,40
86985261991,86985261993,2,273,1770,40
86988261150,86988261142,-8,68,904,40
86991106902,86991106897,-5,1230,3374,40
87005092802,87005092796,-6,1944,5151,40
87006119362,87006119356,-6,721,3252,40
87008637855,87008637849,-6,1255,4870,40
87015647430,87015647424,-6,1051,4645,40
87020742958,87020742954,-4,714,2747,40
87025264103,87025264097,-6,927,3922,40
87027019590,87027019583,-7,853,4390,40
87027321997,87027321988,-9,1071,3037,40
87029714222,87029714215,-7,1002,1786,40
87043744133,87043744128,-5,904,3215,40
87046384387,87046384381,-6,1119,3617,40
87051421766,87051421765,-1,1193,1370,40
87052973261,87052973256,-5,816,2258,40
87053028967,87053028982,15,216,1022,40
87054324719,87054324729,10,11,1605,40
87055211535,87055211530,-5,892,3902,40
87062855290,87062855294,4,3404,1825,40
87069801543,87069801545,2,1249,1491,40
87071108167,87071108162,-5,934,3362,40
87074209593,87074209597,4,1644,1166,40
87074759109,87074759103,-6,1186,3951,40
87074848462,87074848473,11,84,1237,40
87080573193,87080573186,-7,1101,5730,40
87083144662,87083144658,-4,900,2845,40
87083713938,87083713933,-5,730,2585,40
87099705658,87099705653,-5,990,3263,40
87101856781,87101856775,-6,935,3470,40
87102457909,87102457930,21,573,2802,40
87104912537,87104912531,-6,602,1370,40
87106113793,87106113788,-5,863,3458,40
87106149904,87106149898,-6,932,3127,40
87107996373,87107996374,1,1458,1686,40
87113377025,87113377032,7,2052,1284,40
87116306523,87116306517,-6,656,4308,40
87119966942,87119966936,-6,1457,4836,40
87120018998,87120019007,9,107,438,40
87120888767,87120888761,-6,940,4070,40
87125358478,87125358472,-6,921,3279,40
87129271211,87129271205,-6,1091,4017,40
87135230762,87135230757,-5,885,3820,40
87135350365,87135350358,-7,1242,5325,40
87135790843,87135790836,-7,927,3258,40
87136171854,87136171849,-5,1095,4654,40
87140148802,87140148794,-8,1048,3559,40
87147986065,87147986058,-7,1745,5085,40
87149425017,87149425013,-4,909,3426,40
87149728921,87149728913,-8,886,3729,40
87151104806,87151104807,1,1418,1468,40
87152454875,87152454867,-8,1179,4629,40
87152895389,87152895374,-15,904,3626,40
87157343357,87157343351,-6,1004,3592,40
87158896917,87158896918,1,1568,1475,40
87165801336,87165801331,-5,953,3165,40
87173188461,87173188454,-7,1027,4653,40
87176990221,87176990214,-7,1157,5727,40
87177104488,87177104506,18,466,2370,40
87177638951,87177638959,8,8839,34700,40
87178232334,87178232326,-8,851,3914,40
87178265336,87178265350,14,552,2069,40
87182573087,87182573079,-8,1007,3764,40
87186157129,87186157121,-8,1070,5634,40
87186302625,87186302631,6,2430,1091,40
87188863871,87188863878,7,5683,2911,40
87193902348,87193902344,-4,2353,4705,40
87200405876,87200405870,-6,946,3672,40
87202116827,87202116823,-4,1274,3951,40
87203358869,87203358863,-6,1114,3327,40
87211686879,87211686874,-5,811,2389,40
87219730968,87219730954,-14,1131,3801,40
87225834941,87225834936,-5,843,3553,40
87227138246,87227138241,-5,1281,3867,40
87229904847,87229904842,-5,834,4141,40
87230853345,87230853350,5,24670,1354,40
87231987631,87231987625,-6,542,1135,40
87237347043,87237347037,-6,976,2880,40
87247082259,87247082254,-5,1131,3679,40
87247255845,87247255865,20,657,2425,40
87250336839,87250336831,-8,1007,3884,40
87251251212,87251251198,-14,48,1131,40
87252050735,87252050730,-5,766,2740,40
87254423335,87254423329,-6,1118,4387,40
87260182770,87260182763,-7,1012,2932,40
87261772096,87261772089,-7,1252,3259,40
87263168062,87263168055,-7,1286,4763,40
87268074320,87268074314,-6,717,3815,40
87271198544,87271198538,-6,1049,3316,40
87278657867,87278657862,-5,931,3614,40
87287560575,87287560570,-5,1085,3981,40
87293612298,87293612293,-5,637,1288,40
87307756895,87307756890,-5,958,3307,40
87309360303,87309360298,-5,985,2341,40
87316696184,87316696178,-6,1045,2068,40
87319753588,87319753583,-5,1123,2992,40
87319912204,87319912224,20,810,2790,40
87320669409,87320669413,4,3558,2316,40
87324031350,87324031355,5,4438,1891,40
87325248421,87325248417,-4,894,2951,40
87327751946,87327751941,-5,521,1753,40
87327825120,87327825131,11,329,1476,40
87329634382,87329634377,-5,859,3394,40
87334885950,87334885943,-7,791,3963,40
87340534574,87340534567,-7,1206,5114,40
87350006530,87350006524,-6,932,4420,40
87350107686,87350107705,19,74,1214,40
87354153201,87354153209,8,3134,1165,40
87355258760,87355258754,-6,969,4765,40
87355639855,87355639870,15,708,3294,40
87355830061,87355830054,-7,1036,4610,40
87358009029,87358009026,-3,868,2097,40
87358228605,87358228622,17,90,1221,40
87358286151,87358286131,-20,112,1119,40
87359325493,87359325482,-11,15,1167,40
87362091584,87362091591,7,1625,937,40
87363117207,87363117204,-3,971,3128,40
87370002040,87370002034,-6,1049,3140,40
87376969084,87376969095,11,15521,24397,40
87388034666,87388034661,-5,946,3589,40
87388774126,87388774143,17,703,2568,40
87389652749,87389652743,-6,663,3334,40
87389713878,87389713886,8,220,1778,40
87389984342,87389984342,0,156,1578,40
87393982537,87393982532,-5,1230,3839,40
87402015279,87402015273,-6,603,3233,40
87402094310,87402094326,16,764,3755,40
87403308700,87403308693,-7,803,5268,40
87403474912,87403474902,-10,814,4356,40
87404720199,87404720186,-13,248,1867,40
87405402110,87405402096,-14,110,1588,40
87405571161,87405571165,4,2967,1400,40
87409099442,87409099446,4,2241,1703,40
87415706046,87415706042,-4,1026,3120,40
87415919678,87415919673,-5,783,3098,40
87416758831,87416758824,-7,726,2849,40
87420815466,87420815470,4,1750,1048,40
87421665474,87421665466,-8,555,3032,40
87422710366,87422710359,-7,992,3587,40
87423453734,87423453726,-8,1347,5057,40
87423778096,87423778093,-3,29,515,40
87425074916,87425074910,-6,1082,5083,40
87429262500,87429262495,-5,1299,3375,40
87429324135,87429324131,-4,857,3168,40
87446791830,87446791826,-4,725,2358,40
87447233311,87447233310,-1,132,1409,40
87447470354,87447470347,-7,1469,5397,40
87447911699,87447911693,-6,1318,3606,40
87448548002,87448547995,-7,1385,4389,40
87454511737,87454511729,-8,1080,4202,40
87458203782,87458203774,-8,1068,3971,40
87458750249,87458750242,-7,1052,5696,40
87459078783,87459078786,3,435,1550,40
87471203058,87471203073,15,1114,160,40
87472117373,87472117381,8,120,743,40
87474057015,87474057009,-6,1002,3303,40
87474304678,87474304671,-7,842,2891,40
87476780198,87476780193,-5,1270,4367,40
87478908294,87478908289,-5,536,3162,40
87479336524,87479336543,19,211,1049,40
87480017925,87480017917,-8,1317,6220,40
87481043483,87481043480,-3,802,2355,40
87483945945,87483945938,-7,740,2009,40
87484641711,87484641706,-5,890,3469,40
87486047510,87486047513,3,1150,1556,40
87491464639,87491464633,-6,1383,4280,40
87495913910,87495913904,-6,1226,4090,40
87503755917,87503755916,-1,1307,2141,40
87505799334,87505799333,-1,1151,1466,40
87506600022,87506600021,-1,405,1235,40
87507547394,87507547401,7,3502,1455,40
87513453039,87513453034,-5,1039,3504,40
87514647126,87514647127,1,2890,2813,40
87523526669,87523526665,-4,19086,16009,40
87525762042,87525762037,-5,1077,3550,40
87526280509,87526280530,21,1248,1158,40
87527304247,87527304247,0,253,1067,40
87528121950,87528121941,-9,1146,3815,40
87533185757,87533185762,5,3642,1374,40
87533306350,87533306345,-5,943,3223,40
87557163348,87557163342,-6,1011,4449,40
87560503525,87560503527,2,1127,1994,40
87560653550,87560653570,20,1259,3433,40
87567776580,87567776573,-7,918,3057,40
87568247822,87568247801,-21,910,2078,40
87568919943,87568919938,-5,81,691,40
87570318062,87570318056,-6,1185,3560,40
87575641810,87575641805,-5,916,2731,40
87582871482,87582871481,-1,917,1770,40
87583081747,87583081741,-6,982,3741,40
87583190436,87583190451,15,359,2257,40
87583734215,87583734206,-9,630,2516,40
87588229799,87588229794,-5,802,2819,40
87594054209,87594054214,5,3617,1961,40
87603415143,87603415139,-4,1208,3733,40
87606815758,87606815753,-5,528,3636,40
87609079779,87609079772,-7,948,5573,40
87616049615,87616049609,-6,2529,10765,40
87622238015,87622238009,-6,1164,5646,40
87622735434,87622735429,-5,997,4657,40
87625293762,87625293756,-6,873,3472,40
87627261824,87627261818,-6,1145,4537,40
87628890674,87628890668,-6,758,2605,40
87633865326,87633865320,-6,1158,3579,40
87635557159,87635557154,-5,1130,3146,40
87636809894,87636809893,-1,901,1704,40
87640738011,87640738005,-6,585,3335,40
87642720449,87642720469,20,2149,1592,40
87647926574,87647926567,-7,779,3465,40
87647974165,87647974171,6,147,1235,40
87655198691,87655198685,-6,1059,3613,40
87655693481,87655693474,-7,742,3140,40
87657032415,87657032401,-14,1170,3110,40
87657509426,87657509422,-4,885,2254,40
87659579865,87659579860,-5,948,3512,40
87663563770,87663563767,-3,1284,1948,40
87664398596,87664398589,-7,1019,4234,40
87664841276,87664841269,-7,131,1078,40
87666861933,87666861928,-5,964,3957,40
87669477929,87669477924,-5,935,2256,40
87672235022,87672235018,-4,1022,3752,40
87674854003,87674853997,-6,1165,4464,40
87681771334,87681771329,-5,981,3495,40
87682248271,87682248266,-5,1246,3958,40
87683602018,87683602014,-4,765,2540,40
87688644539,87688644533,-6,663,3525,40
87690742814,87690742809,-5,985,4755,40
87691296405,87691296400,-5,1350,5256,40
87692509178,87692509173,-5,998,2786,40
87694963439,87694963434,-5,741,2857,40
87695479977,87695479972,-5,723,2938,40
87697474682,87697474675,-7,1127,3468,40
87709496753,87709496775,22,2475,1544,40
87715819985,87715819980,-5,1456,4394,40
87717854877,87717854874,-3,815,3020,40
87720242393,87720242386,-7,1381,5359,40
87722505091,87722505085,-6,821,2228,40
87725718063,87725718058,-5,878,3703,40
87727170239,87727170232,-7,1026,3248,40
87727747026,87727747020,-6,983,5180,40
87728593667,87728593662,-5,887,3256,40
87736755378,87736755370,-8,1443,9265,40
87737733625,87737733618,-7,1232,4214,40
87746995396,87746995390,-6,958,4242,40
87747421328,87747421342,14,1204,4574,40
87748652289,87748652283,-6,1157,3792,40
87750082287,87750082290,3,1108,763,40
87752392057,87752392056,-1,1410,2441,40
87752557678,87752557661,-17,257,656,40
87757300009,87757300006,-3,1174,1538,40
87757893837,87757893858,21,387,1576,40
87762030514,87762030510,-4,941,1679,40
87773318109,87773318102,-7,794,4646,40
87774921546,87774921539,-7,720,3200,40
87775114335,87775114313,-22,239,1141,40
87776548387,87776548380,-7,1117,4427,40
87778064845,87778064841,-4,5191,14839,40
87780811689,87780811685,-4,667,1577,40
87782573487,87782573482,-5,1278,2854,40
87787934211,87787934205,-6,889,4435,40
87787987750,87787987735,-15,648,1867,40
87789875971,87789875968,-3,2106,5859,40
87790559471,87790559466,-5,833,2403,40
87797159790,87797159785,-5,737,2467,40
87801769856,87801769850,-6,1377,5592,40
87802129376,87802129369,-7,1044,3255,40
87802989698,87802989695,-3,1008,2769,40
87803155030,87803155026,-4,1004,3341,40
87806381409,87806381405,-4,1164,2943,40
87822607321,87822607315,-6,1295,3984,40
87829481605,87829481599,-6,993,3505,40
87831880203,87831880199,-4,1083,3168,40
87832000992,87832001010,18,552,3331,40
87835388693,87835388694,1,2726,2756,40
87835771478,87835771474,-4,1185,2290,40
87837261620,87837261613,-7,719,4241,40
87838267555,87838267548,-7,983,2907,40
87838457172,87838457162,-10,103,936,40
87840334471,87840334468,-3,328,1117,40
87842636689,87842636682,-7,819,2374,40
87845224117,87845224111,-6,905,2592,40
87860627849,87860627842,-7,830,4124,40
87865317319,87865317314,-5,731,3261,40
87866170209,87866170204,-5,1030,3634,40
87866651815,87866651819,4,222,915,40
87870093566,87870093567,1,1939,1468,40
87875166425,87875166421,-4,1474,3364,40
87887614978,87887614973,-5,881,3802,40
87889634826,87889634826,0,2012,1996,40
87890732921,87890732923,2,1479,1066,40
87891590574,87891590569,-5,1442,3656,40
87900119391,87900119386,-5,1048,2580,40
87904443446,87904443441,-5,1119,4946,40
87909801743,87909801738,-5,855,4622,40
87916978976,87916978972,-4,840,4690,40
87917195994,87917195989,-5,755,2735,40
87918376479,87918376491,12,642,2503,40
87922659641,87922659637,-4,957,2291,40
87926220945,87926220938,-7,739,2522,40
87926334487,87926334478,-9,522,1341,40
87932123106,87932123101,-5,1041,4101,40
87933587020,87933587018,-2,1278,1228,40
87933900443,87933900438,-5,931,3960,40
87938215501,87938215508,7,14608,25086,40
87939880559,87939880553,-6,1452,5044,40
87940591502,87940591498,-4,1004,3359,40
87944884069,87944884063,-6,1157,4664,40
87945802838,87945802831,-7,977,3326,40
87946594976,87946594969,-7,850,4647,40
87949938262,87949938256,-6,687,3434,40
87951758374,87951758381,7,4118,1393,40
87952763526,87952763520,-6,1070,5144,40
87959089047,87959089041,-6,554,4536,40
87960387029,87960387023,-6,1033,2724,40
87965989679,87965989673,-6,1159,3401,40
87966447140,87966447160,20,379,1531,40
87966945933,87966945933,0,2417,4489,40
87968587201,87968587196,-5,1263,3403,40
87977667414,87977667419,5,2293,938,40
87989499593,87989499587,-6,889,3589,40
88010961284,88010961278,-6,1052,3396,40
88011035133,88011035147,14,951,3628,40
88016016135,88016016129,-6,891,3321,40
88017682979,88017682973,-6,765,3896,40
88027625117,88027625115,-2,1127,2163,40
88030507441,88030507436,-5,941,2902,40
88031159012,88031159031,19,183,1133,40
88031466979,88031466973,-6,1040,3180,40
88032643887,88032643882,-5,925,2305,40
88040646537,88040646535,-2,1117,2422,40
88041327736,88041327729,-7,894,2474,40
88041614224,88041614242,18,817,2400,40
88044258455,88044258448,-7,1105,5073,40
88044825934,88044825952,18,122,1760,40
88048059254,88048059249,-5,708,2487,40
88048948340,88048948335,-5,1096,3191,40
88050885841,88050885834,-7,1081,4329,40
88051878113,88051878106,-7,1028,4871,40
88054485573,88054485567,-6,829,3658,40
88055201039,88055201045,6,293,1738,40
88055585020,88055585027,7,222,1225,40
88068331666,88068331661,-5,936,2769,40
88070661026,88070661021,-5,1101,4033,40
88070697194,88070697187,-7,1157,3737,40
88073177242,88073177238,-4,1159,3669,40
88079256833,88079256829,-4,1282,3041,40
88080987830,88080987818,-12,248,2522,40
88082803511,88082803506,-5,789,2833,40
88083572590,88083572582,-8,128,560,40
88083954740,88083954758,18,497,2477,40
88093015202,88093015197,-5,11264,16069,40
88100163959,88100163954,-5,1107,2955,40
88114646521,88114646522,1,23429,18198,40
88117550305,88117550298,-7,735,3675,40
88118748259,88118748255,-4,978,2806,40
88118954629,88118954623,-6,1476,2581,40
88119763693,88119763675,-18,1137,2178,40
88120225686,88120225682,-4,1356,3886,40
88126642485,88126642482,-3,727,2576,40
88128532873,88128532873,0,1737,2963,40
88131071116,88131071110,-6,998,5157,40
88131467679,88131467682,3,1587,1423,40
88135747124,88135747119,-5,1064,3365,40
88136904958,88136904937,-21,1469,4387,40
88137370199,88137370197,-2,831,2130,40
88139358632,88139358636,4,2057,1839,40
88139694139,88139694133,-6,1216,4045,40
88142201249,88142201243,-6,816,2882,40
88143920686,88143920680,-6,622,2944,40
88144424424,88144424437,13,205,890,40
88144649148,88144649138,-10,1232,4331,40
88145182875,88145182870,-5,758,3541,40
88146883222,88146883214,-8,1413,4746,40
88147352877,88147352870,-7,1124,4729,40
88147866557,88147866553,-4,953,3901,40
88158218510,88158218505,-5,1659,2584,40
88158326677,88158326662,-15,94,760,40
88159435810,88159435807,-3,783,2220,40
88159943575,88159943594,19,351,1151,40
88167499082,88167499077,-5,934,3023,40
88168546101,88168546095,-6,823,3777,40
88169583502,88169583497,-5,97,1424,40
88177562997,88177562990,-7,1102,5514,40
88178604895,88178604892,-3,1459,2738,40
88182791798,88182791789,-9,917,3233,40
88201491685,88201491679,-6,885,3095,40
88201867405,88201867391,-14,184,841,40
88202622180,88202622197,17,608,2778,40
88205177703,88205177697,-6,934,5096,40
88207866506,88207866499,-7,917,4436,40
88208741470,88208741464,-6,1344,5526,40
88208909782,88208909797,15,124,1343,40
88210784675,88210784669,-6,723,2189,40
88215239652,88215239635,-17,12,518,40
88215530569,88215530567,-2,20727,12341,40
88218437266,88218437261,-5,1014,2984,40
88220057394,88220057389,-5,1056,4737,40
88220276340,88220276327,-13,118,1175,40
88226384443,88226384435,-8,999,4014,40
88230772334,88230772326,-8,1257,3282,40
88235964785,88235964784,-1,1658,2361,40
88236429157,88236429177,20,706,2916,40
88239821069,88239821075,6,2988,893,40
88243415255,88243415249,-6,825,2376,40
88252368839,88252368836,-3,8229,17218,40
88253819297,88253819290,-7,969,3880,40
88267551220,88267551214,-6,931,4225,40
88271216786,88271216781,-5,862,2404,40
88271437904,88271437898,-6,926,3354,40
88272584934,88272584938,4,1287,911,40
88281149662,88281149658,-4,734,2784,40
88282165681,88282165677,-4,1046,3009,40
88285939517,88285939510,-7,1048,4106,40
88288915762,88288915782,20,344,1393,40
88290078066,88290078060,-6,811,2929,40
88298175189,88298175181,-8,1430,4575,40
88298717807,88298717797,-10,14,757,40
88299362630,88299362624,-6,1173,4637,40
88305704018,88305704010,-8,984,4896,40
88311513873,88311513866,-7,986,3919,40
88311749093,88311749110,17,291,1210,40
88312433596,88312433590,-6,727,4406,40
88319591525,88319591519,-6,991,3656,40
88320909872,88320909886,14,945,3668,40
88321199747,88321199742,-5,799,3664,40
88322181962,88322181957,-5,1319,3317,40
88325040642,88325040636,-6,1055,3280,40
88326994878,88326994870,-8,1085,4478,40
88331314158,88331314151,-7,1297,4175,40
88336380078,88336380093,15,922,3586,40
88341446594,88341446594,0,896,1750,40
88349762995,88349762990,-5,1879,6141,40
88350182019,88350182014,-5,382,1482,40
88351684118,88351684111,-7,1044,4408,40
88357315433,88357315426,-7,1343,5092,40
88362326755,88362326756,1,9885,11980,40
88362417823,88362417818,-5,831,3674,40
88368182446,88368182450,4,1675,1151,40
88375083775,88375083768,-7,1143,3878,40
88398101599,88398101595,-4,947,3012,40
88403509701,88403509695,-6,48564,15378,40
88405686626,88405686623,-3,1191,1880,40
88406390897,88406390898,1,1488,2967,40
88407499719,88407499713,-6,761,3098,40
88408106813,88408106806,-7,1085,3404,40
88412935263,88412935254,-9,1217,3130,40
88416927447,88416927445,-2,1070,1813,40
88423011536,88423011530,-6,1102,3400,40
88423231255,88423231240,-15,836,3219,40
88424304750,88424304765,15,459,2942,40
88432712917,88432712917,0,4062,17726,40
88438464910,88438464904,-6,724,1756,40
88450771895,88450771891,-4,1435,3645,40
88452258931,88452258925,-6,966,3612,40
88466700984,88466700977,-7,522,2162,40
88467627838,88467627843,5,2585,1386,40
88470353326,88470353321,-5,1147,3662,40
88472598361,88472598355,-6,791,2154,40
88484468274,88484468269,-5,945,3380,40
88486637302,88486637297,-5,1026,2487,40
88488889774,88488889769,-5,1363,3383,40
88491562112,88491562107,-5,986,4108,40
88492005019,88492005013,-6,1237,4299,40
88497594074,88497594092,18,426,1281,40
88497748663,88497748656,-7,1465,3906,40
88499192053,88499192047,-6,1136,4457,40
88507420109,88507420103,-6,1369,4534,40
88509629963,88509629958,-5,932,3922,40
88510787691,88510787687,-4,1091,2272,40
88518198834,88518198843,9,2665,1348,40
88524243421,88524243414,-7,1198,5181,40
88529468002,88529467996,-6,902,3000,40
88530823253,88530823248,-5,599,3951,40
88536735118,88536735122,4,3651,1957,40
88537059102,88537059096,-6,972,2977,40
88542546871,88542546865,-6,859,3721,40
88543489504,88543489526,22,962,1490,40
88556260438,88556260430,-8,1326,4061,40
88557157725,88557157738,13,614,3131,40
88559529092,88559529094,2,1916,1395,40
88565299339,88565299333,-6,1210,4963,40
88568044135,88568044130,-5,905,3700,40
88568790083,88568790074,-9,504,4097,40
88570176731,88570176729,-2,1014,2523,40
88571137241,88571137235,-6,1390,4003,40
88571660199,88571660202,3,2524,1693,40
88573568507,88573568502,-5,931,2714,40
88580231641,88580231648,7,1108,348,40
88582273394,88582273392,-2,1159,1734,40
88582456374,88582456369,-5,1268,4181,40
88584920637,88584920630,-7,946,3175,40
88589691631,88589691625,-6,1115,5703,40
88589729670,88589729681,11,680,2907,40
88591675942,88591675945,3,2143,1549,40
88598160822,88598160817,-5,798,2772,40
88601293782,88601293777,-5,898,2626,40
88602687035,88602687030,-5,915,3664,40
88603070285,88603070278,-7,850,3280,40
88605915019,88605915014,-5,1686,4159,40
88610412719,88610412713,-6,1107,3282,40
88610875747,88610875747,0,1091,1302,40
88611488439,88611488453,14,848,2996,40
88612858625,88612858621,-4,1281,2172,40
88615958872,88615958867,-5,863,3230,40
88616233071,88616233070,-1,136,1063,40
88616928103,88616928102,-1,641,965,40
88620037037,88620037032,-5,1026,3468,40
88621052030,88621052029,-1,1308,1906,40
88621308787,88621308782,-5,1576,4722,40
88625313894,88625313889,-5,972,3081,40
88625833902,88625833914,12,726,3371,40
88629376597,88629376591,-6,1164,3559,40
88633236654,88633236648,-6,1023,3152,40
88636037457,88636037452,-5,1473,3704,40
88643925958,88643925953,-5,1375,5410,40
88644851646,88644851642,-4,993,2661,40
88646320088,88646320104,16,934,3015,40
88652226955,88652226949,-6,1193,2809,40
88652292013,88652292013,0,162,813,40
88655798641,88655798636,-5,1163,4074,40
88656255572,88656255562,-10,236,890,40
88656655432,88656655426,-6,1089,3362,40
88657671358,88657671359,1,1899,1585,40
88660639070,88660639066,-4,1092,3181,40
88667452617,88667452613,-4,1276,3758,40
88686726161,88686726156,-5,26999,12934,40
88688604901,88688604896,-5,822,3627,40
88697157079,88697157073,-6,1194,3827,40
88698065725,88698065718,-7,1210,3854,40
88700067967,88700067971,4,2430,2024,40
88715777703,88715777709,6,2603,1399,40
88726302075,88726302080,5,2053,1260,40
88728013947,88728013944,-3,1258,3145,40
88728152975,88728152971,-4,519,1589,40
88747574978,88747574972,-6,848,2875,40
88749302345,88749302339,-6,950,3640,40
88750573727,88750573722,-5,715,3456,40
88752749862,88752749857,-5,874,4166,40
88753152946,88753152938,-8,34820,46381,40
88762379009,88762379004,-5,1021,2931,40
88767822167,88767822162,-5,685,3379,40
88767862079,88767862080,1,387,1134,40
88770829985,88770830000,15,981,3058,40
88774392312,88774392318,6,3146,1459,40
88775839319,88775839315,-4,1372,3868,40
88775956608,88775956585,-23,202,1378,40
88778260029,88778260033,4,1827,1759,40
88778428588,88778428582,-6,745,3201,40
88786466606,88786466593,-13,1283,27352,40
88789068039,88789068032,-7,1661,4924,40
88803640250,88803640246,-4,1195,3161,40
88804735198,88804735200,2,126,1920,40
88812575146,88812575140,-6,999,4002,40
88812617597,88812617615,18,927,2417,40
88813498307,88813498301,-6,1111,5193,40
88816935006,88816934999,-7,1114,3526,40
88818325986,88818325988,2,3855,2674,40
88825110974,88825110970,-4,960,3075,40
88825183431,88825183448,17,1025,2485,40
88826695905,88826695897,-8,718,3906,40
88826895910,88826895904,-6,1323,4600,40
88831499214,88831499208,-6,976,3350,40
88832207190,88832207195,5,2693,1842,40
88833824891,88833824884,-7,828,3422,40
88834281008,88834281023,15,320,1127,40
88839641650,88839641646,-4,813,2092,40
88840357640,88840357657,17,630,3007,40
88841532365,88841532358,-7,1415,4291,40
88842740565,88842740559,-6,1276,2850,40
88843050911,88843050925,14,1604,3960,40
88852945011,88852945005,-6,902,2314,40
88856800395,88856800389,-6,1773,5125,40
88858311746,88858311744,-2,28871,27790,40
88858619226,88858619221,-5,1103,4145,40
88864500954,88864500952,-2,3124,4800,40
88868384950,88868384944,-6,1176,4934,40
88874214757,88874214753,-4,1012,3405,40
88874391183,88874391165,-18,198,988,40
88878118892,88878118877,-15,185,1776,40
88881782157,88881782151,-6,942,3764,40
88883108026,88883108022,-4,817,4401,40
88885225084,88885225077,-7,1040,3383,40
88885484981,88885484967,-14,417,1230,40
88891268041,88891268036,-5,1446,4080,40
88904752230,88904752222,-8,928,3373,40
88910526581,88910526590,9,204,916,40
88911504835,88911504829,-6,1292,3883,40
88916271389,88916271391,2,1672,1422,40
88916484164,88916484158,-6,872,3489,40
88916567660,88916567650,-10,900,3449,40
88921157909,88921157903,-6,788,2292,40
88922308046,88922308049,3,1512,1377,40
88924270286,88924270285,-1,1811,2044,40
88938072253,88938072247,-6,935,2983,40
88938120469,88938120490,21,935,3643,40
88938516081,88938516075,-6,2421,6582,40
88938968174,88938968166,-8,707,2787,40
88946982283,88946982276,-7,1200,3591,40
88951522746,88951522742,-4,876,3410,40
88952064626,88952064621,-5,990,4634,40
88953050679,88953050674,-5,840,3237,40
88956812398,88956812403,5,5859,2874,40
88960688510,88960688505,-5,944,3692,40
88965474713,88965474710,-3,948,2451,40
88966814346,88966814349,3,1505,1579,40
88972821583,88972821579,-4,1406,2519,40
88973463054,88973463046,-8,812,4899,40
88973997799,88973997813,14,719,4384,40
88977033432,88977033429,-3,1001,2033,40
88977374543,88977374546,3,115,1300,40
88979798742,88979798737,-5,795,3685,40
88980135294,88980135314,20,739,2108,40
88983359966,88983359962,-4,1313,1685,40
88996026047,88996026039,-8,1038,3500,40
88998318199,88998318194,-5,1128,2399,40
88999047341,88999047359,18,26,931,40
89012027158,89012027154,-4,856,3915,40
89020228044,89020228051,7,3920,1662,40
89025425942,89025425940,-2,945,2854,40
89026135489,89026135484,-5,1017,3835,40
89032941030,89032941043,13,716,2361,40
89035303031,89035303026,-5,856,3970,40
89035459822,89035459833,11,326,2372,40
89035680797,89035680786,-11,1069,3748,40
89038135018,89038135010,-8,992,4309,40
89038196716,89038196723,7,420,2014,40
89047797046,89047797050,4,2206,2275,40
89049217259,89049217254,-5,927,3338,40
89053125019,89053125013,-6,889,4754,40
89053400462,89053400480,18,771,3727,40
89053993778,89053993786,8,6180,2124,40
89055417517,89055417515,-2,2360,3883,40
89064054028,89064054035,7,3861,1074,40
89066618414,89066618400,-14,1836,545,40
89073911765,89073911761,-4,1010,4309,40
89077004687,89077004706,19,880,3159,40
89083357602,89083357598,-4,856,4015,40
89083910455,89083910449,-6,1039,4224,40
89095797131,89095797125,-6,988,3492,40
89097492315,89097492309,-6,753,4752,40
89097696237,89097696246,9,150,1107,40
89104877918,89104877911,-7,987,4292,40
89105786875,89105786866,-9,854,2807,40
89106427791,89106427793,2,231,1023,40
89116928535,89116928526,-9,1020,3442,40
89117168749,89117168734,-15,161,1246,40
89117583211,89117583206,-5,1257,2900,40
89119923973,89119923969,-4,1004,1969,40
89132695350,89132695344,-6,865,2582,40
89132864046,89132864067,21,791,3362,40
89135463371,89135463366,-5,929,2702,40
89136727469,89136727449,-20,958,3794,40
89136989957,89136989973,16,397,4098,40
89137987161,89137987154,-7,1304,3948,40
89138984550,89138984544,-6,787,3239,40
89142773007,89142773002,-5,1062,4470,40
89145554069,89145554062,-7,2209,7888,40
89146974043,89146974036,-7,1015,6162,40
89147523612,89147523633,21,107,1598,40
89153059585,89153059577,-8,1339,5527,40
89154904432,89154904414,-18,176,921,40
89157617911,89157617905,-6,768,4889,40
89158043646,89158043665,19,686,2006,40
89160452042,89160452036,-6,1108,5858,40
89163794992,89163794985,-7,1101,4333,40
89164242759,89164242745,-14,828,3667,40
89166963070,89166963066,-4,1171,3569,40
89172489895,89172489889,-6,1120,3587,40
89178829334,89178829329,-5,901,3059,40
89182605439,89182605435,-4,1038,2214,40
89190223210,89190223206,-4,1096,3631,40
89190473888,89190473907,19,724,3758,40
89191781231,89191781226,-5,873,2720,40
89196388935,89196388930,-5,1144,3875,40
89196671631,89196671625,-6,191,1497,40
89197120743,89197120725,-18,131,1290,40
89203428793,89203428797,4,1853,1416,40
89218358727,89218358721,-6,1130,4370,40
89218951931,89218951926,-5,902,3003,40
89220542708,89220542701,-7,1994,10978,40
89224714013,89224714008,-5,1464,3894,40
89226344604,89226344609,5,2637,1749,40
89237036839,89237036833,-6,907,3687,40
89249096681,89249096673,-8,1257,6845,40
89249763839,89249763834,-5,1116,2979,40
89252936657,89252936650,-7,1165,3243,40
89253750631,89253750626,-5,996,4773,40
89253786128,89253786141,13,843,3812,40
89259255951,89259255945,-6,1086,4030,40
89259799332,89259799314,-18,327,1029,40
89261401393,89261401386,-7,636,2319,40
89261494102,89261494109,7,120,852,40
89261835175,89261835154,-21,557,3457,40
89272316908,89272316906,-2,2962,4557,40
89277156934,89277156928,-6,792,3084,40
89280555091,89280555098,7,2602,1247,40
89286437158,89286437164,6,3712,1179,40
89293095534,89293095527,-7,1252,4100,40
89293707994,89293707989,-5,848,5080,40
89304703559,89304703554,-5,746,3376,40
89305349758,89305349745,-13,233,1846,40
89305446405,89305446389,-16,863,3365,40
89305783103,89305783096,-7,178,1415,40
89305913352,89305913365,13,503,1242,40
89310034856,89310034850,-6,1555,4159,40
89310544983,89310544977,-6,904,3520,40
89315202907,89315202901,-6,941,3619,40
89326536945,89326536947,2,1034,862,40
89329857193,89329857188,-5,664,3592,40
89337139214,89337139210,-4,1209,3426,40
89338531834,89338531829,-5,1118,3188,40
89340025809,89340025802,-7,1202,4000,40
89340435660,89340435654,-6,1096,4243,40
89341203975,89341203970,-5,784,2736,40
89344280102,89344280096,-6,884,3462,40
89344746156,89344746165,9,253,1161,40
89350800004,89350799998,-6,1308,3352,40
89355574598,89355574604,6,2043,1097,40
89359286767,89359286761,-6,943,3071,40
89359663400,89359663412,12,164,1318,40
89360223764,89360223786,22,677,2974,40
89361739518,89361739514,-4,1048,2746,40
89365892309,89365892310,1,1304,2257,40
89370038253,89370038248,-5,1209,3309,40
89373962708,89373962685,-23,113,1798,40
89378287859,89378287856,-3,1147,1795,40
89384016870,89384016866,-4,1722,4406,40
89384977689,89384977683,-6,842,3457,40
89385215262,89385215252,-10,49,854,40
89386260480,89386260474,-6,813,4949,40
89394095647,89394095639,-8,956,3577,40
89403224228,89403224221,-7,1155,3867,40
89405517134,89405517142,8,5385,2390,40
89410592170,89410592164,-6,1049,3757,40
89414202785,89414202777,-8,1027,4741,40
89422176314,89422176309,-5,1211,4416,40
89423408094,89423408089,-5,1216,3593,40
89430830172,89430830166,-6,1002,2501,40
89435415243,89435415237,-6,1541,3741,40
89437559462,89437559457,-5,797,2979,40
89437793628,89437793645,17,487,1939,40
89455015511,89455015511,0,1334,1195,40
89455787780,89455787802,22,460,1645,40
89455870275,89455870268,-7,1101,3964,40
89457645199,89457645206,7,2518,1361,40
89459247789,89459247789,0,813,1098,40
89461028718,89461028711,-7,530,2412,40
89463801189,89463801186,-3,1175,3419,40
89463965795,89463965790,-5,1213,4891,40
89465247382,89465247375,-7,953,4255,40
89465417105,89465417105,0,1136,2026,40
89465508662,89465508646,-16,310,1306,40
89469340490,89469340485,-5,747,2938,40
89475489467,89475489466,-1,1687,3016,40
89477819183,89477819183,0,1006,2071,40
89478281589,89478281606,17,294,1232,40
89488994561,89488994550,-11,235,1361,40
89489118740,89489118739,-1,1114,2144,40
89491361084,89491361078,-6,851,2555,40
89492462462,89492462460,-2,1029,1266,40
89492908407,89492908422,15,311,1526,40
89493309367,89493309362,-5,1121,4160,40
89494034633,89494034623,-10,2144,940,40
89497689258,89497689258,0,1388,1473,40
89497970894,89497970878,-16,120,968,40
89498972238,89498972233,-5,860,3768,40
89502826342,89502826337,-5,1276,4077,40
89506260392,89506260396,4,19614,18266,40
89513348255,89513348246,-9,1156,4193,40
89517410879,89517410874,-5,923,3542,40
89517612740,89517612726,-14,891,3786,40
89518606414,89518606402,-12,44,1025,40
89519451834,89519451830,-4,1400,2345,40
89519752671,89519752648,-23,790,3721,40
89525234619,89525234621,2,1357,1446,40
89529569618,89529569627,9,13655,28482,40
89529724227,89529724231,4,5150,4548,40
89535163367,89535163362,-5,916,4147,40
89538836008,89538836002,-6,1139,4600,40
89539142944,89539142955,11,436,1464,40
89541905774,89541905769,-5,682,3338,40
89541935749,89541935733,-16,128,1617,40
89542846111,89542846105,-6,1189,3248,40
89543742106,89543742102,-4,1234,3111,40
89544714098,89544714117,19,727,1621,40
89563136278,89563136278,0,1608,2811,40
89563606434,89563606428,-6,1092,3879,40
89564351295,89564351289,-6,656,1813,40
89564992673,89564992678,5,2620,1170,40
89568127626,89568127622,-4,986,2547,40
89568377295,89568377313,18,650,2635,40
89569828613,89569828607,-6,1436,3715,40
89570186796,89570186790,-6,1570,4577,40
89574687004,89574686998,-6,748,2518,40
89577965319,89577965314,-5,886,2942,40
89578174478,89578174462,-16,760,4146,40
89578341157,89578341174,17,252,958,40
89582634609,89582634603,-6,959,3865,40
89583728324,89583728317,-7,624,2187,40
89586489248,89586489244,-4,1153,3450,40
89586808134,89586808115,-19,230,987,40
89589261926,89589261933,7,2959,1343,40
89592990459,89592990452,-7,986,3718,40
89593300414,89593300423,9,148,850,40
89601352227,89601352233,6,5345,1822,40
89603073937,89603073941,4,2173,1461,40
89614163329,89614163322,-7,1066,4508,40
89616096321,89616096315,-6,812,2697,40
89616491907,89616491902,-5,1448,4688,40
89625294855,89625294849,-6,993,2664,40
89625402401,89625402395,-6,922,4184,40
89627037182,89627037181,-1,1735,2225,40
89627330921,89627330928,7,3377,1551,40
89631001047,89631001043,-4,1170,2335,40
89635976129,89635976122,-7,1130,3302,40
89636456928,89636456922,-6,1291,4376,40
89637218039,89637218050,11,189,1511,40
89638304938,89638304933,-5,963,4383,40
89644235023,89644235016,-7,657,4118,40
89645120635,89645120628,-7,1310,4447,40
89645267820,89645267802,-18,814,3203,40
89651430699,89651430693,-6,869,3467,40
89655665552,89655665550,-2,671,1516,40
89655837496,89655837489,-7,607,2557,40
89658535942,89658535937,-5,1239,3916,40
89676429242,89676429235,-7,798,2414,40
89676690110,89676690103,-7,1015,6049,40
89695118226,89695118221,-5,987,4011,40
89701303567,89701303561,-6,1036,2859,40
89706262522,89706262518,-4,1220,3275,40
89713395106,89713395102,-4,817,2044,40
89713715044,89713715041,-3,888,1785,40
89717543646,89717543640,-6,820,3999,40
89719542382,89719542376,-6,1112,3996,40
89720350352,89720350346,-6,942,3630,40
89722430994,89722430989,-5,1069,4690,40
89722741093,89722741105,12,649,3594,40
89728060833,89728060833,0,1057,1087,40
89733562529,89733562524,-5,832,2319,40
89734698911,89734698907,-4,715,2722,40
89741901483,89741901489,6,1401,673,40
89752741522,89752741514,-8,890,4084,40
89755693558,89755693558,0,2087,3031,40
89756165762,89756165757,-5,1036,4739,40
89756805127,89756805138,11,378,968,40
89758003941,89758003935,-6,1076,3162,40
89758873439,89758873425,-14,955,2730,40
89762160479,89762160465,-14,1147,2720,40
89763585326,89763585321,-5,1105,4042,40
89766527582,89766527582,0,1888,1768,40
89777939764,89777939760,-4,688,3670,40
89779505199,89779505202,3,4653,4764,40
89783507657,89783507651,-6,1064,4692,40
89785585750,89785585744,-6,951,2208,40
89789634674,89789634678,4,1987,1116,40
89791049682,89791049674,-8,868,5415,40
89804880306,89804880301,-5,636,1926,40
89805480498,89805480501,3,1472,1075,40
89815698274,89815698267,-7,960,3602,40
89817973279,89817973274,-5,769,3250,40
89820642063,89820642058,-5,1168,4773,40
89823846582,89823846577,-5,1113,3027,40
89825199821,89825199829,8,4868,1365,40
89827012514,89827012507,-7,1440,2587,40
89833513788,89833513781,-7,943,4912,40
89834084007,89834084022,15,847,2560,40
89836797649,89836797643,-6,860,4687,40
89841433575,89841433588,13,723,3162,40
89843571006,89843570999,-7,1058,4543,40
89844278983,89844278978,-5,1242,4074,40
89846132845,89846132838,-7,929,3418,40
89852106662,89852106657,-5,904,3437,40
89861690831,89861690824,-7,1149,3395,40
89864407654,89864407645,-9,33307,16971,40
89870899911,89870899905,-6,1030,4291,40
89872874317,89872874302,-15,1201,2833,40
89879889243,89879889238,-5,623,2216,40
89882084582,89882084574,-8,1591,3746,40
89882621103,89882621117,14,417,1290,40
89883369614,89883369610,-4,1056,3311,40
89897719163,89897719156,-7,1292,4709,40
89898049663,89898049666,3,287,1137,40
89908629551,89908629546,-5,846,2952,40
89910238406,89910238401,-5,1259,3363,40
89919867723,89919867725,2,2222,1988,40
89928377138,89928377134,-4,1510,4373,40
89930958831,89930958826,-5,856,3149,40
89937560081,89937560083,2,9910,8628,40
89938353498,89938353492,-6,892,4099,40
89942346677,89942346672,-5,1802,5999,40
89942573538,89942573524,-14,3507,1159,40
89952214212,89952214206,-6,1026,3849,40
89959225491,89959225483,-8,741,2804,40
89962763554,89962763562,8,15239,12200,40
89967231325,89967231337,12,646,5669,40
89970037010,89970037006,-4,979,4201,40
89971912142,89971912138,-4,1223,2541,40
89972441478,89972441471,-7,1327,5175,40
89973911646,89973911625,-21,249,1303,40
89976808442,89976808442,0,969,1229,40
89990308814,89990308809,-5,1335,4676,40
89991937283,89991937277,-6,762,3368,40
89996431031,89996431025,-6,1238,4653,40
90001354625,90001354621,-4,1239,3966,40
90005006489,90005006486,-3,902,1798,40
90011757508,90011757510,2,1615,1799,40
90014584970,90014584963,-7,666,1633,40
90022743009,90022743003,-6,938,3581,40
90024835718,90024835716,-2,1244,1757,40
90029255689,90029255684,-5,1177,5160,40
90029957517,90029957510,-7,1544,5021,40
90030961656,90030961661,5,161,1213,40
90033946656,90033946650,-6,1008,4225,40
90034228871,90034228875,4,21,1275,40
90049178641,90049178645,4,20133,14420,40
90057563989,90057563998,9,231,875,40
90058513221,90058513222,1,260,1414,40
90060217768,90060217787,19,598,2093,40
90065649475,90065649473,-2,1056,3222,40
90065808942,90065808935,-7,792,2302,40
90069336706,90069336702,-4,931,3145,40
90076709074,90076709070,-4,934,3601,40
90076852434,90076852430,-4,1188,3129,40
90079000767,90079000762,-5,1200,3601,40
90081750818,90081750813,-5,813,3783,40
90083420882,90083420878,-4,979,2946,40
90085452183,90085452175,-8,978,3571,40
90085799247,90085799237,-10,589,3140,40
90086580103,90086580097,-6,988,3428,40
90094816686,90094816681,-5,953,2701,40
90097876227,90097876222,-5,844,3177,40
90101112773,90101112767,-6,2008,8316,40
90102985316,90102985310,-6,1607,3564,40
90103283085,90103283104,19,613,3470,40
90119174457,90119174453,-4,883,4143,40
90122260047,90122260047,0,1300,2161,40
90123087609,90123087603,-6,1061,4262,40
90123691914,90123691908,-6,964,3464,40
90128026265,90128026267,2,1424,1749,40
90130066874,90130066870,-4,1204,3434,40
90134119210,90134119205,-5,1194,4138,40
90135830219,90135830214,-5,867,3529,40
90155825752,90155825734,-18,942,3515,40
90158847547,90158847541,-6,847,2724,40
90162073401,90162073396,-5,766,3661,40
90167611569,90167611563,-6,1127,3513,40
90167967742,90167967736,-6,785,3062,40
90168282599,90168282616,17,235,1289,40
90170034344,90170034338,-6,1016,3084,40
90174660420,90174660414,-6,1016,2876,40
90174771183,90174771182,-1,44,1316,40
90175273944,90175273938,-6,1074,3356,40
90176937504,90176937498,-6,1221,4207,40
90180186775,90180186773,-2,945,2146,40
90181856457,90181856451,-6,1069,4698,40
90186010326,90186010326,0,1305,1756,40
90189614099,90189614094,-5,949,3752,40
90191351086,90191351082,-4,1020,3364,40
90195780685,90195780678,-7,1126,4589,40
90196464949,90196464969,20,402,2095,40
90197929231,90197929226,-5,753,2916,40
90202527612,90202527617,5,80901,41269,40
90205887451,90205887445,-6,1214,3655,40
90214948262,90214948255,-7,821,3121,40
90216800999,90216800994,-5,663,2996,40
90222314692,90222314697,5,3714,1393,40
90223686108,90223686111,3,1526,1036,40
90230387149,90230387153,4,1963,1241,40
90231336227,90231336221,-6,1061,3182,40
90233090663,90233090663,0,1243,2374,40
90233414829,90233414816,-13,159,810,40
90234697255,90234697261,6,3428,1486,40
90243727815,90243727810,-5,896,2040,40
90266617760,90266617759,-1,1264,2052,40
90276276639,90276276633,-6,589,2343,40
90277564837,90277564823,-14,718,3056,40
90279194190,90279194184,-6,994,3591,40
90287207687,90287207681,-6,732,2996,40
90287358863,90287358881,18,427,2590,40
90287689048,90287689042,-6,864,2162,40
90291115243,90291115236,-7,1056,3930,40
90292310446,90292310439,-7,997,3859,40
90302044134,90302044136,2,4960,3913,40
90305760346,90305760347,1,868,931,40
90307191000,90307191001,1,805,1141,40
90307576321,90307576313,-8,1532,4059,40
90309390170,90309390166,-4,1105,3583,40
90309828684,90309828676,-8,807,4942,40
90317025241,90317025233,-8,1744,10428,40
90320395062,90320395068,6,1300,711,40
90322383686,90322383670,-16,119,1364,40
90323524734,90323524737,3,23964,23635,40
90324695253,90324695246,-7,831,4033,40
90325364162,90325364162,0,1690,2598,40
90326355910,90326355906,-4,927,2723,40
90331724922,90331724929,7,4345,1748,40
90336495702,90336495697,-5,767,2782,40
90336523898,90336523896,-2,1087,2119,40
90336812974,90336812952,-22,1117,4426,40
90337607739,90337607732,-7,829,3283,40
90340185568,90340185566,-2,932,1114,40
90341655582,90341655577,-5,741,3561,40
90347392722,90347392717,-5,1414,3342,40
90352910073,90352910068,-5,993,3113,40
90352949984,90352949970,-14,35,1006,40
90355485761,90355485762,1,1123,1667,40
90357358594,90357358594,0,1581,1926,40
90358410962,90358410958,-4,706,2479,40
90358826857,90358826862,5,3393,2257,40
90366335936,90366335939,3,1836,1905,40
90369891557,90369891552,-5,1263,4344,40
90372755470,90372755475,5,3259,1217,40
90389093413,90389093407,-6,1118,3571,40
90389231006,90389231023,17,547,2599,40
90394206047,90394206041,-6,1148,5691,40
90397442930,90397442925,-5,1389,4436,40
90402637523,90402637518,-5,1016,3661,40
90402767957,90402767978,21,530,2599,40
90414970260,90414970253,-7,1183,3150,40
90415427392,90415427407,15,336,794,40
90421112802,90421112798,-4,942,2684,40
90422534341,90422534362,21,1031,4198,40
90423002669,90423002664,-5,865,2906,40
90424437085,90424437078,-7,617,2842,40
90430436643,90430436658,15,406,1984,40
90439132106,90439132099,-7,1189,4014,40
90440714396,90440714391,-5,722,3909,40
90443460189,90443460192,3,64,1069,40
90444051838,90444051837,-1,147,1052,40
90463487475,90463487470,-5,743,1549,40
90465418806,90465418800,-6,1037,3754,40
90467179655,90467179650,-5,1082,3226,40
90468937445,90468937444,-1,1149,1347,40
90470366871,90470366867,-4,22122,9229,40
90470584356,90470584356,0,3549,3685,40
90470666473,90470666477,4,4012,2649,40
90478508849,90478508843,-6,1474,5167,40
90491480135,90491480132,-3,920,2057,40
90493985706,90493985698,-8,1208,4680,40
90494596785,90494596781,-4,1383,3633,40
90496393166,90496393162,-4,867,2969,40
90501280551,90501280546,-5,607,3374,40
90505661510,90505661503,-7,1085,5690,40
90513036058,90513036054,-4,648,1505,40
90519191698,90519191693,-5,1069,4150,40
90519341219,90519341214,-5,900,1926,40
90519605093,90519605085,-8,931,3179,40
90519721423,90519721434,11,190,1308,40
90521211701,90521211705,4,1601,916,40
90526969100,90526969103,3,3723,2962,40
90529956287,90529956280,-7,1315,4832,40
90538965806,90538965798,-8,1139,4083,40
90541659876,90541659869,-7,1264,3465,40
90541746925,90541746937,12,423,1334,40
90546146602,90546146597,-5,1036,3008,40
90571192710,90571192705,-5,1243,3573,40
90572703288,90572703284,-4,988,3178,40
90574684600,90574684595,-5,876,2876,40
90579048635,90579048631,-4,1102,4449,40
90585481286,90585481282,-4,1256,3287,40
90593794175,90593794170,-5,1085,4301,40
90598344833,90598344827,-6,1068,4976,40
90599236070,90599236051,-19,32,833,40
90599426847,90599426856,9,399,1811,40
90600485183,90600485177,-6,1215,2983,40
90601224283,90601224277,-6,868,3120,40
90602688349,90602688360,11,479,1377,40
90603122295,90603122291,-4,1005,3520,40
90606789007,90606788998,-9,998,7302,40
90608044374,90608044393,19,372,1700,40
90619287815,90619287810,-5,1495,4372,40
90620138630,90620138626,-4,640,3001,40
90624858395,90624858389,-6,559,2888,40
90626197518,90626197517,-1,2813,3799,40
90629395915,90629395909,-6,811,4048,40
90629691773,90629691765,-8,947,4090,40
90632087942,90632087958,16,296,1688,40
90636433277,90636433271,-6,916,3531,40
90645826842,90645826837,-5,1471,4204,40
90646966853,90646966849,-4,988,3361,40
90650879923,90650879927,4,1679,1404,40
90651225558,90651225552,-6,1434,2912,40
90657527201,90657527205,4,1422,978,40
90668367817,90668367810,-7,1411,4809,40
90670666198,90670666176,-22,189,2227,40
90672679924,90672679917,-7,949,4989,40
90673241022,90673241009,-13,1026,4309,40
90674749014,90674749007,-7,1220,4787,40
90675564320,90675564307,-13,153,873,40
90680151107,90680151102,-5,898,3475,40
90683773293,90683773287,-6,1185,2558,40
90686614329,90686614322,-7,1172,3748,40
90687713220,90687713211,-9,803,3567,40
90691001679,90691001679,0,2898,3365,40
90696428095,90696428090,-5,1155,2785,40
90701978498,90701978493,-5,953,4411,40
90703216478,90703216473,-5,1464,3213,40
90705429939,90705429940,1,2998,2881,40
90707889161,90707889166,5,2666,915,40
90708061674,90708061666,-8,1417,4983,40
90712328838,90712328834,-4,1027,2800,40
90713620627,90713620623,-4,1211,3075,40
90717430709,90717430714,5,4005,1940,40
90721215212,90721215208,-4,954,2621,40
90726182289,90726182283,-6,806,3709,40
90726882198,90726882219,21,672,4319,40
90729419547,90729419541,-6,992,3650,40
90730819741,90730819734,-7,1124,3597,40
90731395286,90731395298,12,401,2974,40
90733762006,90733762001,-5,1212,2573,40
90740591541,90740591534,-7,1280,3499,40
90743185389,90743185371,-18,253,805,40
90744095444,90744095467,23,829,3919,40
90745463628,90745463638,10,223,2140,40
90745706976,90745706988,12,449,2772,40
90748371610,90748371604,-6,1027,3650,40
90750390065,90750390058,-7,1023,2943,40
90754071558,90754071553,-5,912,5218,40
90766585578,90766585571,-7,18990,12371,40
90774839762,90774839775,13,10768,45143,40
90775086422,90775086422,0,226,983,40
90780068915,90780068906,-9,824,3867,40
90780946378,90780946373,-5,972,4926,40
90781210762,90781210755,-7,917,3845,40
90783847346,90783847341,-5,988,4570,40
90784969208,90784969208,0,22934,39105,40
90788998547,90788998542,-5,766,2152,40
90790836073,90790836069,-4,826,3251,40
90791174301,90791174323,22,408,1937,40
90799143130,90799143108,-22,2645,3337,40
90800517259,90800517254,-5,887,3863,40
90803924595,90803924589,-6,1546,5449,40
90804262998,90804262996,-2,860,2361,40
90805200557,90805200574,17,676,4104,40
90806477364,90806477356,-8,1087,4835,40
90809915782,90809915777,-5,1052,3812,40
90814481845,90814481841,-4,969,2895,40
90814727396,90814727391,-5,1277,5217,40
90825942655,90825942650,-5,721,2232,40
90829511598,90829511593,-5,920,5033,40
90832012401,90832012395,-6,1419,4708,40
90838918002,90838917995,-7,1195,4217,40
90841438714,90841438713,-1,657,1614,40
90844138790,90844138786,-4,937,3794,40
90853107080,90853107073,-7,719,2664,40
90855330426,90855330422,-4,669,2086,40
90855599007,90855599027,20,597,3059,40
90859339045,90859339041,-4,819,2024,40
90866136728,90866136722,-6,921,2992,40
90866357117,90866357137,20,93,833,40
90873489878,90873489877,-1,1148,1095,40
90874680911,90874680905,-6,701,2845,40
90884865441,90884865435,-6,804,2280,40
90885282682,90885282675,-7,1126,4701,40
90885985295,90885985289,-6,1410,4880,40
90888868014,90888868013,-1,1387,2142,40
90894507749,90894507753,4,3656,2677,40
90905488001,90905488003,2,20257,22633,40
90909670045,90909670040,-5,1078,3786,40
90909950724,90909950739,15,165,948,40
90916082734,90916082727,-7,671,2695,40
90917633902,90917633896,-6,922,3720,40
90918875913,90918875909,-4,740,2674,40
90921975430,90921975425,-5,1408,4001,40
90931930275,90931930269,-6,1274,4096,40
90936059090,90936059085,-5,863,3430,40
90937015421,90937015417,-4,716,2631,40
90937535926,90937535923,-3,854,2328,40
90939797170,90939797163,-7,734,2953,40
90941049484,90941049480,-4,1063,3177,40
90941413150,90941413146,-4,1093,3488,40
90941515848,90941515867,19,520,989,40
90946128935,90946128928,-7,1766,8610,40
90949374850,90949374842,-8,637,3093,40
90962584202,90962584199,-3,841,2088,40
90963069239,90963069234,-5,675,3098,40
90965682770,90965682778,8,4014,1462,40
90977206959,90977206978,19,225,1776,40
90977241848,90977241866,18,992,4095,40
90977643959,90977643954,-5,903,2354,40
90977713053,90977713042,-11,110,792,40
90983559690,90983559685,-5,1219,3981,40
90985231551,90985231567,16,634,1182,40
90988650722,90988650717,-5,1035,2769,40
90991629574,90991629575,1,2031,3025,40
90995172090,90995172084,-6,1253,4536,40
90995721569,90995721565,-4,1238,3462,40
90995763883,90995763878,-5,679,2454,40
90995801484,90995801499,15,169,1105,40
91000711808,91000711806,-2,985,1725,40
91003334828,91003334825,-3,1035,1993,40
91005380700,91005380694,-6,1166,3072,40
91011174485,91011174480,-5,925,3648,40
91011289028,91011289022,-6,1002,3002,40
91012813744,91012813738,-6,1145,4461,40
91019557525,91019557517,-8,1115,3678,40
91019875416,91019875411,-5,1538,3385,40
91021606369,91021606362,-7,1327,4226,40
91021819941,91021819938,-3,733,2454,40
91022461667,91022461659,-8,658,4119,40
91022836760,91022836778,18,437,2374,40
91031252227,91031252220,-7,968,3289,40
91031633988,91031633985,-3,47,1038,40
91035555024,91035555017,-7,795,2724,40
91040379069,91040379063,-6,1025,3180,40
91043167510,91043167508,-2,501,1765,40
91043660893,91043660887,-6,1190,5101,40
91055235501,91055235498,-3,366,1345,40
91055503607,91055503625,18,231,1379,40
91057000234,91057000228,-6,679,3315,40
91058037654,91058037648,-6,937,3267,40
91058803003,91058802998,-5,830,2989,40
91061284666,91061284661,-5,824,1738,40
91063196932,91063196939,7,3190,1515,40
91064944830,91064944822,-8,1159,4596,40
91067856649,91067856643,-6,1087,5661,40
91069817667,91069817678,11,699,2606,40
91090006554,91090006549,-5,593,3356,40
91091343811,91091343805,-6,1079,4204,40
91091379596,91091379591,-5,918,4060,40
91097092729,91097092723,-6,901,3202,40
91099341892,91099341887,-5,1838,7294,40
91106513214,91106513215,1,942,1123,40
91108333699,91108333694,-5,974,3374,40
91116830634,91116830629,-5,836,3088,40
91118027873,91118027866,-7,898,2941,40
91118128072,91118128085,13,629,2009,40
91121411088,91121411082,-6,902,2757,40
91122188996,91122189017,21,1021,3850,40
91126675917,91126675910,-7,976,2678,40
91138102349,91138102351,2,51350,48014,40
91139104899,91139104893,-6,1308,8378,40
91143244333,91143244336,3,23103,18442,40
91144548403,91144548410,7,2219,1579,40
91145701147,91145701141,-6,944,3634,40
91148024520,91148024539,19,351,2010,40
91149788123,91149788118,-5,1146,3530,40
91153377863,91153377869,6,5708,2498,40
91154279026,91154279030,4,2619,1059,40
91154669950,91154669945,-5,935,3281,40
91156713598,91156713593,-5,950,2715,40
91162626765,91162626758,-7,888,4264,40
91162804754,91162804748,-6,876,2832,40
91163070595,91163070589,-6,888,2459,40
91164672036,91164672017,-19,113,1093,40
91165580708,91165580715,7,4756,1344,40
91167800518,91167800514,-4,1138,3815,40
91170084290,91170084285,-5,983,3946,40
91176673970,91176673964,-6,1049,2759,40
91178970896,91178970890,-6,982,3713,40
91179106567,91179106585,18,444,2624,40
91181203374,91181203390,16,703,1070,40
91182257907,91182257900,-7,877,2606,40
91184286889,91184286883,-6,1233,3539,40
91191718587,91191718582,-5,1100,3332,40
91192043661,91192043645,-16,944,2407,40
91199721375,91199721368,-7,803,3611,40
91199923047,91199923026,-21,412,1168,40
91200994009,91200994003,-6,1194,5085,40
91202990587,91202990580,-7,1176,4742,40
91209239654,91209239648,-6,923,3741,40
91211357178,91211357173,-5,1143,3509,40
91222932693,91222932687,-6,1271,3981,40
91230351978,91230351974,-4,778,1296,40
91235386807,91235386801,-6,1512,3596,40
91250769759,91250769754,-5,1033,2913,40
91253812782,91253812777,-5,411,1750,40
91253943608,91253943621,13,546,1959,40
91256030180,91256030178,-2,22516,11065,40
91258806347,91258806340,-7,896,4952,40
91266518714,91266518708,-6,1011,3264,40
91269631943,91269631938,-5,733,3120,40
91269970653,91269970642,-11,917,2687,40
91270235111,91270235124,13,122,1283,40
91271009654,91271009673,19,1119,3756,40
91271610134,91271610129,-5,1328,2930,40
91272780793,91272780793,0,11716,14524,40
91278350346,91278350341,-5,898,3143,40
91280905981,91280905986,5,2518,1555,40
91290462375,91290462368,-7,1010,2403,40
91293602586,91293602581,-5,698,2008,40
91297868023,91297868017,-6,359,1608,40
91310726386,91310726383,-3,1413,2316,40
91314664125,91314664117,-8,968,4664,40
91316626842,91316626837,-5,961,3922,40
91318966925,91318966919,-6,974,3313,40
91325472958,91325472951,-7,668,2621,40
91325983618,91325983611,-7,1025,3711,40
91326793098,91326793093,-5,911,2841,40
91334525746,91334525743,-3,813,1737,40
91335035583,91335035577,-6,979,2954,40
91335732299,91335732294,-5,1020,3708,40
91338050097,91338050091,-6,953,4564,40
91347545652,91347545647,-5,420,1296,40
91355656937,91355656932,-5,2292,5854,40
91355731924,91355731918,-6,928,5245,40
91358391909,91358391915,6,1543,1032,40
91363011384,91363011381,-3,1341,2384,40
91371451022,91371451017,-5,750,2699,40
91371717348,91371717365,17,50,1071,40
91372926614,91372926609,-5,947,3395,40
91373272659,91373272654,-5,416,1364,40
91373392823,91373392838,15,182,1542,40
91373931132,91373931150,18,47,843,40
91376577244,91376577242,-2,956,908,40
91385151655,91385151656,1,1277,1262,40
91392361576,91392361570,-6,1335,4856,40
91395461788,91395461789,1,1700,2099,40
91402700514,91402700509,-5,797,3576,40
91406686302,91406686287,-15,1615,26489,40
91411837111,91411837102,-9,813,3502,40
91413055835,91413055830,-5,871,3427,40
91414599629,91414599623,-6,129,1289,40
91415336963,91415336957,-6,961,4640,40
91419566201,91419566195,-6,1415,4571,40
91429435698,91429435690,-8,843,1923,40
91432343087,91432343082,-5,1054,3881,40
91432562709,91432562726,17,874,2979,40
91434464857,91434464862,5,2180,1446,40
91437470785,91437470778,-7,895,3457,40
91439085476,91439085494,18,728,1855,40
91441529051,91441529045,-6,707,3735,40
91444597200,91444597193,-7,893,2943,40
91447206006,91447206001,-5,803,2541,40
91452690286,91452690281,-5,1287,4488,40
91457134515,91457134509,-6,1183,3853,40
91460328982,91460328977,-5,1073,4737,40
91463105981,91463105985,4,2427,1796,40
91472495390,91472495385,-5,1485,5321,40
91473908538,91473908530,-8,988,3471,40
91477626919,91477626913,-6,587,3482,40
91478449181,91478449176,-5,918,3541,40
91478904113,91478904108,-5,1188,3608,40
91485260622,91485260616,-6,728,2989,40
91493206066,91493206060,-6,707,3588,40
91497322054,91497322047,-7,888,2030,40
91497784274,91497784267,-7,762,1718,40
91501178887,91501178883,-4,906,2774,40
91501523599,91501523595,-4,100,1075,40
91504692544,91504692539,-5,1200,3302,40
91505862804,91505862793,-11,67,1013,40
91507784830,91507784825,-5,1492,4171,40
91510512032,91510512033,1,1657,1673,40
91517098114,91517098110,-4,1387,2658,40
91517305396,91517305394,-2,450,1815,40
91520217369,91520217373,4,2899,1526,40
91522318413,91522318406,-7,1057,2464,40
91523026270,91523026290,20,571,2716,40
91524798281,91524798274,-7,1272,3804,40
91525026253,91525026274,21,27,1008,40
91525735735,91525735728,-7,110,1259,40
91531433112,91531433106,-6,1174,3707,40
91533807946,91533807940,-6,869,3145,40
91540035203,91540035198,-5,1196,5121,40
91540430016,91540430010,-6,1111,3902,40
91541817323,91541817317,-6,1028,3699,40
91543903637,91543903642,5,24547,22962,40
91544979101,91544979095,-6,741,4267,40
91545324483,91545324476,-7,1096,2288,40
91557616526,91557616521,-5,1685,3882,40
91559616834,91559616828,-6,581,2920,40
91560656631,91560656650,19,397,1264,40
91564102747,91564102743,-4,740,4551,40
91568861841,91568861835,-6,1000,3348,40
91571196019,91571196010,-9,1249,4524,40
91571623502,91571623501,-1,2098,3413,40
91575199050,91575199044,-6,1089,3748,40
91576666150,91576666146,-4,993,3992,40
91579176066,91579176082,16,914,3325,40
91579375195,91579375189,-6,601,2843,40
91579521949,91579521959,10,280,1260,40
91580870515,91580870509,-6,925,4374,40
91581484838,91581484852,14,739,3641,40
91582712545,91582712538,-7,1329,3374,40
91585850673,91585850671,-2,2045,2663,40
91593504769,91593504763,-6,1087,6009,40
91599561586,91599561584,-2,1407,2404,40
91600105798,91600105798,0,1428,1798,40
91606742673,91606742665,-8,825,3291,40
91611519962,91611519963,1,34490,33122,40
91619699172,91619699167,-5,816,3836,40
91629925274,91629925267,-7,1050,3767,40
91639757666,91639757660,-6,1479,5346,40
91639879943,91639879935,-8,1288,4048,40
91648026473,91648026468,-5,2083,6345,40
91650941572,91650941567,-5,1023,4532,40
91652116156,91652116152,-4,137,1070,40
91653769477,91653769471,-6,825,4188,40
91653873326,91653873305,-21,183,1330,40
91654285887,91654285879,-8,1107,3940,40
91662086796,91662086798,2,1667,1250,40
91663027578,91663027571,-7,445,1353,40
91664201686,91664201681,-5,1243,2997,40
91668848343,91668848339,-4,1944,4489,40
91670856731,91670856725,-6,1219,3996,40
91673331459,91673331454,-5,531,1516,40
91673642230,91673642237,7,2588,1132,40
91674638495,91674638489,-6,964,4721,40
91675094133,91675094126,-7,955,4546,40
91676940666,91676940660,-6,991,3518,40
91679604737,91679604734,-3,2133,5823,40
91680947351,91680947346,-5,988,3519,40
91687626417,91687626409,-8,824,4205,40
91687721143,91687721154,11,1031,4094,40
91688959031,91688959042,11,378,1644,40
91693658161,91693658156,-5,1300,3044,40
91706883467,91706883462,-5,1360,4137,40
91715564382,91715564391,9,973,4923,40
91718931207,91718931202,-5,1078,3258,40
91720534282,91720534275,-7,1074,4449,40
91720917964,91720917946,-18,61,1015,40
91721191531,91721191530,-1,1661,2095,40
91729556836,91729556843,7,6630,2187,40
91733359216,91733359209,-7,1078,4317,40
91749172457,91749172450,-7,880,3984,40
91749913215,91749913231,16,608,1240,40
91752047583,91752047577,-6,1097,3477,40
91754315050,91754315044,-6,1096,3727,40
91757435241,91757435234,-7,1135,4428,40
91758531179,91758531174,-5,1187,3282,40
91761178285,91761178303,18,1420,5724,40
91766971827,91766971821,-6,1019,3778,40
91767017829,91767017839,10,259,1286,40
91770738452,91770738446,-6,1060,3092,40
91774106502,91774106502,0,2020,1680,40
91782919368,91782919362,-6,1117,4729,40
91784385647,91784385628,-19,1250,2527,40
91789563989,91789563982,-7,1541,3198,40
91796184493,91796184493,0,2365,4358,40
91799885377,91799885372,-5,1160,3473,40
91801248906,91801248905,-1,22222,30438,40
91801466700,91801466722,22,736,2588,40
91803533932,91803533925,-7,1394,4648,40
91804102731,91804102726,-5,979,3870,40
91811746003,91811745998,-5,628,2444,40
91813590279,91813590273,-6,728,3463,40
91829105734,91829105729,-5,1331,3771,40
91830056947,91830056941,-6,770,2793,40
91830127997,91830127991,-6,1103,3895,40
91830892650,91830892643,-7,553,1477,40
91831049821,91831049835,14,222,1088,40
91831118608,91831118602,-6,980,3525,40
91834653788,91834653784,-4,1201,3187,40
91842974047,91842974051,4,1142,2042,40
91845080285,91845080292,7,14647,21308,40
91845948141,91845948135,-6,1387,3216,40
91846272405,91846272392,-13,45,678,40
91852522298,91852522294,-4,1054,4034,40
91852603175,91852603169,-6,918,5842,40
91853443148,91853443159,11,273,1350,40
91853872402,91853872395,-7,913,3716,40
91854454661,91854454661,0,312,2170,40
91854779838,91854779856,18,1564,4311,40
91859889538,91859889530,-8,880,2643,40
91861096848,91861096846,-2,1340,1681,40
91862120080,91862120074,-6,879,3238,40
91865177192,91865177195,3,1292,1284,40
91874734834,91874734834,0,1446,1854,40
91877650679,91877650673,-6,1296,4609,40
91881472054,91881472049,-5,1023,3201,40
91883951643,91883951638,-5,1066,3888,40
91884151589,91884151590,1,25998,86169,40
91886453750,91886453745,-5,1128,4693,40
91897235034,91897235028,-6,1253,3672,40
91897574768,91897574774,6,2497,1107,40
91902306779,91902306773,-6,904,3046,40
91903744201,91903744194,-7,1552,4458,40
91911065366,91911065369,3,1480,1317,40
91915554352,91915554346,-6,808,2669,40
91916309103,91916309096,-7,995,4385,40
91917782631,91917782630,-1,208,1044,40
91917906546,91917906538,-8,699,3601,40
91917974964,91917974963,-1,135,1376,40
91920514543,91920514537,-6,824,3383,40
91937507602,91937507595,-7,729,3824,40
91938573942,91938573924,-18,351,1382,40
91941701434,91941701429,-5,1193,3348,40
91941875645,91941875663,18,126,1156,40
91942949878,91942949895,17,287,1556,40
91943540597,91943540579,-18,2034,945,40
91949826050,91949826042,-8,760,3780,40
91971322437,91971322438,1,1271,1721,40
91976644995,91976644990,-5,569,3773,40
91977268535,91977268551,16,1260,1912,40
91979469606,91979469611,5,2375,1547,40
91982785374,91982785371,-3,887,2611,40
91991138987,91991138981,-6,1384,4388,40
91993344426,91993344420,-6,789,3353,40
91994379363,91994379364,1,1609,2085,40
92000876018,92000876022,4,4814,3015,40
92006602082,92006602077,-5,989,3427,40
92008264193,92008264198,5,2382,1015,40
92015454041,92015454045,4,1954,1317,40
92020131423,92020131417,-6,1007,3487,40
92021370718,92021370714,-4,653,1875,40
92022555563,92022555558,-5,816,2752,40
92029391809,92029391804,-5,20674,17613,40
92030518402,92030518397,-5,566,3507,40
92031429520,92031429514,-6,1051,3835,40
92032887638,92032887630,-8,266,1379,40
92034276202,92034276195,-7,962,4300,40
92037087734,92037087737,3,6474,6353,40
92044416287,92044416280,-7,718,2195,40
92045939636,92045939643,7,355,948,40
92046170158,92046170174,16,80,966,40
92047259437,92047259430,-7,842,3524,40
92047367046,92047367042,-4,1639,4088,40
92048603100,92048603106,6,211,1394,40
92049544744,92049544737,-7,1164,4024,40
92049831372,92049831366,-6,157,1119,40
92055152322,92055152319,-3,850,1775,40
92058362067,92058362062,-5,974,3077,40
92060081687,92060081686,-1,115,913,40
92062225827,92062225821,-6,1231,2984,40
92067440810,92067440805,-5,1199,4645,40
92071272802,92071272804,2,833,1221,40
92073826223,92073826217,-6,791,3133,40
92077642577,92077642594,17,998,157,40
92078751101,92078751122,21,460,1241,40
92079596310,92079596302,-8,828,3368,40
92080856330,92080856322,-8,1070,3580,40
92083915307,92083915303,-4,933,3791,40
92085141200,92085141210,10,330,1203,40
92085345338,92085345331,-7,920,3765,40
92086900057,92086900050,-7,1169,5329,40
92101902465,92101902461,-4,955,2769,40
92105041957,92105041950,-7,772,2944,40
92107244211,92107244206,-5,723,3118,40
92111660552,92111660547,-5,928,4500,40
92120175577,92120175570,-7,844,2878,40
92122377771,92122377765,-6,1305,5093,40
92123632361,92123632355,-6,1032,3924,40
92126429185,92126429178,-7,1384,4732,40
92127153524,92127153542,18,306,1441,40
92127573131,92127573125,-6,897,3560,40
92134151099,92134151090,-9,865,3013,40
92135177932,92135177924,-8,1089,2546,40
92139271587,92139271583,-4,853,2769,40
92139396596,92139396616,20,418,2685,40
92139426732,92139426726,-6,108,1574,40
92145373461,92145373456,-5,1313,3969,40
92145557297,92145557291,-6,1092,3245,40
92146364215,92146364209,-6,1619,6293,40
92147597870,92147597862,-8,707,3744,40
92151265463,92151265458,-5,772,2284,40
92151600015,92151600009,-6,753,3975,40
92152801360,92152801356,-4,818,2515,40
92154341715,92154341710,-5,540,2749,40
92162183887,92162183882,-5,1103,4044,40
92172128248,92172128242,-6,1497,4361,40
92179820766,92179820761,-5,906,3980,40
92183066842,92183066836,-6,958,3854,40
92183421404,92183421398,-6,856,3604,40
92186281865,92186281869,4,9881,7597,40
92186390276,92186390270,-6,54,770,40
92186844514,92186844510,-4,1036,3535,40
92189173802,92189173795,-7,1136,4003,40
92189202431,92189202425,-6,1107,3352,40
92192021278,92192021271,-7,831,6224,40
92193979482,92193979477,-5,1209,3018,40
92196185028,92196185048,20,2070,754,40
92197940945,92197940936,-9,961,3410,40
92199847682,92199847676,-6,1177,3753,40
92220528525,92220528518,-7,1175,3941,40
92221874959,92221874954,-5,1334,3473,40
92222751819,92222751813,-6,1048,1863,40
92224062279,92224062273,-6,1122,2717,40
92228494263,92228494257,-6,934,3224,40
92231994743,92231994737,-6,1110,3485,40
92232058704,92232058720,16,949,2369,40
92233110318,92233110312,-6,889,3599,40
92237384382,92237384374,-8,750,5816,40
92245079686,92245079686,0,1466,1386,40
92245751504,92245751492,-12,125,1546,40
92247731331,92247731334,3,1741,1647,40
92249028715,92249028710,-5,1135,2121,40
92250493460,92250493451,-9,1126,4447,40
92250539758,92250539745,-13,787,2234,40
92259716079,92259716074,-5,849,4235,40
92263602163,92263602157,-6,1401,3067,40
92265349527,92265349522,-5,1013,3635,40
92267739678,92267739672,-6,973,2336,40
92271319121,92271319127,6,2268,1233,40
92278624635,92278624629,-6,887,2567,40
92286003247,92286003241,-6,827,4522,40
92288956781,92288956775,-6,1387,3194,40
92291083058,92291083052,-6,872,3455,40
92295559975,92295559968,-7,1131,4932,40
92299211103,92299211098,-5,1214,3673,40
92302785293,92302785294,1,2184,1832,40
92302929907,92302929900,-7,890,3687,40
92303560599,92303560613,14,298,1141,40
92304031496,92304031514,18,1074,4045,40
92308779378,92308779378,0,1194,2034,40
92311677123,92311677123,0,1132,2065,40
92312682731,92312682736,5,4383,1955,40
92313063301,92313063297,-4,815,4092,40
92320831261,92320831257,-4,930,4633,40
92321184422,92321184439,17,507,1121,40
92330116551,92330116545,-6,1253,3195,40
92331946524,92331946517,-7,1022,3474,40
92335782121,92335782117,-4,972,3967,40
92342266448,92342266441,-7,921,3412,40
92343926978,92343926971,-7,789,3939,40
92344466209,92344466205,-4,663,3234,40
92350322392,92350322387,-5,1233,3677,40
92351790971,92351790966,-5,497,2916,40
92354142812,92354142810,-2,26852,10037,40
92356798468,92356798475,7,3722,1334,40
92369063493,92369063487,-6,1007,3364,40
92369875345,92369875338,-7,993,4502,40
92370039812,92370039801,-11,836,3469,40
92375663023,92375663014,-9,961,3497,40
92376495038,92376495033,-5,956,2917,40
92377405446,92377405438,-8,1233,5617,40
92387270294,92387270280,-14,1024,1011,40
92397536147,92397536142,-5,810,3481,40
92397708535,92397708546,11,217,1366,40
92397996974,92397996986,12,275,805,40
92412312661,92412312654,-7,987,11408,40
92413206158,92413206173,15,896,3937,40
92419000665,92419000659,-6,1138,3278,40
92420108706,92420108701,-5,878,2076,40
92420555526,92420555521,-5,1243,2721,40
92422238500,92422238506,6,2711,1884,40
92428954322,92428954318,-4,1102,4247,40
92435903349,92435903356,7,2864,1857,40
92440567430,92440567429,-1,964,1800,40
92441753305,92441753310,5,3775,1525,40
92443266962,92443266958,-4,844,3175,40
92445120203,92445120194,-9,735,3469,40
92445840944,92445840962,18,197,1129,40
92446233127,92446233121,-6,679,2101,40
92446564457,92446564449,-8,1072,4761,40
92449657536,92449657530,-6,680,3613,40
92456930678,92456930683,5,1381,758,40
92457951102,92457951101,-1,1145,1530,40
92458422529,92458422531,2,1031,1227,40
92464064626,92464064622,-4,936,3158,40
92467900732,92467900737,5,42910,3246,40
92475431761,92475431754,-7,934,5080,40
92477302959,92477302954,-5,802,2844,40
92480909398,92480909393,-5,1307,3493,40
92481306430,92481306417,-13,257,1117,40
92485526238,92485526233,-5,1118,1889,40
92488489218,92488489212,-6,1209,5735,40
92488625189,92488625183,-6,1898,4928,40
92489113374,92489113391,17,730,3090,40
92496004121,92496004124,3,4133,4283,40
92497124002,92497123997,-5,902,4137,40
92497572378,92497572373,-5,888,2703,40
92501113573,92501113568,-5,989,4117,40
92506820405,92506820400,-5,785,3610,40
92507307581,92507307594,13,240,1095,40
92509420353,92509420359,6,1584,1213,40
92511547501,92511547495,-6,914,2299,40
92516659734,92516659727,-7,851,3576,40
92519318763,92519318758,-5,777,3882,40
92521706880,92521706882,2,1825,1531,40
92522252862,92522252847,-15,4073,1151,40
92523729446,92523729439,-7,1237,4169,40
92530517229,92530517225,-4,1246,4269,40
92530700132,92530700127,-5,738,2739,40
92531505408,92531505425,17,421,1768,40
92533394503,92533394508,5,1571,1284,40
92534895373,92534895369,-4,1153,3090,40
92535117648,92535117651,3,35002,25051,40
92540900822,92540900814,-8,1366,4293,40
92543164914,92543164910,-4,1048,2705,40
92544580127,92544580120,-7,925,4828,40
92544898263,92544898255,-8,813,2027,40
92545851468,92545851455,-13,135,2193,40
92549184683,92549184675,-8,999,4694,40
92551242341,92551242335,-6,593,1452,40
92558579518,92558579501,-17,203,914,40
92559067510,92559067524,14,615,2675,40
92564916262,92564916257,-5,1280,5170,40
92566844400,92566844393,-7,375,1015,40
92567557920,92567557938,18,129,726,40
92569284187,92569284182,-5,1026,4034,40
92569359735,92569359727,-8,791,2551,40
92570799394,92570799389,-5,910,4079,40
92571568038,92571568051,13,374,1424,40
92572880445,92572880439,-6,1222,4514,40
92575683342,92575683338,-4,894,2018,40
92582824755,92582824749,-6,602,2704,40
92584767873,92584767866,-7,966,3867,40
92593847496,92593847488,-8,1056,3315,40
92606568349,92606568354,5,3058,1609,40
92607601631,92607601625,-6,1259,3990,40
92610293624,92610293631,7,419,1993,40
92615679509,92615679514,5,2333,1161,40
92617575345,92617575338,-7,1053,3472,40
92617600774,92617600767,-7,1131,4048,40
92618981064,92618981059,-5,843,2805,40
92622199206,92622199201,-5,1473,3914,40
92622294229,92622294223,-6,680,4443,40
92629277303,92629277297,-6,1130,3830,40
92639026248,92639026254,6,3869,1222,40
92648150069,92648150064,-5,809,3370,40
92648314590,92648314606,16,831,3273,40
92655920170,92655920165,-5,1298,4885,40
92665481855,92665481850,-5,938,3951,40
92666311769,92666311765,-4,1061,1983,40
92666873716,92666873711,-5,1056,2802,40
92667052829,92667052842,13,47,1179,40
92671183338,92671183333,-5,603,2770,40
92674946183,92674946177,-6,957,3210,40
92677703313,92677703307,-6,1520,3209,40
92677935270,92677935249,-21,172,1207,40
92679976267,92679976266,-1,749,1885,40
92681189011,92681189008,-3,1377,2797,40
92688007541,92688007537,-4,1149,3087,40
92690510450,92690510444,-6,1090,3527,40
92696500294,92696500289,-5,1083,4572,40
92700621702,92700621697,-5,874,3289,40
92703551132,92703551125,-7,1136,3450,40
92714100853,92714100854,1,2135,2496,40
92717094850,92717094857,7,5328,2163,40
92722471113,92722471115,2,1043,1510,40
92726108094,92726108088,-6,1356,3976,40
92726289639,92726289633,-6,757,4194,40
92727769887,92727769880,-7,936,4412,40
92735868599,92735868595,-4,1638,4472,40
92739116759,92739116754,-5,1158,2812,40
92740787786,92740787781,-5,1252,2701,40
92740904795,92740904787,-8,1140,4013,40
92741493357,92741493374,17,1013,4790,40
92744975684,92744975677,-7,1162,3194,40
92756045401,92756045394,-7,817,3492,40
92756489710,92756489727,17,283,1048,40
92762846121,92762846120,-1,1268,2671,40
92772860193,92772860189,-4,1190,3535,40
92774596405,92774596399,-6,1237,4299,40
92778295330,92778295325,-5,750,2371,40
92785578618,92785578619,1,1158,1101,40
92785793466,92785793465,-1,788,1780,40
92791019530,92791019525,-5,770,3301,40
92796266342,92796266337,-5,1438,2855,40
92806945476,92806945482,6,1529,1026,40
92808097142,92808097137,-5,1183,3890,40
92809973364,92809973368,4,18458,38182,40
92810953973,92810953968,-5,1244,3542,40
92812161823,92812161818,-5,1146,3334,40
92815203386,92815203380,-6,1002,4202,40
92818612805,92818612799,-6,1381,3648,40
92820075513,92820075506,-7,1135,3478,40
92823750661,92823750655,-6,962,4403,40
92824047372,92824047371,-1,5174,6903,40
92824872603,92824872598,-5,1162,2362,40
92830283996,92830284003,7,1758,822,40
92844421497,92844421493,-4,992,3058,40
92845412815,92845412810,-5,1778,5698,40
92845770937,92845770930,-7,980,2887,40
92846289062,92846289057,-5,1030,4438,40
92859072937,92859072931,-6,1599,4458,40
92859557025,92859557024,-1,855,1589,40
92861295529,92861295523,-6,1403,4299,40
92865120511,92865120506,-5,828,2037,40
92865468835,92865468829,-6,1000,3357,40
92879684721,92879684706,-15,2242,1195,40
92881922828,92881922823,-5,1069,2333,40
92882043877,92882043869,-8,743,2915,40
92882513534,92882513513,-21,1775,9625,40
92883249899,92883249893,-6,988,3273,40
92886414011,92886414005,-6,1140,4354,40
92886487376,92886487392,16,792,3303,40
92892583037,92892583041,4,10776,30919,40
92898383862,92898383855,-7,951,3981,40
92898886639,92898886657,18,138,1156,40
92903905799,92903905793,-6,1084,4564,40
92910162057,92910162050,-7,925,3994,40
92915010994,92915010990,-4,680,1221,40
92916093780,92916093773,-7,1193,3342,40
92916411180,92916411183,3,54,880,40
92918967510,92918967508,-2,1588,2889,40
92922226600,92922226594,-6,1033,3688,40
92922481402,92922481397,-5,1091,4591,40
92922658356,92922658349,-7,1459,4623,40
92930236749,92930236751,2,1276,935,40
92939966867,92939966865,-2,1449,2189,40
92943274247,92943274241,-6,958,3419,40
92944663111,92944663104,-7,1047,3757,40
92944868291,92944868285,-6,776,4418,40
92953202507,92953202503,-4,975,1792,40
92953670590,92953670585,-5,1271,4355,40
92955435615,92955435609,-6,895,4081,40
92962857727,92962857721,-6,1105,3712,40
92967401354,92967401349,-5,1212,3975,40
92967557039,92967557053,14,253,1144,40
92973332565,92973332557,-8,1402,4006,40
92981275053,92981275045,-8,929,3088,40
92982453128,92982453120,-8,1075,4604,40
92988656061,92988656055,-6,1270,4431,40
92995952446,92995952442,-4,797,2193,40
92996123976,92996123965,-11,84,696,40
93008024778,93008024774,-4,699,1892,40
93014270158,93014270154,-4,1051,2596,40
93018119113,93018119115,2,42093,25656,40
93018512736,93018512755,19,968,3240,40
93021704828,93021704822,-6,958,2903,40
93037804808,93037804801,-7,847,12391,40
93038763147,93038763141,-6,846,3180,40
93039135358,93039135353,-5,220,946,40
93039820768,93039820761,-7,863,3925,40
93048579186,93048579181,-5,1006,4039,40
93050038934,93050038951,17,672,4068,40
93050202978,93050202973,-5,1094,3486,40
93053060325,93053060311,-14,678,16072,40
93076063321,93076063314,-7,842,3294,40
93090026062,93090026055,-7,144,1356,40
93090520226,93090520221,-5,889,3465,40
93099905970,93099905965,-5,694,3566,40
93100092612,93100092594,-18,100,739,40
93103657835,93103657830,-5,1110,4345,40
93103820237,93103820222,-15,256,1087,40
93106549043,93106549037,-6,1433,3545,40
93109350823,93109350817,-6,1074,3091,40
93111929462,93111929455,-7,1048,4182,40
93112217436,93112217430,-6,138,730,40
93119438014,93119438009,-5,808,3830,40
93121038361,93121038364,3,1438,1072,40
93131017137,93131017131,-6,1582,4027,40
93132219374,93132219380,6,3305,2158,40
93136277931,93136277936,5,4447,2682,40
93138511875,93138511871,-4,795,3016,40
93146838748,93146838742,-6,1233,4789,40
93153396845,93153396840,-5,708,3207,40
93155120009,93155120003,-6,1275,4104,40
93155914533,93155914529,-4,509,1512,40
93158213868,93158213875,7,13040,56588,40
93158467215,93158467212,-3,1095,2366,40
93159694583,93159694585,2,1873,2148,40
93159919215,93159919209,-6,697,3055,40
93159975927,93159975947,20,409,2705,40
93160618757,93160618762,5,8149,5091,40
93160648926,93160648935,9,131,1202,40
93171773980,93171773974,-6,1338,4001,40
93171893812,93171893819,7,125,1904,40
93173077576,93173077569,-7,1217,4699,40
93173195536,93173195546,10,424,1489,40
93175645356,93175645350,-6,1357,5115,40
93182560459,93182560454,-5,1046,2402,40
93192120491,93192120495,4,1705,1108,40
93194987919,93194987913,-6,1277,3737,40
93198185270,93198185264,-6,780,2657,40
93198304103,93198304108,5,6463,4067,40
93198894522,93198894517,-5,931,3905,40
93207082926,93207082929,3,1325,1597,40
93207359285,93207359307,22,730,3049,40
93207856654,93207856648,-6,1168,4257,40
93218975922,93218975918,-4,1009,3072,40
93224886531,93224886532,1,1212,1841,40
93226334921,93226334915,-6,1141,3607,40
93226479516,93226479503,-13,257,1676,40
93229222217,93229222212,-5,1292,4978,40
93229457869,93229457886,17,239,2147,40
93230074807,93230074817,10,153,1440,40
93230472444,93230472453,9,195,1191,40
93230979948,93230979942,-6,1114,4540,40
93231876766,93231876761,-5,1233,4511,40
93234694017,93234694018,1,1331,1660,40
93242803545,93242803538,-7,985,4385,40
93243004831,93243004818,-13,346,1285,40
93245620642,93245620637,-5,1021,4087,40
93246084407,93246084402,-5,1069,4571,40
93246124845,93246124843,-2,288,1595,40
93247357125,93247357147,22,867,628,40
93251597278,93251597281,3,6099,27387,40
93258505553,93258505550,-3,2686,4823,40
93258811310,93258811304,-6,898,3507,40
93261979511,93261979516,5,4815,2765,40
93262167175,93262167170,-5,768,3342,40
93262442835,93262442829,-6,1099,4371,40
93263128166,93263128161,-5,972,2235,40
93270314330,93270314325,-5,622,2407,40
93270997178,93270997187,9,11455,32444,40
93272499410,93272499404,-6,1625,4066,40
93272536152,93272536158,6,180,1222,40
93272813936,93272813946,10,429,1198,40
93284901962,93284901959,-3,1375,2517,40
93286089474,93286089467,-7,1001,4768,40
93287179039,93287179035,-4,1246,3367,40
93288572721,93288572728,7,12068,4339,40
93289286008,93289286003,-5,713,3092,40
93290926364,93290926369,5,2627,1049,40
93291830655,93291830649,-6,1181,2765,40
93294055090,93294055097,7,3504,1676,40
93301276379,93301276373,-6,955,3461,40
93301695259,93301695254,-5,878,4146,40
93302666703,93302666698,-5,1110,2882,40
93303287126,93303287121,-5,1017,4028,40
93305236124,93305236118,-6,1204,4106,40
93311386855,93311386850,-5,780,2436,40
93313467470,93313467470,0,2065,3352,40
93316206026,93316206022,-4,966,2016,40
93320111287,93320111281,-6,1435,4375,40
93323600084,93323600087,3,25239,25405,40
93329846700,93329846692,-8,1033,3099,40
93337263519,93337263522,3,1685,1469,40
93340126397,93340126391,-6,1118,3431,40
93340425365,93340425380,15,218,1476,40
93340536240,93340536253,13,486,3036,40
93343585194,93343585198,4,1087,1351,40
93345848561,93345848555,-6,1048,4217,40
93351289259,93351289252,-7,932,3859,40
93351330807,93351330801,-6,456,2272,40
93355548558,93355548554,-4,1016,2854,40
93356905852,93356905846,-6,1088,3557,40
93357006199,93357006188,-11,672,4578,40
93357289802,93357289823,21,13617,48084,40
93357913250,93357913249,-1,1006,2503,40
93370828346,93370828338,-8,1359,11794,40
93371176221,93371176236,15,253,1095,40
93372247517,93372247509,-8,1920,4207,40
93372644459,93372644456,-3,766,2442,40
93376482227,93376482220,-7,824,3286,40
93378262422,93378262418,-4,699,1621,40
93378456316,93378456322,6,277,1229,40
93384853790,93384853791,1,2096,3105,40
93388639545,93388639538,-7,1100,4438,40
93389268070,93389268064,-6,939,5674,40
93390281123,93390281116,-7,1206,7588,40
93391917914,93391917908,-6,495,1854,40
93392085264,93392085271,7,86,577,40
93392877188,93392877183,-5,1122,2961,40
93395870338,93395870335,-3,899,2773,40
93395936840,93395936853,13,101,827,40
93396619142,93396619137,-5,705,2549,40
93403159386,93403159391,5,1757,1359,40
93403670987,93403670982,-5,701,2289,40
93405474899,93405474894,-5,986,2383,40
93405863903,93405863894,-9,673,2661,40
93406245860,93406245878,18,462,1835,40
93409565254,93409565249,-5,509,2302,40
93412398190,93412398185,-5,1126,4255,40
93418006652,93418006646,-6,1040,6405,40
93421811581,93421811575,-6,1096,4120,40
93423665810,93423665806,-4,584,2146,40
93428476867,93428476860,-7,1327,3441,40
93434968836,93434968840,4,2840,2066,40
93435240098,93435240092,-6,1142,4886,40
93435654212,93435654196,-16,747,2306,40
93438368086,93438368102,16,264,1512,40
93448820548,93448820565,17,648,1585,40
93452894873,93452894866,-7,911,3426,40
93454143579,93454143574,-5,1138,3170,40
93454619944,93454619938,-6,1496,4902,40
93456119157,93456119150,-7,1155,5778,40
93460742767,93460742762,-5,1006,4004,40
93465180274,93465180269,-5,978,1923,40
93474182618,93474182610,-8,1011,5534,40
93475976026,93475976035,9,1198,231,40
93478118866,93478118861,-5,1196,3385,40
93479318603,93479318598,-5,839,3293,40
93481736854,93481736849,-5,819,2608,40
93481803607,93481803602,-5,1027,3540,40
93500034327,93500034320,-7,987,4175,40
93505455975,93505455969,-6,1288,4589,40
93508672362,93508672356,-6,895,3976,40
93511557874,93511557873,-1,1625,2285,40
93511686591,93511686583,-8,753,4732,40
93513336250,93513336243,-7,950,2968,40
93513380096,93513380113,17,744,3170,40
93514007397,93514007390,-7,1190,2133,40
93517371091,93517371087,-4,861,2301,40
93518863004,93518862998,-6,959,3172,40
93519705333,93519705351,18,1759,5063,40
93524914685,93524914681,-4,1156,3767,40
93525348677,93525348693,16,559,1756,40
93526765763,93526765758,-5,980,3267,40
93533583351,93533583342,-9,1293,4991,40
93533962798,93533962793,-5,1354,4281,40
93535736262,93535736254,-8,774,3841,40
93543285452,93543285446,-6,1394,3848,40
93545957107,93545957101,-6,1157,3081,40
93548773303,93548773300,-3,1171,1610,40
93557479553,93557479546,-7,1187,2440,40
93562106917,93562106911,-6,1014,4317,40
93566052497,93566052492,-5,1147,3811,40
93571726369,93571726369,0,2849,4786,40
93573726951,93573726947,-4,1027,2704,40
93579336518,93579336513,-5,743,1862,40
93580422973,93580422959,-14,29,1012,40
93588878092,93588878114,22,373,921,40
93595276449,93595276445,-4,1327,3505,40
93596004398,93596004391,-7,1462,3579,40
93596172613,93596172633,20,949,3718,40
93596917534,93596917529,-5,1293,4718,40
93601359787,93601359790,3,2269,1409,40
93602970142,93602970141,-1,2937,4525,40
93604283597,93604283589,-8,668,4009,40
93605387270,93605387266,-4,906,3328,40
93605939246,93605939240,-6,884,3711,40
93613826497,93613826493,-4,1218,4223,40
93615763874,93615763868,-6,967,3234,40
93620030342,93620030335,-7,1159,3636,40
93623744124,93623744145,21,698,2125,40
93631818273,93631818266,-7,1271,2772,40
93640754162,93640754155,-7,1296,3694,40
93650798411,93650798407,-4,1099,2868,40
93656171039,93656171034,-5,762,3124,40
93658723061,93658723065,4,2365,2106,40
93658767546,93658767541,-5,953,3891,40
93666150541,93666150536,-5,742,2803,40
93666544118,93666544129,11,359,1718,40
93668348226,93668348221,-5,952,6612,40
93668396391,93668396394,3,106,960,40
93674674178,93674674174,-4,1133,3502,40
93689192263,93689192256,-7,834,3261,40
93697710705,93697710698,-7,801,2819,40
93699071956,93699071957,1,314,1411,40
93701283872,93701283886,14,241,1281,40
93702758659,93702758652,-7,1128,3619,40
93709002955,93709002949,-6,689,2908,40
93710777150,93710777143,-7,1139,4821,40
93712490307,93712490302,-5,1147,2970,40
93713682730,93713682726,-4,1141,3344,40
93714534364,93714534371,7,2195,1053,40
93719713577,93719713571,-6,1106,3359,40
93726580925,93726580921,-4,1167,3575,40
93727620390,93727620383,-7,1159,5256,40
93733821093,93733821115,22,314,1115,40
93736517134,93736517127,-7,1005,3464,40
93737117304,93737117321,17,900,4279,40
93740172565,93740172558,-7,1098,3949,40
93749404910,93749404890,-20,3499,2916,40
93760632294,93760632290,-4,1157,4624,40
93761257133,93761257133,0,1614,2051,40
93762231998,93762231991,-7,921,4156,40
93762403140,93762403155,15,383,1104,40
93767728537,93767728529,-8,1012,3322,40
93768565867,93768565861,-6,695,4241,40
93769198534,93769198530,-4,1469,3703,40
93771108548,93771108554,6,1623,961,40
93772345128,93772345135,7,435,896,40
93784669834,93784669829,-5,851,3602,40
93796744746,93796744741,-5,753,3534,40
93797134328,93797134322,-6,1275,4608,40
93801458799,93801458793,-6,1012,3887,40
93802432644,93802432663,19,693,3611,40
93803920738,93803920743,5,2653,1035,40
93804178158,93804178156,-2,1022,1918,40
93819650059,93819650053,-6,1015,4538,40
93820035271,93820035265,-6,1432,4028,40
93828865699,93828865690,-9,1069,4872,40
93829461314,93829461313,-1,761,1692,40
93835408246,93835408266,20,973,3604,40
93836608279,93836608274,-5,922,2381,40
93836988474,93836988469,-5,984,2919,40
93843440579,93843440573,-6,727,3577,40
93844180196,93844180190,-6,1500,5630,40
93852368094,93852368113,19,902,3346,40
93864613042,93864613047,5,5173,1894,40
93869382044,93869382036,-8,1080,4768,40
93872555878,93872555871,-7,1300,4463,40
93890698147,93890698141,-6,1222,4154,40
93890981608,93890981625,17,612,2874,40
93894574090,93894574082,-8,831,3564,40
93895396330,93895396334,4,1224,1537,40
93896232497,93896232490,-7,820,2361,40
93897850167,93897850175,8,365,1241,40
93900281401,93900281408,7,11183,2103,40
93902051256,93902051249,-7,736,2417,40
93905668859,93905668854,-5,985,3216,40
93909287310,93909287318,8,6569,2220,40
93915654071,93915654067,-4,630,2681,40
93920831293,93920831298,5,4768,2496,40
93921999617,93921999624,7,2935,900,40
93926116874,93926116870,-4,650,2898,40
93932700979,93932700974,-5,868,3147,40
93932768295,93932768311,16,812,2107,40
93934216103,93934216101,-2,47352,22820,40
93955885379,93955885374,-5,868,4287,40
93956024619,93956024614,-5,1394,4754,40
93956305225,93956305222,-3,905,2396,40
93964780077,93964780072,-5,769,3692,40
93967562547,93967562542,-5,1094,2646,40
93968276276,93968276293,17,863,4008,40
93969075487,93969075490,3,7599,16247,40
93972967255,93972967250,-5,967,3558,40
93973172255,93973172246,-9,926,4937,40
93973908212,93973908218,6,268,1049,40
93974777093,93974777088,-5,1187,4270,40
93978016770,93978016764,-6,1163,3608,40
93978787025,93978787018,-7,1141,4347,40
93983746386,93983746381,-5,1152,3167,40
93987016025,93987016017,-8,1012,4684,40
93987603180,93987603183,3,100,1260,40
93987789108,93987789101,-7,228,2640,40
93988078823,93988078826,3,1766,2029,40
93991896308,93991896302,-6,867,3715,40
93997934593,93997934586,-7,811,3397,40
93998796390,93998796406,16,1389,5440,40
94003385396,94003385378,-18,2210,1346,40
94015117735,94015117728,-7,828,4759,40
94015836907,94015836909,2,1505,1982,40
94018057774,94018057770,-4,941,3389,40
94021452286,94021452280,-6,718,4001,40
94023457773,94023457780,7,3427,1314,40
94024403670,94024403663,-7,1007,3387,40
94029687330,94029687335,5,4866,1620,40
94035785841,94035785837,-4,976,3465,40
94037519811,94037519807,-4,730,2566,40
94037815512,94037815489,-23,225,1065,40
94037908125,94037908111,-14,206,712,40
94038724961,94038724954,-7,990,4468,40
94041301661,94041301654,-7,828,2217,40
94041386414,94041386408,-6,850,5177,40
94045189029,94045189022,-7,1087,3920,40
94051388002,94051388008,6,2468,1455,40
94055176041,94055176034,-7,1276,3743,40
94061279138,94061279133,-5,844,3747,40
94061385335,94061385331,-4,244,969,40
94064722171,94064722165,-6,2406,10638,40
94068969127,94068969122,-5,492,3478,40
94074210168,94074210161,-7,1053,3941,40
94077845163,94077845158,-5,802,2512,40
94078203482,94078203477,-5,1142,2063,40
94081145106,94081145101,-5,1061,3870,40
94081405432,94081405443,11,649,2356,40
94082502390,94082502411,21,376,1308,40
94090924614,94090924609,-5,916,3097,40
94091269086,94091269073,-13,1075,4280,40
94102709246,94102709241,-5,1035,3272,40
94105466803,94105466798,-5,1175,2079,40
94105551350,94105551334,-16,737,2180,40
94109030810,94109030807,-3,880,2705,40
94117221523,94117221518,-5,1615,4485,40
94130195442,94130195437,-5,1066,4062,40
94133837764,94133837761,-3,772,2549,40
94141420655,94141420650,-5,736,2454,40
94145734710,94145734703,-7,752,3732,40
94148553083,94148553079,-4,905,3981,40
94150841782,94150841777,-5,1181,5648,40
94151504211,94151504210,-1,8647,9270,40
94153109103,94153109121,18,1026,2326,40
94153467362,94153467371,9,8757,30452,40
94155893025,94155893018,-7,1087,3428,40
94156933352,94156933351,-1,7,921,40
94158673706,94158673711,5,1570,1195,40
94159244526,94159244522,-4,688,2617,40
94161871730,94161871725,-5,1034,3440,40
94162173189,94162173210,21,907,3317,40
94163219489,94163219481,-8,892,4461,40
94166381952,94166381945,-7,1191,4653,40
94171294222,94171294213,-9,1033,8194,40
94173290595,94173290590,-5,767,4548,40
94176842091,94176842086,-5,988,4386,40
94184175019,94184175014,-5,964,3963,40
94184306845,94184306861,16,17636,21719,40
94185476875,94185476853,-22,846,467,40
94185535406,94185535407,1,168,705,40
94189456550,94189456545,-5,889,3549,40
94197385337,94197385338,1,785,1554,40
94202340698,94202340691,-7,889,4564,40
94210152820,94210152813,-7,1105,3166,40
94210475982,94210475997,15,107,1278,40
94214370646,94214370644,-2,911,2378,40
94218444627,94218444622,-5,664,2751,40
94218756742,94218756760,18,473,1704,40
94218918775,94218918783,8,2399,1265,40
94219977222,94219977215,-7,472,3384,40
94220323478,94220323470,-8,1125,4055,40
94221226861,94221226870,9,384,1551,40
94226877140,94226877136,-4,897,3338,40
94226997453,94226997474,21,823,3241,40
94227272840,94227272835,-5,1234,3635,40
94234227309,94234227304,-5,804,4345,40
94237134447,94237134446,-1,1162,2386,40
94238213923,94238213917,-6,522,1297,40
94244438812,94244438806,-6,1067,3841,40
94256627574,94256627581,7,6858,2795,40
94262116630,94262116625,-5,781,3762,40
94264056342,94264056335,-7,1110,3600,40
94264326337,94264326330,-7,973,3168,40
94266658607,94266658602,-5,646,2332,40
94269458957,94269458959,2,1309,2041,40
94269613934,94269613934,0,2659,3783,40
94271839751,94271839744,-7,1228,3170,40
94276275949,94276275954,5,2879,1356,40
94286705351,94286705345,-6,569,1859,40
94287942613,94287942607,-6,989,3501,40
94293645719,94293645726,7,6205,2960,40
94295646496,94295646515,19,1150,3114,40
94305584999,94305584993,-6,1070,3642,40
94306633440,94306633429,-11,268,920,40
94309895459,94309895454,-5,1152,2493,40
94314931670,94314931662,-8,1069,4467,40
94323184994,94323184986,-8,957,4075,40
94323462257,94323462265,8,16999,32902,40
94326097278,94326097272,-6,1043,4848,40
94327030919,94327030918,-1,814,2017,40
94327646845,94327646841,-4,1390,4253,40
94327731876,94327731864,-12,920,3517,40
94335445068,94335445066,-2,956,1620,40
94339290258,94339290252,-6,725,2001,40
94343247946,94343247948,2,1268,1571,40
94344410563,94344410552,-11,1731,2374,40
94354342468,94354342461,-7,778,2110,40
94354690156,94354690178,22,465,1836,40
94358441946,94358441953,7,7077,1793,40
94363455357,94363455344,-13,26855,14450,40
94363616683,94363616687,4,2151,995,40
94366135785,94366135779,-6,1006,3460,40
94369763759,94369763753,-6,1128,4012,40
94371709220,94371709214,-6,734,3947,40
94372863186,94372863181,-5,559,3024,40
94378550070,94378550063,-7,852,3466,40
94378640382,94378640394,12,323,1393,40
94378939427,94378939423,-4,971,2153,40
94379156031,94379156025,-6,1023,3761,40
94383808988,94383808983,-5,909,3393,40
94387892880,94387892874,-6,987,4568,40
94399244192,94399244193,1,1012,1076,40
94400286871,94400286854,-17,570,2759,40
94400632926,94400632940,14,749,4460,40
94405248426,94405248421,-5,769,3207,40
94409040431,94409040425,-6,937,2530,40
94415609651,94415609645,-6,732,3726,40
94415756359,94415756353,-6,222,1548,40
94417181398,94417181394,-4,711,3294,40
94418510926,94418510930,4,1131,873,40
94420233367,94420233363,-4,677,1429,40
94422752399,94422752393,-6,1012,3296,40
94423101385,94423101400,15,14534,53539,40
94426950347,94426950342,-5,1156,2874,40
94436108911,94436108906,-5,947,4870,40
94436263381,94436263374,-7,1158,3559,40
94438838719,94438838712,-7,1029,3736,40
94438930086,94438930103,17,948,5461,40
94442493061,94442493057,-4,865,2993,40
94445060045,94445060039,-6,1072,3704,40
94450076523,94450076531,8,1753,981,40
94454850157,94454850150,-7,1464,3580,40
94459943505,94459943510,5,1659,948,40
94466408570,94466408564,-6,567,1327,40
94467640459,94467640453,-6,943,4275,40
94472756136,94472756151,15,246,922,40
94473551040,94473551035,-5,982,2422,40
94475441254,94475441268,14,399,1666,40
94476356942,94476356937,-5,923,3701,40
94479419207,94479419203,-4,601,2326,40
94487289618,94487289611,-7,1047,2677,40
94489771758,94489771759,1,1866,3521,40
94491659994,94491659989,-5,1290,5294,40
94503349950,94503349945,-5,605,4577,40
94506134965,94506134958,-7,1078,6491,40
94506750373,94506750366,-7,853,3742,40
94507224927,94507224935,8,164,1736,40
94518429098,94518429092,-6,666,3670,40
94519302109,94519302114,5,2528,1093,40
94520610291,94520610286,-5,848,3595,40
94521475387,94521475382,-5,1164,4867,40
94522361518,94522361510,-8,854,2323,40
94523630664,94523630679,15,893,1513,40
94525344305,94525344318,13,441,2760,40
94536553687,94536553685,-2,21290,19940,40
94537183697,94537183691,-6,870,4197,40
94538134682,94538134677,-5,1019,4856,40
94543395370,94543395362,-8,721,3703,40
94548256232,94548256235,3,2041,1804,40
94548501551,94548501545,-6,1005,3923,40
94556655487,94556655482,-5,1036,5321,40
94557836034,94557836027,-7,831,3451,40
94561050735,94561050731,-4,836,2330,40
94569090338,94569090332,-6,1416,6332,40
94569457860,94569457853,-7,589,3255,40
94572169659,94572169654,-5,1031,2910,40
94579215568,94579215565,-3,1427,4257,40
94579884927,94579884934,7,11143,33271,40
94580653839,94580653832,-7,824,3720,40
94587098959,94587098953,-6,648,1337,40
94594994991,94594994987,-4,804,3569,40
94595113772,94595113765,-7,1263,4037,40
94608450124,94608450115,-9,1134,3345,40
94608847753,94608847749,-4,1128,2979,40
94609748280,94609748274,-6,1404,4012,40
94612876027,94612876021,-6,619,3992,40
94619698145,94619698141,-4,739,2425,40
94623682388,94623682386,-2,1369,2235,40
94629307514,94629307509,-5,800,2751,40
94630250066,94630250076,10,1189,1515,40
94631813768,94631813763,-5,1879,5625,40
94635401681,94635401685,4,2520,1594,40
94641118249,94641118242,-7,743,2866,40
94641163773,94641163761,-12,1021,3395,40
94642390901,94642390895,-6,767,4161,40
94650193664,94650193660,-4,937,2701,40
94652487521,94652487514,-7,1583,4446,40
94652573414,94652573409,-5,281,1303,40
94665897562,94665897555,-7,1194,3468,40
94671349481,94671349477,-4,783,3163,40
94675483878,94675483873,-5,1120,2342,40
94678037027,94678037026,-1,784,1299,40
94678835242,94678835237,-5,766,2569,40
94685168867,94685168861,-6,1446,4331,40
94691440366,94691440360,-6,915,2577,40
94706138834,94706138845,11,14332,28016,40
94707406894,94707406890,-4,480,2401,40
94710421238,94710421233,-5,1507,4292,40
94711443102,94711443096,-6,707,2312,40
94714169693,94714169688,-5,814,3766,40
94717865095,94717865090,-5,968,2683,40
94719441719,94719441713,-6,1095,3604,40
94719477212,94719477227,15,641,2727,40
94722967941,94722967935,-6,879,5213,40
94728731406,94728731398,-8,769,4373,40
94731144065,94731144073,8,3569,1019,40
94732457981,94732457980,-1,1799,2168,40
94736900959,94736900954,-5,1466,4350,40
94737680045,94737680047,2,1670,1952,40
94738383665,94738383658,-7,858,1966,40
94743887456,94743887451,-5,1192,4051,40
94745264834,94745264826,-8,899,2805,40
94748319857,94748319851,-6,1125,2872,40
94750505543,94750505539,-4,1152,2162,40
94760975809,94760975803,-6,1267,3666,40
94762662842,94762662838,-4,633,2301,40
94763546350,94763546365,15,953,4690,40
94764984273,94764984271,-2,1570,2786,40
94766329997,94766329989,-8,654,3061,40
94767433290,94767433282,-8,1042,3807,40
94769100205,94769100214,9,246,1061,40
94769323582,94769323591,9,220,1303,40
94769398258,94769398251,-7,936,3782,40
94770358591,94770358583,-8,1127,2799,40
94785421803,94785421797,-6,719,2476,40
94787545866,94787545866,0,1146,1632,40
94790319393,94790319374,-19,1279,443,40
94790658247,94790658264,17,343,2125,40
94792672078,94792672076,-2,712,1355,40
94793851337,94793851333,-4,916,2992,40
94794727405,94794727394,-11,693,2230,40
94799307623,94799307615,-8,815,2995,40
94802416942,94802416938,-4,1203,3029,40
94807670394,94807670389,-5,1271,3957,40
94808536957,94808536954,-3,750,1664,40
94821794213,94821794209,-4,1276,2890,40
94826368970,94826368966,-4,1171,3210,40
94828142855,94828142850,-5,708,3027,40
94828208263,94828208257,-6,991,3498,40
94843700418,94843700421,3,2903,2697,40
94846349743,94846349737,-6,418,1941,40
94851009271,94851009266,-5,1100,3518,40
94851993159,94851993154,-5,725,3016,40
94858011182,94858011177,-5,1149,3820,40
94861049891,94861049885,-6,770,4582,40
94865962509,94865962504,-5,450,1379,40
94867556313,94867556317,4,2087,1687,40
94868046525,94868046522,-3,1847,3641,40
94869319943,94869319938,-5,1447,3247,40
94880469728,94880469722,-6,1248,5248,40
94884291363,94884291366,3,1409,1197,40
94885819934,94885819927,-7,1268,4024,40
94901190894,94901190911,17,991,2571,40
94903247141,94903247137,-4,1168,3618,40
94903384663,94903384654,-9,488,2315,40
94905473512,94905473505,-7,1266,4322,40
94914714802,94914714797,-5,1085,2433,40
94916342125,94916342118,-7,890,2385,40
94916466381,94916466373,-8,991,3905,40
94916500392,94916500407,15,636,2382,40
94919283654,94919283648,-6,1496,3420,40
94919545238,94919545231,-7,883,3783,40
94923134278,94923134271,-7,1228,4454,40
94924961935,94924961928,-7,904,3946,40
94930766269,94930766262,-7,1394,4315,40
94932438055,94932438063,8,17239,53499,40
94934936963,94934936957,-6,840,4223,40
94936670393,94936670389,-4,1244,3098,40
94937484206,94937484184,-22,1168,4915,40
94937952950,94937952970,20,410,1843,40
94952565685,94952565679,-6,905,4251,40
94952624508,94952624497,-11,196,1207,40
94955628465,94955628459,-6,880,3099,40
94955973846,94955973863,17,267,1100,40
94956579070,94956579062,-8,1111,3772,40
94956850872,94956850874,2,200,1374,40
94957290119,94957290117,-2,300,1792,40
94960109495,94960109490,-5,499,2818,40
94960999962,94960999955,-7,711,3258,40
94961131694,94961131714,20,807,3396,40
94971816520,94971816514,-6,806,3360,40
94972643391,94972643384,-7,106,1091,40
94979110717,94979110723,6,4486,2463,40
94980615505,94980615503,-2,1367,2450,40
94980870905,94980870914,9,2827,968,40
94992992831,94992992825,-6,823,3687,40
94997775134,94997775129,-5,1283,3999,40
94997998022,94997998031,9,10,912,40
95002902682,95002902674,-8,820,3349,40
95008540777,95008540772,-5,1221,3614,40
95008738414,95008738425,11,234,1109,40
95008861660,95008861650,-10,247,1520,40
95017335402,95017335397,-5,1338,4438,40
95017911208,95017911202,-6,881,3287,40
95024592771,95024592771,0,1072,1528,40
95033046057,95033046054,-3,546,1104,40
95035222392,95035222385,-7,866,4527,40
95035592112,95035592123,11,982,4219,40
95037142469,95037142464,-5,1410,4742,40
95039011757,95039011750,-7,1445,4929,40
95039480164,95039480158,-6,1585,2451,40
95040694410,95040694402,-8,727,3196,40
95041200448,95041200442,-6,43,711,40
95043756346,95043756339,-7,680,4631,40
95043947932,95043947926,-6,1046,5427,40
95051837837,95051837839,2,832,1189,40
95054340626,95054340622,-4,762,3433,40
95054919614,95054919607,-7,1109,3087,40
95056649606,95056649595,-11,876,2178,40
95056863538,95056863532,-6,1029,3973,40
95062241994,95062241988,-6,987,5429,40
95069980343,95069980338,-5,632,2560,40
95073947803,95073947797,-6,2192,5408,40
95085957909,95085957903,-6,907,3062,40
95093477162,95093477158,-4,1217,3772,40
95096139419,95096139413,-6,608,3492,40
95098951137,95098951132,-5,1427,3885,40
95126734651,95126734645,-6,983,3687,40
95127272261,95127272256,-5,1170,3629,40
95132440107,95132440102,-5,982,3344,40
95132630119,95132630114,-5,950,4231,40
95135225869,95135225863,-6,872,3610,40
95135461927,95135461921,-6,1128,4354,40
95135701810,95135701806,-4,819,2735,40
95139384065,95139384059,-6,1143,3622,40
95140797203,95140797208,5,2095,1397,40
95148267754,95148267749,-5,896,3247,40
95162568155,95162568152,-3,1017,3033,40
95169666891,95169666891,0,769,1128,40
95174937781,95174937774,-7,470,3284,40
95175916771,95175916762,-9,1258,4394,40
95178076935,95178076937,2,2375,987,40
95178742068,95178742062,-6,1311,3235,40
95178811302,95178811309,7,590,1093,40
95180640298,95180640295,-3,785,1183,40
95181399688,95181399681,-7,1533,5164,40
95184196255,95184196250,-5,1509,3350,40
95198108653,95198108646,-7,1344,4257,40
95205365106,95205365100,-6,934,4338,40
95208367129,95208367122,-7,1442,3537,40
95209629849,95209629843,-6,679,2993,40
95213393839,95213393833,-6,1048,3295,40
95213833181,95213833175,-6,964,3404,40
95217159324,95217159321,-3,2322,3381,40
95219191587,95219191582,-5,1470,3958,40
95219928454,95219928447,-7,111,1215,40
95220512728,95220512721,-7,1080,4116,40
95222367924,95222367918,-6,715,2896,40
95222510845,95222510861,16,440,1412,40
95236226158,95236226154,-4,846,2820,40
95248061883,95248061877,-6,1114,2965,40
95261207533,95261207526,-7,1382,3529,40
95262090368,95262090359,-9,1029,4277,40
95266415567,95266415562,-5,1093,4369,40
95271171807,95271171803,-4,1573,3173,40
95271681012,95271681006,-6,1138,4605,40
95272327664,95272327658,-6,1000,2748,40
95272407941,95272407956,15,754,1964,40
95277002900,95277002894,-6,1060,3871,40
95285969943,95285969938,-5,1046,3671,40
95293099158,95293099150,-8,1311,5089,40
95304266219,95304266216,-3,1099,2314,40
95307894171,95307894165,-6,844,3042,40
95310034771,95310034769,-2,2477,2757,40
95311988926,95311988918,-8,1094,2844,40
95312609880,95312609897,17,283,2414,40
95315181367,95315181362,-5,519,2803,40
95318275683,95318275678,-5,1105,3988,40
95318659787,95318659782,-5,947,3658,40
95318799436,95318799458,22,249,630,40
95319398586,95319398565,-21,926,903,40
95320819472,95320819472,0,14086,16600,40
95330494014,95330494008,-6,866,4926,40
95331510145,95331510166,21,654,2333,40
95332111169,95332111171,2,1287,1235,40
95338140367,95338140366,-1,699,1738,40
95338626106,95338626098,-8,653,3083,40
95338950558,95338950550,-8,201,1257,40
95339538510,95339538505,-5,769,3913,40
95348895186,95348895178,-8,934,3386,40
95352821798,95352821798,0,1757,2266,40
95354321370,95354321374,4,3444,1220,40
95356459333,95356459329,-4,944,3489,40
95357125309,95357125298,-11,1139,4184,40
95361739091,95361739090,-1,1209,1668,40
95365499205,95365499225,20,1016,3528,40
95372257442,95372257437,-5,1224,3622,40
95402131648,95402131644,-4,26254,13072,40
95404997818,95404997814,-4,1343,3397,40
95405068782,95405068798,16,20,1218,40
95409093134,95409093129,-5,1215,5390,40
95410082603,95410082595,-8,200,1674,40
95411568604,95411568622,18,145,784,40
95416505794,95416505788,-6,1354,3845,40
95417381333,95417381314,-19,104,1577,40
95418100087,95418100093,6,2612,1701,40
95418193311,95418193305,-6,855,3231,40
95418494294,95418494285,-9,779,3151,40
95418922745,95418922725,-20,1996,1650,40
95422626981,95422626974,-7,950,3940,40
95425627831,95425627824,-7,970,3574,40
95432089331,95432089325,-6,852,3387,40
95433243861,95433243869,8,3134,1338,40
95433720058,95433720049,-9,1059,3568,40
95435752365,95435752361,-4,1269,4759,40
95436255718,95436255725,7,256,1251,40
95437532831,95437532826,-5,1123,2938,40
95437956519,95437956514,-5,1383,4337,40
95440303021,95440303013,-8,951,4261,40
95445245166,95445245168,2,1529,1912,40
95449885918,95449885918,0,3284,3290,40
95452581546,95452581548,2,1499,1376,40
95453290197,95453290191,-6,1529,4977,40
95455510943,95455510941,-2,1299,2137,40
95458457309,95458457302,-7,890,3419,40
95475497834,95475497827,-7,1185,4046,40
95476698427,95476698421,-6,1179,4710,40
95479065886,95479065891,5,2735,1849,40
95489101442,95489101436,-6,664,2632,40
95489229669,95489229684,15,89,1086,40
95490364586,95490364592,6,5198,2844,40
95492559486,95492559476,-10,73,890,40
95498901029,95498901029,0,1002,2259,40
95502479153,95502479149,-4,457,1793,40
95503605876,95503605892,16,1092,4009,40
95506222883,95506222890,7,4402,1404,40
95509255781,95509255782,1,33692,29925,40
95509433984,95509433978,-6,1201,3255,40
95509566781,95509566775,-6,1025,3682,40
95510157880,95510157895,15,367,1537,40
95510366312,95510366306,-6,1078,4351,40
95512957812,95512957806,-6,1030,4277,40
95517502304,95517502308,4,33778,39970,40
95523977242,95523977241,-1,1102,2185,40
95524010047,95524010025,-22,160,2047,40
95524231113,95524231109,-4,509,2295,40
95525870141,95525870151,10,127,1227,40
95527159190,95527159203,13,382,2910,40
95535014035,95535014030,-5,1079,4080,40
95536224145,95536224139,-6,1522,4723,40
95541972225,95541972218,-7,1278,3947,40
95547125915,95547125910,-5,1111,2836,40
95547892687,95547892667,-20,128,1286,40
95549438610,95549438605,-5,936,2831,40
95550158869,95550158890,21,378,1291,40
95550310782,95550310795,13,184,1102,40
95551157668,95551157669,1,1473,1901,40
95551326846,95551326866,20,118,826,40
95561414456,95561414453,-3,976,3041,40
95563369365,95563369361,-4,930,3102,40
95564044990,95564045010,20,663,2887,40
95570219510,95570219506,-4,1169,4587,40
95572864825,95572864817,-8,928,3521,40
95577281026,95577281019,-7,1166,4115,40
95579096524,95579096522,-2,3511,12439,40
95589371577,95589371569,-8,91,1958,40
95592584298,95592584293,-5,454,2142,40
95593773904,95593773922,18,13,1267,40
95594541630,95594541646,16,1096,4743,40
95597435510,95597435501,-9,930,3621,40
95598564918,95598564913,-5,966,3530,40
95598748157,95598748165,8,159,747,40
95600011450,95600011445,-5,696,3175,40
95600416438,95600416436,-2,1002,2405,40
95600616381,95600616398,17,590,3448,40
95601992806,95601992801,-5,1027,3924,40
95602563946,95602563942,-4,2052,4555,40
95618427134,95618427130,-4,1567,3455,40
95622109571,95622109565,-6,1051,4566,40
95623896045,95623896038,-7,1427,4820,40
95628070510,95628070505,-5,979,4118,40
95628148341,95628148343,2,54,809,40
95638461726,95638461720,-6,1010,10046,40
95642674626,95642674620,-6,487,3057,40
95644023349,95644023342,-7,1277,3775,40
95659072962,95659072957,-5,901,4362,40
95659578904,95659578915,11,194,975,40
95660839796,95660839788,-8,723,2162,40
95666417276,95666417270,-6,1052,4435,40
95669708278,95669708289,11,222,1080,40
95669765658,95669765655,-3,1037,3390,40
95671060461,95671060455,-6,1448,4167,40
95672460931,95672460926,-5,891,2790,40
95672533332,95672533320,-12,201,1224,40
95673184959,95673184954,-5,1304,3870,40
95677068022,95677068042,20,2311,3528,40
95679322142,95679322138,-4,995,1274,40
95683594192,95683594187,-5,1227,3545,40
95683816500,95683816511,11,21787,27044,40
95694364112,95694364117,5,3501,1942,40
95700516138,95700516133,-5,2626,6124,40
95702504965,95702504957,-8,409,1499,40
95704920281,95704920277,-4,952,3491,40
95707294758,95707294753,-5,1347,5068,40
95710324639,95710324632,-7,774,3540,40
95712373159,95712373178,19,478,1792,40
95714457269,95714457265,-4,847,3411,40
95717100966,95717100962,-4,1288,3527,40
95724352454,95724352449,-5,587,3736,40
95724900398,95724900385,-13,83,1458,40
95731893762,95731893757,-5,879,5512,40
95732716790,95732716795,5,115,940,40
95734522530,95734522523,-7,1103,3905,40
95737517750,95737517742,-8,650,3196,40
95741490608,95741490601,-7,1037,2978,40
95744782850,95744782845,-5,1090,4875,40
95745183387,95745183383,-4,772,3141,40
95753586222,95753586218,-4,2126,4320,40
95753671941,95753671938,-3,863,3142,40
95754333275,95754333270,-5,507,1601,40
95759022710,95759022707,-3,900,1662,40
95760193503,95760193490,-13,492,1507,40
95766207175,95766207179,4,2807,1778,40
95767039913,95767039930,17,588,2407,40
95768334838,95768334837,-1,1144,2684,40
95769021565,95769021560,-5,1413,4732,40
95769165175,95769165169,-6,517,2665,40
95769296672,95769296682,10,142,972,40
95782586297,95782586291,-6,1078,4635,40
95789598935,95789598928,-7,1040,5053,40
95796277085,95796277081,-4,1264,4449,40
95797763376,95797763371,-5,1208,4107,40
95798348567,95798348580,13,861,3005,40
95799378270,95799378265,-5,782,4182,40
95800374103,95800374098,-5,806,2860,40
95813592679,95813592675,-4,1036,2833,40
95819336141,95819336138,-3,868,1190,40
95826497859,95826497852,-7,1166,4486,40
95827985920,95827985915,-5,1303,2816,40
95828215764,95828215765,1,273,1505,40
95846678455,95846678450,-5,872,3875,40
95848510219,95848510220,1,2091,2427,40
95849716960,95849716954,-6,1122,3422,40
95849937448,95849937455,7,140,990,40
95866444701,95866444695,-6,1408,3582,40
95867420845,95867420839,-6,1281,3702,40
95868649802,95868649782,-20,875,3373,40
95884752906,95884752900,-6,882,2961,40
95885454112,95885454105,-7,563,3388,40
95892183898,95892183894,-4,1319,2970,40
95898230887,95898230883,-4,1548,3844,40
95909284564,95909284567,3,1872,1289,40
95915218277,95915218270,-7,1136,3527,40
95918771799,95918771793,-6,1108,2669,40
95919408786,95919408781,-5,1139,5571,40
95920532765,95920532762,-3,1408,2596,40
95921185191,95921185189,-2,1143,2473,40
95924991175,95924991169,-6,1157,1899,40
95929260432,95929260426,-6,1564,4044,40
95930489547,95930489542,-5,670,2221,40
95942346222,95942346217,-5,759,2391,40
95942494038,95942494033,-5,1104,4119,40
95945164143,95945164136,-7,664,3489,40
95947240930,95947240926,-4,799,3503,40
95947570037,95947570054,17,467,2457,40
95948392636,95948392635,-1,1270,2004,40
95948818543,95948818542,-1,263,694,40
95954390219,95954390213,-6,1500,5191,40
95958226428,95958226443,15,1049,3502,40
95958486775,95958486769,-6,837,2640,40
95958634367,95958634361,-6,705,3434,40
95976454954,95976454949,-5,1095,3757,40
95978140619,95978140613,-6,1167,5461,40
95982377340,95982377334,-6,2160,6485,40
95985756175,95985756170,-5,927,3782,40
95995582499,95995582493,-6,991,2535,40
95995693927,95995693905,-22,1028,2669,40
95996213817,95996213811,-6,1205,4019,40
95998650080,95998650095,15,71,1506,40
95999450670,95999450677,7,14648,29984,40
96011655349,96011655355,6,167,1043,40
96019484452,96019484450,-2,1394,1923,40
96023655530,96023655525,-5,821,4630,40
96024245472,96024245484,12,475,1603,40
96032738591,96032738591,0,873,1322,40
96033251352,96033251363,11,156,967,40
96033453460,96033453453,-7,192,1180,40
96040714751,96040714755,4,1583,758,40
96043062021,96043062018,-3,1348,3541,40
96045261378,96045261373,-5,801,4510,40
96052845882,96052845885,3,1966,1570,40
96054752890,96054752883,-7,891,4622,40
96054912703,96054912717,14,380,2350,40
96070784725,96070784720,-5,898,3351,40
96072372579,96072372574,-5,939,3739,40
96074382465,96074382458,-7,908,3548,40
96083088690,96083088692,2,1947,1631,40
96097786993,96097786988,-5,992,4535,40
96099293742,96099293738,-4,1113,2126,40
96101646879,96101646873,-6,1220,4514,40
96109836051,96109836067,16,283,1124,40
96110117581,96110117573,-8,131,1111,40
96110709310,96110709307,-3,960,2333,40
96115394127,96115394129,2,2033,2237,40
96115719540,96115719534,-6,1151,3071,40
96120892977,96120892980,3,3392,2349,40
96121048694,96121048688,-6,777,2754,40
96127031078,96127031071,-7,553,3246,40
96132926166,96132926155,-11,1102,24594,40
96135236893,96135236886,-7,795,3716,40
96135285312,96135285306,-6,1122,3823,40
96136076930,96136076938,8,41012,15785,40
96137365682,96137365679,-3,755,2043,40
96139461243,96139461236,-7,962,4215,40
96139822041,96139822037,-4,1346,3586,40
96144387583,96144387583,0,1315,2002,40
96146488873,96146488870,-3,1368,2522,40
96146540828,96146540851,23,618,2984,40
96147773125,96147773117,-8,809,3253,40
96150025738,96150025733,-5,1422,4291,40
96150181349,96150181345,-4,799,2929,40
96150751327,96150751319,-8,1010,2106,40
96154053051,96154053046,-5,866,2280,40
96154501535,96154501530,-5,1078,3723,40
96155451049,96155451045,-4,1074,3059,40
96156243837,96156243853,16,161,1943,40
96163021942,96163021937,-5,1110,3580,40
96164995122,96164995117,-5,1734,7443,40
96166011178,96166011171,-7,1095,3673,40
96166512652,96166512634,-18,158,1603,40
96168330894,96168330890,-4,961,2723,40
96174858630,96174858625,-5,1076,2929,40
96176092774,96176092772,-2,2103,4879,40
96177993478,96177993471,-7,1169,3060,40
96180700358,96180700352,-6,835,3927,40
96184566835,96184566830,-5,1031,4353,40
96191909191,96191909194,3,2223,2211,40
96195765467,96195765471,4,1856,2044,40
96209524819,96209524813,-6,681,4517,40
96214800843,96214800838,-5,1263,4407,40
96215118861,96215118872,11,97,1507,40
96216352114,96216352109,-5,681,3963,40
96216703976,96216703993,17,493,1852,40
96222382411,96222382405,-6,1041,3969,40
96227485924,96227485918,-6,1454,4085,40
96232654631,96232654630,-1,1674,1834,40
96237010362,96237010357,-5,1229,3757,40
96240708101,96240708096,-5,783,4461,40
96242558378,96242558378,0,2069,3801,40
96245286710,96245286703,-7,985,4043,40
96251515139,96251515134,-5,1009,3030,40
96256452949,96256452942,-7,1285,3994,40
96268061897,96268061890,-7,976,3310,40
96269429869,96269429860,-9,192,935,40
96272566870,96272566862,-8,684,7602,40
96272623882,96272623877,-5,647,3422,40
96277791702,96277791695,-7,1140,5750,40
96281754379,96281754374,-5,819,3815,40
96283698803,96283698803,0,1512,2064,40
96286696769,96286696766,-3,1131,2890,40
96287606170,96287606162,-8,1086,4303,40
96289914002,96289913994,-8,565,3223,40
96290349528,96290349540,12,134,1011,40
96291058792,96291058806,14,415,1875,40
96295753487,96295753483,-4,1769,4595,40
96295885317,96295885311,-6,1624,4806,40
96296869971,96296869973,2,1913,1964,40
96297234413,96297234407,-6,1068,4565,40
96300611279,96300611287,8,2133,965,40
96302414342,96302414337,-5,1003,4741,40
96305584222,96305584216,-6,775,3671,40
96305729736,96305729754,18,871,3208,40
96317335382,96317335375,-7,1535,4546,40
96318704387,96318704379,-8,1302,4505,40
96320464256,96320464258,2,231,1358,40
96320544911,96320544908,-3,1122,2673,40
96320841431,96320841411,-20,89,1500,40
96324742818,96324742813,-5,893,2687,40
96325840417,96325840414,-3,1729,2734,40
96326446712,96326446707,-5,994,3763,40
96329602281,96329602277,-4,979,3140,40
96336570498,96336570490,-8,1588,4788,40
96344081645,96344081652,7,2569,765,40
96350584012,96350584002,-10,117,1070,40
96353235876,96353235878,2,2437,1537,40
96358038810,96358038806,-4,470,2976,40
96359666323,96359666338,15,769,4779,40
96360609538,96360609533,-5,1364,2497,40
96370970430,96370970423,-7,894,3509,40
96371604964,96371604980,16,310,3405,40
96374762927,96374762922,-5,701,3091,40
96375281345,96375281350,5,1900,1609,40
96378326151,96378326145,-6,467,1467,40
96382867025,96382867018,-7,1355,3923,40
96383675259,96383675252,-7,841,3449,40
96390022566,96390022561,-5,1076,3217,40
96393735873,96393735866,-7,1405,4987,40
96393804103,96393804117,14,237,996,40
96393965726,96393965708,-18,2078,1179,40
96401119539,96401119533,-6,689,3403,40
96401577719,96401577721,2,445,1554,40
96408146431,96408146425,-6,628,2354,40
96412986786,96412986779,-7,974,3769,40
96415335325,96415335317,-8,1783,8905,40
96425142605,96425142599,-6,893,2194,40
96434729193,96434729194,1,2077,1943,40
96436149006,96436149003,-3,1184,2580,40
96438797247,96438797242,-5,734,3930,40
96441834370,96441834365,-5,640,2562,40
96443230182,96443230182,0,57,967,40
96455209610,96455209605,-5,1041,4357,40
96457380346,96457380340,-6,825,3794,40
96471343922,96471343916,-6,605,2624,40
96475855431,96475855426,-5,1295,5087,40
96476368760,96476368755,-5,1042,2340,40
96479673246,96479673239,-7,760,3620,40
96482136753,96482136754,1,1492,1783,40
96484289403,96484289396,-7,1372,4068,40
96485815342,96485815337,-5,1310,4091,40
96487696119,96487696114,-5,1147,3799,40
96487849767,96487849762,-5,1065,3433,40
96492828242,96492828237,-5,681,3727,40
96501004544,96501004538,-6,1413,4064,40
96505085975,96505085967,-8,1045,4412,40
96506895386,96506895381,-5,171,600,40
96515342211,96515342204,-7,1073,3644,40
96515631621,96515631614,-7,319,1092,40
96522697264,96522697256,-8,1072,4813,40
96523200406,96523200401,-5,971,4684,40
96525630093,96525630086,-7,1293,3741,40
96528638860,96528638863,3,144,1769,40
96530620221,96530620222,1,1750,1923,40
96531440451,96531440458,7,2163,1788,40
96532445049,96532445043,-6,845,2663,40
96536067712,96536067710,-2,990,1125,40
96548292168,96548292162,-6,593,2878,40
96551830536,96551830529,-7,859,3511,40
96558175887,96558175881,-6,1357,3707,40
96561311548,96561311542,-6,1142,4128,40
96578145683,96578145678,-5,950,3592,40
96582814428,96582814425,-3,1447,3207,40
96583073658,96583073654,-4,811,5075,40
96588095690,96588095682,-8,1053,4853,40
96589759530,96589759525,-5,1226,4610,40
96596444799,96596444799,0,1517,2132,40
96602812447,96602812452,5,1899,1870,40
96609638252,96609638257,5,1904,1902,40
96611729842,96611729843,1,2530,2496,40
96622043857,96622043853,-4,1007,1776,40
96622184732,96622184727,-5,1195,4474,40
96624113838,96624113834,-4,755,2660,40
96629971894,96629971888,-6,727,2895,40
96632748658,96632748652,-6,1065,3820,40
96635164097,96635164092,-5,564,2813,40
96636285055,96636285048,-7,972,3626,40
96638994849,96638994842,-7,1250,2266,40
96641997443,96641997436,-7,1062,2229,40
96643040404,96643040400,-4,1124,3282,40
96643659737,96643659754,17,177,777,40
96644295214,96644295196,-18,1649,1152,40
96652623455,96652623462,7,5712,1935,40
96653508166,96653508178,12,15167,26613,40
96661518022,96661518017,-5,1262,3464,40
96665047505,96665047510,5,3345,2095,40
96673348131,96673348126,-5,937,3658,40
96673786164,96673786160,-4,607,2548,40
96677991279,96677991274,-5,708,2861,40
96681113998,96681113990,-8,984,2974,40
96681412244,96681412238,-6,89,1213,40
96681865252,96681865246,-6,1294,3432,40
96682167966,96682167960,-6,833,3893,40
96690386791,96690386787,-4,1069,3515,40
96700026163,96700026157,-6,939,2880,40
96702236259,96702236258,-1,1531,2365,40
96702418103,96702418120,17,1284,4548,40
96705669581,96705669580,-1,1076,1059,40
96713217233,96713217227,-6,1221,4964,40
96714274520,96714274515,-5,1237,2811,40
96714300944,96714300922,-22,1415,3555,40
96724802099,96724802092,-7,637,3506,40
96732824085,96732824088,3,1787,1659,40
96734029738,96734029732,-6,1048,4107,40
96740023230,96740023224,-6,808,3775,40
96740508196,96740508178,-18,239,1442,40
96747011525,96747011520,-5,1057,5011,40
96750714651,96750714646,-5,1242,5220,40
96752018723,96752018720,-3,1398,2612,40
96753825846,96753825840,-6,1050,3696,40
96756551199,96756551193,-6,1607,5324,40
96767025904,96767025898,-6,793,2765,40
96770243443,96770243439,-4,984,3790,40
96770413977,96770413982,5,1559,1358,40
96772476947,96772476941,-6,1185,4812,40
96772869702,96772869722,20,341,941,40
96775968196,96775968192,-4,1328,4605,40
96777188333,96777188350,17,176,1230,40
96777957446,96777957450,4,3828,3343,40
96780092875,96780092870,-5,841,2121,40
96780403214,96780403204,-10,55,872,40
96781608831,96781608846,15,342,1969,40
96783899458,96783899462,4,1752,1581,40
96796866679,96796866673,-6,1131,3532,40
96802753471,96802753465,-6,1035,3200,40
96803554614,96803554602,-12,168,1542,40
96804402578,96804402572,-6,1236,3314,40
96806336851,96806336844,-7,1500,5278,40
96807362896,96807362903,7,2658,984,40
96813135078,96813135073,-5,1071,4084,40
96814936295,96814936291,-4,912,3555,40
96818820385,96818820380,-5,1066,3113,40
96818858612,96818858635,23,660,1893,40
96820959356,96820959349,-7,880,4466,40
96822540638,96822540645,7,2996,1576,40
96829333951,96829333958,7,4664,1646,40
96839888973,96839888972,-1,3265,4755,40
96846551905,96846551906,1,1523,1643,40
96847522238,96847522237,-1,2163,3446,40
96861954474,96861954470,-4,1274,2926,40
96867497464,96867497457,-7,935,3445,40
96872863482,96872863477,-5,843,3239,40
96873311669,96873311662,-7,896,3116,40
96874360541,96874360556,15,545,2793,40
96875985651,96875985646,-5,1143,3180,40
96876028632,96876028647,15,144,999,40
96879528443,96879528441,-2,629,1501,40
96883647138,96883647132,-6,1036,4231,40
96885666136,96885666147,11,14837,27950,40
96893507835,96893507854,19,784,2657,40
96893677470,96893677462,-8,844,3710,40
96901120552,96901120546,-6,906,2750,40
96904434735,96904434738,3,2336,1816,40
96904842463,96904842457,-6,1049,1995,40
96907755225,96907755219,-6,1402,4763,40
96911579879,96911579874,-5,882,2741,40
96919715642,96919715637,-5,1186,4147,40
96921115653,96921115650,-3,973,2300,40
96921583630,96921583650,20,710,2362,40
96928944212,96928944206,-6,1232,4921,40
96932971674,96932971670,-4,1443,4133,40
96933902657,96933902652,-5,1061,3376,40
96936461254,96936461249,-5,939,3998,40
96949505451,96949505446,-5,1342,2747,40
96952515747,96952515742,-5,1013,2640,40
96953692102,96953692097,-5,1234,3474,40
96954760058,96954760052,-6,934,3362,40
96955051026,96955051018,-8,919,4938,40
96961956074,96961956069,-5,846,2674,40
96961999773,96961999775,2,73,856,40
96965181152,96965181145,-7,1268,4904,40
96982234434,96982234433,-1,2018,4219,40
96982896436,96982896430,-6,1000,1802,40
96988650173,96988650169,-4,505,2300,40
96993242266,96993242258,-8,1241,4138,40
96996481581,96996481586,5,6104,2338,40
97005990059,97005990054,-5,788,3281,40
97007611546,97007611554,8,2353,659,40
97014700785,97014700778,-7,1216,6194,40
97018280105,97018280101,-4,1550,2841,40
97026508084,97026508080,-4,595,1768,40
97028175235,97028175229,-6,1260,4928,40
97041698504,97041698498,-6,1165,4106,40
97045121766,97045121762,-4,1233,3023,40
97049359513,97049359506,-7,564,2166,40
97049935389,97049935405,16,21,970,40
97050979141,97050979120,-21,12820,38145,40
97054718518,97054718517,-1,1338,1670,40
97055020894,97055020906,12,115,932,40
97055627597,97055627605,8,105,1079,40
97058116294,97058116298,4,2085,1344,40
97064828655,97064828650,-5,1156,4449,40
97065200534,97065200552,18,475,3226,40
97070749922,97070749917,-5,815,4516,40
97071522886,97071522903,17,705,2872,40
97072132858,97072132854,-4,2074,7907,40
97073034752,97073034745,-7,880,3375,40
97073771046,97073771060,14,158,889,40
97074990334,97074990327,-7,1268,4693,40
97078577194,97078577187,-7,958,3812,40
97081302388,97081302384,-4,1103,3296,40
97094748903,97094748900,-3,1152,3025,40
97094783485,97094783478,-7,12,957,40
97094974971,97094974965,-6,1538,3251,40
97095271658,97095271666,8,26765,53366,40
97096309667,97096309662,-5,854,3391,40
97100405885,97100405881,-4,1255,2890,40
97103606215,97103606209,-6,1158,4931,40
97104325374,97104325389,15,63,1247,40
97104572713,97104572708,-5,1105,3705,40
97105928277,97105928272,-5,1443,4398,40
97109389360,97109389354,-6,1110,4380,40
97110078319,97110078313,-6,1021,4567,40
97110608262,97110608278,16,413,2314,40
97110792686,97110792681,-5,1201,2984,40
97126114662,97126114656,-6,771,3219,40
97130104291,97130104286,-5,1099,3770,40
97132010539,97132010535,-4,547,3120,40
97143799559,97143799557,-2,5085,10893,40
97144514465,97144514461,-4,1176,5103,40
97152935831,97152935826,-5,660,2275,40
97156206356,97156206349,-7,1915,6923,40
97161171841,97161171836,-5,1037,3558,40
97162440359,97162440377,18,1249,4346,40
97164006867,97164006862,-5,847,3414,40
97171855390,97171855385,-5,824,3917,40
97172487690,97172487695,5,3702,1884,40
97175486906,97175486914,8,5093,1919,40
97177000190,97177000186,-4,1135,4121,40
97179150194,97179150190,-4,1591,5118,40
97181859113,97181859118,5,1993,1173,40
97183160475,97183160470,-5,1185,2281,40
97184728150,97184728145,-5,1336,4227,40
97185008162,97185008157,-5,1300,3242,40
97185500039,97185500058,19,1236,2482,40
97187332690,97187332686,-4,820,3174,40
97187812419,97187812411,-8,1168,5140,40
97190021298,97190021301,3,2190,1635,40
97193779842,97193779835,-7,1525,4822,40
97201453262,97201453257,-5,493,2615,40
97204816891,97204816885,-6,713,3565,40
97206991919,97206991911,-8,562,1359,40
97209611579,97209611577,-2,1643,3750,40
97212520572,97212520566,-6,1179,3073,40
97212997624,97212997619,-5,136,997,40
97213521879,97213521874,-5,942,3112,40
97214728198,97214728191,-7,875,4190,40
97215037005,97215036992,-13,76,901,40
97220327930,97220327923,-7,808,2926,40
97220374126,97220374106,-20,1136,3218,40
97227785510,97227785517,7,6555,2207,40
97228051263,97228051269,6,4477,2172,40
97231438710,97231438703,-7,158,1093,40
97233359356,97233359355,-1,14,968,40
97237687646,97237687641,-5,794,3721,40
97238270294,97238270313,19,310,1109,40
97238510088,97238510106,18,15568,27854,40
97240294112,97240294105,-7,1125,2555,40
97244402209,97244402203,-6,1231,3805,40
97247966257,97247966252,-5,1070,3406,40
97248357053,97248357048,-5,1368,3755,40
97248623117,97248623110,-7,979,4139,40
97249792234,97249792228,-6,765,2380,40
97256834342,97256834337,-5,860,3314,40
97258140223,97258140218,-5,355,1218,40
97260179977,97260179970,-7,939,4729,40
97260726959,97260726946,-13,164,1724,40
97261525272,97261525277,5,27,3869,40
97261745429,97261745425,-4,238,1045,40
97263137351,97263137346,-5,829,4074,40
97265556368,97265556362,-6,1147,3303,40
97268214648,97268214648,0,1694,2677,40
97271434506,97271434501,-5,702,3108,40
97271846701,97271846690,-11,1823,5522,40
97277370090,97277370085,-5,1089,4127,40
97284530018,97284530016,-2,723,2358,40
97285422970,97285422986,16,215,1301,40
97285507392,97285507369,-23,165,1039,40
97291347058,97291347063,5,1421,1260,40
97296394647,97296394642,-5,738,4353,40
97301127966,97301127966,0,1516,2191,40
97313980721,97313980727,6,2942,1037,40
97316506330,97316506326,-4,1168,3563,40
97317942361,97317942354,-7,793,4085,40
97322746891,97322746886,-5,754,2436,40
97328942751,97328942746,-5,1227,4557,40
97330448320,97330448324,4,2786,1588,40
97331827028,97331827010,-18,930,3589,40
97332606119,97332606112,-7,1129,4306,40
97341837017,97341837009,-8,1337,4768,40
97342762430,97342762422,-8,241,906,40
97343429811,97343429807,-4,1010,3397,40
97347814370,97347814365,-5,1238,3372,40
97348225001,97348224995,-6,1071,2920,40
97348682066,97348682058,-8,532,1112,40
97353815906,97353815901,-5,879,3473,40
97354132302,97354132298,-4,1262,2622,40
97360305911,97360305914,3,917,840,40
97366852089,97366852084,-5,1090,3508,40
97370658950,97370658943,-7,1046,4624,40
97374608375,97374608374,-1,115,1652,40
97375547162,97375547158,-4,971,1710,40
97383180414,97383180406,-8,817,3063,40
97385755436,97385755432,-4,1368,2600,40
97385850503,97385850486,-17,115,1163,40
97386871525,97386871518,-7,872,2843,40
97389431457,97389431451,-6,667,4186,40
97397657346,97397657341,-5,1041,3382,40
97397781752,97397781749,-3,1198,2830,40
97398031712,97398031729,17,644,1544,40
97404187235,97404187229,-6,1178,3605,40
97406413448,97406413444,-4,737,1915,40
97406763994,97406763994,0,1327,1162,40
97408157994,97408157989,-5,920,4026,40
97409307404,97409307398,-6,928,4017,40
97412309388,97412309381,-7,1007,3146,40
97414047256,97414047250,-6,842,2919,40
97414261798,97414261793,-5,1209,4114,40
97414288220,97414288208,-12,1008,3243,40
97414894152,97414894161,9,96,1177,40
97422393482,97422393477,-5,775,2883,40
97422424749,97422424765,16,916,4273,40
97423206655,97423206662,7,2464,899,40
97431965879,97431965873,-6,982,3053,40
97435133097,97435133098,1,1976,25346,40
97435322239,97435322240,1,1554,1810,40
97436711776,97436711770,-6,982,2898,40
97437283478,97437283496,18,398,2221,40
97447855958,97447855963,5,3418,2063,40
97453420270,97453420262,-8,907,4288,40
97455327067,97455327061,-6,1792,3530,40
97456513861,97456513855,-6,1271,3566,40
97456880798,97456880804,6,204,1325,40
97463358691,97463358687,-4,1220,3711,40
97466290402,97466290397,-5,884,2952,40
97468555090,97468555085,-5,806,2511,40
97470832890,97470832884,-6,965,3697,40
97473634332,97473634337,5,1138,1172,40
97480236307,97480236302,-5,1154,4641,40
97484000274,97484000270,-4,1124,4271,40
97484340853,97484340867,14,257,1024,40
97499442499,97499442493,-6,983,2588,40
97501085107,97501085105,-2,1011,1596,40
97504094899,97504094897,-2,1120,1864,40
97505448443,97505448437,-6,961,3382,40
97505889005,97505888985,-20,326,1313,40
97507409251,97507409245,-6,1305,3071,40
97510317095,97510317090,-5,1165,3274,40
97519027587,97519027583,-4,999,2584,40
97519809050,97519809045,-5,1037,3832,40
97523978494,97523978489,-5,1160,3572,40
97527262867,97527262862,-5,975,2993,40
97529720231,97529720224,-7,842,3819,40
97535220489,97535220480,-9,1012,4200,40
97538067654,97538067650,-4,1214,3096,40
97538576239,97538576255,16,74,1074,40
97538969207,97538969221,14,623,1551,40
97539145174,97539145165,-9,780,4921,40
97540059535,97540059529,-6,934,2381,40
97541436387,97541436385,-2,1004,3724,40
97554634101,97554634105,4,1947,1368,40
97567453148,97567453153,5,3375,1178,40
97571377628,97571377626,-2,2370,4771,40
97573274762,97573274756,-6,728,3845,40
97574678157,97574678176,19,1010,3620,40
97580899842,97580899846,4,3257,1844,40
97582319470,97582319465,-5,659,2455,40
97590429546,97590429547,1,1140,932,40
97600066068,97600066069,1,1673,1576,40
97604105723,97604105717,-6,1126,4570,40
97610427323,97610427318,-5,1061,2616,40
97611695300,97611695296,-4,1213,3105,40
97612030558,97612030549,-9,135,1560,40
97623858631,97623858627,-4,765,1973,40
97629149840,97629149857,17,1273,3731,40
97629682916,97629682902,-14,495,2574,40
97640803612,97640803606,-6,1091,2665,40
97645742402,97645742397,-5,1211,4004,40
97647405630,97647405625,-5,1053,3246,40
97652115442,97652115436,-6,796,3412,40
97652317110,97652317115,5,2042,1222,40
97652846682,97652846677,-5,1454,3472,40
97652996848,97652996857,9,293,1197,40
97653697198,97653697204,6,119,1132,40
97670297913,97670297906,-7,1068,3691,40
97671292322,97671292317,-5,1238,3140,40
97676368952,97676368973,21,290,1388,40
97679910288,97679910282,-6,1271,3677,40
97681326358,97681326345,-13,115,1328,40
97682856606,97682856600,-6,1251,4121,40
97685600594,97685600590,-4,1101,3560,40
97686393765,97686393779,14,713,3708,40
97692968008,97692968002,-6,1940,6603,40
97693464623,97693464617,-6,892,2966,40
97702203481,97702203474,-7,1046,5787,40
97702325184,97702325201,17,1057,3412,40
97702388724,97702388720,-4,1214,3729,40
97708707424,97708707417,-7,1120,3340,40
97709353821,97709353814,-7,1306,3953,40
97710877966,97710877961,-5,1395,2838,40
97711838229,97711838230,1,72,1209,40
97725026587,97725026579,-8,206,2087,40
97725388189,97725388181,-8,49,1049,40
97728369754,97728369749,-5,1173,3013,40
97730239592,97730239585,-7,1247,4340,40
97730318426,97730318419,-7,1521,4859,40
97746985297,97746985290,-7,826,3677,40
97748591321,97748591315,-6,901,3767,40
97751816994,97751816988,-6,1597,3742,40
97754873590,97754873586,-4,737,2626,40
97760314654,97760314650,-4,789,3244,40
97760738085,97760738086,1,341,2114,40
97763465859,97763465854,-5,734,3370,40
97777201257,97777201251,-6,1280,3450,40
97777500381,97777500374,-7,971,4067,40
97781249065,97781249059,-6,1253,3598,40
97781973151,97781973146,-5,1801,7070,40
97785851843,97785851837,-6,1330,2477,40
97788882848,97788882843,-5,1294,3759,40
97797716228,97797716224,-4,2114,4597,40
97804695838,97804695842,4,1022,1032,40
97804951510,97804951491,-19,42,1136,40
97810736015,97810736010,-5,1073,3867,40
97813585170,97813585163,-7,617,4236,40
97813739558,97813739577,19,536,1303,40
97815317781,97815317774,-7,1186,4602,40
97821149924,97821149919,-5,990,3119,40
97822013372,97822013394,22,1046,3500,40
97823032120,97823032131,11,745,3726,40
97826595695,97826595693,-2,811,1020,40
97835568575,97835568569,-6,867,3669,40
97844158937,97844158930,-7,1098,3421,40
97849574769,97849574762,-7,881,4557,40
97850331726,97850331733,7,2712,939,40
97851355265,97851355260,-5,751,2250,40
97855085925,97855085918,-7,503,2744,40
97855656047,97855656031,-16,1167,4072,40
97860009910,97860009904,-6,1238,3531,40
97876717694,97876717686,-8,1019,5266,40
97877672197,97877672179,-18,104,1026,40
97878178093,97878178084,-9,230,1032,40
97879310271,97879310265,-6,735,3922,40
97887086727,97887086722,-5,585,2642,40
97900666559,97900666555,-4,1201,3995,40
97907351402,97907351396,-6,1015,2971,40
97908902259,97908902264,5,3596,1821,40
97912550246,97912550240,-6,949,2924,40
97915096125,97915096117,-8,1066,3911,40
97921208185,97921208178,-7,1023,4617,40
97924177719,97924177714,-5,653,2362,40
97925998335,97925998329,-6,1097,4605,40
97927259983,97927259978,-5,988,4039,40
97929109401,97929109395,-6,321,1531,40
97929501773,97929501763,-10,964,2103,40
97930012566,97930012545,-21,143,663,40
97936558669,97936558664,-5,1910,5199,40
97941997977,97941997971,-6,1319,4824,40
97943360652,97943360647,-5,888,2908,40
97957214528,97957214529,1,4174,21180,40
97964268939,97964268932,-7,1381,4640,40
97974269806,97974269798,-8,1024,3332,40
97974389784,97974389786,2,77,850,40
97979630237,97979630231,-6,738,2128,40
97979964967,97979964965,-2,190,1500,40
97991791951,97991791943,-8,1149,3911,40
97992130287,97992130283,-4,1052,2720,40
97992568711,97992568704,-7,959,3267,40
97992716143,97992716161,18,1101,4297,40
97996088638,97996088633,-5,1070,2893,40
97996342139,97996342136,-3,1068,3140,40
97997303861,97997303853,-8,826,3312,40
97998426874,97998426869,-5,1229,3988,40
97999789576,97999789563,-13,8559,37718,40
98000892392,98000892387,-5,1013,2171,40
98009777999,98009778003,4,1026,806,40
98010522411,98010522405,-6,1931,7489,40
98016293301,98016293295,-6,1626,3742,40
98023744966,98023744970,4,2502,1971,40
98026479275,98026479268,-7,739,2515,40
98026611533,98026611551,18,121,1601,40
98028726454,98028726439,-15,2911,959,40
98030523023,98030523018,-5,1000,4855,40
98032480390,98032480385,-5,858,3084,40
98034565089,98034565084,-5,2589,5256,40
98044847879,98044847862,-17,1853,885,40
98045391940,98045391935,-5,1789,4427,40
98050674342,98050674337,-5,1031,2963,40
98051639424,98051639418,-6,1065,3216,40
98052715581,98052715575,-6,1074,3806,40
98053147803,98053147798,-5,19505,13760,40
98060944051,98060944050,-1,1433,1505,40
98069004432,98069004429,-3,1064,1745,40
98091184203,98091184197,-6,584,3492,40
98094316178,98094316174,-4,804,3361,40
98094898967,98094898950,-17,214,973,40
98098857735,98098857729,-6,937,3320,40
98099712764,98099712787,23,15488,52905,40
98100339893,98100339888,-5,1036,3645,40
98103630521,98103630517,-4,1133,1603,40
98111344335,98111344329,-6,756,2263,40
98111466420,98111466414,-6,828,3373,40
98115832782,98115832774,-8,910,4085,40
98119371861,98119371854,-7,1076,4395,40
98121630141,98121630134,-7,628,1627,40
98123547860,98123547854,-6,961,2842,40
98125276319,98125276322,3,93,991,40
98127439179,98127439175,-4,1059,3957,40
98128191857,98128191849,-8,736,3465,40
98128369395,98128369394,-1,1250,2293,40
98131822058,98131822052,-6,1334,3802,40
98134465095,98134465089,-6,972,3029,40
98134716973,98134716984,11,250,754,40
98139315552,98139315538,-14,316,1643,40
98144540262,98144540270,8,8615,32014,40
98144895140,98144895145,5,245,1357,40
98147664884,98147664877,-7,702,3365,40
98149033918,98149033906,-12,1373,3173,40
98155997794,98155997809,15,199,1693,40
98156258901,98156258902,1,18,1327,40
98159538678,98159538673,-5,1125,5830,40
98161029914,98161029906,-8,974,3074,40
98161072509,98161072498,-11,108,1257,40
98161964966,98161964960,-6,904,4154,40
98164718164,98164718157,-7,1172,3665,40
98170892939,98170892933,-6,801,1782,40
98171409728,98171409730,2,222,854,40
98177002039,98177002034,-5,1401,3427,40
98184202621,98184202617,-4,763,3235,40
98186238598,98186238593,-5,963,4024,40
98186273053,98186273059,6,2180,1144,40
98188930855,98188930849,-6,639,3486,40
98193082098,98193082113,15,681,2836,40
98209026577,98209026571,-6,1050,2883,40
98209565781,98209565775,-6,141,998,40
98214499165,98214499158,-7,976,2742,40
98214898170,98214898165,-5,868,2790,40
98217797518,98217797511,-7,999,4415,40
98217947204,98217947221,17,632,2492,40
98225818387,98225818382,-5,1140,3443,40
98226593846,98226593839,-7,125,894,40
98230033610,98230033601,-9,940,4027,40
98230738429,98230738422,-7,1085,2687,40
98240607607,98240607601,-6,1156,3091,40
98240684462,98240684458,-4,1329,3425,40
98244220146,98244220144,-2,1728,2582,40
98255253212,98255253205,-7,674,4190,40
98255625240,98255625242,2,154,1010,40
98256303629,98256303623,-6,1183,3292,40
98256333269,98256333261,-8,409,1816,40
98257847737,98257847732,-5,926,3567,40
98262898240,98262898234,-6,1072,3815,40
98265004633,98265004628,-5,860,3067,40
98265800245,98265800241,-4,1074,3303,40
98268170067,98268170059,-8,1300,4363,40
98270061776,98270061769,-7,1275,3994,40
98270118918,98270118919,1,1066,1912,40
98270449382,98270449386,4,1990,1517,40
98273427804,98273427799,-5,1295,3529,40
98276172865,98276172858,-7,898,4016,40
98289549397,98289549392,-5,1240,4371,40
98290226070,98290226065,-5,1180,3737,40
98300486609,98300486603,-6,1222,5089,40
98302359035,98302359030,-5,1057,4800,40
98302423759,98302423762,3,95,1108,40
98304480797,98304480792,-5,1072,3166,40
98312175588,98312175594,6,169,1306,40
98320840301,98320840295,-6,906,3715,40
98322124606,98322124603,-3,816,1943,40
98325656624,98325656618,-6,189,1122,40
98337410927,98337410922,-5,1226,3592,40
98344838487,98344838482,-5,1016,4605,40
98349143883,98349143877,-6,1046,3317,40
98354480671,98354480665,-6,1145,3626,40
98358229838,98358229830,-8,1318,4028,40
98359574654,98359574650,-4,1093,3312,40
98359739653,98359739646,-7,274,1316,40
98365453249,98365453245,-4,491,2603,40
98365771415,98365771415,0,13530,18308,40
98366947882,98366947876,-6,1034,4181,40
98371352398,98371352393,-5,1070,3723,40
98371884378,98371884374,-4,1023,4364,40
98371914830,98371914828,-2,252,1107,40
98378316750,98378316741,-9,919,3619,40
98378399764,98378399778,14,274,993,40
98378636179,98378636173,-6,875,3501,40
98378853877,98378853862,-15,1156,3308,40
98379616343,98379616337,-6,1063,4867,40
98385309375,98385309370,-5,1394,3644,40
98391359083,98391359077,-6,1291,3808,40
98392257381,98392257377,-4,875,3531,40
98395183079,98395183078,-1,674,1166,40
98401349262,98401349256,-6,1028,4468,40
98402817191,98402817185,-6,819,2971,40
98405971981,98405971974,-7,704,2674,40
98406063253,98406063273,20,795,3450,40
98406312075,98406312068,-7,1364,4514,40
98410425943,98410425940,-3,1094,2128,40
98410768643,98410768640,-3,1033,2850,40
98415674947,98415674942,-5,744,8400,40
98415944100,98415944081,-19,315,1153,40
98418378498,98418378493,-5,1068,3042,40
98425207293,98425207287,-6,1123,3643,40
98425420079,98425420098,19,453,962,40
98429149211,98429149218,7,2631,1268,40
98434574679,98434574674,-5,1048,4897,40
98439052610,98439052608,-2,812,1818,40
98445986690,98445986684,-6,1161,4867,40
98446675741,98446675759,18,303,1785,40
98449497855,98449497857,2,2610,1731,40
98457555819,98457555826,7,1820,1207,40
98466703418,98466703411,-7,1216,4310,40
98470327383,98470327377,-6,1023,3181,40
98475592728,98475592722,-6,972,4659,40
98477759026,98477759020,-6,994,4397,40
98479121004,98479121002,-2,1440,3228,40
98479351382,98479351377,-5,857,4231,40
98484043191,98484043189,-2,1206,2996,40
98484319311,98484319298,-13,263,1428,40
98484908341,98484908360,19,648,2494,40
98486069617,98486069613,-4,819,3932,40
98488914571,98488914566,-5,1001,2741,40
98490264982,98490264986,4,3184,1653,40
98495375783,98495375777,-6,914,4388,40
98500550223,98500550222,-1,322,1501,40
98508743631,98508743629,-2,1219,2076,40
98510940673,98510940673,0,900,1169,40
98517589077,98517589085,8,8571,2294,40
98520188007,98520188003,-4,1748,4024,40
98524491355,98524491350,-5,1381,3778,40
98525516658,98525516663,5,4286,1898,40
98530147734,98530147737,3,22137,18707,40
98531057345,98531057338,-7,1044,3116,40
98531344404,98531344421,17,1124,2901,40
98533073700,98533073701,1,28095,30605,40
98537317437,98537317431,-6,1173,4834,40
98539822757,98539822750,-7,1230,4194,40
98542194433,98542194426,-7,1174,3325,40
98558733273,98558733293,20,1280,4118,40
98559313498,98559313494,-4,1215,4433,40
98560158909,98560158903,-6,748,3935,40
98567922471,98567922465,-6,1057,3522,40
98569449549,98569449542,-7,1095,5346,40
98578953383,98578953378,-5,1014,3622,40
98580696649,98580696650,1,1422,1007,40
98583303090,98583303082,-8,1248,3774,40
98584005063,98584005069,6,31,624,40
98589021062,98589021055,-7,1100,3842,40
98590747186,98590747181,-5,1019,3352,40
98593682999,98593682995,-4,1183,3176,40
98594247889,98594247894,5,3866,2738,40
98594699106,98594699099,-7,1252,3977,40
98597486059,98597486053,-6,909,1834,40
98602562635,98602562628,-7,701,2384,40
98602751390,98602751391,1,873,588,40
98605990858,98605990853,-5,858,3920,40
98609381114,98609381121,7,2226,1294,40
98616994064,98616994066,2,41562,27395,40
98619902650,98619902646,-4,915,2693,40
98620057996,98620057990,-6,1234,3228,40
98622390853,98622390846,-7,1319,2964,40
98622586584,98622586578,-6,943,3538,40
98623553375,98623553369,-6,848,2754,40
98624371929,98624371933,4,1121,910,40
98625338686,98625338681,-5,1355,4748,40
98626310794,98626310786,-8,1561,4284,40
98627659945,98627659938,-7,1283,4389,40
98630264243,98630264239,-4,1317,2858,40
98631882914,98631882906,-8,1137,3971,40
98634352846,98634352842,-4,841,1932,40
98644410525,98644410518,-7,1158,3873,40
98645265431,98645265435,4,29,1065,40
98645445190,98645445186,-4,767,3868,40
98646210382,98646210376,-6,1254,4798,40
98650519575,98650519569,-6,969,2734,40
98650603503,98650603481,-22,235,736,40
98653627015,98653627009,-6,862,2672,40
98654403240,98654403236,-4,1014,2048,40
98654707918,98654707906,-12,157,847,40
98662920063,98662920058,-5,1062,3281,40
98663180142,98663180136,-6,862,2933,40
98666929547,98666929542,-5,1244,4498,40
98668656181,98668656188,7,244,954,40
98671282721,98671282728,7,1294,36533,40
98676656883,98676656878,-5,1384,5462,40
98686458929,98686458930,1,1121,1260,40
98688375987,98688375981,-6,1336,4322,40
98689643338,98689643330,-8,1472,4332,40
98689795374,98689795391,17,154,917,40
98696992935,98696992930,-5,811,3351,40
98697565184,98697565189,5,4615,3166,40
98701128963,98701128957,-6,1432,4669,40
98701340807,98701340791,-16,1339,5194,40
98703951965,98703951959,-6,1233,3719,40
98704302371,98704302363,-8,1151,5135,40
98709936303,98709936297,-6,1116,4641,40
98718013252,98718013251,-1,1550,3302,40
98725052529,98725052522,-7,961,4282,40
98732850271,98732850264,-7,1043,3857,40
98733534630,98733534650,20,905,2700,40
98743181342,98743181336,-6,918,3553,40
98747756149,98747756144,-5,923,3856,40
98754311432,98754311427,-5,1054,3276,40
98754829698,98754829694,-4,1070,4205,40
98755686531,98755686526,-5,970,4260,40
98759397912,98759397906,-6,729,3375,40
98760685910,98760685903,-7,932,2645,40
98764841751,98764841745,-6,946,3534,40
98765399497,98765399502,5,7103,1966,40
98767980504,98767980512,8,5444,1455,40
98769610883,98769610879,-4,1183,4899,40
98772217246,98772217241,-5,1207,4103,40
98774250379,98774250373,-6,1089,3465,40
98778308846,98778308839,-7,961,3859,40
98790488051,98790488046,-5,687,4152,40
98795451670,98795451665,-5,575,2160,40
98797894128,98797894129,1,1285,1907,40
98798435783,98798435780,-3,1016,1732,40
98811783471,98811783466,-5,757,2865,40
98813070709,98813070711,2,275,1400,40
98815683567,98815683562,-5,1188,3937,40
98816661541,98816661542,1,2912,1989,40
98819028507,98819028499,-8,963,3492,40
98820217102,98820217118,16,351,725,40
98822787569,98822787563,-6,860,3774,40
98823255300,98823255303,3,142,1428,40
98829764018,98829764017,-1,1544,2476,40
98830823427,98830823422,-5,1288,3516,40
98833142790,98833142786,-4,790,2160,40
98834536653,98834536645,-8,1817,8697,40
98835967630,98835967622,-8,1058,4714,40
98838038209,98838038208,-1,921,2297,40
98839110039,98839110036,-3,38350,20868,40
98857359667,98857359660,-7,1862,10986,40
98858905287,98858905280,-7,1564,5739,40
98863545679,98863545673,-6,1068,3941,40
98864145706,98864145700,-6,1152,5154,40
98865015488,98865015498,10,6,1129,40
98868606941,98868606931,-10,1152,3339,40
98873948653,98873948663,10,239,679,40
98879796037,98879796042,5,2671,1575,40
98880979047,98880979041,-6,711,2713,40
98881218841,98881218838,-3,2331,4078,40
98885338807,98885338811,4,196,926,40
98886809287,98886809268,-19,190,1033,40
98887380425,98887380418,-7,1164,4169,40
98888469320,98888469335,15,17247,37717,40
98892812847,98892812841,-6,1162,3755,40
98893309101,98893309106,5,6495,3439,40
98896169559,98896169550,-9,434,1172,40
98896624534,98896624529,-5,1100,3976,40
98904973482,98904973477,-5,1458,3123,40
98916078111,98916078105,-6,960,3147,40
98918791150,98918791145,-5,932,4110,40
98919700246,98919700261,15,247,1290,40
98926208079,98926208073,-6,709,3688,40
98927054581,98927054578,-3,409,1147,40
98927442495,98927442473,-22,294,966,40
98928420650,98928420643,-7,940,3755,40
98928450525,98928450531,6,78,1090,40
98929468302,98929468309,7,5404,1484,40
98937050477,98937050473,-4,1196,4006,40
98938967463,98938967458,-5,947,3074,40
98943053462,98943053470,8,11454,30442,40
98948244185,98948244179,-6,930,3516,40
98948398332,98948398323,-9,302,941,40
98962390842,98962390838,-4,1244,3127,40
98963776205,98963776198,-7,1111,3522,40
98964130486,98964130482,-4,870,3914,40
98966364570,98966364565,-5,920,2546,40
98975339124,98975339120,-4,1315,5277,40
98975392622,98975392620,-2,1094,2162,40
98976504923,98976504917,-6,1016,3562,40
98977332605,98977332598,-7,1255,4666,40
98977514934,98977514935,1,354,1329,40
98978238821,98978238815,-6,283,1107,40
98980193334,98980193345,11,93,1584,40
98983673021,98983673014,-7,631,2876,40
98986514797,98986514790,-7,1150,4064,40
98993027198,98993027192,-6,1192,2522,40
98994204667,98994204661,-6,755,3133,40
98996879205,98996879200,-5,1240,3594,40
99000895110,99000895104,-6,1069,4831,40
99001099471,99001099490,19,30,981,40
99007182706,99007182699,-7,1256,5180,40
99011454873,99011454878,5,2079,1039,40
99020004581,99020004573,-8,1130,4207,40
99020932126,99020932122,-4,1111,4114,40
99030600827,99030600821,-6,714,1635,40
99030985927,99030985910,-17,1162,3253,40
99039276983,99039276978,-5,663,1854,40
99044349228,99044349222,-6,1533,4706,40
99045367958,99045367936,-22,9,1325,40
99050180967,99050180962,-5,905,3400,40
99050233436,99050233432,-4,957,2610,40
99052484740,99052484746,6,3075,1190,40
99059284759,99059284755,-4,1314,2964,40
99066052946,99066052942,-4,1038,4708,40
99067723935,99067723924,-11,38005,12258,40
99070861281,99070861273,-8,1243,4305,40
99070966326,99070966342,16,747,4158,40
99072615062,99072615057,-5,1073,3437,40
99076178939,99076178930,-9,820,4651,40
99076698720,99076698722,2,40404,18434,40
99083296623,99083296618,-5,1454,4836,40
99085024226,99085024220,-6,849,3864,40
99086188442,99086188444,2,1291,1812,40
99088665887,99088665881,-6,869,2968,40
99088873272,99088873281,9,296,1945,40
99089367966,99089367966,0,1130,1869,40
99089942011,99089942005,-6,1076,3859,40
99094231222,99094231219,-3,848,2624,40
99096594749,99096594742,-7,1117,4038,40
99098085943,99098085937,-6,197,1057,40
99098942452,99098942448,-4,780,2358,40
99102054029,99102054022,-7,742,4369,40
99102902305,99102902298,-7,1577,4883,40
99104342065,99104342058,-7,1286,3681,40
99106798503,99106798495,-8,1025,4661,40
99110665881,99110665874,-7,1144,3268,40
99113659063,99113659057,-6,853,2871,40
99116124147,99116124141,-6,675,2939,40
99116756132,99116756133,1,113,900,40
99117278112,99117278091,-21,182,1317,40
99117512637,99117512621,-16,144,1262,40
99120734670,99120734665,-5,745,3667,40
99120937158,99120937173,15,698,2173,40
99121227726,99121227722,-4,996,2752,40
99127192142,99127192150,8,2901,1728,40
99127464746,99127464745,-1,968,1834,40
99129230206,99129230185,-21,249,1957,40
99129703366,99129703367,1,285,1226,40
99132810851,99132810843,-8,711,4713,40
99133170581,99133170562,-19,1102,3927,40
99135589772,99135589767,-5,935,2976,40
99141998071,99141998065,-6,987,3646,40
99150565117,99150565123,6,5174,2013,40
99155524075,99155524070,-5,984,3301,40
99172102201,99172102195,-6,1005,3004,40
99173345681,99173345673,-8,810,3851,40
99175627917,99175627913,-4,394,2832,40
99181160125,99181160118,-7,925,4233,40
99184799882,99184799877,-5,1134,2357,40
99184864988,99184865005,17,235,820,40
99193327067,99193327059,-8,972,4060,40
99193550285,99193550302,17,551,2476,40
99195002208,99195002198,-10,131,1062,40
99195708391,99195708386,-5,1061,3232,40
99200802761,99200802755,-6,1101,3685,40
99201291902,99201291916,14,943,4063,40
99201478670,99201478666,-4,884,3310,40
99202193503,99202193497,-6,771,3283,40
99205627152,99205627145,-7,806,4000,40
99205696200,99205696209,9,261,1279,40
99206983305,99206983302,-3,1397,2225,40
99207300079,99207300073,-6,1336,3843,40
99210794695,99210794689,-6,267,1315,40
99218799763,99218799757,-6,1328,3246,40
99228935939,99228935933,-6,927,3517,40
99235485602,99235485597,-5,1469,4280,40
99236424334,99236424327,-7,1132,3730,40
99236856983,99236857002,19,534,4312,40
99239752982,99239752977,-5,1089,4156,40
99240130064,99240130058,-6,1096,3396,40
99241065864,99241065861,-3,1197,3264,40
99247399501,99247399507,6,4916,2212,40
99249420087,99249420087,0,1135,1688,40
99255064013,99255064007,-6,1857,6454,40
99260668086,99260668080,-6,1289,3858,40
99262775220,99262775221,1,1436,1221,40
99266258617,99266258613,-4,902,2359,40
99276924675,99276924670,-5,1109,3920,40
99277766410,99277766404,-6,818,3728,40
99289171939,99289171933,-6,856,4352,40
99293055607,99293055602,-5,1122,2729,40
99299249407,99299249402,-5,905,2890,40
99299553463,99299553477,14,175,1534,40
99300074030,99300074011,-19,1469,1328,40
99308368633,99308368628,-5,1048,3693,40
99311424509,99311424503,-6,1123,3327,40
99311739990,99311739973,-17,135,1353,40
99311980832,99311980830,-2,194,1361,40
99313285525,99313285542,17,2651,1422,40
99313879425,99313879422,-3,1045,2262,40
99317132656,99317132649,-7,916,3437,40
99320439394,99320439389,-5,792,1601,40
99320526419,99320526414,-5,593,1481,40
99322791325,99322791320,-5,959,4896,40
99327905562,99327905557,-5,703,1418,40
99342396639,99342396643,4,1895,1840,40
99353597661,99353597682,21,383,1884,40
99358309407,99358309403,-4,1151,3341,40
99360753669,99360753665,-4,1177,3230,40
99366609602,99366609598,-4,1086,2179,40
99368092090,99368092088,-2,1241,2566,40
99371514321,99371514315,-6,1382,3632,40
99378751737,99378751743,6,1477,856,40
99379002586,99379002590,4,2593,1877,40
99385086885,99385086879,-6,1281,4115,40
99387044141,99387044137,-4,982,3317,40
99389993915,99389993909,-6,1080,2972,40
99390224431,99390224431,0,162,892,40
99390480344,99390480361,17,553,1390,40
99400216023,99400216020,-3,1315,3494,40
99403987506,99403987496,-10,745,2482,40
99404317923,99404317918,-5,645,3285,40
99404745239,99404745230,-9,123,1200,40
99411714918,99411714913,-5,706,1812,40
99422474191,99422474185,-6,1145,3553,40
99423806835,99423806831,-4,715,1910,40
99423886247,99423886254,7,175,1394,40
99424208166,99424208186,20,734,2938,40
99434096638,99434096632,-6,895,3466,40
99434670164,99434670182,18,497,1798,40
99441587102,99441587101,-1,1030,2053,40
99446158665,99446158655,-10,512,2323,40
99453842803,99453842797,-6,870,3029,40
99459187682,99459187676,-6,1090,4337,40
99459555903,99459555898,-5,1239,4512,40
99462185407,99462185402,-5,812,2580,40
99472855725,99472855722,-3,1324,2355,40
99494481959,99494481955,-4,678,2474,40
99495833187,99495833182,-5,1144,3698,40
99513882490,99513882495,5,1469,1011,40
99513974323,99513974317,-6,814,2570,40
99515470711,99515470705,-6,975,2915,40
99516992574,99516992571,-3,116,923,40
99517428423,99517428417,-6,1124,5264,40
99520307031,99520307026,-5,667,3891,40
99527413934,99527413929,-5,1100,4301,40
99527918794,99527918786,-8,984,3819,40
99530373841,99530373835,-6,1119,3913,40
99531153864,99531153877,13,918,4138,40
99534879170,99534879164,-6,1037,3387,40
99535688483,99535688482,-1,178,851,40
99536586055,99536586039,-16,912,2960,40
99537649170,99537649176,6,2017,788,40
99544117681,99544117676,-5,708,2244,40
99544809829,99544809824,-5,946,4102,40
99544958704,99544958718,14,195,1170,40
99545737791,99545737786,-5,920,3457,40
99549420378,99549420371,-7,875,3299,40
99550491616,99550491601,-15,311,866,40
99553169535,99553169530,-5,1486,4695,40
99554666213,99554666210,-3,1349,2153,40
99556224098,99556224090,-8,815,4485,40
99559161480,99559161474,-6,799,3913,40
99569038653,99569038647,-6,785,3025,40
99576418086,99576418080,-6,948,3816,40
99578518966,99578518959,-7,874,2182,40
99583324463,99583324458,-5,2181,6065,40
99583904838,99583904833,-5,819,2851,40
99584656350,99584656348,-2,164,896,40
99594834805,99594834801,-4,955,1851,40
99598117242,99598117235,-7,1073,4032,40
99600207996,99600208003,7,2506,1096,40
99603766250,99603766245,-5,815,2500,40
99604231982,99604231977,-5,1215,3831,40
99619585671,99619585665,-6,991,3595,40
99619895150,99619895164,14,798,3771,40
99620165554,99620165548,-6,865,4565,40
99620220776,99620220772,-4,1060,3799,40
99620443564,99620443556,-8,142,1572,40
99628539673,99628539677,4,3327,2284,40
99629828835,99629828829,-6,1094,3370,40
99630641808,99630641803,-5,793,2727,40
99630795478,99630795470,-8,224,855,40
99631497552,99631497562,10,242,1388,40
99632939120,99632939134,14,220,1061,40
99634951102,99634951095,-7,1083,4710,40
99644516050,99644516043,-7,662,2950,40
99647246130,99647246126,-4,1075,3117,40
99647993224,99647993206,-18,43,1186,40
99648668174,99648668195,21,2574,4002,40
99648745106,99648745101,-5,1236,3699,40
99656600015,99656600011,-4,1156,1858,40
99657569766,99657569759,-7,958,3191,40
99657927010,99657927005,-5,1468,4429,40
99658855274,99658855269,-5,1306,3194,40
99659232349,99659232343,-6,1067,2175,40
99664669604,99664669598,-6,1229,4586,40
99668216155,99668216149,-6,1092,1523,40
99668558893,99668558874,-19,1437,1458,40
99676800443,99676800437,-6,809,1946,40
99677532368,99677532367,-1,207,1067,40
99678171559,99678171540,-19,208,1298,40
99686936494,99686936486,-8,818,3086,40
99690916760,99690916756,-4,1724,3444,40
99693357144,99693357146,2,1108,1131,40
99697885641,99697885639,-2,2077,3633,40
99716016367,99716016366,-1,958,1335,40
99716194038,99716194046,8,164,1112,40
99716558773,99716558795,22,966,2293,40
99717230925,99717230918,-7,925,4397,40
99717417770,99717417765,-5,1182,2989,40
99720988810,99720988802,-8,572,3346,40
99724149669,99724149662,-7,966,3567,40
99727017114,99727017109,-5,1073,4474,40
99727340269,99727340257,-12,786,3328,40
99729076678,99729076673,-5,978,2965,40
99732682134,99732682128,-6,1118,4229,40
99732853376,99732853391,15,422,1089,40
99735165449,99735165446,-3,982,2297,40
99736196438,99736196432,-6,897,3668,40
99741838098,99741838093,-5,1171,3020,40
99749070396,99749070389,-7,1302,4761,40
99756555897,99756555891,-6,1002,4563,40
99757010534,99757010536,2,1754,2026,40
99757441962,99757441966,4,4080,2682,40
99760121079,99760121073,-6,1154,4315,40
99765342558,99765342550,-8,1186,5813,40
99769982738,99769982733,-5,1083,2790,40
99771702898,99771702893,-5,1090,3693,40
99773754818,99773754811,-7,982,3349,40
99774775366,99774775346,-20,125,1151,40
99777472887,99777472880,-7,1120,5404,40
99784767520,99784767513,-7,1072,1300,40
99787000501,99787000489,-12,348,1482,40
99787965424,99787965441,17,814,3008,40
99790125523,99790125519,-4,902,3418,40
99790346096,99790346090,-6,1198,3656,40
99792086512,99792086514,2,2955,2801,40
99792862120,99792862117,-3,1209,2804,40
99800955410,99800955403,-7,1063,4465,40
99806686295,99806686290,-5,1526,4103,40
99807986264,99807986258,-6,992,4916,40
99808408156,99808408142,-14,879,2428,40
99808918698,99808918692,-6,576,1362,40
99817817971,99817817965,-6,568,3304,40
99828479935,99828479928,-7,958,4374,40
99835068144,99835068144,0,1094,1059,40
99835555582,99835555586,4,1032,819,40
99837443104,99837443101,-3,44638,22206,40
99837505075,99837505069,-6,615,3229,40
99838612021,99838612017,-4,145,1379,40
99841852727,99841852713,-14,39873,14484,40
99845788680,99845788674,-6,314,1212,40
99846430654,99846430633,-21,204,1070,40
99849141383,99849141376,-7,949,3261,40
99855282848,99855282854,6,5306,2075,40
99855953202,99855953197,-5,1142,2897,40
99858738934,99858738929,-5,971,3579,40
99860320745,99860320740,-5,1376,4904,40
99862057157,99862057168,11,18030,29748,40
99862211854,99862211849,-5,714,3568,40
99862357029,99862357011,-18,411,1817,40
99868081101,99868081105,4,1136,1169,40
99875665619,99875665617,-2,565,1661,40
99875955642,99875955637,-5,969,3606,40
99877568063,99877568058,-5,1212,4144,40
99880916770,99880916763,-7,1103,4205,40
99883390041,99883390035,-6,1013,3074,40
99888932333,99888932335,2,1399,1320,40
99889712017,99889712022,5,2231,1471,40
99889871905,99889871900,-5,578,1786,40
99899754300,99899754311,11,21922,45354,40
99906751128,99906751114,-14,522,2379,40
99926639796,99926639806,10,14701,28161,40
99928888090,99928888082,-8,1323,4412,40
99931595632,99931595625,-7,1233,4330,40
99933749405,99933749398,-7,1561,4534,40
99936492203,99936492197,-6,627,2637,40
99942083663,99942083657,-6,1346,4400,40
99945665347,99945665362,15,1250,5188,40
99957153370,99957153366,-4,824,2439,40
99958560008,99958560004,-4,717,2232,40
99958968413,99958968433,20,1112,1996,40
99959257611,99959257606,-5,1473,3507,40
99960414106,99960414111,5,5323,2527,40
99964795322,99964795317,-5,986,2670,40
99967744974,99967744981,7,1153,869,40
99975069228,99975069227,-1,1486,1804,40
99984083367,99984083361,-6,924,3814,40
99984152560,99984152573,13,243,905,40
99987735912,99987735908,-4,1012,3248,40
99987851520,99987851516,-4,1072,2759,40
99988491861,99988491878,17,583,2889,40
99990894162,99990894153,-9,895,3097,40
99993455178,99993455173,-5,1511,4931,40
100002066927,100002066922,-5,888,4221,40
100012105427,100012105422,-5,1007,3262,40
100019462490,100019462484,-6,1229,3295,40
100019744414,100019744394,-20,209,1663,40
100019827381,100019827361,-20,84,593,40
100024788907,100024788903,-4,824,1287,40
100032623281,100032623280,-1,1770,2906,40
100038539393,100038539388,-5,1465,3344,40
100044237850,100044237845,-5,1120,4652,40
100046125110,100046125114,4,3807,2606,40
100050870691,100050870686,-5,1039,3979,40
100070568777,100070568773,-4,1304,3838,40
100072958709,100072958706,-3,1016,4151,40
100100949786,100100949780,-6,1045,3699,40
100102008252,100102008263,11,200,1115,40
100102441265,100102441263,-2,1360,2068,40
100110424083,100110424077,-6,731,3071,40
100111182447,100111182442,-5,1121,2648,40
100114814243,100114814237,-6,984,3320,40
100115417336,100115417349,13,247,1211,40
100116062963,100116062958,-5,582,1910,40
100121481899,100121481914,15,50,929,40
100124033566,100124033564,-2,1065,2675,40
100124359702,100124359717,15,526,2675,40
100125098626,100125098621,-5,759,3517,40
100125485387,100125485382,-5,923,2629,40
100127630035,100127630029,-6,1497,5004,40
100130834389,100130834383,-6,1040,3360,40
100132187486,100132187498,12,401,1184,40
100143437015,100143437009,-6,2175,7442,40
100144548358,100144548350,-8,1173,4549,40
100144578009,100144578001,-8,991,4176,40
100144728180,100144728174,-6,965,3638,40
100145731693,100145731711,18,120,1660,40
100146260884,100146260889,5,50,1723,40
100148069934,100148069931,-3,156,1303,40
100151085823,100151085822,-1,18161,4160,40
100152879589,100152879585,-4,1316,2457,40
100155404129,100155404125,-4,1553,5692,40
100155542871,100155542854,-17,281,1389,40
100168795587,100168795590,3,2053,1430,40
100170284506,100170284499,-7,1047,4922,40
100170480126,100170480122,-4,442,1443,40
100176755259,100176755254,-5,2117,5064,40
100184039963,100184039957,-6,1205,5012,40
100185692154,100185692149,-5,781,3639,40
100192364274,100192364267,-7,936,3178,40
100192475078,100192475075,-3,297,1074,40
100196408870,100196408865,-5,943,3554,40
100214801063,100214801075,12,2665,114,40
100234313349,100234313344,-5,1043,2558,40
100235864255,100235864239,-16,236,1074,40
100236646134,100236646127,-7,1053,4443,40
100236969534,100236969524,-10,245,1168,40
100240665994,100240665991,-3,155,1179,40
100242526783,100242526802,19,289,2091,40
100246927785,100246927779,-6,1140,4101,40
100253929751,100253929746,-5,1128,3270,40
100256125867,100256125863,-4,1742,3487,40
100259187837,100259187841,4,1988,1670,40
100264038847,100264038841,-6,672,1816,40
100264531161,100264531154,-7,1149,3863,40
100267886923,100267886917,-6,824,3189,40
100272116204,100272116198,-6,1641,6028,40
100272528007,100272528001,-6,1094,3082,40
100274473906,100274473899,-7,999,2941,40
100277363573,100277363573,0,1343,977,40
100277834418,100277834412,-6,1118,4088,40
100280359112,100280359112,0,29406,15962,40
100281258952,100281258946,-6,937,3343,40
100283757851,100283757846,-5,979,3649,40
100284318511,100284318526,15,431,1678,40
100286426355,100286426350,-5,1288,4752,40
100288304758,100288304753,-5,1277,3935,40
100289102391,100289102386,-5,742,3347,40
100291757018,100291757011,-7,1009,3111,40
100295799036,100295799040,4,1913,1241,40
100295950373,100295950357,-16,1708,953,40
100302123829,100302123823,-6,921,3657,40
100321432379,100321432373,-6,774,3132,40
100322173934,100322173927,-7,805,3820,40
100322575013,100322575021,8,2893,1166,40
100325606175,100325606167,-8,1204,4260,40
100334799590,100334799582,-8,1047,3609,40
100335419869,100335419879,10,36,935,40
100343057522,100343057515,-7,1444,5206,40
100344774302,100344774297,-5,1288,4580,40
100348061585,100348061580,-5,921,2802,40
100348275590,100348275586,-4,1654,3963,40
100348428828,100348428839,11,172,815,40
100350711791,100350711785,-6,1055,2434,40
100351343013,100351343018,5,17,615,40
100362009647,100362009640,-7,1359,4879,40
100363261377,100363261371,-6,1171,3408,40
100369053950,100369053945,-5,881,3540,40
100371273060,100371273054,-6,1294,2731,40
100387396902,100387396897,-5,1270,3792,40
100388652318,100388652332,14,881,2748,40
100390369570,100390369591,21,877,1273,40
100391722613,100391722631,18,359,1706,40
100397480896,100397480890,-6,903,2779,40
100398829376,100398829369,-7,907,2157,40
100399927928,100399927947,19,434,2943,40
100414259018,100414259011,-7,843,2785,40
100417181971,100417181965,-6,1125,3279,40
100419859405,100419859409,4,1141,1272,40
100423778253,100423778247,-6,789,3673,40
100426052683,100426052674,-9,603,2235,40
100428061095,100428061089,-6,669,3390,40
100431197154,100431197152,-2,1357,1929,40
100438753447,100438753443,-4,848,2097,40
100441379018,100441379013,-5,1753,4550,40
100449048446,100449048446,0,3266,4382,40
100451681482,100451681477,-5,952,4592,40
100452337757,100452337739,-18,196,1449,40
100456373767,100456373761,-6,1200,4075,40
100457639846,100457639842,-4,974,3095,40
100457773083,100457773078,-5,1115,3594,40
100457803841,100457803835,-6,1141,3825,40
100459165225,100459165218,-7,1181,3015,40
100461022206,100461022201,-5,1092,3172,40
100462466737,100462466730,-7,1311,4718,40
100477458230,100477458225,-5,1076,3160,40
100481959084,100481959077,-7,1108,3611,40
100483644154,100483644149,-5,934,3210,40
100486712327,100486712332,5,4648,2383,40
100494004240,100494004234,-6,984,4256,40
100497143774,100497143769,-5,907,4504,40
100500314043,100500314041,-2,1119,1298,40
100501518087,100501518086,-1,1791,2215,40
100512514544,100512514536,-8,922,6917,40
100512636392,100512636411,19,304,1184,40
100513894652,100513894674,22,798,2400,40
100517291267,100517291262,-5,455,3112,40
100517374875,100517374868,-7,1159,3927,40
100520915059,100520915054,-5,763,1898,40
100521043702,100521043697,-5,843,2497,40
100526879438,100526879430,-8,719,7514,40
100527273170,100527273164,-6,2324,11420,40
100527545442,100527545451,9,7022,884,40
100529870345,100529870338,-7,1250,3252,40
100531247890,100531247890,0,1346,1440,40
100533932427,100533932423,-4,597,2621,40
100534144176,100534144165,-11,190,1026,40
100535634093,100535634087,-6,987,4038,40
100540513075,100540513069,-6,1149,3260,40
100542546374,100542546369,-5,711,4249,40
100542817690,100542817684,-6,699,3178,40
100543272271,100543272274,3,311,990,40
100544489910,100544489905,-5,1141,4843,40
100545520441,100545520446,5,4066,2496,40
100553756482,100553756477,-5,754,3904,40
100555550487,100555550482,-5,1009,3531,40
100556296665,100556296668,3,19895,18488,40
100557456075,100557456067,-8,955,4480,40
100557541203,100557541197,-6,839,3306,40
100558003604,100558003617,13,438,1845,40
100559594630,100559594625,-5,1396,3754,40
100561259388,100561259381,-7,81,1021,40
100570373538,100570373532,-6,1145,4361,40
100570723574,100570723582,8,166,1576,40
100571512839,100571512833,-6,1056,3094,40
100581717653,100581717659,6,939,365,40
100584291994,100584291991,-3,1258,3889,40
100584502589,100584502601,12,149,1126,40
100596096320,100596096319,-1,1799,2563,40
100597152199,100597152202,3,28,651,40
100599247277,100599247269,-8,904,3130,40
100599480870,100599480890,20,280,1060,40
100600197859,100600197853,-6,968,3950,40
100600231238,100600231257,19,199,753,40
100602560771,100602560765,-6,1136,2808,40
100602665093,100602665114,21,554,2874,40
100602958279,100602958273,-6,915,3020,40
100603250334,100603250318,-16,1103,4622,40
100608588931,100608588924,-7,1183,2692,40
100612503101,100612503098,-3,1690,2935,40
100614334862,100614334857,-5,921,3489,40
100616224146,100616224140,-6,1044,3388,40
100617043751,100617043746,-5,914,3397,40
100618620338,100618620333,-5,841,3456,40
100620915451,100620915445,-6,1096,4637,40
100622827936,100622827942,6,3510,1890,40
100623604785,100623604778,-7,1404,5291,40
100626818054,100626818050,-4,1087,2865,40
100628898439,100628898437,-2,6208,12442,40
100630847131,100630847125,-6,931,3833,40
100636198090,100636198084,-6,1234,2425,40
100637129742,100637129755,13,1248,4788,40
100637350685,100637350679,-6,1096,3470,40
100644942339,100644942333,-6,1699,5761,40
100649613662,100649613656,-6,2392,7075,40
100651378649,100651378653,4,3690,3217,40
100653225754,100653225749,-5,1079,2838,40
100662397424,100662397415,-9,1046,4426,40
100667291042,100667291040,-2,1177,2208,40
100670509017,100670509009,-8,674,3735,40
100671262109,100671262103,-6,1002,4056,40
100676656454,100676656460,6,1866,1160,40
100678316085,100678316080,-5,998,2901,40
100678871782,100678871778,-4,1088,4243,40
100691035530,100691035525,-5,1251,4816,40
100693662773,100693662768,-5,1073,2764,40
100697877767,100697877762,-5,1130,2930,40
100698824902,100698824897,-5,1167,4630,40
100700115782,100700115778,-4,2566,8195,40
100701543871,100701543866,-5,503,2424,40
100701797143,100701797146,3,127,981,40
100706558179,100706558174,-5,1087,3929,40
100706793428,100706793430,2,1899,1390,40
100706836317,100706836314,-3,371,1415,40
100712096596,100712096593,-3,1073,2111,40
100717121662,100717121658,-4,1037,4967,40
100726983358,100726983355,-3,1851,3890,40
100728207802,100728207795,-7,1039,4879,40
100734989769,100734989769,0,1628,1876,40
100736447438,100736447433,-5,1143,3456,40
100737155812,100737155805,-7,892,3384,40
100739514646,100739514647,1,49758,22878,40
100742276461,100742276454,-7,905,2188,40
100742536514,100742536514,0,2381,3347,40
100742694397,100742694395,-2,53226,30619,40
100744380054,100744380056,2,1689,1855,40
100745306959,100745306952,-7,1153,3752,40
100754724670,100754724664,-6,1120,3675,40
100760452042,100760452037,-5,1228,3426,40
100762364470,100762364463,-7,1048,3665,40
100768615821,100768615815,-6,1210,3459,40
100770558655,100770558646,-9,724,3725,40
100780124577,100780124570,-7,1448,6643,40
100803005509,100803005503,-6,1230,4746,40
100806573174,100806573168,-6,581,2911,40
100807516270,100807516266,-4,1173,2029,40
100814597814,100814597807,-7,890,2877,40
100814977182,100814977171,-11,199,1527,40
100815385686,100815385704,18,772,3375,40
100817128574,100817128566,-8,879,5529,40
100817206501,100817206522,21,43,753,40
100820854151,100820854157,6,3348,1552,40
100828382350,100828382345,-5,1320,3275,40
100836028190,100836028182,-8,1784,3379,40
100837607662,100837607661,-1,1212,2150,40
100838895194,100838895188,-6,1018,4220,40
100839080235,100839080229,-6,1076,5069,40
100844105646,100844105641,-5,921,3494,40
100846270698,100846270692,-6,783,3353,40
100850594793,100850594800,7,1041,501,40
100869987254,100869987249,-5,1248,3006,40
100871168882,100871168875,-7,755,3707,40
100871363638,100871363658,20,762,3652,40
100877114850,100877114853,3,1688,1167,40
100878539467,100878539462,-5,683,2918,40
100880459321,100880459317,-4,988,3398,40
100883290674,100883290670,-4,1049,3937,40
100885990793,100885990794,1,289,919,40
100886890311,100886890305,-6,777,2540,40
100888265774,100888265753,-21,1769,4954,40
100902469500,100902469493,-7,1300,4573,40
100903041496,100903041499,3,116,1071,40
100905984309,100905984302,-7,1427,4834,40
100906077027,100906077021,-6,641,2838,40
100906355238,100906355233,-5,1013,3575,40
100911955451,100911955446,-5,2203,5741,40
100914782932,100914782926,-6,1061,4602,40
100916170016,100916170020,4,2929,1362,40
100917213943,100917213938,-5,986,3196,40
100918270034,100918270027,-7,766,4364,40
100918641322,100918641318,-4,1057,2278,40
100918978111,100918978130,19,641,2313,40
100921748423,100921748422,-1,1117,2126,40
100922489858,100922489871,13,854,3694,40
100922677227,100922677222,-5,874,2590,40
100923821846,100923821840,-6,1160,4509,40
100923914542,100923914538,-4,943,4210,40
100924606580,100924606586,6,164,1238,40
100927059986,100927059987,1,1343,1965,40
100932361928,100932361922,-6,1519,4681,40
100933307936,100933307949,13,5,1180,40
100941533733,100941533739,6,19686,23167,40
100943471439,100943471433,-6,749,3621,40
100947741699,100947741694,-5,1085,3737,40
100953089530,100953089524,-6,916,3419,40
100953538781,100953538796,15,300,1176,40
100955191436,100955191430,-6,1486,5542,40
100962692169,100962692163,-6,862,2623,40
100964739765,100964739759,-6,1080,4208,40
100975106370,100975106366,-4,1095,2991,40
100987767631,100987767626,-5,1133,2860,40
100990350381,100990350373,-8,1150,4704,40
100996818290,100996818283,-7,1225,4391,40
101002703166,101002703159,-7,911,2942,40
101003530854,101003530836,-18,930,4550,40
101004562926,101004562927,1,19,671,40
101006383843,101006383839,-4,887,2647,40
101006435796,101006435794,-2,1338,1715,40
101009538198,101009538193,-5,751,2678,40
101011144757,101011144752,-5,1100,3650,40
101013159141,101013159136,-5,1224,5010,40
101013823214,101013823208,-6,1437,4356,40
101016501176,101016501197,21,711,3132,40
101020433150,101020433144,-6,1297,4780,40
101026248358,101026248353,-5,729,3015,40
101026521598,101026521616,18,769,2658,40
101028371074,101028371065,-9,956,3980,40
101029159399,101029159382,-17,412,1205,40
101030476419,101030476421,2,302,750,40
101035521235,101035521230,-5,1576,4243,40
101036573211,101036573206,-5,1466,3473,40
101036918915,101036918909,-6,782,2061,40
101037041047,101037041041,-6,202,1197,40
101037512495,101037512490,-5,1400,4355,40
101039922351,101039922346,-5,908,2970,40
101043141647,101043141650,3,2361,1383,40
101048107890,101048107882,-8,856,3311,40
101057587705,101057587699,-6,530,2694,40
101073999308,101073999311,3,2608,1829,40
101075578089,101075578082,-7,897,3354,40
101075898125,101075898136,11,581,2203,40
101077110326,101077110321,-5,853,3031,40
101087372462,101087372467,5,2120,996,40
101091119058,101091119053,-5,1025,4155,40
101095364487,101095364480,-7,638,2387,40
101101059701,101101059695,-6,1369,3447,40
101112095440,101112095434,-6,537,2722,40
101112485077,101112485069,-8,1202,3758,40
101113068255,101113068246,-9,261,859,40
101132401133,101132401128,-5,1174,3501,40
101139307702,101139307697,-5,1065,4840,40
101139680880,101139680883,3,183,851,40
101140245318,101140245323,5,2137,1209,40
101147514965,101147514960,-5,1186,3751,40
101160123874,101160123867,-7,879,2831,40
101160201750,101160201739,-11,72,1195,40
101162124614,101162124609,-5,1023,3030,40
101164199527,101164199533,6,7094,2607,40
101170146913,101170146906,-7,732,2928,40
101173648765,101173648761,-4,1202,3152,40
101173855866,101173855861,-5,694,2041,40
101175979241,101175979235,-6,658,2406,40
101178643141,101178643137,-4,684,3224,40
101178865791,101178865791,0,205,781,40
101182396606,101182396598,-8,718,3087,40
101182479094,101182479113,19,311,1824,40
101185855601,101185855596,-5,788,2372,40
101186374406,101186374427,21,798,3575,40
101186874739,101186874733,-6,874,3842,40
101190239589,101190239583,-6,771,3334,40
101191508437,101191508430,-7,1260,4193,40
101191582527,101191582546,19,324,726,40
101203635109,101203635114,5,1707,1199,40
101204032846,101204032838,-8,923,3901,40
101208755942,101208755940,-2,25465,22932,40
101210676181,101210676173,-8,1678,9985,40
101220367450,101220367445,-5,957,3409,40
101220423583,101220423585,2,244,1448,40
101222767426,101222767422,-4,1183,3386,40
101232373506,101232373509,3,2318,2076,40
101233829046,101233829047,1,1133,941,40
101239928754,101239928749,-5,1115,3363,40
101241005842,101241005837,-5,1458,4712,40
101243199962,101243199958,-4,2367,4485,40
101245196052,101245196046,-6,1395,5133,40
101246942371,101246942367,-4,2401,4652,40
101250832974,101250832969,-5,1297,4398,40
101255797640,101255797646,6,1752,989,40
101258839025,101258839020,-5,938,3761,40
101266303870,101266303865,-5,708,4726,40
101266422359,101266422348,-11,892,3673,40
101267367936,101267367950,14,1088,4342,40
101267413573,101267413575,2,83,1068,40
101269509021,101269509015,-6,1017,3851,40
101272900254,101272900249,-5,1392,4735,40
101274966975,101274966970,-5,849,2843,40
101278528098,101278528097,-1,10094,13510,40
101283808094,101283808090,-4,800,3130,40
101292822491,101292822483,-8,916,2808,40
101294322400,101294322405,5,2660,1502,40
101295639852,101295639864,12,389,1252,40
101298903271,101298903266,-5,747,4553,40
101299591612,101299591629,17,903,3211,40
101301846140,101301846133,-7,816,3496,40
101302103206,101302103227,21,310,1016,40
101306024986,101306024985,-1,619,2175,40
101309611618,101309611613,-5,849,4652,40
101309775190,101309775185,-5,1154,4373,40
101311516053,101311516049,-4,1329,3458,40
101311956142,101311956138,-4,104,1187,40
101312940690,101312940685,-5,1057,4255,40
101323357281,101323357274,-7,778,2686,40
101323415286,101323415303,17,160,1106,40
101324128890,101324128885,-5,622,2793,40
101324555965,101324555950,-15,178,1573,40
101332768639,101332768637,-2,2650,3575,40
101334047484,101334047478,-6,971,4565,40
101334870578,101334870570,-8,1508,4362,40
101339803378,101339803371,-7,1086,3330,40
101340680214,101340680207,-7,677,2468,40
101340782239,101340782259,20,380,1021,40
101343745023,101343745014,-9,1001,4327,40
101354330630,101354330625,-5,1206,3021,40
101362707592,101362707585,-7,816,3609,40
101363482384,101363482395,11,63,955,40
101366876214,101366876213,-1,1004,1418,40
101366935088,101366935065,-23,50,1317,40
101367881921,101367881916,-5,898,1936,40
101369204226,101369204211,-15,28,513,40
101373350427,101373350422,-5,904,2628,40
101390425387,101390425382,-5,887,3081,40
101391030706,101391030700,-6,1013,4915,40
101402399802,101402399798,-4,1080,3587,40
101402723006,101402723003,-3,226,775,40
101405214353,101405214349,-4,695,3321,40
101407096935,101407096930,-5,768,3719,40
101407486478,101407486490,12,112,1731,40
101407949058,101407949051,-7,731,3226,40
101408674030,101408674024,-6,1528,4280,40
101414278798,101414278791,-7,819,2876,40
101414394790,101414394793,3,214,1063,40
101416733237,101416733230,-7,1116,4843,40
101423336793,101423336786,-7,903,2353,40
101423471599,101423471583,-16,175,631,40
101426822087,101426822082,-5,972,3570,40
101427325700,101427325687,-13,5,671,40
101437299763,101437299758,-5,814,2581,40
101440193291,101440193285,-6,967,3030,40
101443754763,101443754755,-8,739,4440,40
101448868373,101448868369,-4,1043,3689,40
101450036493,101450036488,-5,1023,2978,40
101450260251,101450260242,-9,708,2192,40
101453359135,101453359128,-7,786,4242,40
101454390920,101454390939,19,568,4179,40
101456932916,101456932910,-6,785,3722,40
101457397535,101457397513,-22,1653,746,40
101461276706,101461276699,-7,1274,2845,40
101464435154,101464435152,-2,1213,2452,40
101466050106,101466050101,-5,698,3919,40
101466975324,101466975313,-11,163,3686,40
101470161341,101470161343,2,2312,12359,40
101471027583,101471027584,1,730,505,40
101472803114,101472803106,-8,1309,4562,40
101486698063,101486698057,-6,1043,4753,40
101488975882,101488975878,-4,1251,2859,40
101490744895,101490744914,19,243,1128,40
101492574221,101492574218,-3,1507,2242,40
101492701325,101492701320,-5,794,2229,40
101497099950,101497099945,-5,1205,3413,40
101497450855,101497450836,-19,1359,4534,40
101500740394,101500740392,-2,984,2703,40
101500896991,101500896999,8,311,1006,40
101504380423,101504380420,-3,584,1152,40
101508341375,101508341382,7,2924,1566,40
101510455194,101510455187,-7,956,3816,40
101511345390,101511345383,-7,932,4882,40
101517040391,101517040399,8,10011,21335,40
101520491655,101520491650,-5,856,3185,40
101521434544,101521434550,6,16,1149,40
101524345931,101524345927,-4,1003,2880,40
101525365811,101525365817,6,4113,1544,40
101525418563,101525418560,-3,30314,24843,40
101534072733,101534072739,6,2070,1168,40
101534113107,101534113112,5,1189,1018,40
101537230010,101537230009,-1,836,1734,40
101539997193,101539997187,-6,917,1709,40
101543592642,101543592634,-8,1255,4644,40
101543958324,101543958314,-10,189,1780,40
101545236059,101545236053,-6,732,2907,40
101545682286,101545682303,17,319,1578,40
101552314255,101552314253,-2,925,1562,40
101559535873,101559535874,1,2128,2578,40
101571523792,101571523785,-7,1156,4792,40
101572123690,101572123685,-5,1179,2711,40
101572384686,101572384674,-12,181,1209,40
101574538709,101574538704,-5,959,3098,40
101575795618,101575795613,-5,1788,3336,40
101576360917,101576360922,5,2654,1884,40
101578811381,101578811377,-4,933,3762,40
101579408374,101579408369,-5,723,3050,40
101583201550,101583201545,-5,1268,2548,40
101584220091,101584220083,-8,817,3186,40
101584372847,101584372845,-2,167,1195,40
101589474877,101589474871,-6,800,1971,40
101590849734,101590849726,-8,1075,4182,40
101591076892,101591076886,-6,290,812,40
101603697877,101603697875,-2,747,1986,40
101605750670,101605750675,5,3538,2387,40
101609151548,101609151570,22,222,2223,40
101618190419,101618190414,-5,1268,4648,40
101623269591,101623269586,-5,1098,4096,40
101623442078,101623442091,13,206,1717,40
101624627566,101624627586,20,895,2659,40
101629773635,101629773630,-5,864,3760,40
101630122376,101630122387,11,246,1101,40
101636951818,101636951810,-8,508,3351,40
101640557499,101640557496,-3,866,2194,40
101642083791,101642083783,-8,757,3614,40
101644308826,101644308828,2,2167,2248,40
101644874809,101644874802,-7,1258,4018,40
101644940253,101644940238,-15,999,4676,40
101646811514,101646811517,3,1246,1000,40
101653827695,101653827689,-6,791,4334,40
101665283664,101665283658,-6,860,4506,40
101673940817,101673940810,-7,1514,5371,40
101674175463,101674175443,-20,1569,3405,40
101674531116,101674531111,-5,206,924,40
101675560454,101675560448,-6,820,2964,40
101678715950,101678715943,-7,1059,2956,40
101690532543,101690532538,-5,848,3766,40
101691051014,101691051027,13,312,1849,40
101698226542,101698226545,3,2849,2208,40
101698574143,101698574136,-7,740,3518,40
101700060295,101700060290,-5,259,1327,40
101704823817,101704823810,-7,911,4673,40
101705571389,101705571374,-15,119,606,40
101714518423,101714518417,-6,682,3386,40
101714634558,101714634573,15,855,2924,40
101714980538,101714980533,-5,629,4711,40
101715252096,101715252107,11,8,1288,40
101715305454,101715305448,-6,755,3316,40
101715572372,101715572365,-7,1598,4183,40
101716758751,101716758757,6,11973,5705,40
101722756597,101722756591,-6,939,3918,40
101723609293,101723609313,20,696,2293,40
101724184355,101724184350,-5,868,3999,40
101725300955,101725300949,-6,927,3790,40
101725531255,101725531272,17,495,1552,40
101727900351,101727900345,-6,1041,3287,40
101727938247,101727938254,7,231,1217,40
101732968579,101732968574,-5,1067,4038,40
101737700726,101737700721,-5,931,4033,40
101745154690,101745154694,4,1861,1323,40
101745723410,101745723405,-5,940,3876,40
101748698786,101748698793,7,3138,1648,40
101757035786,101757035781,-5,1111,3610,40
101770250843,101770250828,-15,25614,107743,40
101773456114,101773456110,-4,649,1851,40
101773545461,101773545455,-6,1375,3963,40
101779062565,101779062561,-4,1266,3279,40
101783134673,101783134671,-2,1355,2092,40
101785825087,101785825081,-6,1008,2886,40
101786026249,101786026254,5,5512,2621,40
101788825767,101788825762,-5,969,3917,40
101793475383,101793475377,-6,1036,3648,40
101798915683,101798915676,-7,944,3824,40
101798989478,101798989465,-13,337,2584,40
101811579396,101811579392,-4,774,1470,40
101812549493,101812549486,-7,1256,4432,40
101817945132,101817945127,-5,1173,3516,40
101818254280,101818254259,-21,224,1003,40
101819985853,101819985865,12,257,1162,40
101824391509,101824391505,-4,1193,3066,40
101826474574,101826474568,-6,845,2959,40
101829683650,101829683642,-8,963,3961,40
101834442785,101834442783,-2,836,2246,40
101835222903,101835222899,-4,171,1589,40
101835430958,101835430944,-14,41,1417,40
101836253005,101836253026,21,260,1204,40
101836837546,101836837542,-4,1099,4356,40
101838646221,101838646217,-4,775,3368,40
101838960600,101838960612,12,886,2676,40
101843665851,101843665846,-5,1226,4083,40
101844569298,101844569293,-5,1324,2973,40
101856925472,101856925466,-6,1002,3970,40
101857435967,101857435962,-5,904,3948,40
101860427966,101860427945,-21,1327,549,40
101861356391,101861356386,-5,773,3846,40
101862307480,101862307474,-6,1130,4343,40
101865044942,101865044935,-7,602,1998,40
101869074193,101869074197,4,1235,1527,40
101869313885,101869313906,21,1,868,40
101884532610,101884532610,0,1047,2133,40
101886728198,101886728194,-4,940,2953,40
101888896964,101888896958,-6,1064,3295,40
101889769773,101889769765,-8,595,2659,40
101890349252,101890349274,22,596,1373,40
101892678994,101892679000,6,3106,1501,40
101907192287,101907192281,-6,591,3537,40
101910082166,101910082163,-3,1276,3672,40
101917074472,101917074468,-4,895,3465,40
101917572502,101917572497,-5,840,3476,40
101926473570,101926473564,-6,870,3961,40
101926560138,101926560132,-6,1184,4343,40
101934136290,101934136283,-7,677,3195,40
101947391023,101947391029,6,4478,1582,40
101954516180,101954516175,-5,1181,2831,40
101959627263,101959627257,-6,543,2102,40
101965845270,101965845254,-16,1158,4260,40
101969090990,101969090983,-7,693,3730,40
101976577803,101976577798,-5,1132,2404,40
101979377282,101979377287,5,889,763,40
101983150415,101983150410,-5,911,3222,40
101983364375,101983364370,-5,870,3583,40
101992996840,101992996833,-7,1096,2969,40
102000040966,102000040971,5,2796,2110,40
102005246221,102005246216,-5,1122,4006,40
102006778023,102006778018,-5,944,3666,40
102006952045,102006952050,5,238,1442,40
102007565894,102007565874,-20,141,868,40
102015074637,102015074633,-4,717,3049,40
102016569092,102016569085,-7,694,2706,40
102023226343,102023226337,-6,902,2340,40
102024745305,102024745299,-6,902,3213,40
102024828991,102024828985,-6,821,3032,40
102025796788,102025796770,-18,1113,4021,40
102027217326,102027217307,-19,1225,2757,40
102041072170,102041072164,-6,865,3763,40
102041290114,102041290109,-5,812,3457,40
102042576050,102042576056,6,5774,2731,40
102045429905,102045429899,-6,895,4838,40
102045636470,102045636483,13,177,637,40
102049829342,102049829324,-18,263,749,40
102055147406,102055147410,4,2071,1626,40
102057050818,102057050837,19,513,3366,40
102059601514,102059601510,-4,890,2568,40
102060264140,102060264135,-5,1045,3059,40
102061029546,102061029545,-1,47534,23320,40
102062642321,102062642316,-5,394,4560,40
102063851230,102063851222,-8,1442,4784,40
102064627037,102064627033,-4,974,2595,40
102066375100,102066375098,-2,1758,3697,40
102066678998,102066678999,1,1003,1461,40
102067181569,102067181563,-6,501,2335,40
102067525509,102067525507,-2,105,987,40
102067985518,102067985518,0,390,1239,40
102085129643,102085129646,3,1069,1056,40
102091612970,102091612964,-6,1006,4686,40
102093101962,102093101957,-5,1177,4638,40
102097197911,102097197909,-2,757,1707,40
102098456911,102098456905,-6,706,4600,40
102099916365,102099916358,-7,1144,4313,40
102100271302,102100271305,3,186,1049,40
102102132202,102102132205,3,2849,2637,40
102104367182,102104367178,-4,975,3175,40
102105184442,102105184443,1,17787,19323,40
102107758150,102107758145,-5,968,3018,40
102108428542,102108428526,-16,149,1197,40
102109376777,102109376770,-7,918,3715,40
102113370389,102113370395,6,2266,1194,40
102114822505,102114822499,-6,1205,4697,40
102118184777,102118184780,3,1528,1298,40
102124514564,102124514561,-3,1198,4423,40
102133507826,102133507821,-5,1191,5311,40
102139551876,102139551874,-2,1050,2100,40
102142184963,102142184957,-6,715,2265,40
102142302292,102142302313,21,775,3302,40
102143291294,102143291289,-5,1243,3176,40
102147705674,102147705673,-1,2913,4492,40
102150788650,102150788645,-5,788,3120,40
102151263006,102151262988,-18,253,621,40
102155964767,102155964762,-5,1247,3115,40
102159711330,102159711324,-6,763,3117,40
102160300980,102160300969,-11,269,1632,40
102161879262,102161879257,-5,1396,3705,40
102164220918,102164220910,-8,594,3464,40
102166897485,102166897491,6,6109,1517,40
102168214015,102168214014,-1,1096,2353,40
102186481870,102186481870,0,1020,1788,40
102190224860,102190224853,-7,1149,3327,40
102193952265,102193952270,5,1949,1121,40
102199760532,102199760529,-3,1313,2729,40
102201047898,102201047893,-5,1147,3746,40
102210179165,102210179161,-4,717,2773,40
102210244822,102210244816,-6,714,3529,40
102211157238,102211157233,-5,982,3846,40
102212170693,102212170699,6,1899,1299,40
102219256285,102219256281,-4,947,4205,40
102222925131,102222925125,-6,941,4368,40
102225133941,102225133942,1,1828,1805,40
102231677313,102231677309,-4,1069,3938,40
102234663225,102234663219,-6,956,3435,40
102237418564,102237418558,-6,823,3383,40
102242386558,102242386551,-7,968,3331,40
102242512966,102242512947,-19,819,2036,40
102243241628,102243241647,19,742,2436,40
102250652695,102250652689,-6,1080,4349,40
102251734493,102251734507,14,228,1249,40
102261475095,102261475088,-7,870,2828,40
102261519038,102261519052,14,964,2751,40
102264383723,102264383721,-2,863,1463,40
102269271910,102269271905,-5,853,2178,40
102276692061,102276692046,-15,379,1204,40
102277893985,102277893978,-7,1119,3651,40
102278210088,102278210094,6,124,845,40
102281296050,102281296042,-8,1127,6314,40
102281732059,102281732046,-13,4570,1219,40
102283424077,102283424070,-7,1119,4036,40
102284695209,102284695212,3,3291,2403,40
102285525492,102285525488,-4,1123,3480,40
102286731277,102286731265,-12,168,1350,40
102290667728,102290667730,2,3272,2321,40
102300071342,102300071338,-4,1225,3088,40
102301408212,102301408235,23,641,2516,40
102306394377,102306394370,-7,1291,3616,40
102316523788,102316523794,6,80561,34010,40
102320191890,102320191882,-8,1106,3729,40
102330407759,102330407754,-5,1187,2604,40
102332780381,102332780374,-7,1205,3422,40
102335634106,102335634105,-1,31132,18705,40
102335976461,102335976455,-6,1275,5905,40
102340037310,102340037303,-7,941,3245,40
102340441588,102340441590,2,186,1359,40
102344402987,102344402982,-5,1078,2951,40
102352280659,102352280654,-5,1328,3697,40
102364952434,102364952442,8,3644,1538,40
102365716938,102365716931,-7,1105,3963,40
102366575624,102366575630,6,3304,1263,40
102371065862,102371065862,0,1502,2359,40
102374450508,102374450502,-6,1718,4347,40
102377842239,102377842231,-8,707,3603,40
102378935851,102378935846,-5,1457,5251,40
102381935885,102381935889,4,354,971,40
102391365987,102391365982,-5,1057,4341,40
102393632618,102393632613,-5,973,3527,40
102398571302,102398571297,-5,36215,14204,40
102407003621,102407003614,-7,1277,10323,40
102414192798,102414192800,2,1741,1553,40
102415096605,102415096605,0,1200,1089,40
102415817690,102415817687,-3,1096,5143,40
102416134031,102416134038,7,57,1043,40
102418347390,102418347383,-7,882,2957,40
102422481015,102422481018,3,1471,965,40
102425797191,102425797185,-6,1071,3268,40
102432574787,102432574780,-7,747,1701,40
102433515064,102433515060,-4,4624,12922,40
102439562455,102439562450,-5,1209,3559,40
102439751227,102439751223,-4,1139,3144,40
102439800064,102439800079,15,728,2048,40
102451166612,102451166635,23,15093,43014,40
102451826758,102451826751,-7,980,3722,40
102458489827,102458489834,7,3440,1528,40
102460178673,102460178667,-6,504,2119,40
102464169287,102464169280,-7,786,3446,40
102485231774,102485231777,3,974,1624,40
102489018661,102489018656,-5,1231,3025,40
102490297923,102490297918,-5,1042,3460,40
102492890791,102492890785,-6,889,2735,40
102495421665,102495421673,8,65868,6513,40
102506677494,102506677489,-5,956,4411,40
102511373609,102511373615,6,5164,2331,40
102514239913,102514239908,-5,580,3339,40
102515302082,102515302077,-5,953,4675,40
102515938632,102515938646,14,414,1236,40
102518312526,102518312524,-2,1182,1976,40
102519757555,102519757555,0,110,1233,40
102523505117,102523505111,-6,1198,4594,40
102524518511,102524518506,-5,1433,3966,40
102525835408,102525835403,-5,704,3129,40
102530253650,102530253643,-7,839,4166,40
102535674362,102535674356,-6,1153,3171,40
102543523513,102543523508,-5,1198,2498,40
102546004080,102546004085,5,2235,1407,40
102546526148,102546526154,6,3413,1693,40
102562181542,102562181534,-8,754,4200,40
102562569070,102562569071,1,64,793,40
102563823123,102563823118,-5,974,3567,40
102565472642,102565472632,-10,1203,4794,40
102567956835,102567956829,-6,787,3161,40
102582670389,102582670382,-7,1290,2908,40
102583429583,102583429567,-16,211,1520,40
102598967791,102598967786,-5,550,1808,40
102614013633,102614013632,-1,2635,4087,40
102623319595,102623319590,-5,1247,5089,40
102623631990,102623631983,-7,1312,5992,40
102623720823,102623720828,5,2807,950,40
102624606153,102624606173,20,847,3566,40
102631151446,102631151441,-5,806,3357,40
102633436713,102633436719,6,3024,1735,40
102643340815,102643340812,-3,564,3086,40
102643646980,102643646995,15,846,2839,40
102648237262,102648237257,-5,1529,3688,40
102650020092,102650020085,-7,829,4845,40
102651131367,102651131385,18,870,5270,40
102667095846,102667095846,0,1866,3367,40
102681814245,102681814247,2,2072,1580,40
102688012662,102688012657,-5,1286,7495,40
102689237622,102689237616,-6,1120,4220,40
102691691558,102691691553,-5,952,2815,40
102694008405,102694008399,-6,1320,4620,40
102696664167,102696664161,-6,1065,3724,40
102702710986,102702711007,21,263,972,40
102703415698,102703415703,5,3399,1944,40
102705869161,102705869158,-3,878,2710,40
102707317925,102707317922,-3,875,1616,40
102712406796,102712406791,-5,909,4833,40
102719797744,102719797738,-6,734,2846,40
102719993030,102719993025,-5,164,947,40
102723207346,102723207338,-8,917,4208,40
102730386118,102730386111,-7,1396,4906,40
102731124718,102731124734,16,1208,4469,40
102731566153,102731566146,-7,754,2535,40
102733617159,102733617154,-5,1049,3761,40
102733907533,102733907553,20,395,2493,40
102736159583,102736159578,-5,884,3968,40
102746667941,102746667935,-6,941,2836,40
102749893518,102749893514,-4,1078,2553,40
102755534402,102755534395,-7,938,3981,40
102755769957,102755769969,12,319,1189,40
102757956604,102757956600,-4,1530,2417,40
102757999070,102757999066,-4,915,3303,40
102760179457,102760179451,-6,1121,3958,40
102761010310,102761010318,8,239,1462,40
102770598396,102770598399,3,1625,1355,40
102787124575,102787124570,-5,915,2644,40
102792296933,102792296929,-4,809,2101,40
102796868027,102796868020,-7,1108,4143,40
102796945710,102796945695,-15,283,1186,40
102797477045,102797477026,-19,317,1543,40
102806560406,102806560396,-10,8694,14366,40
102821306707,102821306701,-6,1201,3219,40
102824044670,102824044662,-8,878,3197,40
102824687228,102824687240,12,1070,3309,40
102826448597,102826448591,-6,1215,2916,40
102827191409,102827191402,-7,1122,3090,40
102828066599,102828066603,4,2072,1743,40
102829929916,102829929911,-5,1463,3767,40
102830711097,102830711090,-7,826,2887,40
102831323354,102831323349,-5,817,5019,40
102831354237,102831354247,10,14,959,40
102831891246,102831891241,-5,1153,3210,40
102832010525,102832010519,-6,833,3747,40
102838550182,102838550176,-6,662,6022,40
102851668086,102851668087,1,1328,1008,40
102852718376,102852718370,-6,1138,4607,40
102853581101,102853581086,-15,1202,3535,40
102854298694,102854298689,-5,1361,3664,40
102861957321,102861957328,7,3532,1634,40
102863536415,102863536409,-6,1048,4512,40
102865141351,102865141355,4,2001,1490,40
102869524486,102869524479,-7,834,3234,40
102888298086,102888298084,-2,943,2214,40
102889013159,102889013157,-2,36609,24172,40
102895004471,102895004465,-6,677,3077,40
102907574086,102907574081,-5,907,3569,40
102908651473,102908651468,-5,1140,4456,40
102915987329,102915987334,5,7004,2441,40
102921341850,102921341845,-5,662,3097,40
102928922176,102928922170,-6,1187,4994,40
102938186851,102938186844,-7,987,3690,40
102939060895,102939060898,3,2708,1856,40
102942292610,102942292605,-5,986,4259,40
102942461540,102942461559,19,86,710,40
102942816039,102942816034,-5,698,3368,40
102950689118,102950689135,17,341,994,40
102955304844,102955304846,2,1536,1643,40
102957348260,102957348253,-7,1062,4528,40
102960417973,102960417968,-5,719,3436,40
102965708524,102965708536,12,12689,39176,40
102972629694,102972629690,-4,1085,3446,40
102979689297,102979689289,-8,1175,4091,40
102979773319,102979773334,15,342,1398,40
102985912107,102985912102,-5,1087,3653,40
102992990243,102992990238,-5,1084,3715,40
102994813689,102994813684,-5,713,3240,40
102995119525,102995119518,-7,924,3359,40
102996472690,102996472685,-5,1199,3977,40
102998539057,102998539049,-8,1145,4020,40
102999576294,102999576287,-7,1305,3918,40
103002258905,103002258900,-5,1071,3127,40
103005722318,103005722310,-8,1222,3738,40
103008030567,103008030569,2,2012,2027,40
103011078078,103011078081,3,1294,1313,40
103012434884,103012434877,-7,1175,2995,40
103012608140,103012608134,-6,997,3227,40
103013641175,103013641152,-23,890,4063,40
103017222375,103017222369,-6,946,3023,40
103017865879,103017865873,-6,779,4387,40
103018695786,103018695781,-5,960,3185,40
103018800396,103018800407,11,430,1274,40
103023449286,103023449280,-6,1345,4257,40
103028657179,103028657174,-5,662,3661,40
103031036007,103031036010,3,3076,2355,40
103034668499,103034668498,-1,1278,2128,40
103047671577,103047671579,2,1242,1638,40
103048181596,103048181592,-4,137,1405,40
103048618139,103048618138,-1,9522,14703,40
103051781102,103051781096,-6,1372,4722,40
103052390113,103052390106,-7,1005,3097,40
103053579398,103053579393,-5,1441,3444,40
103054005519,103054005506,-13,1213,4558,40
103054376150,103054376170,20,742,3750,40
103057720231,103057720225,-6,737,3136,40
103071143625,103071143628,3,1506,1560,40
103077070475,103077070470,-5,493,2434,40
103080205705,103080205698,-7,925,3343,40
103082182051,103082182045,-6,1115,6024,40
103085667324,103085667329,5,1473,771,40
103095585969,103095585962,-7,1089,6827,40
103096883135,103096883129,-6,1107,3821,40
103100498401,103100498394,-7,1010,3583,40
103100750565,103100750553,-12,1,884,40
103106469131,103106469125,-6,925,2716,40
103111857553,103111857549,-4,606,2019,40
103119105702,103119105705,3,1949,1108,40
103125880875,103125880879,4,2324,1621,40
103128711386,103128711382,-4,1028,3064,40
103129533168,103129533184,16,187,1330,40
103130379519,103130379514,-5,631,2715,40
103130970806,103130970827,21,177,1171,40
103134653611,103134653606,-5,913,2834,40
103137427574,103137427569,-5,763,3250,40
103140358811,103140358802,-9,788,3990,40
103142960763,103142960757,-6,1272,5249,40
103154042658,103154042653,-5,1143,4134,40
103163550924,103163550919,-5,1057,3617,40
103163779354,103163779350,-4,589,2236,40
103165496574,103165496569,-5,731,3117,40
103170230184,103170230184,0,1353,2034,40
103171058975,103171058955,-20,83,1330,40
103172587509,103172587502,-7,181,1177,40
103173965791,103173965782,-9,1080,3336,40
103175457984,103175457977,-7,2266,10808,40
103177667540,103177667534,-6,666,3840,40
103190699850,103190699843,-7,796,3462,40
103190917837,103190917851,14,472,1567,40
103196856005,103196856004,-1,1625,1894,40
103202079252,103202079256,4,1433,1621,40
103203140765,103203140759,-6,1231,4042,40
103204692514,103204692509,-5,934,3156,40
103204930518,103204930504,-14,87,2295,40
103204985178,103204985171,-7,528,867,40
103205318955,103205318950,-5,1118,3081,40
103206903359,103206903342,-17,114,929,40
103208837840,103208837834,-6,1288,4879,40
103211219507,103211219503,-4,943,2474,40
103213934514,103213934514,0,1682,1085,40
103220345626,103220345622,-4,1427,3973,40
103228131713,103228131705,-8,719,258,40
103229169773,103229169769,-4,678,2407,40
103231823413,103231823409,-4,840,2812,40
103232201366,103232201362,-4,658,2042,40
103242932462,103242932462,0,1246,2247,40
103252693174,103252693170,-4,1172,3672,40
103256457118,103256457112,-6,1295,3296,40
103258628947,103258628945,-2,1329,3000,40
103259937319,103259937313,-6,1338,3495,40
103260374914,103260374909,-5,1007,2671,40
103264507922,103264507916,-6,853,3617,40
103264951239,103264951234,-5,985,4201,40
103269863791,103269863786,-5,789,3419,40
103272162139,103272162132,-7,754,3623,40
103274134013,103274134006,-7,1123,4449,40
103277954862,103277954855,-7,694,3913,40
103282516288,103282516285,-3,2035,2216,40
103302801230,103302801233,3,1387,993,40
103306940195,103306940189,-6,1054,3139,40
103312957933,103312957930,-3,1231,2977,40
103324276704,103324276698,-6,798,4042,40
103325011515,103325011510,-5,1202,3122,40
103325892503,103325892494,-9,990,3426,40
103351565365,103351565358,-7,1254,4064,40
103351803567,103351803579,12,497,846,40
103354986241,103354986246,5,5526,2718,40
103357387162,103357387157,-5,1096,3445,40
103360702948,103360702949,1,2178,2169,40
103363161262,103363161257,-5,938,3824,40
103363429316,103363429337,21,776,3487,40
103365435247,103365435241,-6,1413,4412,40
103367123623,103367123621,-2,997,2137,40
103367670645,103367670641,-4,1189,3885,40
103367860895,103367860887,-8,31,1574,40
103368706821,103368706839,18,319,1873,40
103375350221,103375350215,-6,1199,3742,40
103377651282,103377651276,-6,1703,3752,40
103379724413,103379724420,7,1599,1397,40
103385278475,103385278469,-6,1215,3883,40
103386058303,103386058302,-1,918,1880,40
103386192831,103386192827,-4,1120,2664,40
103390723474,103390723469,-5,1688,4078,40
103390954002,103390953998,-4,1377,3295,40
103391210200,103391210217,17,98,1758,40
103416640026,103416640022,-4,1378,3749,40
103419990023,103419990027,4,3100,2079,40
103425387178,103425387173,-5,935,2285,40
103430062990,103430062986,-4,1030,3016,40
103434251883,103434251877,-6,809,3274,40
103442954865,103442954858,-7,911,2913,40
103448290263,103448290257,-6,953,2802,40
103453697875,103453697871,-4,1042,2910,40
103458480030,103458480026,-4,826,2894,40
103482906857,103482906852,-5,965,4230,40
103483639167,103483639145,-22,125,1338,40
103487193751,103487193745,-6,668,2995,40
103487773855,103487773875,20,374,1000,40
103492301232,103492301226,-6,2284,4899,40
103495243043,103495243036,-7,881,3217,40
103495338004,103495337993,-11,1005,3621,40
103496063771,103496063763,-8,1140,3322,40
103496946798,103496946793,-5,1204,3434,40
103500702023,103500702030,7,2907,1389,40
103503880935,103503880929,-6,705,3130,40
103506189622,103506189614,-8,975,4067,40
103506259200,103506259210,10,48,1045,40
103508153221,103508153219,-2,2868,4395,40
103511807447,103511807441,-6,2068,6409,40
103512592551,103512592545,-6,786,3644,40
103515602345,103515602339,-6,729,2846,40
103516267817,103516267811,-6,954,2781,40
103516470061,103516470054,-7,91,1307,40
103516911878,103516911883,5,440,1117,40
103517994105,103517994098,-7,786,2883,40
103519074893,103519074893,0,35056,46628,40
103522824528,103522824522,-6,916,4096,40
103526579458,103526579453,-5,1328,3104,40
103527319543,103527319557,14,897,4187,40
103531168054,103531168053,-1,1435,2036,40
103531703716,103531703710,-6,1061,4072,40
103532337003,103532336998,-5,771,2333,40
103533266590,103533266611,21,580,1548,40
103534379702,103534379695,-7,881,3274,40
103538785591,103538785589,-2,1606,2354,40
103543813383,103543813390,7,2700,836,40
103551987107,103551987108,1,1400,1298,40
103552592627,103552592620,-7,1062,4104,40
103553161106,103553161102,-4,1224,4369,40
103554151173,103554151166,-7,1198,3253,40
103556518741,103556518737,-4,1063,2945,40
103556550253,103556550274,21,226,1160,40
103557728286,103557728292,6,12049,19521,40
103565682498,103565682491,-7,897,2676,40
103565946134,103565946126,-8,228,859,40
103569510070,103569510066,-4,774,2988,40
103572485934,103572485930,-4,754,2895,40
103572858486,103572858504,18,239,1339,40
103574380522,103574380522,0,1113,2111,40
103585640405,103585640398,-7,790,3264,40
103586327119,103586327114,-5,909,3666,40
103590971890,103590971897,7,4132,2631,40
103592093558,103592093551,-7,1241,978,40
103595675972,103595675964,-8,886,2648,40
103596113565,103596113561,-4,1420,4022,40
103603618279,103603618278,-1,10551,13607,40
103610830239,103610830233,-6,1242,4062,40
103613345633,103613345626,-7,709,2716,40
103614709077,103614709072,-5,1478,3927,40
103621661351,103621661346,-5,761,2896,40
103623466154,103623466148,-6,1164,3359,40
103623496558,103623496542,-16,1673,1877,40
103624227142,103624227157,15,842,2862,40
103624264526,103624264539,13,124,1208,40
103624865425,103624865419,-6,1078,2657,40
103625509850,103625509845,-5,885,3700,40
103625765853,103625765870,17,988,3313,40
103628401397,103628401392,-5,1062,3381,40
103628780672,103628780682,10,410,1012,40
103629511991,103629511986,-5,1063,3955,40
103632821971,103632821965,-6,325,2102,40
103634346973,103634346967,-6,947,2842,40
103634429606,103634429598,-8,720,2846,40
103646921127,103646921122,-5,1223,1892,40
103647093519,103647093514,-5,1061,2716,40
103650410109,103650410104,-5,959,3161,40
103652743364,103652743360,-4,1198,4318,40
103654786386,103654786382,-4,842,3059,40
103654988918,103654988934,16,911,2229,40
103658373460,103658373454,-6,1227,3463,40
103672132058,103672132054,-4,1096,2105,40
103678179850,103678179844,-6,1023,4392,40
103682206398,103682206404,6,4320,2074,40
103685107447,103685107442,-5,381,3888,40
103685468634,103685468629,-5,1100,4055,40
103686407647,103686407641,-6,1440,4605,40
103689328621,103689328618,-3,818,2666,40
103692791583,103692791578,-5,1399,3755,40
103697510195,103697510189,-6,926,4926,40
103699041067,103699041061,-6,983,2787,40
103705970285,103705970290,5,2365,1196,40
103712120022,103712120024,2,3355,2827,40
103727241030,103727241023,-7,823,4080,40
103728729791,103728729785,-6,847,3644,40
103729121351,103729121362,11,827,3248,40
103729880298,103729880293,-5,2377,7464,40
103736752560,103736752554,-6,967,4465,40
103737855043,103737855037,-6,821,3698,40
103737894708,103737894721,13,84,874,40
103737969860,103737969842,-18,228,1214,40
103740791850,103740791843,-7,838,6456,40
103740896604,103740896614,10,237,1014,40
103744847478,103744847474,-4,1114,4364,40
103745433869,103745433865,-4,1075,3751,40
103750189663,103750189656,-7,990,3682,40
103751771808,103751771801,-7,1096,3939,40
103757303002,103757303006,4,1184,943,40
103758094726,103758094722,-4,987,3609,40
103758822830,103758822828,-2,2077,4799,40
103764583603,103764583598,-5,1008,2849,40
103767262589,103767262585,-4,1218,3953,40
103770021579,103770021573,-6,879,4075,40
103770964279,103770964272,-7,952,3614,40
103773085407,103773085401,-6,1113,4837,40
103774034531,103774034527,-4,1317,3248,40
103778002931,103778002923,-8,888,3079,40
103778625844,103778625825,-19,374,1528,40
103781575931,103781575925,-6,882,2937,40
103784694584,103784694578,-6,1129,4764,40
103784946218,103784946220,2,6925,32815,40
103786848217,103786848213,-4,873,3224,40
103796459231,103796459226,-5,838,3103,40
103798083117,103798083111,-6,906,4487,40
103798676038,103798676021,-17,325,1002,40
103802634349,103802634340,-9,1367,381,40
103804294366,103804294362,-4,735,3466,40
103808742522,103808742516,-6,728,2872,40
103809633696,103809633690,-6,1365,4597,40
103814870386,103814870378,-8,519,2712,40
103815237125,103815237141,16,764,2806,40
103822390382,103822390378,-4,1333,3197,40
103824609954,103824609962,8,3037,925,40
103827631464,103827631448,-16,45603,14716,40
103830570097,103830570091,-6,744,3128,40
103833549307,103833549304,-3,857,3601,40
103842187943,103842187938,-5,715,3599,40
103846702547,103846702543,-4,1267,4508,40
103847473792,103847473787,-5,957,2779,40
103853225763,103853225758,-5,761,3117,40
103853335654,103853335647,-7,642,1711,40
103853367645,103853367662,17,304,1114,40
103856554190,103856554185,-5,915,1178,40
103860017042,103860017038,-4,1052,4680,40
103864328101,103864328094,-7,1272,4670,40
103865813165,103865813161,-4,1339,3407,40
103867070902,103867070895,-7,705,2496,40
103868161202,103868161195,-7,475,1449,40
103871905006,103871904999,-7,1063,5084,40
103872285207,103872285201,-6,859,2556,40
103872635039,103872635033,-6,800,4152,40
103873189174,103873189186,12,183,979,40
103876786958,103876786950,-8,1074,4990,40
103877014687,103877014682,-5,1182,5020,40
103877773447,103877773450,3,236,1013,40
103877986101,103877986095,-6,825,3835,40
103880147986,103880147982,-4,1092,2772,40
103880358121,103880358114,-7,864,3947,40
103880744733,103880744754,21,692,2950,40
103888209061,103888209054,-7,1125,7887,40
103897812174,103897812169,-5,1224,5082,40
103898878991,103898878991,0,661,1752,40
103900877495,103900877490,-5,772,4202,40
103901205438,103901205432,-6,1274,4104,40
103901494566,103901494564,-2,138,913,40
103903813299,103903813292,-7,1049,3787,40
103911715975,103911715969,-6,694,5054,40
103911851549,103911851568,19,1074,4347,40
103915856483,103915856477,-6,2073,7668,40
103917911677,103917911670,-7,1023,2743,40
103918062711,103918062717,6,284,1514,40
103918501605,103918501622,17,748,3636,40
103919754517,103919754522,5,3116,1038,40
103931504754,103931504749,-5,703,3380,40
103931565494,103931565507,13,986,3887,40
103932886959,103932886953,-6,970,2680,40
103944752365,103944752370,5,5155,1714,40
103948402395,103948402389,-6,1068,3652,40
103951649667,103951649661,-6,891,3114,40
103954060131,103954060126,-5,740,2507,40
103955572894,103955572886,-8,1087,3082,40
103958491510,103958491504,-6,1170,4044,40
103958626276,103958626270,-6,544,2745,40
103961554758,103961554753,-5,922,5150,40
103969792522,103969792516,-6,892,3719,40
103969993291,103969993285,-6,633,2439,40
103979564640,103979564638,-2,1093,1831,40
103980363092,103980363103,11,92,892,40
103984378822,103984378827,5,4104,2797,40
103985504840,103985504851,11,10773,40265,40
103993831710,103993831705,-5,217,1194,40
104000879194,104000879197,3,1963,1827,40
104019388746,104019388741,-5,514,2659,40
104033936696,104033936690,-6,1162,4013,40
104034039065,104034039061,-4,438,3496,40
104037167779,104037167773,-6,760,3384,40
104044020367,104044020359,-8,991,4704,40
104044250418,104044250412,-6,25831,13490,40
104046647804,104046647798,-6,1010,3418,40
104046765431,104046765419,-12,1085,4030,40
104051476174,104051476169,-5,978,3389,40
104064817646,104064817641,-5,940,3372,40
104065304577,104065304570,-7,1183,4486,40
104074316009,104074316003,-6,1007,3670,40
104079069738,104079069731,-7,1194,4538,40
104079919788,104079919806,18,570,2005,40
104080305343,104080305337,-6,794,2808,40
104081755340,104081755342,2,1601,1587,40
104082631020,104082631014,-6,1638,3730,40
104091501914,104091501906,-8,1145,4196,40
104103660651,104103660644,-7,1237,4152,40
104110555201,104110555194,-7,1222,3988,40
104110864126,104110864124,-2,1257,2480,40
104116929126,104116929121,-5,977,4032,40
104118546327,104118546321,-6,882,2995,40
104124297650,104124297645,-5,930,3263,40
104129129002,104129129001,-1,1077,1240,40
104130848747,104130848743,-4,897,1914,40
104144511423,104144511419,-4,766,2421,40
104145791488,104145791483,-5,1162,3694,40
104146438692,104146438698,6,46,1013,40
104148191149,104148191143,-6,1088,2873,40
104148753073,104148753067,-6,1218,4529,40
104152317513,104152317508,-5,1051,3391,40
104157881173,104157881167,-6,760,4780,40
104164141221,104164141216,-5,1462,4514,40
104167039186,104167039181,-5,770,2466,40
104169322321,104169322315,-6,750,3561,40
104169637412,104169637430,18,760,3244,40
104170571374,104170571381,7,2759,1115,40
104179206530,104179206533,3,1831,1437,40
104181037918,104181037922,4,2413,1039,40
104182501021,104182501002,-19,290,1397,40
104182532070,104182532064,-6,1324,3338,40
104186398847,104186398842,-5,1048,4192,40
104187021446,104187021441,-5,666,3083,40
104191912554,104191912549,-5,1324,5333,40
104193232116,104193232110,-6,1293,5133,40
104199373678,104199373675,-3,825,1794,40
104199737609,104199737613,4,2240,1331,40
104201498646,104201498640,-6,1348,4305,40
104208810099,104208810094,-5,934,4421,40
104210345826,104210345822,-4,905,2973,40
104213833581,104213833578,-3,1277,3233,40
104215697767,104215697761,-6,855,3727,40
104217118707,104217118701,-6,934,3945,40
104219943325,104219943317,-8,915,3541,40
104222737786,104222737780,-6,17880,14697,40
104223798261,104223798254,-7,1431,4821,40
104230202897,104230202903,6,2380,1460,40
104231055538,104231055533,-5,1087,3771,40
104241725822,104241725818,-4,935,4085,40
104242279167,104242279163,-4,767,2465,40
104243958257,104243958250,-7,821,4034,40
104244121731,104244121724,-7,1084,4845,40
104246885858,104246885857,-1,1198,1368,40
104247650539,104247650533,-6,823,3202,40
104248249867,104248249861,-6,1545,4836,40
104250742162,104250742157,-5,982,3654,40
104254449678,104254449674,-4,1220,3938,40
104255842451,104255842445,-6,1276,2986,40
104256715806,104256715804,-2,1035,1776,40
104259133738,104259133733,-5,905,2795,40
104263986141,104263986137,-4,1508,5777,40
104273773720,104273773711,-9,1069,3339,40
104279661014,104279661018,4,40052,87186,40
104281208641,104281208642,1,1617,2290,40
104284813871,104284813865,-6,1193,3451,40
104285325603,104285325597,-6,1267,3427,40
104290022891,104290022885,-6,1496,3783,40
104290057855,104290057871,16,148,1165,40
104291992319,104291992313,-6,1407,3330,40
104293884359,104293884353,-6,1179,3550,40
104294677269,104294677274,5,3793,3287,40
104296423094,104296423089,-5,879,2203,40
104305794453,104305794446,-7,1071,4121,40
104313247499,104313247503,4,3167,1370,40
104314947269,104314947264,-5,1159,4799,40
104315115775,104315115770,-5,1127,2950,40
104323952359,104323952353,-6,1182,2774,40
104324178614,104324178610,-4,1028,1785,40
104324245932,104324245915,-17,1180,4321,40
104325696458,104325696462,4,2316,1308,40
104332890478,104332890472,-6,849,3291,40
104333332210,104333332206,-4,860,3327,40
104334418522,104334418517,-5,1314,4001,40
104340898702,104340898709,7,17720,20141,40
104348993371,104348993374,3,3263,1878,40
104350795201,104350795196,-5,1105,3495,40
104362144471,104362144463,-8,601,4282,40
104362391312,104362391306,-6,699,2691,40
104367315329,104367315325,-4,1334,3969,40
104367416315,104367416320,5,1928,1330,40
104370767028,104370767046,18,1056,2034,40
104370933771,104370933764,-7,931,3494,40
104371882030,104371882046,16,1105,2334,40
104374646761,104374646762,1,851,1286,40
104377338395,104377338390,-5,1400,3623,40
104381706798,104381706795,-3,788,2344,40
104384691233,104384691226,-7,971,3586,40
104388376507,104388376501,-6,990,3124,40
104388545436,104388545422,-14,732,3490,40
104388932248,104388932254,6,126,947,40
104391321719,104391321713,-6,1016,2787,40
104394032643,104394032638,-5,1275,3649,40
104394074443,104394074437,-6,875,3518,40
104397058818,104397058810,-8,1315,5371,40
104399835582,104399835590,8,18493,53347,40
104411807766,104411807759,-7,829,2561,40
104413237087,104413237079,-8,226,788,40
104417121183,104417121178,-5,923,3097,40
104420210433,104420210425,-8,820,3698,40
104425280477,104425280473,-4,1069,4572,40
104425407077,104425407087,10,366,933,40
104432777834,104432777826,-8,695,2065,40
104433114967,104433114961,-6,1016,4444,40
104451043911,104451043904,-7,708,2441,40
104454248330,104454248323,-7,930,3610,40
104455354844,104455354850,6,216,805,40
104456862102,104456862098,-4,945,2681,40
104457432224,104457432238,14,371,1574,40
104457919831,104457919826,-5,846,2705,40
104460332467,104460332461,-6,900,4071,40
104460413224,104460413239,15,329,1630,40
104460438847,104460438840,-7,973,3459,40
104463546950,104463546945,-5,781,3245,40
104463681805,104463681786,-19,134,1378,40
104465123269,104465123275,6,4546,1225,40
104466673981,104466673980,-1,2602,4508,40
104470913710,104470913703,-7,853,3831,40
104476219513,104476219515,2,1727,1782,40
104476635895,104476635889,-6,916,4330,40
104479746604,104479746587,-17,2667,1390,40
104483878171,104483878166,-5,842,2830,40
104486986690,104486986685,-5,749,3284,40
104491914603,104491914597,-6,1016,3994,40
104496692212,104496692213,1,2465,2455,40
104499768402,104499768411,9,194,1280,40
104499949293,104499949315,22,536,2251,40
104500459898,104500459893,-5,803,2371,40
104503900246,104503900242,-4,779,2488,40
104506384820,104506384814,-6,1111,3598,40
104512746767,104512746761,-6,1061,4098,40
104512941397,104512941402,5,1600,1329,40
104514816625,104514816619,-6,1260,3623,40
104515549187,104515549181,-6,990,4419,40
104520537682,104520537677,-5,1026,3128,40
104522894638,104522894638,0,1706,2793,40
104523047126,104523047110,-16,998,3756,40
104523659293,104523659305,12,143,847,40
104524229686,104524229682,-4,757,3054,40
104525256974,104525256966,-8,1451,4103,40
104526370987,104526370981,-6,692,5017,40
104527665952,104527665949,-3,18558,16815,40
104529670354,104529670347,-7,1036,5611,40
104535393892,104535393885,-7,981,3791,40
104545245354,104545245358,4,4948,3038,40
104549992822,104549992817,-5,1481,4244,40
104550494157,104550494179,22,1587,2073,40
104553379892,104553379885,-7,1677,3591,40
104556472264,104556472259,-5,996,3437,40
104561360529,104561360530,1,2131,2468,40
104562238163,104562238158,-5,900,3589,40
104564832127,104564832121,-6,975,2689,40
104565375223,104565375241,18,1107,3653,40
104568249255,104568249251,-4,1249,2218,40
104576648584,104576648578,-6,856,2943,40
104582924629,104582924630,1,1916,1990,40
104582971222,104582971217,-5,1337,4484,40
104586968811,104586968803,-8,1126,4677,40
104587338960,104587338973,13,962,2660,40
104589583295,104589583289,-6,894,3783,40
104593072301,104593072296,-5,755,2842,40
104593563221,104593563221,0,435,1119,40
104594361545,104594361538,-7,970,4824,40
104595389505,104595389501,-4,1214,3386,40
104596143703,104596143720,17,202,1489,40
104601539505,104601539499,-6,970,4000,40
104606955831,104606955826,-5,1509,4488,40
104609255711,104609255706,-5,976,3599,40
104610382095,104610382092,-3,1035,2440,40
104617489234,104617489249,15,488,3553,40
104622978261,104622978253,-8,938,2915,40
104623322399,104623322389,-10,897,4449,40
104623833334,104623833354,20,422,1782,40
104626485709,104626485711,2,1115,1491,40
104631604054,104631604050,-4,2279,5220,40
104635516823,104635516818,-5,855,3741,40
104642170254,104642170250,-4,928,2340,40
104642446566,104642446554,-12,694,2849,40
104646114300,104646114296,-4,1199,2958,40
104649085779,104649085773,-6,932,3116,40
104656722871,104656722864,-7,1060,4303,40
104659997769,104659997765,-4,1033,4333,40
104661730666,104661730661,-5,585,2065,40
104666636799,104666636791,-8,905,3766,40
104669699242,104669699242,0,7175,7341,40
104681753566,104681753559,-7,692,3895,40
104683267031,104683267051,20,455,1133,40
104692125262,104692125258,-4,735,1245,40
104692795527,104692795522,-5,826,2939,40
104695096903,104695096891,-12,3012,1004,40
104695890281,104695890286,5,1463,1209,40
104699300875,104699300869,-6,664,3939,40
104699555103,104699555117,14,390,1557,40
104701145218,104701145213,-5,1059,3120,40
104702129140,104702129156,16,458,1373,40
104712479117,104712479111,-6,1264,4587,40
104717324623,104717324627,4,4975,20754,40
104729464133,104729464129,-4,885,3061,40
104732754598,104732754593,-5,672,3199,40
104736447746,104736447738,-8,1241,3875,40
104738476964,104738476986,22,846,3425,40
104747697569,104747697566,-3,960,1152,40
104752600903,104752600898,-5,1106,5207,40
104755248397,104755248391,-6,672,3655,40
104755341684,104755341681,-3,149,1151,40
104758229071,104758229065,-6,728,3482,40
104758772116,104758772097,-19,37,1231,40
104758803726,104758803738,12,164,2314,40
104759003006,104759002986,-20,248,1710,40
104759279510,104759279526,16,501,1301,40
104760700859,104760700854,-5,1323,3015,40
104762104965,104762104959,-6,872,3418,40
104767331641,104767331633,-8,1164,4214,40
104770756281,104770756274,-7,879,4181,40
104776559874,104776559873,-1,1279,2640,40
104796034744,104796034737,-7,1127,2806,40
104796644559,104796644573,14,1003,3176,40
104807575894,104807575889,-5,772,3130,40
104808649397,104808649397,0,2780,3320,40
104812430485,104812430480,-5,1252,2034,40
104812504053,104812504059,6,3940,1942,40
104812772999,104812772993,-6,1261,2644,40
104820825007,104820825001,-6,957,3404,40
104831991474,104831991469,-5,1040,3168,40
104839833638,104839833632,-6,556,2441,40
104841421281,104841421275,-6,1164,5438,40
104845243449,104845243442,-7,948,3707,40
104846262936,104846262930,-6,994,4237,40
104849555611,104849555606,-5,908,3292,40
104850047862,104850047855,-7,1187,4281,40
104850479934,104850479955,21,743,3003,40
104852014207,104852014202,-5,997,2342,40
104853932081,104853932075,-6,884,3434,40
104856574665,104856574667,2,1503,1152,40
104858429914,104858429907,-7,263,1445,40
104858526751,104858526742,-9,164,1171,40
104863009226,104863009219,-7,657,2520,40
104866462182,104866462177,-5,1228,3393,40
104873749338,104873749333,-5,1179,3746,40
104878240482,104878240476,-6,906,4395,40
104878690068,104878690068,0,37604,25057,40
104879779567,104879779562,-5,1358,5471,40
104883244498,104883244500,2,1577,1949,40
104900709126,104900709126,0,1163,1131,40
104902901649,104902901651,2,2663,1735,40
104918353938,104918353932,-6,1159,4183,40
104923052050,104923052044,-6,782,2859,40
104923293124,104923293145,21,463,2422,40
104924387590,104924387585,-5,1036,4226,40
104927460334,104927460336,2,1537,1180,40
104927651559,104927651563,4,2575,1362,40
104929353303,104929353301,-2,2432,5748,40
104934111531,104934111526,-5,868,3033,40
104934166638,104934166630,-8,24865,11603,40
104936061910,104936061906,-4,982,3663,40
104937606299,104937606298,-1,1402,1369,40
104950012357,104950012350,-7,1154,4036,40
104961225799,104961225805,6,1348,1035,40
104961711639,104961711634,-5,1169,2645,40
104978327881,104978327874,-7,1396,3451,40
104980195472,104980195465,-7,1290,5135,40
104982235566,104982235561,-5,926,3566,40
104987099057,104987099053,-4,988,4204,40
104988314715,104988314709,-6,1178,3789,40
104989566479,104989566474,-5,1130,3306,40
104990574886,104990574884,-2,999,2182,40
104992067379,104992067374,-5,976,3732,40
104995950039,104995950035,-4,997,3471,40
104999008064,104999008058,-6,1484,4155,40
105002059798,105002059793,-5,1145,2981,40
105003547130,105003547126,-4,22724,58945,40
105006930314,105006930307,-7,858,3514,40
105012071879,105012071874,-5,1051,3531,40
105013090170,105013090188,18,756,1442,40
105018971151,105018971157,6,2908,1860,40
105023838109,105023838101,-8,927,3841,40
105033526759,105033526759,0,1414,1783,40
105039328461,105039328457,-4,1137,4107,40
105040040423,105040040441,18,122,1062,40
105043199169,105043199162,-7,999,3763,40
105053846463,105053846466,3,3035,2131,40
105054319473,105054319474,1,22030,23750,40
105055935241,105055935237,-4,681,3112,40
105058202915,105058202912,-3,1082,1770,40
105060021039,105060021033,-6,685,3499,40
105060888583,105060888577,-6,1193,4755,40
105064118946,105064118939,-7,906,5052,40
105064733327,105064733319,-8,530,2448,40
105065200341,105065200357,16,418,2516,40
105067804978,105067804973,-5,1149,3968,40
105072632489,105072632485,-4,1206,2705,40
105073478614,105073478620,6,1076,563,40
105075829378,105075829373,-5,721,1894,40
105083902830,105083902817,-13,222,992,40
105087263636,105087263629,-7,950,4064,40
105088320356,105088320350,-6,2381,5482,40
105090766878,105090766878,0,3119,4335,40
105093786658,105093786678,20,3219,1380,40
105100052582,105100052577,-5,911,3868,40
105103991072,105103991066,-6,1112,4136,40
105105669043,105105669061,18,574,4674,40
105114453846,105114453847,1,1810,1866,40
105118661094,105118661089,-5,717,3144,40
105120668289,105120668283,-6,1144,4622,40
105123809803,105123809797,-6,948,4331,40
105124450974,105124450967,-7,1056,3197,40
105124875079,105124875063,-16,144,1154,40
105125648838,105125648832,-6,963,4280,40
105134254847,105134254841,-6,626,2940,40
105134753687,105134753702,15,189,933,40
105140342967,105140342962,-5,941,3220,40
105141025111,105141025109,-2,855,2256,40
105142081328,105142081321,-7,962,3324,40
105143290087,105143290075,-12,190,1518,40
105144705180,105144705174,-6,1064,3974,40
105145045826,105145045819,-7,1736,4455,40
105146017268,105146017267,-1,210,895,40
105146317130,105146317126,-4,1051,3671,40
105147980949,105147980942,-7,1004,4193,40
105148305471,105148305466,-5,1048,3662,40
105148565750,105148565756,6,270,1453,40
105153481279,105153481273,-6,903,3097,40
105165486394,105165486388,-6,717,3749,40
105169666586,105169666578,-8,1422,4519,40
105171416709,105171416702,-7,1121,4534,40
105181364512,105181364506,-6,1071,4036,40
105185104667,105185104661,-6,1066,2816,40
105185203084,105185203102,18,735,3649,40
105185728641,105185728645,4,3340,2316,40
105186835039,105186835034,-5,707,3156,40
105189034230,105189034225,-5,1154,3647,40
105193295884,105193295885,1,1548,2484,40
105197691098,105197691090,-8,1129,4095,40
105201626142,105201626141,-1,27546,20207,40
105209113384,105209113385,1,1462,1751,40
105209341456,105209341474,18,23,1383,40
105212585798,105212585791,-7,1080,3054,40
105213164393,105213164388,-5,1071,3657,40
105214339697,105214339693,-4,1030,2492,40
105215678403,105215678395,-8,486,1966,40
105218472619,105218472611,-8,1239,4266,40
105227302163,105227302167,4,1975,1063,40
105229872424,105229872417,-7,907,4349,40
105231682041,105231682037,-4,1997,3838,40
105232509505,105232509498,-7,1052,3752,40
105235984676,105235984670,-6,757,2790,40
105243631531,105243631526,-5,876,2814,40
105245841154,105245841151,-3,1413,2520,40
105260181590,105260181585,-5,1064,3893,40
105264224635,105264224630,-5,1059,3600,40
105266208929,105266208921,-8,1156,4405,40
105266453942,105266453957,15,1181,3366,40
105270806823,105270806817,-6,1081,3836,40
105272315919,105272315935,16,130,2086,40
105272393285,105272393307,22,857,2631,40
105275209271,105275209276,5,1724,1202,40
105276882162,105276882160,-2,1365,1812,40
105285289490,105285289483,-7,1190,5079,40
105288702241,105288702247,6,5122,2572,40
105290994852,105290994848,-4,807,2023,40
105294089052,105294089045,-7,1144,3113,40
105294846541,105294846535,-6,944,3549,40
105309576635,105309576633,-2,870,3041,40
105312055375,105312055369,-6,800,3428,40
105312960517,105312960510,-7,896,2031,40
105315591784,105315591778,-6,1144,4305,40
105315923582,105315923602,20,86,1624,40
105324158705,105324158702,-3,1104,3350,40
105343754170,105343754165,-5,959,4116,40
105358834190,105358834182,-8,1129,4088,40
105363820982,105363820987,5,2161,1561,40
105365743187,105365743179,-8,964,4733,40
105366019621,105366019617,-4,1720,4429,40
105371956095,105371956098,3,1286,1130,40
105376211746,105376211746,0,1787,1853,40
105379687507,105379687501,-6,790,2619,40
105380056022,105380056007,-15,387,1339,40
105380852951,105380852952,1,8880,19097,40
105384096112,105384096107,-5,1016,3313,40
105390757546,105390757541,-5,1319,3480,40
105393404175,105393404174,-1,1123,1291,40
105401788295,105401788288,-7,880,5092,40
105402376031,105402376042,11,512,2814,40
105413016299,105413016298,-1,1347,2244,40
105415041249,105415041255,6,4395,1555,40
105415471674,105415471666,-8,980,3678,40
105416060798,105416060812,14,120,1154,40
105425455186,105425455178,-8,884,3273,40
105430697048,105430697042,-6,1182,4867,40
105438702562,105438702559,-3,638,1492,40
105439182919,105439182931,12,570,3626,40
105439873432,105439873428,-4,697,3184,40
105444756083,105444756075,-8,342,723,40
105451727441,105451727446,5,5334,3119,40
105452323950,105452323944,-6,945,3497,40
105454867529,105454867515,-14,1059,5260,40
105465705898,105465705899,1,1385,1780,40
105468335819,105468335814,-5,726,2739,40
105476179821,105476179819,-2,2473,4195,40
105479158075,105479158073,-2,629,1487,40
105480750754,105480750749,-5,831,2854,40
105487484194,105487484189,-5,793,3833,40
105490653926,105490653921,-5,842,3516,40
105491307900,105491307917,17,692,2828,40
105492450707,105492450713,6,2902,2796,40
105495530158,105495530152,-6,723,3707,40
105496017572,105496017586,14,161,947,40
105500556550,105500556545,-5,960,3004,40
105518898498,105518898490,-8,1087,3125,40
105525926881,105525926876,-5,1034,5217,40
105529010022,105529010017,-5,970,4033,40
105529272512,105529272527,15,425,2467,40
105529883015,105529883013,-2,936,1926,40
105536953070,105536953064,-6,1143,3463,40
105540589255,105540589245,-10,1037,4286,40
105542749675,105542749671,-4,974,3795,40
105543069292,105543069286,-6,927,2629,40
105544719044,105544719037,-7,1369,5539,40
105544824045,105544824067,22,466,952,40
105546946749,105546946742,-7,1205,3978,40
105550577061,105550577054,-7,824,3612,40
105555428555,105555428550,-5,1393,4551,40
105559183129,105559183122,-7,893,4604,40
105560492482,105560492476,-6,1092,4063,40
105560544390,105560544382,-8,1098,5240,40
105560847199,105560847217,18,859,3664,40
105568971962,105568971965,3,1474,1274,40
105578048845,105578048856,11,379,1532,40
105579303250,105579303245,-5,1042,3021,40
105581976470,105581976468,-2,1379,3221,40
105584663264,105584663269,5,3083,1746,40
105585477945,105585477938,-7,941,3925,40
105586136431,105586136450,19,346,801,40
105594015343,105594015340,-3,1731,2280,40
105598788931,105598788927,-4,856,2808,40
105600875458,105600875462,4,1946,1665,40
105603582394,105603582388,-6,796,3620,40
105607067319,105607067311,-8,488,2933,40
105609111014,105609111015,1,17606,19075,40
105610996898,105610996893,-5,1238,2994,40
105617148219,105617148213,-6,480,3728,40
105617303328,105617303345,17,611,2355,40
105617810574,105617810569,-5,1150,3881,40
105619162811,105619162806,-5,652,2875,40
105620324923,105620324917,-6,723,4771,40
105626542899,105626542884,-15,2481,557,40
105638352827,105638352830,3,7346,7559,40
105646985792,105646985788,-4,867,1657,40
105648562741,105648562735,-6,1079,3745,40
105653512726,105653512719,-7,1068,4044,40
105659705767,105659705762,-5,640,3258,40
105661193466,105661193462,-4,989,2889,40
105669963229,105669963222,-7,1136,5921,40
105670647782,105670647798,16,432,2386,40
105672416122,105672416127,5,2028,1524,40
105672758211,105672758205,-6,813,4437,40
105673706142,105673706138,-4,887,3644,40
105673993351,105673993361,10,175,1092,40
105676346670,105676346665,-5,1443,3637,40
105680396395,105680396389,-6,1389,3935,40
105684546631,105684546626,-5,963,2597,40
105685458150,105685458142,-8,976,4197,40
105686024186,105686024181,-5,1074,3502,40
105686531843,105686531838,-5,1079,4748,40
105691389342,105691389337,-5,899,2602,40
105692088438,105692088433,-5,327,1276,40
105692995997,105692995993,-4,848,2655,40
105694759976,105694759971,-5,1083,3259,40
105695013007,105695012989,-18,1169,3670,40
105695366646,105695366627,-19,159,1137,40
105703837331,105703837329,-2,1244,2586,40
105704267155,105704267149,-6,1200,4081,40
105714881076,105714881069,-7,1115,7710,40
105714966831,105714966850,19,386,2225,40
105718941334,105718941329,-5,757,3203,40
105723227347,105723227342,-5,891,3568,40
105723522119,105723522114,-5,887,3338,40
105726719959,105726719954,-5,488,2756,40
105729334292,105729334286,-6,1057,2610,40
105729666326,105729666318,-8,1962,7104,40
105736219354,105736219357,3,3232,2756,40
105739425602,105739425594,-8,674,3789,40
105739576100,105739576110,10,177,1058,40
105743543629,105743543621,-8,999,4032,40
105744329940,105744329958,18,787,3555,40
105745402825,105745402818,-7,1118,4242,40
105745778063,105745778076,13,912,2459,40
105745815927,105745815921,-6,807,5045,40
105747568137,105747568142,5,3450,2311,40
105749353915,105749353909,-6,1168,3379,40
105755236255,105755236261,6,5560,2461,40
105756804711,105756804714,3,1440,1765,40
105761507597,105761507606,9,7815,3840,40
105764564474,105764564469,-5,1176,4880,40
105766237037,105766237043,6,4968,1917,40
105775541956,105775541951,-5,1665,4613,40
105776984685,105776984681,-4,1033,3386,40
105784742190,105784742185,-5,985,4695,40
105792765781,105792765774,-7,624,2226,40
105793458026,105793458018,-8,883,2353,40
105794127451,105794127445,-6,626,2947,40
105794575775,105794575770,-5,850,2935,40
105797664410,105797664406,-4,1085,3295,40
105797777180,105797777203,23,466,2680,40
105799765959,105799765937,-22,1353,4593,40
105800247373,105800247380,7,454,1372,40
105806996610,105806996614,4,4166,2910,40
105810530462,105810530456,-6,1069,3825,40
105812981558,105812981577,19,141,1418,40
105820983611,105820983603,-8,1184,4834,40
105821881945,105821881938,-7,822,2884,40
105824248871,105824248864,-7,1179,3674,40
105825190395,105825190402,7,2024,1105,40
105827386086,105827386080,-6,1072,3652,40
105838374476,105838374481,5,1889,949,40
105838822422,105838822418,-4,1316,4470,40
105841519695,105841519689,-6,967,2953,40
105847700771,105847700763,-8,1114,4161,40
105848961985,105848961980,-5,923,2786,40
105850753559,105850753555,-4,997,3265,40
105865833994,105865833986,-8,1154,5908,40
105875189793,105875189787,-6,1125,3985,40
105875329688,105875329704,16,791,2906,40
105882814503,105882814507,4,1738,1199,40
105886835817,105886835811,-6,1216,3813,40
105886949310,105886949323,13,591,3646,40
105889852509,105889852504,-5,1114,2613,40
105891596530,105891596524,-6,1179,3198,40
105896218158,105896218152,-6,957,2639,40
105896526326,105896526319,-7,1076,3388,40
105902462170,105902462164,-6,1116,4367,40
105902496606,105902496622,16,861,4057,40
105903966387,105903966386,-1,1218,2195,40
105905013855,105905013850,-5,745,2729,40
105913466313,105913466307,-6,1050,4703,40
105913669708,105913669702,-6,214,1375,40
105913885255,105913885257,2,111,981,40
105918831015,105918831014,-1,2040,3402,40
105923862326,105923862320,-6,1021,4821,40
105924334313,105924334307,-6,1107,3761,40
105924655069,105924655063,-6,144,1355,40
105926117846,105926117862,16,147,1045,40
105927227501,105927227495,-6,1144,3918,40
105929255530,105929255525,-5,1296,3390,40
105931579098,105931579101,3,1025,1155,40
105932971186,105932971182,-4,771,3016,40
105937204299,105937204293,-6,1009,3388,40
105940648098,105940648090,-8,944,5238,40
105940924408,105940924406,-2,247,1040,40
105943187650,105943187646,-4,1772,5234,40
105945673315,105945673314,-1,1306,2438,40
105946160390,105946160391,1,1648,1747,40
105947250514,105947250509,-5,675,2055,40
105951769918,105951769912,-6,936,1894,40
105954225230,105954225225,-5,1191,2568,40
105955644773,105955644766,-7,1267,5518,40
105962882470,105962882464,-6,569,3647,40
105963065132,105963065151,19,126,1216,40
105964715055,105964715050,-5,928,2725,40
105965472853,105965472871,18,478,3079,40
105968036639,105968036638,-1,1593,1608,40
105968691034,105968691035,1,1465,1417,40
105973706233,105973706227,-6,809,3429,40
105986949055,105986949065,10,2484,975,40
105989292588,105989292581,-7,841,3422,40
105998021795,105998021788,-7,1218,3749,40
105999155518,105999155513,-5,1004,2130,40
106000101959,106000101977,18,1047,1922,40
106005953731,106005953726,-5,1244,5294,40
106006921678,106006921681,3,2711,1912,40
106007775567,106007775563,-4,733,1529,40
106011703589,106011703583,-6,1079,5347,40
106012439742,106012439761,19,637,2008,40
106020344892,106020344886,-6,740,4016,40
106022620049,106022620043,-6,1038,4161,40
106027755342,106027755337,-5,1325,4277,40
106029986702,106029986697,-5,1091,2984,40
106030116806,106030116823,17,1139,3616,40
106030986457,106030986452,-5,514,1208,40
106033267068,106033267064,-4,29959,12823,40
106038684382,106038684374,-8,1116,4629,40
106039479526,106039479545,19,89,1057,40
106049557466,106049557461,-5,1088,3544,40
106049752082,106049752077,-5,1016,3575,40
106054491213,106054491208,-5,930,3454,40
106055187494,106055187489,-5,1187,4069,40
106060236750,106060236757,7,3081,1774,40
106061435702,106061435707,5,3946,1367,40
106065449094,106065449093,-1,1164,3047,40
106065579485,106065579502,17,899,4384,40
106066123458,106066123457,-1,1526,2531,40
106067042385,106067042378,-7,1224,4354,40
106067284423,106067284409,-14,84,1402,40
106077324101,106077324096,-5,823,3664,40
106078729282,106078729275,-7,1157,3598,40
106080450411,106080450405,-6,790,2906,40
106082317462,106082317455,-7,1293,3743,40
106082396833,106082396831,-2,1184,2582,40
106083758329,106083758322,-7,681,4308,40
106084064156,106084064178,22,285,1069,40
106094002557,106094002551,-6,863,4183,40
106104033503,106104033497,-6,969,3076,40
106109413373,106109413365,-8,1219,2824,40
106111444608,106111444603,-5,1157,4442,40
106116870256,106116870250,-6,1120,4130,40
106118979154,106118979151,-3,848,1471,40
106123786854,106123786851,-3,2098,4847,40
106125547734,106125547739,5,2211,1084,40
106127439906,106127439898,-8,970,5138,40
106129060161,106129060154,-7,804,4468,40
106129418260,106129418280,20,1288,3976,40
106134428543,106134428537,-6,1217,3661,40
106136380902,106136380919,17,462,2503,40
106138856595,106138856586,-9,1164,4208,40
106140728413,106140728405,-8,1273,4783,40
106154378433,106154378427,-6,843,3540,40
106156214509,106156214501,-8,1158,3994,40
106156337221,106156337207,-14,15,977,40
106156569805,106156569821,16,835,3713,40
106164491003,106164490994,-9,1144,4468,40
106164518285,106164518290,5,98,1255,40
106168906725,106168906734,9,331,1146,40
106176531043,106176531037,-6,1293,3780,40
106177362830,106177362832,2,4717,7418,40
106180731374,106180731369,-5,700,3791,40
106180821594,106180821595,1,22589,88272,40
106182118929,106182118940,11,12742,49643,40
106188812983,106188812987,4,1180,1165,40
106191940802,106191940797,-5,1382,3543,40
106191990087,106191990081,-6,1307,4253,40
106196024922,106196024917,-5,1255,4495,40
106196647387,106196647383,-4,623,2457,40
106198650862,106198650857,-5,1095,5076,40
106198781060,106198781058,-2,153,1268,40
106199434974,106199434967,-7,1543,5887,40
106200889042,106200889034,-8,1096,5359,40
106201590830,106201590822,-8,961,4338,40
106207453304,106207453303,-1,1451,1498,40
106209330274,106209330270,-4,957,3471,40
106209703783,106209703768,-15,1067,4447,40
106210670207,106210670202,-5,1049,3572,40
106212922787,106212922780,-7,939,3902,40
106213070692,106213070714,22,1084,3247,40
106229048558,106229048554,-4,1866,4107,40
106229579265,106229579260,-5,767,3240,40
106231423355,106231423350,-5,1025,2679,40
106235175004,106235175003,-1,191,936,40
106239328426,106239328425,-1,2605,4516,40
106240608855,106240608848,-7,1197,3909,40
106241238494,106241238510,16,358,2054,40
106241361308,106241361301,-7,761,3850,40
106241707128,106241707142,14,699,2672,40
106244399526,106244399522,-4,1402,3902,40
106246042886,106246042889,3,1433,1359,40
106252749031,106252749025,-6,540,3581,40
106255949813,106255949806,-7,1230,3404,40
106256525451,106256525445,-6,857,3048,40
106256657709,106256657701,-8,15,1379,40
106260944552,106260944546,-6,1182,4675,40
106263866216,106263866210,-6,1556,3735,40
106265027434,106265027428,-6,738,2905,40
106272055097,106272055093,-4,1493,3594,40
106272810746,106272810740,-6,1027,3119,40
106278157194,106278157199,5,3342,1884,40
106283187042,106283187037,-5,1002,3760,40
106284913255,106284913246,-9,1026,3271,40
106289787660,106289787654,-6,714,2756,40
106290725030,106290725025,-5,1181,4530,40
106304563213,106304563207,-6,743,2487,40
106304678533,106304678554,21,363,1005,40
106309878517,106309878512,-5,1154,2291,40
106323183546,106323183538,-8,903,7515,40
106324219147,106324219142,-5,1102,3437,40
106331088374,106331088369,-5,651,1852,40
106332105518,106332105518,0,301,1356,40
106333948453,106333948446,-7,1211,5036,40
106336246784,106336246787,3,2034,1261,40
106339767664,106339767659,-5,978,1984,40
106340677698,106340677697,-1,2511,3904,40
106340959023,106340959017,-6,678,2926,40
106342600883,106342600878,-5,670,2476,40
106343101878,106343101863,-15,303,1105,40
106354033108,106354033102,-6,1230,3536,40
106356647475,106356647470,-5,893,4479,40
106357066341,106357066359,18,989,4540,40
106357321787,106357321781,-6,886,2589,40
106361385303,106361385298,-5,689,3117,40
106361570603,106361570602,-1,1711,2460,40
106361707824,106361707818,-6,591,3958,40
106364560710,106364560705,-5,893,2935,40
106364830591,106364830569,-22,1467,7744,40
106365402004,106365402006,2,8,921,40
106370355731,106370355726,-5,961,3730,40
106374484950,106374484945,-5,973,3482,40
106379027187,106379027181,-6,1426,2865,40
106381334890,106381334885,-5,702,3710,40
106383362006,106383362000,-6,1213,3304,40
106384002253,106384002238,-15,280,816,40
106391147618,106391147620,2,15886,14348,40
106396608476,106396608472,-4,1284,3788,40
106401342432,106401342425,-7,1656,7806,40
106401849861,106401849854,-7,107,1263,40
106402873159,106402873152,-7,1008,3067,40
106403656321,106403656314,-7,543,2867,40
106406454618,106406454612,-6,900,3909,40
106407812333,106407812326,-7,1192,4585,40
106411552809,106411552802,-7,926,3222,40
106411782750,106411782742,-8,68,1194,40
106413125883,106413125882,-1,965,1287,40
106413688091,106413688085,-6,1224,4721,40
106419330613,106419330606,-7,1071,4693,40
106426128616,106426128610,-6,718,2644,40
106432452761,106432452755,-6,821,2491,40
106441815439,106441815432,-7,761,3008,40
106443770303,106443770298,-5,906,3518,40
106446236510,106446236504,-6,1360,5076,40
106448633990,106448633982,-8,700,3869,40
106449238122,106449238115,-7,727,3837,40
106449327095,106449327090,-5,683,3474,40
106453352262,106453352255,-7,1152,4622,40
106454347910,106454347909,-1,1079,1419,40
106454456982,106454456965,-17,344,1277,40
106460112924,106460112935,11,15162,19292,40
106460981238,106460981233,-5,1097,3527,40
106461835372,106461835385,13,47,818,40
106463391106,106463391100,-6,735,2999,40
106480343116,106480343110,-6,726,2869,40
106482302885,106482302869,-16,1051,4924,40
106482351689,106482351681,-8,903,4178,40
106484762848,106484762841,-7,529,2606,40
106486441787,106486441778,-9,789,2530,40
106488399819,106488399814,-5,1237,4767,40
106499126459,106499126453,-6,931,3380,40
106505554963,106505554957,-6,1208,4051,40
106505857335,106505857350,15,895,3956,40
106506134973,106506134970,-3,837,2312,40
106511255466,106511255461,-5,954,2807,40
106511913564,106511913580,16,923,2645,40
106522246565,106522246560,-5,737,2483,40
106529252111,106529252105,-6,1051,3008,40
106530127857,106530127851,-6,1313,4846,40
106530400614,106530400602,-12,983,4284,40
106532513311,106532513305,-6,1195,2800,40
106544645225,106544645220,-5,848,3935,40
106545329370,106545329363,-7,684,2822,40
106546416778,106546416770,-8,911,3182,40
106547762326,106547762318,-8,815,2289,40
106549162803,106549162796,-7,942,3068,40
106554645350,106554645370,20,160,1118,40
106557356123,106557356118,-5,680,4415,40
106557701214,106557701210,-4,301,1248,40
106559762484,106559762482,-2,1310,1929,40
106567851102,106567851097,-5,895,3799,40
106568976033,106568976028,-5,1081,4254,40
106578775593,106578775586,-7,861,3141,40
106578845566,106578845561,-5,1160,5486,40
106579010874,106579010868,-6,866,4115,40
106579383098,106579383090,-8,1203,4742,40
106581262029,106581262028,-1,1750,2257,40
106583720314,106583720309,-5,869,2789,40
106586357935,106586357928,-7,998,3709,40
106586902146,106586902139,-7,1392,3502,40
106596635720,106596635713,-7,642,3607,40
106597561530,106597561526,-4,1133,4726,40
106597627741,106597627737,-4,206,619,40
106602244618,106602244613,-5,977,3645,40
106604300383,106604300378,-5,1126,3571,40
106607080650,106607080646,-4,885,3882,40
106618868078,106618868073,-5,918,2715,40
106622952384,106622952387,3,1644,1127,40
106624397962,106624397957,-5,852,2881,40
106628071463,106628071469,6,4529,2227,40
106633901995,106633901990,-5,926,3669,40
106634982792,106634982789,-3,1359,2754,40
106635310799,106635310793,-6,940,3830,40
106643094023,106643094019,-4,975,3786,40
106652625240,106652625253,13,1250,1534,40
106656151232,106656151226,-6,782,4586,40
106656542215,106656542214,-1,74,1071,40
106659422383,106659422378,-5,945,3713,40
106666700233,106666700237,4,1828,656,40
106667495227,106667495221,-6,782,3179,40
106669250693,106669250688,-5,1083,3261,40
106672618516,106672618510,-6,858,3262,40
106676573990,106676573984,-6,1128,3992,40
106676649135,106676649112,-23,877,3415,40
106686556258,106686556253,-5,1201,2996,40
106689526016,106689526010,-6,1305,4574,40
106690746677,106690746685,8,13960,36371,40
106697225160,106697225154,-6,873,2740,40
106697748844,106697748839,-5,480,3152,40
106697859352,106697859357,5,1908,1152,40
106706419274,106706419269,-5,1086,3168,40
106715757996,106715757998,2,22760,20493,40
106716758759,106716758755,-4,1130,2954,40
106717191517,106717191511,-6,1135,3139,40
106718051105,106718051098,-7,1080,2880,40
106720529419,106720529414,-5,1168,3712,40
106725667926,106725667922,-4,1180,3389,40
106738372400,106738372393,-7,1012,3962,40
106738805049,106738805043,-6,996,2944,40
106742781626,106742781620,-6,1007,2738,40
106746371939,106746371934,-5,930,3128,40
106747907732,106747907733,1,1171,1223,40
106749027505,106749027499,-6,1104,3874,40
106757882186,106757882180,-6,1137,4111,40
106763235504,106763235504,0,1848,1684,40
106768084706,106768084702,-4,633,3069,40
106770655026,106770655019,-7,987,4507,40
106772190271,106772190267,-4,987,2567,40
106780270306,106780270301,-5,1115,2385,40
106780630230,106780630220,-10,107,698,40
106782440507,106782440498,-9,1116,3553,40
106784903276,106784903270,-6,998,4266,40
106785182710,106785182725,15,1235,4471,40
106794784238,106794784233,-5,1011,2040,40
106794918854,106794918867,13,517,4482,40
106795156629,106795156633,4,2542,1317,40
106797430330,106797430332,2,1867,1302,40
106798544074,106798544069,-5,1031,3684,40
106799995277,106799995270,-7,1279,4593,40
106802119085,106802119079,-6,822,4282,40
106805422255,106805422248,-7,265,1692,40
106806858672,106806858667,-5,1120,3655,40
106809501323,106809501318,-5,987,3604,40
106811367417,106811367417,0,1237,1845,40
106811817079,106811817074,-5,653,2904,40
106812681952,106812681953,1,1217,2468,40
106814631718,106814631714,-4,1222,3202,40
106815297855,106815297850,-5,869,2815,40
106831801174,106831801169,-5,964,4610,40
106832795765,106832795762,-3,1165,1764,40
106833648405,106833648400,-5,991,2393,40
106835273407,106835273402,-5,706,3482,40
106836115985,106836115979,-6,648,3201,40
106837382102,106837382086,-16,921,3141,40
106841735535,106841735530,-5,1420,2536,40
106844085504,106844085497,-7,1523,4902,40
106844134100,106844134107,7,91,997,40
106845036783,106845036778,-5,1343,2796,40
106846328918,106846328933,15,448,2550,40
106863053567,106863053562,-5,1270,3787,40
106868198463,106868198462,-1,40569,31540,40
106871645347,106871645341,-6,552,1534,40
106881302642,106881302646,4,2168,1318,40
106885154908,106885154901,-7,1288,5730,40
106887652395,106887652393,-2,1715,1770,40
106893609086,106893609081,-5,839,4058,40
106897914076,106897914070,-6,1040,4435,40
106904425499,106904425496,-3,1268,2992,40
106907298565,106907298558,-7,857,3025,40
106911278690,106911278685,-5,858,3354,40
106911734952,106911734970,18,173,1058,40
106930044829,106930044832,3,1441,1236,40
106941288654,106941288661,7,3608,1051,40
106943568562,106943568554,-8,481,4087,40
106944283852,106944283849,-3,1554,1882,40
106944438551,106944438544,-7,865,3996,40
106944849988,106944849981,-7,1289,2934,40
106960689966,106960689960,-6,1216,3177,40
106964962472,106964962466,-6,1079,3758,40
106972816803,106972816797,-6,1070,4437,40
106973447622,106973447617,-5,973,3153,40
106976567366,106976567358,-8,1059,4627,40
106984910909,106984910902,-7,775,2234,40
106985074374,106985074394,20,620,3242,40
107017653963,107017653957,-6,1142,4007,40
107018561034,107018561036,2,911,1040,40
107020303578,107020303574,-4,807,3206,40
107028299014,107028299009,-5,1156,3751,40
107032880707,107032880702,-5,782,2413,40
107033848333,107033848329,-4,821,3165,40
107035189814,107035189807,-7,1055,3390,40
107043520490,107043520484,-6,859,2673,40
107046785300,107046785292,-8,784,3651,40
107049570092,107049570088,-4,1211,2746,40
107049956325,107049956320,-5,916,4494,40
107053814426,107053814421,-5,946,3316,40
107054528075,107054528070,-5,1121,3240,40
107054827619,107054827613,-6,740,3544,40
107055906141,107055906135,-6,956,3767,40
107060032703,107060032697,-6,1230,3326,40
107060172119,107060172139,20,301,946,40
107060490686,107060490686,0,93,1055,40
107073103203,107073103197,-6,1135,3135,40
107077390778,107077390773,-5,730,2971,40
107077769805,107077769799,-6,1021,4312,40
107079418779,107079418771,-8,771,4742,40
107083181410,107083181405,-5,916,3741,40
107084936127,107084936140,13,13576,49234,40
107087973341,107087973325,-16,928,2101,40
107088097886,107088097881,-5,767,3200,40
107088707512,107088707506,-6,599,2773,40
107096354442,107096354436,-6,1378,6322,40
107099498379,107099498373,-6,569,2329,40
107099814430,107099814448,18,573,1769,40
107103108681,107103108673,-8,1188,2901,40
107106905591,107106905593,2,2025,2225,40
107110080657,107110080649,-8,949,2934,40
107112731882,107112731881,-1,1145,1410,40
107121262683,107121262677,-6,941,4129,40
107123012044,107123012041,-3,2584,4332,40
107129114892,107129114899,7,87493,28062,40
107134182540,107134182551,11,448,1101,40
107137436114,107137436109,-5,987,3208,40
107137490421,107137490437,16,447,1295,40
107139072331,107139072324,-7,904,3728,40
107141967495,107141967486,-9,1010,3445,40
107144649050,107144649044,-6,1244,3435,40
107144874114,107144874108,-6,1008,4077,40
107153124668,107153124661,-7,1266,4548,40
107156149899,107156149893,-6,993,3751,40
107161016189,107161016184,-5,930,3442,40
107166214004,107166213999,-5,1023,2107,40
107166965519,107166965532,13,137,873,40
107169914044,107169914040,-4,2006,4134,40
107171629353,107171629348,-5,937,2703,40
107172063388,107172063375,-13,166,1331,40
107175108680,107175108677,-3,1181,3304,40
107182344007,107182344021,14,1049,2951,40
107184868690,107184868686,-4,1754,5545,40
107185339947,107185339941,-6,995,2961,40
107185930174,107185930187,13,445,2125,40
107199990230,107199990222,-8,1056,4895,40
107200924056,107200924072,16,328,2366,40
107201810850,107201810843,-7,617,3103,40
107203754139,107203754134,-5,52730,20071,40
107206060106,107206060101,-5,770,1433,40
107206833258,107206833251,-7,1054,4871,40
107207351870,107207351852,-18,139,1351,40
107208133556,107208133562,6,5046,2656,40
107208853463,107208853456,-7,1028,3574,40
107211081714,107211081709,-5,1072,4034,40
107211241239,107211241227,-12,179,1037,40
107213652785,107213652794,9,141,1107,40
107214640522,107214640528,6,7166,3222,40
107221459156,107221459139,-17,165,808,40
107237750457,107237750450,-7,833,3584,40
107241590576,107241590570,-6,728,6661,40
107244518374,107244518373,-1,1786,1984,40
107251125878,107251125873,-5,1141,5041,40
107267700455,107267700457,2,8692,7802,40
107268239269,107268239263,-6,1353,3771,40
107272814983,107272814978,-5,1065,3469,40
107273233817,107273233810,-7,1314,3601,40
107275554344,107275554338,-6,1275,5398,40
107276893151,107276893145,-6,992,3272,40
107280988156,107280988150,-6,1696,2637,40
107291288348,107291288334,-14,116,972,40
107291579344,107291579354,10,212,1377,40
107292594350,107292594346,-4,1104,3439,40
107293565947,107293565939,-8,944,2719,40
107298596945,107298596945,0,1624,2108,40
107299197857,107299197852,-5,1047,2546,40
107299497446,107299497467,21,298,869,40
107300784026,107300784021,-5,577,4186,40
107303177632,107303177626,-6,930,2492,40
107307278223,107307278219,-4,1187,2584,40
107307626430,107307626425,-5,1071,3213,40
107308239557,107308239569,12,109,1269,40
107320334449,107320334444,-5,799,3723,40
107322371801,107322371797,-4,976,3211,40
107322680892,107322680883,-9,158,962,40
107341262443,107341262435,-8,1193,4787,40
107347640817,107347640811,-6,146,971,40
107348079307,107348079302,-5,692,2811,40
107348754799,107348754792,-7,793,4178,40
107349034458,107349034451,-7,1182,3503,40
107350536397,107350536389,-8,850,3049,40
107355902353,107355902345,-8,677,4086,40
107359631903,107359631898,-5,936,4408,40
107359765796,107359765785,-11,53,1067,40
107362621459,107362621454,-5,1060,2964,40
107363208902,107363208913,11,677,3055,40
107365106264,107365106258,-6,973,3788,40
107369535212,107369535206,-6,1266,4609,40
107369623769,107369623758,-11,2093,11149,40
107373036785,107373036781,-4,32797,14595,40
107376153837,107376153831,-6,843,3135,40
107380683257,107380683252,-5,932,3080,40
107382568731,107382568726,-5,975,3076,40
107382978284,107382978290,6,172,1522,40
107390948102,107390948096,-6,1461,5927,40
107391176989,107391177004,15,210,1166,40
107395994362,107395994351,-11,11444,30286,40
107409385041,107409385034,-7,1098,2481,40
107410560025,107410560018,-7,683,4520,40
107413357089,107413357083,-6,622,3312,40
107413828967,107413828962,-5,974,3842,40
107414747940,107414747930,-10,118,922,40
107417108714,107417108719,5,4970,2498,40
107418051380,107418051374,-6,824,2546,40
107418677057,107418677052,-5,1193,3994,40
107426253178,107426253173,-5,1043,3036,40
107430116898,107430116892,-6,942,3339,40
107430172989,107430172983,-6,1138,4288,40
107430651119,107430651113,-6,1022,4080,40
107430718510,107430718502,-8,1159,3834,40
107432749187,107432749181,-6,931,3157,40
107433097636,107433097654,18,810,4190,40
107447967382,107447967388,6,4738,1960,40
107448287941,107448287935,-6,1222,3844,40
107448941052,107448941056,4,102,1305,40
107449298102,107449298111,9,141,1072,40
107450910130,107450910125,-5,1032,4176,40
107452702402,107452702397,-5,762,1780,40
107454081944,107454081953,9,205,1160,40
107455045163,107455045164,1,2263,1974,40
107465526878,107465526873,-5,1018,4913,40
107466949939,107466949933,-6,1194,4763,40
107469541082,107469541073,-9,846,2925,40
107469662494,107469662479,-15,12,790,40
107471585758,107471585754,-4,1115,2806,40
107472961978,107472961976,-2,1529,1693,40
107475366481,107475366481,0,26381,23962,40
107478478156,107478478151,-5,1071,3860,40
107478640856,107478640874,18,297,702,40
107479006973,107479006980,7,3687,1507,40
107481369526,107481369518,-8,921,3713,40
107493669147,107493669142,-5,591,3265,40
107494160417,107494160425,8,5294,1780,40
107496236582,107496236576,-6,894,2837,40
107498653135,107498653129,-6,1431,4110,40
107499649530,107499649531,1,1597,2193,40
107501556370,107501556365,-5,1241,3126,40
107503198253,107503198255,2,1276,1094,40
107509908452,107509908447,-5,1091,1825,40
107510153132,107510153146,14,71,663,40
107511029570,107511029574,4,1422,907,40
107512314850,107512314850,0,1850,1595,40
107515840647,107515840640,-7,1181,4474,40
107517093647,107517093641,-6,1061,3588,40
107517566661,107517566661,0,327,2614,40
107517949294,107517949313,19,587,1949,40
107529503889,107529503883,-6,1160,3772,40
107530346390,107530346389,-1,1292,2311,40
107530462189,107530462170,-19,123,1131,40
107534295390,107534295386,-4,1078,3255,40
107538822682,107538822677,-5,987,4353,40
107540264615,107540264608,-7,741,2950,40
107541008205,107541008218,13,365,1295,40
107543879733,107543879729,-4,1168,4017,40
107545285841,107545285836,-5,1017,3366,40
107545922710,107545922705,-5,965,3792,40
107547463022,107547463016,-6,915,3155,40
107547669495,107547669513,18,858,4165,40
107549478134,107549478128,-6,996,3490,40
107555239602,107555239595,-7,1214,3575,40
107560214495,107560214489,-6,928,3921,40
107565271523,107565271517,-6,738,2602,40
107572573435,107572573430,-5,764,2878,40
107574111746,107574111741,-5,976,2747,40
107576001604,107576001597,-7,1392,4509,40
107579644321,107579644315,-6,840,3396,40
107580320135,107580320133,-2,335,1493,40
107581605489,107581605485,-4,860,2288,40
107582138128,107582138129,1,1477,2170,40
107583532327,107583532321,-6,1305,5255,40
107587522008,107587522003,-5,520,2780,40
107589711012,107589711006,-6,1146,3525,40
107593219470,107593219463,-7,1262,4920,40
107594539014,107594539030,16,407,1257,40
107597167301,107597167295,-6,1187,3887,40
107599588876,107599588862,-14,1280,193,40
107600357147,107600357139,-8,1195,4698,40
107609206238,107609206233,-5,1367,3752,40
107610531305,107610531300,-5,1328,4282,40
107618300753,107618300757,4,7264,22852,40
107619243951,107619243943,-8,733,2242,40
107622427639,107622427634,-5,1072,3933,40
107625870575,107625870569,-6,941,3491,40
107629709111,107629709105,-6,1238,3841,40
107634509934,107634509933,-1,23981,17501,40
107636430913,107636430905,-8,936,2521,40
107641772987,107641772982,-5,1028,3783,40
107643545499,107643545514,15,971,2503,40
107644575705,107644575699,-6,1136,3591,40
107645616202,107645616209,7,9683,2347,40
107646872479,107646872483,4,1436,1031,40
107648839728,107648839721,-7,1112,3528,40
107651045607,107651045605,-2,1133,1477,40
107658416927,107658416923,-4,806,3634,40
107661950667,107661950670,3,4299,3161,40
107663203546,107663203541,-5,1096,4691,40
107664059779,107664059773,-6,952,3334,40
107664976497,107664976503,6,2074,978,40
107672250365,107672250366,1,1113,1017,40
107676548699,107676548693,-6,996,3815,40
107683455808,107683455811,3,1561,1434,40
107693364293,107693364286,-7,1103,3565,40
107695062078,107695062074,-4,1000,2830,40
107703259646,107703259640,-6,1085,3358,40
107703613286,107703613306,20,397,1482,40
107708465340,107708465333,-7,735,1717,40
107710971618,107710971612,-6,687,3596,40
107712287287,107712287281,-6,1103,4338,40
107718937371,107718937366,-5,1067,2959,40
107724067516,107724067530,14,68,1222,40
107727367567,107727367550,-17,189,1281,40
107733489967,107733489960,-7,996,3956,40
107734092344,107734092359,15,745,3679,40
107734309593,107734309599,6,1743,1130,40
107735140691,107735140685,-6,970,5017,40
107739330107,107739330101,-6,1006,4581,40
107739998330,107739998325,-5,914,2883,40
107740266143,107740266124,-19,611,3673,40
107741473606,107741473601,-5,29030,11580,40
107743305168,107743305163,-5,1293,5028,40
107743608473,107743608468,-5,3006,10881,40
107750443622,107750443621,-1,1340,3082,40
107751688671,107751688668,-3,1346,2577,40
107752594694,107752594713,19,465,1557,40
107771411058,107771411053,-5,1226,4412,40
107777514835,107777514831,-4,1183,3375,40
107781684449,107781684445,-4,1357,4248,40
107789138091,107789138086,-5,964,2917,40
107794468882,107794468875,-7,759,2591,40
107794704547,107794704546,-1,22782,34579,40
107795312964,107795312964,0,1609,1937,40
107795384701,107795384690,-11,435,1229,40
107799180092,107799180087,-5,1968,5235,40
107811710215,107811710210,-5,825,2193,40
107818585827,107818585821,-6,881,2385,40
107818711797,107818711785,-12,248,1183,40
107821818426,107821818420,-6,833,4780,40
107824414003,107824413998,-5,735,2315,40
107824817128,107824817145,17,917,3178,40
107831199436,107831199429,-7,1076,3404,40
107831341975,107831341963,-12,155,1264,40
107838802367,107838802372,5,2225,1173,40
107857511558,107857511563,5,1250,1602,40
107866574944,107866574931,-13,10248,39454,40
107880633407,107880633401,-6,940,3203,40
107882061395,107882061390,-5,928,3689,40
107883160007,107883159990,-17,1307,629,40
107898750961,107898750956,-5,690,2096,40
107900298045,107900298041,-4,690,2835,40
107918966061,107918966054,-7,1063,3163,40
107919524903,107919524898,-5,762,3876,40
107929624846,107929624841,-5,942,3852,40
107929652229,107929652249,20,241,1373,40
107931073264,107931073274,10,299,1293,40
107932304710,107932304705,-5,1241,4325,40
107934839342,107934839336,-6,746,2762,40
107941202457,107941202450,-7,1194,4605,40
107950978010,107950978004,-6,1297,4018,40
107972898282,107972898274,-8,990,3861,40
107975238494,107975238491,-3,1374,1870,40
107978421139,107978421133,-6,1231,3321,40
107986637587,107986637583,-4,506,2418,40
107989464727,107989464720,-7,1151,3778,40
107990929950,107990929951,1,3781,3506,40
107991965226,107991965219,-7,969,3503,40
108001060621,108001060614,-7,1062,2204,40
108010947155,108010947158,3,2598,2101,40
108016725663,108016725655,-8,976,2487,40
108016758328,108016758345,17,295,2577,40
108016902409,108016902410,1,1417,1721,40
108025252910,108025252905,-5,883,3749,40
108025756621,108025756626,5,2097,1473,40
108029308855,108029308848,-7,833,3323,40
108031392297,108031392294,-3,1325,2506,40
108033845898,108033845894,-4,1094,3472,40
108034499870,108034499849,-21,323,964,40
108035620501,108035620495,-6,1185,3893,40
108036244911,108036244893,-18,1339,1811,40
108042085333,108042085326,-7,987,4421,40
108048360345,108048360339,-6,855,4008,40
108050592287,108050592281,-6,863,2768,40
108052077886,108052077902,16,1017,3601,40
108062934816,108062934810,-6,695,3268,40
108067998991,108067998981,-10,674,3613,40
108070767119,108070767114,-5,836,1766,40
108081597258,108081597251,-7,1121,4043,40
108081722147,108081722141,-6,770,3619,40
108085592314,108085592292,-22,1673,78,40
108086428895,108086428890,-5,824,3497,40
108088171655,108088171651,-4,2,1061,40
108092405450,108092405445,-5,732,2839,40
108095994689,108095994691,2,2123,1487,40
108097869798,108097869819,21,856,1471,40
108099435343,108099435338,-5,1778,4917,40
108100210582,108100210577,-5,888,2345,40
108100365696,108100365714,18,408,1280,40
108107836353,108107836345,-8,989,4088,40
108120804534,108120804526,-8,1229,3671,40
108120933638,108120933631,-7,1100,3587,40
108121158734,108121158726,-8,280,1407,40
108125520699,108125520694,-5,1492,3467,40
108128885378,108128885382,4,3108,1554,40
108130139468,108130139485,17,209,1091,40
108131812790,108131812786,-4,1163,3139,40
108133046126,108133046125,-1,1505,2188,40
108141532453,108141532446,-7,955,2759,40
108141618158,108141618165,7,228,832,40
108141778998,108141778999,1,1741,1305,40
108145750546,108145750541,-5,903,3462,40
108148285337,108148285331,-6,1415,3734,40
108148453012,108148453009,-3,801,1679,40
108149745343,108149745338,-5,1012,4095,40
108156696622,108156696614,-8,962,4369,40
108160012781,108160012775,-6,823,3460,40
108160259524,108160259508,-16,258,1067,40
108160432962,108160432957,-5,660,1858,40
108161522054,108161522066,12,495,907,40
108162641778,108162641773,-5,884,3417,40
108163569034,108163569029,-5,1116,3469,40
108167063451,108167063445,-6,1087,2960,40
108168031391,108168031407,16,999,3711,40
108168570165,108168570158,-7,1349,4784,40
108168610268,108168610286,18,215,1079,40
108170397150,108170397156,6,3008,1614,40
108172644751,108172644742,-9,827,5081,40
108172773415,108172773430,15,94,1472,40
108173051285,108173051280,-5,785,3201,40
108180452174,108180452167,-7,1145,3785,40
108187949873,108187949865,-8,928,3070,40
108194989421,108194989414,-7,822,3646,40
108195470167,108195470186,19,985,1615,40
108195737870,108195737865,-5,1279,3037,40
108199190262,108199190257,-5,1218,2830,40
108206389889,108206389883,-6,1053,3489,40
108209196909,108209196905,-4,975,2896,40
108210071639,108210071630,-9,251,1048,40
108211936197,108211936192,-5,891,2846,40
108213568403,108213568397,-6,1150,4037,40
108215750473,108215750466,-7,1126,2954,40
108216635229,108216635238,9,36,2619,40
108217205895,108217205889,-6,814,3481,40
108225270823,108225270817,-6,960,2925,40
108231723314,108231723320,6,894,1154,40
108237445614,108237445608,-6,1230,3814,40
108238319562,108238319557,-5,727,2306,40
108247907689,108247907683,-6,857,3376,40
108251171460,108251171455,-5,1035,3717,40
108254508403,108254508397,-6,966,4016,40
108258072000,108258071995,-5,921,2774,40
108267224952,108267224965,13,243,1472,40
108276814439,108276814433,-6,636,3206,40
108277134620,108277134619,-1,289,1048,40
108277684777,108277684783,6,2275,1091,40
108284973127,108284973119,-8,784,3940,40
108286066864,108286066858,-6,1072,3485,40
108289046930,108289046926,-4,1128,3189,40
108290204325,108290204333,8,146,952,40
108290909059,108290909052,-7,1080,4009,40
108291954356,108291954358,2,1411,1208,40
108292211707,108292211703,-4,542,1550,40
108305127227,108305127221,-6,804,3265,40
108307486174,108307486167,-7,1208,4307,40
108308244117,108308244102,-15,165,1748,40
108308483759,108308483738,-21,606,2388,40
108313975362,108313975358,-4,1129,2065,40
108317716711,108317716705,-6,649,2397,40
108320555154,108320555150,-4,725,2824,40
108328207674,108328207654,-20,1352,706,40
108331818575,108331818567,-8,959,4769,40
108334729034,108334729028,-6,965,4325,40
108335348178,108335348172,-6,846,3185,40
108336494118,108336494111,-7,1292,4386,40
108339179561,108339179566,5,4086,2914,40
108343108466,108343108466,0,1527,2643,40
108344028418,108344028411,-7,1197,4330,40
108344990072,108344990088,16,393,1774,40
108346138154,108346138146,-8,1294,4620,40
108354973382,108354973385,3,1134,1500,40
108357067845,108357067839,-6,1415,5379,40
108362326403,108362326397,-6,1059,3541,40
108363065189,108363065210,21,89,967,40
108371592460,108371592473,13,801,4010,40
108374328509,108374328513,4,1732,1232,40
108377541382,108377541374,-8,1169,3683,40
108377735446,108377735439,-7,762,2844,40
108378274992,108378275002,10,59,1003,40
108383101076,108383101073,-3,1486,2999,40
108383679838,108383679858,20,1683,5282,40
108384224945,108384224938,-7,1176,5026,40
108386413212,108386413223,11,21751,53041,40
108397346895,108397346897,2,1586,1631,40
108400040141,108400040135,-6,1124,2983,40
108407864002,108407863998,-4,1148,3162,40
108410018176,108410018167,-9,1033,3382,40
108410858645,108410858637,-8,1428,4826,40
108411108080,108411108095,15,425,1994,40
108412700395,108412700389,-6,1113,4122,40
108412792947,108412792942,-5,1073,2955,40
108412935198,108412935205,7,2342,1293,40
108420221983,108420221978,-5,1377,4613,40
108420623925,108420623924,-1,32333,49220,40
108421064294,108421064289,-5,1253,4577,40
108424106444,108424106450,6,1458,652,40
108439249370,108439249367,-3,778,3262,40
108447067786,108447067779,-7,1596,4484,40
108447394831,108447394837,6,5972,2094,40
108450900762,108450900757,-5,1124,4726,40
108457820338,108457820333,-5,1243,3755,40
108458630870,108458630891,21,13,1328,40
108462512702,108462512705,3,1153,595,40
108471461937,108471461929,-8,816,1561,40
108473164595,108473164587,-8,970,4207,40
108474006656,108474006650,-6,1369,4543,40
108476027559,108476027553,-6,1122,3198,40
108477826204,108477826201,-3,2313,4494,40
108478130660,108478130654,-6,1527,4591,40
108478239165,108478239179,14,136,750,40
108478545247,108478545246,-1,325,1299,40
108479167205,108479167206,1,73,1000,40
108479772772,108479772790,18,343,2319,40
108480754314,108480754315,1,1205,1509,40
108491873131,108491873125,-6,1016,2980,40
108499661281,108499661286,5,4397,2911,40
108501252358,108501252353,-5,1034,3772,40
108502105566,108502105560,-6,1129,3054,40
108507284529,108507284524,-5,905,14923,40
108507470599,108507470579,-20,329,781,40
108510230043,108510230036,-7,718,4964,40
108513082754,108513082746,-8,1296,2957,40
108519827037,108519827033,-4,1336,2779,40
108520959875,108520959869,-6,916,2908,40
108525492160,108525492166,6,3253,1253,40
108526773409,108526773402,-7,1058,4640,40
108528299707,108528299719,12,1638,1258,40
108529734445,108529734440,-5,1585,4615,40
108531546329,108531546329,0,2263,3841,40
108533783978,108533783986,8,5666,2153,40
108539508683,108539508677,-6,1153,3311,40
108543425666,108543425669,3,1542,1348,40
108552018550,108552018545,-5,1223,4590,40
108560156381,108560156374,-7,959,4471,40
108562866333,108562866328,-5,858,3722,40
108576376979,108576376973,-6,968,3869,40
108577620391,108577620410,19,39,1018,40
108577921296,108577921279,-17,99,854,40
108581513183,108581513178,-5,1176,2489,40
108582047444,108582047435,-9,932,868,40
108583504530,108583504525,-5,1320,3646,40
108595559274,108595559269,-5,1062,3704,40
108596215359,108596215371,12,7,1322,40
108598237487,108598237481,-6,899,4175,40
108599362449,108599362445,-4,681,2045,40
108600175646,108600175650,4,4581,2451,40
108601679126,108601679119,-7,967,3559,40
108605127152,108605127158,6,3057,1884,40
108613989441,108613989434,-7,1170,4165,40
108619619514,108619619509,-5,939,2023,40
108645148495,108645148490,-5,1001,4174,40
108649639211,108649639206,-5,956,3433,40
108658364461,108658364483,22,708,3345,40
108665074352,108665074358,6,12935,6474,40
108665709992,108665709995,3,4367,2764,40
108680177692,108680177686,-6,1000,3886,40
108681556396,108681556401,5,5099,3096,40
108682343414,108682343409,-5,1044,3731,40
108682396909,108682396929,20,115,942,40
108683463176,108683463170,-6,793,4243,40
108684875981,108684875962,-19,184,1659,40
108692926747,108692926741,-6,580,2775,40
108693058622,108693058641,19,223,1191,40
108693849639,108693849635,-4,1051,3521,40
108706323151,108706323147,-4,945,2007,40
108706497966,108706497963,-3,3072,6416,40
108708589898,108708589892,-6,902,3836,40
108713238635,108713238630,-5,794,2147,40
108713370128,108713370113,-15,186,1386,40
108720535796,108720535802,6,7433,2013,40
108726302857,108726302840,-17,1202,994,40
108732540458,108732540454,-4,1152,3583,40
108735351525,108735351518,-7,1100,5502,40
108735440541,108735440554,13,387,1557,40
108739853505,108739853504,-1,1171,1469,40
108741274211,108741274204,-7,1012,5619,40
108749121408,108749121406,-2,2302,3670,40
108749603347,108749603343,-4,1188,4802,40
108759276614,108759276612,-2,943,1930,40
108767106427,108767106422,-5,1087,4081,40
108768428582,108768428573,-9,801,4645,40
108769907500,108769907492,-8,927,3672,40
108775066557,108775066550,-7,63,966,40
108778355037,108778355025,-12,371,103,40
108780581660,108780581653,-7,1433,5212,40
108797172075,108797172069,-6,1047,4998,40
108799718299,108799718291,-8,967,2835,40
108805447819,108805447829,10,11120,46784,40
108809117174,108809117167,-7,1515,6841,40
108815383721,108815383713,-8,918,3294,40
108818994357,108818994351,-6,999,3447,40
108820221721,108820221717,-4,1460,4760,40
108825928774,108825928768,-6,1232,3640,40
108826391114,108826391106,-8,976,3606,40
108826652782,108826652787,5,207,1199,40
108827118165,108827118146,-19,205,1011,40
108827734006,108827733998,-8,150,987,40
108831335807,108831335805,-2,963,2404,40
108837632056,108837632050,-6,779,3316,40
108837814237,108837814259,22,321,1018,40
108837982193,108837982186,-7,937,4712,40
108838263353,108838263357,4,8711,5762,40
108839514353,108839514357,4,2896,1310,40
108841377198,108841377190,-8,839,4758,40
108842075148,108842075139,-9,1162,3327,40
108842222055,108842222058,3,2418,1606,40
108843121984,108843121965,-19,3151,2283,40
108844198907,108844198914,7,3973,683,40
108850724298,108850724292,-6,995,4626,40
108851163662,108851163682,20,377,986,40
108853010290,108853010302,12,16909,15323,40
108861326666,108861326660,-6,1314,4021,40
108874661566,108874661561,-5,921,4548,40
108875283527,108875283545,18,531,2467,40
108883088894,108883088889,-5,806,3851,40
108883990512,108883990505,-7,704,2384,40
108901614226,108901614220,-6,758,3840,40
108902333191,108902333203,12,943,2460,40
108902943967,108902943983,16,3721,1233,40
108908911330,108908911323,-7,881,3107,40
108908989541,108908989522,-19,51,671,40
108911196379,108911196372,-7,1164,4645,40
108911803713,108911803708,-5,1011,2860,40
108912530713,108912530706,-7,1037,3875,40
108912589694,108912589689,-5,735,3326,40
108912619382,108912619382,0,1487,2521,40
108916356458,108916356452,-6,927,3964,40
108917612425,108917612422,-3,465,1114,40
108919985479,108919985473,-6,1140,3533,40
108920059220,108920059213,-7,1555,5088,40
108925271826,108925271818,-8,929,4237,40
108929929643,108929929638,-5,1283,4305,40
108935141318,108935141317,-1,1113,2407,40
108938748924,108938748926,2,910,1208,40
108945797838,108945797845,7,1577,777,40
108948750163,108948750157,-6,887,3616,40
108951454964,108951454957,-7,915,4414,40
108955095370,108955095370,0,10639,47741,40
108962509066,108962509061,-5,1044,3114,40
108964100494,108964100495,1,890,1461,40
108965906610,108965906616,6,2030,1074,40
108966213495,108966213488,-7,1311,5414,40
108974313440,108974313434,-6,818,3626,40
108983541615,108983541608,-7,1129,3615,40
108983640663,108983640656,-7,242,1506,40
108984572508,108984572530,22,800,3781,40
108987037933,108987037927,-6,1157,3588,40
108993523926,108993523921,-5,1207,3665,40
108993561344,108993561322,-22,1000,3536,40
108995005063,108995005061,-2,321,1182,40
108995030141,108995030128,-13,106,993,40
108995043701,108995043703,2,94,84,40
109001517183,109001517179,-4,1021,2998,40
109002833266,109002833261,-5,1660,5831,40
109002977110,109002977114,4,1511,1265,40
109008312698,109008312690,-8,898,3754,40
109012561190,109012561195,5,2874,2529,40
109017493660,109017493662,2,920,1252,40
109019732962,109019732958,-4,803,2397,40
109020782695,109020782702,7,393,1783,40
109028064105,109028064110,5,1269,640,40
109037985713,109037985707,-6,839,3634,40
109038066088,109038066099,11,193,1297,40
109040671482,109040671478,-4,1437,2783,40
109044945407,109044945402,-5,915,3163,40
109046317265,109046317261,-4,1200,3963,40
109046544565,109046544578,13,301,1304,40
109049026619,109049026614,-5,1051,3201,40
109049185902,109049185902,0,8,692,40
109050336142,109050336136,-6,784,2608,40
109056116936,109056116931,-5,890,3376,40
109066111191,109066111194,3,12853,11974,40
109069393314,109069393319,5,1714,2149,40
109070231692,109070231685,-7,1366,2470,40
109070369668,109070369683,15,564,2929,40
109071522580,109071522574,-6,1256,4098,40
109072951649,109072951653,4,2524,1638,40
109075140035,109075140051,16,94,1028,40
109075357745,109075357741,-4,1034,2968,40
109081370758,109081370759,1,1236,1631,40
109086474222,109086474218,-4,1062,3521,40
109095106711,109095106706,-5,823,3156,40
109100654091,109100654086,-5,992,4338,40
109101497487,109101497489,2,2409,1655,40
109102427439,109102427440,1,1897,2310,40
109109544249,109109544243,-6,783,2913,40
109109942062,109109942058,-4,897,4495,40
109114855654,109114855651,-3,1352,2808,40
109116026506,109116026500,-6,1161,2998,40
109123315095,109123315086,-9,1006,4887,40
109131010394,109131010389,-5,836,3684,40
109133459105,109133459101,-4,1214,2955,40
109134121702,109134121697,-5,1094,4688,40
109134476158,109134476158,0,23,951,40
109137235091,109137235085,-6,1247,4618,40
109139969236,109139969258,22,124,1196,40
109140516622,109140516634,12,670,3281,40
109142142513,109142142518,5,3351,2274,40
109148965617,109148965610,-7,1092,3346,40
109149017093,109149017112,19,635,1496,40
109159961229,109159961222,-7,980,3837,40
109161763098,109161763095,-3,1098,3655,40
109161904671,109161904673,2,374,1135,40
109165451968,109165451966,-2,1279,2387,40
109167630429,109167630412,-17,42646,14611,40
109175453546,109175453551,5,1585,874,40
109182442259,109182442253,-6,1078,4411,40
109185690440,109185690432,-8,1124,3205,40
109190725344,109190725335,-9,1059,3504,40
109191037079,109191037064,-15,169,890,40
109197512394,109197512389,-5,1162,3531,40
109199620298,109199620305,7,5866,2477,40
109203363431,109203363426,-5,978,3130,40
109203970316,109203970306,-10,385,1547,40
109204076664,109204076642,-22,238,1390,40
109204871910,109204871905,-5,1114,3351,40
109210793566,109210793558,-8,1165,5228,40
109215423210,109215423192,-18,1936,855,40
109224483231,109224483222,-9,1014,3751,40
109227708794,109227708788,-6,1142,3881,40
109230861266,109230861270,4,1416,888,40
109231301505,109231301500,-5,922,4454,40
109249121841,109249121835,-6,949,3342,40
109249630228,109249630235,7,141,1250,40
109251513562,109251513559,-3,1289,2918,40
109252630007,109252630001,-6,1442,2997,40
109255728521,109255728526,5,1969,997,40
109261873386,109261873381,-5,983,2918,40
109264150596,109264150593,-3,1449,2493,40
109264311372,109264311390,18,103,1038,40
109268266917,109268266905,-12,153,1639,40
109272707038,109272707031,-7,956,4798,40
109274342278,109274342257,-21,99,1637,40
109280137579,109280137576,-3,1091,2750,40
109286894686,109286894681,-5,1115,3707,40
109291158975,109291158970,-5,966,3406,40
109296554202,109296554198,-4,971,2706,40
109300368854,109300368849,-5,1331,4225,40
109301244303,109301244287,-16,49,1237,40
109301418903,109301418920,17,288,1323,40
109302596565,109302596558,-7,803,2942,40
109302627792,109302627805,13,210,1537,40
109308494121,109308494117,-4,863,3306,40
109309719103,109309719118,15,1199,4519,40
109310827764,109310827755,-9,797,4041,40
109312011871,109312011864,-7,1006,3010,40
109319324457,109319324451,-6,845,3299,40
109320027726,109320027742,16,428,1495,40
109327242371,109327242365,-6,1036,2918,40
109338749688,109338749682,-6,1258,4835,40
109339269322,109339269316,-6,735,4890,40
109342645395,109342645389,-6,853,3601,40
109345440550,109345440555,5,3132,1564,40
109347610067,109347610062,-5,809,3550,40
109348610644,109348610629,-15,59,1194,40
109349534670,109349534682,12,186,1926,40
109349752718,109349752700,-18,660,1545,40
109353249038,109353249033,-5,756,2621,40
109353310858,109353310855,-3,2826,37084,40
109357241423,109357241426,3,1015,954,40
109358802593,109358802588,-5,1080,2990,40
109360005205,109360005197,-8,1311,1267,40
109364871425,109364871419,-6,1234,5233,40
109365858437,109365858432,-5,1364,5506,40
109367123448,109367123439,-9,1149,4317,40
109372004375,109372004369,-6,1027,2787,40
109376888154,109376888150,-4,824,5029,40
109378063993,109378063998,5,9386,8540,40
109380003534,109380003529,-5,911,3972,40
109385413885,109385413880,-5,1398,3319,40
109386073380,109386073385,5,13446,8316,40
109390424621,109390424618,-3,1394,3203,40
109391381453,109391381447,-6,1103,3091,40
109395108930,109395108924,-6,667,8753,40
109409500624,109409500634,10,648,2737,40
109409659342,109409659342,0,12,1421,40
109411546346,109411546341,-5,1012,3881,40
109412351245,109412351239,-6,1134,3315,40
109422425721,109422425715,-6,605,4765,40
109423473678,109423473694,16,546,1116,40
109427342678,109427342676,-2,1619,3179,40
109427625137,109427625131,-6,1494,4727,40
109432855924,109432855917,-7,761,3404,40
109439255140,109439255134,-6,1340,4040,40
109442151255,109442151250,-5,1054,2701,40
109454783335,109454783329,-6,1271,3966,40
109456012981,109456012980,-1,1717,2292,40
109457357713,109457357706,-7,1231,4826,40
109460867305,109460867301,-4,852,2684,40
109460944957,109460944951,-6,790,2128,40
109461347245,109461347242,-3,48,1232,40
109470421926,109470421930,4,1855,753,40
109472184774,109472184769,-5,1128,4739,40
109472613363,109472613358,-5,887,3376,40
109481587697,109481587692,-5,974,3416,40
109482018134,109482018145,11,166,838,40
109484150176,109484150168,-8,1098,3855,40
109485084610,109485084604,-6,1194,3931,40
109486149358,109486149359,1,17533,33589,40
109489730039,109489730033,-6,900,3959,40
109491206730,109491206725,-5,1442,7076,40
109497325238,109497325232,-6,1368,2857,40
109502977001,109502976982,-19,1325,602,40
109506702815,109506702809,-6,757,2393,40
109509335850,109509335845,-5,732,2542,40
109512563415,109512563398,-17,8,1552,40
109516972499,109516972494,-5,763,2706,40
109519443517,109519443512,-5,1236,3980,40
109520088982,109520088976,-6,797,3205,40
109520750830,109520750849,19,2437,5445,40
109521181227,109521181221,-6,983,3216,40
109523559993,109523559985,-8,1020,3941,40
109523748174,109523748156,-18,965,2711,40
109530540732,109530540739,7,198,719,40
109530707893,109530707893,0,359,1101,40
109532875686,109532875681,-5,731,2638,40
109533701606,109533701611,5,3960,2375,40
109539382699,109539382706,7,126,1235,40
109539640390,109539640404,14,95,740,40
109540257468,109540257486,18,918,4424,40
109542040138,109542040142,4,1182,1006,40
109543733285,109543733280,-5,1085,2963,40
109547752532,109547752527,-5,1018,3489,40
109557733850,109557733849,-1,1008,1934,40
109565803167,109565803159,-8,762,2117,40
109566479083,109566479076,-7,1034,4915,40
109570590933,109570590926,-7,1025,2308,40
109583887748,109583887743,-5,819,3067,40
109585198316,109585198310,-6,815,3639,40
109593016384,109593016378,-6,801,3174,40
109594804056,109594804049,-7,1463,4285,40
109610404373,109610404365,-8,1012,5606,40
109610533034,109610533030,-4,594,1525,40
109612875273,109612875267,-6,1080,4692,40
109614153479,109614153473,-6,908,3335,40
109614924908,109614924906,-2,224,952,40
109621158722,109621158717,-5,825,3558,40
109621824359,109621824354,-5,1290,4692,40
109623076356,109623076350,-6,1331,5026,40
109634029106,109634029109,3,4320,2857,40
109635251991,109635251984,-7,948,3900,40
109636003951,109636003946,-5,1193,3288,40
109636481443,109636481439,-4,964,2595,40
109636540117,109636540134,17,204,1138,40
109639720875,109639720869,-6,1142,3652,40
109640500654,109640500633,-21,117,1073,40
109640770308,109640770302,-6,1154,4756,40
109641812797,109641812794,-3,256,615,40
109648706323,109648706320,-3,1184,3119,40
109649187639,109649187647,8,168,1289,40
109650451362,109650451356,-6,789,3805,40
109650738468,109650738473,5,10862,7748,40
109654886397,109654886393,-4,880,2724,40
109658116381,109658116381,0,3551,3657,40
109662057155,109662057150,-5,883,3043,40
109662082927,109662082921,-6,1020,3344,40
109662237412,109662237410,-2,32283,68903,40
109663701696,109663701692,-4,1594,5423,40
109666354961,109666354954,-7,847,3989,40
109667288826,109667288821,-5,1033,4264,40
109680963072,109680963066,-6,1423,3285,40
109685133854,109685133848,-6,1054,3010,40
109694372974,109694372967,-7,1001,4162,40
109695513766,109695513762,-4,812,2979,40
109710154301,109710154295,-6,998,3613,40
109717186777,109717186783,6,6088,2913,40
109720057657,109720057651,-6,1142,3333,40
109722007889,109722007884,-5,877,3639,40
109723533234,109723533233,-1,1089,2009,40
109726247473,109726247466,-7,795,4319,40
109727613408,109727613412,4,2818,1709,40
109729335927,109729335921,-6,586,2463,40
109729700907,109729700901,-6,844,3609,40
109733849541,109733849540,-1,1043,2676,40
109735031610,109735031603,-7,749,3649,40
109736346502,109736346521,19,3346,1512,40
109741969497,109741969491,-6,866,3513,40
109742285934,109742285913,-21,130,1375,40
109744210470,109744210470,0,810,1573,40
109750581606,109750581600,-6,987,3568,40
109758604374,109758604369,-5,958,3718,40
109759236750,109759236735,-15,46,699,40
109763458632,109763458635,3,1484,1204,40
109763665775,109763665771,-4,1373,5358,40
109763782089,109763782081,-8,841,3938,40
109769073016,109769073017,1,1406,1935,40
109769530044,109769530039,-5,1151,2727,40
109771199778,109771199771,-7,1062,3986,40
109771362727,109771362721,-6,925,3736,40
109774796315,109774796310,-5,682,2864,40
109780256058,109780256066,8,136,1009,40
109780667182,109780667190,8,63,1362,40
109780794316,109780794339,23,719,3566,40
109780867047,109780867038,-9,698,3059,40
109782052654,109782052632,-22,728,297,40
109786180611,109786180606,-5,797,2454,40
109787633494,109787633489,-5,1186,3505,40
109789515538,109789515533,-5,1030,3190,40
109791193022,109791193022,0,1274,2716,40
109796949217,109796949212,-5,1467,2850,40
109798681514,109798681510,-4,1009,4280,40
109814644367,109814644361,-6,921,3522,40
109820429286,109820429282,-4,1299,2470,40
109822936282,109822936277,-5,775,2486,40
109841175282,109841175277,-5,813,3999,40
109841962983,109841962971,-12,499,3426,40
109842825263,109842825256,-7,901,3305,40
109843852583,109843852567,-16,292,1223,40
109848158954,109848158950,-4,703,3481,40
109848488591,109848488577,-14,1040,2216,40
109851627993,109851627990,-3,1002,2172,40
109852640087,109852640082,-5,904,2769,40
109866603201,109866603205,4,2278,1316,40
109875274654,109875274649,-5,1523,5344,40
109876385399,109876385393,-6,834,3758,40
109882343027,109882343021,-6,678,2522,40
109883316208,109883316202,-6,922,3661,40
109883356550,109883356571,21,1715,4160,40
109883570477,109883570469,-8,84,683,40
109884082110,109884082120,10,323,1662,40
109889973037,109889973030,-7,847,3710,40
109891820595,109891820590,-5,611,3410,40
109893100676,109893100693,17,272,984,40
109897971249,109897971242,-7,575,3683,40
109899382123,109899382115,-8,800,2838,40
109904673603,109904673598,-5,1558,6215,40
109910461123,109910461117,-6,1022,2807,40
109911859334,109911859333,-1,150,1406,40
109930633939,109930633933,-6,1030,3657,40
109934905315,109934905310,-5,941,3929,40
109949118383,109949118376,-7,580,3244,40
109954595093,109954595091,-2,724,1520,40
109954862862,109954862846,-16,797,4406,40
109956061878,109956061895,17,588,3669,40
109959003169,109959003166,-3,1141,3187,40
109960156043,109960156047,4,1477,1189,40
109964654571,109964654565,-6,997,3397,40
109967852304,109967852299,-5,1234,3974,40
109968230854,109968230838,-16,1041,5231,40
109969232664,109969232674,10,159,1002,40
109969857914,109969857917,3,2867,2368,40
109970010854,109970010851,-3,2318,4095,40
109974374547,109974374540,-7,813,2502,40
109977383010,109977382989,-21,1509,4727,40
109983218047,109983218041,-6,1059,4865,40
109985486481,109985486476,-5,1026,3108,40
109985964487,109985964481,-6,1338,3428,40
109995716047,109995716042,-5,966,3898,40
109997392639,109997392634,-5,773,2609,40
110002830023,110002830016,-7,968,3326,40
110003425457,110003425453,-4,679,1168,40
110006020415,110006020408,-7,861,4269,40
110006190164,110006190182,18,40,1836,40
110016362416,110016362410,-6,1016,4098,40
110016509511,110016509524,13,985,3684,40
110024728737,110024728740,3,2073,1949,40
110024881563,110024881567,4,1151,971,40
110025955278,110025955271,-7,1323,5497,40
110026230340,110026230326,-14,92,979,40
110029610500,110029610495,-5,921,3946,40
110036589874,110036589868,-6,1263,5307,40
110042351138,110042351134,-4,1347,3653,40
110053076797,110053076790,-7,1489,4255,40
110057786699,110057786694,-5,855,3643,40
110063952806,110063952802,-4,946,3494,40
110067999997,110068000002,5,1301,670,40
110068136129,110068136123,-6,1352,3575,40
110070045307,110070045310,3,1345,1027,40
110071440054,110071440050,-4,1230,4064,40
110075075206,110075075209,3,2630,1433,40
110075645361,110075645361,0,1213,1377,40
110075718870,110075718864,-6,1042,3523,40
110076097085,110076097103,18,237,1265,40
110077752778,110077752772,-6,1239,3661,40
110078049405,110078049399,-6,790,4010,40
110078606279,110078606267,-12,56,980,40
110079091893,110079091874,-19,97,1086,40
110080237098,110080237093,-5,1242,3280,40
110086676678,110086676681,3,1409,1250,40
110087529658,110087529653,-5,1368,3431,40
110089156718,110089156713,-5,650,3458,40
110093271253,110093271253,0,1788,2836,40
110094425298,110094425293,-5,1715,2690,40
110095835653,110095835646,-7,1042,3486,40
110097685847,110097685841,-6,1494,4919,40
110098477866,110098477861,-5,875,2729,40
110100218654,110100218651,-3,191,558,40
110101565067,110101565062,-5,790,2912,40
110101882214,110101882207,-7,1130,4089,40
110103507767,110103507761,-6,763,2251,40
110105432641,110105432635,-6,1185,4757,40
110105466707,110105466701,-6,835,3822,40
110106796289,110106796282,-7,984,3992,40
110113471296,110113471290,-6,917,2390,40
110118169933,110118169938,5,20496,24653,40
110120012177,110120012171,-6,980,2870,40
110120247065,110120247067,2,2842,1887,40
110121137264,110121137257,-7,773,2065,40
110123103230,110123103224,-6,1196,2988,40
110125131006,110125130999,-7,798,5102,40
110129373736,110129373730,-6,1129,4290,40
110131116503,110131116498,-5,1105,3713,40
110152557563,110152557558,-5,830,3728,40
110156684419,110156684410,-9,1039,3331,40
110167691445,110167691437,-8,1091,3878,40
110175163282,110175163277,-5,1203,3882,40
110175193256,110175193270,14,221,2840,40
110187501166,110187501161,-5,1354,4217,40
110190110338,110190110332,-6,784,3419,40
110192967971,110192967966,-5,1100,3691,40
110195301519,110195301512,-7,822,2627,40
110202410719,110202410714,-5,1066,3081,40
110205031084,110205031078,-6,1628,5282,40
110206797243,110206797235,-8,671,4099,40
110209051038,110209051033,-5,814,4155,40
110211431002,110211430997,-5,956,2613,40
110211671130,110211671126,-4,1149,3420,40
110211701772,110211701762,-10,57,861,40
110215073197,110215073192,-5,1219,4074,40
110223100681,110223100677,-4,1397,1559,40
110235450867,110235450862,-5,948,4690,40
110236803416,110236803409,-7,911,3889,40
110239998792,110239998785,-7,1430,5398,40
110244735167,110244735163,-4,909,2158,40
110249076973,110249076967,-6,800,2166,40
110249524262,110249524278,16,250,1765,40
110260488325,110260488318,-7,918,3249,40
110260591323,110260591318,-5,934,2440,40
110271463144,110271463142,-2,1685,2019,40
110282517443,110282517450,7,3701,1401,40
110289416778,110289416771,-7,1105,3124,40
110293703862,110293703856,-6,1444,2979,40
110315627013,110315627018,5,4356,2345,40
110317388103,110317388097,-6,822,4195,40
110318715039,110318715032,-7,1068,4305,40
110319970371,110319970366,-5,953,3944,40
110321474451,110321474445,-6,602,3356,40
110323866740,110323866735,-5,1066,3790,40
110336140419,110336140425,6,2493,1272,40
110340155730,110340155739,9,302,1069,40
110345396098,110345396094,-4,1134,3855,40
110358566221,110358566221,0,2275,3623,40
110361986451,110361986453,2,252,1014,40
110378809151,110378809145,-6,814,4056,40
110379019510,110379019492,-18,394,1216,40
110379488516,110379488533,17,333,1602,40
110380316877,110380316870,-7,1195,4021,40
110380458229,110380458221,-8,1138,3496,40
110384947497,110384947490,-7,1121,4142,40
110385358447,110385358464,17,276,1269,40
110388115949,110388115947,-2,2248,4039,40
110390924837,110390924830,-7,1074,3559,40
110393643590,110393643592,2,587,1125,40
110394123564,110394123553,-11,1401,3474,40
110396356703,110396356696,-7,689,3125,40
110399767602,110399767596,-6,1076,2865,40
110401791657,110401791654,-3,933,2864,40
110402873867,110402873867,0,1868,2035,40
110403144912,110403144906,-6,1102,3799,40
110404624057,110404624051,-6,1161,3896,40
110407920660,110407920658,-2,1689,1625,40
110408279870,110408279865,-5,859,3154,40
110416237578,110416237572,-6,972,3581,40
110418018151,110418018149,-2,1097,2553,40
110420164529,110420164529,0,1450,2298,40
110433657654,110433657649,-5,1286,3597,40
110433876630,110433876625,-5,839,4225,40
110436525596,110436525591,-5,1341,3675,40
110436887446,110436887425,-21,803,2785,40
110436927887,110436927873,-14,258,1594,40
110444178482,110444178481,-1,5046,5746,40
110445240765,110445240761,-4,1043,5019,40
110448579173,110448579171,-2,1268,1961,40
110448630174,110448630193,19,816,3872,40
110451778351,110451778351,0,2991,3951,40
110452690954,110452690954,0,12684,19788,40
110453988777,110453988769,-8,1172,3834,40
110460348751,110460348744,-7,914,3366,40
110462124186,110462124171,-15,1935,1454,40
110462323755,110462323750,-5,1024,2941,40
110465000730,110465000724,-6,1321,3910,40
110466809282,110466809277,-5,1127,3556,40
110468226027,110468226022,-5,822,3023,40
110469103263,110469103258,-5,535,1472,40
110472093787,110472093789,2,208,753,40
110472964061,110472964054,-7,1138,3999,40
110473802139,110473802134,-5,1174,5111,40
110478053809,110478053812,3,3174,3188,40
110490520682,110490520674,-8,1516,3747,40
110491053936,110491053930,-6,851,1996,40
110496629206,110496629201,-5,1625,3243,40
110500263017,110500263018,1,1264,2059,40
110500869853,110500869846,-7,938,5135,40
110500995032,110500995029,-3,843,2681,40
110501123746,110501123741,-5,971,3191,40
110506458954,110506458947,-7,1962,10576,40
110511317934,110511317929,-5,855,2767,40
110512891435,110512891430,-5,1333,4457,40
110518935703,110518935697,-6,873,3544,40
110529214282,110529214276,-6,1511,4402,40
110529405871,110529405890,19,936,4765,40
110531276438,110531276434,-4,1124,3175,40
110533061247,110533061241,-6,692,3467,40
110539209632,110539209627,-5,780,3025,40
110540380382,110540380375,-7,833,5104,40
110547839749,110547839742,-7,24330,15116,40
110548204981,110548204974,-7,1138,3119,40
110549717976,110549717969,-7,1157,3901,40
110550837019,110550837014,-5,1106,2588,40
110554007759,110554007752,-7,1414,2849,40
110558157829,110558157837,8,20756,54573,40
110564756799,110564756794,-5,1485,3326,40
110568809505,110568809499,-6,1106,3213,40
110569890106,110569890099,-7,928,4546,40
110570135407,110570135394,-13,432,2924,40
110570312741,110570312734,-7,975,3584,40
110570896492,110570896481,-11,246,852,40
110574168470,110574168465,-5,1042,4041,40
110579079730,110579079726,-4,920,3546,40
110580733294,110580733287,-7,851,2736,40
110583891201,110583891195,-6,818,3925,40
110584588471,110584588485,14,2,1126,40
110586983925,110586983919,-6,1054,3366,40
110587035212,110587035227,15,1240,3488,40
110591468141,110591468136,-5,861,3205,40
110595769626,110595769619,-7,971,2202,40
110597494870,110597494862,-8,729,4144,40
110597597134,110597597117,-17,170,1622,40
110600746541,110600746543,2,1002,1237,40
110605430329,110605430323,-6,1132,3562,40
110609130849,110609130842,-7,1209,3934,40
110615040494,110615040490,-4,868,3821,40
110616325643,110616325636,-7,1001,4124,40
110618297873,110618297869,-4,1036,2400,40
110625025390,110625025387,-3,1070,3002,40
110626288965,110626288959,-6,1207,4708,40
110627043032,110627043031,-1,1439,1649,40
110627775304,110627775298,-6,1053,4919,40
110627804511,110627804523,12,52,1256,40
110629590534,110629590541,7,5669,2684,40
110632309648,110632309646,-2,823,2180,40
110633967416,110633967409,-7,680,2677,40
110634045724,110634045743,19,861,3429,40
110643313778,110643313774,-4,685,3072,40
110643426551,110643426551,0,227,929,40
110653447578,110653447573,-5,1072,6017,40
110656362114,110656362107,-7,1109,3375,40
110659209327,110659209318,-9,563,2914,40
110659533013,110659533027,14,268,1038,40
110661122747,110661122742,-5,1083,4208,40
110665370993,110665370985,-8,1163,4109,40
110666301047,110666301042,-5,996,3759,40
110672920522,110672920521,-1,878,2001,40
110673306700,110673306717,17,902,2925,40
110673476057,110673476059,2,980,1162,40
110675856217,110675856222,5,3693,1500,40
110678390510,110678390502,-8,1132,3699,40
110680883442,110680883438,-4,664,3074,40
110682556645,110682556639,-6,1105,3940,40
110685796147,110685796142,-5,765,4005,40
110701127839,110701127834,-5,762,2643,40
110701381166,110701381162,-4,2376,4045,40
110706166752,110706166746,-6,1178,3837,40
110711226210,110711226205,-5,1585,4605,40
110718427846,110718427838,-8,1475,4373,40
110721580790,110721580785,-5,804,4185,40
110725814995,110725814990,-5,1342,4456,40
110729419661,110729419651,-10,195,1063,40
110731416758,110731416751,-7,1356,5372,40
110733465880,110733465874,-6,1017,5108,40
110735901813,110735901818,5,1424,818,40
110741815782,110741815786,4,920,829,40
110745630787,110745630794,7,1713,413,40
110750992928,110750992946,18,59,1104,40
110753910741,110753910742,1,2280,3696,40
110755201347,110755201341,-6,733,3210,40
110755548878,110755548871,-7,1135,3493,40
110759962323,110759962316,-7,1297,4262,40
110762173945,110762173951,6,2457,1071,40
110763944526,110763944521,-5,798,3908,40
110778513946,110778513941,-5,995,4072,40
110788760004,110788760006,2,1113,970,40
110794983868,110794983864,-4,773,2060,40
110795218616,110795218630,14,1062,4889,40
110805804882,110805804879,-3,1302,1944,40
110807672682,110807672675,-7,932,4137,40
110807878288,110807878301,13,18,1098,40
110813080001,110813079994,-7,815,1745,40
110815548564,110815548557,-7,1387,4443,40
110817417821,110817417805,-16,3918,1270,40
110818212070,110818212066,-4,824,3438,40
110823415467,110823415467,0,1639,1155,40
110826315774,110826315768,-6,1249,3453,40
110833542716,110833542705,-11,248,1486,40
110839241586,110839241585,-1,1098,1330,40
110841761598,110841761592,-6,885,3779,40
110842093397,110842093387,-10,115,962,40
110848307941,110848307937,-4,1368,2823,40
110850257908,110850257903,-5,765,2645,40
110856428547,110856428542,-5,948,2221,40
110859203269,110859203262,-7,832,3625,40
110877743757,110877743750,-7,1453,4658,40
110884421198,110884421199,1,2037,3325,40
110887444903,110887444897,-6,987,4147,40
110887513044,110887513042,-2,1485,2248,40
110888274252,110888274254,2,175,1129,40
110893129765,110893129761,-4,1012,2396,40
110893391005,110893391025,20,646,2406,40
110896045402,110896045400,-2,955,1922,40
110904069414,110904069409,-5,741,3430,40
110908064038,110908064054,16,990,2256,40
110915050091,110915050086,-5,1297,3528,40
110915952030,110915952022,-8,1091,2231,40
110917590070,110917590064,-6,1133,3953,40
110918921510,110918921506,-4,642,2862,40
110918948028,110918948046,18,403,3119,40
110923312041,110923312037,-4,1266,1977,40
110924501947,110924501933,-14,917,3333,40
110934186543,110934186537,-6,1270,3455,40
110935372051,110935372058,7,7609,3013,40
110936154525,110936154546,21,1139,4284,40
110943183698,110943183697,-1,914,1468,40
110946675853,110946675846,-7,1075,3875,40
110949706405,110949706399,-6,1299,3757,40
110966070551,110966070546,-5,1036,4147,40
110970153904,110970153898,-6,1122,3485,40
110973931518,110973931512,-6,1576,5497,40
110974517429,110974517409,-20,35,1281,40
110976622551,110976622551,0,1567,1880,40
110978293158,110978293166,8,2216,1029,40
110979723247,110979723246,-1,1326,2072,40
110987835987,110987835983,-4,766,1772,40
110989584861,110989584855,-6,924,3576,40
110995720287,110995720282,-5,944,3388,40
110999059951,110999059946,-5,490,1640,40
111002375709,111002375704,-5,1106,3344,40
111017318538,111017318532,-6,979,3231,40
111017371885,111017371902,17,262,762,40
111021522754,111021522762,8,16125,22733,40
111023572887,111023572881,-6,1022,2770,40
111028685314,111028685310,-4,987,4167,40
111032991519,111032991511,-8,22550,13192,40
111033702751,111033702745,-6,1094,3543,40
111035501818,111035501813,-5,997,3145,40
111038432585,111038432596,11,1548,1637,40
111059164521,111059164515,-6,1329,2875,40
111064185258,111064185250,-8,1236,4146,40
111067265233,111067265225,-8,1350,6303,40
111067756835,111067756830,-5,738,2716,40
111073163975,111073163970,-5,934,3396,40
111073611761,111073611756,-5,896,4992,40
111077289861,111077289854,-7,1301,4965,40
111078306990,111078306985,-5,778,3410,40
111080199774,111080199766,-8,1211,3982,40
111080275204,111080275211,7,19,984,40
111086496306,111086496303,-3,915,2430,40
111096562227,111096562221,-6,836,4306,40
111098513016,111098513031,15,344,1250,40
111100605421,111100605426,5,5036,2316,40
111100955428,111100955435,7,3417,889,40
111104592050,111104592044,-6,1242,4171,40
111105755720,111105755720,0,1002,2930,40
111106174865,111106174858,-7,1506,4928,40
111109956459,111109956463,4,3140,2018,40
111121557154,111121557147,-7,1362,5030,40
111122227106,111122227100,-6,977,3546,40
111135700716,111135700710,-6,1280,3557,40
111144202730,111144202725,-5,840,3802,40
111144332878,111144332896,18,1362,2891,40
111144890007,111144890002,-5,684,1803,40
111148180748,111148180750,2,3094,2770,40
111153611091,111153611086,-5,1352,4414,40
111153643470,111153643464,-6,1397,4660,40
111159678795,111159678790,-5,1453,3492,40
111161478382,111161478375,-7,1346,5143,40
111163825496,111163825490,-6,1070,3669,40
111172649559,111172649553,-6,1119,4180,40
111174319306,111174319301,-5,901,3025,40
111178347519,111178347514,-5,610,1827,40
111178678187,111178678187,0,1059,1254,40
111180583101,111180583095,-6,881,5160,40
111185429934,111185429927,-7,1775,6058,40
111186556851,111186556845,-6,1158,4000,40
111189581306,111189581302,-4,1152,4544,40
111197590662,111197590654,-8,907,3237,40
111197848974,111197848961,-13,20,1086,40
111201898495,111201898489,-6,822,3500,40
111202175142,111202175162,20,1127,1623,40
111203236017,111203236009,-8,796,2556,40
111212612541,111212612537,-4,1080,4138,40
111213154435,111213154425,-10,735,4173,40
111218833166,111218833167,1,1304,1202,40
111230154379,111230154372,-7,1172,4325,40
111231574123,111231574114,-9,1109,3835,40
111232827897,111232827890,-7,1033,2990,40
111233346977,111233346969,-8,809,3789,40
111234024232,111234024212,-20,195,1426,40
111241406514,111241406518,4,2128,1278,40
111241542398,111241542393,-5,1119,4258,40
111242529590,111242529601,11,166,794,40
111245680497,111245680489,-8,929,5442,40
111247308254,111247308248,-6,1743,4995,40
111254500046,111254500041,-5,816,4332,40
111255385719,111255385729,10,286,1136,40
111256715095,111256715089,-6,1343,4931,40
111259603050,111259603045,-5,1001,2519,40
111274502272,111274502266,-6,1052,2643,40
111275112472,111275112490,18,418,2400,40
111278479199,111278479193,-6,1210,5401,40
111283710794,111283710789,-5,925,3516,40
111284581197,111284581216,19,219,1375,40
111285918987,111285918981,-6,1073,4471,40
111287530940,111287530939,-1,1136,2045,40
111291412395,111291412391,-4,701,3919,40
111291640745,111291640746,1,517,3869,40
111292472689,111292472681,-8,911,7504,40
111293252086,111293252083,-3,161,860,40
111294246545,111294246538,-7,1399,4872,40
111298883782,111298883781,-1,2435,3187,40
111300745642,111300745647,5,1625,868,40
111307147842,111307147836,-6,513,1212,40
111310149250,111310149246,-4,72,753,40
111310796024,111310796019,-5,92,694,40
111311385974,111311385968,-6,1109,3329,40
111312340685,111312340679,-6,632,2049,40
111319523946,111319523941,-5,1037,3947,40
111323712359,111323712354,-5,785,3202,40
111328457947,111328457941,-6,1111,4065,40
111330716486,111330716480,-6,1190,5924,40
111333147367,111333147361,-6,1055,2258,40
111333401646,111333401666,20,485,1031,40
111335467769,111335467762,-7,875,4294,40
111342355957,111342355950,-7,1208,4858,40
111342642975,111342642977,2,244,990,40
111343114550,111343114568,18,207,853,40
111343328109,111343328103,-6,1026,4552,40
111346240536,111346240554,18,1078,3963,40
111351572111,111351572106,-5,1137,4434,40
111360864094,111360864087,-7,906,3405,40
111360979086,111360979084,-2,898,1419,40
111364020392,111364020386,-6,1453,3577,40
111369144671,111369144674,3,3677,2835,40
111380176326,111380176318,-8,855,3606,40
111381123822,111381123842,20,1016,2907,40
111382113722,111382113718,-4,632,3421,40
111382547378,111382547370,-8,1274,5071,40
111383434637,111383434630,-7,894,3375,40
111383571269,111383571291,22,264,1004,40
111392658855,111392658850,-5,1055,2994,40
111397197647,111397197642,-5,1099,4106,40
111403449576,111403449579,3,2564,2047,40
111403896284,111403896283,-1,273,1006,40
111407181406,111407181399,-7,729,4379,40
111407850692,111407850686,-6,1185,3158,40
111415189944,111415189948,4,2564,38181,40
111422528323,111422528315,-8,1415,3394,40
111422934315,111422934309,-6,667,3074,40
111426331998,111426331993,-5,888,2788,40
111426484279,111426484259,-20,1318,4768,40
111426864796,111426864790,-6,162,1191,40
111434242021,111434242014,-7,945,4692,40
111449903478,111449903473,-5,1685,5327,40
111452728165,111452728158,-7,880,3096,40
111453871022,111453871034,12,564,1222,40
111455682762,111455682767,5,2815,1119,40
111460029301,111460029300,-1,890,1917,40
111460967126,111460967122,-4,1037,3240,40
111464831398,111464831391,-7,1016,4329,40
111464929102,111464929121,19,518,2742,40
111467385192,111467385185,-7,1002,2233,40
111472056394,111472056388,-6,1310,3710,40
111472185829,111472185835,6,2828,1649,40
111474606894,111474606888,-6,1023,5019,40
111474702103,111474702115,12,388,2394,40
111475611586,111475611582,-4,1476,3999,40
111476898270,111476898265,-5,1166,5365,40
111484808626,111484808627,1,1309,1243,40
111485536747,111485536746,-1,470,1814,40
111491695693,111491695687,-6,957,3811,40
111497415729,111497415726,-3,900,2015,40
111504962165,111504962160,-5,840,4117,40
111505274823,111505274818,-5,1158,4349,40
111508454870,111508454865,-5,1008,3290,40
111515504755,111515504750,-5,1082,4628,40
111516782698,111516782690,-8,1137,5110,40
111518044318,111518044313,-5,1080,3621,40
111522581174,111522581167,-7,1290,3620,40
111536847939,111536847934,-5,745,2520,40
111538348380,111538348374,-6,1093,4058,40
111538526100,111538526091,-9,27,819,40
111540854919,111540854914,-5,916,3958,40
111561496081,111561496075,-6,1185,3396,40
111576954313,111576954306,-7,1053,4391,40
111580308845,111580308839,-6,566,2529,40
111580624902,111580624910,8,360,2189,40
111585454823,111585454819,-4,1470,4427,40
111586602953,111586602947,-6,995,3488,40
111586689566,111586689544,-22,174,1127,40
111600049894,111600049889,-5,1237,4860,40
111601069403,111601069397,-6,823,3430,40
111602654175,111602654170,-5,419,1903,40
111603312710,111603312729,19,232,1178,40
111609127104,111609127098,-6,993,3365,40
111609918522,111609918516,-6,1378,4322,40
111611470133,111611470128,-5,1467,6739,40
111613839398,111613839390,-8,971,3811,40
111626594869,111626594865,-4,754,3406,40
111632360062,111632360055,-7,1116,2252,40
111634068303,111634068297,-6,856,4110,40
111634795476,111634795470,-6,727,2695,40
111634890062,111634890047,-15,927,2792,40
111635779299,111635779291,-8,1029,4227,40
111636169667,111636169665,-2,14705,30875,40
111640253543,111640253537,-6,1128,6021,40
111645632526,111645632531,5,4014,1622,40
111647524565,111647524560,-5,861,2925,40
111648811018,111648811013,-5,784,3794,40
111649414493,111649414475,-18,118,613,40
111660142878,111660142873,-5,892,3510,40
111660398548,111660398563,15,364,1336,40
111661055703,111661055691,-12,1330,6281,40
111662181091,111662181087,-4,1354,3326,40
111663097113,111663097106,-7,984,2845,40
111666746262,111666746256,-6,1015,4028,40
111667198220,111667198216,-4,1185,2707,40
111677092387,111677092381,-6,1079,2853,40
111684549010,111684549005,-5,986,2773,40
111687778614,111687778608,-6,1810,4169,40
111689251464,111689251459,-5,1055,4771,40
111709224780,111709224774,-6,1371,3536,40
111709954118,111709954137,19,1241,1432,40
111710665370,111710665366,-4,771,1847,40
111715011007,111715011002,-5,995,3752,40
111716572163,111716572159,-4,1014,2729,40
111719281678,111719281674,-4,1020,3400,40
111721096655,111721096650,-5,1307,3897,40
111722342213,111722342213,0,1809,2717,40
111722458312,111722458305,-7,1324,5541,40
111725116090,111725116088,-2,1028,2529,40
111730507742,111730507755,13,579,3305,40
111733672558,111733672552,-6,834,3420,40
111736637621,111736637626,5,2866,1406,40
111740102168,111740102161,-7,974,3545,40
111750440630,111750440623,-7,883,3201,40
111761649341,111761649335,-6,854,4688,40
111767937172,111767937165,-7,1563,4539,40
111773460876,111773460871,-5,1118,3890,40
111774491604,111774491596,-8,724,2829,40
111779398011,111779398010,-1,842,988,40
111781676687,111781676674,-13,83,1143,40
111784447239,111784447222,-17,81,1479,40
111797705995,111797705990,-5,1024,4232,40
111803247421,111803247422,1,1093,1308,40
111804805711,111804805705,-6,917,4088,40
111805223477,111805223497,20,240,1045,40
111806348904,111806348898,-6,1222,3242,40
111809875878,111809875873,-5,759,2844,40
111809953488,111809953482,-6,1001,3337,40
111818091770,111818091783,13,1138,237,40
111820025258,111820025252,-6,1046,3408,40
111821493004,111821492998,-6,855,3898,40
111821592531,111821592528,-3,1201,2850,40
111822625599,111822625593,-6,968,3563,40
111823286741,111823286737,-4,1377,3527,40
111824896994,111824896988,-6,642,2294,40
111825496446,111825496442,-4,1074,2520,40
111827847765,111827847758,-7,1099,3377,40
111830947850,111830947844,-6,942,5510,40
111834036599,111834036594,-5,672,1862,40
111837063426,111837063420,-6,1054,2975,40
111849069417,111849069417,0,2737,15335,40
111855086693,111855086706,13,372,1122,40
111861989934,111861989929,-5,1123,4174,40
111864446731,111864446725,-6,835,3687,40
111865743811,111865743810,-1,2647,4446,40
111868365166,111868365167,1,6519,6979,40
111869658578,111869658573,-5,931,2507,40
111871980743,111871980737,-6,534,2216,40
111883402702,111883402696,-6,976,4910,40
111889667974,111889667966,-8,926,3271,40
111890036930,111890036924,-6,1157,4618,40
111890985995,111890985990,-5,999,3380,40
111891505276,111891505266,-10,231,687,40
111891730304,111891730310,6,98,1198,40
111900353079,111900353073,-6,1075,4682,40
111900839787,111900839781,-6,790,3130,40
111906468675,111906468667,-8,1088,3353,40
111906511942,111906511951,9,296,1027,40
111914380379,111914380373,-6,691,2949,40
111916255415,111916255409,-6,1071,3219,40
111927147222,111927147218,-4,1245,3359,40
111929057447,111929057441,-6,993,3927,40
111933184784,111933184785,1,2051,1721,40
111943296411,111943296405,-6,875,3283,40
111956250202,111956250196,-6,1495,4350,40
111959123586,111959123579,-7,1029,3866,40
111959392475,111959392470,-5,781,3344,40
111960162843,111960162839,-4,1060,3781,40
111966078446,111966078441,-5,629,1870,40
111966240647,111966240641,-6,1226,3779,40
111969302603,111969302605,2,1399,1555,40
111975398584,111975398577,-7,1024,4084,40
111981052484,111981052478,-6,1014,2628,40
111981153310,111981153316,6,186,1039,40
111986345727,111986345718,-9,459,2919,40
111990617095,111990617089,-6,929,3484,40
111991053911,111991053905,-6,832,4229,40
111995402570,111995402565,-5,1308,4087,40
111996530643,111996530634,-9,978,2871,40
111996620852,111996620854,2,236,1074,40
111998285537,111998285533,-4,1199,3215,40
111998992950,111998992945,-5,1137,3555,40
111999506000,111999505981,-19,124,1212,40
111999727543,111999727543,0,69,921,40
112004816195,112004816192,-3,1035,2874,40
112005408479,112005408481,2,1752,1380,40
112012888833,112012888826,-7,631,2622,40
112014914048,112014914041,-7,1096,4367,40
112015881627,112015881621,-6,999,3582,40
112018467155,112018467147,-8,1161,4094,40
112030419824,112030419838,14,79,1288,40
112035068396,112035068402,6,4125,1296,40
112041801959,112041801953,-6,893,4167,40
112048312911,112048312906,-5,904,3977,40
112048882877,112048882873,-4,1288,3662,40
112055694629,112055694642,13,12129,48938,40
112060641786,112060641781,-5,878,2868,40
112060890447,112060890426,-21,70,1354,40
112064453834,112064453831,-3,1239,3732,40
112070967041,112070967036,-5,837,3383,40
112071514880,112071514883,3,2591,2090,40
112077021911,112077021905,-6,1139,4665,40
112077682217,112077682213,-4,1310,3546,40
112081251894,112081251889,-5,1040,3337,40
112082204060,112082204062,2,40256,39485,40
112083870161,112083870154,-7,1101,3658,40
112083917278,112083917281,3,1274,1081,40
112084701274,112084701266,-8,832,4311,40
112088485218,112088485213,-5,1006,4484,40
112089594438,112089594441,3,2244,1460,40
112092464236,112092464258,22,337,1132,40
112098382870,112098382858,-12,1183,343,40
112100054064,112100054083,19,105,1627,40
112103868767,112103868762,-5,863,3434,40
112121460385,112121460379,-6,666,3375,40
112128899784,112128899778,-6,845,3037,40
112135716149,112135716144,-5,836,3352,40
112138239131,112138239126,-5,659,2298,40
112138557676,112138557666,-10,231,728,40
112140518141,112140518139,-2,2399,4863,40
112149853729,112149853727,-2,1127,1897,40
112150937119,112150937113,-6,1122,3934,40
112155814607,112155814601,-6,1093,2659,40
112157101195,112157101187,-8,701,3199,40
112158063376,112158063387,11,253,754,40
112158857843,112158857837,-6,1096,3273,40
112161461306,112161461297,-9,1279,4606,40
112162258799,112162258817,18,308,1315,40
112170363298,112170363302,4,4691,3337,40
112172246275,112172246268,-7,753,3204,40
112177030158,112177030153,-5,935,3197,40
112178774506,112178774499,-7,706,1772,40
112179395116,112179395138,22,475,1241,40
112180776016,112180776009,-7,1274,6443,40
112182398526,112182398522,-4,1099,2856,40
112184227148,112184227142,-6,1435,3785,40
112185751034,112185751028,-6,694,3739,40
112189285112,112189285107,-5,1125,3193,40
112189329151,112189329149,-2,225,1152,40
112192250668,112192250654,-14,180,1097,40
112194085561,112194085558,-3,2119,4444,40
112194852314,112194852309,-5,905,3873,40
112195808046,112195808040,-6,790,2589,40
112206397757,112206397775,18,272,886,40
112208206428,112208206421,-7,975,4107,40
112208872746,112208872741,-5,1295,2794,40
112214214418,112214214411,-7,986,3519,40
112225184141,112225184135,-6,1123,3308,40
112225953559,112225953573,14,275,1203,40
112226834530,112226834525,-5,927,3606,40
112227329430,112227329437,7,3978,1105,40
112232809835,112232809832,-3,882,3461,40
112234243728,112234243722,-6,931,4128,40
112249582379,112249582373,-6,720,3448,40
112249845680,112249845677,-3,15,1373,40
112253118598,112253118594,-4,1105,2544,40
112256965198,112256965190,-8,801,2637,40
112263671479,112263671473,-6,1144,3861,40
112265127785,112265127794,9,48152,19226,40
112268968944,112268968937,-7,1,2255,40
112269129765,112269129783,18,651,4158,40
112269230173,112269230190,17,928,4910,40
112269851918,112269851913,-5,1132,3542,40
112273644735,112273644735,0,1841,1927,40
112283675499,112283675493,-6,1091,5074,40
112284256211,112284256206,-5,823,2938,40
112286068374,112286068391,17,488,2854,40
112289184999,112289184993,-6,798,3308,40
112289274493,112289274511,18,127,956,40
112290018623,112290018616,-7,1098,3849,40
112290412294,112290412278,-16,233,1018,40
112292308062,112292308057,-5,1203,3230,40
112296911130,112296911129,-1,3217,6755,40
112297359899,112297359899,0,405,1234,40
112305193755,112305193749,-6,1229,3874,40
112307864026,112307864018,-8,783,8723,40
112308233311,112308233308,-3,763,3553,40
112312273412,112312273427,15,192,1463,40
112314535829,112314535822,-7,524,1435,40
112316260373,112316260365,-8,822,3188,40
112319058377,112319058369,-8,1087,3119,40
112322491551,112322491545,-6,666,3297,40
112322761429,112322761441,12,243,964,40
112330327223,112330327227,4,1625,1318,40
112338453148,112338453145,-3,177,1720,40
112345454518,112345454510,-8,774,2828,40
112349952873,112349952878,5,5075,2189,40
112362684290,112362684299,9,10690,31236,40
112365948008,112365948005,-3,1003,2789,40
112366322092,112366322092,0,314,1088,40
112367893533,112367893528,-5,1035,2836,40
112372235019,112372235011,-8,621,2590,40
112375483289,112375483281,-8,1173,6516,40
112378068397,112378068393,-4,1035,3117,40
112378192166,112378192182,16,293,1390,40
112379835053,112379835047,-6,1132,4154,40
112381257598,112381257594,-4,2188,5166,40
112383124526,112383124546,20,360,1359,40
112387942058,112387942057,-1,2535,4309,40
112389567631,112389567623,-8,876,4036,40
112390855397,112390855392,-5,484,2850,40
112391147857,112391147851,-6,927,2790,40
112392147825,112392147819,-6,1056,3872,40
112394457082,112394457077,-5,1062,3119,40
112397523202,112397523198,-4,945,2709,40
112398965198,112398965191,-7,1039,4427,40
112399481271,112399481283,12,232,2106,40
112410892454,112410892446,-8,898,5931,40
112418561934,112418561940,6,10001,4177,40
112419019563,112419019556,-7,1036,3059,40
112430940890,112430940883,-7,1244,5191,40
112431106286,112431106294,8,3718,1115,40
112435549736,112435549730,-6,1209,4681,40
112440572922,112440572917,-5,1597,3701,40
112442156495,112442156491,-4,647,2207,40
112452093245,112452093239,-6,1176,2891,40
112453727994,112453727990,-4,838,3588,40
112454534515,112454534510,-5,868,2547,40
112457757929,112457757922,-7,1313,4499,40
112458610329,112458610323,-6,903,3954,40
112464046645,112464046640,-5,769,3236,40
112465139676,112465139681,5,3831,1669,40
112466176327,112466176321,-6,1319,4052,40
112472259399,112472259394,-5,916,3828,40
112482039994,112482039989,-5,1079,3720,40
112482278622,112482278606,-16,694,3026,40
112487596754,112487596749,-5,748,4042,40
112487862597,112487862617,20,499,2247,40
112492237696,112492237696,0,21794,15256,40
112493511072,112493511067,-5,1056,4130,40
112495808497,112495808490,-7,1128,3156,40
112496369733,112496369718,-15,254,967,40
112499979349,112499979344,-5,1505,3243,40
112500265936,112500265953,17,448,913,40
112505318015,112505318033,18,271,776,40
112510836595,112510836590,-5,1008,3748,40
112511817105,112511817097,-8,876,2178,40
112515938660,112515938656,-4,1443,4287,40
112521644878,112521644870,-8,1337,7065,40
112522610647,112522610642,-5,1049,3700,40
112528248181,112528248199,18,1161,5411,40
112533061828,112533061821,-7,1073,3565,40
112533388773,112533388767,-6,864,3343,40
112543563206,112543563202,-4,929,3570,40
112545033948,112545033968,20,1002,3239,40
112546987727,112546987719,-8,927,2876,40
112552356886,112552356880,-6,1478,3648,40
112552878169,112552878162,-7,785,3594,40
112556757190,112556757186,-4,929,2598,40
112567281623,112567281618,-5,972,2465,40
112575905970,112575905965,-5,719,3364,40
112578688667,112578688662,-5,443,1962,40
112578929888,112578929894,6,211,1035,40
112582490967,112582490960,-7,931,4319,40
112583868112,112583868113,1,1786,2368,40
112587060637,112587060631,-6,1049,4801,40
112592432902,112592432898,-4,734,3314,40
112599149671,112599149666,-5,946,4429,40
112599617627,112599617620,-7,1059,3904,40
112601904182,112601904177,-5,1002,4257,40
112604839206,112604839207,1,1452,1770,40
112607342414,112607342409,-5,873,3233,40
112607424232,112607424246,14,456,1292,40
112607626114,112607626109,-5,945,3724,40
112615593610,112615593605,-5,1055,3765,40
112618963743,112618963738,-5,1216,2233,40
112628157534,112628157525,-9,709,3474,40
112633504004,112633504025,21,1967,1047,40
112635093053,112635093053,0,1237,1568,40
112637821966,112637821961,-5,706,2594,40
112641734538,112641734531,-7,897,3390,40
112647302582,112647302575,-7,881,4476,40
112649911497,112649911490,-7,682,3401,40
112651980671,112651980665,-6,1081,2881,40
112657644279,112657644272,-7,1554,4280,40
112659282441,112659282439,-2,1343,2372,40
112661847036,112661847039,3,3662,2619,40
112662564567,112662564560,-7,1023,3271,40
112663308045,112663308049,4,2804,1965,40
112664995993,112664995987,-6,876,2890,40
112665143327,112665143326,-1,1734,3095,40
112667356895,112667356888,-7,1089,3935,40
112670157365,112670157359,-6,824,3462,40
112670375597,112670375614,17,369,592,40
112671330781,112671330788,7,10461,29756,40
112674873998,112674873992,-6,1029,2798,40
112675438743,112675438755,12,577,2284,40
112675778893,112675778885,-8,1057,3182,40
112678127013,112678127007,-6,1128,2647,40
112678866418,112678866415,-3,993,1561,40
112680810358,112680810353,-5,1300,5646,40
112683985313,112683985304,-9,1208,99,40
112685943813,112685943832,19,273,1377,40
112691827794,112691827789,-5,1081,4462,40
112692061590,112692061585,-5,953,2809,40
112692488750,112692488744,-6,1046,2685,40
112694289326,112694289307,-19,933,300,40
112696587191,112696587191,0,20379,87592,40
112697619568,112697619563,-5,1239,3556,40
112701234039,112701234033,-6,757,2728,40
112705837846,112705837840,-6,1325,5129,40
112711257329,112711257324,-5,974,3158,40
112716268116,112716268138,22,326,1249,40
112719969410,112719969406,-4,802,2535,40
112720018485,112720018478,-7,140,1052,40
112723719911,112723719909,-2,1424,3087,40
112724764488,112724764481,-7,831,3117,40
112731003099,112731003090,-9,863,4629,40
112731557244,112731557263,19,43,1786,40
112736220606,112736220599,-7,821,3551,40
112736561301,112736561295,-6,772,3281,40
112740277613,112740277607,-6,911,3452,40
112740793507,112740793501,-6,1777,5130,40
112743433021,112743433014,-7,1475,4300,40
112744032950,112744032970,20,968,4449,40
112744657885,112744657886,1,194,1144,40
112745307287,112745307282,-5,750,3367,40
112748231559,112748231555,-4,915,3194,40
112748948859,112748948852,-7,961,5031,40
112749454270,112749454266,-4,1364,4035,40
112750870230,112750870243,13,14050,36142,40
112751691228,112751691223,-5,469,1264,40
112753971098,112753971090,-8,868,3694,40
112755019731,112755019726,-5,1120,3954,40
112758570525,112758570518,-7,419,5474,40
112758825957,112758825975,18,693,2921,40
112759358194,112759358185,-9,921,5227,40
112768162024,112768162026,2,15181,17709,40
112769459675,112769459668,-7,712,2741,40
112772231089,112772231086,-3,1011,2630,40
112781221931,112781221924,-7,998,3014,40
112784346911,112784346906,-5,472,1523,40
112784828519,112784828536,17,788,2724,40
112790484563,112790484555,-8,875,3280,40
112790795672,112790795682,10,530,2475,40
112793271082,112793271077,-5,975,3882,40
112794160192,112794160186,-6,1290,4553,40
112795369009,112795369017,8,3985,2179,40
112800762281,112800762280,-1,1434,2160,40
112801627936,112801627930,-6,1152,3896,40
112802447801,112802447794,-7,1043,3578,40
112807036313,112807036307,-6,1023,3859,40
112809065295,112809065291,-4,1459,5457,40
112819616047,112819616050,3,1227,1510,40
112822341290,112822341285,-5,1153,3752,40
112828874522,112828874517,-5,1123,3847,40
112830069158,112830069153,-5,1140,2907,40
112830250578,112830250572,-6,1161,3835,40
112830676360,112830676375,15,544,3765,40
112837134065,112837134068,3,1740,1028,40
112839820926,112839820920,-6,866,3395,40
112842159368,112842159383,15,317,1560,40
112843509183,112843509179,-4,1313,5460,40
112849960026,112849960035,9,7391,34649,40
112861132215,112861132220,5,242,1409,40
112861688686,112861688686,0,266,1665,40
112863826595,112863826588,-7,1089,3840,40
112864094485,112864094478,-7,1535,3996,40
112864743040,112864743051,11,1118,2976,40
112874221535,112874221530,-5,1181,3643,40
112877196446,112877196449,3,3410,3080,40
112886669716,112886669715,-1,2986,3247,40
112888479291,112888479285,-6,1005,4012,40
112891435789,112891435784,-5,1314,3637,40
112891830952,112891830962,10,607,2530,40
112898673297,112898673290,-7,1086,4821,40
112898906645,112898906641,-4,865,3947,40
112900011326,112900011327,1,2417,1970,40
112900466222,112900466241,19,473,1419,40
112906057023,112906057018,-5,1164,4445,40
112911659030,112911659026,-4,887,2464,40
112911825470,112911825490,20,87,1174,40
112912999455,112912999450,-5,2351,8187,40
112920656206,112920656200,-6,2240,5125,40
112931839591,112931839594,3,1754,1692,40
112933532104,112933532101,-3,1409,2367,40
112934665450,112934665450,0,747,1286,40
112935761005,112935761001,-4,832,3003,40
112937535066,112937535059,-7,1131,3774,40
112941906994,112941906988,-6,1307,4065,40
112944216199,112944216214,15,241,944,40
112948309454,112948309447,-7,1458,5575,40
112952087674,112952087670,-4,975,4215,40
112960919898,112960919892,-6,1163,3470,40
112962016093,112962016074,-19,65,663,40
112965299307,112965299306,-1,1229,3720,40
112967370391,112967370385,-6,1061,2692,40
112972422553,112972422550,-3,1458,3654,40
112974844457,112974844453,-4,732,3385,40
112975285901,112975285902,1,1570,1481,40
112975371599,112975371594,-5,707,2849,40
112977303811,112977303817,6,3722,1372,40
112979133194,112979133188,-6,1163,2833,40
112984030420,112984030414,-6,1126,3000,40
112986169764,112986169761,-3,922,1974,40
112987688050,112987688045,-5,1236,3361,40
112992174002,112992174000,-2,41119,26090,40
112997458858,112997458853,-5,729,3550,40
112997532702,112997532718,16,509,1610,40
113001143853,113001143848,-5,1498,3416,40
113005540672,113005540669,-3,4709,10317,40
113008328705,113008328698,-7,843,3128,40
113016684969,113016684962,-7,1119,2913,40
113023431155,113023431150,-5,898,2894,40
113023935580,113023935574,-6,1183,3086,40
113029992179,113029992170,-9,770,2310,40
113031842275,113031842269,-6,980,4354,40
113038732312,113038732305,-7,912,3547,40
113040730100,113040730096,-4,1110,2108,40
113045722664,113045722657,-7,684,2870,40
113046283804,113046283796,-8,105,1008,40
113048076270,113048076265,-5,214,1623,40
113055324462,113055324469,7,7712,2290,40
113059315719,113059315714,-5,1087,3490,40
113069149363,113069149358,-5,210,2906,40
113069338419,113069338413,-6,848,3774,40
113074873154,113074873147,-7,798,3901,40
113077407313,113077407306,-7,845,4034,40
113077794213,113077794207,-6,1047,2743,40
113082704406,113082704401,-5,1032,3816,40
113082870394,113082870389,-5,792,4510,40
113083183088,113083183103,15,718,3293,40
113083483643,113083483636,-7,1223,4395,40
113090372026,113090372030,4,3517,2440,40
113092960906,113092960903,-3,270,3133,40
113093020830,113093020845,15,933,4478,40
113095446201,113095446197,-4,1316,3497,40
113096272654,113096272647,-7,1180,5565,40
113096466164,113096466171,7,239,1054,40
113097933558,113097933553,-5,1083,3500,40
113104143262,113104143257,-5,1114,2938,40
113104721431,113104721426,-5,1046,2906,40
113112696239,113112696234,-5,1126,4137,40
113121873074,113121873069,-5,1052,2746,40
113122584829,113122584817,-12,279,1625,40
113124396612,113124396603,-9,299,780,40
113124778790,113124778785,-5,1021,3090,40
113127436596,113127436590,-6,1152,3325,40
113128444958,113128444966,8,54,983,40
113131887712,113131887705,-7,1008,4424,40
113132057029,113132057029,0,236,1164,40
113134381406,113134381400,-6,960,4719,40
113136755077,113136755071,-6,794,3159,40
113144946851,113144946846,-5,1250,4156,40
113152515003,113152514999,-4,752,2589,40
113152778350,113152778367,17,717,2583,40
113156511810,113156511805,-5,1214,2768,40
113157250254,113157250248,-6,931,2996,40
113157635814,113157635821,7,141,2092,40
113158827249,113158827243,-6,1243,3286,40
113160193834,113160193828,-6,794,3798,40
113162173185,113162173178,-7,1234,5259,40
113162532820,113162532819,-1,72,1337,40
113163957870,113163957886,16,414,1191,40
113164910890,113164910885,-5,921,3257,40
113166571121,113166571116,-5,697,3469,40
113170436346,113170436338,-8,1097,4976,40
113170891976,113170891970,-6,748,3005,40
113175716279,113175716274,-5,745,3144,40
113176404763,113176404757,-6,1354,4876,40
113176740172,113176740181,9,14456,20831,40
113178993362,113178993355,-7,966,3898,40
113179782360,113179782363,3,1743,2194,40
113181972641,113181972637,-4,1095,4742,40
113190569850,113190569848,-2,1165,2744,40
113200103573,113200103566,-7,1293,4870,40
113204445713,113204445706,-7,1239,4039,40
113204762630,113204762642,12,408,2095,40
113205701141,113205701135,-6,919,3729,40
113205916684,113205916706,22,607,1799,40
113235093722,113235093717,-5,1000,3868,40
113235857804,113235857817,13,85,1478,40
113236777350,113236777370,20,271,708,40
113237523503,113237523497,-6,1040,3589,40
113240257667,113240257662,-5,1071,2986,40
113241781097,113241781099,2,3157,3932,40
113241957290,113241957283,-7,1206,3453,40
113242384365,113242384380,15,871,3603,40
113258697244,113258697244,0,1730,22844,40
113265778522,113265778517,-5,1026,2714,40
113266969390,113266969387,-3,609,1467,40
113270881932,113270881925,-7,1110,3400,40
113274827283,113274827277,-6,881,2876,40
113275434479,113275434481,2,206,838,40
113275952208,113275952201,-7,1020,3392,40
113276214176,113276214168,-8,1156,4512,40
113276668378,113276668373,-5,754,3873,40
113276727390,113276727382,-8,67,1013,40
113278157686,113278157679,-7,1240,5247,40
113279092202,113279092181,-21,896,1579,40
113283124894,113283124889,-5,1120,3835,40
113283939142,113283939163,21,1119,4729,40
113287829950,113287829947,-3,1111,2226,40
113293491078,113293491071,-7,796,3249,40
113293808048,113293808058,10,11618,24418,40
113297296945,113297296936,-9,1488,5520,40
113304931391,113304931385,-6,1216,3683,40
113307414403,113307414397,-6,744,2595,40
113307597021,113307597020,-1,2416,3832,40
113308634195,113308634189,-6,942,3809,40
113311254548,113311254542,-6,831,4620,40
113320167457,113320167453,-4,853,3896,40
113320273990,113320273991,1,2122,15848,40
113324044451,113324044447,-4,1264,3567,40
113329387579,113329387580,1,1254,15795,40
113337023206,113337023200,-6,1096,3939,40
113338151520,113338151516,-4,419,1800,40
113340659347,113340659342,-5,1028,3722,40
113346533595,113346533589,-6,1035,1681,40
113351142236,113351142230,-6,1087,4143,40
113351496069,113351496082,13,124,887,40
113359222162,113359222158,-4,1762,4110,40
113365833532,113365833526,-6,900,4557,40
113366915141,113366915157,16,1014,3582,40
113369426875,113369426870,-5,1002,3407,40
113381434893,113381434889,-4,1134,4813,40
113381468134,113381468152,18,269,1619,40
113389369234,113389369228,-6,865,3421,40
113391124758,113391124773,15,108,428,40
113394315285,113394315281,-4,1230,3541,40
113394985163,113394985158,-5,720,2406,40
113399992870,113399992863,-7,883,3497,40
113404592161,113404592160,-1,1493,1765,40
113405763537,113405763541,4,3030,1719,40
113415527347,113415527345,-2,1739,2600,40
113421550680,113421550674,-6,776,3628,40
113421598654,113421598634,-20,1151,2908,40
113424405980,113424405970,-10,965,4259,40
113424649845,113424649837,-8,195,1559,40
113425325373,113425325390,17,345,1392,40
113439594302,113439594297,-5,411,2304,40
113439856981,113439857003,22,889,2679,40
113441691615,113441691610,-5,688,3033,40
113445584470,113445584465,-5,1344,4064,40
113448965387,113448965379,-8,995,4632,40
113450738527,113450738506,-21,40,1057,40
113452123534,113452123528,-6,1133,3885,40
113456447614,113456447606,-8,987,3513,40
113456724740,113456724753,13,269,1337,40
113456913489,113456913481,-8,1275,5611,40
113468846767,113468846762,-5,1051,2937,40
113474627377,113474627370,-7,1055,3870,40
113475602765,113475602747,-18,2065,1945,40
113480745763,113480745758,-5,1499,3960,40
113492158113,113492158107,-6,1153,4108,40
113496029950,113496029946,-4,549,1853,40
113500762728,113500762720,-8,955,3540,40
113505286430,113505286425,-5,1189,4493,40
113508969843,113508969840,-3,848,1557,40
113512934225,113512934215,-10,1080,3795,40
113521793319,113521793318,-1,1085,1473,40
113523004218,113523004213,-5,671,2959,40
113529772866,113529772861,-5,829,3111,40
113537059542,113537059537,-5,943,3233,40
113538277134,113538277153,19,533,1837,40
113541612667,113541612662,-5,1152,3689,40
113552411949,113552411942,-7,786,3310,40
113558027443,113558027435,-8,1276,4369,40
113558194407,113558194394,-13,100,1380,40
113565418702,113565418697,-5,957,3988,40
113578023150,113578023145,-5,1032,3946,40
113581580998,113581580990,-8,1284,4836,40
113583534373,113583534368,-5,1262,2520,40
113588964125,113588964123,-2,1079,2856,40
113591676526,113591676521,-5,552,4106,40
113594633915,113594633906,-9,1130,4044,40
113599607942,113599607936,-6,626,2934,40
113601384542,113601384550,8,126,924,40
113603949651,113603949652,1,3610,3590,40
113613109465,113613109459,-6,793,3145,40
113618802745,113618802739,-6,1216,4807,40
113626091091,113626091084,-7,838,4379,40
113626828354,113626828347,-7,724,2418,40
113629189318,113629189313,-5,1061,2420,40
113633510894,113633510886,-8,428,1623,40
113646122432,113646122426,-6,1035,3317,40
113646481495,113646481512,17,732,3002,40
113647118659,113647118652,-7,1080,4503,40
113650032697,113650032691,-6,1414,4199,40
113653076429,113653076422,-7,1115,3583,40
113656112225,113656112227,2,1245,1332,40
113660470638,113660470633,-5,1386,5331,40
113665323550,113665323545,-5,818,4465,40
113674733010,113674733005,-5,659,2993,40
113678447978,113678447977,-1,1658,2078,40
113679577334,113679577329,-5,1272,4023,40
113680429766,113680429761,-5,1180,5152,40
113680462574,113680462586,12,204,1485,40
113681760284,113681760293,9,206,1330,40
113682569614,113682569610,-4,482,1534,40
113683086792,113683086801,9,231,2901,40
113684751511,113684751505,-6,994,1990,40
113690387149,113690387142,-7,795,3192,40
113693543026,113693543018,-8,1084,5240,40
113695677618,113695677613,-5,1409,5468,40
113697801410,113697801405,-5,1405,3751,40
113706553822,113706553818,-4,828,4348,40
113707528150,113707528170,20,328,863,40
113709129231,113709129224,-7,924,4336,40
113715895195,113715895189,-6,1106,4394,40
113723182861,113723182855,-6,1005,3205,40
113725472846,113725472840,-6,947,4576,40
113729385415,113729385408,-7,1053,4629,40
113729565314,113729565318,4,2453,1752,40
113731814417,113731814413,-4,919,2882,40
113742496840,113742496834,-6,1347,3688,40
113744052879,113744052873,-6,1019,2733,40
113749318578,113749318573,-5,1036,3211,40
113749985124,113749985131,7,120,1242,40
113763463030,113763463022,-8,1157,5456,40
113764663650,113764663645,-5,614,2187,40
113765119723,113765119716,-7,1153,3621,40
113778688101,113778688103,2,3300,2746,40
113779596338,113779596331,-7,1422,3651,40
113786670127,113786670122,-5,1202,4739,40
113787785294,113787785290,-4,885,3088,40
113788605014,113788605008,-6,1486,5953,40
113792953702,113792953697,-5,1343,7014,40
113793735858,113793735852,-6,1025,2932,40
113798270833,113798270822,-11,627,4247,40
113806883650,113806883656,6,4372,2220,40
113808163529,113808163526,-3,1096,2373,40
113811584847,113811584842,-5,1216,3848,40
113812752863,113812752858,-5,924,2607,40
113817665545,113817665539,-6,1109,4172,40
113826224617,113826224610,-7,1053,3931,40
113831909982,113831909977,-5,777,3170,40
113833331539,113833331543,4,2052,1570,40
113835236369,113835236369,0,1669,2234,40
113838988837,113838988833,-4,374,2306,40
113839644204,113839644197,-7,1014,5828,40
113849631921,113849631917,-4,919,2846,40
113850370680,113850370678,-2,945,2052,40
113851857357,113851857341,-16,131,1176,40
113853143665,113853143673,8,20028,23378,40
113853818363,113853818369,6,1149,1208,40
113854033234,113854033229,-5,804,3926,40
113854498183,113854498199,16,242,1063,40
113859857540,113859857551,11,279,1091,40
113862138541,113862138534,-7,815,3762,40
113862561353,113862561347,-6,1042,2729,40
113863692592,113863692585,-7,1183,4342,40
113863903292,113863903293,1,1097,1035,40
113866280190,113866280184,-6,1107,3535,40
113870387095,113870387108,13,398,2388,40
113871109185,113871109178,-7,1195,4541,40
113876813345,113876813338,-7,1126,4886,40
113885643591,113885643584,-7,1213,3741,40
113885956911,113885956921,10,290,1142,40
113890247952,113890247946,-6,765,2669,40
113890906499,113890906493,-6,750,2743,40
113891552550,113891552565,15,955,3684,40
113901837882,113901837879,-3,1183,2163,40
113907448954,113907448945,-9,266,1076,40
113907721321,113907721316,-5,1091,3292,40
113913276180,113913276174,-6,32755,12492,40
113916061757,113916061751,-6,1050,3800,40
113916294004,113916293994,-10,156,937,40
113920836585,113920836591,6,2471,925,40
113922003558,113922003560,2,4080,3717,40
113924765538,113924765533,-5,602,3396,40
113926430051,113926430046,-5,1122,4650,40
113928567014,113928567010,-4,1233,3667,40
113929912975,113929912970,-5,793,2475,40
113930388601,113930388594,-7,1019,3445,40
113932227219,113932227215,-4,715,2782,40
113932832853,113932832848,-5,1001,3293,40
113934409200,113934409202,2,1863,1530,40
113934485300,113934485295,-5,1009,2794,40
113935330706,113935330701,-5,1691,4921,40
113947307053,113947307069,16,304,1205,40
113949079471,113949079489,18,361,2073,40
113957949549,113957949543,-6,867,2538,40
113958230711,113958230725,14,843,4235,40
113959611865,113959611861,-4,805,3426,40
113959985613,113959985594,-19,212,1421,40
113967143170,113967143171,1,1917,1560,40
113973915960,113973915953,-7,1114,4094,40
113974372318,113974372298,-20,1227,3724,40
113974644934,113974644949,15,416,2709,40
113976775735,113976775730,-5,2780,11770,40
113977736807,113977736806,-1,1144,2084,40
113980864722,113980864722,0,1124,1311,40
113980991461,113980991441,-20,312,1454,40
113982453933,113982453932,-1,23714,36442,40
113986837463,113986837470,7,2078,1150,40
114001506721,114001506725,4,1834,2229,40
114003454014,114003454015,1,5408,20122,40
114009096910,114009096911,1,1507,1364,40
114011263530,114011263523,-7,886,2867,40
114012774359,114012774353,-6,803,3777,40
114014200879,114014200885,6,2785,1705,40
114015157503,114015157523,20,24,1055,40
114022464079,114022464072,-7,1052,4005,40
114026591091,114026591084,-7,1290,4006,40
114031486659,114031486653,-6,772,2467,40
114035721118,114035721113,-5,944,3257,40
114040433109,114040433113,4,4076,2399,40
114042038438,114042038432,-6,1020,3267,40
114054236227,114054236222,-5,981,3689,40
114068522844,114068522839,-5,1277,3318,40
114072112635,114072112629,-6,1013,4036,40
114079024626,114079024619,-7,1259,5224,40
114081578393,114081578387,-6,1249,3240,40
114083044911,114083044904,-7,623,2267,40
114083998446,114083998438,-8,1401,2865,40
114093868247,114093868241,-6,892,4654,40
114101653093,114101653094,1,1213,1373,40
114104001954,114104001950,-4,1028,2346,40
114107118527,114107118521,-6,610,2436,40
114107581827,114107581822,-5,861,4619,40
114107626343,114107626331,-12,287,1450,40
114108286413,114108286405,-8,1056,3777,40
114116201807,114116201802,-5,1182,3662,40
114116884289,114116884293,4,2379,1824,40
114118269539,114118269534,-5,940,3382,40
114119895678,114119895672,-6,1199,4254,40
114131630488,114131630482,-6,1168,3780,40
114134079982,114134079976,-6,1292,3045,40
114135849618,114135849618,0,2254,1576,40
114141002435,114141002428,-7,610,3962,40
114143924419,114143924413,-6,871,2271,40
114144221104,114144221092,-12,22502,15099,40
114145053711,114145053713,2,1617,1952,40
114161951587,114161951582,-5,699,3852,40
114162206198,114162206198,0,87,1056,40
114167768171,114167768167,-4,1350,3575,40
114169103868,114169103861,-7,1039,3861,40
114176594499,114176594493,-6,1294,4742,40
114190684791,114190684785,-6,1081,4865,40
114197814816,114197814818,2,2856,3343,40
114200617158,114200617153,-5,855,3913,40
114203181709,114203181714,5,3895,2827,40
114203211289,114203211282,-7,1455,3170,40
114204236221,114204236214,-7,1055,3547,40
114204707653,114204707646,-7,821,3360,40
114207562533,114207562528,-5,1165,3463,40
114208859034,114208859028,-6,1162,4176,40
114212723097,114212723104,7,2744,1093,40
114221628473,114221628467,-6,794,3350,40
114222273949,114222273969,20,985,3296,40
114233962031,114233962025,-6,1041,3729,40
114234764086,114234764079,-7,1357,4145,40
114237767410,114237767405,-5,700,2881,40
114239037447,114239037440,-7,879,3565,40
114242650546,114242650541,-5,750,3450,40
114253941839,114253941834,-5,1080,3779,40
114257004302,114257004295,-7,641,3504,40
114267723698,114267723693,-5,844,2999,40
114267789814,114267789809,-5,1320,3831,40
114268127398,114268127390,-8,1150,4345,40
114268910854,114268910850,-4,1037,3421,40
114273710953,114273710949,-4,1084,3463,40
114275708542,114275708561,19,1137,1950,40
114280104496,114280104490,-6,906,3878,40
114280774356,114280774377,21,899,3714,40
114280839240,114280839234,-6,1118,3687,40
114280965692,114280965691,-1,1781,862,40
114289722010,114289722005,-5,1175,3949,40
114290403166,114290403161,-5,934,2448,40
114296959833,114296959832,-1,37237,17149,40
114297337566,114297337549,-17,1373,3653,40
114300405014,114300405013,-1,1214,2006,40
114303050437,114303050433,-4,1165,2573,40
114303538477,114303538493,16,727,3709,40
114305738977,114305738972,-5,1182,3499,40
114306129046,114306129066,20,395,1371,40
114306664047,114306664045,-2,493,2789,40
114307561131,114307561125,-6,954,2968,40
114310740518,114310740513,-5,1143,4002,40
114312704340,114312704335,-5,1188,3280,40
114313226629,114313226634,5,12597,8308,40
114325705993,114325705989,-4,934,4138,40
114325836297,114325836292,-5,1014,2192,40
114325933086,114325933106,20,772,2470,40
114330588606,114330588603,-3,461,2058,40
114333386986,114333386980,-6,774,2476,40
114333847951,114333847968,17,91,936,40
114335160234,114335160227,-7,1062,4599,40
114337294986,114337294980,-6,1273,3903,40
114343280914,114343280906,-8,1176,3861,40
114343711783,114343711802,19,321,1311,40
114352842438,114352842432,-6,1023,3003,40
114363752989,114363752983,-6,954,3767,40
114364151272,114364151249,-23,33,1135,40
114372510131,114372510125,-6,863,2364,40
114373113870,114373113886,16,404,1780,40
114373880445,114373880439,-6,833,2755,40
114375285949,114375285942,-7,1033,4506,40
114377729301,114377729296,-5,952,3907,40
114378067774,114378067787,13,979,10445,40
114379990902,114379990902,0,1146,2008,40
114384040101,114384040094,-7,1179,4411,40
114386216067,114386216061,-6,939,3915,40
114388032581,114388032587,6,2646,1143,40
114398402676,114398402670,-6,1021,3090,40
114398442831,114398442825,-6,1044,3503,40
114401307395,114401307390,-5,894,2930,40
114401877701,114401877717,16,983,2672,40
114403224238,114403224243,5,1262,915,40
114405436790,114405436798,8,1530,842,40
114408940536,114408940532,-4,576,3280,40
114410335961,114410335957,-4,1076,2843,40
114410394109,114410394129,20,645,4312,40
114414469137,114414469143,6,5296,2526,40
114431210569,114431210562,-7,1070,4396,40
114431561904,114431561918,14,421,1133,40
114432454819,114432454814,-5,938,3772,40
114432534422,114432534404,-18,373,1287,40
114440397403,114440397398,-5,1174,4265,40
114442225638,114442225633,-5,1212,3182,40
114447959370,114447959364,-6,1106,1999,40
114452016767,114452016781,14,687,2841,40
114464751326,114464751321,-5,832,3426,40
114483366106,114483366101,-5,1371,3130,40
114485838144,114485838137,-7,1123,3403,40
114489301569,114489301564,-5,1214,4821,40
114490237889,114490237885,-4,954,4182,40
114493443197,114493443203,6,2925,1180,40
114495730839,114495730831,-8,1193,3432,40
114499337130,114499337125,-5,959,3588,40
114499574319,114499574332,13,958,3619,40
114503894362,114503894355,-7,1276,4148,40
114508336949,114508336949,0,1012,1632,40
114512112482,114512112480,-2,1963,3402,40
114516205705,114516205701,-4,1379,3831,40
114537900022,114537900017,-5,992,2651,40
114544510518,114544510513,-5,1257,2655,40
114551333200,114551333194,-6,1310,3570,40
114552467800,114552467813,13,755,2481,40
114557663343,114557663337,-6,729,2835,40
114559107367,114559107362,-5,988,3599,40
114559763535,114559763531,-4,1779,2445,40
114561173913,114561173914,1,1613,1477,40
114561399647,114561399649,2,699,797,40
114562465883,114562465879,-4,1386,3913,40
114563271762,114563271748,-14,68,1287,40
114565168638,114565168630,-8,647,3512,40
114565244308,114565244310,2,1777,29853,40
114567683822,114567683817,-5,990,2767,40
114572983735,114572983730,-5,1110,3395,40
114575014939,114575014930,-9,846,3883,40
114577078229,114577078223,-6,996,3749,40
114593676602,114593676597,-5,749,3732,40
114593806606,114593806614,8,192,1018,40
114597312707,114597312707,0,1248,1489,40
114605863054,114605863047,-7,1192,4456,40
114606439089,114606439083,-6,811,3500,40
114612772799,114612772793,-6,862,4788,40
114612913605,114612913622,17,1074,2805,40
114613533123,114613533116,-7,1133,4199,40
114615214089,114615214094,5,9275,3890,40
114618431682,114618431674,-8,1100,3639,40
114619790408,114619790401,-7,935,3976,40
114623447738,114623447741,3,1198,978,40
114624590426,114624590421,-5,1061,5267,40
114625112830,114625112845,15,478,1959,40
114639227923,114639227915,-8,905,3605,40
114641257590,114641257583,-7,1089,3355,40
114642416979,114642416974,-5,943,3210,40
114646765658,114646765653,-5,907,3567,40
114647536848,114647536858,10,72,665,40
114650703878,114650703873,-5,1196,2426,40
114653086764,114653086759,-5,1227,4278,40
114654477222,114654477219,-3,581,2639,40
114654941706,114654941698,-8,1321,3555,40
114663607539,114663607530,-9,823,3711,40
114663777956,114663777977,21,318,923,40
114667751017,114667751010,-7,744,3022,40
114670907088,114670907083,-5,952,2919,40
114675305989,114675305985,-4,693,2203,40
114675607440,114675607433,-7,1105,4705,40
114679327817,114679327818,1,1286,1765,40
114684058578,114684058571,-7,783,3069,40
114694757059,114694757053,-6,553,2568,40
114695448170,114695448172,2,2230,1629,40
114700149782,114700149777,-5,692,3039,40
114701024173,114701024193,20,954,3759,40
114703547163,114703547157,-6,764,3006,40
114711369430,114711369424,-6,898,3584,40
114713529599,114713529591,-8,920,3065,40
114718707887,114718707882,-5,1354,3253,40
114720730829,114720730824,-5,530,2508,40
114724968149,114724968145,-4,953,3433,40
114726834836,114726834839,3,2055,1213,40
114728888949,114728888947,-2,1078,2281,40
114737513644,114737513637,-7,739,3758,40
114737760822,114737760818,-4,210,1019,40
114738429676,114738429665,-11,189,1285,40
114741485443,114741485437,-6,1371,5035,40
114746694793,114746694798,5,7207,4017,40
114749567519,114749567518,-1,1258,2022,40
114749696565,114749696585,20,370,2227,40
114754630991,114754630989,-2,1091,3081,40
114756699831,114756699826,-5,915,4146,40
114759029945,114759029938,-7,646,1668,40
114764532190,114764532186,-4,1206,3765,40
114765816684,114765816679,-5,1022,3723,40
114769517385,114769517379,-6,638,4111,40
114770167662,114770167683,21,337,1245,40
114770753536,114770753529,-7,937,4186,40
114777926786,114777926779,-7,984,5389,40
114778687269,114778687279,10,346,2122,40
114781405861,114781405854,-7,914,2893,40
114783938683,114783938677,-6,925,3083,40
114784489156,114784489150,-6,781,3051,40
114785355498,114785355501,3,1194,1684,40
114793526791,114793526786,-5,927,3176,40
114795577242,114795577235,-7,980,3711,40
114798806127,114798806127,0,105,869,40
114800710665,114800710658,-7,1168,3486,40
114807296861,114807296856,-5,805,3281,40
114811796514,114811796507,-7,699,4102,40
114813114396,114813114390,-6,961,3747,40
114813691681,114813691678,-3,1601,2908,40
114816357490,114816357485,-5,1570,4754,40
114826407691,114826407685,-6,1047,3421,40
114827474886,114827474881,-5,2359,6358,40
114829397512,114829397508,-4,1464,4331,40
114829467913,114829467908,-5,1338,3543,40
114837531107,114837531100,-7,1205,3484,40
114843456115,114843456108,-7,1560,6073,40
114846197969,114846197970,1,1998,2144,40
114851558820,114851558814,-6,908,3302,40
114853041433,114853041438,5,5462,3106,40
114863174550,114863174545,-5,742,4222,40
114864245995,114864246000,5,2792,1623,40
114865270489,114865270483,-6,913,2103,40
114870563730,114870563726,-4,995,3311,40
114870623114,114870623108,-6,1170,4521,40
114870905183,114870905178,-5,1086,3088,40
114875317678,114875317672,-6,1212,4009,40
114877455390,114877455386,-4,1012,4067,40
114883284175,114883284173,-2,1386,2306,40
114885338694,114885338693,-1,1640,3544,40
114885389694,114885389713,19,834,2451,40
114892051432,114892051427,-5,736,2403,40
114895305422,114895305418,-4,489,1804,40
114903851975,114903851969,-6,1073,3561,40
114909279273,114909279267,-6,886,3582,40
114914781736,114914781742,6,4105,1306,40
114920566767,114920566765,-2,1461,2261,40
114927629234,114927629238,4,3749,2351,40
114928651735,114928651729,-6,1000,3566,40
114929765886,114929765887,1,175,740,40
114937726640,114937726635,-5,1053,2753,40
114937880984,114937881002,18,695,2748,40
114943542301,114943542299,-2,1273,2599,40
114949062545,114949062540,-5,1026,3297,40
114949671533,114949671539,6,1857,893,40
114956099731,114956099724,-7,712,2476,40
114958068115,114958068110,-5,774,2647,40
114958644568,114958644572,4,239,1374,40
114959582543,114959582561,18,145,1133,40
114961841481,114961841474,-7,1499,4906,40
114964014642,114964014654,12,543,2340,40
114966831174,114966831169,-5,994,4139,40
114971835848,114971835842,-6,1168,3547,40
114973806103,114973806098,-5,1171,2758,40
114975387565,114975387559,-6,1286,3545,40
114975557509,114975557489,-20,884,4606,40
114981010058,114981010053,-5,866,3547,40
114998120363,114998120357,-6,1056,4093,40
115002013842,115002013838,-4,843,3105,40
115002624559,115002624553,-6,726,2392,40
115003215366,115003215366,0,194,998,40
115008645599,115008645594,-5,841,2304,40
115014600546,115014600539,-7,1230,3871,40
115021684386,115021684382,-4,768,1832,40
115023921187,115023921181,-6,996,5750,40
115024047784,115024047798,14,165,1448,40
115028952695,115028952687,-8,762,3198,40
115034010230,115034010222,-8,1166,3430,40
115035049788,115035049775,-13,290,1947,40
115035739573,115035739569,-4,102,1020,40
115041613830,115041613825,-5,1174,3098,40
115043738801,115043738796,-5,1016,1831,40
115049467693,115049467687,-6,821,3621,40
115049896597,115049896613,16,473,3380,40
115053437752,115053437746,-6,27408,15473,40
115055710425,115055710444,19,577,1729,40
115056795269,115056795263,-6,1274,3281,40
115056973469,115056973459,-10,123,923,40
115057496404,115057496387,-17,171,1000,40
115068589813,115068589808,-5,1000,3969,40
115073597660,115073597666,6,1174,744,40
115073978422,115073978426,4,144,1127,40
115074199389,115074199369,-20,756,3501,40
115078201176,115078201170,-6,1307,4048,40
115082384710,115082384705,-5,1120,3012,40
115093019655,115093019652,-3,680,1864,40
115094598995,115094598989,-6,1144,3626,40
115095678487,115095678506,19,918,2266,40
115097329756,115097329750,-6,1577,5790,40
115104606604,115104606598,-6,1055,2712,40
115106544566,115106544562,-4,674,3023,40
115112995244,115112995237,-7,664,1959,40
115120971332,115120971331,-1,821,1172,40
115123093710,115123093705,-5,1015,4423,40
115125846697,115125846691,-6,1278,3863,40
115128453301,115128453295,-6,1226,3293,40
115128803363,115128803359,-4,1180,4544,40
115138155723,115138155716,-7,905,3795,40
115139268238,115139268254,16,455,1636,40
115139905354,115139905348,-6,755,3049,40
115141647710,115141647702,-8,932,3376,40
115151909564,115151909558,-6,1309,3972,40
115153627764,115153627773,9,12860,33203,40
115164258707,115164258702,-5,922,3405,40
115167131854,115167131850,-4,1163,3337,40
115171497565,115171497573,8,4555,1607,40
115175287579,115175287571,-8,1047,2751,40
115178090638,115178090639,1,2876,2537,40
115178246090,115178246093,3,1274,1541,40
115178538630,115178538645,15,638,5370,40
115187222731,115187222726,-5,1041,4706,40
115189341470,115189341449,-21,130,1218,40
115195302171,115195302151,-20,3623,1242,40
115195415459,115195415454,-5,1630,4045,40
115195706551,115195706571,20,62,981,40
115196132218,115196132214,-4,878,4628,40
115203607799,115203607796,-3,1191,2938,40
115210787695,115210787690,-5,1714,2644,40
115212855049,115212855043,-6,956,3797,40
115213826167,115213826162,-5,1156,3229,40
115215830008,115215830002,-6,686,2998,40
115219312095,115219312090,-5,1014,3718,40
115221525235,115221525229,-6,1266,3861,40
115222038134,115222038155,21,152,1518,40
115222478526,115222478538,12,150,1052,40
115225662198,115225662193,-5,1293,5054,40
115226664704,115226664717,13,1145,4000,40
115230112799,115230112794,-5,1105,4389,40
115230249684,115230249678,-6,1468,5264,40
115231983533,115231983538,5,3712,1717,40
115233367014,115233367009,-5,973,2495,40
115233967135,115233967124,-11,193,1856,40
115240787841,115240787847,6,1495,1225,40
115252206450,115252206428,-22,1006,4361,40
115256924947,115256924946,-1,2460,2659,40
115260005531,115260005537,6,3078,1968,40
115260351982,115260351975,-7,846,2605,40
115261028614,115261028597,-17,841,3714,40
115263907574,115263907589,15,427,2804,40
115266943805,115266943799,-6,1056,2927,40
115269836683,115269836679,-4,1043,3386,40
115278137827,115278137822,-5,865,3533,40
115282983959,115282983953,-6,1010,3406,40
115284899871,115284899869,-2,1300,2110,40
115286668850,115286668844,-6,877,4105,40
115289556366,115289556365,-1,1106,2621,40
115293706028,115293706022,-6,961,3655,40
115294598711,115294598722,11,724,3060,40
115303887263,115303887257,-6,700,4051,40
115307392143,115307392133,-10,880,2574,40
115311946582,115311946579,-3,1096,3271,40
115312561871,115312561870,-1,69,863,40
115315946474,115315946469,-5,575,2590,40
115316355831,115316355824,-7,646,3073,40
115319205814,115319205809,-5,921,3644,40
115320821326,115320821322,-4,1224,3973,40
115331761348,115331761343,-5,1106,3317,40
115337637431,115337637423,-8,723,2877,40
115346286809,115346286801,-8,1460,11429,40
115348175410,115348175406,-4,918,3229,40
115351184908,115351184901,-7,1291,3504,40
115353388963,115353388956,-7,1015,3277,40
115353791853,115353791849,-4,501,2483,40
115355321322,115355321317,-5,947,3312,40
115357350643,115357350638,-5,975,3219,40
115357754872,115357754890,18,720,5416,40
115361267045,115361267038,-7,1179,3884,40
115362778554,115362778550,-4,712,2087,40
115362930495,115362930482,-13,17,1231,40
115363114502,115363114518,16,306,1533,40
115369870798,115369870788,-10,757,3082,40
115373443762,115373443758,-4,813,3920,40
115373825955,115373825949,-6,1232,3457,40
115374722850,115374722831,-19,1093,442,40
115380251635,115380251630,-5,706,3969,40
115384829778,115384829774,-4,843,3874,40
115392442930,115392442924,-6,1167,4439,40
115393260566,115393260567,1,2377,3783,40
115397803923,115397803918,-5,875,3349,40
115398135720,115398135734,14,277,1364,40
115401107517,115401107510,-7,984,4227,40
115402937109,115402937104,-5,1145,3590,40
115413809579,115413809581,2,131,1080,40
115418322943,115418322923,-20,1735,459,40
115421134966,115421134972,6,9699,35067,40
115421421272,115421421286,14,625,3804,40
115432650394,115432650389,-5,910,4691,40
115433109054,115433109070,16,774,2629,40
115435545450,115435545444,-6,1111,6552,40
115436384848,115436384861,13,696,2619,40
115444733215,115444733209,-6,1136,3496,40
115450285128,115450285150,22,499,2457,40
115456284307,115456284304,-3,525,1153,40
115457263807,115457263803,-4,955,2981,40
115460076299,115460076295,-4,2009,4922,40
115464136710,115464136703,-7,790,4194,40
115471419300,115471419301,1,1644,2245,40
115471478798,115471478817,19,504,3022,40
115478518894,115478518887,-7,1410,4365,40
115478690132,115478690121,-11,1015,4152,40
115480031657,115480031672,15,1408,3857,40
115487858973,115487858979,6,2706,1030,40
115491900879,115491900874,-5,1204,3787,40
115492200578,115492200572,-6,1151,3684,40
115501145165,115501145159,-6,1475,5067,40
115506606970,115506606966,-4,636,3464,40
115514771480,115514771483,3,1451,997,40
115515021001,115515020996,-5,816,4002,40
115523361321,115523361309,-12,1466,4216,40
115524325111,115524325104,-7,32902,14301,40
115537507601,115537507596,-5,1538,3864,40
115537949944,115537949963,19,926,4417,40
115541531871,115541531865,-6,784,3273,40
115541930477,115541930472,-5,1424,4444,40
115560314591,115560314586,-5,814,2370,40
115567707490,115567707482,-8,738,3652,40
115570465471,115570465467,-4,595,2180,40
115571046870,115571046879,9,548,2548,40
115577151157,115577151151,-6,744,2641,40
115578539728,115578539726,-2,2015,2729,40
115579468723,115579468720,-3,1073,2272,40
115587573890,115587573885,-5,729,2837,40
115588483354,115588483349,-5,1339,3196,40
115589600727,115589600724,-3,992,2046,40
115590523823,115590523817,-6,1424,3700,40
115591497960,115591497974,14,647,3123,40
115592738920,115592738918,-2,832,1521,40
115593203105,115593203098,-7,861,4501,40
115594874200,115594874181,-19,528,2872,40
115609185854,115609185851,-3,592,2601,40
115612010314,115612010310,-4,617,3727,40
115612225951,115612225964,13,1187,3287,40
115623036088,115623036083,-5,975,3020,40
115629852978,115629852975,-3,966,2495,40
115633570591,115633570585,-6,1101,2958,40
115643463542,115643463556,14,519,3457,40
115643768079,115643768073,-6,1010,3408,40
115644824417,115644824410,-7,922,3084,40
115657381358,115657381353,-5,624,3649,40
115659889551,115659889549,-2,1451,2270,40
115663381417,115663381411,-6,948,3692,40
115663583769,115663583762,-7,1831,4502,40
115665406906,115665406900,-6,1316,4820,40
115665657775,115665657778,3,417,1760,40
115665781206,115665781205,-1,347,916,40
115670118342,115670118336,-6,806,2489,40
115670632925,115670632930,5,2421,1301,40
115672100305,115672100298,-7,882,3931,40
115675167281,115675167277,-4,1685,4719,40
115686447602,115686447594,-8,1405,3279,40
115697195840,115697195834,-6,989,3843,40
115699244264,115699244258,-6,1151,3712,40
115703446193,115703446190,-3,2506,6039,40
115705708068,115705708061,-7,848,4436,40
115713744318,115713744311,-7,1117,4747,40
115713831224,115713831205,-19,127,1591,40
115717762498,115717762491,-7,1138,3830,40
115722702107,115722702102,-5,1124,2953,40
115727935717,115727935713,-4,1896,4457,40
115738065865,115738065859,-6,692,2739,40
115746700935,115746700930,-5,853,1622,40
115747250558,115747250577,19,395,2669,40
115751925429,115751925424,-5,984,3526,40
115753498639,115753498633,-6,1075,4393,40
115753525351,115753525371,20,166,1518,40
115755122856,115755122850,-6,1371,3561,40
115756217324,115756217335,11,146,1346,40
115757566212,115757566206,-6,1405,3765,40
115762433629,115762433621,-8,1606,2697,40
115762973428,115762973421,-7,1041,5157,40
115763927886,115763927897,11,319,1894,40
115765853637,115765853631,-6,1080,4192,40
115768046283,115768046280,-3,1604,3302,40
115770674827,115770674821,-6,1376,5656,40
115777849797,115777849790,-7,755,3557,40
115779551635,115779551629,-6,840,4425,40
115779697911,115779697925,14,232,1427,40
115779934399,115779934390,-9,1110,3389,40
115798234571,115798234565,-6,690,3499,40
115798957231,115798957242,11,189,896,40
115801484379,115801484373,-6,1201,4001,40
115801574108,115801574098,-10,79,700,40
115802732611,115802732606,-5,359,2200,40
115811863254,115811863258,4,7915,17650,40
115820309014,115820309009,-5,899,2263,40
115828281567,115828281561,-6,814,3325,40
115837938951,115837938945,-6,804,2367,40
115841710380,115841710374,-6,746,2399,40
115848660169,115848660173,4,2366,2471,40
115855860497,115855860498,1,2477,2673,40
115859870053,115859870047,-6,1243,3475,40
115860124622,115860124605,-17,236,1312,40
115863728241,115863728234,-7,976,3586,40
115864220932,115864220934,2,286,2297,40
115865542682,115865542677,-5,1184,4170,40
115867590751,115867590745,-6,1891,6808,40
115875086190,115875086182,-8,1057,4234,40
115875667110,115875667115,5,21,1193,40
115877205539,115877205533,-6,808,4427,40
115884261187,115884261182,-5,597,2882,40
115884708805,115884708820,15,107,1240,40
115892276010,115892276004,-6,804,3578,40
115907654043,115907654037,-6,1443,4945,40
115914715659,115914715654,-5,1127,4592,40
115924760878,115924760873,-5,1220,4005,40
115928987745,115928987738,-7,1027,4230,40
115933124469,115933124464,-5,1382,4541,40
115933900898,115933900893,-5,1217,3962,40
115934355479,115934355499,20,440,1341,40
115935185412,115935185406,-6,1427,4472,40
115935307836,115935307817,-19,272,1484,40
115943973879,115943973873,-6,1222,4175,40
115944979851,115944979845,-6,1150,5800,40
115956185548,115956185541,-7,1433,4735,40
115958638643,115958638636,-7,1253,3177,40
115958676296,115958676311,15,264,1239,40
115968016159,115968016155,-4,505,2880,40
115973681974,115973681969,-5,1052,4763,40
115975035103,115975035096,-7,1022,4495,40
115988401904,115988401898,-6,922,2784,40
115994562183,115994562179,-4,873,2855,40
116021620137,116021620132,-5,1356,4212,40
116023224879,116023224874,-5,1172,3842,40
116023621623,116023621606,-17,197,1286,40
116023758063,116023758045,-18,117,1059,40
116024935890,116024935885,-5,1762,5406,40
116025387275,116025387268,-7,838,4649,40
116032345422,116032345417,-5,751,2573,40
116035804398,116035804393,-5,1209,2609,40
116036335062,116036335055,-7,1444,4673,40
116038002294,116038002287,-7,1059,2862,40
116041253106,116041253102,-4,805,2572,40
116045403338,116045403344,6,1953,1027,40
116045893966,116045893961,-5,987,3272,40
116048297372,116048297366,-6,1102,3709,40
116058357459,116058357454,-5,843,3030,40
116073101652,116073101650,-2,21368,10198,40
116079101858,116079101854,-4,1004,4646,40
116079744210,116079744205,-5,1267,4087,40
116081923415,116081923409,-6,900,2616,40
116083770029,116083770024,-5,1301,3617,40
116083853670,116083853655,-15,154,941,40
116084361894,116084361889,-5,597,2857,40
116094803611,116094803606,-5,1102,4365,40
116098436033,116098436028,-5,1228,3279,40
116103951884,116103951879,-5,1649,4134,40
116107193003,116107193004,1,616,1193,40
116118963095,116118963092,-3,1511,3186,40
116119451278,116119451266,-12,937,3834,40
116124824381,116124824384,3,33215,28550,40
116130911829,116130911837,8,17236,23171,40
116132264980,116132264994,14,391,1187,40
116134237739,116134237734,-5,1080,3736,40
116134519675,116134519667,-8,897,3142,40
116138907093,116138907096,3,10546,23294,40
116140416913,116140416909,-4,1354,2418,40
116142856001,116142855994,-7,1508,4268,40
116143943653,116143943666,13,380,1645,40
116144663575,116144663569,-6,1004,2531,40
116155716760,116155716757,-3,895,3053,40
116156198799,116156198797,-2,1415,3153,40
116166366739,116166366733,-6,859,5127,40
116166510807,116166510807,0,252,1637,40
116169959263,116169959258,-5,906,2034,40
116174348619,116174348614,-5,308,1408,40
116174884077,116174884069,-8,151,1838,40
116184394942,116184394945,3,2090,2107,40
116187346862,116187346856,-6,823,3078,40
116190062535,116190062529,-6,1093,2446,40
116194909701,116194909694,-7,1057,3709,40
116195572607,116195572622,15,528,2580,40
116199126783,116199126776,-7,689,3775,40
116203341131,116203341126,-5,870,3307,40
116205945750,116205945744,-6,1125,3574,40
116206578270,116206578266,-4,874,3372,40
116208029765,116208029760,-5,1293,3960,40
116209226055,116209226060,5,7578,4708,40
116210698565,116210698558,-7,806,4186,40
116219135462,116219135467,5,3803,2377,40
116219320665,116219320667,2,2133,1733,40
116220584378,116220584373,-5,801,3596,40
116225427950,116225427949,-1,765,1276,40
116225968810,116225968806,-4,1019,3231,40
116237897522,116237897517,-5,1404,3961,40
116238442458,116238442451,-7,1238,3338,40
116238556774,116238556769,-5,966,3682,40
116241878562,116241878554,-8,1354,4741,40
116246000798,116246000790,-8,415,2828,40
116248218855,116248218849,-6,998,5526,40
116248539278,116248539277,-1,844,8777,40
116248616818,116248616811,-7,735,3370,40
116248815125,116248815142,17,263,1653,40
116252614781,116252614779,-2,1767,3417,40
116255528986,116255528981,-5,1279,2446,40
116258357639,116258357639,0,2283,2376,40
116258923027,116258923022,-5,986,1669,40
116261495365,116261495382,17,338,1395,40
116263841591,116263841585,-6,1152,3356,40
116263962725,116263962720,-5,730,3132,40
116264098780,116264098765,-15,1139,3945,40
116267164086,116267164092,6,5912,1703,40
116269010288,116269010285,-3,2132,5052,40
116269052488,116269052483,-5,1253,2983,40
116269664259,116269664254,-5,904,3665,40
116281546439,116281546434,-5,1038,3577,40
116285354638,116285354633,-5,1083,4153,40
116290745493,116290745487,-6,1228,4669,40
116291836024,116291836021,-3,1542,2527,40
116298176882,116298176876,-6,1585,4714,40
116304390551,116304390549,-2,2708,6233,40
116307137076,116307137065,-11,174,2124,40
116307610526,116307610543,17,292,801,40
116312590946,116312590939,-7,1464,4495,40
116315527355,116315527349,-6,981,3851,40
116315579937,116315579934,-3,1577,2060,40
116317722822,116317722804,-18,127,798,40
116319040011,116319040006,-5,1125,4185,40
116322193979,116322193973,-6,939,5095,40
116324927455,116324927450,-5,1237,3727,40
116327132805,116327132799,-6,1204,3525,40
116331918645,116331918641,-4,661,2222,40
116334574024,116334574016,-8,1282,4436,40
116341346637,116341346642,5,1460,1577,40
116362700901,116362700899,-2,1394,1980,40
116363300017,116363300027,10,13041,27627,40
116368387118,116368387112,-6,1114,4221,40
116370103277,116370103277,0,1593,3048,40
116372081921,116372081916,-5,1130,3825,40
116372643352,116372643368,16,994,2295,40
116378344726,116378344721,-5,1377,3438,40
116378844911,116378844927,16,254,1107,40
116379901254,116379901246,-8,41445,12691,40
116383104517,116383104528,11,1116,1259,40
116388277235,116388277230,-5,1386,2250,40
116389307915,116389307907,-8,808,1300,40
116389425485,116389425464,-21,128,1171,40
116390711481,116390711473,-8,20382,17518,40
116391354152,116391354153,1,2002,2306,40
116395074285,116395074279,-6,1310,3373,40
116401205045,116401205042,-3,1148,2103,40
116402168047,116402168062,15,646,3396,40
116403370969,116403370967,-2,1967,1505,40
116404373360,116404373354,-6,994,3509,40
116404469768,116404469785,17,105,1322,40
116405454285,116405454276,-9,789,4355,40
116407128417,116407128410,-7,991,4263,40
116407599222,116407599238,16,1254,3675,40
116408139600,116408139595,-5,77,963,40
116417955697,116417955693,-4,4189,8815,40
116420310234,116420310227,-7,1190,3682,40
116423049982,116423049977,-5,901,3325,40
116423087350,116423087361,11,393,2271,40
116423293254,116423293275,21,106,886,40
116424322786,116424322779,-7,1365,3432,40
116425603251,116425603245,-6,1107,3034,40
116425680165,116425680183,18,767,2443,40
116428824947,116428824939,-8,1065,4558,40
116429988724,116429988730,6,186,1183,40
116431692361,116431692353,-8,874,3427,40
116440564202,116440564198,-4,1307,3770,40
116448780239,116448780244,5,16870,18894,40
116450749846,116450749842,-4,2318,7450,40
116453393884,116453393878,-6,1018,3755,40
116456314729,116456314724,-5,694,1837,40
116458139422,116458139441,19,202,886,40
116460104835,116460104829,-6,1017,3207,40
116460356470,116460356489,19,881,3779,40
116463839950,116463839955,5,2392,1302,40
116464408293,116464408304,11,1916,1109,40
116466082015,116466082017,2,12035,14060,40
116468703830,116468703823,-7,968,4610,40
116468995215,116468995235,20,230,1182,40
116470223143,116470223134,-9,755,3743,40
116479841871,116479841866,-5,821,4191,40
116482220118,116482220113,-5,1141,4692,40
116483019388,116483019410,22,233,1765,40
116484923750,116484923745,-5,1176,5543,40
116487947025,116487947019,-6,1451,5049,40
116488927197,116488927203,6,6575,2851,40
116499108083,116499108077,-6,1060,3264,40
116499981608,116499981602,-6,1175,4634,40
116500989436,116500989457,21,747,779,40
116503437243,116503437237,-6,604,3573,40
116505322618,116505322625,7,1570,905,40
116508147393,116508147389,-4,982,3252,40
116512326752,116512326747,-5,844,3688,40
116512875799,116512875818,19,231,1251,40
116513215773,116513215787,14,255,1116,40
116519989913,116519989906,-7,1183,4310,40
116527981891,116527981884,-7,27556,12722,40
116542270702,116542270698,-4,1208,4585,40
116546007115,116546007108,-7,1098,4913,40
116546428554,116546428547,-7,1068,3323,40
116546499088,116546499103,15,70,741,40
116546985709,116546985707,-2,1117,2390,40
116548344385,116548344379,-6,715,2923,40
116551426315,116551426309,-6,933,3871,40
116556513510,116556513505,-5,1051,3399,40
116558569807,116558569801,-6,1108,2623,40
116558700785,116558700778,-7,1517,4071,40
116560041019,116560041013,-6,960,3488,40
116564102690,116564102682,-8,867,3516,40
116567234346,116567234342,-4,585,2099,40
116567282272,116567282278,6,317,2440,40
116569295390,116569295395,5,2359,1500,40
116570122538,116570122531,-7,1236,5257,40
116573716670,116573716666,-4,1415,4243,40
116574846179,116574846173,-6,1131,3315,40
116575842257,116575842250,-7,757,2882,40
116577139862,116577139856,-6,823,3995,40
116577381084,116577381095,11,297,1364,40
116579277943,116579277937,-6,1130,3821,40
116580513335,116580513328,-7,851,3598,40
116585263102,116585263095,-7,1154,3184,40
116585990819,116585990831,12,377,1406,40
116588798258,116588798253,-5,889,3560,40
116590897055,116590897049,-6,1077,3808,40
116591537637,116591537618,-19,950,4494,40
116595716715,116595716711,-4,555,2993,40
116597929955,116597929950,-5,1073,5281,40
116598308275,116598308273,-2,1220,3322,40
116599143743,116599143734,-9,847,2616,40
116601987270,116601987269,-1,1158,2032,40
116602491651,116602491645,-6,1173,3022,40
116605977072,116605977065,-7,1112,5239,40
116606262465,116606262461,-4,1122,2731,40
116606493123,116606493117,-6,745,1904,40
116606619621,116606619641,20,244,952,40
116606759774,116606759779,5,106,857,40
116607745310,116607745311,1,1647,1751,40
116608499652,116608499632,-20,152,1137,40
116609901314,116609901306,-8,1154,3952,40
116611224884,116611224902,18,254,1273,40
116614221829,116614221823,-6,1049,4165,40
116621086870,116621086865,-5,827,3647,40
116621850910,116621850923,13,891,4086,40
116643266574,116643266568,-6,1470,4323,40
116645003941,116645003935,-6,1061,3309,40
116645062286,116645062268,-18,340,1753,40
116645588055,116645588049,-6,1209,3346,40
116652046576,116652046583,7,3046,1207,40
116656656794,116656656787,-7,1019,4552,40
116660728243,116660728236,-7,995,5043,40
116681900652,116681900646,-6,1076,5094,40
116681935336,116681935329,-7,135,1037,40
116684156307,116684156300,-7,944,4896,40
116684733380,116684733378,-2,136,1168,40
116686064574,116686064578,4,1955,1861,40
116686520870,116686520866,-4,658,3722,40
116689114301,116689114296,-5,1307,4342,40
116693447799,116693447794,-5,1027,3697,40
116694929343,116694929350,7,137,1752,40
116695376157,116695376166,9,81,1075,40
116708888244,116708888238,-6,935,4194,40
116716582675,116716582671,-4,759,3300,40
116716772296,116716772314,18,651,2377,40
116726888078,116726888074,-4,656,3222,40
116726993652,116726993675,23,973,3044,40
116730652964,116730652962,-2,2138,2995,40
116731441047,116731441039,-8,968,4162,40
116733430179,116733430173,-6,1111,4777,40
116736262007,116736262001,-6,1314,4275,40
116741428106,116741428102,-4,1085,4196,40
116745455098,116745455093,-5,1047,4674,40
116753942949,116753942944,-5,958,3886,40
116759719762,116759719759,-3,1109,2645,40
116762871890,116762871885,-5,1077,3871,40
116763091988,116763092006,18,796,3478,40
116773511033,116773511053,20,439,1907,40
116777466095,116777466091,-4,618,2091,40
116778336313,116778336315,2,1422,1298,40
116779175411,116779175414,3,1299,924,40
116779667606,116779667602,-4,246,1216,40
116780476141,116780476132,-9,1002,2161,40
116780516772,116780516794,22,1192,3722,40
116780736542,116780736535,-7,735,3493,40
116783254829,116783254823,-6,944,3046,40
116785352646,116785352642,-4,752,2347,40
116785849616,116785849624,8,79,1822,40
116786149981,116786149995,14,807,4860,40
116787914111,116787914106,-5,1182,4266,40
116788324006,116788324018,12,268,1004,40
116796718663,116796718658,-5,1108,3064,40
116805504150,116805504145,-5,1024,3225,40
116808815558,116808815553,-5,1034,3119,40
116809146428,116809146422,-6,681,2307,40
116815868611,116815868606,-5,871,3363,40
116816057220,116816057230,10,307,1125,40
116817736878,116817736872,-6,866,4744,40
116817905717,116817905731,14,58,964,40
116820079429,116820079422,-7,995,4218,40
116820873184,116820873198,14,61,1117,40
116824940394,116824940389,-5,903,3853,40
116826489570,116826489565,-5,860,3517,40
116826631380,116826631393,13,450,3276,40
116848598391,116848598385,-6,1050,3770,40
116849088686,116849088703,17,895,4518,40
116867985169,116867985168,-1,1479,2101,40
116874719891,116874719885,-6,897,4002,40
116878855414,116878855409,-5,794,1980,40
116879607303,116879607309,6,3906,1538,40
116883854678,116883854673,-5,1549,7440,40
116884498651,116884498644,-7,471,1578,40
116886422704,116886422719,15,618,1099,40
116892523546,116892523542,-4,1212,1905,40
116893448642,116893448637,-5,1194,3131,40
116893730952,116893730970,18,275,1296,40
116898006888,116898006882,-6,1105,3766,40
116906719566,116906719561,-5,720,4946,40
116909436992,116909436992,0,766,1107,40
116911725484,116911725484,0,1314,1946,40
116912112279,116912112274,-5,1314,4162,40
116913261824,116913261813,-11,112,1165,40
116916657877,116916657873,-4,1254,3662,40
116922553742,116922553737,-5,661,2390,40
116925180779,116925180778,-1,2747,4181,40
116925472840,116925472834,-6,1330,4678,40
116928414757,116928414750,-7,1037,4385,40
116929001580,116929001570,-10,91,482,40
116930204341,116930204339,-2,736,2349,40
116930280876,116930280871,-5,1687,3786,40
116930924871,116930924866,-5,398,1301,40
116941372787,116941372780,-7,1337,5723,40
116942414165,116942414183,18,865,3075,40
116944119566,116944119570,4,1532,1229,40
116952195632,116952195627,-5,970,3975,40
116954344879,116954344883,4,3548,1474,40
116960950852,116960950849,-3,241,1029,40
116962538210,116962538203,-7,1318,4740,40
116963326962,116963326960,-2,1091,2707,40
116964026341,116964026342,1,110,1288,40
116974543747,116974543742,-5,793,2552,40
116992142565,116992142559,-6,1038,2965,40
116992173452,116992173447,-5,208,1367,40
116994044397,116994044394,-3,1761,4630,40
117004173818,117004173813,-5,1313,3053,40
117006807146,117006807138,-8,960,4671,40
117006867692,117006867674,-18,84,1401,40
117010247850,117010247842,-8,1079,3840,40
117018887593,117018887586,-7,978,3482,40
117018941088,117018941105,17,321,3274,40
117019605268,117019605263,-5,1699,3796,40
117020488889,117020488890,1,1018,1077,40
117024610477,117024610470,-7,1279,5045,40
117027446352,117027446347,-5,980,4345,40
117027674849,117027674851,2,3369,2887,40
117038771701,117038771694,-7,830,4260,40
117052730092,117052730086,-6,1030,3286,40
117058416882,117058416883,1,1875,1952,40
117058903953,117058903963,10,275,1182,40
117059626961,117059626954,-7,1326,4333,40
117060150754,117060150748,-6,1141,3670,40
117060414905,117060414899,-6,247,2841,40
117061067100,117061067121,21,370,729,40
117062946143,117062946138,-5,1225,2293,40
117064200234,117064200236,2,1099,913,40
117068881699,117068881693,-6,1157,4378,40
117070496795,117070496790,-5,931,3118,40
117081550216,117081550210,-6,1047,2769,40
117083719542,117083719537,-5,972,2847,40
117086158445,117086158442,-3,42756,16122,40
117090600205,117090600199,-6,650,1962,40
117095536475,117095536469,-6,1107,3291,40
117096104263,117096104258,-5,858,1924,40
117097032539,117097032534,-5,527,1975,40
117097304144,117097304160,16,365,2046,40
117099176623,117099176631,8,2536,1244,40
117101504437,117101504431,-6,941,3735,40
117103034345,117103034350,5,2403,1804,40
117109212211,117109212204,-7,1432,5948,40
117110637803,117110637798,-5,1169,4588,40
117114548994,117114548989,-5,556,3134,40
117122470981,117122470976,-5,947,4337,40
117124941295,117124941293,-2,10773,18115,40
117124970588,117124970582,-6,985,2759,40
117127502851,117127502845,-6,1500,5194,40
117129802469,117129802463,-6,299,1064,40
117131481030,117131481018,-12,150,1384,40
117135255414,117135255409,-5,644,3593,40
117135315486,117135315466,-20,246,1251,40
117137610574,117137610568,-6,1077,2776,40
117137879252,117137879266,14,365,2882,40
117137966611,117137966606,-5,1151,4658,40
117139554172,117139554173,1,1536,1794,40
117144330371,117144330367,-4,2178,4577,40
117150978286,117150978278,-8,1113,4066,40
117151775799,117151775793,-6,813,2937,40
117152875521,117152875521,0,2280,2374,40
117160789799,117160789793,-6,953,5060,40
117167481190,117167481195,5,2961,2115,40
117169794295,117169794290,-5,967,4112,40
117179901589,117179901594,5,2795,2056,40
117182771738,117182771733,-5,772,2668,40
117187459498,117187459493,-5,672,2204,40
117189436311,117189436306,-5,1013,3723,40
117191565571,117191565565,-6,779,3928,40
117199901666,117199901659,-7,907,2858,40
117200635894,117200635909,15,954,2925,40
117202830361,117202830355,-6,925,2640,40
117203861133,117203861138,5,1565,1151,40
117206699608,117206699605,-3,1459,1898,40
117215742252,117215742246,-6,1292,5162,40
117220949645,117220949639,-6,1224,3626,40
117221101321,117221101320,-1,1756,3674,40
117221193025,117221193019,-6,1017,3577,40
117225494166,117225494162,-4,1262,3510,40
117226573278,117226573271,-7,1158,5146,40
117226693247,117226693242,-5,1281,3283,40
117227537636,117227537634,-2,888,2005,40
117231654028,117231654033,5,7713,4473,40
117236650350,117236650345,-5,999,3101,40
117237034252,117237034252,0,1319,2923,40
117239374707,117239374700,-7,925,3766,40
117239474277,117239474297,20,890,4981,40
117242768307,117242768301,-6,862,3903,40
117245049195,117245049189,-6,725,3621,40
117250115000,117250114989,-11,1266,4032,40
117251725792,117251725786,-6,1220,3079,40
117258988907,117258988902,-5,1305,4157,40
117259718156,117259718150,-6,982,5312,40
117263813130,117263813124,-6,1171,3741,40
117270981390,117270981384,-6,1180,4749,40
117279940149,117279940150,1,3091,2557,40
117286210119,117286210113,-6,945,2328,40
117286936206,117286936201,-5,1168,3694,40
117288210168,117288210161,-7,1007,3764,40
117292795227,117292795218,-9,1470,5331,40
117293216037,117293216039,2,1775,1658,40
117296984965,117296984959,-6,1070,4009,40
117297126493,117297126475,-18,659,2846,40
117297220358,117297220346,-12,259,1199,40
117297759040,117297759057,17,558,1364,40
117300098951,117300098944,-7,1345,4372,40
117300491720,117300491713,-7,936,4006,40
117304352318,117304352328,10,14397,29374,40
117309736814,117309736809,-5,1127,4518,40
117310870946,117310870942,-4,932,1308,40
117311567692,117311567686,-6,844,4910,40
117314378545,117314378538,-7,960,2774,40
117319328046,117319328040,-6,886,3912,40
117319819444,117319819452,8,256,1235,40
117325314706,117325314701,-5,750,2498,40
117325693347,117325693341,-6,879,2864,40
117329501177,117329501178,1,1162,15187,40
117329622444,117329622428,-16,853,3659,40
117333477063,117333477057,-6,740,3253,40
117333519576,117333519570,-6,887,3174,40
117334152238,117334152259,21,539,2471,40
117344639183,117344639178,-5,527,1667,40
117345561891,117345561885,-6,1201,3019,40
117349177241,117349177235,-6,1249,3885,40
117349370691,117349370686,-5,1068,4390,40
117349568216,117349568212,-4,1447,3869,40
117351895482,117351895480,-2,1215,3300,40
117352248208,117352248219,11,297,935,40
117367900200,117367900207,7,102,1009,40
117370177250,117370177245,-5,606,2982,40
117370220276,117370220293,17,365,1610,40
117374114447,117374114443,-4,47962,20027,40
117378660214,117378660220,6,11476,27793,40
117378733303,117378733303,0,60,734,40
117380285563,117380285557,-6,1127,3429,40
117382062926,117382062907,-19,243,967,40
117386800500,117386800499,-1,2222,2738,40
117387318054,117387318049,-5,1171,4410,40
117387805475,117387805469,-6,1041,3123,40
117389647176,117389647171,-5,984,4218,40
117390516396,117390516396,0,3840,5615,40
117398747378,117398747385,7,2784,1538,40
117405690254,117405690250,-4,1840,4177,40
117412516529,117412516523,-6,651,4585,40
117414949649,117414949645,-4,1135,4602,40
117423499670,117423499671,1,1685,2250,40
117424526717,117424526713,-4,1168,4255,40
117425727159,117425727153,-6,825,3120,40
117427058727,117427058722,-5,808,3585,40
117431336838,117431336834,-4,945,4094,40
117431408455,117431408455,0,1142,3051,40
117433093342,117433093343,1,1179,1538,40
117433636966,117433636979,13,327,664,40
117437332531,117437332524,-7,916,3703,40
117443835663,117443835657,-6,873,3113,40
117444345301,117444345303,2,84,1463,40
117449421718,117449421712,-6,1072,3062,40
117450049525,117450049532,7,1174,521,40
117451739010,117451739005,-5,970,3399,40
117452302022,117452302042,20,140,912,40
117452645615,117452645610,-5,720,3006,40
117454179765,117454179759,-6,1392,4955,40
117456198445,117456198437,-8,942,3375,40
117461662534,117461662528,-6,726,2715,40
117463587597,117463587591,-6,580,2394,40
117463826709,117463826702,-7,1068,4038,40
117472367293,117472367289,-4,1097,1731,40
117476073150,117476073152,2,1487,1457,40
117479348061,117479348054,-7,912,5220,40
117480549047,117480549045,-2,225,1668,40
117481169928,117481169922,-6,1621,7714,40
117481957893,117481957886,-7,1382,3349,40
117483082316,117483082309,-7,2431,5552,40
117487293735,117487293729,-6,1174,3785,40
117488323087,117488323081,-6,1155,3991,40
117488802341,117488802358,17,183,827,40
117495000783,117495000774,-9,1368,4482,40
117495697489,117495697485,-4,1107,2963,40
117497133671,117497133667,-4,47,1031,40
117497473588,117497473583,-5,1099,3617,40
117498375772,117498375766,-6,1084,3403,40
117506974862,117506974871,9,7200,35975,40
117508865067,117508865061,-6,853,3632,40
117508949038,117508949028,-10,963,3163,40
117512614943,117512614937,-6,1128,3789,40
117513494210,117513494205,-5,1349,4326,40
117515668178,117515668173,-5,1217,5019,40
117517501079,117517501085,6,2928,1508,40
117518995358,117518995354,-4,1133,2715,40
117523379211,117523379205,-6,683,2878,40
117526915315,117526915309,-6,637,2960,40
117533084266,117533084269,3,4180,3574,40
117539783138,117539783133,-5,728,1689,40
117540868039,117540868034,-5,856,3729,40
117543226498,117543226491,-7,881,2600,40
117545002835,117545002829,-6,956,4350,40
117561946725,117561946719,-6,1443,4176,40
117562122002,117562121998,-4,759,1642,40
117562799496,117562799513,17,950,3094,40
117564322906,117564322900,-6,932,2414,40
117569537851,117569537845,-6,740,1669,40
117570237428,117570237445,17,187,1477,40
117576046258,117576046252,-6,1244,2359,40
117577970642,117577970637,-5,973,3491,40
117578241585,117578241578,-7,1077,3577,40
117583979257,117583979241,-16,750,3988,40
117586275001,117586275001,0,1038,1843,40
117587545051,117587545048,-3,988,1031,40
117588003109,117588003102,-7,1339,3578,40
117589797040,117589797055,15,926,1297,40
117592991445,117592991442,-3,911,3656,40
117595481173,117595481169,-4,24782,12117,40
117596426855,117596426850,-5,1176,2580,40
117598695755,117598695749,-6,1450,6066,40
117601632234,117601632227,-7,976,3577,40
117610278118,117610278122,4,4105,1982,40
117611140588,117611140582,-6,1320,4880,40
117612582666,117612582660,-6,1600,3899,40
117621000598,117621000590,-8,1091,4406,40
117624278563,117624278581,18,129,1110,40
117631164103,117631164098,-5,738,2672,40
117633954611,117633954605,-6,1241,5230,40
117634331827,117634331821,-6,1241,4863,40
117635023814,117635023833,19,199,1222,40
117651824266,117651824260,-6,1118,3537,40
117658193034,117658193028,-6,1151,3404,40
117670347167,117670347161,-6,860,2988,40
117672314970,117672314962,-8,795,2457,40
117672356751,117672356745,-6,977,3373,40
117672664692,117672664709,17,1058,3438,40
117678538379,117678538372,-7,1662,5594,40
117678601276,117678601293,17,825,3259,40
117686846660,117686846654,-6,991,2536,40
117686875621,117686875641,20,235,1443,40
117688120914,117688120909,-5,818,3935,40
117690025714,117690025707,-7,1145,3250,40
117693720346,117693720355,9,3785,909,40
117694026624,117694026636,12,17654,36001,40
117696868976,117696868970,-6,785,3843,40
117701716394,117701716387,-7,1033,4548,40
117703100473,117703100473,0,26992,20278,40
117704477213,117704477208,-5,3541,11728,40
117705916448,117705916451,3,2971,1596,40
117709304876,117709304859,-17,29420,28564,40
117712621951,117712621947,-4,1152,3699,40
117713294359,117713294338,-21,6,1043,40
117714970117,117714970110,-7,987,3518,40
117717941847,117717941840,-7,872,3677,40
117723987740,117723987735,-5,962,3280,40
117724272405,117724272422,17,762,4044,40
117727379164,117727379158,-6,843,1881,40
117728062894,117728062897,3,337,1598,40
117728809630,117728809650,20,290,756,40
117732804894,117732804889,-5,1309,4536,40
117737112351,117737112345,-6,927,3440,40
117743295151,117743295142,-9,832,4044,40
117744789981,117744789975,-6,873,3076,40
117751069486,117751069479,-7,888,4405,40
117754310699,117754310693,-6,1213,3371,40
117756399242,117756399243,1,867,934,40
117761930550,117761930563,13,748,3084,40
117768203034,117768203025,-9,899,4702,40
117769178846,117769178834,-12,128,1783,40
117770017240,117770017249,9,100,1387,40
117773349251,117773349244,-7,850,2826,40
117782420743,117782420737,-6,800,3652,40
117782847773,117782847794,21,617,3228,40
117793640295,117793640288,-7,1135,4716,40
117794356359,117794356354,-5,1049,3403,40
117798529334,117798529335,1,1886,2185,40
117810845650,117810845642,-8,1235,4743,40
117812420479,117812420474,-5,185,1534,40
117813206838,117813206838,0,153,730,40
117814672863,117814672858,-5,706,2862,40
117816090009,117816090001,-8,1308,4300,40
117834714179,117834714173,-6,913,2028,40
117841030302,117841030297,-5,549,2428,40
117843088377,117843088372,-5,943,2274,40
117846568872,117846568880,8,1222,1787,40
117849781089,117849781085,-4,974,3440,40
117852779143,117852779137,-6,936,3466,40
117853305916,117853305910,-6,1189,2616,40
117860551577,117860551579,2,1439,825,40
117861728790,117861728782,-8,1255,4165,40
117862100730,117862100723,-7,1122,5252,40
117864451002,117864450997,-5,1160,4749,40
117865493824,117865493825,1,117,1316,40
117872495317,117872495322,5,1718,922,40
117872857262,117872857255,-7,673,2247,40
117873271046,117873271058,12,130,1281,40
117882453923,117882453914,-9,759,3237,40
117882503816,117882503802,-14,281,1299,40
117884327308,117884327302,-6,1236,3361,40
117884683975,117884683978,3,278,1207,40
117885149715,117885149719,4,2392,1442,40
117885998413,117885998417,4,2199,1724,40
117887810605,117887810598,-7,958,3312,40
117888954420,117888954436,16,280,1045,40
117891409750,117891409747,-3,781,2837,40
117892251799,117892251794,-5,409,1442,40
117900978335,117900978326,-9,697,3608,40
117901159368,117901159381,13,192,1463,40
117902711302,117902711297,-5,696,3250,40
117905207490,117905207483,-7,937,2865,40
117910916039,117910916033,-6,737,2896,40
117914594416,117914594409,-7,568,3894,40
117917444347,117917444341,-6,1142,4093,40
117923343906,117923343900,-6,778,2161,40
117925040896,117925040890,-6,1169,4022,40
117929000722,117929000728,6,1369,1079,40
117930735062,117930735049,-13,803,2965,40
117931811919,117931811906,-13,1053,3149,40
117933314773,117933314755,-18,274,1465,40
117934329231,117934329218,-13,257,1809,40
117941084442,117941084437,-5,1205,4196,40
117941633181,117941633178,-3,744,2012,40
117942664391,117942664371,-20,139,1066,40
117943773960,117943773978,18,37,1358,40
117944609585,117944609580,-5,1075,3420,40
117947216189,117947216190,1,1997,1693,40
117947978131,117947978123,-8,936,3492,40
117954183561,117954183554,-7,831,2806,40
117960348977,117960348973,-4,1076,3644,40
117967571410,117967571405,-5,849,2803,40
117972416890,117972416883,-7,964,3979,40
117975041346,117975041345,-1,1512,1544,40
117984681905,117984681902,-3,1226,3898,40
117989087401,117989087395,-6,1160,3537,40
117993023258,117993023253,-5,1482,5237,40
117994116387,117994116382,-5,1070,3597,40
117997358019,117997358012,-7,862,2948,40
117998457908,117998457929,21,601,2146,40
118000382458,118000382450,-8,174,1647,40
118003485941,118003485935,-6,888,3505,40
118007622205,118007622199,-6,1247,4418,40
118007844338,118007844331,-7,980,2250,40
118008439461,118008439450,-11,661,3472,40
118009364156,118009364174,18,957,2594,40
118009542518,118009542516,-2,144,851,40
118010249606,118010249600,-6,1053,5314,40
118015892765,118015892758,-7,943,3089,40
118015954622,118015954615,-7,698,4472,40
118032537263,118032537258,-5,700,2629,40
118035732222,118035732214,-8,1337,4486,40
118041716477,118041716473,-4,995,3993,40
118048353682,118048353682,0,449,1296,40
118048900900,118048900882,-18,273,1560,40
118052263619,118052263613,-6,1073,3174,40
118052868839,118052868833,-6,1395,4229,40
118056941755,118056941749,-6,1131,4500,40
118059253563,118059253556,-7,836,4501,40
118059576383,118059576363,-20,179,1066,40
118060656866,118060656860,-6,937,2896,40
118060909748,118060909765,17,566,2204,40
118067080935,118067080930,-5,1172,4014,40
118068826197,118068826192,-5,1167,3203,40
118074293573,118074293566,-7,1332,5152,40
118087246918,118087246912,-6,1071,3234,40
118098462050,118098462044,-6,695,3043,40
118107466207,118107466202,-5,1146,3850,40
118113314008,118113314006,-2,1392,3136,40
118115440585,118115440579,-6,1046,3339,40
118118398827,118118398833,6,2692,1415,40
118120188393,118120188390,-3,696,2501,40
118122155623,118122155617,-6,1113,3680,40
118123728683,118123728676,-7,1123,2834,40
118124775822,118124775817,-5,748,3337,40
118132700513,118132700506,-7,1070,3796,40
118132942730,118132942723,-7,1162,3691,40
118140560102,118140560097,-5,1609,6351,40
118140720493,118140720480,-13,881,4057,40
118141150023,118141150003,-20,1188,4025,40
118143547688,118143547697,9,328,1178,40
118151619030,118151619023,-7,1181,3697,40
118153588307,118153588300,-7,1462,5823,40
118155454307,118155454303,-4,945,3481,40
118172074922,118172074916,-6,797,2451,40
118174834247,118174834238,-9,730,2372,40
118174866535,118174866521,-14,23728,15087,40
118175368105,118175368099,-6,1001,3462,40
118179395442,118179395436,-6,667,2403,40
118180435503,118180435497,-6,758,4755,40
118181316550,118181316547,-3,1171,1728,40
118187900230,118187900226,-4,1055,4478,40
118190020471,118190020465,-6,1040,3927,40
118194712777,118194712771,-6,748,3137,40
118195152164,118195152169,5,5172,2578,40
118201821271,118201821264,-7,463,3014,40
118209717581,118209717575,-6,957,4258,40
118210567601,118210567596,-5,2300,5761,40
118211113870,118211113865,-5,1061,2955,40
118214285633,118214285629,-4,805,2168,40
118224830990,118224830984,-6,601,2595,40
118230185795,118230185791,-4,694,3215,40
118230287572,118230287592,20,1028,4297,40
118243572060,118243572063,3,25447,19222,40
118249795358,118249795353,-5,1218,3665,40
118254974558,118254974552,-6,852,3985,40
118257141915,118257141902,-13,1052,4041,40
118259344354,118259344348,-6,901,6502,40
118259782807,118259782823,16,444,1952,40
118260134742,118260134737,-5,918,4610,40
118261870062,118261870060,-2,872,2844,40
118264781799,118264781793,-6,929,2440,40
118265035934,118265035933,-1,172,1269,40
118268137398,118268137393,-5,770,3452,40
118288422286,118288422280,-6,2943,9050,40
118289032279,118289032273,-6,993,3233,40
118294680527,118294680522,-5,571,3734,40
118295645047,118295645041,-6,759,3997,40
118295970944,118295970952,8,76,1351,40
118300416615,118300416616,1,1508,1746,40
118305229272,118305229265,-7,640,3077,40
118305470982,118305470978,-4,1127,3639,40
118310754418,118310754413,-5,929,3192,40
118316266767,118316266762,-5,1220,2896,40
118317204637,118317204631,-6,22056,13542,40
118324850485,118324850479,-6,949,3176,40
118328664367,118328664361,-6,785,3965,40
118332564719,118332564721,2,2536,2457,40
118333136735,118333136731,-4,1133,2645,40
118334718676,118334718677,1,1573,1762,40
118335229308,118335229302,-6,1033,4518,40
118340825751,118340825744,-7,1349,4778,40
118341609232,118341609250,18,150,832,40
118342246430,118342246424,-6,1070,4077,40
118343738130,118343738122,-8,1002,3633,40
118347679862,118347679859,-3,885,1740,40
118348323566,118348323583,17,367,3020,40
118349461828,118349461823,-5,204,1108,40
118351669462,118351669456,-6,1212,5038,40
118360640614,118360640610,-4,715,2961,40
118365073641,118365073643,2,2014,1474,40
118368335532,118368335526,-6,1056,3271,40
118368493384,118368493403,19,242,1258,40
118378969665,118378969658,-7,1252,5165,40
118379879562,118379879557,-5,779,2136,40
118384128499,118384128492,-7,696,3549,40
118389145815,118389145810,-5,1015,3803,40
118393832587,118393832584,-3,602,1535,40
118394460350,118394460349,-1,390,1459,40
118410421810,118410421802,-8,894,3659,40
118411556383,118411556378,-5,1187,3435,40
118419418584,118419418582,-2,843,1236,40
118420459532,118420459555,23,607,2885,40
118422701182,118422701183,1,6600,6377,40
118425163583,118425163570,-13,38895,14053,40
118433275732,118433275726,-6,832,3427,40
118439314686,118439314684,-2,2705,5875,40
118448222375,118448222369,-6,1053,4219,40
118457172173,118457172166,-7,1071,3465,40
118458081270,118458081267,-3,52,1338,40
118458928046,118458928040,-6,1603,4434,40
118461873247,118461873242,-5,808,2327,40
118463892193,118463892188,-5,992,3774,40
118467000255,118467000249,-6,935,4653,40
118467506822,118467506823,1,62,984,40
118484283067,118484283061,-6,929,4772,40
