fTNear,fTFar,fDelT,fQNear,fQFar,d
118889890930,118889890931,1,34,326,0
882850,882851,1,1328,1443,0
3590721,3590721,0,1303,1278,0
4332158,4332157,-1,1133,1538,0
6363659,6363662,3,1400,1888,0
9279262,9279263,1,2019,1633,0
13619816,13619815,-1,1231,1634,0
18995146,18995146,0,1335,1377,0
20479887,20479886,-1,1067,1447,0
21321723,21321723,0,1228,1758,0
21466533,21466534,1,1608,1638,0
22158738,22158720,-18,1692,1637,0
24325994,24325996,2,1521,1569,0
24493410,24493417,7,8120,2211,0
27873737,27873743,6,5454,1765,0
28310510,28310510,0,1554,1837,0
28887265,28887268,3,1216,1370,0
30908110,30908109,-1,1091,1694,0
31442207,31442206,-1,1212,1696,0
32336118,32336118,0,1071,1317,0
32460275,32460254,-21,1024,1138,0
35939708,35939710,2,1903,1272,0
36942649,36942651,2,1161,1474,0
42794758,42794757,-1,998,1237,0
45106957,45106959,2,1366,985,0
45869570,45869570,0,1686,1786,0
46734923,46734923,0,1318,1400,0
55247476,55247472,-4,21459,14812,0
55642278,55642279,1,1698,1760,0
59248818,59248818,0,1773,2318,0
59451193,59451193,0,1403,2146,0
60755751,60755750,-1,1048,1290,0
64759955,64759955,0,1673,1652,0
68224297,68224297,0,891,1594,0
71159045,71159050,5,1520,840,0
73722417,73722418,1,1678,1497,0
74062882,74062882,0,1553,1743,0
75255142,75255144,2,1127,1538,0
77783900,77783908,8,3352,1080,0
84196317,84196319,2,1726,1328,0
85798334,85798331,-3,1402,2467,0
92699035,92699031,-4,934,1578,0
97587235,97587235,0,1001,859,0
98981663,98981661,-2,1444,1945,0
99434462,99434461,-1,907,1465,0
101010870,101010870,0,1316,1485,0
103225745,103225746,1,1823,2526,0
104028990,104028986,-4,1422,3028,0
106448243,106448246,3,1383,1428,0
107522986,107522987,1,1171,1692,0
108090172,108090195,23,1577,2064,0
112992897,112992914,17,973,1903,0
113598768,113598770,2,1710,2127,0
114452933,114452933,0,1428,1348,0
114732980,114732978,-2,1124,1520,0
116113070,116113071,1,1177,1355,0
116330183,116330176,-7,929,5143,0
116450398,116450398,0,1034,1146,0
118706202,118706202,0,1694,1958,0
122432434,122432438,4,1175,1251,0
124936490,124936490,0,1315,1455,0
127087266,127087268,2,1351,1970,0
129027254,129027254,0,1221,1505,0
129491768,129491778,10,2346,1406,0
131862071,131862061,-10,1221,1611,0
136508605,136508606,1,1455,1520,0
138312726,138312725,-1,1088,1449,0
140365011,140365012,1,929,1222,0
142447554,142447554,0,1543,1912,0
146323078,146323078,0,1356,2198,0
146476446,146476445,-1,1268,1338,0
150566782,150566783,1,1100,1581,0
151501099,151501097,-2,1331,1489,0
152004690,152004691,1,1295,1883,0
156831987,156831985,-2,998,2257,0
157553547,157553549,2,1109,1396,0
158753865,158753865,0,865,993,0
162318235,162318235,0,1325,2068,0
162736106,162736106,0,1355,1876,0
164963972,164963973,1,1475,1829,0
170762012,170762012,0,1189,1600,0
173524766,173524766,0,989,1187,0
174522859,174522860,1,1425,1718,0
176191735,176191734,-1,1043,1632,0
179928667,179928650,-17,1493,1615,0
181721730,181721731,1,1362,1906,0
183380381,183380380,-1,1330,1805,0
183492674,183492674,0,964,1521,0
183546374,183546374,0,1195,1719,0
183803446,183803448,2,845,1822,0
184371836,184371830,-6,1501,1291,0
186128779,186128766,-13,1794,2659,0
189616145,189616144,-1,1153,1825,0
194432126,194432126,0,1214,2202,0
197800352,197800354,2,1739,1541,0
199938065,199938066,1,1865,1431,0
205289399,205289401,2,1090,1227,0
205740883,205740884,1,1306,1934,0
206691728,206691726,-2,1236,1259,0
210172446,210172449,3,1983,1751,0
210550874,210550875,1,1236,2206,0
211223744,211223745,1,1609,1489,0
211471133,211471132,-1,1039,1163,0
212624827,212624827,0,1019,2205,0
216794840,216794841,1,977,1146,0
219007738,219007739,1,935,1576,0
220025163,220025164,1,1743,2243,0
222445063,222445062,-1,1397,1938,0
224521899,224521898,-1,1292,1425,0
228647938,228647940,2,1170,1822,0
229894179,229894176,-3,1229,2227,0
232018369,232018370,1,1318,1498,0
233373111,233373108,-3,1091,2276,0
236173258,236173260,2,1520,1629,0
236365877,236365881,4,1141,1195,0
236979390,236979390,0,1053,936,0
243601018,243601019,1,2258,1887,0
244299135,244299134,-1,1527,2067,0
245504154,245504155,1,1444,1325,0
247473493,247473491,-2,2070,3128,0
248342357,248342357,0,1426,1796,0
249378015,249378016,1,1487,1700,0
252053485,252053486,1,1807,2089,0
256944854,256944855,1,871,1346,0
259238746,259238746,0,1192,2297,0
263029298,263029297,-1,783,1466,0
269288123,269288123,0,1136,1485,0
270143490,270143490,0,1853,1371,0
270503086,270503087,1,1320,1665,0
270791023,270791024,1,970,2037,0
271321886,271321888,2,1391,1657,0
272335847,272335847,0,1096,1609,0
274635850,274635850,0,2291,2083,0
277057118,277057115,-3,774,1108,0
279111886,279111883,-3,1306,1437,0
279599240,279599242,2,884,934,0
279863704,279863704,0,1358,1396,0
281289752,281289753,1,1620,1501,0
282680298,282680298,0,1691,1718,0
292275768,292275766,-2,1605,2011,0
294113969,294113963,-6,1593,8360,0
294810035,294810040,5,12523,22288,0
295185260,295185262,2,3007,1774,0
299263305,299263306,1,1481,1739,0
309082262,309082263,1,1506,1484,0
310111210,310111213,3,1023,1965,0
311525483,311525484,1,1437,1464,0
315410141,315410142,1,848,1409,0
316537071,316537073,2,1461,1757,0
320069287,320069287,0,1872,2090,0
321329781,321329781,0,1226,1682,0
323408038,323408038,0,1794,1706,0
324647626,324647647,21,425,258,0
327560298,327560297,-1,1369,2015,0
328885837,328885829,-8,1219,5778,0
331006771,331006772,1,1069,1360,0
331311859,331311858,-1,1042,2021,0
331769658,331769663,5,2882,1834,0
332528374,332528375,1,1487,2084,0
334716003,334716005,2,1640,1907,0
338316462,338316465,3,1292,1151,0
339938830,339938831,1,1366,1728,0
340879026,340879027,1,1498,1736,0
342261106,342261106,0,1492,2449,0
343607119,343607118,-1,1024,2034,0
344380674,344380671,-3,536,2062,0
349426230,349426229,-1,1352,1620,0
355801018,355801018,0,1385,1575,0
358308105,358308106,1,1080,1674,0
359772709,359772713,4,1366,1637,0
360763174,360763174,0,1433,1749,0
361310882,361310882,0,2216,2107,0
364816602,364816605,3,1336,1808,0
366198296,366198296,0,1261,1324,0
366854879,366854879,0,826,1349,0
368205195,368205195,0,1660,2206,0
369636131,369636131,0,1364,1587,0
375554297,375554297,0,1474,1552,0
376045394,376045398,4,1268,1139,0
377744739,377744740,1,1670,2857,0
378627772,378627769,-3,1192,3500,0
380594234,380594235,1,1139,1679,0
381456626,381456623,-3,736,886,0
384010570,384010567,-3,1383,2369,0
384182623,384182618,-5,1124,3934,0
384982294,384982297,3,990,1002,0
388231634,388231635,1,1265,1294,0
390352151,390352150,-1,1105,1778,0
393210227,393210227,0,1417,1411,0
393882611,393882612,1,1312,2001,0
395409841,395409841,0,1293,2239,0
397241984,397241985,1,1359,1829,0
403389327,403389326,-1,814,1431,0
404187543,404187542,-1,2347,2249,0
404715153,404715154,1,1900,2119,0
404947315,404947317,2,1243,1687,0
405547607,405547608,1,967,1199,0
406973730,406973730,0,1621,1917,0
416695945,416695946,1,1126,1733,0
418260978,418260979,1,1272,1360,0
418624454,418624453,-1,1595,2123,0
418820355,418820355,0,1530,1349,0
419287926,419287926,0,1110,1390,0
423658997,423658998,1,1930,1955,0
424209917,424209918,1,1416,2459,0
424283601,424283598,-3,941,1473,0
427386343,427386343,0,1249,1299,0
430538942,430538941,-1,939,2191,0
430858499,430858498,-1,1357,1334,0
433948809,433948810,1,1610,1391,0
435409954,435409954,0,1572,1411,0
437804876,437804874,-2,1597,2200,0
442476047,442476048,1,1451,2328,0
444225859,444225863,4,926,1619,0
445930839,445930839,0,1665,2342,0
446641107,446641108,1,1751,2576,0
448256851,448256846,-5,1465,4412,0
448976950,448976956,6,5175,2726,0
453034831,453034829,-2,1303,2296,0
455680553,455680551,-2,31817,18911,0
456482883,456482882,-1,756,1627,0
457204125,457204126,1,1494,1830,0
457536077,457536078,1,1269,1440,0
461686273,461686274,1,1956,2380,0
463165026,463165029,3,1638,1710,0
468433265,468433265,0,1701,1725,0
471990161,471990162,1,1161,934,0
473592564,473592587,23,1406,1323,0
474323271,474323272,1,1831,2274,0
475988567,475988567,0,1524,2046,0
476485534,476485534,0,889,565,0
485663851,485663851,0,1220,1261,0
485733666,485733668,2,1461,1738,0
486679893,486679893,0,1280,1922,0
487435244,487435242,-2,1526,2306,0
489772814,489772815,1,1402,2072,0
490941182,490941183,1,1247,1692,0
496993015,496993015,0,2335,2542,0
497421009,497421010,1,1571,1273,0
499211731,499211728,-3,1065,1510,0
501303458,501303459,1,1372,1688,0
504042051,504042050,-1,937,1331,0
504992767,504992769,2,732,1169,0
506068227,506068221,-6,569,4765,0
506700918,506700918,0,1003,1037,0
507280147,507280146,-1,1365,1771,0
513357758,513357758,0,759,1113,0
514291611,514291610,-1,1085,1631,0
514360894,514360915,21,920,1155,0
515522643,515522645,2,1689,1893,0
516564962,516564954,-8,23811,15214,0
518240330,518240332,2,480,2,0
520491538,520491541,3,1113,1014,0
520999027,520999026,-1,881,2157,0
522142237,522142237,0,1868,1743,0
522911418,522911418,0,890,1826,0
526416576,526416577,1,1653,1648,0
529104469,529104469,0,1464,1962,0
531024384,531024389,5,3912,2294,0
541320498,541320498,0,1086,1696,0
541804482,541804479,-3,1179,2025,0
542793296,542793295,-1,1495,2003,0
545261327,545261327,0,1077,1502,0
545868464,545868465,1,1487,1471,0
547556545,547556548,3,2812,2533,0
549746590,549746590,0,1404,2046,0
552477322,552477322,0,1014,1835,0
554750809,554750810,1,1569,1732,0
555072061,555072061,0,1362,1866,0
555684144,555684144,0,1532,1782,0
557819263,557819258,-5,1870,8891,0
559779239,559779241,2,693,1258,0
562033319,562033323,4,1210,1033,0
563954055,563954057,2,1510,1771,0
565620510,565620511,1,1046,1291,0
566359386,566359387,1,1327,1249,0
566629576,566629576,0,1405,2390,0
568457104,568457102,-2,1223,1857,0
572072468,572072469,1,1230,1815,0
574188846,574188846,0,1104,1252,0
576386712,576386714,2,1661,1969,0
580284646,580284645,-1,1211,1653,0
580354858,580354852,-6,2464,8189,0
580991368,580991367,-1,1101,1683,0
581369763,581369760,-3,704,2107,0
584388421,584388421,0,932,1194,0
584607085,584607076,-9,1155,1520,0
585430934,585430934,0,1158,1499,0
589298614,589298626,12,294,1294,0
589883417,589883418,1,1298,1598,0
590977159,590977159,0,1114,1074,0
594227563,594227562,-1,1078,1962,0
598133545,598133547,2,19541,36474,0
600225013,600225012,-1,2109,2127,0
600552203,600552202,-1,1172,1436,0
601114601,601114599,-2,1510,1528,0
602731203,602731204,1,1683,1416,0
604830386,604830387,1,1450,1269,0
608534426,608534426,0,2591,2043,0
608676095,608676094,-1,1268,2293,0
613294947,613294947,0,1217,1981,0
613402026,613402024,-2,1438,2056,0
616043565,616043567,2,1229,1461,0
616897335,616897337,2,1559,1736,0
617575473,617575472,-1,1219,967,0
618016479,618016477,-2,1202,1780,0
624174379,624174379,0,731,1476,0
624873338,624873337,-1,1397,2063,0
626487308,626487310,2,1046,1558,0
629737783,629737782,-1,1172,1171,0
636377908,636377908,0,1624,2158,0
636834781,636834784,3,2247,1181,0
637516019,637516019,0,1802,1159,0
644499530,644499528,-2,1451,2675,0
644627025,644627026,1,1691,2471,0
649459717,649459718,1,1276,1841,0
650312238,650312237,-1,1584,1640,0
651809290,651809289,-1,1294,2443,0
655170687,655170685,-2,1130,1622,0
659774199,659774202,3,1655,1133,0
662893642,662893644,2,1592,1905,0
664160902,664160902,0,1097,1463,0
665902710,665902710,0,1590,1600,0
666002543,666002546,3,1340,1795,0
666041650,666041650,0,2202,2729,0
667175351,667175352,1,1004,1640,0
668366256,668366262,6,3450,1797,0
670561754,670561754,0,1315,1545,0
671613933,671613935,2,1323,1432,0
672186972,672186971,-1,1334,2106,0
675516587,675516587,0,1037,1013,0
675668727,675668726,-1,1255,1578,0
677473201,677473203,2,1202,1404,0
677498324,677498346,22,293,516,0
677511904,677511902,-2,90,13,0
678069710,678069711,1,1475,1415,0
679488126,679488130,4,901,897,0
681451077,681451077,0,1682,1576,0
682699842,682699843,1,1514,1523,0
686140689,686140682,-7,1369,4749,0
686580463,686580463,0,1654,2202,0
687935389,687935382,-7,1364,903,0
689367668,689367669,1,1657,1591,0
689425794,689425773,-21,1982,1674,0
690154825,690154826,1,1550,2088,0
694469717,694469717,0,1118,1361,0
694527736,694527739,3,1522,1704,0
695258473,695258473,0,1797,1553,0
696942906,696942906,0,1333,1538,0
700816118,700816118,0,1350,2107,0
701489949,701489950,1,1422,1774,0
702361743,702361746,3,1160,1632,0
704701535,704701535,0,1244,1462,0
706791459,706791462,3,1157,1201,0
707387855,707387857,2,1311,1418,0
709226854,709226853,-1,599,1428,0
710514808,710514810,2,1703,1605,0
710564209,710564211,2,1361,1212,0
713078179,713078178,-1,1364,1535,0
715927850,715927850,0,832,1205,0
718071199,718071198,-1,1355,2238,0
720492131,720492132,1,1372,1370,0
723669202,723669205,3,1602,1616,0
727463846,727463838,-8,1235,1402,0
731303826,731303827,1,885,1029,0
733313808,733313801,-7,1133,5131,0
734367058,734367059,1,1383,1793,0
735367713,735367719,6,1512,1041,0
738115846,738115844,-2,1474,1877,0
739448701,739448702,1,1871,2001,0
741442249,741442247,-2,1461,1660,0
743015530,743015530,0,1735,1971,0
743832605,743832606,1,1232,1684,0
745100073,745100075,2,1890,1562,0
746589373,746589374,1,1496,1246,0
748061675,748061677,2,1388,1776,0
751863189,751863190,1,1715,2021,0
752311850,752311851,1,1402,1498,0
754844841,754844842,1,1312,1260,0
755773501,755773499,-2,1320,1662,0
760516161,760516159,-2,1378,1857,0
762780108,762780113,5,3054,1559,0
764327545,764327546,1,1822,2654,0
765509222,765509229,7,17339,28304,0
770166857,770166858,1,1061,1516,0
772315354,772315350,-4,957,1244,0
774906526,774906526,0,1336,2321,0
776264335,776264336,1,2034,1729,0
783167157,783167158,1,1930,1915,0
786010146,786010147,1,1812,2450,0
790282818,790282824,6,1183,1090,0
792043177,792043178,1,1620,1685,0
792598075,792598077,2,901,1312,0
800298774,800298774,0,1063,1489,0
800648815,800648816,1,1109,1596,0
801128600,801128602,2,1667,1770,0
801920461,801920459,-2,1172,1747,0
803454094,803454099,5,2623,1264,0
803791396,803791395,-1,977,1589,0
809648162,809648163,1,1552,2621,0
811070344,811070344,0,1410,1843,0
813227720,813227720,0,1406,1670,0
814636125,814636126,1,1300,1385,0
817654421,817654421,0,1497,1532,0
820359631,820359631,0,1938,2465,0
823056199,823056198,-1,1942,2080,0
825827094,825827093,-1,1198,1070,0
826139620,826139614,-6,927,4634,0
828993896,828993894,-2,1219,2321,0
830912927,830912926,-1,971,1637,0
832142621,832142623,2,1769,1749,0
833194039,833194040,1,1395,2711,0
833867502,833867501,-1,1344,1627,0
835745371,835745372,1,1415,1613,0
836308451,836308453,2,1471,1566,0
837459272,837459272,0,1140,1665,0
837893559,837893561,2,1299,1454,0
841321605,841321608,3,1481,2078,0
841886291,841886291,0,1513,2162,0
844498404,844498402,-2,1838,2084,0
846266457,846266455,-2,1447,1373,0
850294803,850294800,-3,1076,2286,0
850610979,850610981,2,956,1399,0
852394919,852394918,-1,1263,1462,0
853652002,853652002,0,1361,1127,0
858307661,858307661,0,1356,2123,0
859341181,859341179,-2,1412,1551,0
861182101,861182123,22,571,1325,0
861462272,861462271,-1,1129,1629,0
862183642,862183646,4,1400,1553,0
864223113,864223118,5,3284,1318,0
866685383,866685386,3,1316,772,0
876930768,876930766,-2,1181,1821,0
878060896,878060895,-1,1760,1971,0
883123595,883123596,1,1000,1569,0
883181715,883181717,2,1066,1332,0
884410383,884410380,-3,2023,4962,0
885365991,885365992,1,1875,1940,0
897173670,897173669,-1,1635,2175,0
897575315,897575316,1,909,1974,0
897904263,897904266,3,1187,1401,0
900946409,900946409,0,1557,1921,0
905111900,905111899,-1,1133,1957,0
905861631,905861634,3,1300,1655,0
911735734,911735713,-21,827,762,0
913693382,913693381,-1,1258,1712,0
918119431,918119431,0,1197,1681,0
918601598,918601599,1,2212,2096,0
920418582,920418582,0,1199,1760,0
927238850,927238851,1,757,855,0
927345336,927345338,2,1286,1227,0
928848827,928848831,4,2155,1278,0
929960863,929960864,1,1625,1770,0
931384858,931384859,1,1276,1491,0
931766306,931766306,0,1818,1866,0
933563570,933563570,0,1503,1720,0
938331635,938331635,0,1594,1735,0
942180846,942180845,-1,1284,1845,0
942246279,942246279,0,979,1295,0
944918791,944918793,2,1219,1014,0
948735126,948735127,1,1460,1675,0
949644755,949644755,0,1169,1198,0
952097076,952097077,1,1466,1721,0
952333887,952333888,1,1242,1361,0
953765343,953765344,1,1347,1870,0
954321780,954321780,0,2088,2284,0
955485846,955485847,1,956,1736,0
957941666,957941667,1,607,1134,0
959458171,959458171,0,1217,1403,0
962559999,962559999,0,1443,1775,0
963671098,963671098,0,1337,1296,0
964407254,964407255,1,3595,4101,0
966050286,966050286,0,819,1740,0
967236536,967236537,1,1276,1257,0
973027090,973027111,21,444,863,0
976088252,976088253,1,1784,1503,0
977125543,977125541,-2,1804,1960,0
977911234,977911239,5,1654,1229,0
980166543,980166545,2,1447,1864,0
981717000,981716990,-10,1713,1897,0
984265233,984265233,0,1881,2157,0
984614514,984614510,-4,2267,7376,0
987316846,987316846,0,1054,1568,0
992808218,992808218,0,1164,1328,0
995060266,995060266,0,1923,1452,0
995423322,995423323,1,1523,2335,0
995982852,995982853,1,1646,1470,0
999421285,999421284,-1,1533,1873,0
1004174687,1004174694,7,3141,943,0
1007343980,1007343981,1,1293,2070,0
1009348666,1009348666,0,1373,1434,0
1009834961,1009834966,5,2544,1975,0
1014384173,1014384174,1,2340,1165,0
1014659595,1014659596,1,20596,28929,0
1016589990,1016589990,0,777,816,0
1018081879,1018081880,1,2071,2188,0
1020645009,1020645008,-1,1376,1980,0
1022339873,1022339875,2,1313,1827,0
1022984186,1022984187,1,1894,1655,0
1026366507,1026366506,-1,932,2084,0
1027785574,1027785575,1,1136,1214,0
1029105641,1029105640,-1,1538,2293,0
1030618624,1030618622,-2,1853,2305,0
1031157763,1031157765,2,1618,1480,0
1031250531,1031250532,1,1155,1389,0
1031748670,1031748673,3,2011,1582,0
1034832278,1034832277,-1,1512,2542,0
1035196983,1035196982,-1,1503,1832,0
1037850594,1037850593,-1,1306,1502,0
1038240053,1038240053,0,1576,2094,0
1039634002,1039634001,-1,1521,2061,0
1041843573,1041843573,0,738,1349,0
1043778759,1043778763,4,1402,920,0
1044314478,1044314478,0,1765,2092,0
1044914612,1044914613,1,1432,1403,0
1046455873,1046455874,1,1674,1903,0
1047674423,1047674425,2,1275,2123,0
1049086492,1049086495,3,2624,2655,0
1051265519,1051265517,-2,1247,1391,0
1052508421,1052508421,0,1339,1459,0
1057676461,1057676463,2,1306,1501,0
1059235577,1059235579,2,1736,1526,0
1060868520,1060868521,1,1421,2216,0
1061182777,1061182777,0,1837,1685,0
1061408686,1061408686,0,1777,1971,0
1062736799,1062736797,-2,1307,1686,0
1063308591,1063308594,3,32904,43483,0
1066079251,1066079250,-1,869,1519,0
1067617246,1067617246,0,1191,1797,0
1067649626,1067649625,-1,1132,2368,0
1068587563,1068587563,0,1281,1406,0
1069556207,1069556210,3,2083,2237,0
1069942770,1069942769,-1,1493,2357,0
1071240471,1071240470,-1,1767,2060,0
1074689757,1074689758,1,1084,1158,0
1076825051,1076825049,-2,1321,1111,0
1078029684,1078029686,2,1401,1882,0
1078952538,1078952518,-20,954,1382,0
1079526321,1079526321,0,1378,1025,0
1080853907,1080853908,1,993,1561,0
1088547855,1088547856,1,986,1402,0
1090299770,1090299769,-1,1269,2341,0
1091409219,1091409224,5,1472,1823,0
1093673507,1093673505,-2,1356,1306,0
1100291929,1100291928,-1,1824,1792,0
1102590870,1102590872,2,1182,1379,0
1103798998,1103798999,1,1404,1865,0
1108054835,1108054833,-2,1419,1997,0
1109494562,1109494562,0,1329,1598,0
1110634649,1110634650,1,1454,1398,0
1111508429,1111508445,16,212,980,0
1114169998,1114169998,0,1541,1509,0
1114895162,1114895162,0,1865,1928,0
1116472470,1116472470,0,1121,989,0
1122443518,1122443518,0,1633,1705,0
1123459663,1123459663,0,1721,1755,0
1126879871,1126879871,0,1288,1877,0
1129089238,1129089242,4,1166,1451,0
1131944925,1131944924,-1,1353,2055,0
1133554446,1133554446,0,1155,1163,0
1134145794,1134145793,-1,2315,3542,0
1138151333,1138151333,0,1194,1418,0
1141122439,1141122438,-1,1076,1792,0
1141345769,1141345768,-1,1211,1498,0
1144418891,1144418890,-1,1225,1939,0
1144680124,1144680126,2,1335,1669,0
1144927347,1144927342,-5,1268,1554,0
1147399009,1147399009,0,1060,1706,0
1148843426,1148843426,0,1028,1405,0
1155903917,1155903918,1,1459,1695,0
1157167769,1157167768,-1,1115,1412,0
1158679399,1158679400,1,1388,1477,0
1160395908,1160395908,0,1416,1701,0
1161127711,1161127711,0,1475,2052,0
1162197232,1162197233,1,1223,1522,0
1164299304,1164299305,1,1493,1639,0
1164943622,1164943623,1,2396,2180,0
1170598096,1170598096,0,1655,1940,0
1176219470,1176219470,0,1599,1653,0
1176380386,1176380388,2,1208,1270,0
1178548749,1178548749,0,1491,1756,0
1178760482,1178760502,20,1013,1226,0
1180732022,1180732003,-19,2501,2539,0
1182540241,1182540242,1,1299,1233,0
1184099281,1184099278,-3,1456,1401,0
1184621485,1184621477,-8,1974,8337,0
1185144962,1185144961,-1,940,955,0
1187625059,1187625060,1,1292,1567,0
1191535622,1191535623,1,1189,1339,0
1195107208,1195107209,1,1557,1424,0
1195954206,1195954206,0,1091,2047,0
1197525621,1197525621,0,1575,2493,0
1200472170,1200472169,-1,1621,1684,0
1201318953,1201318955,2,1580,1437,0
1205129663,1205129662,-1,2284,1586,0
1205410198,1205410198,0,1223,1567,0
1205456391,1205456391,0,1278,1239,0
1205940898,1205940898,0,1701,1630,0
1207854454,1207854459,5,3266,1106,0
1208344117,1208344119,2,983,1623,0
1209633671,1209633671,0,1675,2260,0
1210378351,1210378342,-9,16425,51996,0
1211594515,1211594514,-1,2068,2671,0
1213644533,1213644534,1,1735,1769,0
1215237575,1215237570,-5,949,2963,0
1215588229,1215588227,-2,1150,2388,0
1219774843,1219774843,0,973,885,0
1219971424,1219971429,5,4295,2411,0
1222146095,1222146095,0,1126,1297,0
1233770416,1233770417,1,1078,1224,0
1235288106,1235288103,-3,1206,2458,0
1235441148,1235441148,0,1249,1487,0
1235797110,1235797111,1,1840,2244,0
1236649263,1236649262,-1,1088,1880,0
1239335441,1239335440,-1,1535,1872,0
1241605967,1241605966,-1,2361,4369,0
1242513171,1242513170,-1,1010,1178,0
1244348481,1244348482,1,1739,1630,0
1246238702,1246238702,0,1434,1737,0
1248540010,1248540012,2,1089,1373,0
1248740597,1248740598,1,1551,2171,0
1256642571,1256642576,5,4954,3326,0
1257188046,1257188046,0,2070,2300,0
1259075050,1259075050,0,1373,1614,0
1259874521,1259874522,1,1338,1521,0
1259978203,1259978203,0,1447,1397,0
1260626220,1260626220,0,1895,1527,0
1260896571,1260896573,2,1663,1600,0
1263008846,1263008846,0,1214,1869,0
1263617670,1263617671,1,1556,1538,0
1266224448,1266224446,-2,1477,1779,0
1266328857,1266328858,1,1592,2129,0
1268498915,1268498915,0,1076,1422,0
1273214170,1273214174,4,2035,1845,0
1274772508,1274772509,1,1248,2009,0
1276327372,1276327374,2,1656,1645,0
1276664549,1276664550,1,1314,1374,0
1277017990,1277017993,3,1749,1433,0
1280918542,1280918542,0,1264,1812,0
1281215045,1281215047,2,1904,1690,0
1282145110,1282145112,2,1318,2271,0
1282892993,1282892994,1,1602,2683,0
1285379191,1285379192,1,2007,2224,0
1285666822,1285666821,-1,1527,1615,0
1286270656,1286270656,0,1501,1259,0
1287411045,1287411046,1,1780,2362,0
1288645548,1288645546,-2,2272,2475,0
1288926098,1288926099,1,1735,2498,0
1289738729,1289738729,0,1317,1272,0
1291346959,1291346959,0,1199,1286,0
1291732313,1291732314,1,1244,1430,0
1292245995,1292245997,2,1553,1690,0
1293430986,1293430987,1,1074,1551,0
1297179236,1297179237,1,1538,1950,0
1297976162,1297976160,-2,1124,1409,0
1298499165,1298499165,0,831,1670,0
1298824270,1298824270,0,2011,2305,0
1300189192,1300189196,4,2266,1564,0
1302485805,1302485806,1,1290,1754,0
1305100523,1305100525,2,985,1846,0
1305920361,1305920361,0,1370,1575,0
1306323844,1306323844,0,1800,1608,0
1309110611,1309110610,-1,1792,1666,0
1309952982,1309952983,1,1220,1814,0
1310422664,1310422671,7,2228,788,0
1311656958,1311656958,0,1511,1593,0
1313661823,1313661825,2,1645,1728,0
1314233794,1314233794,0,1550,2090,0
1316643241,1316643243,2,1494,2059,0
1317076040,1317076041,1,1585,2164,0
1318482791,1318482810,19,339,1418,0
1321546086,1321546086,0,1300,1943,0
1325094758,1325094758,0,1366,1706,0
1326299734,1326299733,-1,1345,1429,0
1331347655,1331347662,7,5585,1379,0
1337900599,1337900599,0,1256,1501,0
1337956501,1337956502,1,1817,2018,0
1338540861,1338540861,0,1235,1707,0
1344435126,1344435129,3,1178,1469,0
1344712495,1344712478,-17,1391,1743,0
1345359029,1345359021,-8,890,1039,0
1348860287,1348860289,2,1581,2648,0
1349099502,1349099504,2,1731,2208,0
1350275310,1350275310,0,1599,1523,0
1350312814,1350312820,6,1131,1091,0
1354255634,1354255635,1,1120,1134,0
1354993742,1354993742,0,1180,1612,0
1355355633,1355355634,1,1044,2111,0
1357158331,1357158333,2,1594,1989,0
1359866758,1359866757,-1,1549,2078,0
1360450207,1360450210,3,2382,1883,0
1367986615,1367986614,-1,887,1669,0
1374468870,1374468870,0,1607,1633,0
1375753798,1375753799,1,1257,1274,0
1376197449,1376197448,-1,1284,1947,0
1376316995,1376316994,-1,884,1437,0
1376682146,1376682147,1,950,1442,0
1378315402,1378315402,0,1654,2250,0
1381083551,1381083551,0,1960,2230,0
1381376919,1381376919,0,1002,1259,0
1383492605,1383492605,0,1470,1615,0
1387071126,1387071125,-1,1523,2292,0
1389178778,1389178777,-1,865,1287,0
1392421814,1392421815,1,1083,982,0
1392664061,1392664061,0,1573,2194,0
1396064799,1396064801,2,2329,1810,0
1399921750,1399921750,0,1344,2199,0
1400796429,1400796451,22,1139,1862,0
1401082651,1401082649,-2,1121,1030,0
1406529374,1406529376,2,1544,1767,0
1409745395,1409745372,-23,892,1079,0
1418798761,1418798762,1,1345,2054,0
1425761470,1425761471,1,1413,1824,0
1426102126,1426102129,3,1441,2568,0
1428614979,1428614978,-1,1594,1993,0
1431266978,1431266978,0,1253,1651,0
1432461723,1432461721,-2,2697,5744,0
1437566865,1437566866,1,1285,955,0
1439841994,1439841994,0,1411,2168,0
1447705169,1447705171,2,1727,1895,0
1449558315,1449558315,0,1570,1990,0
1450560069,1450560072,3,1647,1439,0
1450736361,1450736361,0,1376,1576,0
1451590534,1451590534,0,1503,2454,0
1451817321,1451817322,1,1412,1894,0
1452779453,1452779454,1,1689,1510,0
1455751994,1455751994,0,1396,1559,0
1455866939,1455866938,-1,1068,1458,0
1458644054,1458644059,5,2043,1632,0
1462570453,1462570455,2,1614,2129,0
1463459443,1463459445,2,1191,1686,0
1467405930,1467405930,0,1194,2120,0
1469522661,1469522661,0,1332,1648,0
1471639297,1471639299,2,1359,1577,0
1474272895,1474272897,2,2169,1577,0
1477599443,1477599445,2,3226,2356,0
1479111376,1479111375,-1,850,901,0
1484296415,1484296415,0,1735,1332,0
1486083945,1486083946,1,1588,2410,0
1488564575,1488564574,-1,1076,1707,0
1489321907,1489321909,2,1978,2018,0
1491158353,1491158354,1,1193,1753,0
1491654777,1491654778,1,1467,2025,0
1492160202,1492160199,-3,1467,1685,0
1493242359,1493242361,2,1766,2390,0
1497673958,1497673958,0,1127,1199,0
1499154062,1499154057,-5,990,3861,0
1501260838,1501260839,1,1288,1867,0
1505554322,1505554323,1,834,1164,0
1509818059,1509818060,1,833,1120,0
1512740617,1512740619,2,1214,1318,0
1513766531,1513766530,-1,1163,1493,0
1516915155,1516915154,-1,1470,2116,0
1517090647,1517090648,1,1289,1573,0
1520801780,1520801779,-1,1241,1548,0
1521028809,1521028805,-4,1231,3487,0
1521066309,1521066310,1,1301,1738,0
1521211038,1521211054,16,1364,1478,0
1522409334,1522409336,2,1224,1563,0
1528552590,1528552592,2,1481,1821,0
1529988201,1529988204,3,1801,2172,0
1530300122,1530300121,-1,1155,1758,0
1532484083,1532484084,1,1289,1769,0
1532838334,1532838329,-5,21699,16949,0
1533511747,1533511746,-1,1210,1387,0
1534069404,1534069403,-1,1955,2476,0
1535116515,1535116515,0,1221,1497,0
1535288149,1535288145,-4,682,1681,0
1535687207,1535687206,-1,862,1123,0
1538160750,1538160763,13,2146,1948,0
1539587921,1539587921,0,1175,1523,0
1539910374,1539910374,0,818,1214,0
1542275614,1542275614,0,1528,1784,0
1546458963,1546458962,-1,1702,1532,0
1547762833,1547762836,3,1940,1415,0
1548957813,1548957796,-17,1421,1971,0
1551226969,1551226971,2,1027,1516,0
1552963604,1552963603,-1,1193,1335,0
1553805987,1553805987,0,1650,2397,0
1553891919,1553891918,-1,987,1646,0
1554223846,1554223846,0,1653,1806,0
1557747053,1557747053,0,1506,1823,0
1562233494,1562233493,-1,1361,2014,0
1562789913,1562789912,-1,1262,1384,0
1562840498,1562840476,-22,1144,1267,0
1563769838,1563769833,-5,24535,13973,0
1564825498,1564825502,4,1109,1032,0
1567886225,1567886227,2,1244,1302,0
1571344951,1571344950,-1,1614,1806,0
1571904727,1571904727,0,1475,1531,0
1572595106,1572595086,-20,1504,2076,0
1573050831,1573050829,-2,1132,1236,0
1573258698,1573258698,0,1395,1823,0
1575177299,1575177299,0,1626,2062,0
1575352012,1575352010,-2,1227,1567,0
1578693458,1578693453,-5,839,3735,0
1583769481,1583769482,1,1649,1875,0
1583976130,1583976130,0,1233,1545,0
1585812499,1585812500,1,1264,1757,0
1585976179,1585976181,2,1777,2128,0
1588923921,1588923926,5,1716,1253,0
1590572774,1590572773,-1,1841,2607,0
1591260962,1591260963,1,1589,1385,0
1591827436,1591827437,1,932,1587,0
1597182246,1597182246,0,1285,1733,0
1597376487,1597376486,-1,1381,1687,0
1598054557,1598054558,1,1244,1907,0
1599164535,1599164537,2,1217,1717,0
1599853913,1599853914,1,1796,1589,0
1600127374,1600127391,17,1477,1360,0
1601486634,1601486634,0,759,1147,0
1603150921,1603150924,3,2711,1733,0
1603951946,1603951928,-18,1319,981,0
1604554594,1604554595,1,1404,1743,0
1608156419,1608156418,-1,1218,1876,0
1609219550,1609219550,0,1799,1918,0
1612180712,1612180711,-1,1153,1307,0
1620336908,1620336908,0,1749,2598,0
1623483095,1623483095,0,1433,1451,0
1625744501,1625744502,1,1806,1294,0
1628165647,1628165646,-1,1556,1849,0
1629159511,1629159512,1,964,1705,0
1631745777,1631745777,0,1488,1707,0
1634759118,1634759123,5,4149,2567,0
1638152620,1638152622,2,1338,2006,0
1645439021,1645439022,1,1460,1854,0
1646138831,1646138831,0,1931,1905,0
1648216003,1648216006,3,1060,1451,0
1651472630,1651472632,2,1213,1404,0
1652079601,1652079602,1,1475,2330,0
1653009198,1653009200,2,1706,1527,0
1656179122,1656179124,2,1685,1638,0
1659580811,1659580810,-1,1250,1336,0
1660588504,1660588504,0,1551,1464,0
1661244938,1661244938,0,770,1408,0
1662805098,1662805099,1,1354,1402,0
1663153751,1663153751,0,1585,1382,0
1671857376,1671857377,1,1151,1446,0
1672564408,1672564406,-2,1856,2616,0
1673181423,1673181434,11,536,2038,0
1676958119,1676958122,3,2268,1360,0
1677491006,1677491004,-2,814,1665,0
1679707740,1679707742,2,1269,1679,0
1683864371,1683864373,2,1830,2047,0
1686541378,1686541379,1,1495,1688,0
1690515607,1690515609,2,1492,1138,0
1690996787,1690996786,-1,1724,2089,0
1692006018,1692006019,1,794,1136,0
1692358066,1692358067,1,1775,1619,0
1692737883,1692737882,-1,798,1362,0
1695311206,1695311209,3,1887,1755,0
1698901754,1698901758,4,1732,971,0
1698981002,1698980980,-22,724,1095,0
1699329579,1699329582,3,992,1480,0
1700386017,1700386019,2,1863,1678,0
1700426229,1700426229,0,1015,1140,0
1700908974,1700908974,0,1515,1408,0
1702234252,1702234253,1,1063,1922,0
1704591255,1704591254,-1,1785,2461,0
1705065362,1705065363,1,1302,1463,0
1705491905,1705491905,0,1999,2035,0
1713821350,1713821347,-3,1702,5326,0
1714806238,1714806238,0,1687,1732,0
1715026193,1715026193,0,1219,1638,0
1722296786,1722296785,-1,1016,1201,0
1725296946,1725296947,1,1241,1273,0
1729647515,1729647518,3,2392,1648,0
1730691282,1730691282,0,1198,1427,0
1736677510,1736677510,0,1220,1922,0
1737267328,1737267326,-2,1609,1522,0
1737829859,1737829860,1,1041,1602,0
1738745390,1738745391,1,1953,1846,0
1739001729,1739001730,1,2139,2595,0
1739665226,1739665226,0,1755,1562,0
1740281797,1740281795,-2,1213,922,0
1740432242,1740432239,-3,1051,1400,0
1741797818,1741797821,3,1877,2010,0
1741913841,1741913844,3,1561,1445,0
1745267819,1745267821,2,1141,1521,0
1748881183,1748881182,-1,1316,1485,0
1749352702,1749352705,3,1476,2153,0
1751686928,1751686929,1,1383,1933,0
1752317170,1752317167,-3,1073,1668,0
1752954478,1752954479,1,1356,1190,0
1755069718,1755069718,0,1344,1353,0
1757765449,1757765449,0,1584,2090,0
1767023570,1767023569,-1,1529,1733,0
1768226270,1768226270,0,1361,1060,0
1768745690,1768745688,-2,1356,3290,0
1769086073,1769086074,1,1086,1490,0
1770025581,1770025579,-2,1615,1581,0
1775286579,1775286578,-1,931,2234,0
1775732293,1775732293,0,1300,1993,0
1777263482,1777263483,1,1110,1221,0
1779207595,1779207592,-3,1334,2310,0
1781820426,1781820426,0,1640,1836,0
1781989375,1781989376,1,1304,1638,0
1786977004,1786977004,0,1570,2024,0
1791356101,1791356102,1,2196,1775,0
1791965382,1791965382,0,856,1188,0
1792117638,1792117632,-6,2439,7816,0
1792721626,1792721625,-1,1163,1396,0
1793240210,1793240211,1,802,746,0
1793832597,1793832600,3,1363,1544,0
1798061625,1798061625,0,1063,1918,0
1799284530,1799284530,0,1177,1777,0
1801551116,1801551117,1,1238,1721,0
1802542738,1802542739,1,825,1118,0
1804044416,1804044417,1,1118,1165,0
1804144391,1804144373,-18,2721,1451,0
1805236465,1805236466,1,1452,1136,0
1806972038,1806972039,1,1206,983,0
1808069282,1808069281,-1,2299,1963,0
1811289878,1811289879,1,1240,1698,0
1812679409,1812679409,0,1561,1799,0
1814396338,1814396338,0,1543,1328,0
1814662812,1814662813,1,846,1128,0
1814836859,1814836838,-21,1546,2014,0
1818751990,1818751991,1,1375,1715,0
1820804610,1820804610,0,1171,1434,0
1823159849,1823159850,1,1351,1853,0
1823270558,1823270574,16,724,1694,0
1825819178,1825819178,0,1912,2322,0
1826772330,1826772334,4,1390,1241,0
1831650781,1831650783,2,892,1044,0
1833302383,1833302385,2,1251,1991,0
1834047777,1834047778,1,1235,1491,0
1835150715,1835150715,0,1165,1583,0
1835314930,1835314930,0,1479,2136,0
1836575050,1836575050,0,1571,1250,0
1837776532,1837776535,3,1306,1378,0
1841842674,1841842676,2,1766,1864,0
1842950707,1842950684,-23,1909,1541,0
1846919855,1846919855,0,1364,1647,0
1848678585,1848678585,0,31706,17180,0
1852873619,1852873619,0,1065,1002,0
1855161223,1855161227,4,2362,1291,0
1856876004,1856876003,-1,1171,1650,0
1862515620,1862515620,0,1629,2413,0
1868223558,1868223560,2,1421,2052,0
1868921942,1868921942,0,1608,2271,0
1869861570,1869861575,5,1277,890,0
1870733796,1870733795,-1,1514,1734,0
1879279846,1879279827,-19,1342,1304,0
1881579143,1881579143,0,1218,1377,0
1884134953,1884134953,0,995,1168,0
1886344229,1886344243,14,914,1400,0
1886697470,1886697474,4,1313,1379,0
1888739455,1888739455,0,1535,1376,0
1890053738,1890053738,0,1123,1235,0
1894746559,1894746562,3,897,647,0
1898151802,1898151804,2,1386,1726,0
1900377429,1900377437,8,7031,37269,0
1901273094,1901273094,0,1222,2185,0
1909644915,1909644917,2,1292,1476,0
1913598589,1913598591,2,1079,1086,0
1918759763,1918759762,-1,1496,1842,0
1924168482,1924168483,1,1290,1385,0
1925224203,1925224214,11,1006,815,0
1925358296,1925358298,2,1227,1060,0
1926491462,1926491450,-12,934,2091,0
1927732355,1927732354,-1,1801,1646,0
1928101174,1928101178,4,1561,1962,0
1928693101,1928693103,2,1478,1775,0
1929684240,1929684238,-2,1604,1671,0
1930290610,1930290609,-1,1705,1481,0
1931631674,1931631671,-3,1785,2262,0
1935559038,1935559037,-1,1181,1507,0
1937256786,1937256786,0,1488,2010,0
1940159610,1940159611,1,1379,1279,0
1941354922,1941354922,0,1383,1940,0
1941459646,1941459650,4,1502,1485,0
1941780314,1941780313,-1,1578,1189,0
1945366968,1945366970,2,1517,1824,0
1946544846,1946544846,0,1398,1565,0
1947006395,1947006396,1,1790,1946,0
1949851506,1949851506,0,1459,1329,0
1950001314,1950001315,1,1618,1872,0
1950836129,1950836130,1,1247,1621,0
1952686658,1952686658,0,1878,2357,0
1954359638,1954359638,0,1407,1209,0
1956337688,1956337689,1,1792,1727,0
1957426577,1957426578,1,1520,1811,0
1957827365,1957827368,3,1489,1210,0
1961227003,1961227000,-3,1334,2202,0
1962216290,1962216292,2,1862,1769,0
1962614197,1962614205,8,12900,27044,0
1968957342,1968957342,0,1671,1229,0
1975205147,1975205147,0,1145,1260,0
1981070410,1981070412,2,1672,1729,0
1984803314,1984803315,1,1190,1030,0
1986203806,1986203806,0,1562,2462,0
1988070406,1988070407,1,987,2204,0
1988943859,1988943861,2,1471,1854,0
1989257955,1989257953,-2,1244,1680,0
1992960902,1992960905,3,1907,1913,0
1993001014,1993001017,3,1452,1387,0
1994007972,1994007970,-2,1313,1610,0
1996301082,1996301082,0,1437,1642,0
1999927430,1999927431,1,1546,1334,0
2000204995,2000204995,0,1076,1366,0
2003663414,2003663413,-1,1405,1700,0
2004864122,2004864123,1,1436,1976,0
2005560975,2005560974,-1,1283,1565,0
2007630064,2007630067,3,1658,1738,0
2009504202,2009504202,0,730,1204,0
2009635366,2009635366,0,998,1566,0
2012063979,2012063981,2,1248,1333,0
2013704466,2013704467,1,2627,2806,0
2016129686,2016129687,1,2027,1627,0
2016314170,2016314169,-1,1147,1870,0
2017029071,2017029072,1,1112,1190,0
2017452898,2017452899,1,1271,2016,0
2019870602,2019870581,-21,711,1178,0
2021015934,2021015934,0,3090,4113,0
2023150339,2023150338,-1,1492,1623,0
2024222665,2024222665,0,1469,1548,0
2026170434,2026170432,-2,1197,2197,0
2027658657,2027658658,1,1118,1307,0
2028845842,2028845843,1,1336,2000,0
2029519154,2029519156,2,1866,1925,0
2030261495,2030261494,-1,1285,1869,0
2031691119,2031691119,0,898,1115,0
2034138011,2034137999,-12,1419,1616,0
2035988295,2035988295,0,1365,1906,0
2037838752,2037838742,-10,31265,17386,0
2039057475,2039057473,-2,1616,2034,0
2040683636,2040683636,0,1216,2091,0
2041193042,2041193043,1,1622,1478,0
2045267675,2045267676,1,1529,1909,0
2046359177,2046359178,1,1532,1629,0
2048375340,2048375337,-3,1765,3966,0
2049584314,2049584315,1,1788,2805,0
2052406256,2052406257,1,1321,1439,0
2052736266,2052736271,5,1901,1236,0
2053501637,2053501637,0,1412,1824,0
2058340362,2058340379,17,546,815,0
2060469837,2060469835,-2,1068,1074,0
2061210673,2061210672,-1,1196,1350,0
2064704569,2064704569,0,1489,2607,0
2065355072,2065355071,-1,1224,1258,0
2067358283,2067358284,1,1043,1836,0
2068027751,2068027752,1,2149,2469,0
2073047843,2073047844,1,1392,1965,0
2076669843,2076669845,2,1703,1765,0
2078694979,2078694979,0,1419,1629,0
2079857186,2079857188,2,1131,1666,0
2080945415,2080945416,1,1341,1167,0
2082527822,2082527819,-3,779,2157,0
2083329459,2083329462,3,1297,1522,0
2088308869,2088308870,1,1537,2251,0
2089598366,2089598366,0,1194,1088,0
2090201286,2090201285,-1,1335,2032,0
2091438240,2091438239,-1,1253,1420,0
2095375269,2095375262,-7,942,4067,0
2095646278,2095646278,0,1631,1828,0
2096629951,2096629952,1,1480,1087,0
2103453496,2103453499,3,1407,1381,0
2104238661,2104238665,4,3302,1455,0
2107580958,2107580957,-1,1362,1780,0
2110244303,2110244302,-1,1272,1637,0
2111230357,2111230358,1,919,1478,0
2112743018,2112743019,1,1290,1967,0
2115743559,2115743561,2,974,1208,0
2117655225,2117655225,0,1470,2252,0
2118972542,2118972541,-1,1524,1910,0
2122985850,2122985847,-3,1134,1806,0
2123159150,2123159142,-8,1174,1689,0
2124945924,2124945909,-15,959,1148,0
2136201344,2136201345,1,1090,1811,0
2137137451,2137137451,0,1203,1460,0
2137655417,2137655418,1,1627,1529,0
2138224786,2138224786,0,2336,2390,0
2138815490,2138815493,3,1439,1509,0
2142556786,2142556786,0,1981,1634,0
2142684794,2142684794,0,1153,1626,0
2144444907,2144444907,0,1145,1731,0
2144943294,2144943299,5,1261,1353,0
2145726424,2145726425,1,1257,1839,0
2147107191,2147107189,-2,2426,5569,0
2149018955,2149018955,0,1707,1965,0
2151287876,2151287876,0,1243,1564,0
2152667894,2152667895,1,1013,1633,0
2155248251,2155248253,2,1459,1477,0
2156965749,2156965747,-2,1950,2001,0
2157412115,2157412119,4,1129,1332,0
2162294174,2162294175,1,1296,1571,0
2165618988,2165618989,1,1448,1384,0
2168959301,2168959302,1,1604,1424,0
2171101814,2171101814,0,1017,2221,0
2173918126,2173918126,0,1011,1627,0
2175068883,2175068882,-1,1073,1558,0
2175713369,2175713370,1,1014,1740,0
2177330453,2177330467,14,1334,1199,0
2177432022,2177432008,-14,362,215,0
2177550563,2177550561,-2,905,1813,0
2178299917,2178299918,1,1346,1931,0
2188682583,2188682583,0,1282,2262,0
2189132365,2189132370,5,2175,1426,0
2192953025,2192953019,-6,86,1281,0
2198232573,2198232571,-2,1080,1850,0
2199278598,2199278602,4,1881,1374,0
2205419907,2205419907,0,693,1042,0
2207894879,2207894879,0,2041,2089,0
2208904494,2208904497,3,1434,2000,0
2209816727,2209816729,2,1178,1629,0
2214229131,2214229118,-13,881,1080,0
2214740368,2214740374,6,1506,565,0
2217169414,2217169413,-1,866,1254,0
2220219330,2220219319,-11,1002,1069,0
2224740158,2224740157,-1,1345,1217,0
2225376826,2225376836,10,13792,33313,0
2226503188,2226503189,1,1645,1788,0
2227336394,2227336395,1,1604,1704,0
2228098242,2228098242,0,1650,1424,0
2228702626,2228702627,1,1044,1507,0
2229226569,2229226570,1,1372,1566,0
2230901252,2230901251,-1,1714,1847,0
2231773531,2231773533,2,1484,1249,0
2232916722,2232916722,0,1213,1484,0
2234253367,2234253366,-1,742,1186,0
2234685314,2234685313,-1,1454,1890,0
2235704450,2235704449,-1,1430,1426,0
2235998437,2235998437,0,882,1389,0
2236721161,2236721162,1,1279,1699,0
2238064951,2238064954,3,1332,1320,0
2239054546,2239054542,-4,26880,10937,0
2239607689,2239607691,2,1273,1842,0
2241602598,2241602601,3,1826,1841,0
2243376467,2243376465,-2,1296,1470,0
2247365007,2247365009,2,1369,871,0
2250109110,2250109107,-3,1898,2295,0
2251700306,2251700302,-4,733,1661,0
2253035297,2253035297,0,1086,1187,0
2253241995,2253241989,-6,1466,6024,0
2256226738,2256226738,0,1728,2116,0
2258263986,2258263987,1,1051,1653,0
2259997398,2259997397,-1,1007,1426,0
2264580257,2264580258,1,1070,1844,0
2265826379,2265826379,0,768,1530,0
2272090315,2272090316,1,1883,2032,0
2273424835,2273424836,1,1407,1777,0
2274486572,2274486571,-1,997,845,0
2275347818,2275347818,0,1071,1469,0
2278665758,2278665756,-2,1403,1564,0
2281024752,2281024751,-1,1511,1625,0
2281113011,2281113010,-1,1155,1342,0
2282454102,2282454102,0,1481,1262,0
2282674148,2282674147,-1,1288,2067,0
2283737239,2283737238,-1,1352,2240,0
2284020174,2284020175,1,1103,1427,0
2291007571,2291007579,8,4005,1301,0
2293185834,2293185839,5,1215,1133,0
2300371115,2300371113,-2,1257,1342,0
2303010470,2303010470,0,1219,1698,0
2305393543,2305393543,0,1604,1811,0
2306223629,2306223647,18,333,685,0
2310030046,2310030047,1,1451,1630,0
2312916820,2312916819,-1,792,1521,0
2313633726,2313633725,-1,25060,20149,0
2317802144,2317802145,1,2053,2381,0
2321811094,2321811093,-1,1628,1949,0
2322779869,2322779865,-4,2055,6479,0
2323085534,2323085534,0,1434,1642,0
2323142483,2323142481,-2,1328,1856,0
2324103445,2324103447,2,1377,1059,0
2324300441,2324300461,20,1480,1193,0
2325870911,2325870910,-1,1082,1232,0
2327519314,2327519314,0,1432,1934,0
2339041556,2339041550,-6,1870,8037,0
2339419115,2339419116,1,1214,1674,0
2343603478,2343603477,-1,1856,2787,0
2345593473,2345593474,1,1397,1512,0
2347318299,2347318300,1,1120,1394,0
2350291586,2350291586,0,1018,1563,0
2350888440,2350888441,1,1009,1584,0
2351981633,2351981634,1,2090,1597,0
2352782778,2352782779,1,772,1043,0
2354575839,2354575840,1,1925,1759,0
2359119868,2359119870,2,749,1120,0
2364337578,2364337577,-1,1208,1568,0
2369263561,2369263561,0,1508,2950,0
2369731259,2369731261,2,1367,1670,0
2370165502,2370165503,1,1778,1132,0
2371936120,2371936120,0,1443,1600,0
2377929255,2377929256,1,1134,1992,0
2378180927,2378180929,2,1133,972,0
2378257187,2378257186,-1,1705,2991,0
2379729475,2379729474,-1,1876,1703,0
2381318821,2381318820,-1,1495,1489,0
2382159934,2382159951,17,1140,1414,0
2383365289,2383365289,0,1171,1320,0
2384487404,2384487404,0,1538,2244,0
2384653421,2384653420,-1,1539,1434,0
2386430667,2386430666,-1,1364,1908,0
2388501152,2388501152,0,1234,1965,0
2391896795,2391896802,7,5697,2115,0
2393227545,2393227546,1,1709,1339,0
2393789722,2393789721,-1,1528,1645,0
2393957665,2393957662,-3,1165,2171,0
2395654799,2395654797,-2,1164,1448,0
2396098090,2396098092,2,1738,1980,0
2409956041,2409956043,2,1179,1539,0
2411573155,2411573157,2,1324,2152,0
2411916709,2411916709,0,1223,2171,0
2413701222,2413701225,3,1140,2145,0
2413887515,2413887511,-4,23204,13765,0
2414836146,2414836146,0,1860,1667,0
2418780966,2418780966,0,1319,1987,0
2419030371,2419030371,0,828,1523,0
2419251048,2419251041,-7,1477,1903,0
2420633699,2420633703,4,2988,1663,0
2422683154,2422683156,2,1522,1775,0
2423065281,2423065281,0,1378,1537,0
2425914021,2425914021,0,1447,2108,0
2426079989,2426079991,2,1074,1497,0
2426287966,2426287965,-1,808,1258,0
2428135107,2428135106,-1,1350,1943,0
2428205301,2428205287,-14,917,1490,0
2430168323,2430168325,2,1683,1732,0
2436473103,2436473106,3,1531,1323,0
2441942697,2441942700,3,1518,1426,0
2443441278,2443441278,0,1209,1844,0
2443993333,2443993331,-2,1145,1554,0
2444861554,2444861554,0,1358,1863,0
2445373851,2445373852,1,1456,2044,0
2446805307,2446805316,9,13808,34781,0
2448626250,2448626251,1,941,1643,0
2452071974,2452071973,-1,1617,1563,0
2458412001,2458412001,0,1814,2582,0
2459514422,2459514413,-9,1039,3793,0
2462433321,2462433321,0,1430,1747,0
2464513977,2464513978,1,1525,1949,0
2465395202,2465395202,0,1491,2227,0
2466525367,2466525370,3,451,1268,0
2467766665,2467766666,1,1589,1679,0
2468867712,2468867712,0,1615,1635,0
2469185773,2469185774,1,1405,1581,0
2469257121,2469257119,-2,1191,1842,0
2470147335,2470147337,2,1127,1440,0
2471088630,2471088629,-1,1263,2588,0
2473323222,2473323222,0,1917,2867,0
2474579265,2474579266,1,1039,1326,0
2476317471,2476317470,-1,1224,1687,0
2478201896,2478201904,8,982,1565,0
2479039411,2479039410,-1,3314,3476,0
2479178147,2479178147,0,1076,1372,0
2479408745,2479408746,1,1128,1949,0
2480051290,2480051290,0,1750,2594,0
2480758869,2480758872,3,1597,1421,0
2485330518,2485330521,3,820,894,0
2486686029,2486686029,0,1520,1769,0
2490882547,2490882550,3,1086,883,0
2492152328,2492152327,-1,914,1076,0
2492702410,2492702411,1,1673,1770,0
2498090298,2498090298,0,908,1356,0
2501797284,2501797283,-1,914,1225,0
2505982237,2505982227,-10,1714,32314,0
2508174409,2508174412,3,995,1292,0
2510010016,2510010017,1,1133,1214,0
2519383241,2519383241,0,1494,1417,0
2521866020,2521866018,-2,1558,1833,0
2522480451,2522480449,-2,962,1736,0
2522910219,2522910219,0,1775,1502,0
2523603336,2523603335,-1,1281,1462,0
2524053700,2524053701,1,1358,1824,0
2529444049,2529444049,0,1155,1130,0
2529538722,2529538722,0,1424,1561,0
2530347781,2530347782,1,1245,1955,0
2531531359,2531531362,3,1696,2368,0
2535335963,2535335962,-1,1220,2274,0
2535756942,2535756942,0,1382,1980,0
2536126623,2536126604,-19,1196,1195,0
2541044638,2541044637,-1,1552,1832,0
2543084372,2543084375,3,1404,1643,0
2544121187,2544121181,-6,2096,8947,0
2544764003,2544764006,3,1593,1736,0
2544914285,2544914283,-2,1929,1964,0
2545841469,2545841469,0,601,1354,0
2546603970,2546603968,-2,1064,2065,0
2551489324,2551489327,3,1128,1507,0
2552587398,2552587383,-15,935,827,0
2553199159,2553199159,0,1520,2056,0
2554020617,2554020614,-3,889,2035,0
2555805588,2555805588,0,2180,2063,0
2560539919,2560539915,-4,871,1946,0
2570890693,2570890693,0,1811,1987,0
2571014915,2571014915,0,927,1496,0
2575809346,2575809344,-2,1177,1641,0
2575938672,2575938671,-1,1615,1957,0
2577981054,2577981053,-1,1098,2197,0
2578772046,2578772042,-4,1510,3121,0
2579625466,2579625466,0,1161,1562,0
2580753179,2580753179,0,1099,1460,0
2580917812,2580917812,0,1495,2198,0
2581103665,2581103663,-2,1000,1341,0
2582133659,2582133660,1,1653,1420,0
2582494238,2582494240,2,1535,1201,0
2582709815,2582709828,13,997,1915,0
2582895745,2582895746,1,910,1720,0
2583920583,2583920584,1,906,1139,0
2584762891,2584762890,-1,1234,1369,0
2585255574,2585255580,6,3204,1770,0
2585477223,2585477222,-1,1596,1244,0
2585993075,2585993054,-21,1489,1485,0
2586877302,2586877285,-17,1200,1326,0
2587890119,2587890119,0,1610,1687,0
2587960784,2587960783,-1,1304,1419,0
2599963488,2599963489,1,1664,1490,0
2600353976,2600353977,1,1051,1324,0
2613023985,2613023985,0,1249,1908,0
2615623045,2615623045,0,1550,1833,0
2616094522,2616094522,0,2328,1575,0
2617166518,2617166517,-1,2007,2232,0
2618258010,2618258010,0,1713,2608,0
2618757357,2618757358,1,1548,1770,0
2625067927,2625067929,2,1732,2107,0
2625720751,2625720751,0,1298,1551,0
2626591698,2626591698,0,1440,2263,0
2633097937,2633097936,-1,1227,1338,0
2634878710,2634878707,-3,1241,2777,0
2636221296,2636221295,-1,1396,1610,0
2641168168,2641168152,-16,676,465,0
2644082192,2644082193,1,1709,1524,0
2648833918,2648833921,3,615,1155,0
2652640342,2652640363,21,944,2587,0
2655979757,2655979757,0,1309,2042,0
2659668153,2659668153,0,1458,2063,0
2660259227,2660259226,-1,1176,1749,0
2661908122,2661908126,4,1589,1623,0
2662468495,2662468494,-1,1339,1213,0
2663210699,2663210699,0,1231,2055,0
2663702990,2663702989,-1,1372,2262,0
2666860875,2666860877,2,868,1290,0
2667321370,2667321370,0,846,1510,0
2669744339,2669744341,2,3543,2927,0
2670061352,2670061352,0,1190,1602,0
2671301230,2671301238,8,1874,1064,0
2672410954,2672410950,-4,1084,2202,0
2677327646,2677327647,1,1167,1595,0
2679622447,2679622447,0,1539,1521,0
2679659123,2679659125,2,1181,2510,0
2680496862,2680496862,0,1617,1424,0
2683189819,2683189819,0,821,1082,0
2684493085,2684493075,-10,1310,2062,0
2685335865,2685335864,-1,1337,1603,0
2691623629,2691623624,-5,1242,5004,0
2692984808,2692984810,2,1247,1918,0
2695699907,2695699907,0,1154,1878,0
2696040965,2696040966,1,1234,1361,0
2696069021,2696069022,1,759,1146,0
2701426231,2701426231,0,1351,1332,0
2706063607,2706063609,2,1854,1509,0
2706202218,2706202220,2,2142,2425,0
2707866411,2707866410,-1,1453,1926,0
2712080713,2712080714,1,1123,1950,0
2712727067,2712727067,0,1279,1798,0
2713269843,2713269842,-1,954,951,0
2715288263,2715288265,2,2613,1840,0
2716158690,2716158691,1,1757,1828,0
2721088434,2721088433,-1,1911,1671,0
2723368388,2723368386,-2,1529,2460,0
2725441754,2725441754,0,1576,1731,0
2726066418,2726066418,0,1379,1854,0
2728078370,2728078373,3,1343,1137,0
2729978400,2729978399,-1,1148,1668,0
2730897741,2730897742,1,1126,1762,0
2731807985,2731807985,0,1607,1039,0
2732852882,2732852883,1,962,1620,0
2734200894,2734200897,3,2871,2301,0
2734347341,2734347339,-2,1298,1712,0
2735919973,2735919961,-12,1316,1504,0
2736820594,2736820594,0,1586,2358,0
2740759537,2740759539,2,1161,1239,0
2741570273,2741570274,1,1554,2048,0
2747637471,2747637470,-1,896,1185,0
2747678874,2747678875,1,929,1066,0
2749857311,2749857313,2,905,1488,0
2754135228,2754135247,19,838,1805,0
2756745268,2756745269,1,1404,1203,0
2758037978,2758037979,1,1301,1720,0
2758920365,2758920366,1,1557,1500,0
2759470831,2759470833,2,1190,2005,0
2760010343,2760010342,-1,1160,1528,0
2761221446,2761221447,1,1301,1499,0
2762351378,2762351384,6,4052,1447,0
2762563994,2762563994,0,1509,1342,0
2763035494,2763035495,1,1592,1833,0
2763561421,2763561422,1,1783,1208,0
2764408433,2764408434,1,1423,1742,0
2767654061,2767654059,-2,1215,1981,0
2768822625,2768822627,2,905,1702,0
2769323384,2769323384,0,1670,3297,0
2772728230,2772728237,7,2318,1720,0
2773963492,2773963493,1,901,1226,0
2775740251,2775740250,-1,1128,1330,0
2777080579,2777080579,0,943,1058,0
2777512830,2777512831,1,1070,1230,0
2779191507,2779191495,-12,1155,1764,0
2780307034,2780307036,2,1554,1539,0
2781642709,2781642709,0,1167,1576,0
2781767931,2781767933,2,1375,1099,0
2782341061,2782341058,-3,1503,1472,0
2783894846,2783894847,1,1861,2085,0
2786977214,2786977215,1,858,1169,0
2788488520,2788488521,1,1173,1323,0
2791561538,2791561538,0,1261,1684,0
2795328253,2795328255,2,1454,1847,0
2799324807,2799324801,-6,18260,13093,0
2801449581,2801449581,0,1428,1336,0
2802857343,2802857343,0,1098,1476,0
2805012068,2805012050,-18,2062,1707,0
2806491800,2806491799,-1,1898,2113,0
2808901674,2808901674,0,1116,1208,0
2810016739,2810016738,-1,1047,1612,0
2811624456,2811624457,1,1569,1942,0
2812626840,2812626840,0,1290,1438,0
2814776358,2814776358,0,1119,1361,0
2814863376,2814863380,4,1814,1308,0
2815890904,2815890926,22,1710,1815,0
2816842859,2816842859,0,1865,1492,0
2817454817,2817454814,-3,1759,1516,0
2819395258,2819395259,1,1405,1887,0
2819624295,2819624297,2,1129,1411,0
2820380149,2820380151,2,633,1199,0
2822583183,2822583185,2,1497,2228,0
2823339329,2823339326,-3,1197,2221,0
2825860301,2825860300,-1,1831,2220,0
2826086496,2826086503,7,2260,1105,0
2827320657,2827320657,0,1563,1618,0
2832075906,2832075906,0,1607,1741,0
2835576226,2835576227,1,1257,1939,0
2835707773,2835707773,0,1196,1553,0
2837042232,2837042230,-2,1266,1398,0
2837877669,2837877670,1,1423,1538,0
2839985184,2839985186,2,953,1420,0
2840396873,2840396873,0,1179,1533,0
2841061861,2841061861,0,1314,1809,0
2841878477,2841878477,0,2174,2171,0
2843799483,2843799482,-1,2606,2351,0
2843844746,2843844747,1,1351,2169,0
2846877338,2846877341,3,1728,1958,0
2848364043,2848364042,-1,1497,1752,0
2857432454,2857432455,1,1200,1105,0
2858466148,2858466150,2,1669,2114,0
2858968036,2858968037,1,1054,1234,0
2859832295,2859832297,2,1119,1344,0
2871720699,2871720700,1,1528,1539,0
2872654741,2872654741,0,1651,2417,0
2876346754,2876346754,0,1087,1972,0
2877924683,2877924682,-1,1178,1941,0
2879523099,2879523101,2,1276,1609,0
2882418163,2882418163,0,1461,1491,0
2882789646,2882789647,1,1052,1613,0
2884161742,2884161742,0,2126,1689,0
2886062122,2886062123,1,1293,1860,0
2887940310,2887940312,2,1628,1989,0
2890285407,2890285407,0,1546,1583,0
2897747799,2897747818,19,227,702,0
2901137275,2901137269,-6,1164,4714,0
2904433214,2904433213,-1,1643,2368,0
2905020130,2905020131,1,1958,1331,0
2906530338,2906530340,2,1166,1630,0
2909450831,2909450832,1,1330,1086,0
2913810766,2913810763,-3,1099,986,0
2916647307,2916647309,2,1702,1812,0
2916855469,2916855469,0,1387,1499,0
2919934984,2919934983,-1,1379,1327,0
2925053198,2925053198,0,1074,1717,0
2929303250,2929303249,-1,867,1476,0
2931616635,2931616634,-1,1172,1667,0
2935448210,2935448210,0,1339,2336,0
2936243987,2936243987,0,1247,1955,0
2938388611,2938388610,-1,1553,1445,0
2939986373,2939986372,-1,1107,1334,0
2941416128,2941416129,1,1055,1818,0
2944216255,2944216252,-3,853,1566,0
2947102222,2947102222,0,1325,1551,0
2948751102,2948751104,2,1240,1404,0
2952099782,2952099782,0,840,1450,0
2953567066,2953567067,1,2017,1337,0
2953829649,2953829650,1,1884,1761,0
2956435622,2956435616,-6,2769,9353,0
2958411771,2958411772,1,1618,1845,0
2959025355,2959025355,0,1040,1865,0
2961589124,2961589125,1,1550,1588,0
2964061043,2964061043,0,1402,2298,0
2965444395,2965444394,-1,1980,1996,0
2966474802,2966474805,3,1997,1351,0
2967909994,2967909994,0,1312,1992,0
2970459554,2970459554,0,1313,1851,0
2974375921,2974375921,0,1493,1423,0
2975551145,2975551146,1,1550,1276,0
2977598394,2977598394,0,1305,2151,0
2978694818,2978694819,1,1756,1960,0
2979135717,2979135718,1,1289,1733,0
2980628039,2980628039,0,1263,1343,0
2981636070,2981636069,-1,1480,1491,0
2988581229,2988581231,2,1419,2338,0
2989948850,2989948856,6,4055,1269,0
2990624378,2990624379,1,1031,1264,0
2991453674,2991453673,-1,3095,4133,0
2992132590,2992132591,1,1022,1566,0
2992681578,2992681579,1,902,845,0
2993966134,2993966134,0,1658,2268,0
2994850954,2994850954,0,1427,1662,0
2997998383,2997998382,-1,1471,2105,0
3001274101,3001274102,1,1250,1654,0
3001630713,3001630713,0,1989,2016,0
3003137768,3003137769,1,993,2937,0
3003564046,3003564047,1,1501,2280,0
3005310506,3005310506,0,1811,2461,0
3006272591,3006272592,1,1475,2199,0
3007043841,3007043841,0,1197,1518,0
3007968977,3007968977,0,1541,1019,0
3008743743,3008743739,-4,848,2448,0
3009535999,3009535997,-2,1540,1714,0
3009689478,3009689499,21,1724,1772,0
3013769910,3013769910,0,1335,2520,0
3015685861,3015685862,1,1344,1696,0
3017631490,3017631492,2,1430,1734,0
3020962841,3020962830,-11,4194,15039,0
3024255874,3024255873,-1,1553,1925,0
3028060738,3028060738,0,1244,1750,0
3028186230,3028186249,19,15609,17747,0
3028616445,3028616444,-1,1251,1640,0
3029854403,3029854403,0,945,1687,0
3031836023,3031836022,-1,1181,1370,0
3032763729,3032763730,1,1319,2272,0
3035145713,3035145714,1,1295,1532,0
3035594773,3035594771,-2,1646,2422,0
3037252263,3037252263,0,951,1379,0
3047313257,3047313258,1,1495,1502,0
3049424942,3049424942,0,1119,2126,0
3049817779,3049817780,1,1543,1398,0
3052835469,3052835468,-1,938,999,0
3054194746,3054194746,0,1119,1855,0
3056225443,3056225443,0,881,1402,0
3059813216,3059813217,1,1113,1469,0
3060725941,3060725942,1,1695,1965,0
3060821194,3060821188,-6,999,3116,0
3062397787,3062397789,2,1094,1334,0
3063483101,3063483102,1,1520,1589,0
3064114010,3064114010,0,1006,1682,0
3065371997,3065371997,0,1383,1856,0
3067528680,3067528680,0,2206,2537,0
3068197575,3068197577,2,1065,1854,0
3072386689,3072386690,1,2575,2958,0
3072901439,3072901439,0,1713,1853,0
3075252161,3075252163,2,1428,1379,0
3077188590,3077188585,-5,2048,6714,0
3080375275,3080375276,1,1779,2771,0
3080970954,3080970955,1,1275,1919,0
3081823793,3081823791,-2,1211,1408,0
3082979005,3082979006,1,859,1314,0
3083635289,3083635288,-1,1231,2242,0
3083893218,3083893218,0,1609,1728,0
3085223991,3085223992,1,1754,1822,0
3085823332,3085823333,1,1949,1735,0
3087725074,3087725076,2,1054,1341,0
3089617542,3089617536,-6,30412,14075,0
3097277020,3097277021,1,1476,1304,0
3102348814,3102348814,0,980,1805,0
3105969988,3105969987,-1,826,1201,0
3107145687,3107145680,-7,1695,6853,0
3108979953,3108979953,0,1308,1652,0
3110028165,3110028167,2,1183,919,0
3114068771,3114068772,1,1342,1651,0
3116070518,3116070518,0,1084,1669,0
3118697090,3118697090,0,1336,1429,0
3118843804,3118843802,-2,1763,2861,0
3121753726,3121753726,0,973,1184,0
3123134206,3123134206,0,1274,1789,0
3123545107,3123545111,4,1881,1127,0
3124835878,3124835878,0,1169,1470,0
3126664475,3126664475,0,938,1820,0
3129940050,3129940051,1,34385,39179,0
3130953270,3130953270,0,1024,2155,0
3140100337,3140100338,1,1354,1189,0
3140789453,3140789454,1,1575,2455,0
3148036604,3148036605,1,1927,1640,0
3156677713,3156677713,0,1517,1972,0
3157486890,3157486891,1,1393,1838,0
3158267825,3158267826,1,1566,1372,0
3159136581,3159136581,0,1273,1534,0
3159948560,3159948561,1,776,402,0
3167289345,3167289341,-4,1287,2939,0
3168018711,3168018715,4,1626,1446,0
3174665185,3174665185,0,1420,2103,0
3179422470,3179422471,1,1649,1906,0
3180020719,3180020717,-2,1044,1449,0
3181008779,3181008778,-1,1686,1350,0
3185140482,3185140480,-2,811,1498,0
3185886573,3185886573,0,989,1237,0
3189188587,3189188588,1,2280,1915,0
3190884299,3190884299,0,1214,1552,0
3192455785,3192455787,2,1493,1656,0
3194348608,3194348610,2,1702,1651,0
3196093889,3196093892,3,2277,987,0
3196125196,3196125198,2,1653,1342,0
3197317998,3197318002,4,2156,2009,0
3201989057,3201989056,-1,1850,1729,0
3203141974,3203141977,3,1926,1510,0
3203669554,3203669554,0,1115,1515,0
3203811262,3203811265,3,1164,1458,0
3207368998,3207368997,-1,1420,1775,0
3209048635,3209048635,0,1150,1638,0
3212842788,3212842788,0,1508,2059,0
3213607274,3213607274,0,1092,1492,0
3214605744,3214605763,19,437,1075,0
3216221818,3216221820,2,1065,1323,0
3218180591,3218180591,0,1416,2050,0
3221429932,3221429931,-1,1505,1636,0
3227169048,3227169050,2,1321,1486,0
3228110795,3228110794,-1,1248,1512,0
3231340518,3231340518,0,885,1341,0
3231644670,3231644691,21,1010,1359,0
3234156666,3234156667,1,1516,1945,0
3234671150,3234671151,1,1903,1405,0
3235248881,3235248881,0,935,1024,0
3236164876,3236164877,1,1255,1392,0
3236293222,3236293222,0,983,1272,0
3239735923,3239735926,3,1345,1171,0
3244070386,3244070389,3,1431,1583,0
3244673325,3244673324,-1,1733,1653,0
3245381538,3245381537,-1,1477,1739,0
3245815857,3245815874,17,1963,1867,0
3246672864,3246672858,-6,529,2616,0
3247768477,3247768475,-2,854,1525,0
3247936739,3247936739,0,1844,1718,0
3248858971,3248858972,1,1220,1571,0
3249437342,3249437343,1,1837,2060,0
3252947063,3252947055,-8,1094,1778,0
3256379117,3256379118,1,1406,2169,0
3258492672,3258492672,0,1835,1929,0
3259586510,3259586510,0,1978,2159,0
3259876634,3259876634,0,1676,2079,0
3260975053,3260975053,0,1573,2051,0
3262885860,3262885871,11,16227,30620,0
3263399633,3263399636,3,1155,1764,0
3264055631,3264055630,-1,702,1616,0
3265222418,3265222417,-1,1110,2140,0
3269032007,3269032009,2,1911,1839,0
3272739436,3272739434,-2,1940,1972,0
3272899364,3272899365,1,1107,1417,0
3274833290,3274833289,-1,1533,1982,0
3282971882,3282971879,-3,1184,2746,0
3287171971,3287171973,2,1190,1862,0
3291645649,3291645651,2,1204,916,0
3294665318,3294665318,0,1332,1608,0
3298149815,3298149813,-2,1063,2255,0
3299179673,3299179673,0,1492,1610,0
3300404494,3300404494,0,1266,2033,0
3302413193,3302413194,1,1321,1613,0
3303822085,3303822083,-2,1127,2033,0
3304372107,3304372109,2,763,1403,0
3305907880,3305907878,-2,1385,1960,0
3306338365,3306338349,-16,1297,1514,0
3308945933,3308945933,0,1713,1955,0
3310913778,3310913781,3,1036,1492,0
3312084596,3312084599,3,1136,1339,0
3317235217,3317235217,0,1544,2417,0
3317323625,3317323626,1,1110,1458,0
3318891517,3318891517,0,1365,1409,0
3322625353,3322625355,2,1334,1564,0
3326163530,3326163529,-1,1561,1775,0
3328886899,3328886898,-1,1113,1506,0
3333481767,3333481768,1,1401,1628,0
3335665078,3335665077,-1,1955,1862,0
3340026961,3340026962,1,1600,1695,0
3340790130,3340790130,0,1564,1906,0
3342445458,3342445458,0,1115,1763,0
3346350242,3346350243,1,1070,1398,0
3356029818,3356029818,0,1198,1857,0
3356681336,3356681338,2,2272,2028,0
3358434564,3358434561,-3,994,1201,0
3361641219,3361641236,17,1058,1446,0
3361824206,3361824207,1,1522,1478,0
3364367140,3364367138,-2,1051,1268,0
3367418703,3367418705,2,1060,935,0
3367802412,3367802404,-8,1585,1473,0
3368865633,3368865633,0,1445,2264,0
3370385573,3370385575,2,1030,976,0
3374406411,3374406413,2,1386,1960,0
3376394490,3376394488,-2,1315,2149,0
3378789126,3378789125,-1,1102,1631,0
3379301167,3379301169,2,1630,2013,0
3379899361,3379899362,1,1266,1822,0
3379928276,3379928274,-2,1264,2615,0
3381244172,3381244174,2,1790,1828,0
3383991378,3383991378,0,1129,1706,0
3384141398,3384141398,0,1589,2746,0
3384277541,3384277541,0,1217,1511,0
3384922943,3384922942,-1,962,1364,0
3386123397,3386123397,0,1146,1434,0
3387118814,3387118816,2,1868,1359,0
3387381786,3387381786,0,1152,1656,0
3390577987,3390577989,2,1598,2146,0
3397343798,3397343799,1,1821,1664,0
3398649969,3398649970,1,1272,1869,0
3401327966,3401327966,0,1655,1333,0
3401862329,3401862330,1,1093,1715,0
3402331906,3402331906,0,1581,1830,0
3402977953,3402977946,-7,1104,1507,0
3406108778,3406108779,1,1219,1623,0
3406139949,3406139931,-18,1246,1493,0
3410547911,3410547913,2,1525,1203,0
3411355704,3411355702,-2,1151,1557,0
3412672134,3412672138,4,1473,1810,0
3413715014,3413715018,4,22541,20291,0
3413992932,3413992930,-2,1238,1564,0
3416100115,3416100115,0,1078,1326,0
3416909707,3416909706,-1,1065,1121,0
3418659503,3418659501,-2,1018,1987,0
3420294189,3420294191,2,2011,2484,0
3424826398,3424826395,-3,996,1574,0
3429544177,3429544179,2,770,921,0
3433748374,3433748374,0,1855,1905,0
3436128514,3436128515,1,1465,1262,0
3436596098,3436596098,0,1808,1488,0
3438267179,3438267175,-4,989,211,0
3438451661,3438451662,1,1442,1277,0
3440032438,3440032439,1,909,1665,0
3440464146,3440464147,1,10588,9788,0
3447465030,3447465037,7,2435,1723,0
3451721627,3451721626,-1,1433,1785,0
3451761006,3451761007,1,1031,1371,0
3452044614,3452044594,-20,391,995,0
3452633090,3452633091,1,1484,1438,0
3452962965,3452962966,1,1204,1427,0
3457614810,3457614809,-1,1671,1864,0
3460759622,3460759622,0,912,1294,0
3462647293,3462647293,0,1302,1803,0
3466807905,3466807906,1,1647,1546,0
3472415670,3472415670,0,1183,1356,0
3472854790,3472854792,2,2137,1738,0
3473014582,3473014583,1,1912,1869,0
3473627103,3473627107,4,813,1382,0
3474877237,3474877236,-1,1121,1549,0
3481529617,3481529616,-1,2441,4294,0
3484191925,3484191929,4,1690,1441,0
3491476315,3491476317,2,1461,1798,0
3493676637,3493676638,1,1343,1576,0
3495638775,3495638774,-1,1755,1895,0
3496804182,3496804177,-5,1524,2671,0
3504717649,3504717650,1,1399,1950,0
3510038628,3510038629,1,1289,1545,0
3516671490,3516671491,1,1136,1702,0
3516909542,3516909561,19,1194,2216,0
3517022657,3517022659,2,1861,1641,0
3524121843,3524121845,2,1327,1888,0
3525442499,3525442497,-2,1189,2068,0
3525904531,3525904531,0,1183,1912,0
3527990120,3527990120,0,1267,1502,0
3531446733,3531446730,-3,888,2056,0
3533607361,3533607361,0,1737,3327,0
3535153099,3535153101,2,1796,1378,0
3537310825,3537310825,0,1144,1399,0
3538494289,3538494289,0,1166,1428,0
3539093068,3539093069,1,1408,1808,0
3541570716,3541570717,1,1214,1453,0
3542889358,3542889359,1,1952,1887,0
3545892805,3545892810,5,1478,1570,0
3548103991,3548103990,-1,1401,1571,0
3548351796,3548351795,-1,1415,2180,0
3552890579,3552890574,-5,789,1744,0
3555860046,3555860046,0,1372,1447,0
3557772981,3557772982,1,1177,1224,0
3557820108,3557820109,1,1282,1116,0
3558629882,3558629881,-1,1060,1789,0
3565943246,3565943246,0,1263,1562,0
3566219970,3566219969,-1,1180,1602,0
3567768491,3567768492,1,1960,2020,0
3569927059,3569927061,2,1202,1371,0
3572945421,3572945422,1,1582,1817,0
3574545806,3574545806,0,991,1831,0
3580290374,3580290374,0,1470,1702,0
3580764366,3580764365,-1,1166,1730,0
3582240839,3582240839,0,2231,2386,0
3584611265,3584611265,0,1291,2115,0
3585847321,3585847327,6,2509,1339,0
3590233851,3590233850,-1,1923,1711,0
3590330378,3590330377,-1,1493,1724,0
3601443167,3601443169,2,1573,1663,0
3606230385,3606230386,1,1016,1542,0
3611044724,3611044724,0,1548,1781,0
3611523681,3611523678,-3,1386,2677,0
3612840998,3612840998,0,1247,1122,0
3616035090,3616035090,0,1697,1387,0
3617131095,3617131106,11,969,1436,0
3625070918,3625070920,2,1340,1521,0
3630003220,3630003223,3,1116,1361,0
3632699438,3632699437,-1,1892,2267,0
3632888698,3632888698,0,1539,1742,0
3633913894,3633913893,-1,1026,1050,0
3638282707,3638282691,-16,1315,1237,0
3639750363,3639750366,3,1606,1572,0
3643242249,3643242251,2,1617,1940,0
3646513344,3646513342,-2,1978,2352,0
3647651608,3647651612,4,1520,1253,0
3650829897,3650829898,1,2200,2109,0
3653204247,3653204249,2,1376,1257,0
3653295614,3653295614,0,1603,2946,0
3655004746,3655004747,1,964,1608,0
3655199440,3655199441,1,1439,1551,0
3655890686,3655890684,-2,1972,1615,0
3656270494,3656270499,5,2670,990,0
3660007227,3660007222,-5,1072,1737,0
3661364642,3661364645,3,1505,1751,0
3662043562,3662043562,0,1892,2160,0
3662364592,3662364593,1,1487,2012,0
3663568815,3663568815,0,930,1372,0
3664628245,3664628247,2,902,651,0
3672101250,3672101250,0,1175,2012,0
3672741409,3672741410,1,1199,1845,0
3675226752,3675226752,0,1305,1829,0
3682048175,3682048174,-1,2308,4372,0
3684845431,3684845432,1,1329,1743,0
3686568624,3686568626,2,1348,1656,0
3687999162,3687999178,16,1354,1257,0
3689978163,3689978164,1,1468,1520,0
3697244074,3697244075,1,1552,1888,0
3699329385,3699329385,0,1110,1829,0
3703310706,3703310707,1,1831,1607,0
3703978560,3703978561,1,1140,1408,0
3704816741,3704816739,-2,1346,1909,0
3710799015,3710799010,-5,1274,4831,0
3711719874,3711719874,0,1211,1470,0
3717907573,3717907574,1,1515,1213,0
3718459601,3718459601,0,1111,1355,0
3722799410,3722799411,1,1206,1153,0
3723898597,3723898598,1,1786,1982,0
3728605951,3728605950,-1,1321,1226,0
3728762738,3728762738,0,1275,2142,0
3728937358,3728937358,0,1406,1931,0
3732248867,3732248867,0,1447,1538,0
3732739035,3732739015,-20,696,1018,0
3732859237,3732859239,2,1458,1506,0
3734492304,3734492305,1,900,1063,0
3737882634,3737882635,1,1653,1917,0
3739492253,3739492251,-2,1542,1816,0
3742983631,3742983632,1,1716,2023,0
3752851516,3752851515,-1,1150,1582,0
3754047558,3754047559,1,1669,1851,0
3758141402,3758141406,4,1762,1662,0
3758928846,3758928844,-2,1098,1507,0
3760109997,3760110000,3,1292,2129,0
3762884814,3762884810,-4,742,1495,0
3763688748,3763688749,1,1155,1870,0
3764585417,3764585417,0,1306,1967,0
3765275462,3765275463,1,2232,2082,0
3773961719,3773961722,3,1803,1756,0
3774992415,3774992414,-1,1119,1592,0
3778051022,3778051026,4,1283,1551,0
3778735460,3778735459,-1,1457,1415,0
3779619859,3779619859,0,1242,1796,0
3781761557,3781761557,0,911,1378,0
3788822574,3788822576,2,1257,991,0
3790196231,3790196233,2,43824,4032,0
3790312172,3790312172,0,1296,1105,0
3792967910,3792967911,1,1204,1914,0
3793355974,3793355975,1,964,1464,0
3793878818,3793878819,1,1256,1391,0
3794425601,3794425602,1,1335,1130,0
3796454525,3796454524,-1,1688,2502,0
3796858638,3796858640,2,1606,1771,0
3802687569,3802687570,1,2021,1918,0
3803699303,3803699303,0,1659,1788,0
3811438594,3811438592,-2,1606,1605,0
3811477502,3811477502,0,1164,1372,0
3813453239,3813453240,1,970,1567,0
3814416681,3814416680,-1,1826,2618,0
3815237905,3815237906,1,1454,1897,0
3815783536,3815783538,2,1594,1314,0
3816096790,3816096795,5,1218,1772,0
3816260123,3816260125,2,1456,1269,0
3817385455,3817385453,-2,908,2468,0
3818009430,3818009432,2,1095,1529,0
3821781002,3821780999,-3,891,1253,0
3822536621,3822536622,1,1259,1727,0
3823180461,3823180459,-2,1484,1284,0
3828722955,3828722940,-15,1259,1547,0
3829669562,3829669565,3,1522,1457,0
3831075683,3831075683,0,1587,1513,0
3832589389,3832589369,-20,1506,1597,0
3836368749,3836368750,1,1529,1612,0
3836649543,3836649547,4,1962,1415,0
3837320203,3837320222,19,1396,1067,0
3837681295,3837681294,-1,1102,1999,0
3837766643,3837766643,0,1077,1315,0
3839565853,3839565854,1,1363,1523,0
3842659666,3842659667,1,758,1325,0
3843545713,3843545714,1,1478,2072,0
3845592518,3845592519,1,1786,1613,0
3847329996,3847329995,-1,1002,1309,0
3851820677,3851820675,-2,1300,2874,0
3852921963,3852921963,0,1602,2149,0
3856803458,3856803457,-1,1673,2188,0
3860229666,3860229665,-1,1285,1533,0
3862974327,3862974326,-1,929,1367,0
3865182906,3865182906,0,1146,1895,0
3865422417,3865422418,1,1905,1479,0
3866819882,3866819883,1,1356,1710,0
3867519322,3867519323,1,1379,1267,0
3869484815,3869484814,-1,1536,1481,0
3873097007,3873097010,3,1638,1373,0
3875515305,3875515303,-2,926,882,0
3876946066,3876946068,2,1245,1372,0
3878575330,3878575331,1,1898,1189,0
3879742690,3879742689,-1,1763,1999,0
3881700323,3881700323,0,1256,1206,0
3883592434,3883592435,1,1187,1745,0
3885871171,3885871170,-1,3631,3952,0
3888889315,3888889318,3,2286,1296,0
3889761173,3889761174,1,1690,1701,0
3890316072,3890316071,-1,1609,1877,0
3893473613,3893473614,1,1125,1075,0
3895499381,3895499379,-2,625,1611,0
3896697339,3896697339,0,1063,1469,0
3896840510,3896840511,1,557,972,0
3906494741,3906494740,-1,1824,1786,0
3910252053,3910252053,0,1068,1782,0
3912553127,3912553129,2,1234,1343,0
3916019750,3916019751,1,849,1393,0
3917394098,3917394097,-1,1144,1682,0
3918313178,3918313177,-1,1487,1489,0
3923264645,3923264642,-3,415,2741,0
3928171402,3928171403,1,2383,1942,0
3928313399,3928313393,-6,785,3856,0
3929166010,3929166009,-1,1245,1761,0
3929806231,3929806232,1,1471,1950,0
3934264743,3934264742,-1,1594,1301,0
3935238778,3935238778,0,789,1154,0
3936515715,3936515714,-1,1411,1687,0
3936543014,3936543014,0,1521,2411,0
3939506099,3939506100,1,912,1298,0
3942508294,3942508291,-3,2089,3615,0
3947372927,3947372926,-1,1019,1437,0
3951213730,3951213731,1,945,1119,0
3955768518,3955768524,6,1192,1426,0
3961550833,3961550833,0,1558,2169,0
3963927211,3963927210,-1,1285,1894,0
3965315075,3965315074,-1,1200,1372,0
3968059856,3968059856,0,1216,1991,0
3968612172,3968612170,-2,1571,1669,0
3969972870,3969972870,0,938,956,0
3970956424,3970956426,2,1448,1380,0
3973477587,3973477588,1,2187,2615,0
3975634194,3975634194,0,861,1437,0
3977226234,3977226234,0,1384,1217,0
3977777369,3977777367,-2,1266,2940,0
3978663001,3978663007,6,4171,1624,0
3980337415,3980337417,2,872,1304,0
3982511011,3982511014,3,821,986,0
3983756910,3983756910,0,920,1201,0
3984498893,3984498894,1,904,1056,0
3985917734,3985917734,0,1775,2457,0
3986418143,3986418143,0,1732,1373,0
3986502683,3986502685,2,1303,1820,0
3987155005,3987155005,0,1527,1655,0
3987903178,3987903175,-3,1253,2271,0
3993520668,3993520670,2,1629,1958,0
3993885781,3993885782,1,1255,1476,0
3995584511,3995584512,1,1627,1620,0
3997035329,3997035330,1,1365,1535,0
4001087059,4001087059,0,1055,1297,0
4003743587,4003743586,-1,1531,1558,0
4004045924,4004045919,-5,1791,5954,0
4009255086,4009255086,0,1408,1699,0
4013306501,4013306501,0,848,1388,0
4014118446,4014118445,-1,1651,2170,0
4014965133,4014965134,1,1199,1288,0
4017694763,4017694764,1,1252,2099,0
4018495890,4018495891,1,1757,1753,0
4018944608,4018944606,-2,1262,2506,0
4021171595,4021171594,-1,1467,2339,0
4021750126,4021750127,1,1935,2130,0
4021790702,4021790703,1,1086,1394,0
4024162306,4024162306,0,817,1329,0
4024319709,4024319706,-3,1379,2809,0
4025491782,4025491782,0,1014,894,0
4025655602,4025655582,-20,1653,1723,0
4028706357,4028706356,-1,1349,1520,0
4030124493,4030124497,4,788,658,0
4031615355,4031615355,0,1244,1576,0
4032589850,4032589851,1,1079,1143,0
4033254937,4033254938,1,859,1757,0
4035989664,4035989665,1,1585,1408,0
4038479598,4038479598,0,1125,1308,0
4043869173,4043869174,1,1060,1442,0
4044284693,4044284693,0,1453,1489,0
4048506009,4048505992,-17,1743,1731,0
4050750211,4050750212,1,1175,1800,0
4051782983,4051782983,0,1245,1609,0
4052876709,4052876709,0,1112,1508,0
4055132843,4055132846,3,1916,1680,0
4057571118,4057571118,0,1138,1411,0
4057839911,4057839907,-4,1189,1577,0
4064022035,4064022034,-1,1296,1253,0
4065894815,4065894814,-1,880,2024,0
4070839922,4070839919,-3,1251,1582,0
4073151790,4073151790,0,1580,1645,0
4076512978,4076512979,1,1567,1973,0
4080703626,4080703626,0,1061,1244,0
4082139232,4082139232,0,1381,2591,0
4082388539,4082388538,-1,1157,1639,0
4086851788,4086851791,3,1675,1000,0
4089092691,4089092690,-1,1356,1774,0
4093305611,4093305611,0,1207,1738,0
4094227626,4094227626,0,831,971,0
4094675031,4094675032,1,3316,3062,0
4095303859,4095303861,2,1186,1510,0
4096281289,4096281290,1,1343,1702,0
4098702642,4098702643,1,1863,2170,0
4100241480,4100241477,-3,29212,14183,0
4103066136,4103066138,2,1462,1695,0
4106871559,4106871561,2,1063,1135,0
4107192778,4107192778,0,1692,1792,0
4109314741,4109314743,2,1276,1784,0
4125033361,4125033363,2,2203,1116,0
4128780185,4128780186,1,1849,2198,0
4128978599,4128978604,5,3490,2807,0
4129191106,4129191106,0,1445,1487,0
4131392747,4131392744,-3,1166,3433,0
4131505566,4131505566,0,1335,1424,0
4133675126,4133675127,1,1488,2003,0
4135146279,4135146281,2,929,1542,0
4137923143,4137923142,-1,884,1738,0
4139179133,4139179133,0,1528,2157,0
4139574497,4139574496,-1,1678,1635,0
4141251218,4141251212,-6,2823,7240,0
4141330766,4141330769,3,1166,1025,0
4142301984,4142301983,-1,993,1462,0
4144882306,4144882305,-1,1405,2147,0
4145556929,4145556931,2,1519,1655,0
4146621862,4146621862,0,1667,1874,0
4149034706,4149034703,-3,1094,1562,0
4158013947,4158013948,1,1156,1281,0
4158731175,4158731173,-2,1463,2462,0
4159412588,4159412606,18,737,736,0
4163313948,4163313948,0,1714,2189,0
4166258605,4166258608,3,2085,2190,0
4166701415,4166701416,1,1325,1844,0
4167813411,4167813415,4,1893,1336,0
4169259271,4169259270,-1,1700,1964,0
4170080937,4170080938,1,1941,1600,0
4170494963,4170494962,-1,1358,1509,0
4172610826,4172610827,1,1384,1323,0
4173047026,4173047025,-1,1277,1720,0
4173577926,4173577947,21,412,741,0
4173920070,4173920072,2,1576,1716,0
4175005515,4175005517,2,633,1391,0
4179738236,4179738236,0,1327,1507,0
4184447493,4184447493,0,1580,1229,0
4186676193,4186676188,-5,1237,1501,0
4191674903,4191674904,1,1539,1528,0
4193187775,4193187776,1,1170,1816,0
4193580371,4193580370,-1,1140,1906,0
4197568954,4197568956,2,1213,1890,0
4198605439,4198605439,0,1494,1576,0
4198951419,4198951419,0,1420,1956,0
4200905814,4200905815,1,1522,1740,0
4201090379,4201090377,-2,947,1210,0
4201684594,4201684594,0,2006,2197,0
4202363364,4202363362,-2,1406,2225,0
4210854697,4210854698,1,1306,1916,0
4212051320,4212051329,9,11973,36601,0
4214821194,4214821195,1,1268,1889,0
4217335604,4217335604,0,2506,2732,0
4219479446,4219479446,0,1066,1237,0
4220935289,4220935289,0,732,1406,0
4224008491,4224008493,2,1086,1292,0
4225902930,4225902929,-1,1208,2070,0
4227414086,4227414087,1,1697,1848,0
4229002884,4229002882,-2,1703,1997,0
4230734153,4230734137,-16,502,541,0
4234311855,4234311855,0,1271,1562,0
4235061335,4235061336,1,1278,1895,0
4236459373,4236459372,-1,1030,1579,0
4240600883,4240600882,-1,1168,1609,0
4242221190,4242221189,-1,892,1796,0
4243461846,4243461845,-1,1986,1702,0
4244131317,4244131317,0,1135,1107,0
4245463601,4245463601,0,1559,1716,0
4246516415,4246516416,1,1297,1131,0
4246975494,4246975494,0,1118,1808,0
4248586954,4248586955,1,1624,2056,0
4248848030,4248848031,1,1272,1469,0
4249046924,4249046925,1,1465,1784,0
4251566434,4251566437,3,1568,1474,0
4252621077,4252621081,4,2157,1488,0
4256143692,4256143692,0,1262,1787,0
4262117851,4262117851,0,1295,1820,0
4269493214,4269493230,16,1254,1359,0
4270478502,4270478503,1,1357,1781,0
4270930371,4270930370,-1,1624,2412,0
4272793769,4272793753,-16,1207,1634,0
4272893473,4272893474,1,1591,2006,0
4273120948,4273120949,1,1403,1903,0
4274255518,4274255519,1,1527,1513,0
4275169749,4275169751,2,600,1338,0
4276316677,4276316678,1,1285,2098,0
4281517175,4281517175,0,1388,2149,0
4283701594,4283701594,0,1415,1749,0
4283945938,4283945938,0,1353,1896,0
4284874384,4284874382,-2,1581,1423,0
4291112311,4291112305,-6,1684,5178,0
4291276343,4291276340,-3,981,1633,0
4293053561,4293053575,14,1236,1379,0
4293816550,4293816549,-1,1335,1830,0
4293902156,4293902143,-13,1108,2224,0
4295795503,4295795503,0,1094,1707,0
4297217017,4297217018,1,1396,1822,0
4300245411,4300245413,2,1004,1218,0
4301468448,4301468457,9,2326,1602,0
4304479833,4304479836,3,1552,1734,0
4307240171,4307240173,2,1388,1795,0
4308734845,4308734846,1,1882,2113,0
4311875133,4311875133,0,1579,2056,0
4312891310,4312891311,1,748,1537,0
4313837848,4313837850,2,1323,1614,0
4314206138,4314206135,-3,1224,2165,0
4315730250,4315730250,0,2067,2454,0
4316117982,4316117982,0,1444,1435,0
4319873480,4319873481,1,1621,1448,0
4320290617,4320290617,0,1146,1248,0
4326202562,4326202563,1,1452,2111,0
4327185864,4327185865,1,1558,1895,0
4327623863,4327623863,0,1516,1997,0
4327744639,4327744654,15,771,922,0
4329415853,4329415848,-5,161,5,0
4330412945,4330412946,1,1408,1710,0
4332461644,4332461653,9,1468,1217,0
4335876601,4335876599,-2,1343,2519,0
4336150838,4336150834,-4,753,2705,0
4341425967,4341425969,2,995,1072,0
4341847478,4341847479,1,1559,2020,0
4342395114,4342395114,0,954,1144,0
4342764957,4342764958,1,1532,1898,0
4347416625,4347416625,0,808,1166,0
4348407158,4348407158,0,864,988,0
4350673800,4350673798,-2,1401,2329,0
4351797233,4351797234,1,1612,1878,0
4352424310,4352424311,1,1138,1558,0
4352760131,4352760133,2,1270,1694,0
4356095602,4356095602,0,1901,1682,0
4357857430,4357857430,0,1537,1694,0
4359758274,4359758277,3,1357,1283,0
4361257444,4361257445,1,2064,2285,0
4361576856,4361576855,-1,1118,1291,0
4362873435,4362873434,-1,1514,1927,0
4366316569,4366316566,-3,845,849,0
4366851762,4366851759,-3,1134,1981,0
4368255300,4368255302,2,33104,19816,0
4368990822,4368990822,0,969,1434,0
4369405467,4369405464,-3,1179,1610,0
4370355077,4370355075,-2,940,967,0
4371492156,4371492154,-2,997,1557,0
4372145014,4372145013,-1,1050,1816,0
4374948725,4374948728,3,1852,1834,0
4376589773,4376589772,-1,1315,1325,0
4377001519,4377001524,5,489,324,0
4377596781,4377596785,4,3287,2205,0
4379738274,4379738274,0,1070,1350,0
4380332220,4380332220,0,974,1598,0
4380367475,4380367477,2,1114,1811,0
4388194603,4388194606,3,1442,1533,0
4389249865,4389249867,2,1084,989,0
4391319548,4391319546,-2,2966,4433,0
4391626835,4391626835,0,1256,1341,0
4393567176,4393567178,2,1380,2262,0
4394671302,4394671301,-1,877,1985,0
4398611862,4398611858,-4,438,1190,0
4405104933,4405104933,0,1830,2593,0
4407632073,4407632074,1,2124,2536,0
4407964809,4407964808,-1,1729,2712,0
4411973813,4411973813,0,1423,1808,0
4414059705,4414059706,1,1281,2009,0
4416993533,4416993534,1,2018,2076,0
4417312405,4417312406,1,1358,1978,0
4420701603,4420701603,0,872,918,0
4421444423,4421444421,-2,1149,1454,0
4421932689,4421932691,2,1461,1364,0
4423173595,4423173594,-1,1430,1827,0
4425433244,4425433245,1,1685,2219,0
4425589298,4425589299,1,1032,1417,0
4425775697,4425775697,0,1036,2340,0
4426637042,4426637041,-1,2027,1564,0
4427626089,4427626089,0,1696,1664,0
4432673225,4432673223,-2,1102,1738,0
4432940029,4432940051,22,130,1747,0
4440564319,4440564320,1,1456,1197,0
4441116042,4441116044,2,1374,1442,0
4443917748,4443917745,-3,1252,2415,0
4445547106,4445547105,-1,1600,2015,0
4446508560,4446508561,1,927,1629,0
4448765215,4448765216,1,1167,1607,0
4452045985,4452045990,5,2896,1434,0
4453006014,4453006014,0,1560,1639,0
4454847807,4454847807,0,1921,1429,0
4456136906,4456136906,0,1622,2412,0
4458136423,4458136421,-2,941,1883,0
4463382834,4463382834,0,985,1130,0
4465329167,4465329169,2,1047,1732,0
4467585759,4467585759,0,1118,1278,0
4468122743,4468122743,0,1356,1978,0
4469470851,4469470851,0,1490,1689,0
4470343319,4470343318,-1,1342,1548,0
4473939090,4473939089,-1,661,1817,0
4474477633,4474477632,-1,1296,1797,0
4475373804,4475373807,3,1626,1696,0
4475420779,4475420781,2,1356,1567,0
4475500550,4475500551,1,1870,1277,0
4475594682,4475594682,0,1646,1831,0
4477066065,4477066065,0,1313,1896,0
4477893534,4477893534,0,967,1209,0
4479737638,4479737641,3,1169,1513,0
4484532416,4484532418,2,990,2041,0
4486514509,4486514507,-2,1269,1828,0
4486922275,4486922274,-1,1785,1811,0
4488016985,4488016986,1,1625,1624,0
4490371444,4490371442,-2,1227,1553,0
4491519421,4491519421,0,1760,2216,0
4492335965,4492335967,2,1113,1095,0
4494503978,4494503957,-21,1126,1232,0
4501468893,4501468893,0,2362,2231,0
4502900142,4502900142,0,863,1332,0
4503196629,4503196633,4,1591,1284,0
4503423888,4503423873,-15,182,7216,0
4504084611,4504084610,-1,966,1544,0
4508576639,4508576641,2,2078,1444,0
4508650034,4508650032,-2,1248,1716,0
4508840765,4508840766,1,1124,1664,0
4509297144,4509297143,-1,1369,1064,0
4513916861,4513916866,5,1774,1021,0
4521305863,4521305865,2,1188,1995,0
4522771618,4522771618,0,1552,1737,0
4525159869,4525159867,-2,1317,1655,0
4526675794,4526675797,3,1506,1734,0
4534663560,4534663561,1,1241,1558,0
4538465759,4538465759,0,1924,2022,0
4538781663,4538781663,0,2144,1953,0
4540317093,4540317094,1,1225,1063,0
4542039825,4542039826,1,1328,1563,0
4542774279,4542774279,0,1077,1022,0
4547199264,4547199266,2,1991,1746,0
4549654034,4549654034,0,1152,1627,0
4552840833,4552840832,-1,1627,2512,0
4553315370,4553315373,3,1179,1268,0
4559557114,4559557114,0,1274,1765,0
4562486500,4562486503,3,1283,1925,0
4563074317,4563074316,-1,1283,2278,0
4564106196,4564106194,-2,1062,1139,0
4564540732,4564540730,-2,1024,1726,0
4564845710,4564845708,-2,1439,1997,0
4567672726,4567672727,1,1321,1436,0
4568412961,4568412961,0,1196,1364,0
4568853205,4568853193,-12,33714,17079,0
4570239403,4570239404,1,1445,1811,0
4574581300,4574581305,5,1204,1328,0
4579518134,4579518134,0,1750,2407,0
4580694637,4580694639,2,1138,1614,0
4581742651,4581742650,-1,1082,1301,0
4583481143,4583481143,0,1303,1475,0
4584232612,4584232610,-2,1342,1308,0
4585656038,4585656039,1,1188,1577,0
4587564431,4587564429,-2,1617,1714,0
4589031459,4589031457,-2,1427,1554,0
4593871843,4593871841,-2,2326,1911,0
4594338924,4594338923,-1,1148,1553,0
4597870937,4597870938,1,1909,1829,0
4598553881,4598553866,-15,1021,2314,0
4599356227,4599356227,0,1346,1508,0
4603687483,4603687482,-1,1010,1227,0
4607824961,4607824969,8,1142,1185,0
4608122465,4608122464,-1,1796,1973,0
4608816584,4608816582,-2,771,1595,0
4609812493,4609812493,0,1441,2252,0
4611640242,4611640240,-2,1578,2146,0
4615465822,4615465821,-1,905,1869,0
4619821194,4619821183,-11,12066,39728,0
4626725694,4626725697,3,1995,1770,0
4626756887,4626756887,0,1886,3423,0
4627175553,4627175557,4,4195,2875,0
4633605859,4633605859,0,1202,1945,0
4636618102,4636618102,0,1329,1276,0
4640652104,4640652110,6,4003,1700,0
4642222049,4642222048,-1,1142,1686,0
4644155567,4644155568,1,1762,1759,0
4644766935,4644766934,-1,1929,2937,0
4644816940,4644816942,2,1669,1537,0
4649813058,4649813058,0,883,1664,0
4654709082,4654709083,1,964,1430,0
4658020067,4658020069,2,1203,1969,0
4660649158,4660649158,0,1367,1202,0
4664156706,4664156708,2,1447,1965,0
4667755933,4667755934,1,1454,2244,0
4668733815,4668733797,-18,191,1125,0
4670201380,4670201389,9,13036,27040,0
4671199406,4671199410,4,1902,1875,0
4671353146,4671353124,-22,1357,1999,0
4673655963,4673655942,-21,1444,1212,0
4676469153,4676469154,1,1029,1614,0
4677460134,4677460134,0,1423,1696,0
4678463838,4678463845,7,6888,2479,0
4678977915,4678977917,2,1744,1808,0
4679286811,4679286810,-1,1332,1906,0
4680009670,4680009671,1,1587,1899,0
4685189841,4685189840,-1,3998,23698,0
4686949237,4686949238,1,1680,2182,0
4689366746,4689366749,3,1305,1584,0
4690459499,4690459502,3,1041,1148,0
4694181998,4694181999,1,1465,1390,0
4694844389,4694844390,1,1246,2108,0
4694911275,4694911277,2,1702,2159,0
4695703802,4695703804,2,1310,1284,0
4696292301,4696292308,7,3021,1063,0
4697282095,4697282097,2,1583,1696,0
4700482717,4700482715,-2,1017,2084,0
4707578074,4707578079,5,1268,864,0
4711539977,4711539977,0,1059,1209,0
4713364959,4713364958,-1,1633,1566,0
4715455465,4715455466,1,1595,2557,0
4716800259,4716800261,2,1373,1706,0
4718071433,4718071433,0,1669,2114,0
4719723249,4719723249,0,930,1304,0
4722639650,4722639649,-1,1330,2043,0
4723299577,4723299575,-2,1277,1506,0
4723402846,4723402836,-10,1095,2142,0
4724393295,4724393295,0,1680,2418,0
4726843510,4726843513,3,1345,1772,0
4727327000,4727327002,2,2389,2532,0
4734162374,4734162373,-1,1317,2158,0
4739034871,4739034871,0,1402,1622,0
4739593989,4739593987,-2,1531,1572,0
4740112721,4740112721,0,1604,2251,0
4740330086,4740330087,1,1346,1901,0
4743041044,4743041045,1,1767,1677,0
4743723213,4743723212,-1,1516,1994,0
4748769209,4748769211,2,936,1368,0
4752428699,4752428700,1,1828,2292,0
4755686927,4755686926,-1,956,1383,0
4758827393,4758827394,1,1387,1327,0
4761381447,4761381446,-1,1208,1462,0
4761816071,4761816071,0,1134,1475,0
4764902847,4764902846,-1,1123,1953,0
4767528046,4767528048,2,1116,1816,0
4767864418,4767864418,0,1422,2124,0
4769480416,4769480416,0,1498,1786,0
4770179183,4770179183,0,1268,1810,0
4770637010,4770637010,0,1499,1472,0
4772152637,4772152638,1,2123,2728,0
4773770445,4773770443,-2,1721,2054,0
4778076199,4778076200,1,1404,1905,0
4779129944,4779129943,-1,1607,1851,0
4781011241,4781011239,-2,1331,1943,0
4782627402,4782627405,3,1866,1514,0
4783968618,4783968620,2,1008,1332,0
4784884508,4784884508,0,1658,2499,0
4785047769,4785047768,-1,43717,15305,0
4785693178,4785693179,1,1766,1452,0
4788520677,4788520683,6,2177,1191,0
4788663698,4788663699,1,1304,1510,0
4789264865,4789264863,-2,1649,1750,0
4790443491,4790443493,2,1499,1939,0
4790690659,4790690658,-1,1112,1210,0
4794935199,4794935199,0,1291,1744,0
4796399461,4796399462,1,1538,1262,0
4798866527,4798866525,-2,1457,2693,0
4800347348,4800347351,3,2226,1422,0
4802721699,4802721701,2,996,1534,0
4805199182,4805199184,2,2192,1836,0
4807989761,4807989768,7,1179,1553,0
4808310262,4808310260,-2,1781,2092,0
4808373895,4808373896,1,1298,1731,0
4809117151,4809117151,0,829,1201,0
4809578045,4809578045,0,1429,1556,0
4810590818,4810590818,0,1234,1815,0
4811723991,4811723991,0,1702,1564,0
4812724309,4812724310,1,1102,2277,0
4815141944,4815141943,-1,1505,846,0
4815249693,4815249677,-16,991,324,0
4818807759,4818807761,2,1636,1843,0
4819386034,4819386033,-1,1422,1617,0
4824408185,4824408186,1,1685,1729,0
4828712431,4828712431,0,1375,1578,0
4829615988,4829615989,1,1368,1317,0
4832591132,4832591133,1,1366,1562,0
4834786418,4834786419,1,1642,1906,0
4837190000,4837189998,-2,1509,1582,0
4837650560,4837650560,0,1603,1741,0
4841969226,4841969226,0,988,1356,0
4844623748,4844623751,3,42672,20543,0
4847776918,4847776919,1,1218,1435,0
4850628527,4850628530,3,1909,1810,0
4850760511,4850760510,-1,980,1071,0
4862361435,4862361436,1,1472,1895,0
4864026272,4864026271,-1,1523,1356,0
4864148755,4864148754,-1,1747,1912,0
4866084016,4866084014,-2,1631,1262,0
4867454018,4867454021,3,883,1705,0
4868178703,4868178702,-1,1860,1605,0
4869583124,4869583125,1,1241,1680,0
4871744435,4871744435,0,862,1375,0
4871951343,4871951345,2,1104,1200,0
4873419980,4873419974,-6,2440,7167,0
4873840421,4873840422,1,1758,1774,0
4874108142,4874108143,1,982,1577,0
4874318263,4874318258,-5,1041,1165,0
4877477902,4877477905,3,1445,1338,0
4884265370,4884265371,1,2027,2581,0
4885761810,4885761812,2,1648,1409,0
4886113975,4886113969,-6,1737,7280,0
4888743287,4888743287,0,1200,1459,0
4889692222,4889692221,-1,1254,2468,0
4891099634,4891099634,0,1655,1994,0
4891760501,4891760501,0,1510,1940,0
4896640355,4896640367,12,1647,1565,0
4897455022,4897455023,1,1561,2066,0
4897887113,4897887113,0,1062,1842,0
4898328494,4898328495,1,1932,1006,0
4899638052,4899638054,2,2241,1966,0
4899891154,4899891156,2,1442,1639,0
4906916939,4906916939,0,1230,1357,0
4906991405,4906991405,0,1811,2877,0
4907711534,4907711529,-5,1138,1501,0
4908802953,4908802954,1,109,698,0
4914473682,4914473683,1,1304,1933,0
4921093401,4921093401,0,991,1600,0
4924656119,4924656119,0,1046,834,0
4925481333,4925481334,1,1251,972,0
4927920433,4927920438,5,1341,1183,0
4928380301,4928380307,6,3495,1758,0
4937417442,4937417441,-1,1345,1548,0
4941035351,4941035350,-1,1437,1954,0
4941289803,4941289805,2,1620,1857,0
4943040101,4943040101,0,1278,1520,0
4943722754,4943722754,0,1251,1770,0
4945869485,4945869485,0,1295,1174,0
4946234697,4946234698,1,1164,1330,0
4946868099,4946868100,1,1727,2066,0
4947104928,4947104930,2,2484,1801,0
4949086043,4949086042,-1,1270,1456,0
4950010334,4950010334,0,2449,2381,0
4952750248,4952750249,1,1283,1867,0
4953110959,4953110959,0,861,1149,0
4957388209,4957388209,0,903,1490,0
4958700869,4958700870,1,1715,2566,0
4959055110,4959055110,0,1706,2635,0
4963114051,4963114054,3,1295,1529,0
4963145962,4963145959,-3,1075,1387,0
4966677801,4966677802,1,1725,2022,0
4967999458,4967999458,0,1499,2414,0
4969931044,4969931044,0,1393,1401,0
4971080171,4971080173,2,1536,1613,0
4971659702,4971659699,-3,1191,2208,0
4973418770,4973418773,3,1715,1661,0
4974756071,4974756073,2,1900,2280,0
4975221748,4975221747,-1,1300,1902,0
4975937971,4975937972,1,1687,1464,0
4977928713,4977928711,-2,899,1258,0
4989857536,4989857532,-4,1922,4552,0
4992753894,4992753894,0,2748,3886,0
4993785087,4993785086,-1,2367,1903,0
4993946729,4993946734,5,1514,1172,0
4996952185,4996952201,16,1244,1244,0
4997371020,4997371019,-1,1313,2614,0
5003808262,5003808264,2,1262,1537,0
5008294922,5008294923,1,1113,1570,0
5008463508,5008463509,1,1314,2087,0
5010888266,5010888268,2,942,963,0
5013144255,5013144257,2,1625,1460,0
5013183092,5013183110,18,1427,1642,0
5019300722,5019300721,-1,1734,3830,0
5022959878,5022959880,2,1262,2126,0
5027883126,5027883126,0,1774,1617,0
5029511785,5029511785,0,1016,1638,0
5030942173,5030942173,0,1699,2276,0
5031588471,5031588489,18,1499,1470,0
5033337495,5033337496,1,943,1086,0
5034807066,5034807066,0,1127,1070,0
5035669005,5035669005,0,1268,2007,0
5038064856,5038064871,15,1598,1469,0
5042950835,5042950838,3,1600,1191,0
5046646963,5046646962,-1,1255,1043,0
5047373176,5047373177,1,1298,1710,0
5048654033,5048654022,-11,1349,1795,0
5049980267,5049980262,-5,1249,1690,0
5050293322,5050293330,8,5324,906,0
5052987204,5052987203,-1,1749,1937,0
5053031571,5053031567,-4,978,1592,0
5054464303,5054464302,-1,1619,1489,0
5057090011,5057090010,-1,1532,1956,0
5057928486,5057928486,0,1284,2113,0
5060081194,5060081190,-4,710,3264,0
5064376466,5064376467,1,1312,2644,0
5068401341,5068401343,2,2117,1795,0
5071629850,5071629852,2,8000,32787,0
5072427493,5072427494,1,1669,1985,0
5075599219,5075599217,-2,1246,1680,0
5077688090,5077688089,-1,1796,2339,0
5087973542,5087973547,5,1932,973,0
5089214254,5089214253,-1,1329,1731,0
5091948528,5091948528,0,1296,1510,0
5094277872,5094277872,0,1256,1372,0
5098233943,5098233945,2,1286,1784,0
5101240628,5101240627,-1,1210,1303,0
5102145539,5102145541,2,991,1680,0
5104576417,5104576417,0,1467,2172,0
5108036511,5108036514,3,1064,1268,0
5110325309,5110325302,-7,1907,7517,0
5111481923,5111481925,2,2091,2430,0
5113834755,5113834734,-21,750,523,0
5116898293,5116898293,0,1196,1971,0
5117173286,5117173301,15,706,1087,0
5120613610,5120613611,1,1010,1984,0
5120738206,5120738207,1,1443,2050,0
5120824981,5120824981,0,1615,1679,0
5123931826,5123931826,0,27106,23579,0
5125071749,5125071747,-2,1044,1353,0
5125359109,5125359114,5,4171,1609,0
5126996706,5126996701,-5,1328,4228,0
5128178066,5128178066,0,763,988,0
5129751066,5129751061,-5,1226,2536,0
5130465341,5130465341,0,1310,1751,0
5130895157,5130895178,21,706,1401,0
5131688016,5131688019,3,1909,1311,0
5132717842,5132717842,0,1087,1871,0
5133531245,5133531245,0,1128,1505,0
5135060371,5135060371,0,737,1276,0
5137251635,5137251634,-1,1641,1869,0
5140724254,5140724258,4,1428,1559,0
5144033134,5144033137,3,3719,3168,0
5145623201,5145623206,5,2934,1801,0
5146453938,5146453939,1,1204,1735,0
5148994783,5148994783,0,1886,2593,0
5151756669,5151756668,-1,1461,1759,0
5154128658,5154128660,2,1167,2143,0
5155685382,5155685383,1,855,1192,0
5156036599,5156036601,2,1235,1906,0
5156373041,5156373036,-5,789,2355,0
5158029986,5158029985,-1,1984,1704,0
5159800429,5159800430,1,1223,1071,0
5164974266,5164974266,0,2152,1855,0
5167353013,5167353014,1,1349,1028,0
5168683669,5168683669,0,1828,2272,0
5169163238,5169163239,1,1281,1476,0
5170526142,5170526146,4,1480,1318,0
5171123510,5171123509,-1,1030,2008,0
5172648158,5172648174,16,536,1330,0
5173547607,5173547609,2,1069,1327,0
5177833463,5177833468,5,1267,1462,0
5179703439,5179703439,0,1192,1444,0
5180605645,5180605643,-2,1685,2693,0
5180926598,5180926598,0,1848,1458,0
5184009527,5184009528,1,1074,1271,0
5184563667,5184563663,-4,1342,1305,0
5185183978,5185183977,-1,1968,2232,0
5186058403,5186058403,0,1344,1492,0
5186283906,5186283907,1,1221,1914,0
5186384248,5186384263,15,865,2175,0
5186550531,5186550532,1,1914,2111,0
5192165227,5192165228,1,1326,1702,0
5195637638,5195637638,0,1189,1630,0
5199150439,5199150441,2,1509,1483,0
5200683916,5200683918,2,1301,1319,0
5208949340,5208949336,-4,1024,2540,0
5211803978,5211803978,0,1416,1230,0
5213701281,5213701281,0,1329,1636,0
5214645179,5214645174,-5,1293,1837,0
5217707167,5217707167,0,1491,1554,0
5218781451,5218781451,0,1363,1307,0
5222824615,5222824615,0,1214,1649,0
5223723554,5223723555,1,1371,1725,0
5224173514,5224173514,0,1172,1267,0
5227211317,5227211319,2,4222,3416,0
5227288662,5227288662,0,1096,1237,0
5229354521,5229354524,3,1243,1505,0
5230491495,5230491497,2,1326,1044,0
5231709118,5231709122,4,2363,1344,0
5231990915,5231990916,1,1704,1546,0
5236216465,5236216466,1,1276,1732,0
5237593826,5237593827,1,838,1701,0
5238579788,5238579786,-2,286,832,0
5240371325,5240371325,0,1648,1929,0
5241105349,5241105350,1,1415,1817,0
5242333159,5242333162,3,762,886,0
5242454402,5242454402,0,1465,2180,0
5243509649,5243509652,3,1740,1348,0
5243717611,5243717614,3,887,1473,0
5244205994,5244205993,-1,1546,1248,0
5247320079,5247320082,3,1718,2777,0
5248238761,5248238759,-2,1902,2565,0
5248971743,5248971744,1,1930,2231,0
5249418035,5249418034,-1,1309,1977,0
5253560834,5253560834,0,1667,1856,0
5254930932,5254930938,6,451,1300,0
5255198903,5255198916,13,1899,1494,0
5255477910,5255477919,9,1499,1537,0
5257057827,5257057826,-1,1595,1994,0
5257643679,5257643678,-1,1323,1908,0
5259462385,5259462386,1,1693,2056,0
5261357404,5261357402,-2,1573,2024,0
5262238538,5262238537,-1,1559,2054,0
5264365193,5264365194,1,954,1455,0
5265319762,5265319762,0,1936,2153,0
5265688670,5265688673,3,1843,1480,0
5267285514,5267285514,0,1212,1378,0
5270181506,5270181506,0,741,1220,0
5271158813,5271158813,0,1646,1856,0
5276562369,5276562371,2,1170,1192,0
5277225274,5277225276,2,1526,1565,0
5281220010,5281220013,3,1159,1420,0
5282596596,5282596598,2,1615,1667,0
5285292546,5285292546,0,1623,2112,0
5287988107,5287988107,0,1852,2212,0
5288234867,5288234869,2,1234,1530,0
5289814105,5289814107,2,2496,2333,0
5291435362,5291435364,2,1089,1287,0
5293098234,5293098236,2,1930,1697,0
5294281202,5294281202,0,1348,1476,0
5294945142,5294945142,0,1007,1177,0
5296122831,5296122844,13,200,374,0
5297426119,5297426118,-1,790,2062,0
5301435408,5301435407,-1,1369,1574,0
5304855590,5304855589,-1,1538,1481,0
5306591135,5306591136,1,1162,1179,0
5308769389,5308769379,-10,1257,1464,0
5311680779,5311680781,2,1485,1737,0
5311931803,5311931805,2,1038,1953,0
5312209394,5312209391,-3,1031,1354,0
5315191266,5315191265,-1,1599,1296,0
5318030639,5318030639,0,1569,1482,0
5320105183,5320105183,0,1638,1641,0
5320927787,5320927785,-2,1302,1315,0
5323172723,5323172723,0,493,1050,0
5324553487,5324553490,3,1372,1248,0
5324990352,5324990353,1,1743,1139,0
5327905318,5327905320,2,1415,1285,0
5328257345,5328257327,-18,1096,1775,0
5328838545,5328838547,2,1725,1370,0
5329909555,5329909556,1,1436,1689,0
5332268146,5332268145,-1,1599,2147,0
5332628692,5332628695,3,1189,1001,0
5335605111,5335605112,1,1120,1595,0
5336709639,5336709637,-2,1320,1725,0
5336980868,5336980866,-2,1407,1630,0
5340592426,5340592430,4,2918,1300,0
5341425452,5341425450,-2,1709,2050,0
5342274883,5342274886,3,1110,1379,0
5345017646,5345017652,6,6010,24425,0
5347951646,5347951645,-1,1665,2342,0
5352502267,5352502266,-1,965,926,0
5352677444,5352677446,2,1760,1748,0
5353167138,5353167138,0,991,1869,0
5355074889,5355074890,1,1229,2260,0
5355554670,5355554670,0,1422,1695,0
5356466974,5356466978,4,1604,1252,0
5358192458,5358192459,1,1167,1633,0
5361706626,5361706626,0,1273,2322,0
5362342626,5362342628,2,883,1518,0
5365458041,5365458042,1,1386,2704,0
5366735481,5366735482,1,1192,1281,0
5367480479,5367480481,2,1523,2122,0
5368941701,5368941700,-1,1202,1782,0
5371137499,5371137497,-2,1321,1763,0
5378137875,5378137871,-4,2476,4774,0
5379024199,5379024199,0,868,1319,0
5380069721,5380069722,1,1426,1506,0
5381597630,5381597633,3,1098,1493,0
5385304487,5385304490,3,1432,1812,0
5386736992,5386736998,6,3483,1151,0
5391555578,5391555578,0,1174,1793,0
5394416203,5394416202,-1,1135,2540,0
5394853154,5394853154,0,1324,1679,0
5395833306,5395833306,0,1389,1911,0
5396138717,5396138718,1,1553,1430,0
5398485834,5398485833,-1,1734,1778,0
5399475625,5399475626,1,1584,2242,0
5401820872,5401820874,2,1551,1875,0
5407701442,5407701441,-1,1395,1863,0
5411100076,5411100077,1,1679,1941,0
5413736704,5413736705,1,1425,1983,0
5421006996,5421006999,3,14156,10490,0
5423400954,5423400956,2,1649,1304,0
5423629787,5423629790,3,3712,3200,0
5424997091,5424997091,0,1281,1262,0
5431520676,5431520677,1,1306,1894,0
5438249585,5438249587,2,1674,2012,0
5439342656,5439342658,2,947,1253,0
5439910225,5439910208,-17,1016,1241,0
5441782241,5441782241,0,1165,1871,0
5444826930,5444826929,-1,1258,1648,0
5446710233,5446710231,-2,1621,2087,0
5449763293,5449763295,2,923,753,0
5450044519,5450044518,-1,1123,2038,0
5451067831,5451067829,-2,1001,2209,0
5452528058,5452528058,0,1676,1725,0
5454077811,5454077809,-2,1556,2393,0
5455008242,5455008241,-1,1340,1744,0
5458384886,5458384886,0,1687,1717,0
5458472314,5458472315,1,895,1312,0
5459637302,5459637303,1,1581,2100,0
5459689639,5459689639,0,1635,1747,0
5461160638,5461160639,1,1009,1250,0
5462287593,5462287596,3,1908,1495,0
5464355126,5464355125,-1,1493,1631,0
5465461547,5465461549,2,1467,1660,0
5466979411,5466979413,2,1135,1679,0
5470573451,5470573453,2,1542,2084,0
5470844817,5470844818,1,1916,2245,0
5472514897,5472514897,0,1773,1747,0
5472840331,5472840311,-20,1122,1891,0
5479505778,5479505777,-1,1828,2083,0
5483120505,5483120507,2,7747,8013,0
5483297809,5483297810,1,1687,1973,0
5485873466,5485873467,1,1614,1628,0
5486090341,5486090341,0,1291,1789,0
5486134918,5486134918,0,1467,2125,0
5486450463,5486450463,0,1303,1790,0
5490175906,5490175907,1,1299,2151,0
5491968000,5491967998,-2,1682,1546,0
5492209658,5492209658,0,1574,1638,0
5497655943,5497655945,2,1004,1888,0
5500420122,5500420142,20,1186,1285,0
5502761951,5502761951,0,1263,1677,0
5504036486,5504036489,3,1372,1374,0
5504655254,5504655255,1,1593,1436,0
5505782061,5505782060,-1,1080,1495,0
5507277380,5507277375,-5,1322,1796,0
5508445306,5508445309,3,1174,974,0
5509864658,5509864661,3,1436,1534,0
5510263959,5510263958,-1,1145,2292,0
5511030582,5511030582,0,1170,1603,0
5512639406,5512639407,1,1469,1787,0
5515011462,5515011460,-2,1181,1681,0
5518845369,5518845371,2,1624,2166,0
5519816907,5519816907,0,906,952,0
5521154429,5521154431,2,2630,1668,0
5521362129,5521362130,1,1817,1447,0
5523892379,5523892379,0,1552,1524,0
5526120170,5526120174,4,2099,1436,0
5527232789,5527232789,0,1933,2124,0
5530183942,5530183941,-1,1663,1474,0
5530607193,5530607201,8,11226,35020,0
5531033700,5531033700,0,1784,2636,0
5531666202,5531666203,1,1439,2175,0
5535324066,5535324069,3,769,1105,0
5536378787,5536378786,-1,1544,1175,0
5544843895,5544843896,1,1605,1570,0
5545135883,5545135885,2,1395,1922,0
5545243581,5545243591,10,8292,38831,0
5545546937,5545546937,0,1077,1779,0
5545842492,5545842493,1,1406,1589,0
5548997121,5548997121,0,1531,1250,0
5550532718,5550532718,0,1458,1626,0
5552863438,5552863439,1,1669,1695,0
5553346834,5553346834,0,1597,2405,0
5553751202,5553751201,-1,1086,1890,0
5555270469,5555270470,1,1173,1414,0
5562672318,5562672322,4,932,1302,0
5568431066,5568431067,1,1275,1725,0
5568702389,5568702389,0,1188,1269,0
5570249263,5570249263,0,1213,1194,0
5570958340,5570958332,-8,1104,1889,0
5571635034,5571635034,0,1952,1396,0
5573601786,5573601770,-16,112,1576,0
5574559785,5574559787,2,2231,1856,0
5576903110,5576903111,1,1429,1746,0
5577845514,5577845518,4,1144,2032,0
5579473038,5579473042,4,1190,851,0
5584857490,5584857491,1,1238,1482,0
5587383227,5587383225,-2,996,2041,0
5589588065,5589588065,0,1662,2429,0
5590755269,5590755272,3,1795,2774,0
5595079753,5595079754,1,1713,1307,0
5595978160,5595978154,-6,871,1927,0
5598000268,5598000269,1,1588,1757,0
5598891933,5598891933,0,1261,1881,0
5599468126,5599468126,0,945,1474,0
5601306283,5601306283,0,981,1333,0
5601989426,5601989428,2,2016,1698,0
5603976725,5603976729,4,1643,1103,0
5604142182,5604142202,20,980,1414,0
5604534211,5604534211,0,1545,2211,0
5607708803,5607708801,-2,945,1312,0
5610567460,5610567455,-5,1510,3882,0
5615111070,5615111070,0,1329,1362,0
5615997959,5615997944,-15,922,1098,0
5618039234,5618039234,0,1857,2142,0
5619880318,5619880318,0,1470,2029,0
5620332713,5620332714,1,1563,1688,0
5623380397,5623380397,0,1841,1874,0
5624234889,5624234895,6,1514,1513,0
5625336966,5625336968,2,1864,1869,0
5626075354,5626075353,-1,1143,1368,0
5628626413,5628626415,2,822,874,0
5630007941,5630007943,2,1300,1209,0
5636209727,5636209725,-2,1258,1943,0
5643334795,5643334795,0,1576,1495,0
5646798594,5646798602,8,13566,29313,0
5653401004,5653401006,2,1568,1192,0
5653695179,5653695181,2,1120,1566,0
5656230656,5656230658,2,1356,1709,0
5657631580,5657631580,0,1672,2342,0
5659015881,5659015879,-2,1533,2437,0
5660402135,5660402135,0,1002,1623,0
5661669544,5661669544,0,1794,1770,0
5663647670,5663647670,0,2256,2343,0
5664995886,5664995887,1,34367,19985,0
5667494629,5667494631,2,1523,1132,0
5669417189,5669417191,2,1327,1652,0
5675962823,5675962825,2,1247,1559,0
5677322870,5677322875,5,1752,1268,0
5677401395,5677401395,0,1695,1582,0
5678589054,5678589055,1,1509,1799,0
5680452941,5680452943,2,1373,1971,0
5680904049,5680904051,2,3300,2545,0
5681975839,5681975837,-2,1699,1960,0
5685435141,5685435141,0,1355,1549,0
5687012458,5687012459,1,1397,1586,0
5688757364,5688757361,-3,1207,1449,0
5692873066,5692873067,1,975,1511,0
5697797796,5697797798,2,18507,18365,0
5701265762,5701265763,1,1131,1954,0
5701309749,5701309747,-2,953,1079,0
5702932393,5702932393,0,1703,1839,0
5704484922,5704484923,1,1385,1979,0
5705632405,5705632406,1,1185,1864,0
5706547911,5706547912,1,2010,2049,0
5707569210,5707569209,-1,1791,2400,0
5708071023,5708071014,-9,1461,1646,0
5708568959,5708568958,-1,919,1233,0
5713724357,5713724360,3,1540,1811,0
5719897512,5719897511,-1,1682,1884,0
5726986705,5726986706,1,1470,1772,0
5730081343,5730081344,1,1350,1615,0
5733336246,5733336245,-1,1528,1612,0
5734127358,5734127357,-1,1761,2554,0
5736494457,5736494454,-3,1774,5768,0
5737404517,5737404513,-4,1350,3698,0
5738475373,5738475370,-3,1141,1215,0
5739731061,5739731061,0,1391,1981,0
5743094454,5743094455,1,1255,1700,0
5743752436,5743752434,-2,4308,7381,0
5745584329,5745584330,1,1189,1752,0
5746875554,5746875555,1,1855,2104,0
5748783434,5748783439,5,2108,1407,0
5749039635,5749039635,0,1238,1246,0
5749123962,5749123960,-2,1222,2143,0
5749593867,5749593869,2,1468,2020,0
5751925858,5751925863,5,19325,44333,0
5753843951,5753843955,4,1206,1271,0
5756478825,5756478827,2,1865,1713,0
5758768852,5758768853,1,1481,1736,0
5762993515,5762993514,-1,996,1560,0
5763385092,5763385091,-1,1608,1648,0
5763819001,5763818999,-2,783,1511,0
5764744003,5764744010,7,4175,1571,0
5765213398,5765213398,0,1997,1844,0
5771414818,5771414819,1,1312,1448,0
5772401680,5772401685,5,1917,1672,0
5773385250,5773385251,1,1573,2276,0
5776108049,5776108050,1,1458,2073,0
5777061822,5777061825,3,1422,1239,0
5778072355,5778072357,2,1476,1955,0
5778306125,5778306126,1,1273,1929,0
5779054101,5779054102,1,1226,1639,0
5782731273,5782731274,1,1658,1394,0
5783299230,5783299231,1,1004,1698,0
5785556736,5785556737,1,774,1027,0
5787929610,5787929613,3,1220,1279,0
5791349597,5791349597,0,1390,1686,0
5793287658,5793287657,-1,1153,2102,0
5796571235,5796571233,-2,1209,2400,0
5798974073,5798974073,0,1193,2150,0
5800895939,5800895940,1,1472,1453,0
5801060355,5801060354,-1,1731,2168,0
5802371662,5802371666,4,1746,1666,0
5805257069,5805257070,1,1644,2725,0
5806517002,5806517004,2,1009,1082,0
5807306552,5807306551,-1,1477,1120,0
5809056214,5809056214,0,1518,1512,0
5809295803,5809295806,3,1062,1503,0
5810332376,5810332378,2,935,1224,0
5813120089,5813120090,1,1133,2352,0
5813400545,5813400544,-1,1280,1753,0
5816080997,5816080997,0,1432,1824,0
5816192623,5816192614,-9,998,1391,0
5823861778,5823861777,-1,1337,1400,0
5828159138,5828159138,0,1502,1958,0
5828661442,5828661444,2,1775,1513,0
5829208855,5829208862,7,4349,1477,0
5829471958,5829471975,17,1313,1593,0
5830011421,5830011422,1,2002,2028,0
5830395810,5830395812,2,1988,2280,0
5833475335,5833475334,-1,1272,1843,0
5834537582,5834537585,3,1214,1629,0
5836035782,5836035765,-17,997,4163,0
5839953602,5839953602,0,971,1693,0
5840178989,5840178988,-1,1481,1550,0
5840505726,5840505731,5,3563,2163,0
5841121050,5841121049,-1,957,1514,0
5841799572,5841799575,3,1084,1094,0
5842876477,5842876478,1,1370,1845,0
5843529253,5843529254,1,884,1440,0
5846462414,5846462414,0,937,966,0
5849750101,5849750100,-1,1584,1684,0
5854137299,5854137299,0,1570,1586,0
5854629890,5854629873,-17,1133,1403,0
5857213133,5857213137,4,2300,1367,0
5858555799,5858555798,-1,1271,2031,0
5858952393,5858952391,-2,1411,1657,0
5860973541,5860973541,0,1562,2069,0
5867578658,5867578659,1,1595,1945,0
5869239697,5869239698,1,1477,1701,0
5871395895,5871395895,0,1636,1583,0
5876837731,5876837730,-1,1638,2359,0
5878083233,5878083233,0,1443,1804,0
5880038167,5880038169,2,1296,1383,0
5884957834,5884957834,0,1390,2049,0
5884992893,5884992909,16,410,704,0
5889151522,5889151522,0,1133,1637,0
5890569566,5890569567,1,1403,2068,0
5895763457,5895763452,-5,1434,3392,0
5896627694,5896627695,1,1192,1213,0
5896875832,5896875834,2,1276,1565,0
5898708689,5898708690,1,1352,1895,0
5900859760,5900859759,-1,1595,1955,0
5902467068,5902467066,-2,1429,2322,0
5903429102,5903429103,1,909,1388,0
5904685798,5904685798,0,1178,1459,0
5905417857,5905417857,0,2082,1698,0
5905560507,5905560506,-1,1702,2205,0
5905868778,5905868777,-1,904,3573,0
5910309725,5910309726,1,1583,1694,0
5911237826,5911237826,0,1640,2346,0
5911723482,5911723482,0,1483,1549,0
5913597894,5913597897,3,1549,1687,0
5915241438,5915241438,0,1517,2280,0
5915324378,5915324377,-1,1620,1828,0
5917428106,5917428107,1,1243,1649,0
5918746197,5918746197,0,1348,1425,0
5919931158,5919931157,-1,1305,2222,0
5920133015,5920133010,-5,1001,2981,0
5923971093,5923971091,-2,1312,1880,0
5925142165,5925142166,1,1344,1645,0
5925373881,5925373882,1,1524,1916,0
5928435926,5928435925,-1,1620,1983,0
5937719877,5937719878,1,1437,1468,0
5941752626,5941752626,0,1412,1558,0
5947797890,5947797889,-1,1336,1348,0
5951751033,5951751033,0,1177,1339,0
5952803968,5952803970,2,1688,1906,0
5957996117,5957996117,0,1670,2348,0
5959509710,5959509713,3,1159,1252,0
5959578182,5959578189,7,5400,1433,0
5961944123,5961944124,1,1749,2155,0
5962763321,5962763322,1,1883,1417,0
5963690120,5963690121,1,1867,2111,0
5963910089,5963910090,1,1578,2290,0
5965243911,5965243914,3,1121,1764,0
5967323404,5967323403,-1,1412,1672,0
5970447406,5970447403,-3,1937,1996,0
5971017702,5971017703,1,1270,1991,0
5978104464,5978104463,-1,1209,1568,0
5978633650,5978633652,2,1148,1396,0
5979200830,5979200831,1,1219,1426,0
5981961113,5981961113,0,1437,1685,0
5982468870,5982468870,0,1669,1871,0
5988681612,5988681611,-1,1096,1934,0
5991278362,5991278359,-3,868,1469,0
5993271720,5993271722,2,1232,1541,0
5996934447,5996934447,0,967,1758,0
5997884137,5997884139,2,1301,1305,0
5999781210,5999781213,3,761,957,0
6004229990,6004229984,-6,979,4721,0
6004922161,6004922165,4,1045,1494,0
6005923930,6005923930,0,1291,1822,0
6010973823,6010973822,-1,949,2173,0
6013220653,6013220654,1,1405,1360,0
6014953589,6014953591,2,1105,2332,0
6015490160,6015490159,-1,1557,1761,0
6016682022,6016682023,1,1519,2418,0
6016977769,6016977769,0,1400,2000,0
6017341362,6017341340,-22,1253,330,0
6019487475,6019487476,1,1362,1664,0
6021460206,6021460207,1,39644,35700,0
6026561990,6026561989,-1,1361,1343,0
6026833241,6026833262,21,1551,972,0
6027209815,6027209799,-16,647,523,0
6027800173,6027800174,1,1364,1785,0
6029648227,6029648227,0,1468,2473,0
6035513889,6035513891,2,1466,1541,0
6035873620,6035873621,1,1347,2019,0
6036688990,6036688986,-4,1252,2959,0
6037214175,6037214178,3,1456,1352,0
6037917210,6037917212,2,1631,1382,0
6038027198,6038027194,-4,857,2498,0
6038601399,6038601418,19,2014,1905,0
6040191478,6040191464,-14,1394,1290,0
6042471661,6042471658,-3,1689,1590,0
6045520582,6045520588,6,1273,1907,0
6048065145,6048065138,-7,1007,2703,0
6048217470,6048217457,-13,1351,1867,0
6052479962,6052479963,1,1964,1942,0
6053142742,6053142742,0,1466,1329,0
6057516226,6057516224,-2,1208,2313,0
6062442861,6062442863,2,1285,1077,0
6065422914,6065422915,1,1679,2004,0
6067107226,6067107226,0,1046,1606,0
6068574319,6068574319,0,1376,2344,0
6075214857,6075214858,1,1299,1438,0
6076208963,6076208963,0,1504,1873,0
6080557771,6080557771,0,984,1531,0
6080945882,6080945886,4,2093,1302,0
6082380179,6082380181,2,1057,975,0
6084232371,6084232368,-3,1031,1225,0
6090509073,6090509073,0,1367,1963,0
6094311741,6094311743,2,853,1602,0
6099075332,6099075333,1,1457,1666,0
6101216066,6101216066,0,1374,1526,0
6102546086,6102546086,0,1556,2079,0
6102785069,6102785069,0,820,1056,0
6106586634,6106586634,0,1592,1293,0
6107311292,6107311295,3,1655,1372,0
6110545182,6110545183,1,1185,1331,0
6114147682,6114147682,0,1433,1701,0
6115208062,6115208063,1,1288,1778,0
6121900112,6121900113,1,1124,1323,0
6122771037,6122771035,-2,1614,2328,0
6123709194,6123709197,3,1072,1345,0
6125258588,6125258589,1,1195,2150,0
6126106518,6126106521,3,986,1817,0
6127049495,6127049496,1,1506,1663,0
6131218170,6131218170,0,1343,1431,0
6131503166,6131503166,0,1453,2106,0
6132576528,6132576530,2,1151,1587,0
6135844475,6135844477,2,1484,2168,0
6136796529,6136796530,1,1579,1585,0
6137431979,6137431978,-1,2061,1650,0
6140091488,6140091493,5,2458,1251,0
6140670143,6140670143,0,2087,2569,0
6147800225,6147800224,-1,1275,1226,0
6156027426,6156027426,0,1781,2401,0
6156380329,6156380330,1,1353,1644,0
6157563335,6157563335,0,1532,1563,0
6158996007,6158996007,0,788,1377,0
6162777734,6162777728,-6,993,3954,0
6163137019,6163137017,-2,1233,1490,0
6164203822,6164203822,0,1682,2151,0
6174377343,6174377343,0,649,1427,0
6175876539,6175876539,0,1071,1633,0
6176365946,6176365947,1,1546,1867,0
6176809146,6176809147,1,1191,1266,0
6178492553,6178492535,-18,2479,3577,0
6179587591,6179587590,-1,1369,1884,0
6186221815,6186221817,2,1656,1899,0
6186549451,6186549451,0,1331,1347,0
6187131438,6187131441,3,1421,1908,0
6189832608,6189832608,0,908,1231,0
6190110382,6190110377,-5,793,1907,0
6190231512,6190231524,12,278,749,0
6190694145,6190694147,2,1636,1761,0
6193217172,6193217162,-10,1071,1572,0
6194347130,6194347130,0,1262,1172,0
6195898781,6195898778,-3,1231,2550,0
6196636925,6196636925,0,1500,1703,0
6197049934,6197049934,0,1670,1442,0
6197376034,6197376026,-8,938,2086,0
6198621127,6198621125,-2,1291,2235,0
6200114625,6200114625,0,1286,1493,0
6202863874,6202863874,0,1318,1450,0
6203710708,6203710715,7,4197,1415,0
6209363247,6209363249,2,1935,1581,0
6210770654,6210770658,4,1571,1297,0
6213508886,6213508887,1,1214,1444,0
6214830358,6214830359,1,1156,1657,0
6215377431,6215377431,0,1315,1437,0
6216612367,6216612367,0,1422,1642,0
6218172787,6218172789,2,1248,1226,0
6218230316,6218230317,1,1338,2063,0
6219999891,6219999907,16,2016,1318,0
6220817361,6220817360,-1,1643,1527,0
6221007608,6221007611,3,2128,1361,0
6224799896,6224799897,1,1272,1173,0
6226359823,6226359824,1,1724,1996,0
6227399430,6227399430,0,1779,1488,0
6233528147,6233528147,0,1360,1343,0
6234537958,6234537965,7,3429,1758,0
6240636651,6240636651,0,932,1798,0
6241460154,6241460160,6,2958,1997,0
6244287551,6244287551,0,2179,2208,0
6249714242,6249714241,-1,1319,1291,0
6253571166,6253571166,0,1530,2492,0
6255900371,6255900373,2,1152,1396,0
6259230247,6259230246,-1,1686,1746,0
6261281395,6261281372,-23,1194,2005,0
6261881130,6261881131,1,1115,1534,0
6263208789,6263208790,1,1084,1405,0
6264126358,6264126362,4,1237,1303,0
6264517476,6264517477,1,1614,1568,0
6266622986,6266622986,0,1449,2056,0
6266835758,6266835757,-1,1052,1235,0
6268767363,6268767365,2,1096,1567,0
6273164699,6273164698,-1,1533,1980,0
6276796679,6276796680,1,1985,1752,0
6279179603,6279179605,2,1284,1771,0
6280420449,6280420450,1,1005,1672,0
6284424529,6284424528,-1,1464,1961,0
6292988881,6292988874,-7,19646,19125,0
6293342326,6293342326,0,1434,2025,0
6294618161,6294618162,1,1296,2145,0
6297683937,6297683934,-3,994,2005,0
6299099682,6299099686,4,1872,1513,0
6299944871,6299944870,-1,1075,1519,0
6303616302,6303616302,0,1106,1445,0
6304852427,6304852426,-1,1176,1646,0
6307143588,6307143590,2,1107,1886,0
6307701150,6307701150,0,1250,1418,0
6309217622,6309217623,1,1345,1330,0
6310417839,6310417843,4,1682,1812,0
6311371775,6311371779,4,1295,984,0
6311593733,6311593733,0,1664,1560,0
6313926719,6313926718,-1,1569,1483,0
6314179942,6314179961,19,757,1634,0
6315022711,6315022710,-1,1866,2742,0
6324720417,6324720416,-1,1075,2598,0
6327236227,6327236227,0,1122,1515,0
6328273580,6328273580,0,1607,2075,0
6331121942,6331121942,0,1099,1606,0
6331621718,6331621718,0,1515,2717,0
6332772159,6332772159,0,824,1374,0
6334104355,6334104354,-1,1077,1721,0
6337870911,6337870911,0,1102,1387,0
6339393856,6339393857,1,1057,1492,0
6339608059,6339608062,3,1066,1954,0
6339918406,6339918406,0,1508,2226,0
6341058703,6341058702,-1,1551,1968,0
6343511897,6343511897,0,1115,2464,0
6346035886,6346035886,0,1613,1683,0
6346065336,6346065338,2,1665,1968,0
6348203441,6348203441,0,1625,2422,0
6348693834,6348693834,0,1107,1199,0
6351036556,6351036559,3,2015,1569,0
6357482998,6357482997,-1,1489,2147,0
6358145434,6358145434,0,1703,2050,0
6358280943,6358280942,-1,1950,1944,0
6358324263,6358324265,2,1248,2290,0
6358487987,6358487986,-1,1233,1335,0
6359715441,6359715441,0,1818,2484,0
6360976522,6360976525,3,1176,886,0
6362409142,6362409144,2,2112,1928,0
6362498579,6362498577,-2,1440,2167,0
6362914207,6362914210,3,1533,1598,0
6364153047,6364153042,-5,1288,5422,0
6366339694,6366339696,2,1353,1750,0
6374633402,6374633403,1,1643,1481,0
6375015877,6375015875,-2,1371,1993,0
6376584847,6376584849,2,1370,1299,0
6378924245,6378924245,0,1098,1784,0
6380315198,6380315203,5,2093,1747,0
6380813039,6380813041,2,906,960,0
6384446733,6384446729,-4,1145,1693,0
6385833994,6385833996,2,1620,1452,0
6389869518,6389869518,0,1316,1920,0
6390743497,6390743500,3,1181,1553,0
6391876033,6391876034,1,1189,1730,0
6400425758,6400425758,0,1841,2743,0
6400795041,6400795044,3,1387,1098,0
6407520427,6407520431,4,1358,1344,0
6407624279,6407624286,7,3601,1337,0
6407715688,6407715702,14,1146,1670,0
6409149303,6409149304,1,1702,1574,0
6410283241,6410283241,0,1271,1662,0
6413400656,6413400658,2,1547,1724,0
6415173526,6415173528,2,1419,1917,0
6415765220,6415765216,-4,2057,6526,0
6418694187,6418694189,2,1225,2227,0
6422234623,6422234621,-2,1310,1577,0
6423653774,6423653775,1,1136,2315,0
6424112912,6424112911,-1,1856,2061,0
6426964474,6426964474,0,1218,1928,0
6427461454,6427461454,0,982,1565,0
6431371466,6431371466,0,1112,1945,0
6435303025,6435303026,1,2190,1912,0
6437283856,6437283855,-1,2269,1742,0
6437658547,6437658548,1,2109,1497,0
6440977155,6440977154,-1,2203,1904,0
6443212704,6443212706,2,1493,1078,0
6443538561,6443538562,1,1188,870,0
6444367113,6444367114,1,1887,2039,0
6447735067,6447735068,1,1187,1813,0
6451720491,6451720490,-1,1393,3262,0
6456306684,6456306686,2,1589,1400,0
6457284903,6457284903,0,1400,1878,0
6457663531,6457663530,-1,1602,1873,0
6459019868,6459019870,2,1214,1425,0
6460319070,6460319066,-4,1367,3115,0
6461543542,6461543542,0,1010,1873,0
6463296974,6463296974,0,1046,1285,0
6467558934,6467558933,-1,1564,2380,0
6470109934,6470109937,3,1378,1822,0
6474015411,6474015410,-1,1467,1698,0
6475177017,6475177015,-2,1371,2380,0
6475515676,6475515698,22,1699,1678,0
6475749707,6475749710,3,1470,1115,0
6476806385,6476806385,0,1265,1456,0
6478479795,6478479795,0,1196,1032,0
6480074545,6480074546,1,1579,1376,0
6480685357,6480685358,1,1469,1783,0
6480900133,6480900129,-4,1031,1910,0
6481272929,6481272931,2,1500,1253,0
6481718822,6481718822,0,960,1770,0
6482410237,6482410244,7,355,747,0
6485844311,6485844313,2,1463,1165,0
6486009728,6486009741,13,1139,1143,0
6489763735,6489763735,0,1395,1167,0
6493103489,6493103495,6,8967,22233,0
6493575578,6493575582,4,2185,1040,0
6494562663,6494562665,2,1067,1146,0
6496144281,6496144284,3,3199,2834,0
6497211322,6497211323,1,1468,1562,0
6498138830,6498138832,2,1299,1389,0
6498412191,6498412191,0,1939,2008,0
6498859006,6498859007,1,970,1500,0
6499056757,6499056759,2,1104,1210,0
6499479927,6499479929,2,1272,1348,0
6501336362,6501336363,1,1931,1385,0
6504199411,6504199414,3,1124,1279,0
6507151862,6507151862,0,1282,1747,0
6509167349,6509167352,3,1750,1556,0
6511967933,6511967931,-2,1509,2448,0
6515403698,6515403697,-1,1672,1481,0
6517541116,6517541118,2,1309,1299,0
6521330564,6521330564,0,1177,1566,0
6521396084,6521396083,-1,59244,27783,0
6521462789,6521462789,0,1384,1613,0
6525078762,6525078763,1,1744,2034,0
6525645988,6525645986,-2,1282,1349,0
6526504006,6526504009,3,1555,1582,0
6526664120,6526664121,1,1443,1663,0
6528148620,6528148618,-2,1357,2111,0
6529151499,6529151502,3,1410,1540,0
6529766929,6529766930,1,1788,1499,0
6532748469,6532748469,0,1480,1586,0
6534291805,6534291801,-4,1511,2171,0
6537137482,6537137484,2,560,1056,0
6539713438,6539713437,-1,1315,2165,0
6546150688,6546150687,-1,1558,1767,0
6548488007,6548488007,0,1025,1237,0
6549339515,6549339516,1,1182,1726,0
6550199900,6550199899,-1,1304,1680,0
6553216145,6553216146,1,1511,1299,0
6553722512,6553722514,2,998,1111,0
6555457094,6555457102,8,3546,1208,0
6558687222,6558687222,0,1325,1903,0
6559063019,6559063019,0,1133,1530,0
6561307543,6561307543,0,2071,1770,0
6564585281,6564585284,3,2302,2424,0
6567228741,6567228742,1,1685,1751,0
6568154983,6568154984,1,1710,1924,0
6568512901,6568512900,-1,1349,2286,0
6569237907,6569237908,1,1591,2216,0
6570438893,6570438893,0,1606,1602,0
6571974619,6571974621,2,1801,1471,0
6576435990,6576435991,1,2938,1422,0
6576667790,6576667790,0,1983,1597,0
6577227709,6577227707,-2,1482,1798,0
6578160377,6578160377,0,1331,1386,0
6579181374,6579181375,1,1276,1350,0
6580386669,6580386670,1,1538,1552,0
6580467150,6580467150,0,1150,994,0
6580628406,6580628406,0,890,1023,0
6582215497,6582215499,2,1483,1305,0
6583205882,6583205882,0,1322,1447,0
6586712039,6586712038,-1,1095,1446,0
6587373271,6587373273,2,1105,1301,0
6587870963,6587870963,0,1527,2622,0
6591423286,6591423289,3,1147,1730,0
6591901091,6591901086,-5,1957,5261,0
6593797637,6593797637,0,1657,1709,0
6594397234,6594397234,0,2131,2840,0
6595903748,6595903750,2,986,864,0
6597540818,6597540818,0,2305,2326,0
6600327310,6600327312,2,2136,1458,0
6601673193,6601673194,1,1463,1938,0
6605260060,6605260081,21,1237,1545,0
6605589237,6605589237,0,1961,2002,0
6606788135,6606788135,0,966,1392,0
6607764327,6607764327,0,1076,2194,0
6608899770,6608899765,-5,2695,7929,0
6610267127,6610267124,-3,890,1678,0
6612392893,6612392895,2,1681,2384,0
6614469629,6614469629,0,1591,1029,0
6614659462,6614659462,0,1685,1753,0
6620115787,6620115787,0,1379,1328,0
6621765109,6621765109,0,1298,1192,0
6621893585,6621893585,0,1349,1544,0
6622765802,6622765805,3,1133,1758,0
6623293625,6623293627,2,1627,1356,0
6625097397,6625097402,5,1895,1574,0
6627313380,6627313381,1,1827,1797,0
6630169982,6630169982,0,983,1757,0
6631236377,6631236378,1,1684,1831,0
6632256386,6632256390,4,2125,1286,0
6633037906,6633037907,1,2127,2309,0
6633350070,6633350070,0,930,1709,0
6634038115,6634038117,2,1344,1661,0
6635402738,6635402738,0,1605,1610,0
6636322477,6636322476,-1,1570,1675,0
6639471329,6639471329,0,1088,1610,0
6640173656,6640173654,-2,1215,1340,0
6640708467,6640708467,0,1534,2363,0
6647372476,6647372482,6,5588,2534,0
6647446059,6647446061,2,1152,1517,0
6648941506,6648941507,1,981,2032,0
6649097978,6649097977,-1,1110,2378,0
6652813328,6652813328,0,1690,1332,0
6658248133,6658248134,1,1204,1398,0
6659143450,6659143449,-1,928,1471,0
6660329125,6660329125,0,1096,1235,0
6661951746,6661951748,2,1937,1666,0
6663609923,6663609934,11,13205,33943,0
6664265489,6664265490,1,1426,1851,0
6665267797,6665267797,0,1006,1108,0
6665791706,6665791707,1,1467,1361,0
6668329483,6668329481,-2,958,1759,0
6675683810,6675683809,-1,1549,2513,0
6678149573,6678149574,1,1437,1695,0
6678957648,6678957647,-1,1512,1472,0
6685084461,6685084462,1,1011,1312,0
6686206087,6686206087,0,1177,1384,0
6686412150,6686412151,1,1125,937,0
6686439685,6686439688,3,1462,1518,0
6687449910,6687449910,0,1018,1335,0
6689517125,6689517127,2,979,1273,0
6695046930,6695046929,-1,951,1511,0
6696227675,6696227675,0,1065,1038,0
6698176231,6698176231,0,919,1292,0
6699704165,6699704166,1,1314,1252,0
6703197845,6703197843,-2,2060,2972,0
6705767039,6705767038,-1,1466,1544,0
6705843809,6705843811,2,1003,1387,0
6708410703,6708410706,3,1153,1364,0
6709922875,6709922874,-1,1591,1993,0
6711300421,6711300422,1,1238,1669,0
6712061374,6712061375,1,1235,1522,0
6712213271,6712213271,0,1273,1575,0
6712717204,6712717197,-7,39865,16053,0
6713995475,6713995475,0,1660,1799,0
6714635694,6714635694,0,1159,2002,0
6715196250,6715196251,1,1237,1887,0
6716415890,6716415884,-6,1641,7459,0
6716531889,6716531889,0,1250,1689,0
6716566133,6716566133,0,913,1287,0
6718483620,6718483621,1,1285,2335,0
6719108935,6719108937,2,1584,1678,0
6721092162,6721092162,0,1585,1222,0
6721292358,6721292358,0,957,1370,0
6722744785,6722744797,12,1696,1852,0
6727115818,6727115820,2,575,1190,0
6730309007,6730309007,0,1184,1556,0
6730655534,6730655535,1,1467,1917,0
6731444382,6731444383,1,1308,1390,0
6734261999,6734261999,0,1673,1643,0
6734656542,6734656541,-1,1201,1317,0
6739930498,6739930495,-3,1295,2370,0
6741459317,6741459307,-10,960,1269,0
6742079833,6742079837,4,1985,1612,0
6742929618,6742929618,0,1579,2432,0
6744062892,6744062891,-1,1239,2160,0
6747635837,6747635837,0,1553,2157,0
6753485314,6753485315,1,1263,2204,0
6754609799,6754609800,1,688,1262,0
6755427070,6755427070,0,1494,2134,0
6756850635,6756850637,2,1184,1128,0
6758949431,6758949429,-2,1054,1295,0
6759635593,6759635614,21,1367,954,0
6762973926,6762973926,0,1130,1362,0
6765220938,6765220941,3,1511,1345,0
6765647877,6765647877,0,1287,1913,0
6768557139,6768557138,-1,1753,1835,0
6770691351,6770691349,-2,1540,1871,0
6770953339,6770953334,-5,2883,8097,0
6772333318,6772333317,-1,1237,1740,0
6772461050,6772461050,0,1380,1938,0
6772971026,6772971029,3,1403,1186,0
6773496726,6773496729,3,2596,1649,0
6780002583,6780002584,1,1124,1391,0
6783276224,6783276230,6,2255,1335,0
6783750529,6783750530,1,1943,2312,0
6784014338,6784014339,1,1422,1835,0
6785448534,6785448540,6,2197,1381,0
6789464077,6789464073,-4,661,2028,0
6791325510,6791325509,-1,1380,1543,0
6795679886,6795679887,1,1299,1160,0
6796535769,6796535768,-1,1378,1427,0
6797602853,6797602853,0,1593,1919,0
6800591182,6800591183,1,1377,1121,0
6804887980,6804887986,6,2502,1335,0
6805767101,6805767102,1,1497,1722,0
6807054595,6807054594,-1,839,1523,0
6809240363,6809240365,2,1360,1312,0
6810157066,6810157066,0,1304,2032,0
6810624161,6810624158,-3,849,1169,0
6812577251,6812577252,1,1020,1658,0
6818444976,6818444976,0,2422,3220,0
6818755431,6818755433,2,1009,1330,0
6825480454,6825480455,1,1875,1782,0
6825863239,6825863238,-1,1538,2133,0
6828908195,6828908197,2,1258,1381,0
6831067119,6831067117,-2,1229,1345,0
6833376829,6833376831,2,1737,1928,0
6834910508,6834910509,1,1634,2381,0
6839461547,6839461549,2,1225,1775,0
6841143754,6841143754,0,1234,1575,0
6843210740,6843210738,-2,1206,2810,0
6846356543,6846356541,-2,667,1472,0
6847587998,6847587998,0,1857,1644,0
6849101379,6849101377,-2,1189,1699,0
6850008846,6850008849,3,958,1368,0
6855164013,6855164015,2,1384,1841,0
6859192968,6859192967,-1,1354,1648,0
6859466554,6859466554,0,1567,2212,0
6859598573,6859598570,-3,1721,1537,0
6860175783,6860175786,3,1916,2288,0
6862180534,6862180530,-4,1143,1514,0
6866191478,6866191478,0,1309,2028,0
6867204331,6867204329,-2,1042,882,0
6867551482,6867551483,1,1142,1674,0
6869610153,6869610154,1,1284,1139,0
6874221323,6874221322,-1,1442,1997,0
6878816033,6878816034,1,831,1369,0
6880310110,6880310111,1,1282,1254,0
6881322996,6881322997,1,1430,1282,0
6881489962,6881489964,2,1679,1384,0
6881903009,6881903013,4,25988,16139,0
6882390192,6882390194,2,1327,1499,0
6884388285,6884388284,-1,1443,1785,0
6890117459,6890117460,1,1194,1562,0
6892562811,6892562810,-1,1170,2155,0
6893217246,6893217250,4,1328,1372,0
6894014787,6894014786,-1,2017,2157,0
6894206661,6894206662,1,1336,1644,0
6896116511,6896116514,3,1242,1342,0
6896695229,6896695230,1,1371,1377,0
6900984412,6900984414,2,1382,1761,0
6901720746,6901720747,1,1307,2146,0
6902175702,6902175705,3,1499,1159,0
6907461767,6907461767,0,1340,915,0
6908348605,6908348604,-1,1689,1496,0
6908600917,6908600901,-16,513,3335,0
6912368480,6912368481,1,1422,1607,0
6914817577,6914817577,0,2081,1547,0
6915416707,6915416686,-21,1100,1564,0
6915467749,6915467738,-11,938,1238,0
6915507425,6915507426,1,1354,1619,0
6915757586,6915757586,0,1690,1731,0
6918410790,6918410790,0,1199,1389,0
6922853082,6922853083,1,1148,969,0
6923180482,6923180486,4,1291,1895,0
6929059017,6929059017,0,1223,1185,0
6934413862,6934413864,2,1755,1783,0
6937426989,6937426989,0,1284,1719,0
6937816427,6937816431,4,780,1109,0
6937843088,6937843092,4,1677,1444,0
6939842798,6939842798,0,2058,2839,0
6944988378,6944988377,-1,1603,1936,0
6946469742,6946469742,0,1520,1705,0
6950693017,6950693017,0,973,2314,0
6951706802,6951706802,0,1026,1350,0
6955482113,6955482115,2,1747,1743,0
6957410338,6957410337,-1,1321,1406,0
6961982859,6961982861,2,1622,1657,0
6965470699,6965470699,0,1362,1388,0
6965524321,6965524323,2,1361,1756,0
6966339511,6966339509,-2,1285,2223,0
6966401819,6966401821,2,934,1087,0
6969918778,6969918778,0,1443,1218,0
6971389073,6971389075,2,1962,2350,0
6971721662,6971721662,0,1238,1910,0
6972256842,6972256843,1,1562,1332,0
6976668562,6976668563,1,1079,1374,0
6980307918,6980307917,-1,1852,1694,0
6987607613,6987607614,1,1193,1707,0
6992394109,6992394109,0,1091,1628,0
6994738366,6994738367,1,2150,1797,0
6994927466,6994927465,-1,1368,2311,0
6996337309,6996337295,-14,572,2395,0
6996934990,6996934990,0,1058,1446,0
6997202422,6997202422,0,1622,1507,0
7000758158,7000758160,2,1490,1733,0
7001250023,7001250024,1,716,1179,0
7003263021,7003263021,0,1860,2126,0
7004723172,7004723166,-6,1244,1784,0
7004800570,7004800572,2,1125,1881,0
7005812051,7005812053,2,1118,2254,0
7006945586,7006945587,1,1277,1358,0
7007113278,7007113277,-1,2004,2504,0
7008228967,7008228969,2,1837,1475,0
7011899154,7011899154,0,1125,1880,0
7017498765,7017498758,-7,970,3349,0
7019414251,7019414251,0,1098,1432,0
7024264117,7024264117,0,1382,1694,0
7027090075,7027090074,-1,1080,1710,0
7028572981,7028572979,-2,1692,2053,0
7033301923,7033301924,1,2020,2439,0
7037089741,7037089746,5,1148,993,0
7042156153,7042156149,-4,1265,3329,0
7043360417,7043360418,1,1654,2423,0
7043749679,7043749677,-2,948,2491,0
7048651242,7048651243,1,1285,1934,0
7050725034,7050725014,-20,879,677,0
7051374835,7051374834,-1,947,1908,0
7054200273,7054200274,1,968,1169,0
7056772679,7056772679,0,1277,1811,0
7058036538,7058036541,3,1925,1079,0
7067517498,7067517498,0,1304,1465,0
7070855882,7070855882,0,1358,2065,0
7071681646,7071681647,1,1235,1346,0
7075013023,7075013026,3,1801,1343,0
7075189480,7075189480,0,1376,1907,0
7082083676,7082083676,0,1438,1766,0
7083230233,7083230231,-2,1557,1841,0
7085524999,7085524996,-3,924,2175,0
7085787679,7085787676,-3,1260,2071,0
7088080452,7088080453,1,1308,2209,0
7089692670,7089692671,1,774,1126,0
7091598994,7091598994,0,1753,1702,0
7092551734,7092551739,5,1711,1154,0
7094804597,7094804596,-1,976,1332,0
7096655642,7096655643,1,1665,1491,0
7097124090,7097124089,-1,1301,1438,0
7098695782,7098695782,0,1234,1373,0
7100479159,7100479157,-2,1140,1670,0
7100982242,7100982243,1,1059,1567,0
7102330963,7102330965,2,952,1536,0
7103266743,7103266743,0,1541,1692,0
7103423966,7103423963,-3,820,1818,0
7105255078,7105255078,0,2074,2397,0
7106311571,7106311573,2,1308,1385,0
7106402130,7106402129,-1,1172,2217,0
7107298130,7107298132,2,1111,1804,0
7109410672,7109410674,2,1693,1331,0
7111835241,7111835242,1,1735,1952,0
7119656715,7119656717,2,1334,1547,0
7121285918,7121285917,-1,1227,1518,0
7121928629,7121928628,-1,1262,1491,0
7127277596,7127277597,1,1412,1424,0
7128083747,7128083747,0,1119,1389,0
7128708020,7128708019,-1,1100,2064,0
7129488546,7129488550,4,1493,1320,0
7130934751,7130934752,1,1558,1993,0
7132816596,7132816597,1,2424,3256,0
7133984535,7133984534,-1,851,1829,0
7136060721,7136060721,0,1101,1110,0
7137186506,7137186507,1,1611,1489,0
7141143065,7141143066,1,1348,1361,0
7144760524,7144760523,-1,819,1205,0
7147299407,7147299411,4,1803,1215,0
7148502533,7148502535,2,1498,1372,0
7150877315,7150877318,3,1210,1449,0
7153511423,7153511426,3,1405,1498,0
7156241570,7156241570,0,2559,4296,0
7157466270,7157466273,3,1062,1088,0
7161941681,7161941682,1,1437,1627,0
7162930666,7162930667,1,1766,1421,0
7163010299,7163010300,1,1420,1554,0
7163850654,7163850654,0,1581,1417,0
7165778057,7165778062,5,1424,1446,0
7166196179,7166196178,-1,1109,1697,0
7167909591,7167909591,0,825,1202,0
7169602034,7169602036,2,1990,1594,0
7171764285,7171764286,1,1387,1914,0
7173559006,7173559007,1,1762,1615,0
7177584758,7177584758,0,1894,1894,0
7182571834,7182571835,1,894,1317,0
7188855508,7188855527,19,1689,1496,0
7190241392,7190241393,1,1339,1487,0
7198409254,7198409256,2,1260,1470,0
7199007098,7199007098,0,1197,1217,0
7203764391,7203764393,2,1190,1681,0
7205002898,7205002903,5,1371,1247,0
7207770113,7207770113,0,1390,2031,0
7209399390,7209399390,0,1016,1632,0
7210367170,7210367170,0,1468,1519,0
7212981401,7212981397,-4,1641,4352,0
7215759146,7215759146,0,986,1128,0
7217583426,7217583427,1,753,1093,0
7220318233,7220318233,0,1215,1542,0
7221185265,7221185273,8,3044,1442,0
7224613971,7224613970,-1,1437,2085,0
7227514442,7227514444,2,686,736,0
7228483542,7228483520,-22,2078,1125,0
7231174076,7231174077,1,1390,1681,0
7232235683,7232235683,0,1579,1855,0
7233176877,7233176877,0,1700,2553,0
7235616170,7235616168,-2,1384,2288,0
7236662324,7236662322,-2,1409,2336,0
7238127312,7238127314,2,1031,1656,0
7239658131,7239658133,2,1722,1667,0
7253209034,7253209034,0,799,872,0
7253835554,7253835554,0,1338,2044,0
7254649391,7254649390,-1,1014,1278,0
7256692439,7256692443,4,1080,1672,0
7257746797,7257746798,1,1622,1771,0
7257807797,7257807797,0,1678,2103,0
7259309534,7259309536,2,1649,1311,0
7260594757,7260594778,21,730,1230,0
7268204377,7268204379,2,1509,2001,0
7269643557,7269643558,1,1181,1497,0
7276126561,7276126559,-2,1302,1616,0
7278342719,7278342718,-1,1282,2514,0
7280191453,7280191455,2,1165,1009,0
7280437289,7280437290,1,1625,1541,0
7283117380,7283117378,-2,1246,2530,0
7286630294,7286630294,0,2170,2160,0
7286671466,7286671470,4,2745,2075,0
7290895762,7290895762,0,1303,1507,0
7293523302,7293523302,0,1216,1661,0
7295465146,7295465148,2,1219,1451,0
7295791720,7295791719,-1,1217,1201,0
7300126058,7300126059,1,1854,2315,0
7300466082,7300466083,1,782,1105,0
7302679581,7302679585,4,1627,1397,0
7305654521,7305654518,-3,1556,1654,0
7305930843,7305930843,0,1311,1562,0
7310910910,7310910911,1,1239,1153,0
7312183293,7312183295,2,992,876,0
7313453484,7313453485,1,1187,1821,0
7314779803,7314779802,-1,1016,1570,0
7315165003,7315165003,0,1288,1785,0
7315753010,7315753013,3,1517,1915,0
7316266318,7316266319,1,1759,1454,0
7317585839,7317585838,-1,1337,2139,0
7320218674,7320218675,1,1534,2033,0
7321763045,7321763045,0,1662,1758,0
7322315873,7322315872,-1,1247,1708,0
7324601361,7324601363,2,1529,1591,0
7326415809,7326415810,1,1808,1670,0
7329029217,7329029218,1,1606,1426,0
7330130101,7330130100,-1,1739,2275,0
7331784940,7331784943,3,1504,1499,0
7331942665,7331942666,1,1368,1828,0
7336060386,7336060387,1,1514,1765,0
7336274851,7336274853,2,947,1413,0
7336786134,7336786136,2,1726,1461,0
7339604239,7339604239,0,933,1325,0
7342196749,7342196747,-2,1030,1916,0
7342391090,7342391090,0,1518,1671,0
7342484821,7342484819,-2,1614,1974,0
7343283776,7343283778,2,1325,1911,0
7344541233,7344541240,7,4126,1950,0
7347615050,7347615051,1,1346,1864,0
7347972445,7347972446,1,966,1350,0
7348174510,7348174511,1,972,1182,0
7349892122,7349892122,0,1327,1415,0
7350501025,7350501026,1,1482,1377,0
7351619997,7351620019,22,1245,1986,0
7354584832,7354584831,-1,1564,2206,0
7356866286,7356866294,8,5133,1789,0
7357798877,7357798883,6,6005,2267,0
7359751535,7359751536,1,1335,1708,0
7360117783,7360117785,2,1740,2297,0
7363527611,7363527610,-1,1679,3163,0
7370077810,7370077803,-7,1874,7888,0
7370280151,7370280152,1,1012,1967,0
7372662738,7372662735,-3,1153,2110,0
7375413170,7375413167,-3,1335,2256,0
7377098852,7377098852,0,1475,1865,0
7382151136,7382151134,-2,1360,1552,0
7384181955,7384181954,-1,1677,2254,0
7385769256,7385769257,1,1413,1782,0
7387565903,7387565903,0,994,1500,0
7387789844,7387789830,-14,1018,4854,0
7393023386,7393023389,3,1404,1437,0
7394885633,7394885637,4,2044,2052,0
7395350062,7395350063,1,1252,1899,0
7396377055,7396377055,0,1322,2116,0
7396637530,7396637530,0,1221,1742,0
7396964875,7396964873,-2,1000,1004,0
7400730441,7400730439,-2,762,632,0
7403540006,7403540003,-3,1047,1716,0
7405722282,7405722278,-4,749,1895,0
7405985849,7405985851,2,581,1143,0
7406807747,7406807746,-1,1296,1623,0
7408014159,7408014157,-2,843,1441,0
7408994671,7408994670,-1,1468,1567,0
7410650030,7410650029,-1,1134,1467,0
7412111282,7412111283,1,1492,2089,0
7415656570,7415656573,3,1574,1568,0
7418493100,7418493101,1,1049,1662,0
7421798268,7421798266,-2,1153,1988,0
7422738330,7422738331,1,1712,1340,0
7424773030,7424773031,1,1464,1489,0
7425921057,7425921057,0,1221,1250,0
7426540234,7426540234,0,1481,1739,0
7428694065,7428694065,0,1445,1908,0
7429449967,7429449966,-1,1060,2269,0
7433575726,7433575725,-1,1362,1810,0
7437215108,7437215131,23,674,1429,0
7438374594,7438374594,0,1690,1661,0
7442205750,7442205751,1,1574,1275,0
7444190243,7444190243,0,1167,1940,0
7444627690,7444627690,0,1203,1704,0
7445226958,7445226962,4,1740,1772,0
7446149517,7446149518,1,1290,1259,0
7450061921,7450061917,-4,21454,68091,0
7451525652,7451525647,-5,849,1414,0
7451819138,7451819138,0,1156,1340,0
7453890261,7453890263,2,1448,1599,0
7457103114,7457103115,1,1198,1324,0
7458696378,7458696378,0,1706,1502,0
7467199284,7467199285,1,1334,1575,0
7470681918,7470681917,-1,1403,1834,0
7473356218,7473356218,0,1214,1828,0
7474802972,7474802972,0,1809,2028,0
7475006831,7475006833,2,853,1791,0
7479871774,7479871774,0,1360,1157,0
7480556518,7480556518,0,1352,1899,0
7480669730,7480669732,2,1049,1001,0
7483536964,7483536963,-1,506,1219,0
7484311708,7484311711,3,2004,1261,0
7485192342,7485192343,1,1424,1801,0
7486740599,7486740602,3,1585,1075,0
7486850883,7486850885,2,2336,2373,0
7487384077,7487384078,1,1511,1702,0
7491978370,7491978371,1,1368,1903,0
7492442023,7492442024,1,2433,2194,0
7492970790,7492970794,4,1226,1532,0
7499992662,7499992662,0,1495,1438,0
7501034011,7501034014,3,1717,1685,0
7501363342,7501363341,-1,990,1402,0
7503094373,7503094374,1,1423,1592,0
7505445673,7505445667,-6,966,3155,0
7508524432,7508524435,3,1702,1866,0
7511530001,7511530003,2,2005,1265,0
7513808669,7513808669,0,1699,1314,0
7515438811,7515438790,-21,783,1088,0
7519164325,7519164326,1,1251,1448,0
7523762937,7523762934,-3,961,1753,0
7527180345,7527180347,2,1224,2026,0
7527312715,7527312714,-1,2522,3556,0
7531040232,7531040231,-1,1245,1816,0
7532903967,7532903970,3,1545,1878,0
7533229616,7533229615,-1,1817,1768,0
7534097373,7534097373,0,11888,15912,0
7534726666,7534726668,2,928,854,0
7535078635,7535078635,0,1117,1704,0
7539033846,7539033847,1,1818,1763,0
7543923460,7543923460,0,1636,2015,0
7548615736,7548615740,4,1718,1768,0
7552569255,7552569257,2,1188,2384,0
7553300076,7553300077,1,1268,1867,0
7557693686,7557693686,0,1159,1540,0
7560383870,7560383871,1,1368,2185,0
7563093849,7563093848,-1,1347,1400,0
7564432733,7564432734,1,1927,1931,0
7568228259,7568228259,0,2119,1670,0
7569059758,7569059761,3,908,1265,0
7571360454,7571360453,-1,1768,1573,0
7573993000,7573993000,0,1468,1794,0
7575877533,7575877534,1,976,946,0
7576583162,7576583162,0,1894,1659,0
7580418287,7580418287,0,1453,1862,0
7580839198,7580839199,1,1254,1515,0
7585269260,7585269258,-2,1401,2069,0
7586162919,7586162920,1,1259,1947,0
7587312811,7587312811,0,993,1534,0
7588213586,7588213586,0,1805,1632,0
7589538045,7589538046,1,1279,1403,0
7589823033,7589823035,2,1641,1401,0
7596280327,7596280330,3,1365,751,0
7596772258,7596772259,1,1252,1974,0
7598319762,7598319762,0,1483,2104,0
7598556967,7598556961,-6,771,2050,0
7598879689,7598879690,1,923,1223,0
7599201710,7599201710,0,1532,1602,0
7604312624,7604312626,2,1096,1095,0
7604827149,7604827149,0,1715,1888,0
7607898278,7607898276,-2,1219,2276,0
7608527540,7608527537,-3,1292,3319,0
7609792286,7609792287,1,946,866,0
7614153922,7614153922,0,1022,1926,0
7614624199,7614624217,18,1192,1442,0
7621435484,7621435485,1,1546,2048,0
7624159845,7624159849,4,967,1904,0
7626070069,7626070070,1,1520,1634,0
7626221197,7626221178,-19,1336,1720,0
7629102895,7629102895,0,1129,2172,0
7629741173,7629741174,1,1735,1516,0
7630609222,7630609223,1,1135,1312,0
7631107198,7631107198,0,1360,1417,0
7633336182,7633336182,0,1957,2023,0
7635682625,7635682622,-3,1395,1518,0
7637026248,7637026254,6,1510,1405,0
7637580509,7637580507,-2,2155,2288,0
7643911810,7643911810,0,1498,1680,0
7644493838,7644493839,1,1224,2150,0
7648954594,7648954615,21,1355,2027,0
7651173676,7651173678,2,2183,2225,0
7652039206,7652039207,1,1676,2309,0
7654161958,7654161959,1,1546,1890,0
7654746161,7654746165,4,2556,1843,0
7655069607,7655069607,0,1113,879,0
7662360959,7662360961,2,1111,1894,0
7665643056,7665643056,0,1363,1688,0
7666590718,7666590717,-1,1718,2261,0
7672095709,7672095710,1,814,1006,0
7674562253,7674562255,2,1545,1416,0
7677234340,7677234341,1,1388,2193,0
7677783627,7677783627,0,1255,1467,0
7679032851,7679032849,-2,1721,2503,0
7680996799,7680996800,1,1478,1624,0
7683376026,7683376026,0,1883,2520,0
7686110232,7686110233,1,1554,2006,0
7687734090,7687734093,3,681,816,0
7689797829,7689797830,1,979,1670,0
7690182617,7690182614,-3,1576,2417,0
7693686938,7693686938,0,1951,2702,0
7696011951,7696011950,-1,1942,1782,0
7698476262,7698476261,-1,754,1885,0
7698532938,7698532938,0,1328,1544,0
7700546763,7700546764,1,827,1096,0
7701568902,7701568904,2,1782,1698,0
7702149252,7702149253,1,1352,1562,0
7702911046,7702911047,1,1435,1293,0
7704723576,7704723581,5,2497,936,0
7706473985,7706473987,2,971,1666,0
7707736211,7707736212,1,1035,1566,0
7709671276,7709671277,1,1878,1900,0
7719801818,7719801818,0,938,1394,0
7720183887,7720183888,1,1248,1751,0
7720910578,7720910574,-4,1451,1476,0
7721183958,7721183958,0,1494,1977,0
7726160999,7726161000,1,1330,1470,0
7726922685,7726922707,22,1395,2028,0
7727975150,7727975150,0,1434,1822,0
7728819887,7728819890,3,1453,2174,0
7731388285,7731388288,3,1867,1838,0
7731774862,7731774863,1,1070,1324,0
7735183145,7735183145,0,985,1969,0
7737512027,7737512028,1,1661,1759,0
7741036147,7741036146,-1,1935,2142,0
7756133033,7756133036,3,37598,21612,0
7758618810,7758618811,1,1369,1668,0
7761151741,7761151742,1,1420,1886,0
7761462854,7761462854,0,1334,1577,0
7765576147,7765576148,1,1298,1994,0
7766702677,7766702678,1,707,1050,0
7770110529,7770110530,1,1620,2047,0
7772227758,7772227764,6,724,864,0
7774033011,7774033013,2,1623,1384,0
7782484767,7782484765,-2,1317,2126,0
7782902174,7782902174,0,1759,2145,0
7784317990,7784317991,1,1381,1840,0
7786863797,7786863798,1,1407,1864,0
7787518839,7787518837,-2,1742,1676,0
7787780673,7787780674,1,1132,1703,0
7789209558,7789209547,-11,1143,1285,0
7791780042,7791780041,-1,1638,1947,0
7792503447,7792503447,0,756,1081,0
7794107634,7794107639,5,3884,23242,0
7794743988,7794743982,-6,1270,3069,0
7795355543,7795355542,-1,944,1397,0
7796430166,7796430155,-11,3547,13382,0
7800533310,7800533310,0,1677,1961,0
7802542250,7802542254,4,1739,1542,0
7804226362,7804226363,1,1359,1815,0
7806511730,7806511731,1,1603,1519,0
7811505775,7811505772,-3,2007,5076,0
7812306198,7812306199,1,1423,1922,0
7812336992,7812336992,0,1449,1549,0
7812550905,7812550910,5,1655,1177,0
7815889922,7815889921,-1,1186,1972,0
7816080203,7816080203,0,1425,1723,0
7816286867,7816286866,-1,1140,1386,0
7820046227,7820046229,2,1318,1647,0
7820422502,7820422506,4,1665,1503,0
7821438941,7821438941,0,1181,1333,0
7824572270,7824572274,4,1354,2337,0
7826063426,7826063426,0,1426,874,0
7826670046,7826670045,-1,998,1437,0
7829376962,7829376966,4,1224,1187,0
7831394290,7831394290,0,1395,1934,0
7831847279,7831847278,-1,1101,1107,0
7831873046,7831873047,1,891,1126,0
7832931517,7832931539,22,1372,1050,0
7833886261,7833886261,0,1331,1628,0
7834566014,7834566013,-1,862,1248,0
7835524885,7835524887,2,1708,1640,0
7835997386,7835997386,0,1705,2221,0
7836359467,7836359468,1,2105,2194,0
7837473194,7837473194,0,1748,2088,0
7837631363,7837631370,7,2128,1358,0
7838493587,7838493586,-1,1328,1782,0
7838610000,7838610002,2,1656,1256,0
7841007334,7841007333,-1,1926,1581,0
7846209740,7846209742,2,1107,1616,0
7847818935,7847818938,3,977,1842,0
7849143778,7849143778,0,1130,2185,0
7850338195,7850338193,-2,1684,1821,0
7850432339,7850432339,0,1277,1774,0
7851975985,7851975984,-1,1293,1470,0
7854708050,7854708053,3,1288,1336,0
7856178458,7856178458,0,1672,2051,0
7859220164,7859220162,-2,894,2217,0
7860545773,7860545772,-1,1775,2525,0
7860644725,7860644704,-21,1069,1407,0
7861982387,7861982389,2,1789,1652,0
7864326302,7864326300,-2,1282,1957,0
7864699034,7864699035,1,1045,1710,0
7864793011,7864793013,2,1884,2212,0
7869265672,7869265673,1,1667,1981,0
7869948890,7869948891,1,1582,1336,0
7873501218,7873501225,7,1694,714,0
7876923774,7876923774,0,1486,1112,0
7876975829,7876975849,20,663,1401,0
7877330508,7877330502,-6,980,933,0
7877951997,7877951997,0,1214,2307,0
7880828317,7880828315,-2,1156,1715,0
7881755755,7881755756,1,1767,1056,0
7882101646,7882101646,0,998,1460,0
7882543821,7882543821,0,1574,1744,0
7882960031,7882960030,-1,1252,1558,0
7885983569,7885983571,2,1709,1793,0
7888604905,7888604907,2,1513,2219,0
7888888962,7888888962,0,942,1513,0
7890733975,7890733977,2,1917,1881,0
7891481118,7891481124,6,2252,1141,0
7896272333,7896272330,-3,1025,2266,0
7899884464,7899884469,5,1883,1258,0
7902526395,7902526398,3,1583,1503,0
7903710131,7903710132,1,1452,1219,0
7904844802,7904844800,-2,1598,1689,0
7906391078,7906391095,17,1510,1311,0
7907270854,7907270855,1,1497,1882,0
7912171310,7912171306,-4,914,2619,0
7916484436,7916484436,0,1404,1571,0
7917219418,7917219417,-1,1294,2672,0
7918758045,7918758045,0,1111,1451,0
7919418527,7919418531,4,1129,995,0
7919586758,7919586758,0,1276,2002,0
7920376218,7920376219,1,1191,1432,0
7923934487,7923934490,3,1155,1236,0
7925093413,7925093414,1,1172,1391,0
7925856523,7925856523,0,964,1561,0
7930368686,7930368686,0,1398,1790,0
7931221232,7931221230,-2,1765,1356,0
7932805629,7932805629,0,1193,1600,0
7934038041,7934038042,1,1113,1129,0
7934725948,7934725949,1,1621,2033,0
7937907857,7937907859,2,1334,1339,0
7939228478,7939228478,0,952,952,0
7939417826,7939417825,-1,910,1655,0
7940149144,7940149145,1,1979,2009,0
7940796777,7940796778,1,1503,1763,0
7942241381,7942241382,1,2307,2353,0
7944418377,7944418378,1,1586,1664,0
7946338189,7946338189,0,1542,1517,0
7949639153,7949639154,1,2262,2692,0
7952507700,7952507703,3,892,1312,0
7954345344,7954345346,2,1075,1597,0
7955536890,7955536890,0,1336,1474,0
7959618942,7959618943,1,1528,1717,0
7967541467,7967541466,-1,1306,1689,0
7967748631,7967748632,1,1504,1500,0
7971138687,7971138687,0,1907,2655,0
7971532043,7971532044,1,1488,1777,0
7973067757,7973067757,0,1950,1998,0
7974263999,7974263999,0,1389,1617,0
7974726938,7974726938,0,988,2415,0
7976578189,7976578188,-1,981,1752,0
7978428986,7978428988,2,736,1427,0
7980800534,7980800534,0,1847,1736,0
7980872107,7980872107,0,1416,1815,0
7987665885,7987665888,3,2291,1752,0
7991675795,7991675794,-1,1591,1302,0
7994146361,7994146347,-14,1195,1553,0
7995382699,7995382693,-6,1980,8814,0
8000835517,8000835518,1,854,992,0
8002022947,8002022950,3,1557,1750,0
8005432191,8005432191,0,1394,1592,0
8006564966,8006564966,0,1531,1738,0
8009754506,8009754506,0,1074,1241,0
8010121216,8010121209,-7,874,3998,0
8013497648,8013497649,1,1409,1103,0
8017590301,8017590306,5,2933,1371,0
8017855721,8017855724,3,1336,1672,0
8023450794,8023450788,-6,1131,5559,0
8024957324,8024957322,-2,1583,1439,0
8026013142,8026013145,3,1299,1546,0
8027183442,8027183442,0,1142,1656,0
8028848452,8028848454,2,1912,2011,0
8034276829,8034276829,0,1307,1956,0
8034554244,8034554242,-2,1357,1621,0
8035242964,8035242964,0,1787,1942,0
8035979951,8035979951,0,1098,1257,0
8036354732,8036354733,1,1828,1572,0
8036540093,8036540093,0,1123,1976,0
8036915727,8036915726,-1,1056,1576,0
8039156998,8039156998,0,1899,2525,0
8040198991,8040198992,1,1178,1509,0
8040437673,8040437670,-3,1077,1284,0
8044668170,8044668170,0,1452,1457,0
8045671545,8045671551,6,2558,1187,0
8046119717,8046119719,2,966,1205,0
8046263699,8046263698,-1,1509,1273,0
8046497769,8046497769,0,2279,2314,0
8047746111,8047746112,1,2027,1945,0
8051739186,8051739187,1,1444,2077,0
8054256530,8054256528,-2,926,1771,0
8055391325,8055391323,-2,1197,1665,0
8055509881,8055509881,0,1304,1955,0
8060595038,8060595038,0,1040,1644,0
8061680711,8061680710,-1,1058,1334,0
8066501125,8066501126,1,1262,1911,0
8068256545,8068256543,-2,1064,1516,0
8069442663,8069442661,-2,1206,2119,0
8070063157,8070063158,1,1551,1727,0
8071801574,8071801577,3,1470,1556,0
8073548706,8073548706,0,1341,2287,0
8077660467,8077660468,1,1406,1968,0
8078173231,8078173250,19,2319,3116,0
8079603653,8079603659,6,1674,1287,0
8082269911,8082269914,3,1264,1813,0
8083061377,8083061375,-2,1465,1651,0
8085266775,8085266774,-1,1139,2500,0
8088754902,8088754901,-1,1678,3207,0
8089575138,8089575140,2,2285,1814,0
8089727815,8089727814,-1,1311,1325,0
8091819068,8091819064,-4,1475,1632,0
8093929943,8093929944,1,1792,1999,0
8100410534,8100410535,1,1143,1367,0
8109178512,8109178511,-1,1553,2134,0
8110839847,8110839847,0,1703,2281,0
8114092041,8114092042,1,1583,1708,0
8116161947,8116161946,-1,1156,1349,0
8116358467,8116358476,9,1042,1478,0
8118708102,8118708104,2,1639,1632,0
8125917908,8125917908,0,1058,1502,0
8127624144,8127624138,-6,1672,7082,0
8129479737,8129479737,0,1411,1854,0
8130608399,8130608397,-2,1404,1701,0
8132690226,8132690225,-1,1505,1595,0
8135865002,8135865003,1,1048,2174,0
8137467402,8137467400,-2,1192,1456,0
8139142743,8139142745,2,1605,2068,0
8139786833,8139786831,-2,939,1220,0
8140788056,8140788056,0,2001,2090,0
8140960589,8140960587,-2,1214,1594,0
8141869199,8141869195,-4,1073,1329,0
8143838318,8143838317,-1,1689,1613,0
8149065362,8149065361,-1,1188,2116,0
8151960522,8151960523,1,760,1992,0
8155385037,8155385035,-2,1367,1538,0
8156859203,8156859202,-1,1249,1352,0
8157086069,8157086071,2,2319,1527,0
8159397216,8159397210,-6,1698,5599,0
8165030734,8165030736,2,1327,1351,0
8166573086,8166573086,0,1663,1772,0
8169472898,8169472897,-1,1493,1811,0
8169724224,8169724225,1,2072,2148,0
8170406783,8170406782,-1,1031,970,0
8170945470,8170945470,0,1483,1986,0
8171603702,8171603701,-1,1207,1548,0
8171699487,8171699506,19,1715,1529,0
8172106639,8172106640,1,1460,1538,0
8172517054,8172517055,1,1618,1592,0
8173421182,8173421183,1,1041,1879,0
8174240814,8174240815,1,1014,1384,0
8180048345,8180048345,0,1857,2596,0
8182527720,8182527718,-2,1624,2723,0
8183265322,8183265324,2,1102,1882,0
8183579270,8183579270,0,1211,1470,0
8186221014,8186221018,4,3010,1601,0
8188558429,8188558436,7,2955,1166,0
8188777581,8188777582,1,1246,1928,0
8189950106,8189950106,0,1354,1668,0
8196720554,8196720554,0,1425,2089,0
8198289077,8198289078,1,1357,2061,0
8202510845,8202510846,1,1392,2000,0
8202672470,8202672470,0,702,1151,0
8208507703,8208507703,0,1016,1399,0
8209178211,8209178211,0,1218,978,0
8209614610,8209614604,-6,32297,10318,0
8210034962,8210034961,-1,1078,2045,0
8210797995,8210797994,-1,1214,1879,0
8212064170,8212064171,1,1531,1810,0
8212967759,8212967761,2,603,1498,0
8213292886,8213292889,3,2367,1813,0
8216671126,8216671125,-1,1529,1837,0
8219002809,8219002809,0,1008,1388,0
8219450581,8219450580,-1,1787,1326,0
8221075590,8221075589,-1,1299,1725,0
8223857040,8223857040,0,1469,2012,0
8224783306,8224783307,1,1657,2746,0
8227227870,8227227870,0,1866,1759,0
8228950503,8228950503,0,1404,2044,0
8229838152,8229838152,0,1312,2054,0
8231729266,8231729267,1,17571,12770,0
8233417874,8233417875,1,1453,1575,0
8236559938,8236559939,1,912,1335,0
8236804249,8236804250,1,1127,1343,0
8237984888,8237984890,2,1698,2120,0
8238668010,8238668012,2,1827,2007,0
8241311594,8241311594,0,1056,2079,0
8241811741,8241811742,1,981,1521,0
8245093923,8245093922,-1,1499,1560,0
8247639774,8247639774,0,1256,1080,0
8248792090,8248792090,0,815,1147,0
8249739745,8249739745,0,2014,2184,0
8249855887,8249855890,3,1687,2029,0
8255928626,8255928625,-1,1635,1612,0
8256404254,8256404253,-1,1389,3199,0
8258438985,8258438984,-1,1708,1685,0
8260648817,8260648817,0,1607,1717,0
8261654438,8261654438,0,1027,1422,0
8263874765,8263874765,0,1142,1543,0
8266806511,8266806510,-1,1221,924,0
8268146150,8268146147,-3,1551,2696,0
8268856369,8268856369,0,1741,1620,0
8271508559,8271508559,0,1524,2177,0
8273287161,8273287161,0,1112,1686,0
8275101927,8275101927,0,1328,1559,0
8276660842,8276660843,1,1688,2086,0
8279620334,8279620334,0,1538,1517,0
8281754583,8281754582,-1,1443,1346,0
8282229335,8282229335,0,1433,1655,0
8283422239,8283422237,-2,1451,1494,0
8283720418,8283720418,0,1320,1519,0
8284242715,8284242717,2,1146,1111,0
8285668307,8285668306,-1,1154,1600,0
8287847507,8287847506,-1,1387,1662,0
8290553971,8290553970,-1,1033,1128,0
8292950353,8292950352,-1,1408,1777,0
8293820396,8293820394,-2,1091,1373,0
8294902067,8294902066,-1,1294,1911,0
8295117083,8295117082,-1,1571,2170,0
8296213140,8296213140,0,1438,1510,0
8296522787,8296522787,0,939,1181,0
8297654081,8297654080,-1,1094,1594,0
8299375334,8299375333,-1,1398,1941,0
8302198302,8302198303,1,1313,1675,0
8304345244,8304345246,2,2337,1910,0
8305627003,8305627002,-1,1191,2351,0
8307736919,8307736921,2,1794,1259,0
8308001678,8308001681,3,1401,1878,0
8310967473,8310967474,1,1045,1876,0
8312765450,8312765450,0,1899,2586,0
8314471370,8314471371,1,1316,1526,0
8317004035,8317004034,-1,991,1567,0
8317611112,8317611111,-1,1371,1592,0
8317689265,8317689267,2,1336,1363,0
8317835926,8317835931,5,2092,2293,0
8319153836,8319153835,-1,1310,1836,0
8319400382,8319400386,4,2838,1481,0
8319911007,8319911005,-2,1672,1825,0
8320767003,8320767022,19,911,1242,0
8321985038,8321985038,0,1438,2238,0
8322781809,8322781810,1,1091,743,0
8325060150,8325060163,13,1195,1223,0
8325530181,8325530174,-7,1053,4576,0
8326353867,8326353869,2,2197,2167,0
8326716113,8326716113,0,2042,2404,0
8328465630,8328465630,0,998,1350,0
8329855713,8329855713,0,1115,1675,0
8330594386,8330594387,1,1662,1785,0
8330636770,8330636772,2,1690,1748,0
8332391599,8332391601,2,1555,1974,0
8333584970,8333584974,4,1989,1497,0
8338040119,8338040119,0,1558,1668,0
8344174021,8344174021,0,2116,2175,0
8348226933,8348226934,1,1671,1840,0
8350914691,8350914692,1,1325,1755,0
8352213430,8352213430,0,1839,1430,0
8358360853,8358360854,1,1295,1390,0
8361637038,8361637038,0,2051,2067,0
8366764573,8366764574,1,1023,1903,0
8371435546,8371435546,0,1382,1119,0
8375997393,8375997394,1,1402,1684,0
8378350388,8378350389,1,1303,1331,0
8380172338,8380172338,0,1414,1850,0
8381207243,8381207243,0,1324,1680,0
8382273061,8382273061,0,1760,2442,0
8383390436,8383390435,-1,1383,1468,0
8383895039,8383895039,0,1339,1599,0
8384166822,8384166822,0,1063,1184,0
8388191790,8388191789,-1,2548,3692,0
8393811113,8393811115,2,1273,1594,0
8394889134,8394889149,15,1368,1579,0
8396154873,8396154895,22,1350,1956,0
8398080326,8398080326,0,1217,1357,0
8399208723,8399208722,-1,974,1477,0
8399801449,8399801450,1,2034,1529,0
8404096439,8404096445,6,9655,19386,0
8405954606,8405954607,1,1657,2065,0
8406737164,8406737165,1,1864,2436,0
8408678362,8408678359,-3,1373,2014,0
8409821315,8409821318,3,1565,1178,0
8410010961,8410010962,1,1106,1775,0
8414174238,8414174240,2,1440,1413,0
8414570862,8414570864,2,1465,1959,0
8418554861,8418554862,1,924,1630,0
8427168211,8427168210,-1,1569,1679,0
8431292543,8431292542,-1,1329,1549,0
8431376902,8431376885,-17,1057,1326,0
8432427555,8432427554,-1,2735,3659,0
8435870837,8435870837,0,1294,1862,0
8436218246,8436218246,0,886,921,0
8437048789,8437048769,-20,1298,2510,0
8438552111,8438552113,2,1410,1713,0
8439538640,8439538638,-2,1132,1847,0
8440954253,8440954252,-1,656,2078,0
8442154871,8442154873,2,1689,2238,0
8443424050,8443424051,1,1306,1744,0
8445333307,8445333306,-1,1689,1587,0
8447345265,8447345266,1,1552,1648,0
8447580685,8447580686,1,1441,1879,0
8448360819,8448360821,2,1527,1745,0
8449039299,8449039278,-21,839,1372,0
8450260598,8450260600,2,1714,1389,0
8454114194,8454114195,1,1340,1823,0
8455760303,8455760302,-1,988,1701,0
8457287627,8457287628,1,931,2063,0
8460877874,8460877874,0,1657,1485,0
8463303449,8463303450,1,1583,2350,0
8467081167,8467081169,2,1200,1482,0
8467254092,8467254090,-2,1299,1064,0
8467781745,8467781746,1,1257,2399,0
8475850227,8475850230,3,1054,1487,0
8476256794,8476256795,1,1183,1369,0
8477042999,8477042998,-1,1011,1073,0
8478084446,8478084448,2,1287,1732,0
8478805791,8478805793,2,2051,2435,0
8479888633,8479888633,0,1368,2116,0
8481862880,8481862881,1,2672,2454,0
8486787306,8486787308,2,1515,1812,0
8487939801,8487939801,0,1115,1382,0
8489120419,8489120418,-1,1230,1773,0
8489470655,8489470655,0,1049,1761,0
8490366865,8490366866,1,1381,1674,0
8493885849,8493885849,0,1453,1805,0
8494687989,8494687989,0,1577,1613,0
8495123170,8495123187,17,271,397,0
8496689482,8496689482,0,1394,1835,0
8499909115,8499909117,2,1362,2141,0
8500693224,8500693223,-1,1351,1334,0
8506140280,8506140278,-2,1139,1233,0
8506772850,8506772854,4,2259,1587,0
8507626258,8507626259,1,1246,1665,0
8507767958,8507767959,1,2143,2016,0
8508137378,8508137379,1,1897,1983,0
8510057735,8510057736,1,1233,2083,0
8512281006,8512281005,-1,1661,1747,0
8517586058,8517586058,0,661,1102,0
8518130557,8518130557,0,1948,2014,0
8518998539,8518998540,1,1273,1590,0
8519702042,8519702043,1,1091,1808,0
8522503922,8522503922,0,851,1144,0
8524441802,8524441801,-1,1730,2016,0
8525223893,8525223891,-2,1054,1353,0
8525827555,8525827564,9,1446,1555,0
8527241362,8527241362,0,1583,1739,0
8527294229,8527294231,2,1894,2421,0
8528760561,8528760562,1,1235,1091,0
8530765652,8530765653,1,1728,1675,0
8532425178,8532425183,5,2593,1066,0
8536073561,8536073565,4,1309,1574,0
8538700595,8538700597,2,1055,1853,0
8540692695,8540692690,-5,1058,2754,0
8546728453,8546728454,1,2424,2291,0
8550163071,8550163089,18,29591,19472,0
8557284517,8557284519,2,886,1129,0
8558599782,8558599783,1,1460,1773,0
8561192767,8561192769,2,1537,1689,0
8561227897,8561227894,-3,1505,2314,0
8564286487,8564286489,2,1613,1645,0
8565194878,8565194881,3,1546,1155,0
8571353822,8571353824,2,1644,1987,0
8573469921,8573469921,0,1731,2709,0
8575215517,8575215522,5,1701,729,0
8577208854,8577208854,0,1450,1546,0
8579781990,8579781989,-1,1165,2185,0
8579929650,8579929651,1,1146,1243,0
8580107649,8580107649,0,738,1055,0
8581168207,8581168208,1,1847,1557,0
8582481313,8582481308,-5,1664,3434,0
8586790293,8586790294,1,1293,1761,0
8588170959,8588170960,1,1870,1804,0
8590511542,8590511543,1,1950,2503,0
8596081510,8596081510,0,804,1331,0
8598738854,8598738853,-1,937,1260,0
8607548716,8607548717,1,1841,2163,0
8610931099,8610931099,0,965,1433,0
8613114226,8613114226,0,1777,1831,0
8617994823,8617994825,2,1610,1820,0
8618914865,8618914864,-1,1117,1757,0
8619819872,8619819871,-1,1033,948,0
8620397502,8620397503,1,1334,2076,0
8621946152,8621946153,1,1296,1445,0
8622938691,8622938707,16,835,1250,0
8625200309,8625200311,2,1120,1330,0
8628229588,8628229588,0,1046,1980,0
8628578143,8628578145,2,1754,2317,0
8629873118,8629873119,1,1647,1363,0
8631547593,8631547593,0,1330,2061,0
8632288487,8632288487,0,858,1534,0
8633749463,8633749466,3,1219,1290,0
8634473930,8634473930,0,818,1128,0
8636823771,8636823776,5,4742,3096,0
8638678487,8638678488,1,1254,1702,0
8638871437,8638871437,0,1304,1901,0
8641187167,8641187161,-6,592,2159,0
8643345471,8643345471,0,1449,1646,0
8644383310,8644383310,0,2480,2245,0
8648108552,8648108552,0,1132,1674,0
8649094435,8649094447,12,794,1176,0
8649580588,8649580588,0,2175,2505,0
8651391170,8651391169,-1,1169,1769,0
8653019602,8653019602,0,1444,2060,0
8654023879,8654023872,-7,1308,225,0
8654184362,8654184366,4,1247,1864,0
8656603042,8656603042,0,1449,2216,0
8656998654,8656998654,0,1230,1579,0
8658263543,8658263542,-1,1032,1287,0
8661219307,8661219306,-1,1737,1822,0
8664138988,8664138990,2,1401,1494,0
8665036283,8665036282,-1,1430,2330,0
8666934919,8666934921,2,824,1578,0
8672397258,8672397257,-1,1562,2628,0
8674986683,8674986685,2,1208,2073,0
8675225212,8675225213,1,1603,1834,0
8676315146,8676315146,0,1569,1712,0
8676681437,8676681455,18,869,1278,0
8677737806,8677737807,1,1490,1478,0
8678831189,8678831188,-1,1227,2059,0
8680948439,8680948437,-2,1137,1580,0
8681094054,8681094053,-1,1359,1608,0
8684257954,8684257954,0,1649,1248,0
8685133359,8685133360,1,1631,1856,0
8686244708,8686244727,19,1429,1301,0
8686647850,8686647853,3,1243,1662,0
8689004060,8689004063,3,1030,1432,0
8691679954,8691679954,0,1292,1790,0
8692098662,8692098662,0,1362,1440,0
8693105391,8693105390,-1,571,1184,0
8694561635,8694561637,2,1819,2082,0
8697188798,8697188798,0,1080,1566,0
8697279440,8697279438,-2,1217,1590,0
8697563870,8697563869,-1,1203,1598,0
8697600021,8697600021,0,1265,1666,0
8698027842,8698027842,0,1536,1786,0
8701659393,8701659393,0,1395,2433,0
8703199873,8703199873,0,1318,2357,0
8703806478,8703806485,7,3733,1111,0
8704031263,8704031263,0,1091,1196,0
8706699984,8706699984,0,2872,3449,0
8707307378,8707307379,1,1184,1946,0
8707719477,8707719499,22,984,1402,0
8707859370,8707859370,0,715,1848,0
8713228705,8713228704,-1,1443,1603,0
8713268921,8713268921,0,1256,1609,0
8717776070,8717776072,2,1620,1376,0
8718898797,8718898799,2,567,1103,0
8719870733,8719870733,0,5799,7406,0
8720722487,8720722486,-1,1764,1867,0
8721524332,8721524333,1,1327,1017,0
8723749014,8723749014,0,1104,1351,0
8726396949,8726396949,0,2123,1779,0
8727910451,8727910455,4,973,25208,0
8729164329,8729164332,3,985,1212,0
8731974526,8731974533,7,2949,1331,0
8732444596,8732444597,1,1526,1872,0
8733383563,8733383562,-1,784,1525,0
8733433566,8733433566,0,1614,2304,0
8734208764,8734208765,1,1608,2238,0
8737592041,8737592041,0,1531,1622,0
8747629860,8747629859,-1,1232,1649,0
8748907483,8748907483,0,597,1076,0
8749022815,8749022810,-5,1293,1872,0
8751823314,8751823305,-9,1001,5329,0
8757209124,8757209124,0,1158,1845,0
8759518102,8759518103,1,1205,1183,0
8763502475,8763502479,4,1313,1232,0
8763864413,8763864415,2,1629,1617,0
8764744965,8764744966,1,2040,1534,0
8767654674,8767654673,-1,1361,1525,0
8769615314,8769615319,5,2776,1797,0
8773149557,8773149551,-6,1217,3327,0
8774040422,8774040423,1,889,936,0
8774099343,8774099343,0,1698,1886,0
8774923511,8774923514,3,1500,2202,0
8775219819,8775219820,1,1584,1813,0
8775714848,8775714849,1,1206,1817,0
8776019655,8776019655,0,1316,1877,0
8776560249,8776560250,1,1596,1605,0
8781852068,8781852071,3,1730,1720,0
8784911253,8784911254,1,1751,2476,0
8789130660,8789130662,2,1654,2275,0
8789555159,8789555150,-9,1223,3357,0
8790203909,8790203909,0,1448,2165,0
8790732662,8790732663,1,1048,1054,0
8792061957,8792061958,1,1700,1537,0
8794779289,8794779289,0,1464,1552,0
8796481261,8796481261,0,1384,2111,0
8797320118,8797320118,0,1066,1062,0
8798188970,8798188970,0,1013,1378,0
8800262094,8800262096,2,1399,1329,0
8801101445,8801101445,0,1239,1472,0
8804566223,8804566223,0,1192,1712,0
8810527238,8810527240,2,1882,1890,0
8810877256,8810877255,-1,1165,1824,0
8812879160,8812879160,0,1889,2381,0
8813684931,8813684925,-6,1370,2427,0
8815503091,8815503101,10,1387,1249,0
8815781237,8815781238,1,1400,1627,0
8816144258,8816144259,1,1225,1580,0
8818613256,8818613253,-3,1673,3009,0
8820235090,8820235094,4,957,1077,0
8823420746,8823420747,1,1426,1875,0
8825625198,8825625199,1,1675,1971,0
8826726754,8826726754,0,911,1333,0
8828507233,8828507233,0,1568,1770,0
8830061483,8830061482,-1,1103,1744,0
8831368731,8831368730,-1,1505,1677,0
8832537314,8832537315,1,1337,1130,0
8834067736,8834067737,1,1520,1473,0
8835006904,8835006905,1,1607,1613,0
8836161358,8836161358,0,1038,2059,0
8837615458,8837615458,0,1169,1534,0
8838576570,8838576572,2,1444,2200,0
8840854291,8840854293,2,1392,1861,0
8841170881,8841170881,0,1369,1350,0
8842333973,8842333970,-3,1508,2178,0
8847264869,8847264865,-4,1380,5275,0
8848225126,8848225126,0,906,667,0
8849837749,8849837747,-2,1238,1702,0
8853548552,8853548554,2,1380,1695,0
8853946612,8853946613,1,2021,1845,0
8857175847,8857175847,0,2027,1822,0
8861688098,8861688099,1,1190,1321,0
8863377415,8863377414,-1,2185,2584,0
8865952298,8865952298,0,1053,1160,0
8866353517,8866353518,1,883,1575,0
8867543802,8867543802,0,979,1134,0
8869818882,8869818883,1,1692,1840,0
8874992398,8874992398,0,1246,1766,0
8879219827,8879219828,1,1342,1685,0
8888977141,8888977143,2,1487,1649,0
8892972652,8892972652,0,1382,2178,0
8899164234,8899164234,0,1613,1882,0
8902740293,8902740293,0,835,1597,0
8903441354,8903441354,0,610,1164,0
8906349126,8906349125,-1,887,1377,0
8906898028,8906898008,-20,689,2672,0
8908711363,8908711363,0,1687,1879,0
8911977614,8911977614,0,1114,1568,0
8913770553,8913770552,-1,1482,1694,0
8915424213,8915424214,1,1850,1919,0
8915725482,8915725483,1,1205,980,0
8920763142,8920763142,0,794,1388,0
8920921750,8920921749,-1,881,1129,0
8924695989,8924695989,0,1407,1846,0
8925174261,8925174262,1,1170,2040,0
8925225710,8925225711,1,1384,1387,0
8927266471,8927266466,-5,991,3005,0
8930213709,8930213709,0,1121,1734,0
8936990979,8936990983,4,714,18,0
8938603062,8938603064,2,879,941,0
8942819093,8942819092,-1,1442,2288,0
8946489348,8946489349,1,1224,1269,0
8947478715,8947478716,1,1411,1331,0
8948189606,8948189606,0,1116,1338,0
8948743102,8948743101,-1,1472,1940,0
8950090427,8950090429,2,1042,1993,0
8950664369,8950664369,0,1224,1970,0
8952659361,8952659362,1,2570,1689,0
8956307882,8956307881,-1,903,1531,0
8957149995,8957149997,2,1034,1428,0
8957552312,8957552311,-1,987,1980,0
8958513782,8958513784,2,877,1096,0
8961218056,8961218049,-7,66,609,0
8963709855,8963709857,2,1278,1305,0
8964903270,8964903267,-3,22417,10304,0
8965323539,8965323537,-2,1019,1875,0
8965614548,8965614547,-1,1226,1708,0
8967029638,8967029637,-1,1480,1657,0
8967414933,8967414932,-1,1493,1992,0
8969985254,8969985256,2,1737,1900,0
8971306616,8971306616,0,6123,9554,0
8971518643,8971518642,-1,1387,1962,0
8973661903,8973661904,1,1300,1578,0
8974692321,8974692322,1,1377,1626,0
8976984892,8976984890,-2,1142,1706,0
8983093631,8983093631,0,715,1229,0
8983468957,8983468960,3,1694,1329,0
8984097146,8984097148,2,2131,1855,0
8984561315,8984561317,2,2203,1627,0
8986565085,8986565085,0,1819,1921,0
8993117438,8993117439,1,1456,1958,0
8993697164,8993697163,-1,1874,1860,0
8994658414,8994658414,0,1286,1970,0
8995685376,8995685381,5,2510,1646,0
8998317091,8998317093,2,1051,1956,0
9001827043,9001827039,-4,1125,1847,0
9002508105,9002508104,-1,1314,1525,0
9002603789,9002603789,0,1528,1556,0
9003737823,9003737823,0,886,1337,0
9004283912,9004283910,-2,843,1529,0
9011932150,9011932151,1,998,1477,0
9015710739,9015710738,-1,1686,1697,0
9018072313,9018072315,2,41012,34807,0
9019885006,9019885006,0,1157,1751,0
9020545772,9020545773,1,1280,2108,0
9021228129,9021228128,-1,963,1721,0
9024358986,9024358987,1,1519,1780,0
9025584970,9025584970,0,1283,1322,0
9026615447,9026615444,-3,878,1590,0
9027770381,9027770382,1,1872,1455,0
9031248944,9031248945,1,1057,1638,0
9032173237,9032173230,-7,2917,9446,0
9033738134,9033738139,5,2585,1355,0
9036936916,9036936919,3,1728,1535,0
9039385314,9039385313,-1,1433,1605,0
9040247095,9040247095,0,634,1363,0
9042299054,9042299074,20,1188,1497,0
9042434924,9042434933,9,1635,1130,0
9045342695,9045342697,2,1292,1895,0
9046202999,9046202998,-1,805,1013,0
9047174194,9047174194,0,1120,1125,0
9049067865,9049067865,0,1032,1130,0
9051782009,9051782009,0,2546,2062,0
9054987135,9054987140,5,1446,1421,0
9055748855,9055748862,7,3453,1610,0
9056896105,9056896127,22,1327,1740,0
9057641055,9057641054,-1,1218,1512,0
9059250102,9059250103,1,1125,1578,0
9063094337,9063094338,1,1401,1677,0
9068071041,9068071044,3,1047,1490,0
9068938801,9068938802,1,623,1167,0
9069143599,9069143602,3,1762,2057,0
9071035498,9071035497,-1,1137,1277,0
9075954826,9075954826,0,847,1114,0
9081498953,9081498954,1,1152,1196,0
9083097506,9083097505,-1,1053,1427,0
9087822951,9087822950,-1,1559,1876,0
9088571515,9088571515,0,1041,1562,0
9088819709,9088819708,-1,1602,1717,0
9090651164,9090651167,3,1814,1535,0
9091558462,9091558462,0,1517,2153,0
9091910327,9091910309,-18,1521,1771,0
9096848226,9096848227,1,1968,1672,0
9099264637,9099264635,-2,1164,1254,0
9099654413,9099654406,-7,1450,6620,0
9102510150,9102510150,0,1008,1827,0
9105123730,9105123730,0,1490,1356,0
9107999286,9107999287,1,1142,1768,0
9110038879,9110038880,1,1473,2133,0
9110480253,9110480253,0,1387,2119,0
9111980362,9111980361,-1,1185,1768,0
9112822598,9112822600,2,1111,1430,0
9116904829,9116904828,-1,1666,2257,0
9119039426,9119039426,0,1729,1888,0
9119730618,9119730617,-1,1451,1708,0
9120342063,9120342047,-16,1573,2348,0
9120445928,9120445929,1,1347,1524,0
9124184601,9124184608,7,4948,1799,0
9124234366,9124234366,0,1400,1535,0
9127487240,9127487239,-1,1564,1687,0
9127850434,9127850433,-1,1169,1965,0
9128256522,9128256522,0,984,1452,0
9131197187,9131197188,1,1483,1590,0
9131573838,9131573839,1,1738,1943,0
9132232568,9132232569,1,1640,2018,0
9132380021,9132380022,1,1148,1912,0
9133356998,9133357019,21,1385,1852,0
9139353056,9139353055,-1,1425,1428,0
9139786377,9139786389,12,19885,29345,0
9140699702,9140699704,2,1426,2048,0
9140837782,9140837783,1,2219,2277,0
9144323746,9144323749,3,1514,860,0
9144934203,9144934204,1,2269,2107,0
9147241285,9147241286,1,1619,1328,0
9149108195,9149108198,3,784,1004,0
9149400061,9149400061,0,1500,2242,0
9151629347,9151629348,1,1427,1472,0
9151669037,9151669039,2,942,1293,0
9154373285,9154373286,1,1225,1496,0
9156310526,9156310526,0,1429,1795,0
9158536902,9158536902,0,1450,1683,0
9161829362,9161829364,2,1651,1509,0
9163634680,9163634681,1,1532,1929,0
9163830005,9163830004,-1,1658,2448,0
9169597197,9169597197,0,1136,2089,0
9169965786,9169965784,-2,1608,2134,0
9171017841,9171017842,1,1059,1631,0
9171812550,9171812569,19,792,1387,0
9172394718,9172394717,-1,1630,2053,0
9172489065,9172489064,-1,1854,2288,0
9178239301,9178239302,1,1311,1668,0
9181562625,9181562625,0,1453,2024,0
9181805772,9181805775,3,2889,1314,0
9185555831,9185555831,0,775,1314,0
9187428074,9187428075,1,2077,2479,0
9188839866,9188839868,2,1196,1530,0
9189612081,9189612068,-13,1600,474,0
9189886781,9189886783,2,2101,1179,0
9190622667,9190622667,0,1193,1004,0
9193703092,9193703093,1,1283,1336,0
9195333035,9195333036,1,1930,1452,0
9202577841,9202577842,1,1317,1880,0
9206895773,9206895774,1,1617,1537,0
9210405939,9210405937,-2,1753,1927,0
9211223841,9211223841,0,1420,1659,0
9212349702,9212349702,0,1843,1980,0
9212904892,9212904891,-1,1491,1378,0
9213775068,9213775067,-1,1050,1182,0
9221191696,9221191695,-1,1304,1645,0
9221276086,9221276086,0,1393,1226,0
9221695106,9221695108,2,1156,1556,0
9225177125,9225177126,1,1723,1743,0
9226353482,9226353483,1,1434,1365,0
9227130647,9227130649,2,1133,1344,0
9228838842,9228838842,0,1221,1529,0
9231579721,9231579723,2,1057,1635,0
9232338666,9232338669,3,1587,1449,0
9234075921,9234075921,0,1504,1880,0
9235735278,9235735278,0,1747,1859,0
9238643942,9238643942,0,1404,1705,0
9247072888,9247072884,-4,23798,11875,0
9248584347,9248584348,1,2273,2240,0
9249625037,9249625037,0,2156,1919,0
9251278002,9251278005,3,1467,1198,0
9252666597,9252666598,1,1070,1563,0
9253626620,9253626614,-6,1304,1652,0
9257152253,9257152255,2,2573,1758,0
9257861170,9257861170,0,1670,2044,0
9257966045,9257966045,0,1800,1946,0
9259907253,9259907255,2,1334,1225,0
9266487865,9266487865,0,1644,1973,0
9266536643,9266536647,4,598,1065,0
9268931838,9268931839,1,1192,1297,0
9269745117,9269745121,4,1560,2013,0
9272634925,9272634925,0,1765,2316,0
9273699688,9273699688,0,2020,2197,0
9275751766,9275751767,1,1197,1405,0
9279546419,9279546419,0,1304,2007,0
9279692542,9279692542,0,1975,1744,0
9281036309,9281036310,1,1220,1904,0
9281622069,9281622070,1,1662,2443,0
9285132382,9285132383,1,1652,1318,0
9287829605,9287829605,0,1506,1070,0
9289856214,9289856214,0,1925,2232,0
9290745030,9290745029,-1,1183,1404,0
9291525413,9291525413,0,1458,2041,0
9293779752,9293779752,0,1935,2094,0
9294205079,9294205083,4,1630,1038,0
9304573327,9304573329,2,1318,1683,0
9308025655,9308025655,0,1349,1851,0
9308890503,9308890502,-1,1157,1975,0
9311019599,9311019598,-1,1635,1789,0
9311738399,9311738401,2,1151,2190,0
9312609398,9312609400,2,1072,2197,0
9312818402,9312818403,1,1684,1202,0
9316849084,9316849082,-2,1711,2478,0
9317581225,9317581223,-2,998,941,0
9325547289,9325547290,1,1034,2018,0
9326404009,9326404008,-1,1265,1550,0
9328388570,9328388570,0,1275,1316,0
9328853826,9328853828,2,1282,1568,0
9332194022,9332194025,3,1484,1729,0
9332939059,9332939060,1,1822,1820,0
9334309373,9334309370,-3,1462,2297,0
9334743536,9334743535,-1,1721,2445,0
9336551515,9336551515,0,867,955,0
9339144778,9339144778,0,1199,2071,0
9339862673,9339862674,1,1624,1326,0
9344994538,9344994539,1,1294,2113,0
9346817409,9346817409,0,1689,1473,0
9352177518,9352177519,1,1972,1834,0
9352388416,9352388417,1,1967,2672,0
9354958562,9354958561,-1,1223,1921,0
9355271821,9355271821,0,1721,1955,0
9356236474,9356236474,0,1296,1775,0
9358441081,9358441081,0,1079,1192,0
9366097470,9366097472,2,829,1636,0
9367309578,9367309577,-1,1337,1686,0
9368604489,9368604489,0,1981,1768,0
9370901091,9370901094,3,1406,1289,0
9372594367,9372594369,2,1516,1490,0
9373206934,9373206935,1,1854,1896,0
9375124446,9375124446,0,1938,1472,0
9376670130,9376670130,0,765,984,0
9378591542,9378591539,-3,1033,1464,0
9381727969,9381727967,-2,1848,1926,0
9384202258,9384202260,2,1303,1847,0
9385968109,9385968110,1,937,1577,0
9386917502,9386917502,0,1255,1256,0
9388326761,9388326760,-1,1884,2180,0
9397847518,9397847517,-1,1306,1892,0
9399006333,9399006334,1,1850,2110,0
9400310429,9400310430,1,1686,1953,0
9408944650,9408944651,1,1309,1817,0
9409470285,9409470286,1,1899,2222,0
9410370756,9410370776,20,1234,1017,0
9412548169,9412548171,2,747,925,0
9413174766,9413174768,2,1638,1782,0
9414607159,9414607158,-1,1189,1798,0
9416061149,9416061149,0,1907,2180,0
9416704642,9416704642,0,1484,1432,0
9417377894,9417377895,1,1879,1904,0
9420365607,9420365608,1,1503,1709,0
9420652470,9420652470,0,1010,864,0
9422250073,9422250073,0,1197,1529,0
9423047116,9423047114,-2,2001,2011,0
9424933782,9424933781,-1,1111,1795,0
9429459844,9429459842,-2,1494,2712,0
9441016214,9441016214,0,1194,1641,0
9442332773,9442332774,1,976,1683,0
9448793230,9448793227,-3,826,1655,0
9449737349,9449737348,-1,1047,1287,0
9449766914,9449766913,-1,1442,2463,0
9453732860,9453732861,1,1494,1290,0
9454789412,9454789414,2,1510,1596,0
9457932787,9457932782,-5,812,1971,0
9461019909,9461019908,-1,1687,1491,0
9463587821,9463587824,3,1639,1420,0
9469012178,9469012182,4,1963,1507,0
9469868457,9469868457,0,879,800,0
9472177030,9472177029,-1,1273,1778,0
9474879793,9474879790,-3,1418,2467,0
9476074432,9476074436,4,1850,1427,0
9477117385,9477117384,-1,1627,1894,0
9478288265,9478288266,1,1518,1662,0
9478563678,9478563677,-1,1567,1997,0
9479044303,9479044304,1,2063,2638,0
9479562237,9479562238,1,1538,1687,0
9482019617,9482019618,1,1292,1152,0
9483808190,9483808191,1,1355,1426,0
9485244639,9485244641,2,1153,1715,0
9486519922,9486519922,0,1149,1835,0
9488695518,9488695523,5,2145,1683,0
9488801693,9488801690,-3,1247,1187,0
9488993451,9488993450,-1,742,2463,0
9489612566,9489612565,-1,710,467,0
9490299734,9490299732,-2,1212,1447,0
9492840237,9492840239,2,1388,1600,0
9493460677,9493460677,0,1162,1524,0
9494062830,9494062831,1,1079,1522,0
9494708634,9494708634,0,1320,1280,0
9495442369,9495442372,3,4655,2980,0
9495649255,9495649256,1,1614,1485,0
9500740701,9500740702,1,1671,1461,0
9503114204,9503114202,-2,1327,2117,0
9507197925,9507197926,1,971,1389,0
9508327341,9508327333,-8,1095,1462,0
9508737606,9508737609,3,775,897,0
9515271344,9515271363,19,279,893,0
9518854826,9518854827,1,1582,1186,0
9520594723,9520594723,0,1350,2495,0
9525233025,9525233026,1,1137,1375,0
9527747378,9527747379,1,1169,1463,0
9527964602,9527964605,3,965,1597,0
9533334066,9533334062,-4,1488,4771,0
9536519033,9536519034,1,1069,1118,0
9538015378,9538015381,3,2310,1499,0
9545640651,9545640651,0,1679,1929,0
9545929034,9545929033,-1,1394,1423,0
9547827454,9547827454,0,1420,1566,0
9549200296,9549200294,-2,1367,1204,0
9552438358,9552438361,3,1162,1511,0
9554900410,9554900416,6,3249,1285,0
9555673298,9555673298,0,1329,2368,0
9557214250,9557214250,0,1676,1744,0
9557369411,9557369411,0,1734,2395,0
9559519307,9559519307,0,1332,1563,0
9560150618,9560150618,0,910,1384,0
9561049798,9561049799,1,882,1119,0
9567195898,9567195898,0,1354,1721,0
9569065338,9569065340,2,834,926,0
9579637389,9579637390,1,1583,1860,0
9581189385,9581189386,1,1871,1922,0
9581748964,9581748970,6,5330,2479,0
9582799812,9582799811,-1,1002,1067,0
9585104219,9585104218,-1,1769,1933,0
9585489386,9585489387,1,1754,1626,0
9585714371,9585714371,0,1639,1434,0
9590691101,9590691107,6,1462,794,0
9592510894,9592510895,1,1141,1708,0
9593575522,9593575522,0,1043,1727,0
9594065728,9594065729,1,1287,2111,0
9596963629,9596963631,2,1518,1427,0
9602491643,9602491641,-2,1073,1462,0
9604187758,9604187759,1,1152,1045,0
9609004645,9609004646,1,1371,1757,0
9610699597,9610699598,1,1980,2027,0
9615185590,9615185590,0,1196,1718,0
9617743246,9617743247,1,1788,1562,0
9618192678,9618192682,4,4822,2468,0
9620062867,9620062869,2,1716,2380,0
9620659047,9620659048,1,1205,1767,0
9620848766,9620848768,2,1954,1811,0
9621411201,9621411201,0,1475,1533,0
9621660944,9621660940,-4,1411,1970,0
9622829091,9622829093,2,1591,1788,0
9630482051,9630482051,0,1126,1559,0
9630749510,9630749511,1,1092,1411,0
9631911146,9631911147,1,983,1952,0
9635798478,9635798479,1,1493,1832,0
9635882024,9635882023,-1,1090,1310,0
9639730905,9639730902,-3,1028,1241,0
9640450918,9640450918,0,1231,1420,0
9643498162,9643498162,0,1627,2303,0
9645066450,9645066435,-15,23966,24347,0
9646942970,9646942973,3,1575,2081,0
9651803694,9651803696,2,1377,1107,0
9654391669,9654391670,1,1130,1849,0
9654418201,9654418202,1,1364,1964,0
9654789438,9654789440,2,1454,1740,0
9655728745,9655728743,-2,1645,2024,0
9661438134,9661438133,-1,802,1359,0
9662572981,9662572986,5,1818,1240,0
9663181806,9663181807,1,1191,1511,0
9663681894,9663681894,0,1720,1922,0
9665333826,9665333827,1,1280,1572,0
9665615732,9665615733,1,1450,2337,0
9668782863,9668782862,-1,1428,1494,0
9668976840,9668976841,1,1313,1498,0
9670007426,9670007426,0,635,1283,0
9670624321,9670624321,0,1332,1511,0
9671143882,9671143882,0,1452,2136,0
9671806459,9671806461,2,1752,1604,0
9679570686,9679570692,6,3210,30229,0
9690293659,9690293660,1,1282,1388,0
9700133767,9700133767,0,1419,1302,0
9703619726,9703619726,0,1301,2501,0
9706022047,9706022046,-1,1449,1570,0
9707870038,9707870040,2,1521,1422,0
9708478326,9708478334,8,2729,1088,0
9709718657,9709718658,1,1135,948,0
9710072389,9710072388,-1,1708,2327,0
9710128795,9710128794,-1,842,1250,0
9712566886,9712566887,1,1450,1548,0
9715697830,9715697829,-1,761,1066,0
9717326643,9717326642,-1,1485,1916,0
9721837415,9721837415,0,1121,1559,0
9723325419,9723325419,0,1070,1700,0
9726593986,9726593968,-18,1824,2159,0
9727439556,9727439558,2,1602,1646,0
9728604172,9728604173,1,1222,1783,0
9729132377,9729132377,0,999,1281,0
9730844437,9730844441,4,1071,1098,0
9731919906,9731919905,-1,1390,1868,0
9734457662,9734457661,-1,960,1184,0
9736721886,9736721890,4,31313,45485,0
9738300889,9738300894,5,2033,1552,0
9746185253,9746185253,0,1462,2237,0
9753076230,9753076230,0,1634,1918,0
9755652287,9755652288,1,1446,1647,0
9755821173,9755821174,1,1478,1215,0
9756124351,9756124350,-1,1141,1625,0
9760809620,9760809622,2,2823,2031,0
9767525206,9767525210,4,1215,1445,0
9775757790,9775757791,1,1144,1463,0
9775963397,9775963381,-16,929,1881,0
9778371943,9778371944,1,1305,1922,0
9780302305,9780302305,0,1521,1593,0
9780756761,9780756762,1,1995,1624,0
9786405678,9786405679,1,1025,1691,0
9786876302,9786876304,2,2058,1762,0
9790167528,9790167531,3,2005,2001,0
9796467727,9796467729,2,1273,1316,0
9798032853,9798032854,1,862,1530,0
9800194836,9800194838,2,1054,1893,0
9802485623,9802485623,0,1267,1381,0
9803268167,9803268166,-1,1159,1749,0
9806272531,9806272535,4,1050,1289,0
9807049410,9807049410,0,1061,1465,0
9807830710,9807830710,0,1717,1979,0
9813428189,9813428187,-2,1308,1589,0
9814884777,9814884778,1,826,1315,0
9817277714,9817277712,-2,1365,2512,0
9817629962,9817629962,0,1132,1600,0
9820372808,9820372804,-4,60353,32006,0
9823707817,9823707818,1,1470,1390,0
9826763963,9826763964,1,1344,1920,0
9829399927,9829399927,0,1476,1663,0
9831164542,9831164542,0,2046,1888,0
9832716498,9832716498,0,793,867,0
9835707497,9835707500,3,1768,1324,0
9838246850,9838246851,1,1271,1605,0
9841392530,9841392530,0,1570,1914,0
9842991858,9842991859,1,1294,1872,0
9844481822,9844481818,-4,944,942,0
9846560457,9846560458,1,1192,1374,0
9849038287,9849038287,0,1053,1426,0
9849813066,9849813064,-2,1441,1404,0
9851031306,9851031288,-18,8,12636,0
9851365985,9851365984,-1,769,1105,0
9852351721,9852351724,3,1116,1435,0
9854635606,9854635607,1,1511,1748,0
9855263170,9855263171,1,877,1385,0
9855296792,9855296794,2,1625,1658,0
9856792331,9856792330,-1,799,1198,0
9859016714,9859016716,2,1277,1329,0
9860763775,9860763776,1,1524,1752,0
9861760888,9861760889,1,2995,2397,0
9862585493,9862585494,1,1367,1442,0
9869891389,9869891387,-2,1071,1551,0
9871895474,9871895475,1,1191,2070,0
9877520251,9877520252,1,1417,1740,0
9878084894,9878084893,-1,1168,1487,0
9885493008,9885493006,-2,1296,1502,0
9889169322,9889169324,2,901,1069,0
9894248828,9894248829,1,1463,1481,0
9897564124,9897564125,1,1249,1602,0
9899174369,9899174370,1,1601,2142,0
9902989127,9902989128,1,1152,1555,0
9905078354,9905078355,1,1459,1934,0
9909174674,9909174675,1,955,1408,0
9911418441,9911418439,-2,964,926,0
9912997388,9912997386,-2,2019,2015,0
9916501250,9916501251,1,1770,2048,0
9916541520,9916541514,-6,1830,4994,0
9924336306,9924336307,1,1561,1999,0
9924882751,9924882750,-1,1716,1809,0
9926276747,9926276746,-1,1506,1952,0
9927574529,9927574529,0,1555,1193,0
9932348794,9932348795,1,1519,1495,0
9932620436,9932620438,2,2069,1134,0
9937477604,9937477611,7,10637,22406,0
9942634539,9942634541,2,1106,1372,0
9943301661,9943301659,-2,42660,19399,0
9943892018,9943892018,0,1039,1690,0
9948641123,9948641123,0,1318,1058,0
9948950269,9948950270,1,2379,2005,0
9949862833,9949862833,0,1650,1549,0
9951159796,9951159799,3,1834,1921,0
9952514554,9952514554,0,674,1678,0
9953996228,9953996228,0,1409,1542,0
9959035114,9959035114,0,1326,1572,0
9962973826,9962973825,-1,619,1108,0
9964574034,9964574033,-1,1162,1401,0
9966406661,9966406656,-5,1141,2168,0
9971519315,9971519315,0,990,1011,0
9972051254,9972051255,1,1032,1113,0
9973282214,9973282221,7,6971,3030,0
9975805702,9975805702,0,1388,1623,0
9983929607,9983929609,2,1361,1752,0
9984274625,9984274625,0,1817,2481,0
9984509402,9984509402,0,1236,1611,0
9985144322,9985144325,3,1287,1331,0
9986050124,9986050123,-1,1429,1834,0
9988007493,9988007490,-3,1006,1788,0
9990190884,9990190883,-1,1082,1989,0
9991508593,9991508593,0,1219,1558,0
9996441338,9996441337,-1,1651,1448,0
10000418914,10000418914,0,1917,1593,0
10002602604,10002602603,-1,1280,1430,0
10003846073,10003846078,5,2535,1683,0
10005072519,10005072525,6,2604,1443,0
10005356494,10005356489,-5,1120,2580,0
10009476215,10009476217,2,1430,2106,0
10010377142,10010377142,0,1003,1427,0
10010540637,10010540636,-1,1242,1662,0
10010642526,10010642526,0,1730,1833,0
10014545687,10014545685,-2,898,2240,0
10015199605,10015199608,3,1339,1464,0
10017333853,10017333853,0,1123,1561,0
10017764049,10017764054,5,2241,1128,0
10018147965,10018147982,17,1574,1097,0
10019668165,10019668163,-2,1542,1680,0
10020419733,10020419737,4,1639,1238,0
10027942449,10027942450,1,1322,1224,0
10033828241,10033828243,2,1430,1899,0
10036814018,10036814018,0,1250,1049,0
10037686105,10037686102,-3,1450,4226,0
10039306258,10039306259,1,1684,1894,0
10039982731,10039982733,2,1501,1765,0
10041321883,10041321885,2,942,1988,0
10045240823,10045240825,2,1826,2292,0
10045677934,10045677937,3,1271,1862,0
10047450358,10047450359,1,1179,1576,0
10049933986,10049933987,1,1251,1114,0
10050937553,10050937554,1,1205,1510,0
10055273407,10055273409,2,16477,41165,0
10058084428,10058084430,2,1736,2161,0
10059806259,10059806259,0,1081,1598,0
10061473846,10061473847,1,1530,1192,0
10064499914,10064499914,0,1454,1988,0
10065323362,10065323363,1,2096,1817,0
10066647633,10066647632,-1,1399,1890,0
10067039007,10067039007,0,831,1488,0
10068978282,10068978282,0,1383,2114,0
10070626105,10070626107,2,1415,1769,0
10071417082,10071417081,-1,2098,2195,0
10071969493,10071969494,1,2334,2166,0
10071996993,10071996995,2,1402,1617,0
10073400686,10073400689,3,1387,1705,0
10076911878,10076911879,1,1263,1386,0
10077307741,10077307738,-3,1041,1971,0
10077840605,10077840606,1,833,816,0
10078346081,10078346081,0,1535,1545,0
10082816233,10082816234,1,1086,1801,0
10083048796,10083048807,11,1283,1210,0
10084824442,10084824440,-2,1205,2111,0
10085004318,10085004315,-3,1249,2390,0
10085261243,10085261243,0,980,1394,0
10086827819,10086827820,1,1481,1505,0
10087679111,10087679130,19,1458,1583,0
10090267546,10090267547,1,1160,1470,0
10091518507,10091518508,1,1400,1569,0
10092500937,10092500943,6,2537,1414,0
10097392131,10097392131,0,1555,1886,0
10098052378,10098052381,3,2265,1607,0
10100463806,10100463806,0,1283,1726,0
10104220135,10104220135,0,1202,1537,0
10107108731,10107108731,0,1332,1451,0
10109810103,10109810106,3,912,1514,0
10111179475,10111179477,2,1315,1853,0
10112931683,10112931684,1,1709,1395,0
10114232986,10114232984,-2,2160,2425,0
10116668621,10116668624,3,1860,1909,0
10117200142,10117200143,1,2055,2263,0
10117856271,10117856271,0,1861,1808,0
10118519999,10118519998,-1,1145,1414,0
10119521278,10119521277,-1,776,877,0
10123816358,10123816361,3,1072,1822,0
10126423171,10126423171,0,1385,2039,0
10127460075,10127460078,3,1304,1391,0
10129345535,10129345533,-2,1027,1497,0
10129579701,10129579685,-16,1036,1046,0
10130819279,10130819278,-1,1147,1712,0
10132682407,10132682411,4,2658,1078,0
10138970137,10138970137,0,766,1414,0
10146124115,10146124114,-1,1131,1766,0
10146911485,10146911489,4,3921,3267,0
10150538205,10150538206,1,1080,1272,0
10151850469,10151850469,0,1161,2137,0
10152053021,10152053022,1,897,1458,0
10153344448,10153344452,4,1068,1249,0
10153593041,10153593022,-19,509,1209,0
10155572387,10155572390,3,1553,1722,0
10156551701,10156551703,2,1811,2556,0
10157213417,10157213418,1,1267,1708,0
10157301893,10157301893,0,1198,1845,0
10159853610,10159853611,1,1430,1554,0
10161997286,10161997286,0,1164,1900,0
10163637367,10163637373,6,6504,2717,0
10166319628,10166319627,-1,1060,860,0
10171786092,10171786092,0,1171,2218,0
10172007156,10172007162,6,123,1120,0
10173611341,10173611346,5,2242,1555,0
10176827438,10176827439,1,1219,2033,0
10178895234,10178895234,0,1559,1562,0
10180108301,10180108302,1,656,690,0
10183734554,10183734557,3,2247,1298,0
10183943335,10183943347,12,211,528,0
10186178872,10186178874,2,1517,1447,0
10187108287,10187108291,4,1133,1073,0
10187305325,10187305326,1,1616,1653,0
10190775138,10190775139,1,1401,1644,0
10194585914,10194585916,2,1777,1223,0
10194685647,10194685649,2,1446,1563,0
10196554839,10196554839,0,1218,2077,0
10205711870,10205711872,2,974,1526,0
10207699720,10207699721,1,1285,1210,0
10218290930,10218290932,2,799,1188,0
10218893079,10218893079,0,1251,1463,0
10220495923,10220495922,-1,1265,2057,0
10223738621,10223738619,-2,907,1456,0
10224766598,10224766599,1,1126,1431,0
10227566666,10227566667,1,1635,2204,0
10228253126,10228253126,0,1028,2065,0
10230988170,10230988170,0,1436,1188,0
10231597968,10231597970,2,1977,1454,0
10231942883,10231942883,0,1567,1586,0
10233200386,10233200386,0,1861,1973,0
10233599931,10233599933,2,827,1450,0
10243249735,10243249738,3,1494,1566,0
10245731680,10245731681,1,1742,1786,0
10251277638,10251277638,0,737,1074,0
10254018254,10254018249,-5,1167,2967,0
10254357031,10254357030,-1,1596,1547,0
10254992363,10254992362,-1,1278,2020,0
10255107985,10255107986,1,1759,1445,0
10255152977,10255152980,3,2107,1490,0
10256189479,10256189482,3,1525,2165,0
10257100094,10257100094,0,1518,1936,0
10261663003,10261663003,0,1274,1615,0
10262486711,10262486710,-1,909,1333,0
10267643813,10267643813,0,1595,1599,0
10271204232,10271204233,1,1911,2002,0
10273614949,10273614952,3,1180,1163,0
10275212699,10275212698,-1,1119,1756,0
10277135489,10277135485,-4,1100,3775,0
10278584446,10278584446,0,1636,2777,0
10280715091,10280715091,0,1406,1242,0
10281453481,10281453481,0,2029,1791,0
10281853690,10281853709,19,1558,1215,0
10282861677,10282861670,-7,2753,8614,0
10282961849,10282961850,1,896,1946,0
10283760125,10283760132,7,7690,2455,0
10286387177,10286387192,15,334,1782,0
10286576818,10286576817,-1,1459,1521,0
10286834167,10286834167,0,1281,1113,0
10288356357,10288356355,-2,861,2150,0
10289282160,10289282142,-18,870,790,0
10289454126,10289454125,-1,1194,2010,0
10291896173,10291896177,4,2522,933,0
10292756498,10292756499,1,984,1331,0
10293898966,10293898966,0,1194,1527,0
10302562698,10302562697,-1,1354,2308,0
10313584457,10313584456,-1,1247,1560,0
10315750816,10315750816,0,937,1240,0
10316417585,10316417586,1,2218,2518,0
10317603653,10317603652,-1,1356,2000,0
10318488304,10318488307,3,951,1299,0
10318558072,10318558074,2,1776,1567,0
10318825615,10318825610,-5,1163,3646,0
10319625316,10319625322,6,31133,28071,0
10320817986,10320817987,1,1602,2261,0
10323814594,10323814590,-4,1983,4681,0
10325001700,10325001702,2,1603,1443,0
10325730892,10325730889,-3,1286,1641,0
10327322945,10327322942,-3,3133,6381,0
10327912577,10327912579,2,1362,1881,0
10328597718,10328597718,0,1605,1844,0
10329629673,10329629670,-3,1170,1562,0
10329823006,10329823006,0,910,1583,0
10332170918,10332170918,0,1499,1168,0
10333476902,10333476903,1,1433,1628,0
10334593678,10334593681,3,1223,1790,0
10336548454,10336548454,0,1186,1738,0
10337464903,10337464903,0,1460,2133,0
10343542392,10343542392,0,1551,1734,0
10344929723,10344929725,2,1581,1789,0
10345443454,10345443454,0,1470,1931,0
10346474942,10346474942,0,1355,1475,0
10347390854,10347390854,0,1145,1552,0
10349118062,10349118062,0,1400,1952,0
10351773515,10351773514,-1,1223,1994,0
10352177176,10352177178,2,1401,1999,0
10353495791,10353495792,1,1327,1447,0
10353595700,10353595701,1,44207,26299,0
10354051802,10354051803,1,1093,2098,0
10357794790,10357794789,-1,1620,1413,0
10358237905,10358237905,0,1053,1488,0
10361942124,10361942126,2,19896,30107,0
10363869410,10363869410,0,1292,1558,0
10366826730,10366826734,4,1254,1070,0
10370693309,10370693305,-4,1354,3959,0
10373807050,10373807050,0,1160,1432,0
10375352485,10375352485,0,984,1820,0
10378340497,10378340493,-4,1035,2705,0
10378404174,10378404178,4,641,1265,0
10382048892,10382048891,-1,1210,902,0
10383066372,10383066372,0,1278,1598,0
10383691263,10383691264,1,1518,2004,0
10387296937,10387296937,0,35861,19425,0
10388238470,10388238470,0,1185,1744,0
10394413987,10394413982,-5,1217,2807,0
10395633291,10395633294,3,875,1298,0
10398585820,10398585820,0,1699,1894,0
10400769786,10400769787,1,1413,1834,0
10402694630,10402694630,0,864,1110,0
10402855011,10402855013,2,25118,19437,0
10408292301,10408292301,0,1742,2028,0
10409179172,10409179173,1,1269,1272,0
10409978427,10409978426,-1,2151,2555,0
10410084510,10410084524,14,2554,1545,0
10412375730,10412375730,0,1054,1722,0
10416059375,10416059374,-1,1223,1483,0
10417448193,10417448194,1,1109,929,0
10419388938,10419388937,-1,1054,1406,0
10421375346,10421375347,1,880,2185,0
10423160466,10423160469,3,2166,2193,0
10424160760,10424160761,1,1136,1948,0
10427130424,10427130422,-2,2267,2871,0
10428375495,10428375494,-1,1340,1238,0
10430992755,10430992760,5,42541,22714,0
10431515045,10431515043,-2,1244,1755,0
10432709803,10432709802,-1,1352,2082,0
10436672298,10436672299,1,897,1886,0
10437436994,10437436994,0,1347,1855,0
10441480423,10441480426,3,864,1059,0
10442687085,10442687087,2,1176,1603,0
10443106973,10443106975,2,2102,1860,0
10446088628,10446088627,-1,1428,1709,0
10446744514,10446744516,2,1461,1919,0
10448008175,10448008178,3,1043,1549,0
10448624472,10448624474,2,1127,1279,0
10449462242,10449462246,4,3057,1966,0
10449556152,10449556153,1,2225,1620,0
10450793394,10450793398,4,6614,21176,0
10453692479,10453692481,2,1320,1463,0
10455572231,10455572233,2,996,1408,0
10459930247,10459930248,1,858,954,0
10460798458,10460798458,0,1773,2347,0
10460932057,10460932057,0,1793,1443,0
10466969562,10466969561,-1,1250,1881,0
10467070151,10467070152,1,994,2170,0
10468461685,10468461688,3,1719,2340,0
10469864310,10469864311,1,1142,1334,0
10470509670,10470509674,4,1003,1490,0
10471104499,10471104497,-2,1573,2466,0
10471269661,10471269661,0,1789,2500,0
10480334013,10480334014,1,1907,1830,0
10481696053,10481696054,1,1372,1661,0
10482054417,10482054417,0,1295,1810,0
10483994931,10483994933,2,1369,1448,0
10487849418,10487849418,0,1451,2032,0
10489733213,10489733213,0,1308,1714,0
10492087910,10492087911,1,1163,1299,0
10493439462,10493439463,1,1162,1350,0
10494321936,10494321938,2,936,1709,0
10500167688,10500167676,-12,929,4867,0
10506176295,10506176294,-1,1121,1925,0
10506408541,10506408542,1,1119,1492,0
10508157399,10508157399,0,810,1370,0
10509337893,10509337890,-3,1147,1966,0
10511191038,10511191039,1,1777,1334,0
10512739509,10512739510,1,1256,1360,0
10512931592,10512931593,1,2180,1718,0
10518330886,10518330887,1,1195,1668,0
10520854523,10520854527,4,1400,1479,0
10527653194,10527653195,1,1570,1288,0
10528349068,10528349066,-2,1543,2301,0
10531549598,10531549598,0,1832,1827,0
10533598137,10533598138,1,1235,1427,0
10534443360,10534443361,1,1352,1660,0
10537430195,10537430197,2,2429,2167,0
10538704669,10538704669,0,1358,1679,0
10540417935,10540417935,0,1398,2161,0
10541324303,10541324305,2,1185,1632,0
10541882467,10541882466,-1,1280,1619,0
10543359529,10543359532,3,1707,1281,0
10543655861,10543655861,0,1640,2293,0
10543986574,10543986575,1,1594,1696,0
10549979604,10549979605,1,925,1853,0
10550469054,10550469055,1,1505,1986,0
10553109550,10553109551,1,1466,1325,0
10553828878,10553828878,0,968,1367,0
10558047998,10558047998,0,1222,1892,0
10558440853,10558440854,1,1282,1420,0
10560380798,10560380798,0,1449,1669,0
10562340178,10562340178,0,1318,1519,0
10562500305,10562500305,0,1367,1546,0
10563773200,10563773200,0,1284,1807,0
10568117169,10568117170,1,1002,1337,0
10570359399,10570359378,-21,1221,1650,0
10570953001,10570953004,3,1109,1253,0
10571010629,10571010630,1,1107,2091,0
10573817222,10573817223,1,1166,1250,0
10575282537,10575282536,-1,1153,1178,0
10576060893,10576060895,2,1229,1342,0
10578964571,10578964573,2,1134,1808,0
10582366342,10582366343,1,1385,1708,0
10584383709,10584383709,0,1144,1844,0
10589899585,10589899586,1,1822,1554,0
10591092668,10591092671,3,1386,2177,0
10591295631,10591295633,2,1504,2450,0
10592216329,10592216331,2,1434,1402,0
10600225337,10600225336,-1,1478,1593,0
10606241925,10606241925,0,993,1249,0
10606453753,10606453754,1,1172,2093,0
10608692846,10608692846,0,1732,1866,0
10610333011,10610333011,0,1398,1583,0
10610514743,10610514745,2,1078,1296,0
10611843824,10611843822,-2,1279,1360,0
10612039545,10612039545,0,1317,1696,0
10612855941,10612855941,0,1331,1232,0
10615294966,10615294966,0,1247,1572,0
10617354521,10617354523,2,1394,1946,0
10619242037,10619242035,-2,1899,2040,0
10619356029,10619356029,0,1670,1635,0
10619490974,10619490974,0,1243,2330,0
10620491221,10620491221,0,1443,1216,0
10623718277,10623718277,0,1680,1384,0
10626036982,10626036983,1,1186,1078,0
10629047736,10629047737,1,1838,2095,0
10632002285,10632002287,2,736,1340,0
10632925930,10632925930,0,2011,2246,0
10634486190,10634486190,0,1400,2310,0
10634590198,10634590201,3,1392,1692,0
10635610819,10635610820,1,1614,2018,0
10636320134,10636320133,-1,1282,2569,0
10638978677,10638978678,1,1288,2209,0
10640052355,10640052356,1,1251,1597,0
10641887129,10641887130,1,1320,1552,0
10646450947,10646450946,-1,1539,1968,0
10649138771,10649138774,3,989,1560,0
10650073354,10650073367,13,529,881,0
10651362786,10651362764,-22,12288,51338,0
10655042097,10655042099,2,1582,1438,0
10655792840,10655792832,-8,1317,7303,0
10657714914,10657714912,-2,1163,2218,0
10659863261,10659863262,1,1166,1652,0
10661567675,10661567674,-1,910,1950,0
10664256018,10664256014,-4,1842,6242,0
10667324113,10667324112,-1,1461,2904,0
10672000528,10672000528,0,1506,2083,0
10674696321,10674696320,-1,2067,2086,0
10674812515,10674812515,0,1792,2078,0
10677272963,10677272961,-2,831,1271,0
10680070822,10680070821,-1,1120,1496,0
10681127030,10681127030,0,1029,1333,0
10681780921,10681780922,1,1597,2066,0
10681886460,10681886449,-11,1311,1611,0
10682439039,10682439041,2,940,1966,0
10682993402,10682993401,-1,1310,1856,0
10686307005,10686307005,0,1738,2771,0
10686946588,10686946593,5,5052,2336,0
10687183842,10687183840,-2,1785,2708,0
10687505262,10687505265,3,1784,2400,0
10688847763,10688847747,-16,1317,1243,0
10691153359,10691153359,0,1187,1629,0
10695053730,10695053726,-4,1422,3393,0
10695539916,10695539918,2,1188,1132,0
10695880262,10695880262,0,1112,1449,0
10696845038,10696845038,0,1414,1644,0
10697931102,10697931103,1,955,1205,0
10698221260,10698221260,0,1732,1961,0
10699500941,10699500939,-2,953,1611,0
10704496915,10704496914,-1,1286,2042,0
10707418561,10707418562,1,1490,1512,0
10709011210,10709011218,8,3536,1372,0
10709874486,10709874487,1,1330,1530,0
10710263663,10710263663,0,898,2498,0
10710309545,10710309546,1,1324,1791,0
10713350442,10713350443,1,1816,2065,0
10713543346,10713543346,0,1431,1954,0
10714090433,10714090433,0,1505,1776,0
10715164850,10715164848,-2,1121,1388,0
10717560769,10717560770,1,2072,2441,0
10717938049,10717938047,-2,1360,1834,0
10719702562,10719702562,0,1103,1903,0
10720674359,10720674362,3,1163,1654,0
10721598039,10721598039,0,32,3954,0
10723139994,10723139998,4,2203,1940,0
10723748275,10723748274,-1,1494,1844,0
10725916788,10725916789,1,1294,1906,0
10726525374,10726525374,0,1429,1992,0
10730754998,10730754997,-1,992,1577,0
10731023457,10731023458,1,1644,1535,0
10732320467,10732320465,-2,1244,2188,0
10735574335,10735574336,1,970,1565,0
10736719294,10736719294,0,981,1658,0
10737342332,10737342329,-3,1163,2084,0
10739888582,10739888583,1,1127,1188,0
10743230433,10743230434,1,1575,1663,0
10745647685,10745647686,1,1770,1315,0
10747442655,10747442656,1,1532,1650,0
10748623801,10748623803,2,1339,1880,0
10748717280,10748717278,-2,1236,1644,0
10749958656,10749958651,-5,1011,4149,0
10751263157,10751263163,6,5545,1459,0
10752295438,10752295438,0,1018,1104,0
10754354623,10754354622,-1,1243,1992,0
10755935690,10755935693,3,1036,1356,0
10762362351,10762362352,1,1796,2199,0
10762753342,10762753342,0,1202,1282,0
10767872849,10767872850,1,508,335,0
10769172094,10769172095,1,3430,3672,0
10769975128,10769975129,1,1780,1649,0
10776944211,10776944214,3,1727,2153,0
10777861596,10777861599,3,1748,1364,0
10778824385,10778824384,-1,1496,1308,0
10779752236,10779752223,-13,1275,1705,0
10780601291,10780601292,1,1923,2813,0
10782784570,10782784570,0,1606,1568,0
10785538063,10785538065,2,962,1632,0
10795327258,10795327260,2,1664,1732,0
10797284810,10797284811,1,1467,1563,0
10798379203,10798379204,1,961,1492,0
10801806318,10801806318,0,1200,1985,0
10802400126,10802400127,1,1017,1365,0
10803549149,10803549150,1,1690,1972,0
10807313474,10807313477,3,2157,1721,0
10807556781,10807556780,-1,1141,1671,0
10808613035,10808613034,-1,3058,5407,0
10808916167,10808916167,0,1033,1314,0
10814450977,10814450977,0,1163,1838,0
10815241822,10815241822,0,1231,1675,0
10821851210,10821851209,-1,1350,1656,0
10822300891,10822300890,-1,1412,1389,0
10824692095,10824692094,-1,1103,1799,0
10827458350,10827458351,1,1708,1992,0
10835370790,10835370794,4,1606,1571,0
10835918789,10835918787,-2,2336,2961,0
10836967859,10836967858,-1,1501,1867,0
10839521324,10839521342,18,2174,2021,0
10842024897,10842024899,2,1353,1628,0
10843474127,10843474126,-1,2194,2331,0
10845351533,10845351533,0,1381,1796,0
10847846500,10847846500,0,1521,2368,0
10848678020,10848678022,2,1338,2017,0
10851470734,10851470735,1,1648,1887,0
10852644043,10852644045,2,1066,1525,0
10853384213,10853384214,1,1190,1479,0
10859198341,10859198342,1,1726,1139,0
10860775455,10860775455,0,944,1047,0
10861521390,10861521393,3,1037,1326,0
10862449261,10862449262,1,1453,2235,0
10864971302,10864971304,2,1045,2394,0
10867040494,10867040494,0,1774,1948,0
10867220078,10867220079,1,1259,1464,0
10868039209,10868039213,4,4864,3945,0
10868179150,10868179151,1,1698,1917,0
10868830804,10868830810,6,2767,988,0
10869841440,10869841422,-18,493,243,0
10871937606,10871937606,0,1037,1435,0
10872109099,10872109101,2,1472,2117,0
10872246312,10872246323,11,213,1332,0
10873050826,10873050823,-3,1117,2401,0
10873984919,10873984916,-3,1500,1862,0
10874919764,10874919766,2,1301,2299,0
10875146515,10875146513,-2,1063,1424,0
10876556122,10876556122,0,1606,1528,0
10878718791,10878718790,-1,1406,1993,0
10880630745,10880630744,-1,1003,1496,0
10891134777,10891134777,0,1630,2125,0
10891548401,10891548401,0,1425,2350,0
10892770394,10892770397,3,1194,1728,0
10894120939,10894120939,0,1932,2004,0
10896025312,10896025313,1,1321,1484,0
10896321213,10896321215,2,1854,1606,0
10896868923,10896868924,1,1051,1488,0
10898486152,10898486153,1,2142,2473,0
10899236974,10899236976,2,1343,2229,0
10902368172,10902368171,-1,1250,2127,0
10903612886,10903612886,0,1654,2125,0
10904170054,10904170053,-1,1075,973,0
10905403496,10905403499,3,1564,1886,0
10906369834,10906369833,-1,2156,2489,0
10909029214,10909029214,0,1240,1714,0
10909150111,10909150111,0,1298,1866,0
10911816694,10911816691,-3,1144,1471,0
10912831585,10912831587,2,2369,2807,0
10913711742,10913711742,0,1727,2195,0
10913821374,10913821376,2,1163,1542,0
10913851782,10913851770,-12,1522,1822,0
10915755014,10915755016,2,1921,1911,0
10915830634,10915830635,1,988,1373,0
10916184413,10916184412,-1,1707,1764,0
10923656029,10923656031,2,1920,2464,0
10927409832,10927409833,1,1119,1841,0
10928375854,10928375854,0,1793,1962,0
10930230070,10930230070,0,1242,1203,0
10932391425,10932391427,2,1240,1360,0
10933126582,10933126582,0,1236,1591,0
10934458840,10934458841,1,1118,1339,0
10936881767,10936881769,2,1859,1741,0
10939540734,10939540731,-3,1682,2492,0
10946833629,10946833627,-2,1542,1941,0
10947827770,10947827770,0,1179,1871,0
10951017902,10951017903,1,1104,1051,0
10951111447,10951111451,4,1337,2001,0
10953669176,10953669174,-2,1522,1975,0
10955143513,10955143514,1,1274,2022,0
10955491158,10955491153,-5,791,3458,0
10956000906,10956000909,3,1407,1823,0
10957202876,10957202875,-1,1653,2380,0
10959504882,10959504883,1,1695,1789,0
10964076537,10964076538,1,1371,1763,0
10965348593,10965348594,1,1694,1296,0
10970303230,10970303230,0,1867,1121,0
10971480723,10971480722,-1,1213,1150,0
10972535590,10972535585,-5,1102,1547,0
10973460430,10973460414,-16,1246,1711,0
10975478925,10975478923,-2,809,1375,0
10976225539,10976225538,-1,1147,2437,0
10978546815,10978546814,-1,1507,1139,0
10981395534,10981395524,-10,192,2701,0
10981533894,10981533886,-8,1227,1067,0
10982626711,10982626710,-1,1179,1167,0
10985038798,10985038800,2,975,2012,0
10987255855,10987255855,0,1497,1285,0
10989921625,10989921627,2,1635,902,0
10991363989,10991363989,0,1511,2261,0
10995347787,10995347789,2,1487,2243,0
10995605083,10995605081,-2,1464,2412,0
10997494633,10997494633,0,1471,1753,0
10997660406,10997660406,0,943,1163,0
10998244635,10998244633,-2,908,1702,0
10998751945,10998751945,0,1407,1647,0
11000055141,11000055140,-1,824,1299,0
11001573930,11001573928,-2,33779,22538,0
11003616954,11003616954,0,1151,1280,0
11004989898,11004989899,1,1334,1641,0
11014356074,11014356073,-1,1220,1412,0
11016155131,11016155130,-1,1518,2143,0
11019327515,11019327514,-1,837,2221,0
11020864270,11020864269,-1,1547,2274,0
11021887813,11021887815,2,1694,1269,0
11027478210,11027478209,-1,1837,2575,0
11028176372,11028176374,2,1035,1023,0
11030618930,11030618930,0,1342,1757,0
11032212385,11032212386,1,1451,2818,0
11032359270,11032359269,-1,1555,1424,0
11032909158,11032909159,1,1395,1937,0
11034014135,11034014144,9,2279,748,0
11035221780,11035221781,1,935,895,0
11037893815,11037893815,0,1719,1994,0
11039674518,11039674505,-13,1377,1753,0
11039995731,11039995732,1,1372,1885,0
11043742731,11043742730,-1,1514,2259,0
11046777266,11046777266,0,1167,1337,0
11046907030,11046907030,0,1519,1887,0
11048184087,11048184087,0,1413,1934,0
11050198647,11050198639,-8,41770,16972,0
11052007081,11052007083,2,1641,1548,0
11053687741,11053687742,1,1517,1057,0
11054688523,11054688522,-1,1160,2021,0
11055923403,11055923402,-1,1435,2025,0
11056606681,11056606682,1,1162,1599,0
11057414739,11057414739,0,1398,1660,0
11058683563,11058683562,-1,1578,1793,0
11060691239,11060691237,-2,1087,1249,0
11061293814,11061293834,20,885,1149,0
11062990067,11062990067,0,1259,1782,0
11063047356,11063047357,1,1176,943,0
11065491245,11065491246,1,1239,1840,0
11066421883,11066421883,0,1778,1685,0
11067798662,11067798640,-22,1489,1616,0
11076093747,11076093746,-1,1172,2072,0
11076985399,11076985401,2,1866,1775,0
11077898214,11077898216,2,1228,1544,0
11080110549,11080110550,1,1357,1081,0
11083469520,11083469518,-2,1256,1873,0
11084197400,11084197401,1,1231,2045,0
11087685618,11087685617,-1,1586,1998,0
11088170418,11088170416,-2,1456,1532,0
11091387078,11091387078,0,1286,1583,0
11091691806,11091691806,0,1923,2177,0
11096097702,11096097704,2,2063,2147,0
11097994784,11097994782,-2,1210,2170,0
11098225261,11098225263,2,1055,1336,0
11098763370,11098763369,-1,744,1368,0
11106644218,11106644220,2,1406,1831,0
11114103498,11114103494,-4,1199,3354,0
11114293598,11114293598,0,1881,1912,0
11116267309,11116267309,0,1424,1477,0
11116827790,11116827790,0,1524,1685,0
11117387323,11117387320,-3,1310,2729,0
11117943999,11117944000,1,1204,2200,0
11118245658,11118245658,0,1012,1037,0
11121600141,11121600141,0,1389,1517,0
11128017022,11128017020,-2,1252,2135,0
11130718489,11130718486,-3,1143,2193,0
11131516347,11131516348,1,1826,1815,0
11134754547,11134754546,-1,1129,1530,0
11134903422,11134903422,0,1222,2040,0
11138538139,11138538140,1,858,1516,0
11139292731,11139292731,0,891,1113,0
11142356677,11142356678,1,1253,1000,0
11144695394,11144695392,-2,1450,2216,0
11146690459,11146690461,2,1199,1108,0
11149057285,11149057285,0,1466,2158,0
11151073242,11151073245,3,1139,1741,0
11151770645,11151770646,1,1753,1530,0
11152537051,11152537054,3,1138,1549,0
11157352776,11157352775,-1,1177,1445,0
11159172769,11159172769,0,1223,1378,0
11166688685,11166688689,4,1551,1145,0
11167670789,11167670811,22,1629,1841,0
11170472718,11170472721,3,1171,1567,0
11170990767,11170990786,19,757,1350,0
11171652663,11171652666,3,1422,1174,0
11172499603,11172499602,-1,932,1531,0
11173542762,11173542762,0,1286,1536,0
11174256476,11174256476,0,1346,1716,0
11174386022,11174386025,3,1855,1858,0
11176365706,11176365706,0,1374,1620,0
11181617391,11181617399,8,4333,1563,0
11182329686,11182329684,-2,1292,1932,0
11187695379,11187695380,1,1676,1678,0
11188524198,11188524187,-11,1143,1331,0
11188963067,11188963066,-1,1169,1658,0
11189080514,11189080514,0,1641,2025,0
11189418286,11189418286,0,1465,1421,0
11190750409,11190750409,0,1224,1466,0
11193594140,11193594137,-3,1414,1783,0
11195263518,11195263518,0,1517,1870,0
11196525978,11196525979,1,1377,1547,0
11196622431,11196622415,-16,98,1308,0
11197150094,11197150097,3,1240,1216,0
11197812429,11197812429,0,1170,1483,0
11202360964,11202360963,-1,1521,1854,0
11202687834,11202687833,-1,1183,1679,0
11203075985,11203075986,1,1284,1137,0
11203771943,11203771945,2,1119,1838,0
11205874546,11205874547,1,1802,1909,0
11207000203,11207000214,11,1243,1220,0
11208558577,11208558579,2,1059,1714,0
11213760546,11213760550,4,1018,1077,0
11214760661,11214760663,2,1226,1478,0
11214891256,11214891254,-2,1643,1875,0
11215032783,11215032785,2,1147,2102,0
11215296534,11215296534,0,1272,1793,0
11216025130,11216025138,8,13307,31249,0
11216515370,11216515367,-3,1072,1462,0
11223619897,11223619900,3,3578,1787,0
11224862971,11224862971,0,1924,2080,0
11225124642,11225124641,-1,1070,1357,0
11225766886,11225766878,-8,1058,4846,0
11235241528,11235241530,2,1226,1433,0
11236954374,11236954376,2,1212,1546,0
11237341534,11237341535,1,1487,1181,0
11245987144,11245987145,1,740,888,0
11246252776,11246252776,0,1766,1905,0
11248117597,11248117598,1,1016,1212,0
11248618810,11248618805,-5,20128,7800,0
11249730034,11249730037,3,2770,1925,0
11249859163,11249859166,3,1095,1852,0
11253627266,11253627266,0,1146,940,0
11254186349,11254186349,0,1654,2392,0
11254568165,11254568166,1,1413,1381,0
11255065257,11255065261,4,5760,3069,0
11256034260,11256034259,-1,2287,2268,0
11256729621,11256729621,0,1395,1829,0
11257090725,11257090722,-3,4172,7633,0
11259700223,11259700224,1,2265,2310,0
11259940567,11259940566,-1,1002,1391,0
11271102848,11271102851,3,2841,1491,0
11272370830,11272370839,9,599,1460,0
11273695001,11273695002,1,1446,1566,0
11280662389,11280662389,0,1590,1770,0
11284697859,11284697858,-1,1095,1588,0
11286252646,11286252647,1,910,1131,0
11287155281,11287155287,6,1105,1581,0
11290316760,11290316760,0,915,1772,0
11290939823,11290939823,0,1117,1810,0
11292038281,11292038281,0,1996,2367,0
11294014612,11294014613,1,1328,2065,0
11298933238,11298933239,1,1459,1364,0
11301867608,11301867607,-1,1341,2338,0
11302638918,11302638918,0,1705,1784,0
11303489849,11303489849,0,1592,1590,0
11305507821,11305507819,-2,1739,1720,0
11305688230,11305688231,1,1416,1398,0
11311949081,11311949080,-1,1924,1750,0
11312356359,11312356359,0,1270,1009,0
11312591571,11312591573,2,1172,946,0
11313319868,11313319854,-14,4882,1230,0
11317811468,11317811468,0,1476,1408,0
11318594054,11318594055,1,1740,2327,0
11320252201,11320252199,-2,1277,1560,0
11320410852,11320410853,1,1350,2551,0
11321331165,11321331168,3,1525,1675,0
11322829962,11322829964,2,1408,1926,0
11325622222,11325622225,3,1940,1234,0
11328034105,11328034104,-1,1448,2042,0
11335544294,11335544290,-4,877,2403,0
11336586802,11336586802,0,1480,1597,0
11343243734,11343243730,-4,2276,5840,0
11344048845,11344048846,1,1999,2741,0
11344501434,11344501435,1,1544,1785,0
11346795562,11346795565,3,1485,1624,0
11347177421,11347177420,-1,969,1269,0
11348469059,11348469059,0,1776,1440,0
11351664253,11351664254,1,1199,978,0
11352609810,11352609809,-1,1250,1278,0
11359976446,11359976446,0,1210,1976,0
11362556365,11362556368,3,1137,1237,0
11366217536,11366217536,0,1585,2040,0
11368515931,11368515933,2,1522,1933,0
11370134217,11370134219,2,1733,1324,0
11372963565,11372963566,1,1688,1709,0
11376007553,11376007554,1,2345,2261,0
11378565543,11378565541,-2,1257,1794,0
11379534174,11379534175,1,1450,1308,0
11381238658,11381238659,1,786,1442,0
11387102582,11387102581,-1,1134,1849,0
11388220670,11388220671,1,1643,1991,0
11390920535,11390920536,1,1355,1526,0
11393192003,11393192003,0,1152,1398,0
11396393694,11396393695,1,1242,976,0
11397106735,11397106735,0,1298,1289,0
11399051345,11399051346,1,1815,2094,0
11399545379,11399545380,1,1833,2079,0
11403000663,11403000665,2,1825,2251,0
11405514467,11405514472,5,5660,3115,0
11405581168,11405581170,2,1449,1876,0
11411246354,11411246354,0,1217,2055,0
11413181606,11413181605,-1,1432,1562,0
11415069527,11415069525,-2,1209,2125,0
11426355214,11426355216,2,1545,1758,0
11427975063,11427975065,2,1294,1670,0
11428564502,11428564502,0,1714,1260,0
11429263839,11429263855,16,978,1031,0
11430141957,11430141959,2,1133,993,0
11432562694,11432562694,0,1162,1563,0
11435025050,11435025047,-3,901,3202,0
11435796165,11435796166,1,1061,1698,0
11438850443,11438850442,-1,2343,3791,0
11439381237,11439381238,1,1445,1858,0
11440733523,11440733529,6,5123,1980,0
11440789416,11440789417,1,1611,2290,0
11445497928,11445497930,2,1023,1837,0
11449084439,11449084438,-1,1613,2278,0
11449626546,11449626547,1,1631,1957,0
11450096666,11450096667,1,1224,1508,0
11453177062,11453177059,-3,1205,1414,0
11454724707,11454724709,2,1173,1703,0
11458113402,11458113404,2,1297,1708,0
11460589250,11460589250,0,1001,1412,0
11462187383,11462187383,0,886,1315,0
11466004951,11466004952,1,853,1469,0
11469759833,11469759823,-10,4062,12721,0
11471304394,11471304393,-1,1274,1922,0
11471905570,11471905569,-1,1374,1939,0
11475203891,11475203890,-1,2076,2302,0
11477051477,11477051476,-1,1696,2206,0
11483180821,11483180821,0,1454,1607,0
11484704805,11484704807,2,1477,1133,0
11485436915,11485436914,-1,1216,1900,0
11489111922,11489111922,0,1354,956,0
11490474597,11490474598,1,1242,1771,0
11490838531,11490838535,4,1417,1881,0
11496287382,11496287383,1,1116,1200,0
11498235309,11498235309,0,929,1244,0
11499020378,11499020379,1,806,1446,0
11499520853,11499520854,1,1433,1545,0
11499862690,11499862691,1,1129,1444,0
11500560237,11500560241,4,4791,2794,0
11501811521,11501811522,1,1064,877,0
11502431662,11502431662,0,919,2222,0
11502942202,11502942202,0,1292,1703,0
11504893427,11504893426,-1,1048,1583,0
11506172469,11506172468,-1,901,1232,0
11507102391,11507102389,-2,1443,1447,0
11508608832,11508608830,-2,1697,2054,0
11509266624,11509266626,2,842,1172,0
11511411918,11511411919,1,1113,1034,0
11512696583,11512696586,3,2295,1701,0
11513051039,11513051046,7,1602,908,0
11513133063,11513133059,-4,1275,2025,0
11513291907,11513291909,2,1289,1830,0
11514366694,11514366688,-6,1660,3424,0
11520628246,11520628245,-1,1646,1514,0
11520884120,11520884114,-6,2267,6246,0
11521227146,11521227146,0,1138,1445,0
11522983329,11522983330,1,1709,1484,0
11524951414,11524951415,1,933,1203,0
11528283184,11528283184,0,1245,1327,0
11533949673,11533949672,-1,1170,1771,0
11534445882,11534445882,0,1476,1528,0
11536550566,11536550565,-1,943,1418,0
11538220882,11538220882,0,1497,1774,0
11541514182,11541514181,-1,695,1297,0
11541919655,11541919655,0,1000,1905,0
11542646998,11542646998,0,980,1618,0
11546409020,11546409020,0,1056,2096,0
11547279590,11547279589,-1,1656,1927,0
11550562170,11550562173,3,1400,1936,0
11550633834,11550633835,1,1426,1565,0
11551112181,11551112182,1,1340,1283,0
11552831879,11552831878,-1,1294,1836,0
11553224672,11553224679,7,5360,2113,0
11553697959,11553697960,1,1198,1635,0
11554206978,11554206998,20,674,1069,0
11557027045,11557027043,-2,1207,1346,0
11559141983,11559141985,2,1135,1656,0
11560739914,11560739914,0,1307,1601,0
11562603241,11562603241,0,1553,2487,0
11564807407,11564807409,2,1295,1956,0
11566161842,11566161838,-4,1084,2323,0
11566489998,11566489999,1,1437,1531,0
11567419714,11567419715,1,1284,1450,0
11569077845,11569077839,-6,1129,3773,0
11572224887,11572224890,3,1368,1861,0
11573251485,11573251485,0,1269,1974,0
11576254347,11576254346,-1,1444,1362,0
11583120125,11583120124,-1,2110,3153,0
11586457169,11586457169,0,1381,1252,0
11589092959,11589092959,0,1260,1421,0
11590065207,11590065207,0,1334,917,0
11592545635,11592545635,0,1366,1162,0
11593381816,11593381817,1,1221,2169,0
11595927995,11595927998,3,1560,1661,0
11595958789,11595958789,0,1270,1144,0
11596825077,11596825079,2,19664,20836,0
11605213302,11605213324,22,950,757,0
11607474994,11607474994,0,1582,1792,0
11610008011,11610008010,-1,1138,2207,0
11611283669,11611283670,1,1221,2337,0
11611562933,11611562934,1,1155,1206,0
11615632115,11615632115,0,1551,1652,0
11616022888,11616022887,-1,741,1196,0
11619261387,11619261389,2,1588,1237,0
11619604194,11619604193,-1,1211,1794,0
11620505267,11620505268,1,1135,2007,0
11621026149,11621026150,1,1376,1772,0
11621379774,11621379774,0,1530,2093,0
11625551216,11625551216,0,2140,2489,0
11627424019,11627424018,-1,1515,2469,0
11629004306,11629004308,2,1884,2013,0
11629135076,11629135074,-2,1137,1802,0
11631298638,11631298635,-3,934,1902,0
11631666378,11631666380,2,1569,919,0
11632868672,11632868653,-19,5,879,0
11633081236,11633081234,-2,117,773,0
11638380367,11638380366,-1,944,893,0
11639581246,11639581246,0,1681,1539,0
11642470866,11642470875,9,9976,31113,0
11644919678,11644919678,0,1118,1620,0
11645084678,11645084678,0,1312,1507,0
11645680050,11645680050,0,1384,1782,0
11646668507,11646668505,-2,1110,2557,0
11648096533,11648096534,1,1602,1658,0
11649586327,11649586330,3,1489,1366,0
11650102545,11650102545,0,1441,1750,0
11650924466,11650924466,0,795,1082,0
11653009907,11653009908,1,1126,1516,0
11654915714,11654915716,2,1485,2037,0
11655085640,11655085638,-2,987,1538,0
11658698510,11658698510,0,1231,1246,0
11658957880,11658957878,-2,1835,3064,0
11659543619,11659543614,-5,1051,1362,0
11661659306,11661659308,2,1235,1569,0
11670405537,11670405538,1,911,969,0
11670755475,11670755474,-1,970,1715,0
11673046735,11673046735,0,971,1474,0
11675323282,11675323281,-1,904,1407,0
11676840743,11676840743,0,1001,1180,0
11676950702,11676950702,0,1707,1526,0
11677097873,11677097871,-2,1084,1995,0
11677634396,11677634397,1,1491,1570,0
11681178778,11681178777,-1,1275,1655,0
11681807566,11681807566,0,1351,1062,0
11683937616,11683937621,5,2355,1203,0
11689132226,11689132229,3,1927,1810,0
11690001122,11690001122,0,1258,1509,0
11690572367,11690572367,0,1261,1692,0
11693883493,11693883494,1,1353,1332,0
11694268952,11694268950,-2,1041,1562,0
11699761943,11699761942,-1,1284,1424,0
11701376789,11701376790,1,1366,1234,0
11703078185,11703078186,1,1423,1490,0
11703344202,11703344203,1,1309,1257,0
11703865306,11703865306,0,935,1381,0
11708200355,11708200356,1,1767,1590,0
11709274412,11709274410,-2,1559,2383,0
11711337683,11711337678,-5,1229,1041,0
11716611403,11716611403,0,1304,1584,0
11718012353,11718012355,2,2164,1985,0
11719129969,11719129969,0,1073,1311,0
11719706570,11719706570,0,1569,1704,0
11722811685,11722811685,0,1222,1568,0
11726950254,11726950255,1,2199,1885,0
11728247347,11728247349,2,1530,1553,0
11730968310,11730968309,-1,1188,1399,0
11736223361,11736223365,4,4287,3154,0
11736585707,11736585706,-1,1995,1574,0
11738444782,11738444783,1,997,1407,0
11745182517,11745182518,1,1115,1296,0
11752300590,11752300588,-2,1323,1563,0
11756810426,11756810428,2,1393,1816,0
11759695364,11759695365,1,1680,1497,0
11763133623,11763133622,-1,701,1035,0
11763525298,11763525299,1,1372,1878,0
11767896533,11767896536,3,1250,1806,0
11768630571,11768630571,0,1702,1369,0
11770056885,11770056885,0,1029,1159,0
11773694122,11773694119,-3,1266,1282,0
11774222727,11774222726,-1,1330,1359,0
11774399163,11774399164,1,1284,1540,0
11778019706,11778019707,1,1206,1360,0
11779567398,11779567399,1,1632,1958,0
11781829373,11781829373,0,798,1652,0
11781878046,11781878046,0,1120,1661,0
11782319063,11782319063,0,878,1388,0
11783127267,11783127267,0,972,1222,0
11783201687,11783201700,13,26397,17108,0
11783562950,11783562953,3,782,924,0
11783919457,11783919479,22,2566,1011,0
11786014172,11786014173,1,1577,1564,0
11787193831,11787193830,-1,1530,1922,0
11787272459,11787272460,1,1024,2092,0
11789151090,11789151092,2,1096,1552,0
11790742520,11790742522,2,820,1014,0
11797654722,11797654721,-1,933,1784,0
11798850985,11798850978,-7,820,1239,0
11799316205,11799316205,0,1401,1873,0
11799685037,11799685035,-2,2331,2780,0
11803100926,11803100927,1,1274,1781,0
11807420657,11807420659,2,3153,2931,0
11810171581,11810171581,0,1872,1854,0
11811999589,11811999589,0,1241,2474,0
11813113006,11813113004,-2,1061,1718,0
11821595413,11821595411,-2,1313,1387,0
11823339487,11823339491,4,729,1040,0
11823805703,11823805702,-1,1283,1920,0
11824395325,11824395326,1,1375,1935,0
11826386226,11826386228,2,1544,1679,0
11826929326,11826929318,-8,1105,1448,0
11827370406,11827370404,-2,1234,1540,0
11831811850,11831811852,2,1174,1451,0
11834553182,11834553182,0,1586,1872,0
11836699465,11836699465,0,1161,1060,0
11839346941,11839346936,-5,572,1916,0
11839718199,11839718198,-1,1787,2117,0
11840835790,11840835790,0,1716,2346,0
11841434146,11841434145,-1,1490,1841,0
11841958022,11841958023,1,1805,1613,0
11843974462,11843974461,-1,1395,2139,0
11844713065,11844713066,1,1522,1877,0
11848636882,11848636882,0,1358,1951,0
11849875761,11849875762,1,1737,1384,0
11851624898,11851624897,-1,1465,1736,0
11853138935,11853138936,1,1311,1487,0
11854070227,11854070229,2,1386,1677,0
11854277091,11854277092,1,1510,1801,0
11855416761,11855416762,1,2312,2386,0
11856925668,11856925665,-3,1239,1844,0
11860923028,11860923027,-1,1445,1769,0
11861423662,11861423663,1,1329,1479,0
11862165716,11862165707,-9,1858,2393,0
11862656497,11862656499,2,1622,1813,0
11863431237,11863431238,1,1036,1638,0
11864688138,11864688138,0,932,1425,0
11869453432,11869453434,2,2070,2575,0
11870335966,11870335964,-2,864,775,0
11873316894,11873316899,5,3012,1563,0
11873911701,11873911698,-3,1051,1386,0
11876016719,11876016720,1,1412,1670,0
11876080182,11876080183,1,929,1702,0
11880331771,11880331770,-1,1349,2045,0
11881005013,11881005013,0,2069,3396,0
11882386102,11882386103,1,1640,1561,0
11882569594,11882569594,0,1379,1912,0
11882849515,11882849514,-1,1511,1478,0
11883397411,11883397425,14,874,1369,0
11883588302,11883588306,4,1438,1759,0
11885059149,11885059149,0,1860,1743,0
11885812760,11885812759,-1,1464,1516,0
11886507530,11886507530,0,1415,1053,0
11888060791,11888060769,-22,936,838,0
11891672290,11891672290,0,1100,1756,0
11893074888,11893074889,1,1098,1575,0
11902672926,11902672926,0,1057,1059,0
11903323741,11903323743,2,1354,1252,0
11903417656,11903417675,19,1485,1849,0
11907416978,11907416978,0,1684,1686,0
11909501387,11909501379,-8,923,8522,0
11909765015,11909765015,0,1090,1521,0
11909792557,11909792557,0,1822,2286,0
11910444159,11910444161,2,1697,1934,0
11912055787,11912055788,1,784,1400,0
11912552272,11912552271,-1,2149,1695,0
11912653154,11912653153,-1,923,1218,0
11913708173,11913708174,1,1403,1772,0
11913983597,11913983599,2,1414,1682,0
11915695017,11915695017,0,2360,2196,0
11919198083,11919198081,-2,1214,1624,0
11922055891,11922055891,0,2123,2360,0
11922464392,11922464374,-18,1297,1882,0
11925941465,11925941466,1,1238,2074,0
11928395606,11928395606,0,1568,2225,0
11929692930,11929692930,0,1447,1965,0
11934547718,11934547715,-3,952,2529,0
11935567025,11935567022,-3,1520,1787,0
11937351510,11937351509,-1,1447,2349,0
11940099821,11940099818,-3,1341,1763,0
11940602956,11940602960,4,1649,1381,0
11941538560,11941538561,1,1839,1591,0
11942124909,11942124928,19,923,1486,0
11944570084,11944570082,-2,1460,1676,0
11945882405,11945882413,8,9927,2274,0
11949337158,11949337159,1,1371,2018,0
11950190446,11950190446,0,852,1384,0
11952108674,11952108676,2,1180,1338,0
11955357932,11955357931,-1,19286,12269,0
11957620042,11957620041,-1,1971,2493,0
11958859751,11958859753,2,1461,2092,0
11959248912,11959248888,-24,48,1082,0
11959813901,11959813899,-2,1449,2605,0
11960264884,11960264906,22,1093,1861,0
11961927573,11961927571,-2,1577,1648,0
11963115670,11963115670,0,1498,1810,0
11966302230,11966302229,-1,1313,1755,0
11971544952,11971544954,2,2352,1772,0
11973110550,11973110550,0,1073,1154,0
11975222825,11975222825,0,1206,2556,0
11975382786,11975382787,1,1175,1733,0
11976009963,11976009963,0,971,1556,0
11976514111,11976514114,3,1384,1933,0
11981074929,11981074933,4,1351,1428,0
11981821518,11981821519,1,716,1554,0
11982784095,11982784094,-1,1323,1721,0
11983447520,11983447523,3,1377,1747,0
11983852018,11983852023,5,1670,1222,0
11984834440,11984834441,1,1565,1939,0
11988585765,11988585769,4,2137,1124,0
11991234460,11991234461,1,1450,1841,0
11993301979,11993301978,-1,1158,1656,0
11994122366,11994122370,4,1275,1372,0
11996210016,11996210016,0,1601,1661,0
11997646186,11997646180,-6,1304,5477,0
11998456240,11998456239,-1,1175,1270,0
12001349430,12001349429,-1,1329,1972,0
12001665344,12001665363,19,1335,2161,0
12002252366,12002252364,-2,1108,2340,0
12002554884,12002554873,-11,1124,1152,0
12002906974,12002906954,-20,1669,1623,0
12003939908,12003939909,1,2082,1853,0
12004580427,12004580428,1,1180,1770,0
12004842358,12004842359,1,1346,1920,0
12005772363,12005772363,0,748,812,0
12009666301,12009666302,1,1909,2087,0
12009759204,12009759204,0,1264,1955,0
12010223226,12010223226,0,1108,1364,0
12013236003,12013236001,-2,1481,2070,0
12013980538,12013980539,1,1269,1136,0
12017709676,12017709677,1,1904,1449,0
12018448101,12018448103,2,1003,1298,0
12018928440,12018928442,2,1718,2345,0
12023752535,12023752533,-2,1053,1508,0
12031966016,12031966017,1,1579,1692,0
12032940246,12032940246,0,1768,1861,0
12034007546,12034007545,-1,1371,1754,0
12034493331,12034493331,0,1607,1800,0
12035499606,12035499606,0,1395,1457,0
12037320002,12037319998,-4,1015,2513,0
12043365160,12043365163,3,1392,1374,0
12044269543,12044269542,-1,1071,1211,0
12045058517,12045058516,-1,1150,2116,0
12045397348,12045397351,3,2162,2844,0
12046310519,12046310517,-2,1001,1733,0
12048598650,12048598650,0,1193,1566,0
12050523369,12050523376,7,4276,2423,0
12052398009,12052398010,1,1542,1052,0
12053251335,12053251336,1,1583,1815,0
12054459821,12054459823,2,1194,1457,0
12056289345,12056289347,2,1401,1810,0
12058242898,12058242898,0,1510,1424,0
12061148525,12061148523,-2,1431,1960,0
12062036453,12062036454,1,999,1114,0
12062223343,12062223322,-21,1011,3735,0
12064043880,12064043881,1,1336,1722,0
12065480984,12065480978,-6,1604,5356,0
12066504227,12066504235,8,4459,970,0
12068398515,12068398517,2,1439,1670,0
12068873970,12068873965,-5,790,1597,0
12069495284,12069495284,0,1498,1492,0
12070883336,12070883334,-2,1075,2453,0
12071022706,12071022708,2,1478,1240,0
12071400397,12071400399,2,1257,1214,0
12073826187,12073826186,-1,1293,1940,0
12074114743,12074114744,1,1747,1796,0
12080113397,12080113398,1,1591,1531,0
12080846693,12080846695,2,1916,1842,0
12081269482,12081269482,0,1853,1650,0
12083414275,12083414275,0,1500,2372,0
12083649891,12083649892,1,1242,2365,0
12084125507,12084125506,-1,1247,1887,0
12084474678,12084474662,-16,1138,1883,0
12084626131,12084626133,2,1047,1520,0
12087614590,12087614591,1,1055,2106,0
12089674007,12089674010,3,1184,1677,0
12090148595,12090148594,-1,1335,1801,0
12091784017,12091784019,2,1613,1640,0
12093279885,12093279882,-3,999,2015,0
12093692187,12093692187,0,1425,1848,0
12099558631,12099558631,0,993,1493,0
12103324354,12103324356,2,910,1474,0
12106285283,12106285282,-1,1145,1177,0
12107307550,12107307550,0,1116,1852,0
12113622325,12113622323,-2,1355,1720,0
12117891769,12117891769,0,1567,1717,0
12118706174,12118706176,2,1465,1809,0
12120562679,12120562682,3,845,781,0
12122646055,12122646057,2,1156,1374,0
12123562713,12123562711,-2,1427,2039,0
12130270398,12130270406,8,3076,930,0
12133633206,12133633207,1,1217,1654,0
12133732733,12133732718,-15,1225,1637,0
12134512661,12134512660,-1,1648,2518,0
12139798702,12139798702,0,1234,1210,0
12141608138,12141608138,0,722,765,0
12141902287,12141902303,16,1067,1796,0
12151364417,12151364418,1,1641,2151,0
12152979975,12152979981,6,4943,2287,0
12154237906,12154237902,-4,1138,1427,0
12154505855,12154505859,4,1004,1012,0
12157501968,12157501967,-1,1001,1238,0
12159270773,12159270774,1,2478,2390,0
12159646497,12159646497,0,1204,1369,0
12160018494,12160018495,1,1518,2374,0
12161231364,12161231366,2,1622,2128,0
12163663568,12163663570,2,1258,1275,0
12164227141,12164227142,1,1160,999,0
12166497280,12166497280,0,1776,2064,0
12168038066,12168038066,0,1225,1259,0
12169161050,12169161049,-1,1922,1743,0
12171432261,12171432262,1,1202,1638,0
12175052571,12175052571,0,1019,1360,0
12175234297,12175234297,0,1803,1719,0
12178213134,12178213134,0,1940,1659,0
12180755826,12180755826,0,1111,1275,0
12187955405,12187955407,2,1633,1658,0
12188534491,12188534491,0,1648,1446,0
12190162637,12190162637,0,1286,1661,0
12190387754,12190387754,0,1320,2231,0
12193015463,12193015462,-1,1887,2337,0
12194035905,12194035905,0,1478,1800,0
12198182165,12198182163,-2,1128,1022,0
12201280586,12201280586,0,1308,1715,0
12202146664,12202146665,1,1617,2066,0
12206204727,12206204729,2,1341,1618,0
12211840765,12211840765,0,1511,1763,0
12213150690,12213150691,1,1063,1112,0
12215362314,12215362314,0,913,1947,0
12217877075,12217877073,-2,1252,1619,0
12218795942,12218795942,0,1125,1547,0
12219765023,12219765023,0,1511,1404,0
12222832221,12222832219,-2,731,1525,0
12223855618,12223855617,-1,866,1310,0
12227009972,12227009971,-1,638,1157,0
12228762631,12228762635,4,1140,1522,0
12228888647,12228888645,-2,1499,2635,0
12229448086,12229448086,0,894,1069,0
12231138649,12231138649,0,943,1450,0
12234776192,12234776194,2,1713,1677,0
12236281304,12236281303,-1,1149,1587,0
12238250674,12238250674,0,1139,1500,0
12238668309,12238668309,0,1220,1654,0
12248680011,12248680011,0,1660,2086,0
12248747245,12248747247,2,1822,766,0
12249173054,12249173053,-1,964,2109,0
12250612420,12250612422,2,967,1512,0
12250920738,12250920742,4,1642,1366,0
12253008711,12253008710,-1,1606,1870,0
12253461418,12253461419,1,1554,1897,0
12261635328,12261635326,-2,1462,1776,0
12262324175,12262324175,0,1909,2166,0
12262458207,12262458208,1,1125,1372,0
12264240881,12264240882,1,1537,1463,0
12264510202,12264510202,0,1288,1661,0
12266201464,12266201464,0,1421,2074,0
12271042289,12271042289,0,1153,1140,0
12281035727,12281035729,2,823,1389,0
12282593841,12282593842,1,1232,1915,0
12283372952,12283372954,2,1332,1151,0
12284750402,12284750401,-1,1663,1841,0
12284891280,12284891281,1,1764,1881,0
12285588788,12285588787,-1,1289,1278,0
12286547987,12286547988,1,1383,2270,0
12290887234,12290887249,15,10311,1674,0
12294594721,12294594720,-1,1060,1767,0
12295699562,12295699563,1,1885,2039,0
12300146909,12300146915,6,3039,991,0
12303865813,12303865802,-11,1360,1772,0
12304697856,12304697856,0,3283,3119,0
12308464464,12308464450,-14,1305,1886,0
12308573945,12308573945,0,1053,1051,0
12308765634,12308765635,1,1149,1287,0
12313745795,12313745794,-1,1244,1580,0
12315575154,12315575153,-1,1095,1717,0
12318768050,12318768054,4,912,1552,0
12322383887,12322383889,2,1761,1595,0
12325338821,12325338822,1,935,1680,0
12326137078,12326137078,0,1998,1866,0
12328940446,12328940446,0,1335,1719,0
12330101310,12330101310,0,1586,2397,0
12330258662,12330258665,3,1175,1843,0
12330561425,12330561426,1,3073,1651,0
12331660553,12331660554,1,1887,1548,0
12333253549,12333253550,1,1508,1612,0
12333936607,12333936607,0,1103,1135,0
12336843677,12336843679,2,1692,1267,0
12339098498,12339098502,4,3235,1202,0
12339654821,12339654822,1,1548,1653,0
12341465161,12341465162,1,2025,1691,0
12347799669,12347799669,0,1244,2046,0
12348460604,12348460594,-10,1253,1706,0
12348806661,12348806662,1,1649,1715,0
12349185545,12349185545,0,1444,1239,0
12349823666,12349823666,0,1604,1768,0
12350489061,12350489060,-1,1882,2646,0
12350696085,12350696086,1,1171,1267,0
12353271381,12353271382,1,1288,1856,0
12355934750,12355934750,0,1290,1454,0
12357778802,12357778803,1,1674,1615,0
12357868057,12357868058,1,1293,1407,0
12359898128,12359898127,-1,1513,2011,0
12362332046,12362332047,1,908,1036,0
12364776917,12364776914,-3,1141,1445,0
12367164930,12367164930,0,1676,2027,0
12367572499,12367572500,1,1133,1367,0
12370012538,12370012537,-1,1398,1714,0
12370167354,12370167355,1,1197,1580,0
12372759246,12372759247,1,1996,2817,0
12375302514,12375302514,0,1811,1662,0
12375628493,12375628496,3,1918,1395,0
12377209529,12377209528,-1,1996,1947,0
12379654725,12379654726,1,1208,1279,0
12380321237,12380321236,-1,1165,918,0
12380465839,12380465830,-9,1434,1789,0
12380995590,12380995577,-13,1293,1980,0
12383540019,12383540021,2,1416,1703,0
12384641762,12384641759,-3,1175,1915,0
12385537593,12385537594,1,1540,2350,0
12387420427,12387420426,-1,1696,2025,0
12389481879,12389481879,0,1401,1658,0
12390024732,12390024723,-9,167,417,0
12393100690,12393100690,0,1871,1815,0
12396617142,12396617141,-1,1129,1736,0
12397143581,12397143602,21,1327,2133,0
12398754078,12398754078,0,1527,1443,0
12398914771,12398914770,-1,1713,1580,0
12398944418,12398944417,-1,828,1392,0
12399457778,12399457779,1,1521,1349,0
12400750730,12400750729,-1,1445,1705,0
12401194919,12401194920,1,1401,1982,0
12402600626,12402600625,-1,1283,1698,0
12402765576,12402765578,2,1846,1439,0
12406595543,12406595544,1,2608,3186,0
12406974846,12406974846,0,974,1464,0
12413321731,12413321733,2,1878,1848,0
12413366381,12413366378,-3,1215,1676,0
12414809490,12414809489,-1,1801,2426,0
12418656910,12418656907,-3,1495,1947,0
12419098282,12419098282,0,1147,1831,0
12421517438,12421517438,0,1358,990,0
12425557067,12425557067,0,1503,1856,0
12426741295,12426741297,2,999,1399,0
12428109075,12428109075,0,1353,1211,0
12428603899,12428603903,4,718,1246,0
12430363690,12430363690,0,1216,1236,0
12433853959,12433853959,0,1350,2406,0
12437024022,12437024025,3,1480,1304,0
12437972688,12437972689,1,1687,1727,0
12438019186,12438019186,0,826,1436,0
12439614690,12439614691,1,1282,1670,0
12441314342,12441314343,1,1051,1584,0
12441770667,12441770667,0,1331,1446,0
12442936682,12442936684,2,2018,1647,0
12446892166,12446892166,0,1051,1052,0
12447094771,12447094771,0,1272,1310,0
12450145565,12450145585,20,943,1134,0
12452196871,12452196873,2,1230,1306,0
12453482553,12453482553,0,2127,2245,0
12453836003,12453836002,-1,1531,2169,0
12454446787,12454446785,-2,1421,1279,0
12457564894,12457564894,0,1448,1748,0
12459171700,12459171722,22,1494,1659,0
12460295586,12460295586,0,1052,1263,0
12464550163,12464550162,-1,993,1845,0
12465530306,12465530308,2,1759,1350,0
12467708049,12467708050,1,1270,1140,0
12469907033,12469907032,-1,1943,2406,0
12469991201,12469991202,1,994,1635,0
12471944514,12471944514,0,1051,1317,0
12473369411,12473369412,1,1095,1338,0
12473802275,12473802272,-3,1934,5993,0
12475528657,12475528657,0,2228,1883,0
12475954114,12475954114,0,893,1253,0
12479254954,12479254951,-3,1208,2485,0
12479324936,12479324937,1,1290,1936,0
12486212527,12486212529,2,1350,1506,0
12489743731,12489743732,1,1218,1883,0
12495156532,12495156533,1,1622,1548,0
12496369502,12496369523,21,1781,2900,0
12498622370,12498622369,-1,1589,1792,0
12499248106,12499248106,0,1378,1178,0
12499748109,12499748110,1,1817,1815,0
12501066830,12501066835,5,1309,1114,0
12501900807,12501900805,-2,1739,2286,0
12502682881,12502682884,3,1546,1948,0
12504675206,12504675206,0,1204,1615,0
12505709178,12505709178,0,1320,1835,0
12507955231,12507955230,-1,1268,2015,0
12508113799,12508113817,18,1198,1499,0
12510895288,12510895287,-1,1741,1758,0
12511043184,12511043184,0,1143,1693,0
12513007165,12513007165,0,1606,3147,0
12514650309,12514650309,0,1234,1700,0
12515453562,12515453562,0,1468,1836,0
12520317781,12520317783,2,1330,1395,0
12523944899,12523944897,-2,1284,2014,0
12532752050,12532752051,1,1428,1784,0
12533128307,12533128310,3,1537,1555,0
12535408006,12535408009,3,1090,1218,0
12535751963,12535751964,1,1274,1383,0
12536727159,12536727159,0,2238,1975,0
12537232866,12537232869,3,1582,1884,0
12538095614,12538095613,-1,1086,1437,0
12539494682,12539494682,0,2076,2805,0
12540223122,12540223125,3,2216,2236,0
12540803618,12540803619,1,28114,20774,0
12543549984,12543549982,-2,1119,2519,0
12545400306,12545400305,-1,1091,1725,0
12550448670,12550448671,1,1591,1702,0
12551847267,12551847268,1,1062,2095,0
12552419557,12552419555,-2,1111,1661,0
12556019693,12556019699,6,4653,2586,0
12558562298,12558562299,1,781,1359,0
12558718773,12558718773,0,1270,1361,0
12561613036,12561613034,-2,1199,1914,0
12563632309,12563632308,-1,984,1432,0
12565044236,12565044237,1,1412,1878,0
12568915878,12568915878,0,1023,1256,0
12572415241,12572415242,1,1528,1290,0
12572981801,12572981801,0,469,946,0
12575413058,12575413042,-16,1915,2398,0
12576041971,12576041973,2,1309,1603,0
12576865020,12576865021,1,1901,1862,0
12577329842,12577329845,3,1269,1985,0
12580383330,12580383330,0,645,1372,0
12581485715,12581485717,2,1013,1122,0
12584554457,12584554457,0,1757,2576,0
12588606171,12588606172,1,966,1756,0
12590361093,12590361094,1,1229,1787,0
12593429322,12593429325,3,2148,1551,0
12593652872,12593652872,0,2201,1472,0
12594982313,12594982313,0,1478,2170,0
12599696775,12599696774,-1,1094,1305,0
12600624579,12600624581,2,1335,2077,0
12601182321,12601182320,-1,1181,1795,0
12602416087,12602416086,-1,1495,1549,0
12605924557,12605924558,1,1203,1083,0
12609720841,12609720839,-2,981,1455,0
12610831265,12610831265,0,1977,2018,0
12613402223,12613402223,0,1319,1612,0
12616020865,12616020867,2,1372,1396,0
12617230321,12617230321,0,1330,1603,0
12618815039,12618815043,4,1266,1527,0
12619338934,12619338935,1,1337,1547,0
12621888021,12621888041,20,792,1337,0
12628033958,12628033958,0,1286,1067,0
12631153486,12631153487,1,1191,1283,0
12632219533,12632219531,-2,1325,1514,0
12634344309,12634344311,2,1348,1790,0
12634651700,12634651701,1,2040,1915,0
12635377186,12635377186,0,1121,1358,0
12636072306,12636072307,1,1749,1263,0
12636417697,12636417697,0,1397,1838,0
12638351971,12638351973,2,1345,1523,0
12644737800,12644737800,0,2065,2250,0
12644918014,12644918014,0,1378,2373,0
12645975487,12645975489,2,887,1201,0
12649481975,12649481976,1,1597,1597,0
12649999737,12649999737,0,1406,1703,0
12653107004,12653107005,1,1117,1833,0
12655710414,12655710419,5,1229,1569,0
12655736947,12655736946,-1,1107,1234,0
12657318601,12657318603,2,1430,1985,0
12659886801,12659886801,0,2157,2448,0
12667593782,12667593781,-1,1182,1220,0
12668085546,12668085538,-8,2876,10898,0
12671555111,12671555117,6,4267,2841,0
12672042594,12672042595,1,1464,1688,0
12678036581,12678036583,2,1747,1251,0
12679924322,12679924323,1,1316,1640,0
12681927820,12681927822,2,1185,1089,0
12682827262,12682827265,3,1276,1418,0
12682964528,12682964530,2,1432,1419,0
12683853515,12683853515,0,1117,1950,0
12685579859,12685579857,-2,1340,1739,0
12685663274,12685663277,3,1378,1603,0
12685950148,12685950150,2,975,1916,0
12689341744,12689341745,1,1685,2080,0
12689523227,12689523208,-19,1777,1714,0
12690788086,12690788086,0,1430,1277,0
12690842874,12690842877,3,2014,1331,0
12693445285,12693445284,-1,1751,2359,0
12693668297,12693668299,2,1458,1597,0
12695299330,12695299331,1,1704,1896,0
12699493795,12699493789,-6,930,4040,0
12703200255,12703200258,3,1592,1061,0
12703984442,12703984451,9,2880,1269,0
12704338395,12704338396,1,1479,1756,0
12704997134,12704997134,0,1181,1474,0
12706557226,12706557225,-1,1111,1500,0
12709091230,12709091230,0,1071,1349,0
12710018813,12710018812,-1,1034,2517,0
12710630538,12710630538,0,1057,1436,0
12712433627,12712433647,20,457,858,0
12720034869,12720034870,1,1531,1672,0
12722090127,12722090127,0,1066,1513,0
12722460591,12722460591,0,929,1432,0
12723438054,12723438055,1,1497,1762,0
12724894950,12724894950,0,1479,1651,0
12728532069,12728532067,-2,1895,2319,0
12728806993,12728806991,-2,1224,1745,0
12734518734,12734518736,2,1819,1876,0
12737645248,12737645250,2,2414,2127,0
12737734453,12737734461,8,2455,755,0
12737785554,12737785559,5,1989,1634,0
12738400783,12738400798,15,892,1400,0
12742280090,12742280090,0,1631,1054,0
12749692104,12749692119,15,344,844,0
12752023244,12752023251,7,5423,1425,0
12753403058,12753403054,-4,5523,12931,0
12754016907,12754016907,0,1177,2224,0
12754243677,12754243677,0,1535,2002,0
12754748141,12754748139,-2,1222,1641,0
12754822026,12754822026,0,1243,1430,0
12763161602,12763161600,-2,1268,1911,0
12763611172,12763611174,2,1433,1173,0
12764002159,12764002161,2,1926,1869,0
12767697869,12767697869,0,1093,2287,0
12770758633,12770758635,2,913,1212,0
12774469189,12774469189,0,1647,1331,0
12774882921,12774882922,1,1840,1896,0
12775183082,12775183082,0,1406,1643,0
12779694359,12779694360,1,1052,1400,0
12781305578,12781305579,1,890,2216,0
12784571694,12784571695,1,852,1911,0
12785712130,12785712134,4,1045,1412,0
12787069850,12787069849,-1,1118,1748,0
12789242743,12789242743,0,1078,1482,0
12790129833,12790129834,1,1747,1827,0
12792474510,12792474510,0,1551,1652,0
12792739815,12792739813,-2,1188,1689,0
12794022858,12794022858,0,1641,1820,0
12795054682,12795054682,0,1289,1772,0
12795453017,12795453022,5,1500,932,0
12795764482,12795764482,0,1585,1664,0
12796007898,12796007911,13,15786,20169,0
12796770212,12796770212,0,1648,2638,0
12798759946,12798759947,1,1078,1941,0
12806434558,12806434558,0,1572,1742,0
12806915042,12806915042,0,2012,2397,0
12810868970,12810868969,-1,1062,1913,0
12811057859,12811057858,-1,701,1531,0
12813712445,12813712446,1,1612,1687,0
12814600251,12814600252,1,2143,2938,0
12816349879,12816349881,2,1144,1523,0
12816580794,12816580794,0,1233,1332,0
12821340539,12821340538,-1,1246,2027,0
12823140981,12823140992,11,744,1082,0
12823524755,12823524754,-1,1297,2353,0
12823798427,12823798429,2,1364,1755,0
12823947131,12823947108,-23,1096,1255,0
12825938110,12825938113,3,1702,1396,0
12827315676,12827315676,0,1640,1769,0
12830556846,12830556848,2,1426,1994,0
12832002613,12832002612,-1,1149,1744,0
12834983339,12834983343,4,1949,1092,0
12835267684,12835267685,1,1573,2255,0
12839603671,12839603671,0,1255,1971,0
12840909475,12840909475,0,906,1227,0
12841510243,12841510242,-1,1275,1992,0
12842937972,12842937972,0,1655,1849,0
12846782087,12846782086,-1,1146,1469,0
12849097532,12849097533,1,1667,1708,0
12849187902,12849187909,7,3863,1106,0
12851436542,12851436543,1,1317,1085,0
12851891369,12851891369,0,1704,2928,0
12857611025,12857611037,12,15887,37333,0
12858374086,12858374087,1,1442,2009,0
12860552266,12860552270,4,2723,1711,0
12861462778,12861462778,0,1481,2048,0
12862837285,12862837284,-1,1271,1287,0
12863113989,12863113989,0,1170,1410,0
12863418395,12863418395,0,1147,1753,0
12863444251,12863444250,-1,795,1196,0
12863914494,12863914495,1,1199,1842,0
12867423108,12867423109,1,1588,1449,0
12867884054,12867884056,2,820,1297,0
12869294175,12869294174,-1,678,1254,0
12869840853,12869840854,1,2222,2339,0
12872549931,12872549951,20,1236,2052,0
12873259950,12873259949,-1,1443,2365,0
12873889634,12873889635,1,1164,694,0
12875184602,12875184601,-1,1387,1984,0
12877497834,12877497834,0,1503,1554,0
12881377455,12881377455,0,620,835,0
12881568795,12881568795,0,1471,2095,0
12883813797,12883813789,-8,2102,10253,0
12883938169,12883938164,-5,1226,5195,0
12884676254,12884676255,1,1242,1440,0
12893178882,12893178883,1,1439,1783,0
12893898798,12893898813,15,893,1400,0
12895925281,12895925280,-1,1070,1493,0
12896628957,12896628957,0,968,1252,0
12897630545,12897630544,-1,1153,1083,0
12899691079,12899691081,2,2011,2336,0
12901991095,12901991094,-1,956,1082,0
12906618295,12906618294,-1,1118,1850,0
12908462346,12908462345,-1,1680,1465,0
12908975798,12908975805,7,10363,26285,0
12909263412,12909263415,3,1436,1701,0
12910750323,12910750323,0,1490,1785,0
12911177228,12911177227,-1,1147,1055,0
12913511197,12913511202,5,2566,1231,0
12915128955,12915128957,2,1329,2078,0
12916574827,12916574827,0,1135,1428,0
12918269774,12918269779,5,175,1943,0
12926605422,12926605422,0,1448,1603,0
12927137140,12927137139,-1,1135,984,0
12928745509,12928745510,1,1548,1623,0
12929177980,12929177981,1,1271,1298,0
12929357567,12929357578,11,13507,26494,0
12929872035,12929872035,0,1133,1213,0
12937860472,12937860471,-1,1185,1605,0
12938062720,12938062720,0,1012,1535,0
12939604526,12939604524,-2,1189,2150,0
12940067801,12940067801,0,1748,2151,0
12947798227,12947798227,0,1522,1622,0
12948885216,12948885217,1,1311,1411,0
12951416841,12951416842,1,1729,1983,0
12956240659,12956240660,1,1398,1750,0
12960490650,12960490649,-1,1561,1545,0
12960768399,12960768399,0,1488,1520,0
12962108763,12962108761,-2,2223,5188,0
12964036612,12964036612,0,1199,1557,0
12964110241,12964110242,1,1630,1269,0
12965215746,12965215743,-3,1108,1558,0
12965604611,12965604613,2,1167,1765,0
12966881238,12966881238,0,1472,1107,0
12968866528,12968866527,-1,1406,2303,0
12975399754,12975399756,2,1211,1544,0
12979423077,12979423058,-19,723,1096,0
12980535451,12980535452,1,1277,1331,0
12982343733,12982343734,1,1163,1443,0
12989597699,12989597700,1,1573,1804,0
12995850495,12995850497,2,1417,1595,0
12999408580,12999408586,6,21030,29272,0
13002908178,13002908178,0,1189,1722,0
13006235510,13006235511,1,1236,1234,0
13006547454,13006547453,-1,1781,1536,0
13007895850,13007895851,1,1257,1364,0
13008006942,13008006937,-5,1462,1584,0
13008439698,13008439697,-1,1890,3752,0
13013997369,13013997369,0,1235,1429,0
13014983749,13014983754,5,2413,1428,0
13015802403,13015802413,10,1539,1565,0
13017205080,13017205078,-2,1115,1406,0
13018216957,13018216957,0,1715,2312,0
13018621339,13018621341,2,1248,1428,0
13019413517,13019413524,7,1121,1613,0
13019715482,13019715482,0,1673,1640,0
13020953942,13020953942,0,1450,1649,0
13021604215,13021604222,7,2955,1099,0
13022996114,13022996114,0,888,2330,0
13025502915,13025502917,2,1008,1033,0
13026344503,13026344501,-2,983,1227,0
13030329086,13030329086,0,1482,1290,0
13030561135,13030561136,1,1437,1774,0
13032165483,13032165485,2,836,1138,0
13033949482,13033949483,1,1862,1695,0
13035336118,13035336119,1,9219,7814,0
13036476431,13036476433,2,1194,1645,0
13038023621,13038023621,0,1878,2055,0
13038100982,13038100981,-1,801,1508,0
13041066589,13041066589,0,1685,2313,0
13041655681,13041655682,1,1618,1957,0
13047160154,13047160153,-1,1231,2343,0
13047898475,13047898475,0,918,1640,0
13051016381,13051016386,5,2745,2600,0
13051506807,13051506807,0,1374,1390,0
13051880406,13051880406,0,1372,1934,0
13055271631,13055271631,0,1189,1373,0
13055560052,13055560053,1,1351,1886,0
13056152086,13056152086,0,1254,1735,0
13057432628,13057432629,1,1208,1461,0
13060600554,13060600555,1,1313,1738,0
13063063422,13063063423,1,1871,2062,0
13066657086,13066657084,-2,1341,992,0
13068443355,13068443354,-1,1331,1790,0
13071142826,13071142821,-5,20338,15496,0
13073230417,13073230417,0,1373,2062,0
13074105615,13074105616,1,1168,1442,0
13076372155,13076372154,-1,1655,1922,0
13076648887,13076648886,-1,969,1585,0
13079411498,13079411498,0,1208,1616,0
13081041133,13081041136,3,1882,1810,0
13083802654,13083802653,-1,1383,1356,0
13083997510,13083997513,3,1191,902,0
13085283785,13085283786,1,1965,1895,0
13089355147,13089355150,3,1264,934,0
13089508717,13089508727,10,1135,1375,0
13090480654,13090480658,4,1203,1094,0
13092048862,13092048862,0,852,1926,0
13093319505,13093319507,2,1600,1763,0
13094675936,13094675937,1,1345,2029,0
13096931139,13096931141,2,1185,1786,0
13097089589,13097089590,1,1480,1681,0
13102163752,13102163755,3,1710,1427,0
13102938287,13102938286,-1,1406,2094,0
13104893927,13104893929,2,1271,2311,0
13109912775,13109912775,0,1966,2531,0
13110959904,13110959905,1,2040,2216,0
13113863792,13113863794,2,1379,1758,0
13113979610,13113979610,0,1548,1745,0
13117674289,13117674290,1,1453,1234,0
13118172121,13118172122,1,1630,1724,0
13120012345,13120012342,-3,1267,1173,0
13122269629,13122269632,3,1286,1116,0
13123735513,13123735509,-4,936,1673,0
13124833854,13124833859,5,4716,2494,0
13126954773,13126954774,1,1198,1546,0
13128356134,13128356134,0,944,1134,0
13129131765,13129131766,1,1610,2691,0
13133399601,13133399601,0,1394,1752,0
13136749934,13136749935,1,1064,1345,0
13138893766,13138893766,0,1183,1014,0
13139710249,13139710248,-1,962,1371,0
13142906030,13142906030,0,1564,1849,0
13148148000,13148147998,-2,1077,976,0
13154898746,13154898746,0,2013,2553,0
13158969001,13158969001,0,1212,1633,0
13159212330,13159212330,0,1309,1687,0
13161162781,13161162782,1,1299,1060,0
13161708178,13161708178,0,1659,1929,0
13163080734,13163080734,0,1681,1912,0
13163284886,13163284886,0,989,1726,0
13163663689,13163663689,0,1190,1391,0
13165847165,13165847165,0,1496,1994,0
13166821102,13166821102,0,1468,2101,0
13169395694,13169395695,1,1654,1524,0
13171107765,13171107766,1,1533,1872,0
13173750638,13173750639,1,1444,1598,0
13174950592,13174950590,-2,1332,2835,0
13176783747,13176783746,-1,1242,1494,0
13179870487,13179870486,-1,1514,2434,0
13180779676,13180779676,0,1315,1859,0
13182820786,13182820785,-1,1287,1631,0
13185471928,13185471927,-1,1369,2340,0
13188004389,13188004391,2,1621,1583,0
13189149383,13189149385,2,2122,2052,0
13189545193,13189545194,1,1943,1717,0
13192759653,13192759661,8,8548,949,0
13195117091,13195117091,0,1434,1713,0
13197641109,13197641109,0,1382,1469,0
13198319521,13198319526,5,3436,1376,0
13199183282,13199183284,2,1351,1749,0
13202295014,13202295022,8,6310,2747,0
13202341092,13202341103,11,10791,40360,0
13204621307,13204621310,3,1324,1972,0
13206736323,13206736326,3,1299,1185,0
13207005328,13207005328,0,1230,1998,0
13207756116,13207756117,1,1329,2590,0
13210025109,13210025108,-1,1251,1650,0
13211893617,13211893633,16,1473,1330,0
13213955922,13213955935,13,1724,1095,0
13215116313,13215116315,2,1114,977,0
13215747113,13215747113,0,1606,2312,0
13216328302,13216328302,0,1862,2278,0
13216548801,13216548801,0,1565,1895,0
13218599739,13218599718,-21,1124,1071,0
13218730318,13218730333,15,675,2147,0
13219493697,13219493697,0,1945,2833,0
13221294869,13221294869,0,1891,2195,0
13222794796,13222794796,0,1264,2226,0
13225556998,13225556997,-1,1771,1956,0
13225812387,13225812388,1,990,961,0
13225904925,13225904925,0,1106,1805,0
13231590241,13231590239,-2,966,1499,0
13232446895,13232446897,2,1652,1791,0
13233053389,13233053389,0,1259,1384,0
13233498943,13233498929,-14,1358,1927,0
13233839550,13233839548,-2,1142,1645,0
13236688695,13236688694,-1,1246,1434,0
13238485697,13238485698,1,1362,2465,0
13239161998,13239161997,-1,1180,1500,0
13242258027,13242258009,-18,1070,1493,0
13243514008,13243514008,0,1964,1608,0
13243788214,13243788215,1,1328,1375,0
13244353017,13244353018,1,2036,2029,0
13246906210,13246906211,1,1201,1710,0
13249827506,13249827509,3,984,1022,0
13254055013,13254055017,4,1583,1865,0
13261030571,13261030571,0,855,1390,0
13263819450,13263819450,0,1289,1807,0
13266916473,13266916474,1,1218,1752,0
13267770641,13267770641,0,1507,2033,0
13268444114,13268444115,1,1359,1247,0
13277140026,13277140022,-4,1360,2254,0
13278798148,13278798148,0,1797,1868,0
13284925505,13284925504,-1,1622,1615,0
13289151869,13289151870,1,2469,2190,0
13290754481,13290754482,1,1816,2043,0
13293336354,13293336348,-6,1097,3675,0
13296460062,13296460066,4,1950,2012,0
13300986870,13300986870,0,1536,2150,0
13302786302,13302786302,0,1855,2487,0
13306885823,13306885825,2,1712,1745,0
13307121118,13307121118,0,1171,1952,0
13307917559,13307917546,-13,1707,2395,0
13308811006,13308811008,2,1232,1018,0
13310936522,13310936523,1,955,1615,0
13311063569,13311063570,1,1672,1491,0
13318278523,13318278524,1,2166,2221,0
13318840812,13318840813,1,1478,1469,0
13326702791,13326702790,-1,1139,1118,0
13327729350,13327729350,0,774,1164,0
13332489900,13332489901,1,1624,1534,0
13333680914,13333680915,1,1344,1565,0
13334447633,13334447634,1,1431,1368,0
13336441330,13336441331,1,769,1432,0
13337705530,13337705531,1,1953,2317,0
13338132274,13338132273,-1,1508,1815,0
13340410259,13340410261,2,1712,1776,0
13340840349,13340840350,1,1398,1657,0
13340878771,13340878773,2,1309,2001,0
13341518531,13341518531,0,1751,1897,0
13342802397,13342802395,-2,1325,1648,0
13343316430,13343316432,2,1464,1471,0
13345373965,13345373967,2,1579,2097,0
13346036178,13346036178,0,1487,1853,0
13346297000,13346297000,0,1489,1986,0
13354344319,13354344319,0,1707,2676,0
13354429493,13354429492,-1,1964,2507,0
13354579802,13354579802,0,1842,1391,0
13365712939,13365712942,3,1443,1829,0
13366040937,13366040941,4,2352,2026,0
13369910166,13369910166,0,1097,1045,0
13371672346,13371672345,-1,1028,1521,0
13373879679,13373879679,0,1472,1493,0
13377624574,13377624573,-1,1171,1901,0
13379131238,13379131239,1,1728,1747,0
13382400278,13382400279,1,724,913,0
13382823424,13382823443,19,887,1150,0
13383828602,13383828602,0,1473,1361,0
13387963196,13387963198,2,1716,1775,0
13393671989,13393671991,2,1624,1466,0
13398867214,13398867214,0,1532,1663,0
13399146531,13399146530,-1,980,1478,0
13400009066,13400009066,0,1552,1510,0
13400191655,13400191656,1,1283,1689,0
13400997756,13400997740,-16,7521,935,0
13404652625,13404652625,0,1203,1090,0
13405405421,13405405424,3,1251,1617,0
13406637085,13406637088,3,1759,1953,0
13410196776,13410196775,-1,1485,1961,0
13412846324,13412846324,0,2092,2288,0
13415731626,13415731629,3,1093,1781,0
13416463489,13416463490,1,1390,1943,0
13418274532,13418274530,-2,21506,8971,0
13421498833,13421498832,-1,1239,1571,0
13426086035,13426086038,3,1644,1247,0
13427505450,13427505430,-20,1297,990,0
13436913798,13436913779,-19,1362,1949,0
13437083506,13437083511,5,2061,1357,0
13439588930,13439588931,1,889,1330,0
13442023646,13442023661,15,1153,1342,0
13446344210,13446344210,0,1231,1666,0
13450002370,13450002370,0,1173,2060,0
13451708454,13451708453,-1,824,1417,0
13455058729,13455058725,-4,2290,4622,0
13458331570,13458331568,-2,1647,3268,0
13463156284,13463156287,3,1469,1297,0
13464744494,13464744496,2,1516,1563,0
13472125237,13472125239,2,1593,1876,0
13473343160,13473343162,2,1847,1217,0
13474214387,13474214387,0,1527,2176,0
13475207997,13475208000,3,1343,2179,0
13478603788,13478603783,-5,139,949,0
13480117434,13480117433,-1,1480,1673,0
13481786016,13481786016,0,1215,1039,0
13485133031,13485133031,0,1665,2208,0
13487848430,13487848437,7,4111,2025,0
13488834526,13488834528,2,1473,1868,0
13489874519,13489874522,3,1473,1918,0
13490162958,13490162958,0,1276,1328,0
13490870990,13490870989,-1,1126,1716,0
13494765870,13494765871,1,1857,1591,0
13495360454,13495360455,1,987,1017,0
13496575231,13496575231,0,1296,1591,0
13497698270,13497698270,0,1065,1096,0
13499739374,13499739376,2,1165,1794,0
13501525716,13501525717,1,1176,1590,0
13504373338,13504373339,1,1538,1466,0
13506740019,13506740018,-1,1298,2099,0
13514694655,13514694653,-2,1464,1917,0
13517690859,13517690858,-1,2060,2107,0
13518206894,13518206896,2,1752,2434,0
13523595284,13523595280,-4,1589,5278,0
13524680287,13524680284,-3,774,2069,0
13526097978,13526097980,2,1566,1690,0
13527066730,13527066732,2,1391,1509,0
13528835315,13528835317,2,1013,2220,0
13530436256,13530436257,1,1223,2005,0
13530904779,13530904780,1,1410,1642,0
13531797518,13531797517,-1,1159,1831,0
13534113750,13534113757,7,3342,1563,0
13535572773,13535572779,6,21446,58084,0
13537562592,13537562592,0,2342,3076,0
13539782762,13539782762,0,1487,1648,0
13539870162,13539870157,-5,769,1358,0
13541725823,13541725822,-1,968,1358,0
13542173926,13542173926,0,1189,1873,0
13547071536,13547071534,-2,1589,2154,0
13547241674,13547241675,1,1439,1265,0
13548267423,13548267422,-1,1099,2181,0
13549520573,13549520574,1,1525,1968,0
13549982625,13549982624,-1,1426,1918,0
13554559239,13554559218,-21,877,1693,0
13559010781,13559010782,1,943,1474,0
13559267751,13559267730,-21,1225,2404,0
13560065378,13560065375,-3,694,1042,0
13560980765,13560980769,4,1814,1470,0
13562439514,13562439515,1,1117,1265,0
13564416898,13564416898,0,1708,1512,0
13565008490,13565008490,0,1487,2179,0
13565035418,13565035422,4,2201,1567,0
13566262135,13566262139,4,1654,2062,0
13569604264,13569604271,7,2598,830,0
13570883590,13570883594,4,1006,1165,0
13571104219,13571104221,2,1326,1422,0
13571431106,13571431105,-1,1212,1416,0
13572295158,13572295157,-1,1411,2543,0
13572894410,13572894411,1,1168,1795,0
13576170807,13576170806,-1,1296,2149,0
13578006054,13578006053,-1,1825,2018,0
13578359149,13578359148,-1,1371,1370,0
13584996871,13584996873,2,914,1622,0
13585124148,13585124166,18,1609,1693,0
13588579602,13588579602,0,1237,1565,0
13589222106,13589222107,1,948,1337,0
13589348751,13589348751,0,1889,2000,0
13589577150,13589577149,-1,1504,1868,0
13594217665,13594217664,-1,1897,2300,0
13594410358,13594410358,0,1026,1398,0
13595486582,13595486577,-5,1287,3447,0
13597563639,13597563633,-6,1477,6133,0
13599013605,13599013605,0,1128,1671,0
13599568830,13599568831,1,700,1437,0
13599962409,13599962409,0,1204,2182,0
13600801114,13600801115,1,1100,1601,0
13606013500,13606013499,-1,1872,2126,0
13606082659,13606082661,2,28589,21964,0
13611977016,13611977013,-3,1239,1600,0
13612603423,13612603424,1,2091,2639,0
13614612682,13614612686,4,2818,1620,0
13615665442,13615665442,0,1059,1147,0
13618337734,13618337736,2,895,1131,0
13622393520,13622393519,-1,1801,1854,0
13623385522,13623385521,-1,1518,2086,0
13623537265,13623537269,4,1250,854,0
13627296498,13627296503,5,12691,6891,0
13631925450,13631925450,0,1084,1796,0
13631999874,13631999877,3,813,1078,0
13633644126,13633644129,3,1115,1128,0
13636878365,13636878366,1,1890,1884,0
13638061472,13638061477,5,3022,1810,0
13638688768,13638688767,-1,1142,1869,0
13641499091,13641499091,0,1687,1635,0
13644708167,13644708166,-1,1138,1092,0
13645152102,13645152104,2,1483,1671,0
13645204665,13645204662,-3,1305,2902,0
13645697887,13645697870,-17,182,877,0
13646083922,13646083923,1,1576,2230,0
13650993603,13650993604,1,1314,2020,0
13652710255,13652710252,-3,1225,1434,0
13653598209,13653598211,2,875,1434,0
13655012151,13655012153,2,1094,1202,0
13656865414,13656865412,-2,1361,2451,0
13658177894,13658177875,-19,1095,1708,0
13660575411,13660575410,-1,1303,1781,0
13660787342,13660787342,0,773,1245,0
13661270696,13661270694,-2,1329,1558,0
13663113231,13663113238,7,9423,29631,0
13664206646,13664206646,0,2023,2172,0
13664636707,13664636706,-1,1066,1285,0
13667193626,13667193636,10,1075,1433,0
13669408709,13669408711,2,1219,1653,0
13669546844,13669546844,0,1140,1172,0
13670741851,13670741851,0,956,1785,0
13673831482,13673831485,3,2032,1742,0
13675390690,13675390692,2,1289,1253,0
13677787882,13677787886,4,3030,2539,0
13679013685,13679013689,4,2018,896,0
13679466525,13679466526,1,1763,1594,0
13682550907,13682550906,-1,988,1982,0
13683976866,13683976868,2,1721,1626,0
13686572958,13686572959,1,1433,2360,0
13687960570,13687960574,4,1392,859,0
13691522505,13691522506,1,1735,1630,0
13693036248,13693036247,-1,1546,1412,0
13697507797,13697507798,1,1568,1400,0
13698514855,13698514854,-1,699,1636,0
13699347050,13699347050,0,854,1457,0
13701820353,13701820354,1,1720,1568,0
13701976848,13701976850,2,1191,1196,0
13706017636,13706017634,-2,1305,1733,0
13708159179,13708159181,2,1980,1773,0
13709216665,13709216664,-1,1063,1463,0
13710893002,13710893008,6,2086,1980,0
13712618586,13712618588,2,1249,1367,0
13713459043,13713459044,1,1288,1533,0
13716854269,13716854271,2,1394,1397,0
13720010887,13720010889,2,1158,1435,0
13721547236,13721547237,1,1967,1441,0
13721858526,13721858527,1,1955,2261,0
13723548676,13723548689,13,385,1523,0
13727275143,13727275142,-1,1181,1311,0
13728044274,13728044273,-1,1211,1837,0
13730820475,13730820473,-2,1215,1765,0
13734188187,13734188187,0,1527,1372,0
13735455127,13735455126,-1,1190,1230,0
13739486446,13739486447,1,1724,2585,0
13740495878,13740495878,0,1540,1241,0
13746095859,13746095860,1,1632,1418,0
13746141459,13746141437,-22,1023,1064,0
13746662090,13746662090,0,1203,1771,0
13750314214,13750314215,1,1875,2321,0
13752682600,13752682602,2,1009,1487,0
13753359418,13753359419,1,1680,2196,0
13754956526,13754956526,0,1385,1479,0
13756036258,13756036258,0,1092,2274,0
13757714347,13757714356,9,1336,1663,0
13760306058,13760306059,1,1434,1046,0
13760441138,13760441139,1,1066,1276,0
13761204892,13761204891,-1,1674,1325,0
13766298614,13766298614,0,1310,1311,0
13766999705,13766999706,1,1515,1696,0
13767637426,13767637425,-1,1433,1184,0
13768919610,13768919610,0,1146,1461,0
13769812946,13769812945,-1,1186,1463,0
13770462330,13770462331,1,858,1246,0
13770749751,13770749752,1,2890,3762,0
13772878513,13772878514,1,1411,1228,0
13773551239,13773551241,2,1867,1693,0
13775266826,13775266807,-19,1372,2365,0
13775862159,13775862159,0,1431,1631,0
13777765324,13777765326,2,1518,1251,0
13786160325,13786160324,-1,2017,1767,0
13786771615,13786771613,-2,1065,2103,0
13787249617,13787249618,1,1893,1354,0
13787633950,13787633950,0,1505,1511,0
13788876991,13788876991,0,1289,1900,0
13792589701,13792589701,0,1715,1431,0
13792754990,13792754995,5,4017,2122,0
13796078614,13796078615,1,1123,2013,0
13802903006,13802903005,-1,914,2117,0
13803203898,13803203894,-4,1168,1841,0
13803969438,13803969435,-3,1382,4106,0
13806012027,13806012034,7,4731,1295,0
13806762823,13806762826,3,1452,1933,0
13807166017,13807166016,-1,1408,1569,0
13807853235,13807853235,0,1119,1098,0
13809277758,13809277760,2,1568,1744,0
13809302931,13809302933,2,1013,1346,0
13809638047,13809638049,2,1154,2006,0
13811260565,13811260554,-11,1198,1787,0
13812087825,13812087826,1,1204,2157,0
13813091855,13813091858,3,1691,1633,0
13815557785,13815557781,-4,1051,2744,0
13817367823,13817367825,2,1208,1198,0
13817832131,13817832127,-4,859,1263,0
13818204403,13818204405,2,1790,2012,0
13818886405,13818886402,-3,634,2850,0
13819588297,13819588298,1,1133,1672,0
13820538151,13820538151,0,1599,1657,0
13821422132,13821422138,6,1584,768,0
13821997687,13821997691,4,1509,1237,0
13822398346,13822398346,0,1813,2401,0
13822554501,13822554502,1,558,914,0
13823315046,13823315050,4,1279,1794,0
13824471546,13824471554,8,2391,1579,0
13824975698,13824975698,0,1562,1804,0
13827019722,13827019723,1,1170,1690,0
13828587218,13828587223,5,1072,1224,0
13830037384,13830037385,1,1720,2286,0
13830355081,13830355081,0,1370,1556,0
13830741692,13830741714,22,852,1376,0
13831875054,13831875056,2,1407,2312,0
13835599231,13835599230,-1,1405,1749,0
13838162862,13838162862,0,1610,2471,0
13841651922,13841651923,1,731,1183,0
13842607528,13842607528,0,1127,1624,0
13843490217,13843490218,1,1087,1345,0
13844567551,13844567555,4,6308,4770,0
13845364626,13845364627,1,915,1115,0
13846601556,13846601559,3,1495,1068,0
13846910714,13846910716,2,999,1870,0
13847356166,13847356169,3,1124,1463,0
13848668486,13848668488,2,1273,2106,0
13849182234,13849182234,0,1125,1579,0
13849813087,13849813093,6,2486,1182,0
13850114615,13850114618,3,2079,2026,0
13850160426,13850160427,1,1612,1948,0
13850407189,13850407190,1,1293,2395,0
13850675727,13850675727,0,1508,1913,0
13851500978,13851500994,16,1649,1582,0
13851997195,13851997195,0,1104,1737,0
13856713307,13856713307,0,928,1588,0
13858211051,13858211051,0,1488,1248,0
13864491711,13864491713,2,1682,1969,0
13865218506,13865218508,2,2322,2552,0
13865868849,13865868850,1,1475,1403,0
13866981609,13866981609,0,1832,1748,0
13869220156,13869220156,0,1430,2051,0
13870371111,13870371111,0,2963,4557,0
13871436051,13871436050,-1,1055,1707,0
13872292198,13872292192,-6,2209,8593,0
13872524406,13872524406,0,1080,1504,0
13875226031,13875226031,0,906,1460,0
13876854790,13876854789,-1,1462,1991,0
13879268728,13879268729,1,1595,1443,0
13881434937,13881434937,0,1217,1809,0
13884865957,13884865957,0,1276,1483,0
13886460738,13886460737,-1,1432,1348,0
13886949822,13886949826,4,1101,1965,0
13888055774,13888055775,1,1351,1770,0
13889075722,13889075722,0,1726,2295,0
13889321151,13889321153,2,2198,2010,0
13890346250,13890346251,1,1598,2311,0
13895076980,13895076986,6,2437,1717,0
13897577374,13897577371,-3,936,2178,0
13898149954,13898149956,2,1547,1307,0
13898754850,13898754830,-20,1704,1815,0
13904085411,13904085410,-1,1274,1897,0
13905927622,13905927624,2,1755,1543,0
13907322338,13907322338,0,1354,1403,0
13910713025,13910713026,1,2029,1826,0
13912266673,13912266674,1,1290,1261,0
13914142506,13914142488,-18,1790,1789,0
13914407315,13914407296,-19,1559,2227,0
13916251974,13916251977,3,1635,2119,0
13920291920,13920291942,22,1154,1557,0
13921577345,13921577347,2,1680,1053,0
13925256403,13925256403,0,1153,1557,0
13925346326,13925346310,-16,1121,1537,0
13926706794,13926706792,-2,1073,1166,0
13927725021,13927725023,2,1414,2121,0
13931175609,13931175617,8,4816,797,0
13934586079,13934586081,2,1366,1812,0
13935854170,13935854178,8,11187,5000,0
13936419907,13936419907,0,1118,1741,0
13937478399,13937478407,8,10902,20082,0
13938265977,13938265979,2,823,1447,0
13939325525,13939325526,1,1759,1522,0
13940567562,13940567564,2,1283,1797,0
13940717161,13940717162,1,1335,1554,0
13941520754,13941520755,1,1350,1417,0
13941765354,13941765356,2,2245,1810,0
13945669190,13945669193,3,1281,1540,0
13946310510,13946310511,1,1014,1861,0
13946382345,13946382347,2,646,753,0
13947300799,13947300797,-2,1179,2039,0
13951062156,13951062155,-1,1719,2541,0
13953566623,13953566626,3,1508,2024,0
13953715687,13953715687,0,1788,1883,0
13956461574,13956461575,1,1183,1148,0
13956976966,13956976962,-4,1501,2441,0
13957862726,13957862727,1,1857,1531,0
13966032518,13966032520,2,1861,2195,0
13967177955,13967177956,1,1099,1379,0
13967792729,13967792728,-1,1647,2287,0
13968118726,13968118726,0,1508,1321,0
13969666462,13969666462,0,1900,2325,0
13976853159,13976853157,-2,1227,1053,0
13978079769,13978079769,0,1677,2002,0
13982326263,13982326260,-3,922,1939,0
13985193515,13985193516,1,1234,1820,0
13987404351,13987404349,-2,1227,1780,0
13988819094,13988819094,0,2063,2600,0
13989442509,13989442511,2,1878,1750,0
13989974563,13989974565,2,1761,1913,0
13990022509,13990022494,-15,411,396,0
13993132677,13993132678,1,1126,2668,0
13993875536,13993875538,2,1969,1866,0
13996779139,13996779141,2,1450,1299,0
13997318995,13997318994,-1,2326,5695,0
13998563957,13998563959,2,1511,2249,0
14001140230,14001140221,-9,756,2788,0
14008028957,14008028961,4,1237,1394,0
14008683965,14008683962,-3,1389,1939,0
14014168784,14014168785,1,1273,1964,0
14014563340,14014563342,2,3459,3554,0
14016457370,14016457370,0,977,1674,0
14022551662,14022551663,1,1052,2040,0
14022973382,14022973382,0,1507,1951,0
14023860602,14023860606,4,2965,2174,0
14025593083,14025593084,1,1128,1566,0
14027441594,14027441594,0,1418,1447,0
14028487694,14028487696,2,1379,1690,0
14030454637,14030454637,0,1293,1383,0
14031239461,14031239467,6,8826,1308,0
14035616887,14035616886,-1,1649,2166,0
14036192033,14036192034,1,1939,2323,0
14040318121,14040318122,1,1259,1015,0
14043767491,14043767491,0,1452,1641,0
14048030246,14048030248,2,1647,1333,0
14050979389,14050979389,0,2026,1927,0
14056473245,14056473242,-3,215,652,0
14056617994,14056617998,4,1377,1349,0
14057474614,14057474615,1,1727,1598,0
14057532004,14057532004,0,1592,1857,0
14057757629,14057757630,1,1238,2331,0
14061382970,14061382958,-12,1184,1601,0
14065706950,14065706950,0,1496,1986,0
14067051010,14067051010,0,1636,1503,0
14069121963,14069121965,2,1095,1350,0
14069521926,14069521927,1,921,1230,0
14069786490,14069786489,-1,1590,2246,0
14070782794,14070782795,1,1483,1993,0
14071425020,14071425020,0,810,1360,0
14072290786,14072290765,-21,448,228,0
14073337028,14073337029,1,1116,1615,0
14074249349,14074249353,4,977,1404,0
14078168792,14078168794,2,881,1472,0
14078499310,14078499310,0,1039,1239,0
14080828283,14080828286,3,1145,1413,0
14081382049,14081382047,-2,1499,1912,0
14084321503,14084321504,1,1129,1663,0
14085506142,14085506146,4,2639,1349,0
14089186843,14089186843,0,890,1092,0
14089415148,14089415149,1,1631,2002,0
14093933025,14093933008,-17,1419,2042,0
14095993064,14095993062,-2,1493,3406,0
14096957930,14096957929,-1,1685,2022,0
14097821023,14097821026,3,1671,1247,0
14100463594,14100463594,0,1163,1435,0
14105112910,14105112909,-1,1204,1394,0
14108041395,14108041401,6,2482,1131,0
14108663019,14108663022,3,2398,1868,0
14115500622,14115500623,1,1155,1309,0
14118957150,14118957149,-1,804,1029,0
14125497613,14125497610,-3,1135,1888,0
14127077691,14127077693,2,1119,1716,0
14127248582,14127248581,-1,1160,1578,0
14129707357,14129707358,1,1156,1269,0
14129956041,14129956037,-4,2346,6028,0
14134289062,14134289063,1,1717,2121,0
14135732849,14135732852,3,1195,1440,0
14141116019,14141116014,-5,1289,1514,0
14141349457,14141349457,0,1260,1583,0
14144699878,14144699878,0,861,1513,0
14145829103,14145829101,-2,1130,1927,0
14146499259,14146499258,-1,1052,1243,0
14152385552,14152385551,-1,1472,2093,0
14155437453,14155437455,2,1882,2094,0
14157955566,14157955566,0,1673,2275,0
14158445977,14158445976,-1,1558,2262,0
14165112854,14165112850,-4,1104,1676,0
14166561165,14166561165,0,1315,2229,0
14167323164,14167323162,-2,1563,2031,0
14172333402,14172333403,1,1291,1626,0
14173293626,14173293626,0,1303,1282,0
14176715319,14176715320,1,1580,1768,0
14177170315,14177170316,1,1359,1471,0
14179086883,14179086882,-1,1274,1627,0
14181059758,14181059762,4,1320,1264,0
14181945390,14181945390,0,801,1144,0
14185706977,14185706978,1,1036,1435,0
14186841159,14186841159,0,1164,1369,0
14186970701,14186970702,1,1220,1758,0
14187634270,14187634271,1,1189,1990,0
14191920771,14191920772,1,1763,2315,0
14197502474,14197502475,1,1603,2018,0
14198883584,14198883585,1,1942,1365,0
14200522549,14200522550,1,1281,2309,0
14203303642,14203303643,1,1436,1968,0
14205362282,14205362284,2,1193,1352,0
14207740252,14207740251,-1,1001,1504,0
14208631327,14208631329,2,1620,1487,0
14208693706,14208693706,0,1505,1776,0
14210136051,14210136050,-1,1324,1475,0
14214865636,14214865637,1,1340,2080,0
14217896886,14217896885,-1,2964,3320,0
14218681393,14218681396,3,1829,1945,0
14225966492,14225966492,0,1640,1645,0
14227519846,14227519846,0,1295,1656,0
14227703835,14227703834,-1,1296,1757,0
14228361561,14228361559,-2,1075,1766,0
14229368042,14229368043,1,1243,1823,0
14229645358,14229645347,-11,861,1083,0
14231010563,14231010567,4,1571,1195,0
14242561732,14242561734,2,1596,1411,0
14250699535,14250699536,1,1211,1287,0
14250878434,14250878434,0,1056,1366,0
14251760014,14251760014,0,1653,2078,0
14255515094,14255515094,0,1499,1861,0
14257238753,14257238752,-1,1367,1590,0
14259415564,14259415566,2,1365,1466,0
14262465494,14262465494,0,1761,1857,0
14262769045,14262769045,0,1387,2153,0
14263930450,14263930451,1,1302,1112,0
14264523823,14264523823,0,1623,1047,0
14265069666,14265069666,0,850,1665,0
14266813871,14266813871,0,1586,1483,0
14267846563,14267846553,-10,31421,18535,0
14270210076,14270210077,1,1588,2253,0
14272793763,14272793765,2,1209,1535,0
14277778502,14277778503,1,1182,1569,0
14281626930,14281626932,2,1171,1496,0
14286805370,14286805370,0,3359,4136,0
14288471649,14288471650,1,1718,2115,0
14290240987,14290240987,0,1470,1515,0
14292484512,14292484509,-3,17221,12887,0
14292618351,14292618351,0,969,980,0
14293303514,14293303516,2,1372,2194,0
14293752123,14293752101,-22,1040,319,0
14295381611,14295381613,2,1685,1760,0
14298492433,14298492434,1,1192,1673,0
14305058960,14305058960,0,1182,1639,0
14307978351,14307978357,6,7051,31750,0
14311421501,14311421502,1,1275,1436,0
14312554919,14312554917,-2,732,1492,0
14316196635,14316196638,3,549,1193,0
14320315850,14320315850,0,1597,2115,0
14320463766,14320463785,19,2255,1646,0
14321346317,14321346318,1,1609,1788,0
14323526086,14323526086,0,1598,1721,0
14326448971,14326448974,3,1572,2208,0
14327006489,14327006489,0,901,1447,0
14329356287,14329356291,4,1977,720,0
14330192571,14330192571,0,1542,1923,0
14333404269,14333404270,1,1682,1844,0
14333625130,14333625129,-1,1448,3092,0
14337437430,14337437430,0,1506,1861,0
14337974643,14337974643,0,1302,1906,0
14338677342,14338677342,0,1132,1136,0
14339962915,14339962917,2,1332,1337,0
14344202211,14344202213,2,1609,1653,0
14345201076,14345201077,1,1474,1973,0
14350565838,14350565841,3,1942,1326,0
14353454869,14353454852,-17,687,556,0
14354341741,14354341742,1,1300,1942,0
14354484568,14354484581,13,252,1310,0
14360165483,14360165483,0,1111,1803,0
14361877607,14361877605,-2,1457,1745,0
14365684377,14365684379,2,1335,1777,0
14370254076,14370254076,0,1425,2048,0
14372728077,14372728075,-2,2078,2386,0
14372860507,14372860508,1,1212,2261,0
14377054169,14377054169,0,2127,1903,0
14379433785,14379433784,-1,1312,1880,0
14379619421,14379619402,-19,944,1216,0
14380076554,14380076554,0,1801,2428,0
14381467225,14381467226,1,1404,1892,0
14382347559,14382347562,3,1643,2360,0
14382511558,14382511559,1,1557,1713,0
14382776078,14382776077,-1,1216,2160,0
14390747713,14390747715,2,1581,1546,0
14395064738,14395064737,-1,1158,1776,0
14396181126,14396181122,-4,1095,3721,0
14396635621,14396635621,0,1157,1523,0
14398911096,14398911097,1,1576,1836,0
14399504205,14399504206,1,2082,2518,0
14402895706,14402895710,4,3773,2260,0
14403857771,14403857772,1,1388,1859,0
14406126221,14406126222,1,1350,1593,0
14406322958,14406322961,3,1681,2058,0
14407594058,14407594038,-20,1402,2030,0
14408805189,14408805186,-3,1460,2247,0
14410821883,14410821883,0,1573,1543,0
14411956825,14411956821,-4,23382,17251,0
14413725445,14413725446,1,1256,1872,0
14414576620,14414576620,0,1379,2130,0
14420174189,14420174198,9,2380,710,0
14422099259,14422099257,-2,1187,1258,0
14426332210,14426332210,0,1578,1875,0
14426490242,14426490243,1,1015,1810,0
14427800374,14427800371,-3,881,1428,0
14432178269,14432178267,-2,1522,1668,0
14434082448,14434082451,3,1506,1464,0
14437099054,14437099057,3,1325,1315,0
14437829946,14437829926,-20,1536,1995,0
14439360470,14439360468,-2,1932,2031,0
14440934361,14440934362,1,1495,1617,0
14442483865,14442483868,3,1618,1331,0
14447688370,14447688370,0,1013,1471,0
14453225332,14453225334,2,1120,1634,0
14456787482,14456787485,3,1474,881,0
14457186713,14457186717,4,1431,1168,0
14458417066,14458417068,2,1873,1928,0
14459555790,14459555790,0,1233,1926,0
14460590914,14460590914,0,1592,2302,0
14461527842,14461527842,0,1584,1864,0
14461696653,14461696652,-1,1803,1937,0
14462286374,14462286374,0,1125,1498,0
14464433530,14464433529,-1,997,1988,0
14465630850,14465630847,-3,1295,1356,0
14466372017,14466372017,0,2067,1916,0
14467104718,14467104718,0,1847,2054,0
14467201235,14467201237,2,1010,1417,0
14472091354,14472091353,-1,1181,1138,0
14473880750,14473880742,-8,1187,20016,0
14475346006,14475346007,1,1114,1480,0
14476764908,14476764909,1,2037,2668,0
14479856304,14479856297,-7,1769,9084,0
14480931067,14480931067,0,2266,1671,0
14483076500,14483076521,21,1551,1893,0
14484092856,14484092860,4,1157,1236,0
14486065095,14486065093,-2,1149,1653,0
14490126567,14490126570,3,1567,1416,0
14491577410,14491577411,1,1421,1658,0
14491611062,14491611062,0,1132,1832,0
14491725325,14491725346,21,1164,1476,0
14493946094,14493946095,1,1273,1912,0
14494252178,14494252181,3,1493,1807,0
14495855728,14495855725,-3,1019,2439,0
14498697430,14498697431,1,1429,1538,0
14500037943,14500037942,-1,1372,2305,0
14507050570,14507050572,2,1938,1593,0
14508705367,14508705369,2,1634,1116,0
14508846328,14508846329,1,1763,1547,0
14510959254,14510959250,-4,999,1807,0
14513258341,14513258339,-2,1618,1874,0
14516000204,14516000205,1,1678,2361,0
14518791078,14518791078,0,913,1182,0
14521864283,14521864284,1,1615,1677,0
14523513552,14523513552,0,762,1246,0
14525163010,14525163004,-6,1694,8465,0
14525430158,14525430159,1,1388,1882,0
14527881741,14527881741,0,2024,2092,0
14527912774,14527912775,1,1921,1411,0
14530483457,14530483458,1,1439,2157,0
14532264338,14532264338,0,1028,1469,0
14535377605,14535377607,2,1377,1550,0
14537575781,14537575782,1,1407,1481,0
14543231413,14543231414,1,1710,1289,0
14543816230,14543816237,7,2380,1379,0
14545986119,14545986118,-1,1198,1273,0
14548391798,14548391798,0,1145,1000,0
14548717035,14548717037,2,1628,1067,0
14555767880,14555767880,0,1135,1736,0
14558049622,14558049624,2,4052,2694,0
14567747137,14567747138,1,1796,2675,0
14568685660,14568685660,0,984,1981,0
14569397425,14569397426,1,1519,1945,0
14573996790,14573996790,0,1092,1407,0
14574138159,14574138153,-6,4091,15306,0
14575203497,14575203498,1,1317,1805,0
14576645290,14576645290,0,1463,2335,0
14577908792,14577908790,-2,1224,2145,0
14578831741,14578831740,-1,1627,1856,0
14580648169,14580648168,-1,1274,1188,0
14581650286,14581650286,0,1779,1213,0
14584775770,14584775771,1,1234,2003,0
14590459397,14590459397,0,1423,2141,0
14591485918,14591485918,0,1572,1407,0
14593498243,14593498244,1,956,715,0
14593648554,14593648553,-1,1557,2186,0
14596417715,14596417720,5,12079,21832,0
14596824998,14596824999,1,1337,1314,0
14598683103,14598683104,1,1663,2638,0
14600324719,14600324719,0,1122,2205,0
14601350943,14601350942,-1,1085,1903,0
14602307797,14602307818,21,1512,1878,0
14604525113,14604525110,-3,963,1413,0
14605279921,14605279935,14,1679,1462,0
14605976904,14605976910,6,4660,1297,0
14608081994,14608081993,-1,997,1818,0
14608275599,14608275619,20,1064,1305,0
14614194903,14614194903,0,1126,1159,0
14616875553,14616875558,5,2648,1388,0
14619834294,14619834295,1,1700,1642,0
14620695042,14620695043,1,1307,1214,0
14620915583,14620915583,0,2176,2466,0
14622246257,14622246258,1,1880,1561,0
14626419400,14626419406,6,7316,2758,0
14627861741,14627861742,1,1476,1793,0
14628366261,14628366262,1,2238,2146,0
14629293007,14629293002,-5,3524,11867,0
14633025322,14633025322,0,1838,2084,0
14633952622,14633952622,0,1421,1524,0
14635156306,14635156307,1,1350,1833,0
14635557338,14635557338,0,1064,1157,0
14635965025,14635965022,-3,822,928,0
14636334845,14636334846,1,1814,2028,0
14636599015,14636599014,-1,1116,1748,0
14638719445,14638719445,0,1363,1944,0
14642381648,14642381647,-1,1450,1556,0
14643974498,14643974499,1,1447,1529,0
14645852146,14645852146,0,1575,2246,0
14649922125,14649922126,1,1310,1950,0
14650512956,14650512956,0,1759,2403,0
14651713739,14651713741,2,1570,1764,0
14651864026,14651864029,3,2211,1663,0
14654597221,14654597221,0,1166,1555,0
14656012759,14656012761,2,1182,1626,0
14656639040,14656639038,-2,1347,1493,0
14658094916,14658094918,2,1828,1806,0
14660763299,14660763301,2,1158,1347,0
14661866198,14661866197,-1,1365,1330,0
14662712741,14662712743,2,1949,2233,0
14663942361,14663942358,-3,1375,1437,0
14667225398,14667225398,0,1495,2731,0
14670978350,14670978353,3,1049,899,0
14671376839,14671376841,2,1679,1940,0
14672036917,14672036918,1,3090,3943,0
14673007002,14673006996,-6,1177,2413,0
14683222690,14683222691,1,1042,1444,0
14683766513,14683766511,-2,783,1139,0
14686442290,14686442290,0,1119,1420,0
14687953719,14687953720,1,924,2004,0
14688155776,14688155793,17,1269,2236,0
14689483096,14689483098,2,953,1522,0
14690121896,14690121898,2,1193,1118,0
14690847415,14690847415,0,1383,1228,0
14692592557,14692592557,0,1636,1996,0
14695880517,14695880514,-3,1011,2998,0
14698199769,14698199751,-18,1288,1964,0
14701311010,14701311009,-1,1161,975,0
14702311647,14702311650,3,1338,1404,0
14703963995,14703963995,0,1368,1187,0
14704606028,14704606026,-2,19641,14687,0
14705770288,14705770288,0,1155,1877,0
14706058693,14706058689,-4,1319,1226,0
14710193957,14710193953,-4,1483,1576,0
14710328541,14710328541,0,1233,1781,0
14712145822,14712145822,0,1264,1693,0
14713343989,14713343990,1,1807,1693,0
14713794751,14713794753,2,1160,1042,0
14719777097,14719777098,1,1740,2068,0
14720110565,14720110564,-1,2054,1969,0
14720303380,14720303383,3,1692,1952,0
14722270821,14722270822,1,1088,1533,0
14723647722,14723647722,0,1387,1834,0
14727242221,14727242222,1,1093,2130,0
14727511095,14727511087,-8,1303,1569,0
14728173277,14728173282,5,36,330,0
14733315406,14733315409,3,1954,2144,0
14733574977,14733574980,3,3287,2933,0
14739918886,14739918886,0,2018,2019,0
14740819673,14740819663,-10,23688,16690,0
14745857217,14745857219,2,1991,2273,0
14746424413,14746424409,-4,904,1959,0
14748801105,14748801086,-19,1381,1611,0
14748915178,14748915178,0,1588,1613,0
14749774993,14749774994,1,948,1183,0
14755391639,14755391639,0,1428,1385,0
14757597350,14757597350,0,1260,1391,0
14760184851,14760184854,3,2744,2046,0
14761269642,14761269643,1,1449,1618,0
14763462462,14763462462,0,1269,1644,0
14764939322,14764939321,-1,1421,1064,0
14766761751,14766761752,1,1705,1729,0
14768317087,14768317088,1,1476,1954,0
14770285674,14770285675,1,1206,1448,0
14770729281,14770729302,21,1117,2364,0
14772219549,14772219550,1,944,1116,0
14774198085,14774198086,1,1547,2278,0
14774471854,14774471853,-1,2231,2056,0
14774508575,14774508575,0,1422,1914,0
14778927882,14778927876,-6,1951,7268,0
14779486745,14779486746,1,1058,799,0
14780505478,14780505498,20,538,3084,0
14780987865,14780987866,1,1180,1321,0
14782481331,14782481332,1,1116,1640,0
14786348026,14786348026,0,1035,1446,0
14787597590,14787597588,-2,660,1626,0
14790984877,14790984878,1,1024,1059,0
14791250238,14791250239,1,1485,1486,0
14791911686,14791911686,0,1688,1637,0
14793371075,14793371075,0,882,1654,0
14801060465,14801060472,7,1694,1506,0
14805712466,14805712473,7,15238,24375,0
14807095921,14807095924,3,2689,1872,0
14809124454,14809124453,-1,1228,1428,0
14811412603,14811412606,3,1505,1552,0
14816464014,14816464014,0,1260,1393,0
14816931140,14816931137,-3,1419,2482,0
14818319518,14818319514,-4,1515,1365,0
14820766763,14820766762,-1,20879,2059,0
14820876255,14820876257,2,1458,2489,0
14826186777,14826186778,1,1741,1455,0
14827241521,14827241521,0,1865,2494,0
14831462791,14831462791,0,1419,1621,0
14832454294,14832454296,2,917,1470,0
14833733234,14833733236,2,1541,1345,0
14834004143,14834004143,0,857,1030,0
14837018067,14837018065,-2,1468,2092,0
14840776857,14840776854,-3,920,1552,0
14841722949,14841722949,0,824,1482,0
14842088279,14842088280,1,1289,2123,0
14842678865,14842678866,1,1014,1484,0
14844426478,14844426480,2,1037,971,0
14844877331,14844877332,1,1080,1545,0
14846390035,14846390033,-2,1328,3151,0
14849271726,14849271726,0,984,1508,0
14849953337,14849953337,0,1318,1761,0
14850007345,14850007346,1,1404,1693,0
14851111670,14851111669,-1,1356,2267,0
14851669033,14851669038,5,2076,1306,0
14852009984,14852009983,-1,2098,2431,0
14852270534,14852270534,0,1254,1224,0
14853959235,14853959235,0,1210,1932,0
14854431466,14854431466,0,1140,1859,0
14857330272,14857330272,0,1382,2322,0
14859690386,14859690386,0,1164,1750,0
14860017555,14860017556,1,1246,1749,0
14860945274,14860945274,0,1209,1291,0
14867433773,14867433767,-6,1141,3381,0
14868487445,14868487447,2,1595,1897,0
14868684406,14868684408,2,1793,2498,0
14870363635,14870363637,2,1759,1209,0
14870827202,14870827205,3,1268,1467,0
14871343591,14871343593,2,1757,1805,0
14874722262,14874722266,4,1233,1511,0
14875858179,14875858179,0,1353,2454,0
14876759738,14876759737,-1,1328,1570,0
14876862872,14876862872,0,1022,1291,0
14878341514,14878341514,0,1274,1627,0
14878485534,14878485514,-20,1327,875,0
14878685477,14878685478,1,1467,2406,0
14879668181,14879668182,1,1822,1601,0
14880687315,14880687314,-1,1193,1794,0
14880895907,14880895905,-2,1014,2365,0
14882214148,14882214149,1,1286,1215,0
14882252106,14882252105,-1,1267,1486,0
14889855789,14889855792,3,1243,1360,0
14892453302,14892453301,-1,1169,1331,0
14893269326,14893269326,0,1234,2015,0
14894880250,14894880257,7,1172,1394,0
14898137563,14898137565,2,1226,1689,0
14899146056,14899146054,-2,755,1038,0
14899671750,14899671749,-1,1299,1607,0
14902386833,14902386836,3,1604,1740,0
14902649819,14902649820,1,1325,1458,0
14902714707,14902714711,4,2460,1300,0
14903640540,14903640542,2,1904,1881,0
14905660238,14905660258,20,1514,2353,0
14909910531,14909910533,2,1428,1828,0
14912436869,14912436871,2,1387,1993,0
14914687235,14914687238,3,5999,29150,0
14916894649,14916894647,-2,1723,2742,0
14922316130,14922316129,-1,1438,2362,0
14925687296,14925687297,1,1214,1526,0
14926112951,14926112951,0,1320,1323,0
14926351199,14926351184,-15,1172,2839,0
14927174478,14927174481,3,1818,2407,0
14928350506,14928350506,0,1004,1702,0
14931879958,14931879960,2,1379,2164,0
14933894679,14933894678,-1,1637,2482,0
14937505341,14937505340,-1,1242,1763,0
14939446166,14939446168,2,1826,1531,0
14943436298,14943436297,-1,1072,1287,0
14945886617,14945886618,1,1791,1822,0
14947668195,14947668194,-1,1588,1410,0
14947953109,14947953109,0,1278,1738,0
14949741358,14949741358,0,1549,1419,0
14951721816,14951721813,-3,1516,3147,0
14954281641,14954281640,-1,1539,1657,0
14956075554,14956075554,0,1207,1201,0
14956525634,14956525634,0,1219,1500,0
14961295370,14961295372,2,1647,1486,0
14964309903,14964309902,-1,1668,1849,0
14966350001,14966350003,2,2553,1542,0
14972169720,14972169718,-2,1756,2596,0
14973475778,14973475778,0,1583,1495,0
14977092777,14977092778,1,1121,1659,0
14982100342,14982100340,-2,1377,1674,0
14983533105,14983533106,1,1147,1334,0
14983869710,14983869711,1,1765,2024,0
14984241366,14984241366,0,1352,1952,0
14985907375,14985907381,6,3617,2510,0
14986967783,14986967782,-1,1407,2026,0
14987529670,14987529668,-2,1195,1668,0
14990682493,14990682497,4,1245,1058,0
14994787905,14994787909,4,1893,1702,0
14995118274,14995118274,0,904,1583,0
14995361186,14995361185,-1,1087,1877,0
14996692918,14996692919,1,1934,1692,0
15002733715,15002733717,2,1272,1473,0
15004907082,15004907082,0,1160,1320,0
15006815616,15006815617,1,1224,2013,0
15007020119,15007020118,-1,1143,1585,0
15008564640,15008564641,1,1943,1799,0
15014451730,15014451729,-1,920,1862,0
15015377782,15015377782,0,1360,2001,0
15015709533,15015709533,0,981,1892,0
15015979471,15015979471,0,840,1351,0
15017160814,15017160814,0,1074,1362,0
15018132194,15018132198,4,2041,1787,0
15021939934,15021939941,7,7185,2695,0
15024859109,15024859110,1,1270,1636,0
15025230893,15025230906,13,444,2469,0
15025508248,15025508246,-2,883,1532,0
15026464669,15026464669,0,829,1261,0
15030254524,15030254526,2,1608,1813,0
15031171323,15031171319,-4,1541,3052,0
15033080549,15033080547,-2,2699,5130,0
15033275357,15033275358,1,1467,1886,0
15039470257,15039470258,1,1795,2311,0
15041767351,15041767353,2,1010,1221,0
15042400228,15042400247,19,2377,4942,0
15046330565,15046330558,-7,2918,8494,0
15047583211,15047583213,2,1404,1237,0
15049791200,15049791197,-3,711,2163,0
15050538928,15050538932,4,2141,1659,0
15051159977,15051159978,1,1359,1505,0
15051726746,15051726746,0,1819,2187,0
15058442693,15058442695,2,1466,1729,0
15058731154,15058731155,1,1337,1907,0
15059568535,15059568532,-3,1013,2500,0
15059697878,15059697880,2,884,1463,0
15061480073,15061480074,1,1430,1633,0
15062996602,15062996602,0,1167,1330,0
15069093403,15069093404,1,1789,1681,0
15070796142,15070796149,7,6226,2077,0
15075149685,15075149686,1,1351,1450,0
15081136351,15081136352,1,1631,1881,0
15081634209,15081634209,0,1604,1920,0
15082615086,15082615088,2,1356,1475,0
15083020762,15083020763,1,1186,1848,0
15084235354,15084235358,4,2540,1306,0
15086808427,15086808427,0,1333,1253,0
15091186026,15091186025,-1,1408,1572,0
15091493895,15091493889,-6,1082,4616,0
15092082481,15092082482,1,1860,2100,0
15092175219,15092175220,1,1721,1958,0
15094060510,15094060511,1,1635,2253,0
15094762023,15094762023,0,1114,2526,0
15097602463,15097602465,2,885,1141,0
15099717461,15099717463,2,1480,1768,0
15101574026,15101574027,1,1644,1583,0
15105632461,15105632462,1,1397,2247,0
15113497167,15113497167,0,1302,1063,0
15116644555,15116644553,-2,1314,1621,0
15117668568,15117668570,2,1389,1736,0
15118862515,15118862515,0,1787,1940,0
15120042097,15120042098,1,1518,1648,0
15124188440,15124188441,1,1666,1945,0
15125368978,15125368978,0,1524,1920,0
15127744167,15127744171,4,301,1173,0
15129887077,15129887080,3,2233,1571,0
15131482167,15131482167,0,1370,1890,0
15132026852,15132026853,1,1510,1319,0
15135620004,15135620004,0,1954,2455,0
15136480199,15136480204,5,5098,2384,0
15136633870,15136633870,0,1875,3320,0
15136793013,15136793013,0,1180,1969,0
15137543279,15137543281,2,1648,1924,0
15141124390,15141124393,3,1412,1380,0
15143426103,15143426094,-9,1662,8470,0
15147363559,15147363560,1,957,1446,0
15149257762,15149257757,-5,1080,2165,0
15150098152,15150098151,-1,1055,1347,0
15153191771,15153191782,11,1548,568,0
15153476686,15153476685,-1,1127,1704,0
15153643270,15153643270,0,1031,1584,0
15156194174,15156194175,1,1372,1376,0
15158450714,15158450714,0,1921,2205,0
15159216627,15159216628,1,929,1089,0
15161187642,15161187653,11,1120,1451,0
15161546346,15161546347,1,1509,1671,0
15164572909,15164572909,0,1270,2244,0
15164638545,15164638547,2,3158,1795,0
15165283821,15165283821,0,1659,1714,0
15165877753,15165877753,0,1084,1550,0
15168662585,15168662586,1,1233,1506,0
15171305158,15171305160,2,1675,1886,0
15173369627,15173369628,1,1073,929,0
15174635787,15174635786,-1,1509,1345,0
15177301234,15177301235,1,1362,2175,0
15178076873,15178076875,2,1817,1258,0
15180913680,15180913681,1,1366,1764,0
15180972836,15180972829,-7,278,892,0
15181584630,15181584629,-1,975,2053,0
15183282269,15183282272,3,1823,1632,0
15183568430,15183568430,0,1448,1418,0
15184174827,15184174826,-1,1645,1392,0
15186021946,15186021946,0,1626,1605,0
15187251181,15187251181,0,1491,1541,0
15188916983,15188916983,0,748,1267,0
15193103235,15193103234,-1,1352,1789,0
15193264963,15193264965,2,1898,1582,0
15194295717,15194295717,0,1100,1427,0
15195553716,15195553714,-2,1313,2057,0
15196516428,15196516427,-1,1414,1894,0
15197322359,15197322367,8,1030,1682,0
15198787435,15198787436,1,1014,1077,0
15207244539,15207244539,0,909,1253,0
15207306683,15207306682,-1,1421,2292,0
15210897186,15210897186,0,1112,1749,0
15215172964,15215172962,-2,1275,1525,0
15216009538,15216009538,0,1543,2113,0
15219136318,15219136321,3,1915,1808,0
15219382251,15219382248,-3,939,2616,0
15220261405,15220261405,0,1325,1581,0
15222871462,15222871463,1,1345,1817,0
15223182179,15223182178,-1,906,1179,0
15230749461,15230749471,10,30023,47707,0
15232048170,15232048171,1,956,1338,0
15232732688,15232732689,1,948,2429,0
15233096249,15233096248,-1,1084,1795,0
15234168346,15234168347,1,1861,1653,0
15234883488,15234883489,1,712,1077,0
15237275118,15237275118,0,1457,1938,0
15239789498,15239789500,2,1188,1682,0
15242740921,15242740919,-2,1056,1749,0
15244008897,15244008900,3,1403,1501,0
15245892759,15245892758,-1,1127,1592,0
15246101920,15246101934,14,1211,2815,0
15248134979,15248134974,-5,1249,3649,0
15248333096,15248333107,11,679,1727,0
15249104374,15249104373,-1,1224,1640,0
15251842005,15251842004,-1,1120,1588,0
15261285529,15261285530,1,1464,1811,0
15263806647,15263806650,3,1543,1581,0
15268065974,15268065975,1,1170,2069,0
15268100558,15268100558,0,2,728,0
15268543518,15268543523,5,1865,1743,0
15270973119,15270973119,0,1514,1553,0
15273352438,15273352439,1,815,1120,0
15273929283,15273929285,2,765,860,0
15274181482,15274181501,19,2612,1177,0
15278807424,15278807423,-1,1150,904,0
15282567932,15282567933,1,1618,2054,0
15286760411,15286760410,-1,1466,2176,0
15290720854,15290720855,1,1416,1668,0
15292511026,15292511023,-3,1472,1590,0
15293630694,15293630694,0,1450,1916,0
15293853589,15293853588,-1,1282,1751,0
15294555528,15294555527,-1,834,1215,0
15295616009,15295616009,0,1127,1388,0
15301661720,15301661717,-3,1137,2360,0
15302001736,15302001738,2,1269,1141,0
15303084694,15303084693,-1,1120,1789,0
15303132190,15303132179,-11,1248,1501,0
15304609805,15304609803,-2,1567,1632,0
15308220371,15308220371,0,1204,1469,0
15317185551,15317185551,0,1919,1751,0
15318538832,15318538831,-1,1145,1149,0
15322369969,15322369969,0,1379,1176,0
15327490841,15327490842,1,1157,1214,0
15328812102,15328812103,1,1623,1667,0
15330336324,15330336324,0,1892,2106,0
15332253758,15332253754,-4,3242,8648,0
15332820122,15332820120,-2,1893,5272,0
15334344886,15334344886,0,914,1776,0
15337921423,15337921422,-1,1428,1461,0
15338157303,15338157318,15,920,250,0
15339725450,15339725451,1,2257,2025,0
15339908451,15339908450,-1,1019,1566,0
15339946713,15339946713,0,1730,2138,0
15344244051,15344244055,4,1132,1306,0
15344558659,15344558657,-2,771,2120,0
15350175838,15350175817,-21,1322,1172,0
15355143086,15355143086,0,1599,1888,0
15355352354,15355352354,0,1145,1793,0
15356872820,15356872820,0,1617,1159,0
15359668135,15359668136,1,1797,1834,0
15365985641,15365985643,2,1557,1969,0
15367156089,15367156090,1,1371,1420,0
15371005852,15371005851,-1,1162,1538,0
15374091755,15374091758,3,1881,2137,0
15375379934,15375379934,0,743,980,0
15377987653,15377987650,-3,1282,1397,0
15379314941,15379314940,-1,1491,1834,0
15383382446,15383382446,0,1628,1714,0
15383735322,15383735322,0,1089,1505,0
15386516415,15386516414,-1,1242,2053,0
15389295648,15389295634,-14,1682,2462,0
15390714551,15390714554,3,1497,1569,0
15394161923,15394161923,0,1187,1619,0
15394760795,15394760794,-1,1524,1862,0
15398782134,15398782130,-4,1271,2052,0
15409122150,15409122144,-6,1134,2723,0
15411378370,15411378370,0,1399,1436,0
15412212122,15412212121,-1,1253,2561,0
15419692151,15419692153,2,1044,1802,0
15419931990,15419931989,-1,1342,1531,0
15420518560,15420518560,0,1209,1324,0
15420972907,15420972907,0,1138,1400,0
15421793873,15421793875,2,1551,1978,0
15423976269,15423976265,-4,990,3577,0
15424810889,15424810889,0,1460,1384,0
15425723450,15425723450,0,1664,1351,0
15427317923,15427317923,0,1373,1791,0
15427862122,15427862123,1,1275,1292,0
15429527286,15429527287,1,1423,1430,0
15431845177,15431845178,1,1369,1904,0
15432631678,15432631678,0,1491,1525,0
15433062366,15433062367,1,1269,1350,0
15433955374,15433955383,9,1328,1249,0
15434320637,15434320639,2,1644,2019,0
15435086586,15435086586,0,1732,1747,0
15437889686,15437889686,0,1625,1774,0
15442281612,15442281613,1,2020,1760,0
15443582758,15443582758,0,2586,3221,0
15448108894,15448108893,-1,1152,1978,0
15448240504,15448240507,3,1391,1356,0
15451083138,15451083138,0,950,1544,0
15451280295,15451280295,0,1362,1131,0
15453810365,15453810366,1,1355,1627,0
15456503922,15456503923,1,1054,1458,0
15458210160,15458210160,0,1258,1215,0
15462155322,15462155322,0,1158,1605,0
15462521934,15462521933,-1,2188,2052,0
15462959663,15462959662,-1,1522,1542,0
15463212594,15463212593,-1,1376,1881,0
15470619079,15470619077,-2,1907,2261,0
15471036369,15471036369,0,1970,1766,0
15476669735,15476669736,1,1880,2544,0
15477890786,15477890772,-14,695,484,0
15483461102,15483461103,1,1509,1957,0
15483576772,15483576773,1,2339,2412,0
15485683903,15485683904,1,1221,1609,0
15485938863,15485938843,-20,1339,2271,0
15487963143,15487963144,1,1365,2145,0
15488800424,15488800425,1,1463,1795,0
15491196228,15491196227,-1,1371,1421,0
15493053399,15493053396,-3,1199,2508,0
15493172229,15493172229,0,1597,1668,0
15494503199,15494503207,8,2673,812,0
15502978894,15502978897,3,1118,1698,0
15503031677,15503031678,1,1406,943,0
15504533670,15504533671,1,1421,1764,0
15507924309,15507924309,0,1464,2517,0
15512009514,15512009514,0,1523,1374,0
15513695559,15513695559,0,1326,1763,0
15519013606,15519013606,0,1357,1929,0
15519463777,15519463778,1,1415,1431,0
15520485518,15520485518,0,1070,1352,0
15522610801,15522610803,2,1199,1804,0
15525965746,15525965742,-4,912,2355,0
15527733631,15527733630,-1,1221,1011,0
15529518090,15529518097,7,3129,2772,0
15534023166,15534023167,1,1169,870,0
15536121545,15536121545,0,1424,1440,0
15536837362,15536837363,1,1238,1513,0
15538552157,15538552158,1,773,755,0
15542222157,15542222158,1,1021,1318,0
15544902354,15544902354,0,1744,1963,0
15545010162,15545010167,5,3179,1602,0
15546372859,15546372859,0,1306,1190,0
15549232711,15549232717,6,5845,3203,0
15550832754,15550832753,-1,1458,1208,0
15551460101,15551460099,-2,1287,2439,0
15553090550,15553090550,0,1377,1858,0
15553748793,15553748791,-2,1521,1522,0
15555888013,15555888014,1,1242,1030,0
15556542575,15556542573,-2,1045,1589,0
15557413753,15557413753,0,938,1217,0
15558481008,15558481010,2,1480,1922,0
15561895083,15561895071,-12,1183,1356,0
15562266697,15562266693,-4,1651,4265,0
15569600059,15569600060,1,1813,1338,0
15570953466,15570953467,1,928,777,0
15571410862,15571410863,1,1238,1557,0
15572661115,15572661115,0,1264,1664,0
15573055428,15573055430,2,1303,1620,0
15574148945,15574148947,2,1737,1221,0
15577115055,15577115058,3,1668,1460,0
15582413656,15582413657,1,1497,1423,0
15582590315,15582590316,1,1885,1585,0
15584246088,15584246090,2,1898,1322,0
15587178333,15587178353,20,623,1006,0
15588984016,15588984018,2,1015,918,0
15592076539,15592076548,9,3296,1751,0
15592133271,15592133260,-11,792,242,0
15595103539,15595103539,0,1604,1785,0
15596113666,15596113667,1,1255,1640,0
15603553712,15603553713,1,1356,1649,0
15604860342,15604860357,15,207,615,0
15614829854,15614829857,3,901,1107,0
15616535183,15616535183,0,1394,1650,0
15617673571,15617673572,1,1848,1907,0
15618394125,15618394127,2,882,1050,0
15622265191,15622265193,2,2316,2855,0
15623387033,15623387034,1,1035,1453,0
15624981793,15624981789,-4,1222,2935,0
15626839538,15626839538,0,1456,1603,0
15627932689,15627932690,1,1134,1450,0
15629218050,15629218049,-1,1548,2009,0
15630035206,15630035210,4,1112,1479,0
15632643689,15632643689,0,1371,2333,0
15635252650,15635252650,0,1111,1541,0
15637741682,15637741681,-1,1263,1736,0
15639466885,15639466885,0,1995,2255,0
15640089410,15640089409,-1,1437,1685,0
15642218131,15642218131,0,1479,1548,0
15643856156,15643856157,1,1977,2407,0
15645861744,15645861745,1,1175,1752,0
15647028688,15647028686,-2,1500,1900,0
15647898366,15647898367,1,1494,1626,0
15650680149,15650680151,2,1390,2564,0
15650999754,15650999752,-2,1569,1803,0
15651480495,15651480493,-2,1343,1710,0
15651671878,15651671878,0,1458,1848,0
15652855102,15652855103,1,2418,2077,0
15653485178,15653485179,1,2056,2114,0
15655197229,15655197217,-12,1086,1639,0
15659359878,15659359878,0,936,1194,0
15661123625,15661123625,0,1622,2268,0
15664016098,15664016098,0,2143,3275,0
15666087907,15666087907,0,1197,1118,0
15673804437,15673804431,-6,1462,4988,0
15683142750,15683142751,1,1738,1437,0
15684744470,15684744474,4,1447,1667,0
15687291831,15687291825,-6,2005,7449,0
15687624657,15687624640,-17,1378,1731,0
15688763450,15688763469,19,1410,1914,0
15688923883,15688923863,-20,1264,1272,0
15690246973,15690246974,1,1579,1930,0
15692727823,15692727822,-1,1170,1493,0
15693083136,15693083141,5,901,1940,0
15693877847,15693877848,1,1442,1653,0
15694499758,15694499757,-1,1524,2053,0
15696820061,15696820062,1,1448,2305,0
15699959185,15699959180,-5,1020,2795,0
15705153657,15705153658,1,771,963,0
15706226249,15706226250,1,1205,1000,0
15709379434,15709379435,1,1567,2237,0
15710602713,15710602714,1,1659,1522,0
15714156697,15714156697,0,1434,1414,0
15714800410,15714800409,-1,978,1977,0
15716200133,15716200135,2,1512,1784,0
15718426309,15718426310,1,1264,2034,0
15718922376,15718922376,0,1327,1924,0
15720022094,15720022093,-1,1376,1895,0
15721098562,15721098563,1,1712,2034,0
15728313820,15728313818,-2,1179,1224,0
15731499469,15731499482,13,1368,1803,0
15732670451,15732670453,2,1756,1818,0
15733617238,15733617246,8,4879,1761,0
15737242614,15737242614,0,1458,1315,0
15740728068,15740728064,-4,904,1272,0
15741791150,15741791150,0,1358,1397,0
15747863641,15747863643,2,1847,1596,0
15748358342,15748358345,3,630,924,0
15751930633,15751930629,-4,1251,2709,0
15752355122,15752355123,1,1503,1593,0
15753313218,15753313218,0,1369,1510,0
15753399962,15753399966,4,9328,4233,0
15755427292,15755427295,3,1238,1132,0
15756238743,15756238748,5,2240,1758,0
15756461762,15756461774,12,10079,43426,0
15756871981,15756871981,0,1801,2502,0
15757706850,15757706852,2,1199,1602,0
15759913683,15759913682,-1,1026,1840,0
15765346366,15765346367,1,2503,1766,0
15766527761,15766527763,2,1205,1844,0
15766693828,15766693829,1,1521,2798,0
15767683334,15767683333,-1,1503,3045,0
15768217834,15768217835,1,1316,1472,0
15768842152,15768842153,1,1889,2186,0
15771809074,15771809076,2,1703,1708,0
15772370337,15772370338,1,1522,1364,0
15773537949,15773537951,2,1745,1903,0
15773701330,15773701331,1,1611,2366,0
15781026001,15781026002,1,935,1276,0
15783065021,15783065022,1,1708,1422,0
15783827792,15783827797,5,1432,1352,0
15785463898,15785463898,0,1019,1339,0
15788946741,15788946743,2,1544,1328,0
15789322511,15789322502,-9,1076,1262,0
15795188747,15795188746,-1,1029,1614,0
15796923661,15796923663,2,1456,1297,0
15798951667,15798951666,-1,1361,1904,0
15801825695,15801825696,1,1264,1276,0
15802886906,15802886907,1,1699,1814,0
15809399798,15809399801,3,1130,2058,0
15810842065,15810842065,0,1363,1412,0
15812081137,15812081130,-7,1712,7434,0
15816485965,15816485965,0,1331,1760,0
15816879667,15816879666,-1,1353,1391,0
15817633445,15817633438,-7,1136,4720,0
15819408986,15819408985,-1,1510,1636,0
15821574891,15821574890,-1,1384,1963,0
15821756789,15821756790,1,1529,1619,0
15825135789,15825135789,0,1089,1151,0
15826054031,15826054031,0,1687,1835,0
15827434655,15827434661,6,1347,1612,0
15828669242,15828669242,0,1466,1862,0
15833357634,15833357623,-11,14728,27062,0
15834102469,15834102469,0,909,2082,0
15838889082,15838889084,2,1785,2076,0
15841562506,15841562504,-2,938,2084,0
15842991599,15842991600,1,1703,1621,0
15845265945,15845265946,1,1718,2126,0
15846982304,15846982304,0,1537,1918,0
15849260923,15849260925,2,1322,1740,0
15849645571,15849645562,-9,628,3015,0
15852328105,15852328106,1,1551,1120,0
15855806280,15855806286,6,2652,1119,0
15858341838,15858341838,0,1864,2042,0
15858392321,15858392321,0,1465,2428,0
15861951050,15861951050,0,1015,1896,0
15862969917,15862969917,0,2122,2288,0
15863252599,15863252598,-1,1302,1985,0
15863873367,15863873366,-1,1573,1661,0
15865788329,15865788329,0,2025,1827,0
15869256974,15869256974,0,1263,999,0
15871531018,15871531020,2,1039,675,0
15871969136,15871969140,4,1887,285,0
15872806994,15872806994,0,1224,1529,0
15874560282,15874560283,1,944,1538,0
15877502534,15877502532,-2,1492,2367,0
15880652757,15880652758,1,1822,1494,0
15882464258,15882464258,0,1140,1222,0
15882836834,15882836835,1,1291,1610,0
15885338311,15885338312,1,918,1334,0
15887544716,15887544718,2,3576,26791,0
15888759135,15888759135,0,1119,1423,0
15889989545,15889989546,1,1740,1775,0
15893358715,15893358717,2,1683,1956,0
15897071329,15897071314,-15,1282,1614,0
15898363224,15898363222,-2,1116,1364,0
15902601088,15902601089,1,1114,1537,0
15903270458,15903270462,4,2295,1525,0
15909127029,15909127029,0,1452,1671,0
15911428235,15911428232,-3,1465,1335,0
15912011999,15912011999,0,1068,1889,0
15913203827,15913203827,0,1129,2025,0
15915973370,15915973370,0,1505,1208,0
15923883351,15923883353,2,891,1155,0
15926239766,15926239765,-1,540,1079,0
15929296850,15929296849,-1,1378,1382,0
15931130857,15931130856,-1,3004,4501,0
15932381985,15932381986,1,849,1555,0
15933298376,15933298376,0,1632,1529,0
15938719326,15938719325,-1,1964,2134,0
15940555950,15940555950,0,1556,1701,0
15940909470,15940909469,-1,1492,1723,0
15941382458,15941382459,1,1397,1143,0
15942132041,15942132044,3,1050,981,0
15942599968,15942599970,2,1245,1439,0
15944270121,15944270121,0,1291,2698,0
15944945502,15944945502,0,1283,1312,0
15945918138,15945918142,4,1267,1629,0
15948803022,15948803025,3,778,1074,0
15949361928,15949361926,-2,803,1621,0
15950390873,15950390874,1,1085,1139,0
15950778669,15950778670,1,1397,1597,0
15950891868,15950891868,0,1236,1694,0
15952293654,15952293655,1,1326,1234,0
15954625832,15954625830,-2,1210,2153,0
15956199934,15956199934,0,1184,1694,0
15956481717,15956481718,1,1355,1915,0
15957679035,15957679038,3,978,1592,0
15958158487,15958158477,-10,1298,1316,0
15959767250,15959767252,2,1289,1624,0
15960975510,15960975511,1,929,1155,0
15961567433,15961567434,1,758,881,0
15962205263,15962205263,0,1266,1639,0
15965233975,15965233976,1,1308,1812,0
15968452725,15968452725,0,1302,1504,0
15971676550,15971676551,1,1388,2070,0
15973663684,15973663687,3,3050,2118,0
15975063188,15975063186,-2,1191,1476,0
15975353093,15975353092,-1,1427,1613,0
15975795163,15975795162,-1,692,1182,0
15977112183,15977112184,1,1432,1951,0
15978997738,15978997739,1,1706,1661,0
15981208542,15981208551,9,100,2237,0
15981798303,15981798288,-15,33,783,0
15990336426,15990336428,2,1592,2597,0
15992093066,15992093066,0,3024,2129,0
15992149787,15992149786,-1,1179,1571,0
15996327389,15996327390,1,1045,2160,0
15996527045,15996527046,1,1129,1162,0
15996905289,15996905285,-4,797,2034,0
16002854207,16002854207,0,1185,1013,0
16005606830,16005606834,4,2485,1828,0
16007478694,16007478694,0,1267,2168,0
16007559037,16007559038,1,1349,1640,0
16009983001,16009982999,-2,1229,1775,0
16011212039,16011212039,0,1256,1482,0
16012080270,16012080274,4,1464,1143,0
16013344972,16013344965,-7,1394,2867,0
16016946997,16016947006,9,1583,1858,0
16018465166,16018465167,1,3220,3682,0
16018727117,16018727119,2,1401,1698,0
16022457726,16022457727,1,1297,1519,0
16022702960,16022702958,-2,1651,1609,0
16023930386,16023930386,0,1227,1586,0
16024637798,16024637797,-1,1306,1227,0
16027953268,16027953270,2,1073,1321,0
16031679219,16031679217,-2,1421,2380,0
16031831858,16031831858,0,1507,1674,0
16032673056,16032673057,1,1831,1870,0
16032801714,16032801720,6,12805,36492,0
16035046466,16035046466,0,1046,1062,0
16037184771,16037184769,-2,1457,1782,0
16038304302,16038304307,5,1821,1117,0
16039506059,16039506056,-3,1416,1816,0
16041058542,16041058542,0,1309,1725,0
16044139522,16044139522,0,1652,1740,0
16045312081,16045312082,1,2176,1876,0
16047285217,16047285216,-1,1231,2111,0
16048938611,16048938610,-1,1217,1531,0
16049481427,16049481430,3,1099,1476,0
16051489343,16051489341,-2,1140,1327,0
16052166010,16052166012,2,1168,1414,0
16054638686,16054638686,0,1233,1912,0
16060267196,16060267194,-2,980,1540,0
16061561511,16061561509,-2,1150,1578,0
16062036577,16062036578,1,1215,1537,0
16062906979,16062906980,1,1270,1347,0
16064456285,16064456284,-1,1353,1684,0
16067857218,16067857217,-1,1275,1586,0
16071756486,16071756488,2,1512,1868,0
16073777428,16073777429,1,2139,1794,0
16073852250,16073852239,-11,4596,196,0
16074393377,16074393383,6,2063,1482,0
16076735163,16076735166,3,1278,1836,0
16076890798,16076890798,0,1272,1399,0
16079221946,16079221938,-8,3,451,0
16079607478,16079607456,-22,1333,1824,0
16081257732,16081257733,1,1889,2299,0
16081379922,16081379923,1,1309,1193,0
16082086448,16082086445,-3,1116,1583,0
16082843634,16082843634,0,1004,1670,0
16085390388,16085390389,1,1606,2048,0
16089691467,16089691469,2,1193,1706,0
16092782486,16092782489,3,2213,2614,0
16092871250,16092871257,7,3074,1075,0
16092980866,16092980866,0,1549,1145,0
16095619350,16095619350,0,1252,1548,0
16096276458,16096276461,3,1167,1480,0
16098125874,16098125874,0,1237,1339,0
16100205666,16100205670,4,1800,1479,0
16100296526,16100296526,0,1040,1156,0
16105383806,16105383806,0,1366,1508,0
16111074907,16111074906,-1,1255,1557,0
16113745357,16113745356,-1,1668,2307,0
16114262214,16114262218,4,1849,1401,0
16114965978,16114965979,1,925,943,0
16117315326,16117315327,1,1538,1575,0
16117356230,16117356231,1,1596,1389,0
16119887005,16119887007,2,1379,1796,0
16120187954,16120187955,1,1159,1479,0
16120917909,16120917909,0,1838,2235,0
16121120534,16121120535,1,1246,1424,0
16121775484,16121775484,0,1243,1518,0
16123163625,16123163626,1,1315,2008,0
16124300087,16124300084,-3,1204,1519,0
16131592542,16131592549,7,3454,1507,0
16133350212,16133350213,1,1276,1874,0
16139093182,16139093182,0,1348,1406,0
16139968246,16139968250,4,2967,1617,0
16144144254,16144144254,0,1288,1528,0
16146729378,16146729378,0,2030,2319,0
16147307314,16147307314,0,914,1346,0
16150299298,16150299299,1,1267,1648,0
16156072873,16156072873,0,4203,16307,0
16160055410,16160055411,1,1724,1565,0
16160226590,16160226590,0,1943,2482,0
16163581403,16163581405,2,2014,2321,0
16164535949,16164535951,2,1273,1817,0
16166304208,16166304208,0,988,1640,0
16167197893,16167197891,-2,1590,1639,0
16167296731,16167296734,3,1694,1585,0
16168373417,16168373402,-15,2618,1054,0
16168898995,16168898999,4,1298,1260,0
16170466506,16170466507,1,1125,1664,0
16170811633,16170811635,2,1177,1019,0
16172675961,16172675960,-1,1126,2070,0
16175033628,16175033629,1,1731,1171,0
16177980402,16177980404,2,1063,1265,0
16178718034,16178718033,-1,871,1145,0
16178904610,16178904611,1,1391,1687,0
16181632740,16181632734,-6,722,1996,0
16186336702,16186336703,1,1754,1862,0
16188767262,16188767263,1,1479,2334,0
16190045714,16190045714,0,1520,1780,0
16190330021,16190330021,0,1949,1788,0
16191301311,16191301324,13,640,992,0
16193939107,16193939110,3,1562,1703,0
16194609974,16194609976,2,1750,2172,0
16194809639,16194809641,2,2186,1880,0
16195238707,16195238706,-1,1187,1462,0
16198097794,16198097796,2,1926,1522,0
16198421229,16198421247,18,1974,1674,0
16198839601,16198839600,-1,1881,2289,0
16201690673,16201690673,0,1409,2153,0
16202833831,16202833830,-1,1336,1819,0
16205495187,16205495189,2,1806,1534,0
16208406362,16208406365,3,1980,1868,0
16209178627,16209178629,2,1300,1313,0
16210843993,16210843994,1,1125,1501,0
16211002529,16211002510,-19,1252,1112,0
16213023081,16213023081,0,1381,2147,0
16214935199,16214935202,3,2478,1028,0
16215095794,16215095795,1,2165,2354,0
16218988106,16218988107,1,1175,1456,0
16220224506,16220224502,-4,838,1208,0
16222197094,16222197094,0,1682,2316,0
16222343618,16222343618,0,1401,1719,0
16223944515,16223944516,1,1686,1654,0
16224713781,16224713781,0,1290,2118,0
16230878329,16230878328,-1,1717,1892,0
16230937391,16230937392,1,1375,1659,0
16232835853,16232835855,2,1580,1289,0
16235153394,16235153394,0,1267,2003,0
16235642317,16235642318,1,1959,2073,0
16236464726,16236464726,0,742,1102,0
16237624122,16237624122,0,1728,1634,0
16239269006,16239269007,1,1397,1639,0
16241072210,16241072190,-20,1062,445,0
16242171073,16242171073,0,1524,1514,0
16247013053,16247013054,1,1627,1239,0
16250569323,16250569323,0,1153,1964,0
16255207893,16255207895,2,1179,1020,0
16256345684,16256345670,-14,1267,1407,0
16258438077,16258438078,1,1524,1777,0
16258676747,16258676746,-1,1109,1984,0
16260492428,16260492428,0,1361,1756,0
16262529259,16262529261,2,1577,1629,0
16264056254,16264056254,0,1262,1523,0
16265510743,16265510745,2,1538,2004,0
16269478981,16269478979,-2,1466,1786,0
16271132381,16271132383,2,1201,1209,0
16273532391,16273532390,-1,774,1164,0
16277354574,16277354575,1,1316,1961,0
16280591750,16280591751,1,949,1578,0
16281434270,16281434271,1,216,1532,0
16284836529,16284836526,-3,1387,1497,0
16285343845,16285343846,1,1309,1608,0
16287199150,16287199144,-6,1888,5267,0
16287677190,16287677200,10,11219,46305,0
16289045154,16289045154,0,1363,1888,0
16290326623,16290326622,-1,1797,2220,0
16291477669,16291477671,2,1649,1303,0
16291966115,16291966117,2,1150,1441,0
16292599006,16292599007,1,1010,1756,0
16293392539,16293392538,-1,878,1705,0
16295830147,16295830148,1,1017,1209,0
16296921099,16296921098,-1,1523,2230,0
16297934938,16297934940,2,1101,1808,0
16298806649,16298806649,0,1088,1646,0
16299217036,16299217039,3,3278,2477,0
16299315840,16299315842,2,1180,1190,0
16301336167,16301336166,-1,757,1594,0
16302880537,16302880538,1,1348,1345,0
16303251805,16303251803,-2,1468,1482,0
16303812765,16303812765,0,1160,1818,0
16305092038,16305092038,0,983,1187,0
16305118810,16305118809,-1,1339,2016,0
16308611633,16308611635,2,1708,1682,0
16309340422,16309340422,0,1410,2064,0
16311850546,16311850546,0,752,1393,0
16311909623,16311909622,-1,1086,1778,0
16312084355,16312084356,1,1134,1559,0
16313772656,16313772653,-3,1348,1242,0
16316030165,16316030165,0,1397,1409,0
16322315478,16322315479,1,950,1345,0
16322920067,16322920068,1,1557,1557,0
16326416262,16326416262,0,1231,1197,0
16329794774,16329794768,-6,1258,3503,0
16330165606,16330165606,0,1494,1229,0
16331502428,16331502428,0,2008,1738,0
16332328884,16332328891,7,3753,1165,0
16332956524,16332956526,2,1174,1587,0
16333172118,16333172138,20,1145,1020,0
16333334430,16333334431,1,1744,1968,0
16333799550,16333799551,1,1613,1523,0
16334696082,16334696086,4,1076,1140,0
16335295817,16335295816,-1,1410,1353,0
16335987477,16335987477,0,1563,1540,0
16336893490,16336893490,0,1539,1659,0
16338924238,16338924238,0,1596,1533,0
16339496531,16339496532,1,1645,1707,0
16342644676,16342644678,2,1334,1518,0
16349226077,16349226082,5,1227,1397,0
16352781330,16352781351,21,1614,1446,0
16353535770,16353535771,1,1709,1589,0
16356851140,16356851139,-1,1543,2797,0
16356904950,16356904949,-1,1175,1794,0
16357153714,16357153716,2,1221,1638,0
16357258323,16357258321,-2,986,1858,0
16357642425,16357642427,2,2458,2312,0
16357903057,16357903058,1,1624,1712,0
16358324491,16358324492,1,1097,1265,0
16360371244,16360371233,-11,986,1199,0
16362633437,16362633439,2,1317,839,0
16365838295,16365838294,-1,1000,1467,0
16370095686,16370095687,1,1767,1978,0
16371008075,16371008075,0,1480,1576,0
16372581801,16372581799,-2,1761,1523,0
16372832306,16372832307,1,926,1201,0
16375180263,16375180262,-1,1117,2148,0
16375460974,16375460974,0,1194,1307,0
16376615020,16376615042,22,577,719,0
16377152350,16377152350,0,857,1421,0
16377507153,16377507156,3,1324,1448,0
16379481567,16379481570,3,1418,1511,0
16380357379,16380357379,0,1023,1178,0
16382764642,16382764643,1,1564,1346,0
16393206559,16393206562,3,1535,2149,0
16397655978,16397655978,0,955,1864,0
16398667734,16398667735,1,1781,1726,0
16399761173,16399761174,1,1468,2133,0
16404870842,16404870841,-1,1379,1480,0
16406452583,16406452583,0,1522,1653,0
16409183499,16409183501,2,948,1608,0
16414054189,16414054189,0,1490,1996,0
16414727501,16414727503,2,1426,1374,0
16418676380,16418676381,1,2137,2327,0
16420501477,16420501476,-1,1528,1456,0
16423557610,16423557612,2,1133,1753,0
16423802303,16423802303,0,835,1379,0
16425454739,16425454739,0,1342,2155,0
16425508630,16425508633,3,1946,1562,0
16426470824,16426470823,-1,1248,1671,0
16428097517,16428097517,0,807,1976,0
16430755829,16430755828,-1,978,1541,0
16432799702,16432799706,4,1335,1279,0
16439377573,16439377577,4,1229,1276,0
16440222708,16440222708,0,1352,1445,0
16441189291,16441189290,-1,1457,2417,0
16445397438,16445397439,1,1257,1858,0
16450726754,16450726756,2,1327,1456,0
16450866715,16450866718,3,1919,1923,0
16452008853,16452008852,-1,1554,2428,0
16452671196,16452671197,1,1656,1598,0
16454345350,16454345354,4,2077,2103,0
16455066555,16455066555,0,1101,1298,0
16456325618,16456325618,0,1510,2388,0
16457018278,16457018274,-4,853,1292,0
16457692506,16457692505,-1,988,1282,0
16461113783,16461113786,3,1697,1298,0
16461755291,16461755293,2,2329,2597,0
16465664855,16465664857,2,897,1447,0
16466637024,16466637026,2,1978,1912,0
16469753461,16469753460,-1,1407,1632,0
16471368411,16471368411,0,1434,1966,0
16472070114,16472070114,0,1515,1738,0
16478173478,16478173477,-1,929,1283,0
16479968534,16479968533,-1,1374,1942,0
16481650035,16481650034,-1,1100,1999,0
16481706513,16481706510,-3,1159,1211,0
16484586445,16484586445,0,1664,1689,0
16484906586,16484906586,0,1063,2139,0
16485447939,16485447939,0,922,1302,0
16487486458,16487486457,-1,759,975,0
16492835934,16492835933,-1,1514,2053,0
16496505821,16496505822,1,1209,1533,0
16496534355,16496534353,-2,1081,2173,0
16498132081,16498132081,0,1941,1789,0
16499521123,16499521125,2,2198,2092,0
16499803850,16499803853,3,2022,1517,0
16499942644,16499942642,-2,1393,1273,0
16501249783,16501249784,1,1004,1213,0
16502185398,16502185401,3,3623,2748,0
16503947755,16503947735,-20,1312,2350,0
16504748903,16504748911,8,3672,1296,0
16505785793,16505785797,4,1483,1423,0
16506621080,16506621077,-3,1701,2211,0
16506987639,16506987639,0,949,1101,0
16510493164,16510493163,-1,1470,1877,0
16511963965,16511963966,1,1590,1579,0
16514921329,16514921337,8,1917,1123,0
16516119071,16516119071,0,859,1242,0
16516731447,16516731447,0,1410,1943,0
16518522620,16518522619,-1,1192,1470,0
16520623835,16520623836,1,1236,1716,0
16521677981,16521677982,1,1818,2543,0
16522982595,16522982597,2,1806,1703,0
16524660586,16524660586,0,1237,2281,0
16529242204,16529242197,-7,1936,10480,0
16531254810,16531254811,1,1060,1837,0
16531804626,16531804627,1,1778,1180,0
16532049166,16532049166,0,1111,1773,0
16533468348,16533468342,-6,998,5174,0
16539018557,16539018558,1,1128,1608,0
16539816462,16539816463,1,741,886,0
16540663654,16540663653,-1,913,1909,0
16541716074,16541716075,1,1285,986,0
16542187582,16542187581,-1,1792,2398,0
16549041810,16549041812,2,1083,1711,0
16550193587,16550193589,2,1331,1676,0
16552881763,16552881761,-2,1063,1701,0
16554228979,16554228979,0,2171,2439,0
16554323295,16554323294,-1,1736,1518,0
16556754820,16556754822,2,880,1667,0
16558487766,16558487767,1,1086,1063,0
16563605877,16563605877,0,1601,1571,0
16565769627,16565769627,0,2013,1856,0
16570034492,16570034492,0,1503,1459,0
16572252922,16572252922,0,1187,1867,0
16574159933,16574159933,0,1212,2376,0
16575060627,16575060628,1,1150,1249,0
16577998834,16577998834,0,1550,1678,0
16578449021,16578449023,2,1256,1972,0
16578548202,16578548199,-3,1900,1506,0
16579981354,16579981356,2,779,962,0
16583358390,16583358392,2,1524,1785,0
16588621332,16588621330,-2,1808,1571,0
16589752175,16589752176,1,1454,1305,0
16594280609,16594280608,-1,1188,1248,0
16595077738,16595077738,0,1243,1968,0
16597050262,16597050262,0,1380,1454,0
16600500826,16600500826,0,1529,1383,0
16602182943,16602182942,-1,1201,1452,0
16603874228,16603874228,0,1513,1615,0
16612274450,16612274452,2,1371,1566,0
16615172215,16615172218,3,1458,1358,0
16617344202,16617344201,-1,1000,1762,0
16624478211,16624478211,0,1384,1269,0
16630199719,16630199718,-1,1086,2205,0
16630850069,16630850070,1,1579,1484,0
16631762006,16631762008,2,1777,1896,0
16631988961,16631988959,-2,1289,1485,0
16634656247,16634656247,0,1179,1618,0
16635372074,16635372074,0,1540,1646,0
16638843093,16638843093,0,1649,1668,0
16639282398,16639282399,1,1383,1705,0
16641841543,16641841543,0,1390,2194,0
16641878088,16641878088,0,1732,1636,0
16642801897,16642801895,-2,1551,2050,0
16649254136,16649254139,3,1479,1182,0
16649451333,16649451334,1,1467,1757,0
16650089559,16650089555,-4,1073,1628,0
16652644282,16652644282,0,1163,1528,0
16656846101,16656846100,-1,1429,2001,0
16656918957,16656918950,-7,1165,5456,0
16658067792,16658067791,-1,1196,1798,0
16659644934,16659644936,2,1519,967,0
16660279487,16660279491,4,833,1435,0
16661150973,16661150972,-1,822,816,0
16662709041,16662709042,1,1093,1944,0
16663019800,16663019813,13,1290,1383,0
16663209886,16663209889,3,1207,1652,0
16664823741,16664823738,-3,1561,1973,0
16667850399,16667850400,1,1215,1467,0
16669734357,16669734359,2,2187,1832,0
16669819406,16669819406,0,1426,1991,0
16671007354,16671007354,0,1450,1449,0
16672259367,16672259371,4,995,1414,0
16672445288,16672445290,2,965,1317,0
16675178312,16675178313,1,1144,1714,0
16678684186,16678684186,0,1063,1497,0
16682424626,16682424626,0,1465,1751,0
16686058830,16686058829,-1,1035,1675,0
16686145075,16686145075,0,1730,1490,0
16688735488,16688735486,-2,1261,1756,0
16689709231,16689709230,-1,1316,2383,0
16689802663,16689802661,-2,950,1348,0
16690817834,16690817834,0,1396,1971,0
16692049545,16692049546,1,1249,2238,0
16692368899,16692368895,-4,1445,1324,0
16694471090,16694471090,0,1452,1884,0
16698163092,16698163093,1,844,1388,0
16698710397,16698710398,1,1499,1448,0
16699137006,16699137007,1,1546,1476,0
16705436567,16705436569,2,1601,1392,0
16705939406,16705939413,7,2407,997,0
16708915425,16708915430,5,2177,1080,0
16709817182,16709817178,-4,1037,1844,0
16717631062,16717631054,-8,25598,14191,0
16722277240,16722277241,1,1306,2155,0
16722860962,16722860963,1,844,1262,0
16728160611,16728160606,-5,1196,3940,0
16728930981,16728930982,1,1177,1395,0
16730358063,16730358063,0,1641,1646,0
16730875627,16730875624,-3,1512,2322,0
16734165094,16734165095,1,1216,1515,0
16734608349,16734608337,-12,1157,1877,0
16736949449,16736949450,1,921,2606,0
16737199173,16737199164,-9,1022,4675,0
16741280206,16741280207,1,1536,2150,0
16744167990,16744167992,2,1596,1815,0
16746229771,16746229769,-2,951,2016,0
16748811914,16748811915,1,1236,1603,0
16749415628,16749415626,-2,1061,1263,0
16751588354,16751588349,-5,925,2940,0
16753380382,16753380383,1,1266,900,0
16753888391,16753888397,6,1530,1204,0
16756802406,16756802406,0,1197,1924,0
16761300667,16761300667,0,1334,1460,0
16761727061,16761727063,2,1659,1673,0
16762379664,16762379670,6,4559,1593,0
16763469966,16763469967,1,1613,2212,0
16764021770,16764021773,3,1430,1592,0
16767681607,16767681608,1,1178,1403,0
16775691846,16775691852,6,1139,873,0
16778960762,16778960764,2,1560,1950,0
16779490335,16779490335,0,1217,1750,0
16782227693,16782227691,-2,1382,1705,0
16783717962,16783717965,3,1257,1562,0
16784339237,16784339237,0,1351,2222,0
16787460716,16787460717,1,3172,2472,0
16789899827,16789899827,0,1358,1695,0
16791322883,16791322885,2,1395,1748,0
16797520923,16797520921,-2,887,958,0
16798515847,16798515850,3,1079,1484,0
16802399994,16802399994,0,1156,1385,0
16802732750,16802732742,-8,1074,2413,0
16804931950,16804931950,0,972,1354,0
16807382401,16807382402,1,1417,1542,0
16811529686,16811529686,0,1925,1858,0
16812028698,16812028698,0,1352,1677,0
16812987506,16812987506,0,1751,2266,0
16814635619,16814635618,-1,1139,2437,0
16819066519,16819066519,0,525,1406,0
16821132037,16821132038,1,1483,2045,0
16822933066,16822933067,1,520,1225,0
16823256101,16823256101,0,1678,2227,0
16823298693,16823298692,-1,1738,3667,0
16824108567,16824108566,-1,1468,1614,0
16824877654,16824877654,0,909,917,0
16825497052,16825497051,-1,1360,2132,0
16829039732,16829039733,1,1456,2023,0
16829664959,16829664958,-1,1424,2044,0
16832474646,16832474646,0,1081,2168,0
16832802511,16832802502,-9,988,1288,0
16837367263,16837367264,1,956,1635,0
16837929843,16837929847,4,2374,1223,0
16838038108,16838038095,-13,1210,1382,0
16839841622,16839841621,-1,1622,1713,0
16841574211,16841574207,-4,841,1365,0
16842610851,16842610850,-1,1448,1675,0
16843468021,16843468019,-2,1006,1821,0
16845935571,16845935571,0,1169,1184,0
16849145350,16849145351,1,1471,2675,0
16850186062,16850186061,-1,1375,1663,0
16851241887,16851241889,2,1099,1514,0
16851346387,16851346387,0,1088,1211,0
16854965204,16854965206,2,1149,1659,0
16858330278,16858330281,3,832,1362,0
16859329489,16859329491,2,1403,1873,0
16859510479,16859510480,1,1501,1799,0
16860056951,16860056950,-1,1386,1803,0
16860497491,16860497493,2,1634,1298,0
16862690959,16862690954,-5,1105,1708,0
16863741515,16863741517,2,1052,1594,0
16866145608,16866145610,2,1468,2001,0
16866233194,16866233196,2,1435,2157,0
16868393310,16868393311,1,1494,1630,0
16873361198,16873361198,0,1674,2179,0
16874573598,16874573602,4,1426,1407,0
16874957142,16874957142,0,2095,2544,0
16875481396,16875481406,10,13771,32134,0
16879298094,16879298096,2,1515,1689,0
16882187142,16882187137,-5,1714,3864,0
16885114335,16885114335,0,1552,1918,0
16886167703,16886167703,0,1344,1389,0
16886466605,16886466605,0,1287,1923,0
16886924486,16886924486,0,577,804,0
16887964758,16887964760,2,1473,1860,0
16891104295,16891104295,0,1054,1738,0
16891518377,16891518377,0,1431,1559,0
16891825370,16891825369,-1,1352,2161,0
16894531110,16894531111,1,2338,2553,0
16894606637,16894606637,0,1452,1781,0
16896785110,16896785110,0,1759,1860,0
16897798896,16897798897,1,1997,2018,0
16898566622,16898566622,0,1596,2257,0
16902627070,16902627073,3,1232,1315,0
16908737901,16908737900,-1,1190,1434,0
16909563169,16909563172,3,1099,938,0
16909918803,16909918802,-1,866,1706,0
16913334562,16913334562,0,989,797,0
16914152650,16914152647,-3,932,1566,0
16914408113,16914408114,1,1224,1666,0
16916367827,16916367832,5,2787,1687,0
16917134730,16917134731,1,1815,1727,0
16917556418,16917556418,0,1495,1703,0
16918732421,16918732423,2,1786,1392,0
16921324107,16921324107,0,1493,2110,0
16921950889,16921950889,0,1273,1376,0
16926244634,16926244633,-1,1492,1811,0
16926359235,16926359235,0,1063,1100,0
16929173651,16929173654,3,1766,1255,0
16932235361,16932235362,1,1167,1498,0
16936496366,16936496366,0,1374,1331,0
16942114802,16942114802,0,1191,1715,0
16950347566,16950347566,0,974,1370,0
16953047367,16953047366,-1,1432,1833,0
16957299182,16957299184,2,2333,2192,0
16962285514,16962285513,-1,1313,2123,0
16963496899,16963496878,-21,1169,1271,0
16964040107,16964040107,0,1280,1125,0
16964517270,16964517271,1,1306,1951,0
16966033753,16966033754,1,1296,1257,0
16966381251,16966381251,0,898,1867,0
16967667744,16967667749,5,3104,813,0
16967874717,16967874717,0,1429,1707,0
16968070438,16968070442,4,2238,2541,0
16970138723,16970138722,-1,1033,1852,0
16971307687,16971307685,-2,1005,1170,0
16972515498,16972515498,0,1095,1590,0
16973297012,16973297014,2,2029,2221,0
16973922782,16973922779,-3,2138,5881,0
16978264061,16978264058,-3,1210,1204,0
16980085183,16980085184,1,1381,1510,0
16983720004,16983720006,2,1629,1732,0
16984871967,16984871968,1,1209,1688,0
16989291066,16989291067,1,1556,2163,0
16992888454,16992888457,3,1360,1884,0
16994144232,16994144234,2,1318,1736,0
16995829686,16995829686,0,1954,2464,0
16997278751,16997278751,0,1524,2458,0
17000782761,17000782759,-2,1463,2294,0
17001211421,17001211442,21,461,763,0
17003932589,17003932590,1,1052,1416,0
17005944310,17005944311,1,1200,1350,0
17015758564,17015758561,-3,1524,2147,0
17016518264,17016518262,-2,2002,2464,0
17022294022,17022294020,-2,1050,1652,0
17026009438,17026009439,1,1336,1842,0
17027343252,17027343251,-1,854,1342,0
17030942682,17030942682,0,889,1224,0
17034811484,17034811482,-2,1451,1584,0
17037971641,17037971642,1,1803,1790,0
17045471414,17045471413,-1,1331,1668,0
17049678430,17049678429,-1,2554,4275,0
17050570019,17050570019,0,881,1040,0
17051175335,17051175336,1,934,1300,0
17054947594,17054947595,1,1124,1995,0
17055209068,17055209059,-9,1577,1661,0
17055527929,17055527929,0,1993,2477,0
17057196206,17057196205,-1,1368,2034,0
17059822184,17059822184,0,1323,2095,0
17060233358,17060233356,-2,1389,1873,0
17061141071,17061141073,2,1300,1978,0
17064634090,17064634091,1,1179,1630,0
17065987683,17065987675,-8,1537,2245,0
17069460575,17069460576,1,1461,1470,0
17072169392,17072169394,2,1717,1678,0
17074497429,17074497428,-1,1609,2631,0
17077222137,17077222143,6,1910,685,0
17077663183,17077663182,-1,1019,1744,0
17080835718,17080835718,0,1001,1765,0
17089576332,17089576331,-1,1487,1705,0
17091008586,17091008586,0,1234,1540,0
17092032701,17092032703,2,1595,874,0
17095832693,17095832696,3,2609,1547,0
17095858445,17095858446,1,1415,1953,0
17096925154,17096925153,-1,1192,1705,0
17099071543,17099071543,0,1355,1675,0
17099162949,17099162950,1,1494,1939,0
17101822775,17101822779,4,945,868,0
17103197185,17103197184,-1,1694,1983,0
17107991818,17107991818,0,2223,2455,0
17112776723,17112776724,1,1990,1332,0
17113248287,17113248288,1,1244,2246,0
17115730033,17115730034,1,1306,1786,0
17115762410,17115762411,1,2011,2446,0
17118730815,17118730825,10,203,1377,0
17121525461,17121525464,3,1801,1423,0
17124375513,17124375513,0,1744,2247,0
17124508661,17124508661,0,1122,1306,0
17124821397,17124821397,0,1377,1680,0
17128602314,17128602314,0,617,1694,0
17129823286,17129823286,0,1425,1778,0
17131111550,17131111551,1,1571,1591,0
17131525763,17131525762,-1,1495,2220,0
17131857126,17131857122,-4,1047,1761,0
17132525789,17132525782,-7,1145,1613,0
17135766837,17135766837,0,1032,1815,0
17137669822,17137669840,18,1108,1305,0
17140389070,17140389071,1,833,1184,0
17142096375,17142096375,0,1248,1726,0
17142288168,17142288169,1,2107,1874,0
17145363471,17145363465,-6,2652,7324,0
17146694006,17146694006,0,1303,1132,0
17150734712,17150734710,-2,1431,2035,0
17150876035,17150876034,-1,1173,1953,0
17154644990,17154644990,0,984,2085,0
17156521526,17156521521,-5,1236,2905,0
17157785649,17157785650,1,1518,1409,0
17159440842,17159440840,-2,1374,2498,0
17161904287,17161904288,1,1560,2194,0
17162900202,17162900205,3,1775,2401,0
17167704615,17167704614,-1,1466,1913,0
17168169547,17168169548,1,1145,1734,0
17170485787,17170485788,1,1388,1921,0
17171619368,17171619366,-2,1602,1547,0
17175649399,17175649399,0,1589,1515,0
17177279223,17177279221,-2,917,3055,0
17180306851,17180306855,4,1538,1301,0
17183861144,17183861144,0,1555,1760,0
17189053404,17189053407,3,1820,1848,0
17190716511,17190716511,0,1447,1557,0
17191516319,17191516321,2,1212,1627,0
17193159438,17193159439,1,1853,2405,0
17195192273,17195192277,4,2262,1336,0
17197096358,17197096359,1,1574,2179,0
17199211957,17199211957,0,1002,1384,0
17199723196,17199723208,12,16473,38646,0
17200387795,17200387795,0,1689,2097,0
17201590571,17201590570,-1,1405,1977,0
17202134801,17202134797,-4,1078,2840,0
17203116169,17203116170,1,1358,1304,0
17203843175,17203843159,-16,1035,1521,0
17205657447,17205657446,-1,1425,1421,0
17205791664,17205791665,1,1764,2158,0
17212686124,17212686123,-1,1302,2141,0
17215128397,17215128398,1,889,1411,0
17216681795,17216681794,-1,1176,1417,0
17219728999,17219728998,-1,1368,2035,0
17220832796,17220832796,0,1179,1634,0
17222835630,17222835631,1,1584,1890,0
17223548425,17223548426,1,1267,1193,0
17230025930,17230025908,-22,1315,1715,0
17231632229,17231632231,2,1328,1778,0
17235415330,17235415331,1,1213,1618,0
17235721629,17235721628,-1,2015,1820,0
17240496202,17240496203,1,994,1104,0
17241562578,17241562576,-2,1419,2229,0
17241695250,17241695250,0,1702,2211,0
17242395317,17242395318,1,1958,2666,0
17243993151,17243993151,0,1145,1496,0
17248493004,17248493000,-4,911,2789,0
17248529239,17248529238,-1,973,1812,0
17252614046,17252614047,1,963,1244,0
17255226866,17255226867,1,1383,2113,0
17256046777,17256046778,1,920,1273,0
17258159524,17258159547,23,1275,1638,0
17262914154,17262914158,4,1373,1359,0
17271424273,17271424273,0,1331,1738,0
17273492617,17273492617,0,1611,2577,0
17274335171,17274335169,-2,851,1635,0
17284075662,17284075663,1,1065,1802,0
17286942211,17286942215,4,2014,1141,0
17290476841,17290476842,1,1683,1614,0
17290745362,17290745374,12,502,509,0
17295444009,17295444010,1,1202,1309,0
17295566735,17295566729,-6,2783,8653,0
17295926049,17295926050,1,1937,1751,0
17296242999,17296242998,-1,1845,1629,0
17296991795,17296991795,0,1253,1596,0
17298582690,17298582673,-17,1807,973,0
17300907076,17300907076,0,1429,1716,0
17302135467,17302135467,0,1826,1794,0
17302557223,17302557223,0,1214,1686,0
17304963163,17304963164,1,1638,2140,0
17308086329,17308086327,-2,1307,1989,0
17309562414,17309562413,-1,1505,1529,0
17310808928,17310808927,-1,1151,1759,0
17313438066,17313438061,-5,1491,4782,0
17314687061,17314687062,1,2158,1725,0
17315810595,17315810594,-1,1198,2421,0
17316542770,17316542771,1,1141,1245,0
17318150398,17318150398,0,1372,1962,0
17320111091,17320111094,3,1696,1257,0
17321933283,17321933282,-1,983,1242,0
17326340981,17326340981,0,1511,1111,0
17326479938,17326479939,1,1328,1596,0
17327297465,17327297466,1,2484,3023,0
17330022306,17330022307,1,1808,1641,0
17330646251,17330646249,-2,990,2048,0
17333751723,17333751719,-4,1346,2652,0
17334372450,17334372451,1,1232,1434,0
17334738664,17334738665,1,1261,1876,0
17334769698,17334769699,1,1727,1793,0
17335456278,17335456277,-1,1630,1694,0
17335734331,17335734330,-1,1087,1502,0
17337795667,17337795672,5,1142,1256,0
17340933212,17340933215,3,1311,1868,0
17341233371,17341233365,-6,18271,54903,0
17341713342,17341713344,2,1315,1510,0
17347012447,17347012448,1,876,1449,0
17348950819,17348950821,2,1387,1920,0
17350789865,17350789867,2,1137,2006,0
17351071873,17351071872,-1,1362,2032,0
17352694914,17352694920,6,2496,1727,0
17353239306,17353239307,1,1371,1389,0
17353968306,17353968307,1,2121,2096,0
17354833390,17354833389,-1,1592,1864,0
17355106143,17355106145,2,795,1449,0
17358335578,17358335579,1,1531,1681,0
17359852930,17359852930,0,1419,2109,0
17361064609,17361064615,6,3758,2037,0
17364312352,17364312349,-3,1269,2060,0
17364640855,17364640854,-1,1211,1727,0
17368416695,17368416693,-2,1159,1744,0
17380085577,17380085579,2,2047,1705,0
17386670670,17386670653,-17,1395,2834,0
17388785321,17388785324,3,1980,1748,0
17392154766,17392154767,1,680,1132,0
17393877639,17393877638,-1,1405,1502,0
17395614541,17395614542,1,1343,1486,0
17396123754,17396123753,-1,1540,1910,0
17396702011,17396702011,0,2163,2443,0
17397819394,17397819397,3,1613,1185,0
17400394354,17400394354,0,1759,1966,0
17402778852,17402778852,0,1968,2056,0
17405795947,17405795947,0,1278,1878,0
17407482033,17407482034,1,1215,1887,0
17408737967,17408737964,-3,841,1555,0
17409456344,17409456342,-2,1486,1647,0
17411068397,17411068398,1,1061,1298,0
17411541726,17411541726,0,1509,1717,0
17417911207,17417911214,7,2116,1225,0
17419503428,17419503431,3,1373,1670,0
17424338716,17424338717,1,1590,1482,0
17424884758,17424884759,1,620,1095,0
17432899141,17432899140,-1,1442,1934,0
17433199901,17433199901,0,1429,1030,0
17433676737,17433676731,-6,2383,7134,0
17436499429,17436499433,4,1687,1221,0
17446938715,17446938715,0,1019,858,0
17447048418,17447048418,0,1671,1352,0
17447767055,17447767055,0,1610,2025,0
17447885115,17447885114,-1,1403,1506,0
17448842507,17448842505,-2,1096,1836,0
17449457710,17449457709,-1,1360,1615,0
17449728113,17449728114,1,1388,1175,0
17451064074,17451064074,0,1460,1768,0
17451686618,17451686619,1,864,919,0
17452315823,17452315823,0,914,1623,0
17455459018,17455459026,8,2745,962,0
17457657175,17457657175,0,1373,2424,0
17458212956,17458212958,2,1675,1941,0
17459014627,17459014627,0,1488,2042,0
17460259193,17460259195,2,1219,1519,0
17461291222,17461291218,-4,1496,1364,0
17461355237,17461355249,12,14425,52228,0
17467084114,17467084116,2,946,1413,0
17477676075,17477676074,-1,1713,1871,0
17479060333,17479060337,4,1170,1288,0
17480912236,17480912241,5,1666,881,0
17480988515,17480988518,3,1817,1677,0
17482967285,17482967286,1,1357,1829,0
17484126359,17484126358,-1,1319,1319,0
17487402980,17487402981,1,1528,1717,0
17491421028,17491421027,-1,1685,1375,0
17491780853,17491780854,1,1435,1497,0
17494325331,17494325331,0,1872,1836,0
17495129156,17495129157,1,1850,2310,0
17495916466,17495916466,0,1298,1226,0
17496553912,17496553912,0,1337,2099,0
17500296310,17500296310,0,1510,1365,0
17501628954,17501628954,0,1177,1873,0
17505995783,17505995785,2,1399,2166,0
17508485021,17508485017,-4,1971,4366,0
17508763162,17508763163,1,1290,1930,0
17510083336,17510083339,3,1575,1456,0
17510273335,17510273334,-1,1592,1992,0
17510461914,17510461913,-1,2174,1561,0
17511406206,17511406203,-3,1821,5748,0
17513209562,17513209563,1,2138,2537,0
17517125321,17517125317,-4,23954,8978,0
17517926750,17517926747,-3,1116,1258,0
17522026987,17522026986,-1,1191,1620,0
17524144342,17524144347,5,2004,1199,0
17525990180,17525990181,1,2025,2062,0
17530349710,17530349710,0,1918,2021,0
17530874334,17530874334,0,944,1152,0
17531361829,17531361828,-1,8318,10558,0
17537177698,17537177706,8,3645,1283,0
17538099006,17538099007,1,1287,1970,0
17538414436,17538414437,1,1084,1336,0
17546807630,17546807630,0,1420,1770,0
17549483159,17549483158,-1,1393,2259,0
17553231336,17553231335,-1,1947,1831,0
17553620158,17553620139,-19,1014,1685,0
17561247929,17561247930,1,2193,2659,0
17565950922,17565950923,1,3022,3354,0
17567931263,17567931263,0,1073,1027,0
17570904149,17570904149,0,1066,2155,0
17572620371,17572620367,-4,1136,1081,0
17574198742,17574198742,0,862,1489,0
17575347560,17575347558,-2,1297,1929,0
17577000913,17577000913,0,1354,1359,0
17578389962,17578389966,4,2017,1816,0
17579811028,17579811013,-15,927,1668,0
17581695218,17581695217,-1,1320,1396,0
17583226254,17583226253,-1,1189,1300,0
17584028062,17584028062,0,1166,1736,0
17584715339,17584715341,2,1492,1983,0
17584805771,17584805771,0,1326,1599,0
17585251951,17585251953,2,1482,2133,0
17585462118,17585462118,0,1057,1343,0
17590484840,17590484840,0,1959,2011,0
17596077591,17596077594,3,944,1321,0
17597271485,17597271484,-1,1602,2252,0
17597624406,17597624405,-1,1890,1501,0
17600751923,17600751921,-2,1182,1496,0
17600781798,17600781813,15,704,3189,0
17602314871,17602314872,1,797,1800,0
17602637816,17602637836,20,1226,1571,0
17603144645,17603144646,1,982,1321,0
17607899514,17607899514,0,1045,2087,0
17607928446,17607928450,4,898,1340,0
17609634637,17609634637,0,1801,2010,0
17610280294,17610280294,0,1649,1520,0
17612284214,17612284196,-18,1491,1430,0
17613957337,17613957338,1,1538,1301,0
17614080887,17614080888,1,1143,1924,0
17616395691,17616395711,20,1567,2392,0
17620038703,17620038703,0,1515,2298,0
17620093347,17620093349,2,1969,1872,0
17624458082,17624458082,0,1309,1715,0
17626466111,17626466110,-1,1289,1700,0
17628456960,17628456958,-2,1825,2629,0
17628948605,17628948612,7,1351,1831,0
17630491446,17630491445,-1,1260,1718,0
17630949377,17630949378,1,1936,2405,0
17636038120,17636038121,1,1226,2045,0
17636713653,17636713669,16,841,2056,0
17636896494,17636896495,1,1577,2050,0
17637342290,17637342290,0,2283,1537,0
17637393442,17637393428,-14,407,277,0
17639754238,17639754239,1,1107,1307,0
17646224161,17646224162,1,1439,1524,0
17648004076,17648004080,4,1187,977,0
17650969570,17650969566,-4,1658,2992,0
17651740442,17651740443,1,1234,1733,0
17657149513,17657149515,2,1371,1605,0
17657470621,17657470621,0,1499,1690,0
17658104229,17658104229,0,2272,2214,0
17659478542,17659478543,1,1336,1400,0
17660266321,17660266322,1,1494,1384,0
17664495758,17664495758,0,1560,1518,0
17664808797,17664808798,1,1744,1334,0
17665597710,17665597704,-6,1067,4200,0
17667067266,17667067265,-1,1610,2314,0
17668029759,17668029758,-1,1801,1365,0
17669220079,17669220078,-1,979,1701,0
17669962718,17669962707,-11,10946,26691,0
17675911570,17675911574,4,1669,1539,0
17678751465,17678751463,-2,1358,2190,0
17680697910,17680697911,1,1263,1503,0
17680847309,17680847326,17,160,1705,0
17681872115,17681872114,-1,1143,1439,0
17687762638,17687762638,0,980,1407,0
17690479344,17690479346,2,1168,1282,0
17690973449,17690973443,-6,1520,8245,0
17692340032,17692340034,2,1472,1381,0
17692801464,17692801466,2,1229,1779,0
17695094532,17695094530,-2,1432,1743,0
17695771398,17695771398,0,1743,1596,0
17697971669,17697971670,1,1125,1736,0
17702461337,17702461334,-3,1164,1284,0
17703144894,17703144899,5,920,1344,0
17704390436,17704390434,-2,1287,2055,0
17709157949,17709157952,3,4504,2530,0
17709925638,17709925637,-1,1299,1512,0
17711957265,17711957265,0,1021,1639,0
17713900247,17713900247,0,1027,1541,0
17714874097,17714874097,0,1615,1845,0
17715960551,17715960541,-10,1342,1610,0
17718827005,17718827003,-2,1617,1213,0
17720090925,17720090925,0,1742,1548,0
17721372059,17721372058,-1,1567,1856,0
17722399905,17722399898,-7,653,4490,0
17725555311,17725555310,-1,1090,1692,0
17727091459,17727091459,0,1409,2031,0
17727484383,17727484384,1,10112,11732,0
17728420869,17728420871,2,1950,1650,0
17728592478,17728592479,1,1499,1134,0
17728962370,17728962371,1,1004,1617,0
17729445350,17729445346,-4,900,1629,0
17730030501,17730030500,-1,1104,1217,0
17730975146,17730975149,3,1039,1310,0
17732412509,17732412510,1,2408,1815,0
17732904121,17732904122,1,4140,3220,0
17734122083,17734122085,2,1637,2099,0
17735341657,17735341658,1,2125,2483,0
17736116694,17736116695,1,1663,1929,0
17736255349,17736255351,2,1983,1749,0
17738363434,17738363437,3,1454,1673,0
17740408305,17740408307,2,1296,1799,0
17741596336,17741596322,-14,11042,42747,0
17743874681,17743874681,0,1066,1598,0
17744834967,17744834968,1,1796,2189,0
17745153931,17745153934,3,1464,1166,0
17746481601,17746481602,1,923,1630,0
17748670482,17748670483,1,1228,1715,0
17749278771,17749278773,2,2098,2366,0
17757570171,17757570173,2,1386,2154,0
17760904096,17760904098,2,1732,1554,0
17761212860,17761212862,2,1467,1516,0
17763204846,17763204846,0,1149,1657,0
17766431766,17766431767,1,1502,1709,0
17768024644,17768024642,-2,998,2116,0
17768112177,17768112177,0,1642,2177,0
17769049503,17769049503,0,1532,1650,0
17779426662,17779426661,-1,1350,1734,0
17779586613,17779586618,5,3399,1616,0
17783677462,17783677463,1,1780,1364,0
17786488385,17786488382,-3,1683,2816,0
17797946569,17797946570,1,1806,1436,0
17800464310,17800464308,-2,2140,2087,0
17801862131,17801862131,0,866,1071,0
17806714324,17806714326,2,1682,1077,0
17808437796,17808437796,0,911,1645,0
17812330326,17812330325,-1,1503,1389,0
17812784771,17812784761,-10,44290,10009,0
17815306200,17815306201,1,1611,2064,0
17816493034,17816493035,1,1839,1912,0
17817082054,17817082053,-1,1253,2209,0
17819385871,17819385874,3,2584,1867,0
17819523945,17819523949,4,1049,912,0
17820334834,17820334834,0,1430,1830,0
17821075146,17821075146,0,1400,1585,0
17821200234,17821200236,2,1253,1767,0
17822591180,17822591181,1,1843,2501,0
17822862269,17822862262,-7,1749,8155,0
17822925627,17822925604,-23,1819,1165,0
17823391995,17823392015,20,1500,1670,0
17823528041,17823528041,0,1769,2521,0
17825661449,17825661450,1,1851,2159,0
17828204297,17828204297,0,1390,1882,0
17835809061,17835809061,0,1061,2489,0
17836667609,17836667610,1,2164,2055,0
17836802069,17836802071,2,1484,1756,0
17842031061,17842031061,0,1094,1568,0
17843614090,17843614090,0,1479,1279,0
17845686762,17845686764,2,1478,1627,0
17848686122,17848686123,1,665,1081,0
17849298198,17849298199,1,2846,1838,0
17849431209,17849431210,1,1112,1512,0
17850981646,17850981648,2,1140,1755,0
17855316050,17855316052,2,2188,1675,0
17855540574,17855540573,-1,1110,1248,0
17855649606,17855649606,0,1364,1485,0
17859219068,17859219069,1,1667,2210,0
17861935201,17861935199,-2,1415,1883,0
17862612870,17862612870,0,1608,1947,0
17865262891,17865262891,0,1502,1984,0
17865481167,17865481150,-17,1537,2281,0
17865679624,17865679624,0,1561,2167,0
17868200468,17868200469,1,1517,1854,0
17870361193,17870361194,1,1078,1249,0
17873008939,17873008939,0,1003,991,0
17874238857,17874238858,1,1320,1828,0
17874802983,17874802983,0,1169,1392,0
17878676781,17878676782,1,1883,1249,0
17878859127,17878859129,2,1250,1516,0
17879637125,17879637124,-1,1104,1115,0
17880308672,17880308672,0,883,1317,0
17882622449,17882622450,1,2368,2106,0
17885084835,17885084836,1,1587,1783,0
17887573936,17887573937,1,914,1922,0
17890982276,17890982277,1,1679,2838,0
17892117438,17892117438,0,1296,1486,0
17893089010,17893089009,-1,1587,2079,0
17893771672,17893771675,3,1773,2103,0
17895403310,17895403311,1,1592,2146,0
17898969319,17898969318,-1,1430,1359,0
17904972147,17904972146,-1,1771,2008,0
17905987263,17905987262,-1,826,2102,0
17906956479,17906956480,1,1117,1658,0
17910688130,17910688129,-1,1501,1783,0
17911724319,17911724317,-2,813,1410,0
17913765696,17913765699,3,1383,1500,0
17917551081,17917551083,2,1834,1582,0
17919907243,17919907243,0,1256,1222,0
17922420341,17922420341,0,1395,2065,0
17924250681,17924250683,2,1471,1741,0
17924790698,17924790697,-1,857,1664,0
17926054586,17926054592,6,3653,1596,0
17927914215,17927914214,-1,1348,1263,0
17928489847,17928489847,0,1330,1872,0
17928990804,17928990802,-2,1185,2259,0
17929441740,17929441720,-20,1199,1607,0
17932784054,17932784053,-1,1222,2123,0
17933745292,17933745291,-1,1193,1701,0
17934506311,17934506299,-12,1271,1238,0
17938045559,17938045563,4,1204,885,0
17938892872,17938892872,0,1433,1587,0
17939267086,17939267087,1,1287,1756,0
17939670797,17939670779,-18,744,394,0
17940092119,17940092099,-20,795,2313,0
17943775177,17943775178,1,1729,1573,0
17945073418,17945073417,-1,1554,2239,0
17945228572,17945228573,1,1847,2016,0
17949576302,17949576303,1,1287,2029,0
17950034735,17950034742,7,2733,1526,0
17952216339,17952216341,2,754,1110,0
17953259961,17953259962,1,1800,2094,0
17954392162,17954392161,-1,1406,1197,0
17955632715,17955632714,-1,1158,1339,0
17958895223,17958895224,1,1796,1957,0
17962270513,17962270513,0,1431,1711,0
17964262926,17964262926,0,1207,1454,0
17964545147,17964545144,-3,2210,6059,0
17966942723,17966942722,-1,1020,1291,0
17967714546,17967714545,-1,1670,1810,0
17967844490,17967844489,-1,1167,1035,0
17968801484,17968801481,-3,1644,1873,0
17970442579,17970442578,-1,35820,41246,0
17970612327,17970612329,2,686,1550,0
17973173691,17973173691,0,1181,2043,0
17975680721,17975680722,1,933,1514,0
17980827215,17980827218,3,10074,8036,0
17981461575,17981461568,-7,747,2374,0
17983367830,17983367834,4,2080,1410,0
17983805142,17983805139,-3,2393,5110,0
17984492386,17984492366,-20,1331,1728,0
17985244272,17985244274,2,2067,1990,0
17985269603,17985269602,-1,979,2201,0
17989572718,17989572720,2,1692,1677,0
17990964458,17990964467,9,15269,22092,0
17992854200,17992854199,-1,1111,1379,0
17994959941,17994959942,1,1387,1513,0
17996273804,17996273807,3,1310,1458,0
17998528590,17998528589,-1,1499,2203,0
17999881490,17999881489,-1,1127,1584,0
18002556951,18002556947,-4,713,1170,0
18003902636,18003902635,-1,1285,1386,0
18004025350,18004025370,20,542,714,0
18009876034,18009876035,1,1048,1288,0
18010152817,18010152818,1,1621,2367,0
18013721869,18013721872,3,1387,1662,0
18015900945,18015900951,6,6858,2386,0
18016851652,18016851653,1,1674,1980,0
18018515755,18018515757,2,1626,1492,0
18020653461,18020653464,3,1944,1614,0
18025091897,18025091898,1,1651,2067,0
18026544666,18026544669,3,1577,1146,0
18026762153,18026762155,2,1423,1291,0
18034409223,18034409225,2,1277,1767,0
18034945292,18034945291,-1,807,1405,0
18039248268,18039248268,0,2097,3033,0
18039432545,18039432550,5,1950,936,0
18048180832,18048180831,-1,1190,1764,0
18054835598,18054835598,0,1480,2283,0
18059062258,18059062258,0,1526,2052,0
18060466052,18060466051,-1,1528,1412,0
18060845018,18060845019,1,1147,1261,0
18061058403,18061058405,2,1070,1255,0
18061534358,18061534359,1,2053,2704,0
18061696365,18061696368,3,1380,1832,0
18066560786,18066560785,-1,1530,1534,0
18067283728,18067283727,-1,1347,1730,0
18068427549,18068427549,0,1105,1010,0
18070390751,18070390751,0,1314,2360,0
18075111894,18075111908,14,16000,30661,0
18076178075,18076178076,1,1811,2510,0
18076502052,18076502053,1,948,1253,0
18081097910,18081097910,0,1150,1297,0
18084019792,18084019789,-3,1532,1588,0
18087837981,18087837985,4,37375,24144,0
18088897514,18088897518,4,1844,1219,0
18089324772,18089324771,-1,1790,1826,0
18091751027,18091751028,1,1484,1955,0
18092691046,18092691045,-1,1594,1591,0
18092954004,18092954003,-1,1092,1438,0
18094230941,18094230942,1,1607,1483,0
18097899785,18097899786,1,1418,1654,0
18099903522,18099903522,0,1671,2126,0
18100397460,18100397461,1,1645,1898,0
18103999562,18103999562,0,2080,2366,0
18109633898,18109633898,0,1480,1797,0
18114758931,18114758931,0,1170,1603,0
18114991054,18114991055,1,1160,1753,0
18117924718,18117924718,0,2194,2338,0
18121040834,18121040834,0,2343,2385,0
18123417184,18123417184,0,1069,1096,0
18126273142,18126273142,0,1544,1898,0
18126857587,18126857586,-1,654,1307,0
18128201473,18128201474,1,1288,1969,0
18129299465,18129299466,1,1183,1102,0
18131118838,18131118839,1,679,629,0
18131452309,18131452313,4,1068,1415,0
18131646425,18131646421,-4,1099,2842,0
18134471378,18134471377,-1,1956,1663,0
18134528683,18134528664,-19,1132,2334,0
18135403918,18135403917,-1,964,1034,0
18136257196,18136257194,-2,1462,2033,0
18137970522,18137970524,2,1132,1666,0
18138688187,18138688186,-1,1360,1582,0
18139603851,18139603851,0,1329,1882,0
18143043106,18143043109,3,1229,1632,0
18148713593,18148713610,17,1224,1478,0
18150758702,18150758702,0,1190,1605,0
18152800852,18152800852,0,1973,1769,0
18154484013,18154484011,-2,1536,1273,0
18155231981,18155231965,-16,1526,839,0
18156271923,18156271922,-1,1025,1426,0
18157715702,18157715702,0,1036,2344,0
18159747610,18159747610,0,1110,1396,0
18161134140,18161134142,2,1144,1160,0
18163500389,18163500390,1,1147,2070,0
18164048526,18164048526,0,1674,2024,0
18165680635,18165680633,-2,944,2196,0
18166207759,18166207760,1,1186,1465,0
18168303781,18168303781,0,826,1318,0
18175363631,18175363629,-2,1122,1719,0
18176696546,18176696547,1,1283,2095,0
18179755612,18179755612,0,1161,1324,0
18180524018,18180524018,0,1267,1399,0
18181622737,18181622735,-2,1469,1322,0
18185614663,18185614665,2,1352,1186,0
18185704196,18185704197,1,1689,2460,0
18188789674,18188789677,3,970,1498,0
18189725737,18189725734,-3,1344,2606,0
18191394674,18191394670,-4,1339,1988,0
18194961350,18194961358,8,2200,1355,0
18196099027,18196099027,0,1360,1535,0
18196930028,18196930029,1,1333,1140,0
18200504507,18200504506,-1,1169,2035,0
18201101171,18201101172,1,1640,1395,0
18202414483,18202414487,4,2174,1890,0
18204153241,18204153241,0,1385,1245,0
18204597873,18204597871,-2,982,2737,0
18205601766,18205601767,1,1285,1565,0
18207017157,18207017154,-3,22664,66201,0
18209328877,18209328879,2,1235,1125,0
18211620393,18211620392,-1,1677,1999,0
18212071077,18212071076,-1,1107,1608,0
18214927561,18214927561,0,917,1586,0
18216054028,18216054028,0,1163,1524,0
18217700425,18217700425,0,2052,1474,0
18223099091,18223099091,0,834,1399,0
18227783921,18227783921,0,1023,2080,0
18231459718,18231459721,3,1340,1418,0
18233115751,18233115750,-1,1175,1836,0
18234612513,18234612499,-14,928,3427,0
18237496437,18237496437,0,1003,1214,0
18241905130,18241905132,2,1383,1982,0
18242114156,18242114158,2,1524,1098,0
18243434411,18243434417,6,2524,1352,0
18244338419,18244338421,2,1307,1469,0
18246858634,18246858612,-22,1048,1340,0
18247372194,18247372195,1,1039,1271,0
18249456395,18249456406,11,128,908,0
18252772314,18252772313,-1,1385,1721,0
18253157835,18253157837,2,1403,1646,0
18257483839,18257483838,-1,1556,1333,0
18260732794,18260732794,0,1878,2207,0
18261373690,18261373691,1,1021,1607,0
18261984042,18261984042,0,998,1902,0
18262153137,18262153137,0,1127,1744,0
18263307719,18263307730,11,13054,40589,0
18264102560,18264102562,2,1477,2857,0
18264270206,18264270206,0,1439,1675,0
18264298254,18264298247,-7,2168,9173,0
18266135439,18266135442,3,1207,1717,0
18267271764,18267271764,0,1390,1716,0
18268860870,18268860870,0,1350,1390,0
18269720492,18269720515,23,298,1312,0
18270746837,18270746835,-2,1942,1727,0
18274514087,18274514086,-1,1280,1508,0
18278546806,18278546806,0,1094,1392,0
18282262201,18282262202,1,1437,1571,0
18283668668,18283668669,1,1603,2169,0
18285504495,18285504497,2,1647,1565,0
18287999581,18287999581,0,907,1356,0
18288823347,18288823348,1,1294,1780,0
18290896515,18290896514,-1,1510,1035,0
18295543462,18295543461,-1,986,1813,0
18296983674,18296983681,7,5397,1965,0
18297787529,18297787531,2,1117,1289,0
18298363125,18298363126,1,785,1390,0
18300842606,18300842606,0,1355,2262,0
18302463718,18302463715,-3,1085,2534,0
18303173770,18303173773,3,1088,1235,0
18308333815,18308333814,-1,1342,1737,0
18309734220,18309734215,-5,1270,3130,0
18310092893,18310092892,-1,1216,1529,0
18312720583,18312720582,-1,1655,1829,0
18321774883,18321774881,-2,1744,3740,0
18323977481,18323977481,0,1767,1487,0
18324509117,18324509119,2,1528,1671,0
18328145878,18328145874,-4,1792,3286,0
18328454029,18328454030,1,936,1294,0
18329567334,18329567334,0,1662,1738,0
18333723930,18333723931,1,1409,1127,0
18338399306,18338399325,19,940,1412,0
18338464142,18338464142,0,1520,1532,0
18340749335,18340749338,3,1172,1251,0
18341459433,18341459433,0,1199,1600,0
18342477028,18342477029,1,1298,1386,0
18343404250,18343404250,0,1742,1794,0
18344013950,18344013951,1,1644,1412,0
18347327030,18347327030,0,969,1160,0
18350297459,18350297454,-5,1110,2713,0
18353744642,18353744640,-2,1236,1468,0
18360188600,18360188594,-6,1685,6737,0
18361951434,18361951434,0,1155,1282,0
18362742729,18362742730,1,1291,1215,0
18364877812,18364877811,-1,2077,2410,0
18367008989,18367008988,-1,1250,1852,0
18368543058,18368543057,-1,990,1214,0
18370733200,18370733199,-1,2038,1241,0
18370841990,18370841991,1,1624,1463,0
18372310314,18372310313,-1,1059,1417,0
18372448093,18372448090,-3,1346,1760,0
18374383419,18374383413,-6,849,4084,0
18374890807,18374890806,-1,1107,1731,0
18375343856,18375343869,13,247,791,0
18380889920,18380889921,1,1875,2372,0
18382892647,18382892646,-1,881,1245,0
18383773182,18383773182,0,1741,1745,0
18384914230,18384914230,0,817,1710,0
18386192010,18386192010,0,1588,1260,0
18388469443,18388469450,7,1943,1121,0
18389152482,18389152483,1,1455,1660,0
18393174169,18393174171,2,1661,1165,0
18393311394,18393311402,8,2890,1690,0
18395835926,18395835927,1,1522,1627,0
18399136092,18399136090,-2,958,1920,0
18399258564,18399258585,21,3021,8331,0
18402883739,18402883740,1,837,1481,0
18402959253,18402959255,2,1579,1453,0
18411920477,18411920477,0,971,1645,0
18413247658,18413247659,1,2100,2334,0
18414052800,18414052799,-1,1700,2021,0
18415673794,18415673795,1,876,1054,0
18416965726,18416965726,0,1198,1141,0
18418006951,18418006950,-1,1427,2228,0
18424122143,18424122143,0,1805,2228,0
18424518188,18424518191,3,2028,2424,0
18424792918,18424792917,-1,1682,2384,0
18427610594,18427610597,3,948,1001,0
18429370174,18429370171,-3,1184,3029,0
18435516590,18435516590,0,1452,1850,0
18435680377,18435680378,1,1485,2099,0
18437087717,18437087717,0,1584,1664,0
18437278242,18437278241,-1,1359,2181,0
18441340002,18441340003,1,1128,1631,0
18442852726,18442852725,-1,1521,2187,0
18445947938,18445947946,8,10292,29868,0
18447469335,18447469333,-2,1127,1878,0
18449017994,18449017993,-1,1091,1323,0
18451525397,18451525398,1,1480,2634,0
18452663642,18452663639,-3,834,2011,0
18457833505,18457833510,5,6503,3087,0
18458068525,18458068526,1,1641,1504,0
18458801370,18458801370,0,1611,1676,0
18459600134,18459600134,0,2061,1400,0
18460807078,18460807077,-1,1492,1944,0
18462577177,18462577179,2,1481,1879,0
18464686634,18464686636,2,1502,2147,0
18465448658,18465448658,0,1160,1587,0
18467118821,18467118821,0,1616,1372,0
18468870082,18468870087,5,1941,1071,0
18469851641,18469851640,-1,1274,1701,0
18472540873,18472540873,0,1404,1653,0
18476189754,18476189755,1,1080,1539,0
18482801911,18482801910,-1,1416,1859,0
18483781779,18483781782,3,1578,1370,0
18484931597,18484931598,1,1155,1027,0
18485078406,18485078403,-3,1114,1836,0
18485235737,18485235738,1,1114,1172,0
18485365466,18485365467,1,1726,1411,0
18486417605,18486417605,0,1330,1441,0
18487345430,18487345428,-2,1282,2089,0
18494663770,18494663771,1,1483,1132,0
18497661525,18497661527,2,1726,2533,0
18498340903,18498340901,-2,1104,1362,0
18502308551,18502308550,-1,1560,1710,0
18505727631,18505727634,3,961,860,0
18508261026,18508261025,-1,1331,2084,0
18510912142,18510912141,-1,1959,1907,0
18511000842,18511000843,1,1480,1791,0
18512054903,18512054906,3,1330,1554,0
18513919330,18513919331,1,1600,1649,0
18515175942,18515175941,-1,1781,2593,0
18516540687,18516540674,-13,54029,17688,0
18517172812,18517172810,-2,1179,2161,0
18519424991,18519424991,0,1015,1772,0
18520331323,18520331322,-1,847,1408,0
18523116569,18523116571,2,1455,1849,0
18526948083,18526948099,16,13346,52498,0
18527551611,18527551613,2,1692,1601,0
18528370960,18528370961,1,1896,2264,0
18528620258,18528620255,-3,971,1181,0
18529718135,18529718134,-1,1139,2190,0
18530190425,18530190425,0,1196,1624,0
18531549851,18531549851,0,1788,2708,0
18531939629,18531939630,1,1072,1391,0
18533024030,18533024029,-1,1026,1379,0
18536406983,18536406984,1,1657,2527,0
18537012042,18537012046,4,897,863,0
18537647054,18537647054,0,1068,1618,0
18539861447,18539861446,-1,1400,1546,0
18540046345,18540046364,19,1143,1536,0
18540388277,18540388275,-2,1148,2430,0
18546889056,18546889055,-1,1619,1087,0
18549388288,18549388285,-3,840,2046,0
18550931885,18550931887,2,1087,1028,0
18552937484,18552937482,-2,1262,1873,0
18558307903,18558307902,-1,1279,1426,0
18558965299,18558965300,1,926,1629,0
18572344158,18572344157,-1,1199,1661,0
18572856494,18572856495,1,852,1065,0
18574067912,18574067914,2,1294,2016,0
18574594038,18574594022,-16,1307,1247,0
18575491856,18575491857,1,1322,1736,0
18581574693,18581574695,2,922,1078,0
18582449314,18582449298,-16,1476,1688,0
18582956377,18582956377,0,1432,1907,0
18583125314,18583125317,3,1322,1510,0
18585850236,18585850234,-2,923,1541,0
18590167722,18590167722,0,2320,2521,0
18590548452,18590548472,20,672,811,0
18592685414,18592685415,1,1521,1547,0
18593980846,18593980849,3,4009,3297,0
18594902523,18594902525,2,1267,1229,0
18596365149,18596365149,0,1679,2337,0
18599609431,18599609431,0,1093,1326,0
18599897028,18599897030,2,1399,1381,0
18600096314,18600096313,-1,1505,1830,0
18600352467,18600352467,0,1451,1876,0
18600407978,18600407978,0,1476,1766,0
18600709738,18600709726,-12,460,329,0
18601095571,18601095571,0,991,904,0
18603557464,18603557466,2,1382,1604,0
18604652718,18604652717,-1,1220,1665,0
18605144225,18605144226,1,1216,1466,0
18607040842,18607040841,-1,1014,1586,0
18608770082,18608770082,0,1483,1579,0
18612710854,18612710853,-1,1848,2598,0
18612811314,18612811292,-22,1120,1082,0
18615560500,18615560502,2,1077,1395,0
18622134274,18622134277,3,1915,2761,0
18625180661,18625180661,0,1533,1828,0
18625649790,18625649774,-16,1102,1593,0
18627223726,18627223730,4,1056,1737,0
18629840738,18629840735,-3,1435,1637,0
18630518430,18630518429,-1,1191,1569,0
18631444979,18631444978,-1,1158,1272,0
18632886602,18632886621,19,635,1575,0
18634786427,18634786425,-2,1233,1606,0
18635809078,18635809078,0,2010,3027,0
18641334397,18641334398,1,1693,2149,0
18641487484,18641487485,1,1162,1224,0
18646598771,18646598770,-1,1356,1932,0
18646750950,18646750971,21,1346,1638,0
18647049354,18647049354,0,1109,1397,0
18647730105,18647730108,3,1538,1395,0
18649133445,18649133445,0,1584,1514,0
18651225286,18651225285,-1,1412,1528,0
18652231635,18652231637,2,1940,2241,0
18655507808,18655507810,2,1430,1312,0
18658718346,18658718347,1,1750,2517,0
18659567188,18659567189,1,2086,2283,0
18660798309,18660798308,-1,1810,2125,0
18662794999,18662794998,-1,1620,2319,0
18663468262,18663468262,0,1154,1600,0
18667389527,18667389527,0,1328,1585,0
18667450361,18667450362,1,1460,1458,0
18670363870,18670363870,0,1156,1563,0
18670391659,18670391659,0,1352,1419,0
18672024319,18672024318,-1,1334,2481,0
18672324056,18672324057,1,1177,1814,0
18674975466,18674975465,-1,1141,1388,0
18678878622,18678878622,0,1525,1984,0
18681596885,18681596887,2,1007,1281,0
18681875370,18681875370,0,1516,1434,0
18682171569,18682171569,0,1670,2136,0
18682915837,18682915838,1,1308,1319,0
18688453569,18688453566,-3,847,1942,0
18689265619,18689265619,0,1252,1153,0
18692183017,18692183018,1,1499,1581,0
18692497502,18692497505,3,1160,1373,0
18694522454,18694522454,0,1202,2228,0
18696430451,18696430454,3,1338,1925,0
18697706270,18697706267,-3,1803,2171,0
18698861820,18698861819,-1,1253,1515,0
18700876233,18700876234,1,2099,1807,0
18706176118,18706176121,3,1054,1128,0
18708849777,18708849778,1,774,922,0
18709369490,18709369490,0,3020,4790,0
18709665598,18709665601,3,1147,1749,0
18710877834,18710877835,1,939,1522,0
18711285407,18711285407,0,1318,1917,0
18712393717,18712393716,-1,1309,1844,0
18714012968,18714012970,2,1896,1350,0
18716089310,18716089310,0,1823,1567,0
18716961206,18716961207,1,1895,1539,0
18720250728,18720250728,0,2257,2233,0
18720685077,18720685078,1,1301,1312,0
18723922096,18723922098,2,1280,1269,0
18724518739,18724518741,2,1749,1965,0
18724771977,18724771974,-3,2037,3228,0
18727599383,18727599381,-2,1643,2105,0
18729547754,18729547754,0,1242,1177,0
18732778944,18732778944,0,1640,1553,0
18735043890,18735043889,-1,1744,2043,0
18735347473,18735347473,0,1206,1503,0
18736146137,18736146139,2,865,1482,0
18737607189,18737607189,0,1494,1257,0
18738731417,18738731418,1,764,1291,0
18741370114,18741370114,0,1740,1274,0
18742475179,18742475183,4,2732,934,0
18742717756,18742717756,0,1479,1853,0
18746097026,18746097026,0,1323,1330,0
18749715296,18749715295,-1,832,1476,0
18750260143,18750260147,4,1139,718,0
18751485479,18751485473,-6,2272,8454,0
18753653277,18753653278,1,1447,1867,0
18753893403,18753893404,1,1090,1670,0
18755247502,18755247502,0,1618,2515,0
18758703482,18758703485,3,1346,1490,0
18762462279,18762462279,0,1645,1479,0
18763761254,18763761255,1,1529,1344,0
18764822182,18764822181,-1,1435,2066,0
18765437423,18765437425,2,1360,1570,0
18767447209,18767447210,1,1389,1241,0
18769035346,18769035349,3,1530,1420,0
18769109958,18769109958,0,831,1382,0
18769257097,18769257101,4,1332,1251,0
18769651116,18769651119,3,1502,1152,0
18770293958,18770293958,0,1640,1773,0
18773765233,18773765235,2,1778,1547,0
18774123724,18774123726,2,1522,1395,0
18777663194,18777663195,1,1899,1480,0
18779097641,18779097639,-2,759,1308,0
18781093630,18781093628,-2,1759,2216,0
18784370523,18784370523,0,1066,1309,0
18784626045,18784626027,-18,838,1552,0
18786912586,18786912582,-4,2356,2938,0
18788990845,18788990846,1,1217,1460,0
18792415296,18792415297,1,1486,1561,0
18792785453,18792785455,2,1451,1942,0
18798068038,18798068039,1,1719,1457,0
18798148844,18798148845,1,1509,1556,0
18799277094,18799277097,3,848,1127,0
18800547343,18800547342,-1,1418,1660,0
18801420812,18801420812,0,1159,1793,0
18803883078,18803883079,1,946,1469,0
18811087306,18811087309,3,868,1634,0
18811138138,18811138138,0,1025,1460,0
18812102993,18812102991,-2,1478,1963,0
18813518071,18813518069,-2,2369,3179,0
18813850380,18813850378,-2,1136,1487,0
18817526469,18817526469,0,1509,1538,0
18817675350,18817675350,0,1859,1689,0
18818930430,18818930433,3,1331,1469,0
18821615966,18821615966,0,1567,2284,0
18823516486,18823516487,1,1582,2209,0
18825592395,18825592396,1,1431,2402,0
18825625925,18825625925,0,1119,1431,0
18826024565,18826024563,-2,1175,1746,0
18827059473,18827059475,2,1606,1702,0
18828855118,18828855120,2,1281,1418,0
18833927054,18833927057,3,1644,1395,0
18834712252,18834712250,-2,824,1704,0
18837990558,18837990544,-14,1229,1632,0
18838579297,18838579291,-6,1696,3758,0
18844851353,18844851356,3,1118,1271,0
18845089503,18845089503,0,1144,1518,0
18851620672,18851620674,2,1249,1080,0
18854109405,18854109411,6,2212,1241,0
18854325421,18854325421,0,1255,1481,0
18855395415,18855395401,-14,1573,1500,0
18856346125,18856346125,0,1388,1877,0
18856565912,18856565913,1,1639,1273,0
18858533516,18858533518,2,1288,1521,0
18860403316,18860403315,-1,1028,1610,0
18865804558,18865804549,-9,513,1723,0
18865848708,18865848705,-3,1841,3812,0
18867136817,18867136819,2,936,1160,0
18869610417,18869610422,5,1216,1097,0
18874691022,18874691023,1,805,1127,0
18875614969,18875614970,1,1733,2217,0
18876197667,18876197668,1,1722,2538,0
18876254192,18876254197,5,15603,9051,0
18877815974,18877815973,-1,1455,1393,0
18881641583,18881641582,-1,974,1075,0
18885964553,18885964548,-5,1717,3618,0
18888338187,18888338186,-1,1161,1929,0
18889000950,18889000952,2,1074,1590,0
18889723749,18889723748,-1,2014,2529,0
18890509470,18890509470,0,1796,2189,0
18891310070,18891310070,0,1198,1219,0
18894948496,18894948497,1,1108,1715,0
18895661582,18895661582,0,988,1617,0
18899347810,18899347810,0,1046,1323,0
18900763634,18900763633,-1,1404,1908,0
18904064540,18904064548,8,3028,1169,0
18905233523,18905233524,1,1682,2440,0
18905397146,18905397147,1,1917,1758,0
18907220346,18907220347,1,1031,1269,0
18907755858,18907755858,0,2112,2670,0
18911161560,18911161557,-3,1984,3605,0
18914234030,18914234030,0,1869,1882,0
18915121870,18915121870,0,1491,1880,0
18918561169,18918561170,1,2069,2138,0
18920602651,18920602650,-1,1454,2288,0
18922411685,18922411685,0,1458,1366,0
18924704842,18924704843,1,2157,2388,0
18925621622,18925621625,3,2059,1280,0
18926455549,18926455550,1,1187,1644,0
18932042265,18932042265,0,1011,1055,0
18937196379,18937196378,-1,1168,1850,0
18938254424,18938254425,1,1605,1611,0
18940600852,18940600852,0,1341,1845,0
18942855212,18942855210,-2,1093,1488,0
18944210358,18944210360,2,1143,1300,0
18944685974,18944685973,-1,1531,1655,0
18946585286,18946585287,1,1612,2438,0
18947316707,18947316714,7,4528,2291,0
18947624627,18947624627,0,1432,1724,0
18947901617,18947901615,-2,1912,2018,0
18951295025,18951295027,2,1405,1586,0
18953528015,18953528016,1,1259,1509,0
18953805369,18953805367,-2,1432,1989,0
18954753178,18954753179,1,1596,1387,0
18956871420,18956871421,1,1363,1591,0
18958123497,18958123499,2,1749,1614,0
18962407692,18962407693,1,1139,1280,0
18964125178,18964125180,2,1224,1945,0
18968706223,18968706217,-6,1177,3509,0
18970703494,18970703495,1,1402,1464,0
18974863825,18974863823,-2,1138,1637,0
18979636607,18979636607,0,1476,1971,0
18980255707,18980255707,0,1241,1472,0
18980720758,18980720758,0,1188,1596,0
18981828515,18981828515,0,1882,2035,0
18982605455,18982605453,-2,1149,2218,0
18984269822,18984269823,1,1969,2045,0
18984385589,18984385590,1,1563,2268,0
18986471642,18986471643,1,1809,1999,0
18997141950,18997141949,-1,782,1587,0
18997877382,18997877360,-22,891,1737,0
18998068829,18998068831,2,1207,1947,0
18998365646,18998365647,1,997,1915,0
18999372942,18999372942,0,1669,1794,0
19001572483,19001572483,0,1110,1595,0
19002055194,19002055193,-1,1379,1397,0
19002590069,19002590069,0,1323,1641,0
19004332149,19004332152,3,1263,1876,0
19004990158,19004990158,0,1066,1579,0
19007126055,19007126058,3,1137,1576,0
19008283446,19008283447,1,964,1776,0
19009734179,19009734174,-5,22343,11481,0
19014292562,19014292562,0,855,1038,0
19015738089,19015738090,1,1908,1747,0
19017930591,19017930589,-2,755,1672,0
19025243214,19025243214,0,1267,2590,0
19026496925,19026496927,2,1240,1077,0
19027823402,19027823402,0,1074,1982,0
19028165980,19028165981,1,1588,2180,0
19031723025,19031723026,1,1059,1573,0
19032602081,19032602082,1,963,1119,0
19034034896,19034034897,1,1115,1815,0
19035527166,19035527171,5,970,1083,0
19043028066,19043028068,2,1607,1494,0
19044986942,19044986944,2,1975,1770,0
19051776430,19051776431,1,622,856,0
19053211735,19053211735,0,895,1503,0
19060115498,19060115499,1,2879,2337,0
19062170355,19062170361,6,2509,1607,0
19063502510,19063502511,1,950,1184,0
19064022707,19064022708,1,992,1565,0
19067367612,19067367614,2,1248,1271,0
19068564169,19068564170,1,1327,1397,0
19069386907,19069386914,7,825,1331,0
19077022089,19077022091,2,1252,1550,0
19080062750,19080062750,0,1507,1887,0
19080327747,19080327748,1,1243,1967,0
19083142819,19083142819,0,1069,1324,0
19083720538,19083720539,1,2092,1993,0
19087209908,19087209906,-2,1377,1968,0
19087396222,19087396222,0,864,1388,0
19089430342,19089430343,1,866,952,0
19090151755,19090151753,-2,1505,2414,0
19090315881,19090315882,1,985,1502,0
19093787464,19093787464,0,1283,1916,0
19097996301,19097996302,1,1337,1774,0
19099834934,19099834935,1,1479,2002,0
19101318343,19101318338,-5,1213,2226,0
19104084119,19104084117,-2,967,1262,0
19104865297,19104865299,2,1486,1990,0
19105966373,19105966374,1,1335,1020,0
19108874055,19108874056,1,1310,1603,0
19111707865,19111707866,1,1478,1915,0
19112657267,19112657268,1,1891,1637,0
19115099636,19115099637,1,1361,1775,0
19116673321,19116673319,-2,1905,2249,0
19118527492,19118527493,1,1248,2065,0
19119430306,19119430306,0,1329,1973,0
19119717681,19119717678,-3,1966,5413,0
19120266577,19120266577,0,1301,955,0
19122428227,19122428223,-4,1196,5198,0
19123796173,19123796174,1,1580,1769,0
19125292147,19125292148,1,1688,1247,0
19126291519,19126291521,2,1490,1654,0
19130349165,19130349166,1,843,1604,0
19130527018,19130527018,0,2163,2481,0
19132552698,19132552699,1,785,1445,0
19135467582,19135467582,0,1858,1877,0
19136091159,19136091159,0,1230,1746,0
19136350175,19136350176,1,1330,2152,0
19137803183,19137803182,-1,1058,1304,0
19143149322,19143149325,3,1557,1722,0
19145995286,19145995283,-3,1317,2350,0
19147363231,19147363231,0,1539,2468,0
19147452281,19147452274,-7,1654,6620,0
19151455790,19151455795,5,686,1216,0
19153174687,19153174686,-1,1252,2248,0
19155217482,19155217480,-2,1116,1609,0
19156208081,19156208085,4,818,816,0
19160199365,19160199366,1,1242,1925,0
19160337292,19160337278,-14,1249,1575,0
19162117147,19162117146,-1,2106,2088,0
19165047734,19165047739,5,4571,2646,0
19166022678,19166022679,1,1606,2281,0
19166420742,19166420742,0,812,1593,0
19166829755,19166829754,-1,1099,892,0
19168223438,19168223438,0,2066,1552,0
19168993945,19168993951,6,1469,900,0
19170134165,19170134166,1,1215,1829,0
19170804233,19170804235,2,777,1438,0
19173285453,19173285456,3,1430,1655,0
19173765610,19173765610,0,1542,1803,0
19178768676,19178768675,-1,1554,1408,0
19180491454,19180491455,1,840,1612,0
19181051535,19181051537,2,1320,2076,0
19183193061,19183193061,0,1204,1342,0
19183861739,19183861738,-1,931,1207,0
19184624154,19184624155,1,1473,2538,0
19185102370,19185102369,-1,1281,2163,0
19185410183,19185410185,2,1391,1660,0
19186976552,19186976553,1,1762,1668,0
19187255330,19187255332,2,1288,1397,0
19189956670,19189956670,0,1271,1535,0
19192237298,19192237298,0,1297,1502,0
19192754299,19192754302,3,1489,965,0
19194582497,19194582498,1,1837,1568,0
19194991244,19194991246,2,1454,1841,0
19196935050,19196935052,2,1273,1517,0
19200644754,19200644756,2,1203,1581,0
19204623081,19204623078,-3,1514,2080,0
19204754893,19204754893,0,1372,1776,0
19205620507,19205620509,2,1494,2133,0
19205980162,19205980160,-2,1312,1636,0
19206812324,19206812325,1,1522,1738,0
19209502014,19209502015,1,1262,1825,0
19210150866,19210150870,4,3522,2971,0
19210818122,19210818123,1,1977,1522,0
19212559641,19212559638,-3,1113,1534,0
19213001103,19213001103,0,1619,1549,0
19214722946,19214722946,0,1758,1411,0
19215082958,19215082959,1,1648,2215,0
19217350262,19217350262,0,1608,1766,0
19223446814,19223446814,0,1576,2285,0
19224647603,19224647599,-4,1010,2251,0
19225703917,19225703918,1,1475,2328,0
19226362517,19226362518,1,1379,1623,0
19226739753,19226739752,-1,1507,2132,0
19229240912,19229240911,-1,1237,2074,0
19230234087,19230234094,7,10406,1876,0
19232143343,19232143344,1,1739,1822,0
19233301485,19233301485,0,1285,1753,0
19234732467,19234732470,3,1367,1611,0
19235154914,19235154914,0,1183,1706,0
19236083485,19236083486,1,1147,1503,0
19237258195,19237258210,15,12098,47445,0
19237652260,19237652259,-1,1424,1787,0
19240071002,19240070998,-4,1527,2072,0
19241541984,19241541979,-5,1558,6321,0
19245316246,19245316249,3,1202,1757,0
19248997485,19248997485,0,1729,2154,0
19250124115,19250124116,1,1236,1403,0
19251967157,19251967159,2,1587,2047,0
19252522889,19252522890,1,1753,1846,0
19257051046,19257051049,3,1930,1310,0
19257690137,19257690140,3,1373,1641,0
19263132523,19263132523,0,1173,1323,0
19263668683,19263668683,0,1510,1834,0
19264342678,19264342679,1,1054,1200,0
19264396662,19264396662,0,1082,1171,0
19269727197,19269727180,-17,394,667,0
19270837081,19270837087,6,4665,1594,0
19273230213,19273230215,2,1012,1855,0
19274133017,19274133015,-2,1323,3245,0
19282916262,19282916261,-1,956,1283,0
19285476538,19285476540,2,1461,1587,0
19288302801,19288302800,-1,1364,2023,0
19289130411,19289130410,-1,1777,2232,0
19291242745,19291242746,1,1561,1323,0
19294457290,19294457290,0,1485,1939,0
19296012900,19296012902,2,1584,1682,0
19296052914,19296052911,-3,990,2130,0
19298365010,19298365011,1,1528,2029,0
19299200565,19299200566,1,1266,1827,0
19299961437,19299961439,2,1160,1187,0
19305838812,19305838813,1,1232,1932,0
19306994182,19306994178,-4,1528,1828,0
19314059634,19314059634,0,1009,1712,0
19314522398,19314522398,0,1645,1841,0
19316966993,19316966992,-1,893,1449,0
19324734006,19324734007,1,1461,1916,0
19329736570,19329736569,-1,822,1145,0
19332063227,19332063227,0,565,950,0
19334956954,19334956959,5,1672,942,0
19336210458,19336210459,1,1830,1888,0
19336770171,19336770169,-2,1617,1994,0
19338646967,19338646969,2,919,1707,0
19342086698,19342086698,0,1615,2212,0
19343049433,19343049436,3,4535,3746,0
19343264695,19343264694,-1,1324,1430,0
19347579709,19347579715,6,3848,1283,0
19350473734,19350473735,1,1152,1651,0
19351846462,19351846463,1,1433,1466,0
19355032984,19355032987,3,932,987,0
19357320575,19357320575,0,1679,1665,0
19358927255,19358927255,0,1456,2942,0
19359268815,19359268815,0,1145,1212,0
19363151999,19363152001,2,1087,2002,0
19366829326,19366829327,1,1282,1094,0
19370636018,19370636018,0,907,1836,0
19373266306,19373266305,-1,1079,1633,0
19374763446,19374763444,-2,1277,1491,0
19379595738,19379595739,1,1147,1673,0
19383218190,19383218191,1,1000,992,0
19390259639,19390259638,-1,740,700,0
19394633002,19394633005,3,1358,962,0
19395045051,19395045055,4,2668,1154,0
19401470500,19401470499,-1,1356,1914,0
19408510006,19408510003,-3,1012,1595,0
19410912406,19410912408,2,977,1649,0
19411401677,19411401678,1,1152,1395,0
19414329623,19414329625,2,1645,1822,0
19417758556,19417758572,16,1594,1538,0
19418658761,19418658762,1,1531,1595,0
19419388203,19419388204,1,1317,1579,0
19428884871,19428884868,-3,1040,1966,0
19429716926,19429716926,0,1246,1584,0
19433702037,19433702038,1,1321,1648,0
19433881188,19433881189,1,1413,1795,0
19434866103,19434866102,-1,868,1318,0
19439034337,19439034338,1,1509,1662,0
19444399330,19444399329,-1,1244,1409,0
19451062873,19451062863,-10,1129,1272,0
19451822606,19451822607,1,1023,1067,0
19456642335,19456642335,0,513,885,0
19457549637,19457549638,1,1145,1505,0
19460580637,19460580623,-14,1267,528,0
19462228031,19462228031,0,2543,2650,0
19463169653,19463169654,1,1348,910,0
19465253954,19465253954,0,1517,1613,0
19472116570,19472116569,-1,1186,1398,0
19472196364,19472196385,21,1323,1708,0
19473325184,19473325182,-2,1103,1530,0
19474171286,19474171286,0,1492,1538,0
19476555827,19476555826,-1,882,1472,0
19477090154,19477090136,-18,1606,1532,0
19480531931,19480531933,2,1597,1950,0
19482419533,19482419534,1,850,1104,0
19484397407,19484397411,4,4211,14119,0
19485520083,19485520083,0,1260,1810,0
19486399995,19486399995,0,901,1911,0
19487792413,19487792413,0,1591,1665,0
19488683228,19488683231,3,939,1127,0
19491531439,19491531440,1,816,1827,0
19502599866,19502599868,2,1330,1763,0
19503112981,19503112984,3,1198,1285,0
19503376477,19503376479,2,1359,1161,0
19503983776,19503983793,17,1252,1897,0
19505664722,19505664722,0,1413,1610,0
19508521811,19508521812,1,1317,1252,0
19511081662,19511081661,-1,1903,2090,0
19511205751,19511205750,-1,1234,1522,0
19513068396,19513068396,0,1368,1223,0
19515841084,19515841083,-1,1220,2552,0
19524131904,19524131907,3,1333,1513,0
19524234434,19524234434,0,1515,1840,0
19525689740,19525689733,-7,1250,1471,0
19532514705,19532514703,-2,1489,2090,0
19533167049,19533167057,8,1678,1350,0
19536152297,19536152294,-3,1388,1869,0
19536515293,19536515282,-11,1187,1372,0
19538246223,19538246222,-1,1455,1640,0
19538595865,19538595866,1,1586,1850,0
19545732250,19545732252,2,1332,2088,0
19548165867,19548165869,2,1151,1727,0
19550706130,19550706131,1,1632,1576,0
19553407841,19553407843,2,1342,1795,0
19558588971,19558588979,8,2307,1090,0
19560258945,19560258944,-1,1520,2376,0
19563527349,19563527350,1,975,1570,0
19564548974,19564548978,4,1517,1223,0
19566787310,19566787309,-1,1645,1753,0
19569539001,19569539003,2,2563,3411,0
19573010997,19573011002,5,4359,1985,0
19573473402,19573473403,1,1358,2107,0
19574362311,19574362315,4,286,683,0
19580555630,19580555631,1,1420,1618,0
19581880408,19581880403,-5,1919,7125,0
19585855209,19585855208,-1,1481,2384,0
19586562043,19586562041,-2,1190,2479,0
19593928430,19593928430,0,1451,1719,0
19595047274,19595047274,0,1033,1832,0
19595417449,19595417451,2,1325,1755,0
19597584790,19597584790,0,1338,1999,0
19603921587,19603921585,-2,948,1274,0
19610222663,19610222664,1,1497,2077,0
19612240330,19612240330,0,1323,1659,0
19613078957,19613078957,0,1443,2452,0
19613275208,19613275210,2,1383,2388,0
19617050238,19617050242,4,2490,1614,0
19622134898,19622134904,6,1269,921,0
19625667721,19625667716,-5,1029,3133,0
19631978457,19631978457,0,1212,1750,0
19632387822,19632387822,0,1741,2285,0
19632707583,19632707581,-2,1623,1921,0
19634181990,19634181991,1,2122,2089,0
19637091035,19637091035,0,953,954,0
19639918783,19639918780,-3,1876,1496,0
19640385510,19640385508,-2,1301,1861,0
19640469805,19640469804,-1,1828,2507,0
19644374309,19644374311,2,2033,1690,0
19649937406,19649937404,-2,995,2401,0
19651812021,19651812023,2,1141,1180,0
19652294556,19652294556,0,2181,1843,0
19654659243,19654659240,-3,863,2887,0
19654951454,19654951451,-3,1373,2232,0
19656726330,19656726331,1,830,1777,0
19662358622,19662358621,-1,1655,2372,0
19662506208,19662506206,-2,1129,1599,0
19663259262,19663259262,0,932,1134,0
19663647671,19663647672,1,1499,1435,0
19670919354,19670919355,1,1077,1672,0
19672696554,19672696555,1,907,918,0
19674788938,19674788938,0,1489,1490,0
19681940458,19681940459,1,1615,1477,0
19684521770,19684521770,0,1405,1641,0
19685340768,19685340776,8,19787,56570,0
19685893697,19685893696,-1,1168,1738,0
19689336422,19689336426,4,2380,1161,0
19692864002,19692864010,8,1860,1306,0
19697005781,19697005764,-17,1453,1309,0
19697147273,19697147273,0,1430,1603,0
19697427882,19697427889,7,10006,35927,0
19698470462,19698470461,-1,1472,2089,0
19703681736,19703681733,-3,30297,12030,0
19704694501,19704694502,1,1211,1762,0
19705054720,19705054722,2,1874,1314,0
19706840732,19706840730,-2,1063,1210,0
19709749654,19709749655,1,1398,1847,0
19710578546,19710578545,-1,1949,2112,0
19710607782,19710607782,0,498,854,0
19711048582,19711048580,-2,1500,1773,0
19711177437,19711177438,1,1236,1434,0
19716547318,19716547319,1,1105,1362,0
19716685759,19716685760,1,1740,1923,0
19717254202,19717254202,0,1126,1321,0
19718275020,19718275017,-3,1819,2302,0
19718378988,19718378988,0,1439,1450,0
19720432161,19720432162,1,1621,1627,0
19720571395,19720571395,0,1454,1865,0
19721943257,19721943277,20,1456,1572,0
19724465614,19724465619,5,2484,1835,0
19725364847,19725364847,0,1889,2487,0
19725395074,19725395080,6,3517,2299,0
19725981274,19725981274,0,1277,894,0
19727092806,19727092807,1,1844,1903,0
19728711926,19728711947,21,566,523,0
19728980964,19728980966,2,1361,1592,0
19730802955,19730802954,-1,1312,1259,0
19730932505,19730932507,2,935,1034,0
19731807725,19731807724,-1,1289,2242,0
19734181842,19734181846,4,1661,1932,0
19735855173,19735855172,-1,1285,1376,0
19736967318,19736967318,0,1580,1569,0
19739619382,19739619383,1,895,1538,0
19740891286,19740891287,1,1352,1683,0
19742498373,19742498374,1,1069,1646,0
19742626554,19742626535,-19,916,1664,0
19743775088,19743775089,1,1354,1643,0
19745587762,19745587762,0,1517,2092,0
19748998722,19748998725,3,1356,1570,0
19755323781,19755323781,0,1012,1358,0
19756205719,19756205720,1,1564,1663,0
19757225450,19757225454,4,1279,1672,0
19757274679,19757274682,3,2276,1623,0
19759691150,19759691150,0,1216,2168,0
19759755685,19759755685,0,1524,1435,0
19759950842,19759950843,1,1087,1182,0
19762751790,19762751790,0,1490,2666,0
19764456630,19764456630,0,1089,1651,0
19765127557,19765127557,0,1450,1499,0
19768271437,19768271437,0,1382,1376,0
19773378986,19773378986,0,1284,1856,0
19775134862,19775134860,-2,44721,22246,0
19775744474,19775744474,0,1535,1771,0
19777469290,19777469297,7,2756,1558,0
19778769709,19778769710,1,1598,1262,0
19779154675,19779154674,-1,1516,1643,0
19779294333,19779294334,1,2093,1675,0
19780181014,19780181014,0,1113,1406,0
19784379438,19784379438,0,1038,1698,0
19785113435,19785113436,1,1442,1929,0
19786099013,19786099017,4,851,1410,0
19786543030,19786543030,0,1158,2389,0
19786901700,19786901693,-7,896,3986,0
19788051702,19788051706,4,2079,1933,0
19789475834,19789475835,1,1453,1698,0
19789993947,19789993948,1,1296,1790,0
19790416429,19790416429,0,1510,1572,0
19791495033,19791495031,-2,1446,2595,0
19791688254,19791688250,-4,1086,1642,0
19797547190,19797547189,-1,1158,2318,0
19798987446,19798987446,0,1183,1756,0
19800161407,19800161414,7,1979,794,0
19800431449,19800431450,1,1595,1489,0
19800512005,19800512008,3,1709,2139,0
19801768654,19801768662,8,1924,743,0
19811020656,19811020658,2,1372,1228,0
19812214394,19812214393,-1,1381,1375,0
19815181262,19815181244,-18,1348,1566,0
19816756826,19816756828,2,1108,1644,0
19817746634,19817746635,1,1089,1670,0
19818492787,19818492787,0,811,962,0
19818843915,19818843916,1,1210,1886,0
19825635059,19825635061,2,903,1183,0
19826338556,19826338559,3,1733,1460,0
19829539606,19829539609,3,1051,960,0
19829615197,19829615197,0,1352,1779,0
19831000054,19831000054,0,1779,1670,0
19831416460,19831416460,0,528,1084,0
19835394889,19835394891,2,1841,1934,0
19835454075,19835454074,-1,1208,2075,0
19835913583,19835913582,-1,1580,2274,0
19836229559,19836229558,-1,1477,1493,0
19842999465,19842999465,0,1348,1517,0
19845637618,19845637619,1,1772,1491,0
19846704435,19846704436,1,1504,2075,0
19846914108,19846914106,-2,1026,2360,0
19847286833,19847286836,3,1261,1984,0
19848034980,19848034977,-3,1377,2720,0
19857244620,19857244623,3,401,644,0
19858708118,19858708117,-1,1085,1813,0
19859230476,19859230478,2,1477,1549,0
19862843316,19862843318,2,1084,1658,0
19863574238,19863574234,-4,1268,1780,0
19866771758,19866771757,-1,1282,1780,0
19869496186,19869496186,0,1235,1323,0
19871194110,19871194110,0,1460,2267,0
19872345294,19872345296,2,3151,3217,0
19872998314,19872998329,15,920,1124,0
19875775416,19875775418,2,1153,1501,0
19877352960,19877352960,0,1793,2221,0
19878978805,19878978806,1,1300,2005,0
19880769994,19880769995,1,1586,1703,0
19884261906,19884261905,-1,1175,1076,0
19886271288,19886271286,-2,1314,1602,0
19886432990,19886432993,3,2023,2045,0
19890212775,19890212777,2,2008,1409,0
19890289746,19890289746,0,970,1637,0
19891782385,19891782369,-16,133,1509,0
19894013826,19894013821,-5,1042,1864,0
19894399450,19894399450,0,1292,1646,0
19895640507,19895640510,3,4080,3318,0
19896409443,19896409441,-2,1153,2234,0
19897488050,19897488051,1,1702,2328,0
19903581304,19903581304,0,2007,2218,0
19904024241,19904024221,-20,521,428,0
19907042157,19907042157,0,1410,1498,0
19912999742,19912999742,0,1889,2089,0
19913138306,19913138304,-2,1040,1385,0
19917391053,19917391055,2,1056,1703,0
19922508279,19922508280,1,1726,1966,0
19923065181,19923065184,3,1651,1205,0
19925372337,19925372337,0,674,1085,0
19927053666,19927053666,0,2046,1432,0
19932718662,19932718663,1,1132,1176,0
19933387477,19933387477,0,1278,1913,0
19933960402,19933960402,0,1098,1614,0
19934523556,19934523579,23,1314,1452,0
19934946785,19934946785,0,1170,1420,0
19935772457,19935772459,2,956,1485,0
19937435083,19937435086,3,1812,1753,0
19946543028,19946543027,-1,1383,2018,0
19949556784,19949556783,-1,1521,1229,0
19952969096,19952969097,1,1551,1707,0
19955171162,19955171165,3,2207,1906,0
19957820471,19957820471,0,1528,1515,0
19960048434,19960048435,1,1395,1742,0
19960813679,19960813678,-1,435,1563,0
19961526361,19961526362,1,1491,1828,0
19963373586,19963373583,-3,993,2430,0
19966272283,19966272282,-1,1631,3340,0
19968724151,19968724152,1,1065,1916,0
19969106062,19969106083,21,1165,1666,0
19969611357,19969611358,1,1853,1396,0
19973616220,19973616222,2,1566,1893,0
19973745790,19973745790,0,1742,2240,0
19978737707,19978737707,0,810,1515,0
19979555140,19979555126,-14,285,2173,0
19980893614,19980893614,0,1224,1920,0
19982381589,19982381589,0,1606,1997,0
19984834265,19984834246,-19,1278,1303,0
19986349485,19986349486,1,1858,1712,0
19987907318,19987907317,-1,2118,1838,0
19990590816,19990590817,1,1577,2034,0
19994080304,19994080305,1,1916,1994,0
19995073091,19995073085,-6,1190,4280,0
19997669842,19997669843,1,1098,1630,0
19999083457,19999083457,0,2103,2068,0
19999984150,19999984153,3,1371,1596,0
20002885982,20002885983,1,1293,1821,0
20011607419,20011607417,-2,1012,2287,0
20013095558,20013095558,0,1449,1437,0
20014877745,20014877746,1,1508,2134,0
20016304111,20016304111,0,1251,1820,0
20016727061,20016727058,-3,928,1207,0
20019908757,20019908758,1,1738,1675,0
20021493101,20021493102,1,3002,3335,0
20021588354,20021588353,-1,1365,1816,0
20022744178,20022744178,0,956,2292,0
20023835578,20023835579,1,1616,2457,0
20026472860,20026472860,0,892,1093,0
20032625311,20032625310,-1,1216,1564,0
20033272536,20033272539,3,1499,1526,0
20034154612,20034154612,0,1589,2002,0
20036810550,20036810550,0,1776,1672,0
20039249266,20039249266,0,1267,2018,0
20039363053,20039363048,-5,1103,3118,0
20039459133,20039459133,0,1546,1919,0
20040158469,20040158469,0,1245,1453,0
20041361124,20041361125,1,2091,2241,0
20044308184,20044308185,1,1768,2085,0
20053552902,20053552897,-5,1043,2887,0
20056113093,20056113093,0,1191,1520,0
20066608865,20066608866,1,1523,1253,0
20068426279,20068426279,0,1270,1928,0
20071207065,20071207065,0,1229,1475,0
20073170345,20073170344,-1,1267,1823,0
20074168922,20074168924,2,610,813,0
20076305429,20076305431,2,1337,818,0
20078060731,20078060733,2,1448,1863,0
20079059891,20079059890,-1,910,705,0
20084204486,20084204489,3,1594,1808,0
20087004633,20087004633,0,1172,841,0
20088983550,20088983551,1,1666,1660,0
20090996153,20090996155,2,1668,2599,0
20094110642,20094110641,-1,667,1911,0
20095355366,20095355366,0,1382,1013,0
20095723844,20095723842,-2,1075,1977,0
20098562579,20098562579,0,1321,1985,0
20099115058,20099115058,0,1452,1576,0
20100181777,20100181778,1,1473,1814,0
20103149850,20103149853,3,1395,1495,0
20103708373,20103708375,2,1136,1513,0
20110321326,20110321326,0,606,1653,0
20113430998,20113430999,1,1430,1446,0
20114911496,20114911493,-3,1029,1556,0
20117336703,20117336702,-1,1548,1659,0
20118563974,20118563974,0,1782,1613,0
20118948414,20118948414,0,1385,1635,0
20119494569,20119494570,1,1576,1780,0
20123295614,20123295614,0,1077,1156,0
20125159018,20125159019,1,1335,2107,0
20126667246,20126667247,1,1282,1475,0
20127008322,20127008322,0,1237,1281,0
20129432754,20129432754,0,1803,1460,0
20130791029,20130791029,0,1615,1636,0
20132891107,20132891106,-1,1220,1509,0
20134703544,20134703544,0,1442,1617,0
20135499444,20135499449,5,1603,1213,0
20136047048,20136047050,2,1078,1386,0
20136590024,20136590022,-2,25600,14006,0
20136669926,20136669925,-1,1075,1572,0
20137379359,20137379361,2,2003,1516,0
20138087475,20138087478,3,1553,1391,0
20143988302,20143988303,1,1344,1904,0
20146052229,20146052230,1,1510,1616,0
20147597274,20147597273,-1,2055,2430,0
20149975157,20149975157,0,1332,1479,0
20152498146,20152498141,-5,1254,4025,0
20153115472,20153115472,0,983,1738,0
20153423999,20153424000,1,1267,1763,0
20155753278,20155753280,2,1357,1045,0
20156515927,20156515928,1,1960,2116,0
20162394535,20162394534,-1,1591,2987,0
20163793742,20163793745,3,1209,1064,0
20166869818,20166869819,1,1550,1866,0
20167887867,20167887866,-1,1326,1459,0
20169184755,20169184753,-2,1263,1666,0
20172889074,20172889076,2,1278,1428,0
20175812953,20175812949,-4,1225,2171,0
20180235830,20180235830,0,1759,1468,0
20181112106,20181112107,1,1174,1473,0
20181666870,20181666870,0,1493,2230,0
20184224733,20184224732,-1,1660,1499,0
20186864922,20186864919,-3,1464,2804,0
20187460804,20187460807,3,1098,1714,0
20189065524,20189065525,1,1649,1419,0
20192274861,20192274863,2,1724,1683,0
20194291849,20194291849,0,770,1408,0
20195421877,20195421877,0,1074,1502,0
20196706847,20196706849,2,1855,1361,0
20197412288,20197412289,1,1575,1422,0
20202043936,20202043937,1,1168,1190,0
20207078163,20207078165,2,1306,1573,0
20209916674,20209916675,1,1515,1379,0
20213388284,20213388285,1,993,1594,0
20216780775,20216780774,-1,1370,1777,0
20218503449,20218503447,-2,1992,2337,0
20219641638,20219641639,1,1329,1437,0
20223394560,20223394561,1,1536,1634,0
20226179353,20226179357,4,1715,2004,0
20226525374,20226525375,1,1004,1222,0
20226866440,20226866459,19,1451,1320,0
20228399099,20228399097,-2,716,1194,0
20229777070,20229777074,4,1375,1602,0
20231599167,20231599167,0,1232,1451,0
20233045850,20233045850,0,1238,1530,0
20233549675,20233549675,0,1287,2022,0
20234984853,20234984854,1,1677,1899,0
20235069170,20235069171,1,1450,1421,0
20243181327,20243181324,-3,930,1654,0
20246424455,20246424455,0,1530,1479,0
20247145635,20247145635,0,1765,2295,0
20250309481,20250309481,0,1198,1920,0
20251742155,20251742155,0,1388,1363,0
20252605270,20252605271,1,1042,1032,0
20258376015,20258376014,-1,1296,2157,0
20258544469,20258544490,21,788,1470,0
20259241710,20259241707,-3,1392,1513,0
20265595057,20265595057,0,1379,1517,0
20272542674,20272542674,0,1252,2090,0
20272592029,20272592039,10,2234,1136,0
20273157375,20273157358,-17,1019,1463,0
20277865248,20277865248,0,1680,1754,0
20281769773,20281769771,-2,851,1470,0
20283697894,20283697895,1,1712,2230,0
20284022304,20284022303,-1,1566,1587,0
20285130136,20285130136,0,961,1789,0
20287448987,20287448987,0,1003,1476,0
20289309229,20289309229,0,1861,2056,0
20289786055,20289786056,1,1181,1288,0
20290587529,20290587530,1,1335,1923,0
20290969674,20290969674,0,1333,2637,0
20292511898,20292511898,0,1211,1816,0
20296011431,20296011430,-1,1695,1888,0
20297238574,20297238570,-4,1668,2157,0
20298312065,20298312067,2,2031,1737,0
20299900262,20299900262,0,1098,1931,0
20300124520,20300124520,0,1345,1758,0
20301445933,20301445934,1,2402,1737,0
20301664925,20301664927,2,963,1117,0
20302131214,20302131214,0,1387,1851,0
20302680502,20302680506,4,1294,1585,0
20306641541,20306641541,0,1026,1841,0
20309052644,20309052645,1,1353,1487,0
20310959956,20310959957,1,1670,1461,0
20313517838,20313517838,0,1924,1704,0
20314290932,20314290933,1,1511,1463,0
20314902862,20314902868,6,8072,3613,0
20316175271,20316175272,1,974,1133,0
20319999007,20319999009,2,1050,1494,0
20320668138,20320668138,0,1557,2018,0
20321432098,20321432093,-5,30969,12206,0
20322403415,20322403417,2,945,1025,0
20324146107,20324146106,-1,3278,4004,0
20324639807,20324639814,7,12839,5278,0
20326471195,20326471192,-3,1232,4118,0
20327621529,20327621529,0,911,1930,0
20327663999,20327663998,-1,1432,1510,0
20329218637,20329218637,0,959,1478,0
20330320491,20330320489,-2,1414,2090,0
20335330082,20335330082,0,1311,1305,0
20337875478,20337875478,0,1831,1632,0
20338916242,20338916241,-1,857,1227,0
20341331104,20341331102,-2,1389,2082,0
20341658343,20341658343,0,727,1263,0
20342600903,20342600903,0,1748,2071,0
20344804195,20344804195,0,914,1609,0
20345629110,20345629114,4,1750,1165,0
20347993359,20347993358,-1,1389,1512,0
20348599878,20348599877,-1,1314,2327,0
20349237484,20349237483,-1,953,1204,0
20350000415,20350000414,-1,1350,1451,0
20351549504,20351549506,2,1369,1921,0
20351776373,20351776371,-2,1468,2149,0
20355768151,20355768154,3,1027,1266,0
20358675617,20358675618,1,1476,1621,0
20360714942,20360714943,1,1243,1162,0
20365119665,20365119666,1,1406,1882,0
20367093917,20367093917,0,1788,1880,0
20369731199,20369731200,1,1242,1741,0
20370499320,20370499321,1,1279,1636,0
20372007355,20372007355,0,1087,1655,0
20374177950,20374177950,0,1226,1401,0
20380972898,20380972902,4,1270,1242,0
20386860965,20386860965,0,754,1799,0
20394097709,20394097708,-1,1518,1871,0
20394244822,20394244822,0,1419,1458,0
20397407955,20397407955,0,1667,1865,0
20400811238,20400811239,1,1838,1862,0
20401568191,20401568194,3,2083,1247,0
20405346503,20405346503,0,1473,1591,0
20407110126,20407110126,0,1482,1521,0
20409261190,20409261189,-1,1267,1897,0
20413110649,20413110651,2,1333,1850,0
20414891792,20414891794,2,1331,1669,0
20415015897,20415015891,-6,2710,2818,0
20415352253,20415352255,2,1080,1797,0
20417989265,20417989263,-2,1278,1888,0
20422224358,20422224358,0,1872,2027,0
20422694882,20422694882,0,2421,2973,0
20423857815,20423857813,-2,1043,1772,0
20424336681,20424336699,18,16029,28586,0
20425557398,20425557399,1,969,1973,0
20426178215,20426178215,0,836,948,0
20428510722,20428510723,1,1190,1769,0
20429207690,20429207690,0,1111,1588,0
20436936539,20436936543,4,1218,1407,0
20437102839,20437102838,-1,1683,2503,0
20437185194,20437185194,0,1198,1524,0
20443806049,20443806054,5,1839,1097,0
20446828834,20446828834,0,1594,1967,0
20450752159,20450752159,0,1366,2347,0
20457288876,20457288878,2,1335,2062,0
20457876313,20457876315,2,1419,1636,0
20458418371,20458418371,0,1438,1717,0
20459028689,20459028690,1,2183,1814,0
20459153082,20459153082,0,1942,1687,0
20460724951,20460724951,0,1178,1506,0
20460856316,20460856317,1,1048,1486,0
20462696663,20462696665,2,2250,2359,0
20463451042,20463451043,1,1086,1262,0
20464334376,20464334383,7,4299,1323,0
20466686339,20466686338,-1,1690,1664,0
20468408706,20468408707,1,1671,2038,0
20476627023,20476627018,-5,1329,2841,0
20477147025,20477147024,-1,1288,2002,0
20477910731,20477910731,0,1771,1801,0
20479593461,20479593464,3,1169,1770,0
20486766286,20486766286,0,1390,1549,0
20489426165,20489426164,-1,1287,1791,0
20497336321,20497336322,1,1247,1746,0
20497890986,20497890990,4,1896,1352,0
20500610559,20500610559,0,1342,1760,0
20506387178,20506387178,0,1572,1689,0
20506548118,20506548118,0,1321,1655,0
20507383858,20507383857,-1,1274,1530,0
20514512362,20514512363,1,4608,46640,0
20515199859,20515199858,-1,1894,2082,0
20520029170,20520029170,0,1263,1896,0
20522320063,20522320061,-2,1271,1779,0
20523942411,20523942391,-20,906,1429,0
20525598922,20525598922,0,1400,2061,0
20526627574,20526627575,1,1732,1817,0
20526839682,20526839664,-18,1637,1300,0
20527118830,20527118826,-4,1009,3041,0
20527878670,20527878669,-1,1327,1967,0
20528576575,20528576575,0,1194,1695,0
20529394965,20529394962,-3,1425,2523,0
20533121089,20533121089,0,1440,2150,0
20538251937,20538251944,7,2779,1225,0
20539446348,20539446348,0,1189,1491,0
20539792893,20539792893,0,1228,1505,0
20540257671,20540257673,2,1553,1627,0
20541586694,20541586715,21,1446,1378,0
20543619224,20543619225,1,2039,2010,0
20543864639,20543864639,0,1726,1946,0
20544322189,20544322191,2,1116,992,0
20545452493,20545452495,2,1011,1272,0
20548214919,20548214922,3,1859,1855,0
20548713463,20548713463,0,2326,2257,0
20549253298,20549253299,1,1755,2730,0
20552521684,20552521683,-1,1227,1756,0
20554866943,20554866945,2,1368,1226,0
20558728619,20558728622,3,3962,2919,0
20560372108,20560372098,-10,1000,1458,0
20563035583,20563035584,1,1698,1418,0
20564454336,20564454337,1,1886,1759,0
20566995018,20566995021,3,1648,1508,0
20568128147,20568128146,-1,1103,1856,0
20571203221,20571203222,1,1114,1848,0
20572411010,20572411009,-1,890,1302,0
20572688182,20572688180,-2,1402,1929,0
20572936654,20572936654,0,1471,2100,0
20573209211,20573209210,-1,1350,2363,0
20577645123,20577645125,2,1216,2586,0
20580534269,20580534269,0,1854,2093,0
20580901149,20580901149,0,1046,1462,0
20583038529,20583038530,1,1199,2170,0
20585854830,20585854830,0,1464,2088,0
20587016678,20587016678,0,1467,1756,0
20587680575,20587680576,1,1171,1721,0
20589308393,20589308394,1,1814,1482,0
20589828640,20589828641,1,1885,1853,0
20590464422,20590464418,-4,571,1050,0
20591959902,20591959905,3,1751,1840,0
20595681674,20595681668,-6,2608,8269,0
20598497310,20598497310,0,1097,1319,0
20599730578,20599730579,1,1218,1879,0
20602490319,20602490311,-8,878,3410,0
20606059686,20606059685,-1,1276,1112,0
20606703470,20606703474,4,1158,1248,0
20613920439,20613920438,-1,1204,1550,0
20615230853,20615230853,0,1814,2031,0
20615343486,20615343467,-19,1391,2077,0
20620231450,20620231451,1,3343,2681,0
20622330552,20622330551,-1,1480,2619,0
20623299763,20623299762,-1,1362,1979,0
20626015162,20626015162,0,1190,1713,0
20626132878,20626132877,-1,1828,1706,0
20627118189,20627118190,1,1383,1299,0
20636275454,20636275454,0,1269,1966,0
20638589555,20638589557,2,1250,1819,0
20639480062,20639480062,0,1555,2654,0
20644483072,20644483073,1,1835,1683,0
20646386615,20646386614,-1,1075,1398,0
20646805915,20646805917,2,851,1592,0
20648253938,20648253941,3,2399,1333,0
20655968074,20655968075,1,782,1366,0
20657482157,20657482159,2,1118,985,0
20657924551,20657924541,-10,1431,1463,0
20660505941,20660505938,-3,922,1252,0
20662948304,20662948303,-1,1747,1954,0
20665959090,20665959094,4,1151,1572,0
20667583095,20667583095,0,1285,1124,0
20668574271,20668574270,-1,1529,2187,0
20672576125,20672576126,1,2439,2313,0
20674164665,20674164665,0,1759,2001,0
20675045857,20675045858,1,1556,1986,0
20675243061,20675243044,-17,1170,1213,0
20676371095,20676371093,-2,2027,4955,0
20677221329,20677221330,1,885,2104,0
20677309910,20677309926,16,118,422,0
20678963398,20678963399,1,1025,1713,0
20679229926,20679229926,0,1401,1865,0
20682847200,20682847202,2,1064,1053,0
20685371030,20685371028,-2,1526,1693,0
20686357102,20686357104,2,1595,2161,0
20691804493,20691804494,1,2456,1841,0
20692926418,20692926420,2,1717,1781,0
20694812157,20694812154,-3,1401,1809,0
20695354381,20695354383,2,1150,1977,0
20696025125,20696025127,2,1204,1482,0
20696173981,20696173981,0,1904,2070,0
20696595622,20696595622,0,1532,1453,0
20697521535,20697521554,19,818,1186,0
20698134089,20698134089,0,1486,1670,0
20701631937,20701631940,3,1336,2024,0
20703352791,20703352789,-2,1452,2780,0
20704575833,20704575833,0,842,1684,0
20707328959,20707328958,-1,1324,1628,0
20707963946,20707963946,0,1368,908,0
20708318750,20708318751,1,1073,2609,0
20712336301,20712336300,-1,1137,1687,0
20714727579,20714727581,2,1668,1241,0
20715244029,20715244026,-3,2094,2526,0
20721943410,20721943412,2,1527,1517,0
20726717378,20726717378,0,1406,1323,0
20731455935,20731455934,-1,1504,1575,0
20732191866,20732191865,-1,1173,1439,0
20734108197,20734108200,3,1559,1292,0
20736634639,20736634639,0,1176,1938,0
20737125336,20737125335,-1,1255,1417,0
20738132030,20738132029,-1,897,1235,0
20740460140,20740460140,0,889,1956,0
20744647101,20744647094,-7,1906,9132,0
20745181190,20745181190,0,1141,1519,0
20746224962,20746224962,0,1281,1207,0
20749472530,20749472531,1,1209,1485,0
20750144259,20750144260,1,1241,1450,0
20758652839,20758652842,3,1707,1247,0
20761886617,20761886618,1,1038,1548,0
20763127995,20763127996,1,1754,1729,0
20763662131,20763662132,1,1429,1699,0
20764331937,20764331937,0,1507,1629,0
20764856454,20764856438,-16,1886,2080,0
20766689688,20766689689,1,1177,1237,0
20768050126,20768050125,-1,1055,1404,0
20768481485,20768481485,0,1395,2509,0
20771168520,20771168521,1,1255,1399,0
20772162814,20772162815,1,1214,1558,0
20772370729,20772370736,7,1397,1638,0
20772542867,20772542887,20,661,315,0
20772901441,20772901443,2,1581,1271,0
20775676604,20775676603,-1,1258,1784,0
20784945219,20784945218,-1,1879,1687,0
20787527783,20787527783,0,1045,1005,0
20788183186,20788183187,1,1546,1855,0
20788714666,20788714667,1,2712,2968,0
20789114616,20789114618,2,1369,1750,0
20790270523,20790270522,-1,1359,1833,0
20790425903,20790425905,2,1855,2092,0
20793375877,20793375879,2,1603,1104,0
20797826523,20797826525,2,1881,1861,0
20804342169,20804342170,1,1298,1872,0
20810334381,20810334382,1,1081,1492,0
20818358009,20818358008,-1,1287,1776,0
20820500061,20820500058,-3,909,3602,0
20821093085,20821093086,1,1341,1284,0
20824397599,20824397598,-1,1237,1843,0
20826489336,20826489336,0,1830,2439,0
20827624315,20827624315,0,1388,2914,0
20827674734,20827674734,0,1798,2769,0
20827816782,20827816783,1,1110,1392,0
20828331263,20828331264,1,1703,2321,0
20833129754,20833129757,3,1132,1227,0
20834840636,20834840634,-2,1086,1772,0
20838290042,20838290056,14,14898,48063,0
20841988264,20841988262,-2,1845,2985,0
20844499878,20844499878,0,1197,1844,0
20844913642,20844913650,8,2366,1115,0
20848557903,20848557904,1,1118,1664,0
20850582042,20850582041,-1,1343,1730,0
20851299095,20851299095,0,1247,1659,0
20854327501,20854327503,2,1254,1535,0
20856274865,20856274867,2,1716,1627,0
20858499913,20858499914,1,1519,1864,0
20859361246,20859361246,0,918,1308,0
20860229485,20860229486,1,1389,1658,0
20866996917,20866996917,0,1465,1612,0
20868852726,20868852727,1,1428,1863,0
20870822091,20870822092,1,1690,2257,0
20870934713,20870934715,2,1290,2144,0
20880116057,20880116058,1,1063,1353,0
20885200831,20885200830,-1,1774,1794,0
20886713680,20886713679,-1,1149,839,0
20889614116,20889614117,1,1239,1561,0
20891207951,20891207953,2,874,953,0
20893524971,20893524982,11,1768,1730,0
20893605163,20893605165,2,1536,2185,0
20895363806,20895363805,-1,1419,2004,0
20896132927,20896132930,3,1402,949,0
20897112794,20897112794,0,1923,1526,0
20898018439,20898018438,-1,2139,1613,0
20898622078,20898622079,1,745,1428,0
20909033983,20909033985,2,1087,894,0
20909918255,20909918255,0,950,1449,0
20911716995,20911716994,-1,1558,1462,0
20919289133,20919289134,1,1809,2274,0
20921878206,20921878206,0,1607,1256,0
20922009558,20922009555,-3,1143,2253,0
20923409435,20923409435,0,1192,1517,0
20925380111,20925380110,-1,1599,1818,0
20926381574,20926381574,0,1354,1522,0
20927169588,20927169587,-1,1409,1335,0
20929407249,20929407271,22,1026,1124,0
20930447540,20930447541,1,1349,1792,0
20932458433,20932458431,-2,917,1750,0
20932764364,20932764363,-1,1367,2063,0
20933126367,20933126369,2,2599,2604,0
20933188154,20933188153,-1,1012,2161,0
20934221131,20934221132,1,1201,1836,0
20939435551,20939435554,3,1471,1352,0
20940050677,20940050686,9,900,1289,0
20940710470,20940710470,0,1897,2408,0
20945709980,20945709980,0,1765,1996,0
20950037013,20950037013,0,1430,2029,0
20954132790,20954132794,4,1015,1391,0
20955630865,20955630865,0,1372,1396,0
20956918589,20956918590,1,891,1246,0
20960048393,20960048400,7,1912,883,0
20961134403,20961134403,0,1352,1697,0
20962496247,20962496251,4,1554,1747,0
20965089106,20965089105,-1,1113,1367,0
20967288766,20967288765,-1,875,870,0
20967463461,20967463467,6,6718,32559,0
20967875756,20967875757,1,1009,1628,0
20972090162,20972090164,2,1611,1249,0
20972154088,20972154085,-3,1581,3360,0
20972664927,20972664930,3,925,1162,0
20973224439,20973224419,-20,963,1772,0
20974958604,20974958605,1,1437,1884,0
20978265761,20978265758,-3,1398,2108,0
20982004936,20982004938,2,1373,962,0
20983104034,20983104035,1,1833,1921,0
20986441126,20986441127,1,1278,1213,0
20988241305,20988241305,0,1289,1974,0
20989750655,20989750655,0,836,1631,0
20996606463,20996606463,0,1415,1948,0
20997526219,20997526220,1,1674,2140,0
20997705535,20997705535,0,842,1027,0
20998982369,20998982370,1,1577,2542,0
20999097070,20999097070,0,1204,1581,0
21001093933,21001093931,-2,1487,1375,0
21001913172,21001913171,-1,1174,2542,0
21007513461,21007513461,0,1767,1637,0
21010373865,21010373863,-2,1268,1452,0
21010551693,21010551690,-3,1544,2867,0
21012657967,21012657966,-1,1274,2298,0
21016814378,21016814379,1,1190,1356,0
21018928254,21018928255,1,1394,1520,0
21021403043,21021403046,3,1765,1345,0
21021711146,21021711146,0,1172,1968,0
21022208168,21022208168,0,1613,1599,0
21023646562,21023646565,3,2790,1832,0
21025746075,21025746077,2,1816,2531,0
21026621121,21026621123,2,1327,1209,0
21029468603,21029468603,0,1424,1228,0
21030626887,21030626887,0,1356,1192,0
21034405451,21034405448,-3,1007,2388,0
21036063509,21036063510,1,2200,2145,0
21036520321,21036520322,1,1507,1340,0
21036907289,21036907270,-19,2011,952,0
21038261115,21038261106,-9,33348,16891,0
21039580744,21039580745,1,1428,1801,0
21040847883,21040847874,-9,1434,1388,0
21041976353,21041976355,2,1370,2259,0
21042595941,21042595944,3,942,1007,0
21046344406,21046344401,-5,1988,4571,0
21050670263,21050670263,0,1161,2179,0
21051420709,21051420710,1,1412,1647,0
21054646609,21054646610,1,1593,1490,0
21055808170,21055808171,1,1109,1168,0
21055903766,21055903766,0,1428,1845,0
21056788713,21056788719,6,3062,1953,0
21057031078,21057031079,1,1018,910,0
21058419502,21058419503,1,1248,1783,0
21061102814,21061102815,1,1502,1524,0
21065202363,21065202361,-2,878,1693,0
21065564022,21065564021,-1,1592,2029,0
21068428287,21068428288,1,1051,1899,0
21075382152,21075382150,-2,556,824,0
21077095154,21077095154,0,1333,1623,0
21077779937,21077779938,1,1451,1469,0
21077817418,21077817418,0,1705,1303,0
21078498372,21078498375,3,1373,1538,0
21079666723,21079666724,1,1851,2005,0
21080769966,21080769966,0,907,1572,0
21082268918,21082268902,-16,1300,1424,0
21082771695,21082771709,14,932,3531,0
21083231771,21083231771,0,1156,1168,0
21083407746,21083407745,-1,1590,2245,0
21084191334,21084191333,-1,1760,2683,0
21085447202,21085447206,4,1766,1268,0
21085718606,21085718606,0,1473,2544,0
21085815305,21085815307,2,1200,1802,0
21089146018,21089146020,2,1048,1478,0
21092396543,21092396542,-1,1274,1338,0
21096940127,21096940127,0,1343,1515,0
21097268454,21097268458,4,1767,2048,0
21097523686,21097523675,-11,11823,28794,0
21099634494,21099634493,-1,1471,1870,0
21100937379,21100937378,-1,1876,1718,0
21101681311,21101681312,1,1519,1427,0
21101717962,21101717964,2,1834,1782,0
21102773667,21102773655,-12,2450,1030,0
21108542193,21108542193,0,1446,1458,0
21108572744,21108572745,1,29195,35735,0
21111186795,21111186791,-4,1150,2620,0
21111746785,21111746786,1,1145,1831,0
21116292743,21116292741,-2,1006,1356,0
21117383465,21117383464,-1,1353,1437,0
21118532050,21118532053,3,956,1256,0
21119369001,21119368999,-2,2699,3941,0
21123986228,21123986229,1,1228,1559,0
21127720175,21127720177,2,1785,2055,0
21128460663,21128460665,2,1266,1893,0
21132097229,21132097230,1,1483,1412,0
21135105385,21135105386,1,1557,1576,0
21135438697,21135438698,1,1571,1665,0
21136902227,21136902231,4,3134,1812,0
21143847205,21143847207,2,474,515,0
21144830633,21144830634,1,1514,1691,0
21146358142,21146358142,0,1221,1928,0
21150538416,21150538417,1,1696,1367,0
21151649958,21151649958,0,1309,1699,0
21152529843,21152529845,2,866,951,0
21154970562,21154970562,0,1293,1429,0
21155696938,21155696939,1,1120,1299,0
21156436098,21156436099,1,1335,1824,0
21157076500,21157076498,-2,755,948,0
21158968390,21158968390,0,884,1545,0
21161634346,21161634347,1,2767,3863,0
21164075106,21164075107,1,1451,1648,0
21169234890,21169234894,4,4625,2490,0
21171727186,21171727186,0,1070,1586,0
21173563577,21173563578,1,1501,968,0
21180454302,21180454303,1,1950,1356,0
21181382048,21181382052,4,3665,1715,0
21181487853,21181487853,0,1413,1952,0
21181802660,21181802659,-1,1735,1626,0
21186624503,21186624504,1,1534,1675,0
21189817520,21189817522,2,1211,1147,0
21192800390,21192800389,-1,1357,1739,0
21194582622,21194582622,0,772,1112,0
21195958498,21195958498,0,1594,1874,0
21200917812,21200917811,-1,921,1318,0
21201944414,21201944414,0,931,1791,0
21203863255,21203863257,2,1089,1187,0
21206743280,21206743281,1,1170,1794,0
21206783578,21206783577,-1,1759,1981,0
21212312750,21212312750,0,1251,1718,0
21214549801,21214549799,-2,1034,2050,0
21217140300,21217140300,0,1518,1731,0
21218755582,21218755584,2,1258,1863,0
21219678393,21219678399,6,1686,994,0
21221624078,21221624079,1,1202,1877,0
21222933898,21222933901,3,1428,1657,0
21224730038,21224730038,0,1449,1925,0
21224840005,21224840005,0,1612,1947,0
21226129486,21226129486,0,2686,2865,0
21227561669,21227561670,1,1422,1066,0
21228092078,21228092079,1,1220,1488,0
21229952698,21229952695,-3,1116,1625,0
21231191669,21231191669,0,962,989,0
21235644561,21235644562,1,1073,1080,0
21240454666,21240454667,1,991,1292,0
21241788330,21241788330,0,1841,2271,0
21243998129,21243998129,0,1258,1777,0
21244894608,21244894610,2,757,1018,0
21247874753,21247874754,1,972,867,0
21250624350,21250624350,0,2017,2269,0
21252118622,21252118622,0,1033,1451,0
21252499090,21252499090,0,1241,1291,0
21255892568,21255892570,2,1872,1563,0
21257349949,21257349949,0,1242,1622,0
21257856724,21257856722,-2,1437,1585,0
21262038559,21262038559,0,1111,1014,0
21262525818,21262525818,0,2099,2108,0
21262964169,21262964169,0,1877,1848,0
21265996982,21265996982,0,1016,1119,0
21267243482,21267243482,0,1785,1733,0
21267317345,21267317345,0,1453,2192,0
21267949235,21267949236,1,841,1335,0
21271578862,21271578863,1,1317,1658,0
21272815907,21272815908,1,1428,1542,0
21273926881,21273926884,3,1190,1573,0
21275124066,21275124065,-1,1239,1722,0
21278795523,21278795525,2,2101,1629,0
21279413459,21279413459,0,1848,2329,0
21280883374,21280883394,20,1970,2274,0
21281580913,21281580914,1,1449,1585,0
21282444138,21282444144,6,3863,1276,0
21282953734,21282953734,0,2235,1810,0
21283431102,21283431104,2,1513,1459,0
21284117410,21284117390,-20,1252,1225,0
21288044390,21288044391,1,1221,1580,0
21292734631,21292734632,1,1619,1856,0
21293069207,21293069212,5,1629,1263,0
21295265485,21295265486,1,16081,15942,0
21296400646,21296400645,-1,1603,1704,0
21297702039,21297702042,3,1519,1721,0
21299725418,21299725417,-1,1152,1140,0
21300531159,21300531167,8,1755,1663,0
21300910742,21300910744,2,1643,1849,0
21303740751,21303740750,-1,1254,2119,0
21303804593,21303804589,-4,793,2764,0
21308133422,21308133423,1,926,938,0
21309665943,21309665943,0,1350,1219,0
21310096486,21310096487,1,1534,1427,0
21312400647,21312400648,1,1314,1644,0
21312489971,21312489966,-5,1007,3210,0
21312983972,21312983976,4,6979,24645,0
21317943889,21317943868,-21,2042,1462,0
21320195449,21320195448,-1,1469,1679,0
21321813300,21321813301,1,2404,2444,0
21323959626,21323959626,0,804,866,0
21329056530,21329056526,-4,1082,3286,0
21329758564,21329758564,0,1037,1926,0
21333788378,21333788377,-1,1307,1765,0
21334671273,21334671273,0,1725,2552,0
21343477086,21343477087,1,1181,1320,0
21349119130,21349119130,0,1550,1814,0
21352704715,21352704715,0,1043,1265,0
21356723837,21356723835,-2,1613,1728,0
21357572674,21357572675,1,1408,1730,0
21358394611,21358394614,3,1315,1725,0
21361978338,21361978338,0,1437,1637,0
21362568739,21362568739,0,1090,1611,0
21362745686,21362745686,0,846,1256,0
21364110108,21364110110,2,1199,1699,0
21364357387,21364357388,1,1300,1538,0
21367657501,21367657501,0,1664,1568,0
21369679361,21369679363,2,1738,1325,0
21371004097,21371004097,0,1841,1974,0
21371202522,21371202524,2,1147,1879,0
21373000031,21373000032,1,1259,1504,0
21374471014,21374471015,1,1487,1679,0
21383078326,21383078325,-1,1249,1744,0
21383582815,21383582814,-1,875,1252,0
21385158872,21385158874,2,1356,1448,0
21385775937,21385775920,-17,1821,2127,0
21385964012,21385964014,2,1962,1355,0
21386859290,21386859288,-2,726,1977,0
21390318040,21390318042,2,1420,2487,0
21391292558,21391292558,0,1373,1817,0
21391826058,21391826061,3,2052,2166,0
21392788379,21392788395,16,290,770,0
21395385350,21395385350,0,1709,1661,0
21398432987,21398432988,1,1437,1647,0
21398682010,21398681988,-22,1734,1683,0
21399317158,21399317157,-1,1310,1678,0
21399368337,21399368337,0,923,1414,0
21401533143,21401533143,0,1410,2449,0
21404473824,21404473813,-11,1184,1510,0
21405567606,21405567607,1,1335,2095,0
21405749140,21405749139,-1,1873,2793,0
21408240131,21408240131,0,1402,1834,0
21409227722,21409227722,0,1124,2504,0
21411786233,21411786233,0,1691,1814,0
21414615966,21414615963,-3,1518,3449,0
21416316550,21416316554,4,2713,1648,0
21417875749,21417875750,1,1307,1410,0
21419068413,21419068414,1,1840,2037,0
21420571581,21420571582,1,1177,1733,0
21420953742,21420953741,-1,732,995,0
21421410965,21421410964,-1,1120,1489,0
21425057204,21425057206,2,1523,1247,0
21425536831,21425536833,2,1557,1220,0
21427091733,21427091736,3,1166,1410,0
21427438295,21427438273,-22,115,924,0
21427824751,21427824751,0,1696,2344,0
21427985090,21427985089,-1,1131,1442,0
21431929771,21431929772,1,1774,2281,0
21435378811,21435378811,0,1484,1998,0
21439798924,21439798926,2,1172,1287,0
21443055174,21443055175,1,1142,1698,0
21446852414,21446852414,0,829,1207,0
21450773611,21450773614,3,2222,1070,0
21457268262,21457268262,0,1195,1328,0
21458053611,21458053612,1,1290,1719,0
21458193062,21458193063,1,958,803,0
21458575016,21458575017,1,2085,1975,0
21465129038,21465129020,-18,1154,1015,0
21466714223,21466714219,-4,1525,3265,0
21467851439,21467851439,0,1540,1604,0
21469745807,21469745810,3,800,1129,0
21470734925,21470734926,1,1384,1644,0
21471042953,21471042964,11,893,476,0
21474590910,21474590910,0,1109,1961,0
21475504261,21475504263,2,2072,2123,0
21477987974,21477987974,0,873,1075,0
21479189856,21479189853,-3,669,1998,0
21480661709,21480661714,5,2403,1190,0
21481783236,21481783255,19,713,2048,0
21481857436,21481857438,2,753,1067,0
21483031233,21483031235,2,1703,2686,0
21486135350,21486135349,-1,836,1550,0
21490463091,21490463089,-2,1386,3180,0
21492335674,21492335672,-2,1204,2670,0
21492817862,21492817862,0,912,1145,0
21492876224,21492876224,0,1379,1641,0
21495154692,21495154693,1,1669,1721,0
21496599903,21496599901,-2,1443,2209,0
21499295374,21499295379,5,1697,718,0
21500959913,21500959913,0,1362,1635,0
21503444179,21503444182,3,1766,2210,0
21508997817,21508997817,0,1461,1729,0
21510261042,21510261043,1,1642,1721,0
21510530946,21510530942,-4,758,1404,0
21511334262,21511334261,-1,1174,1444,0
21516109259,21516109259,0,864,1859,0
21518939578,21518939575,-3,1917,4644,0
21520754429,21520754430,1,1916,2884,0
21523284213,21523284217,4,1869,1692,0
21524622082,21524622089,7,3249,1357,0
21525587352,21525587353,1,1239,1845,0
21528291858,21528291855,-3,962,1687,0
21529789542,21529789540,-2,2204,2126,0
21531165871,21531165871,0,1264,1797,0
21531683996,21531683995,-1,962,1517,0
21531884086,21531884074,-12,1063,1748,0
21531992371,21531992368,-3,1113,1611,0
21532440319,21532440318,-1,1029,1093,0
21533878828,21533878830,2,1089,1263,0
21535493409,21535493408,-1,1964,1972,0
21535530793,21535530793,0,1321,1601,0
21535612975,21535612976,1,1563,1940,0
21539034562,21539034563,1,1042,2030,0
21541921220,21541921220,0,1453,1877,0
21542984071,21542984070,-1,1303,1361,0
21544699827,21544699826,-1,1181,1919,0
21547483004,21547483010,6,3783,2231,0
21547780806,21547780805,-1,1690,2871,0
21547948365,21547948369,4,1420,1735,0
21550660504,21550660498,-6,474,1378,0
21552338869,21552338869,0,1167,1490,0
21552920733,21552920735,2,1587,1721,0
21555231047,21555231048,1,1392,1679,0
21559687436,21559687438,2,1942,1332,0
21564468920,21564468921,1,1364,1209,0
21566783769,21566783774,5,2081,1634,0
21571781233,21571781239,6,2434,1536,0
21572226407,21572226409,2,843,1682,0
21575580395,21575580394,-1,1491,1016,0
21576290636,21576290635,-1,1160,1694,0
21576549821,21576549821,0,1294,1519,0
21577469802,21577469799,-3,1232,1489,0
21579243614,21579243620,6,3495,1890,0
21581659785,21581659786,1,1278,1564,0
21590438717,21590438719,2,1339,1127,0
21591910006,21591910001,-5,1058,1343,0
21594085516,21594085515,-1,1064,1306,0
21595255348,21595255332,-16,1582,1984,0
21598485309,21598485309,0,1175,2140,0
21598923569,21598923569,0,1252,1933,0
21599080554,21599080554,0,1749,1775,0
21600021435,21600021434,-1,1635,1631,0
21602197540,21602197540,0,1873,2038,0
21603886247,21603886250,3,1781,1488,0
21604561238,21604561238,0,1118,1544,0
21607500627,21607500627,0,1625,2415,0
21609378213,21609378213,0,1330,2337,0
21609901960,21609901961,1,1612,1844,0
21610290435,21610290435,0,1381,1822,0
21612959796,21612959797,1,1217,1463,0
21617895394,21617895395,1,1751,2610,0
21620211769,21620211767,-2,1484,1489,0
21621950634,21621950634,0,1295,1611,0
21622201954,21622201953,-1,1891,1996,0
21622665895,21622665896,1,1466,1318,0
21626096742,21626096742,0,1388,1778,0
21628074130,21628074131,1,1380,1158,0
21628884046,21628884046,0,1202,1484,0
21632878557,21632878571,14,1464,1339,0
21633335526,21633335518,-8,2412,7144,0
21634912541,21634912543,2,1195,1972,0
21639298973,21639298973,0,1511,1924,0
21640164811,21640164815,4,1342,1344,0
21640341210,21640341207,-3,1972,2421,0
21641437444,21641437443,-1,1384,1188,0
21645406824,21645406827,3,1314,1289,0
21646555030,21646555030,0,1355,2147,0
21647501210,21647501209,-1,1186,1309,0
21649739686,21649739683,-3,1319,1732,0
21654135436,21654135436,0,1390,2490,0
21655837132,21655837133,1,1649,1797,0
21661923069,21661923070,1,1808,2314,0
21668461607,21668461607,0,1358,1690,0
21670555934,21670555936,2,1383,2003,0
21671770845,21671770846,1,1282,2480,0
21672808207,21672808208,1,1569,2182,0
21673329591,21673329590,-1,1178,1768,0
21673814562,21673814562,0,1419,2399,0
21676298142,21676298146,4,1233,1246,0
21678538742,21678538741,-1,1260,1279,0
21681160866,21681160866,0,1113,1398,0
21681821260,21681821260,0,1227,1630,0
21682318476,21682318473,-3,1597,3647,0
21685648286,21685648286,0,1115,1730,0
21688331020,21688331018,-2,1606,2123,0
21688752834,21688752835,1,1173,1668,0
21691271729,21691271731,2,1911,1648,0
21691497598,21691497597,-1,1120,1598,0
21694182775,21694182787,12,985,1043,0
21695647491,21695647491,0,1691,2322,0
21696953477,21696953475,-2,816,1888,0
21697214153,21697214143,-10,797,419,0
21698179926,21698179927,1,1438,2435,0
21701134507,21701134508,1,1346,1274,0
21702255714,21702255714,0,1333,1236,0
21703199160,21703199159,-1,1035,1763,0
21704219469,21704219469,0,1265,1450,0
21707747801,21707747803,2,1246,1293,0
21708315906,21708315897,-9,1721,3755,0
21715255002,21715255002,0,1626,1965,0
21716244302,21716244304,2,1234,1536,0
21718149202,21718149202,0,916,951,0
21719559922,21719559922,0,1508,1566,0
21720279383,21720279394,11,12822,46757,0
21721611229,21721611229,0,811,1471,0
21721893620,21721893621,1,1725,2199,0
21724421662,21724421658,-4,1136,1067,0
21724718773,21724718773,0,1681,2514,0
21728136643,21728136644,1,1145,1262,0
21728253022,21728253022,0,1325,1950,0
21729673490,21729673494,4,3002,2045,0
21731704179,21731704178,-1,1236,2276,0
21732011608,21732011608,0,1644,1763,0
21732286716,21732286739,23,794,1807,0
21732366862,21732366863,1,1321,1021,0
21738877482,21738877482,0,1181,1760,0
21739304638,21739304640,2,1247,1293,0
21739335877,21739335877,0,1958,1965,0
21739674468,21739674467,-1,1446,1545,0
21740537866,21740537868,2,1251,1529,0
21744634042,21744634039,-3,1436,2644,0
21754910378,21754910362,-16,886,1513,0
21756892318,21756892320,2,1028,957,0
21758991220,21758991215,-5,1064,1295,0
21759844613,21759844614,1,1369,1826,0
21760641465,21760641465,0,1328,1942,0
21762539298,21762539306,8,2559,1167,0
21769577055,21769577058,3,2054,1599,0
21771040971,21771040973,2,1440,1694,0
21771824481,21771824481,0,1676,1648,0
21772231940,21772231937,-3,837,986,0
21773624056,21773624058,2,2427,2038,0
21773750269,21773750269,0,1171,1868,0
21773801478,21773801481,3,1705,2001,0
21774807261,21774807262,1,1831,1631,0
21778123318,21778123324,6,2925,1528,0
21781219784,21781219784,0,911,1163,0
21784966537,21784966527,-10,1704,1963,0
21785393559,21785393559,0,1540,1705,0
21785858423,21785858426,3,1222,1606,0
21789859354,21789859355,1,1453,1797,0
21790239567,21790239568,1,1516,2143,0
21792660523,21792660525,2,1193,1413,0
21796130866,21796130867,1,1244,1493,0
21796658985,21796658988,3,3412,1806,0
21797175260,21797175261,1,1009,1571,0
21798028400,21798028402,2,1650,1287,0
21801905630,21801905626,-4,1170,2626,0
21801999657,21801999658,1,1520,1588,0
21804989662,21804989658,-4,1183,2861,0
21806925811,21806925811,0,1340,1528,0
21812948147,21812948150,3,1422,1537,0
21814319349,21814319348,-1,1453,1685,0
21814982474,21814982475,1,1779,2368,0
21818054871,21818054848,-23,1246,2341,0
21820385766,21820385770,4,1429,1442,0
21824471436,21824471436,0,2442,2778,0
21824770243,21824770242,-1,1545,1794,0
21825731990,21825731990,0,1778,2034,0
21826508073,21826508072,-1,942,1829,0
21826602028,21826602024,-4,9,1326,0
21831669794,21831669795,1,1249,1113,0
21832385097,21832385099,2,1406,1447,0
21835204330,21835204330,0,1779,1927,0
21835345966,21835345969,3,1762,2245,0
21835546140,21835546139,-1,1214,2155,0
21836765785,21836765785,0,1092,1475,0
21837393359,21837393360,1,1346,1184,0
21838137507,21838137507,0,1601,1294,0
21838807114,21838807115,1,858,925,0
21839436089,21839436091,2,1444,1814,0
21841375822,21841375822,0,1278,1837,0
21842443577,21842443576,-1,1537,1951,0
21846989053,21846989054,1,1223,1620,0
21848028429,21848028427,-2,1252,1907,0
21849849355,21849849355,0,1357,1451,0
21854032074,21854032085,11,10882,45239,0
21854338383,21854338385,2,1962,1732,0
21855222227,21855222227,0,1257,1314,0
21855586903,21855586896,-7,1323,2593,0
21856429905,21856429907,2,1018,1394,0
21858784654,21858784657,3,1998,1908,0
21859020303,21859020301,-2,1997,4718,0
21861027565,21861027566,1,1249,1532,0
21861148444,21861148445,1,1969,1957,0
21862307426,21862307428,2,747,1250,0
21862907575,21862907576,1,1875,1940,0
21864835734,21864835735,1,1443,2322,0
21868534270,21868534270,0,1727,1700,0
21871684924,21871684914,-10,1134,2051,0
21875873398,21875873398,0,1641,1539,0
21878792383,21878792382,-1,1129,1482,0
21879615070,21879615071,1,2438,3309,0
21881542636,21881542642,6,13877,20196,0
21883858939,21883858940,1,1244,2021,0
21884160368,21884160368,0,1162,1456,0
21886220365,21886220365,0,1711,2326,0
21889443899,21889443901,2,1226,1399,0
21889905267,21889905267,0,1882,1689,0
21892015721,21892015718,-3,1295,2441,0
21894649160,21894649161,1,1671,1742,0
21897304669,21897304666,-3,745,942,0
21898213026,21898213030,4,1019,1190,0
21900287644,21900287642,-2,1827,1837,0
21900434754,21900434754,0,1459,1951,0
21902356776,21902356775,-1,1315,1739,0
21903175278,21903175278,0,1253,1399,0
21903587975,21903587973,-2,1411,1431,0
21906528391,21906528390,-1,1312,1698,0
21906917262,21906917262,0,622,1114,0
21912044899,21912044903,4,1934,1593,0
21913182527,21913182529,2,1901,1644,0
21913990649,21913990650,1,1643,1551,0
21916229101,21916229101,0,1125,1120,0
21918344700,21918344700,0,1481,1898,0
21919738273,21919738274,1,1359,1845,0
21920615460,21920615459,-1,1619,1413,0
21921522057,21921522055,-2,1076,1753,0
21922967729,21922967731,2,992,1067,0
21926524597,21926524596,-1,1191,1752,0
21927218831,21927218833,2,1606,1889,0
21930291771,21930291769,-2,1289,2672,0
21936961776,21936961775,-1,1388,2249,0
21938038638,21938038641,3,1325,1341,0
21938201901,21938201903,2,1472,1852,0
21941910278,21941910278,0,808,1144,0
21943136033,21943136034,1,1300,1506,0
21943539219,21943539220,1,1500,1456,0
21950132544,21950132546,2,1084,1369,0
21950930789,21950930790,1,1494,1659,0
21951127853,21951127853,0,1181,2078,0
21952991704,21952991702,-2,1183,1978,0
21954281611,21954281615,4,1204,1259,0
21955448613,21955448612,-1,1320,1710,0
21958586431,21958586433,2,980,1357,0
21961798799,21961798800,1,1400,1875,0
21962659914,21962659917,3,1854,1309,0
21963011498,21963011496,-2,1612,2966,0
21963354587,21963354589,2,1318,1741,0
21963533991,21963533991,0,1955,2255,0
21965672777,21965672777,0,887,1463,0
21975851557,21975851555,-2,961,1527,0
21975891914,21975891915,1,749,1283,0
21976393033,21976393033,0,1230,1873,0
21979035026,21979035020,-6,906,2712,0
21981431567,21981431568,1,1020,1703,0
21985801968,21985801970,2,1604,1588,0
21986904941,21986904942,1,989,1703,0
21987525715,21987525714,-1,1461,1757,0
21988169386,21988169385,-1,1860,1967,0
21989917614,21989917613,-1,712,1058,0
21991598607,21991598606,-1,1976,1487,0
21992696130,21992696130,0,1160,1455,0
21996017540,21996017541,1,2078,1641,0
21997354449,21997354451,2,1289,1710,0
22002986488,22002986490,2,901,1311,0
22006210942,22006210944,2,1132,1400,0
22007694155,22007694155,0,973,1593,0
22008915213,22008915214,1,1301,1685,0
22010667551,22010667552,1,1421,1912,0
22012503898,22012503903,5,2272,1333,0
22015679424,22015679425,1,842,992,0
22016199481,22016199481,0,993,1952,0
22017961249,22017961250,1,1620,2280,0
22018170714,22018170715,1,1898,1572,0
22020322859,22020322861,2,1157,1358,0
22020729287,22020729301,14,1235,1904,0
22025082886,22025082889,3,1714,1437,0
22027519198,22027519198,0,1439,1968,0
22028254503,22028254504,1,1402,1484,0
22029365014,22029365018,4,1739,969,0
22031911129,22031911129,0,1978,3055,0
22032648530,22032648531,1,1645,1823,0
22033600117,22033600117,0,1196,1779,0
22034717231,22034717230,-1,1208,1279,0
22038313523,22038313523,0,1474,2244,0
22038634441,22038634442,1,1672,1657,0
22041982706,22041982713,7,12610,5884,0
22042870298,22042870298,0,1761,2215,0
22044482307,22044482310,3,2058,1693,0
22046895075,22046895077,2,1243,1473,0
22048536006,22048536009,3,1716,1872,0
22053086679,22053086680,1,1738,2149,0
22053296230,22053296234,4,1895,1212,0
22055383372,22055383373,1,1323,1851,0
22055867884,22055867882,-2,1547,1754,0
22062798836,22062798834,-2,1131,1467,0
22068152219,22068152220,1,921,1368,0
22070426562,22070426561,-1,1143,1819,0
22072264050,22072264050,0,991,1588,0
22075342286,22075342287,1,1464,2022,0
22076654047,22076654047,0,1242,1278,0
22079304171,22079304170,-1,1112,1950,0
22079668655,22079668651,-4,1199,2012,0
22080072665,22080072666,1,2283,2530,0
22082032895,22082032895,0,1397,1902,0
22082692858,22082692858,0,1053,1299,0
22084816399,22084816399,0,1772,2127,0
22085292821,22085292822,1,1340,1705,0
22085809191,22085809193,2,1366,1453,0
22086710495,22086710509,14,1063,1381,0
22087518886,22087518901,15,1326,1372,0
22087852558,22087852557,-1,1501,2057,0
22088859060,22088859061,1,1450,1591,0
22089706236,22089706238,2,1131,1051,0
22091320359,22091320359,0,1499,2101,0
22093648222,22093648223,1,1124,1656,0
22095720331,22095720334,3,1932,1685,0
22096427790,22096427789,-1,1059,1442,0
22097191377,22097191376,-1,988,1809,0
22098495047,22098495047,0,1602,1643,0
22099398654,22099398653,-1,1006,2155,0
22103851718,22103851720,2,2512,1879,0
22105156514,22105156514,0,1456,1611,0
22106422943,22106422942,-1,1183,1968,0
22107692414,22107692414,0,616,1309,0
22109450917,22109450918,1,1192,1327,0
22112236529,22112236535,6,2729,1139,0
22113246870,22113246871,1,1238,1989,0
22114752109,22114752110,1,1036,1234,0
22115546849,22115546849,0,6101,17984,0
22117074776,22117074777,1,1898,1908,0
22121786467,22121786465,-2,1512,1634,0
22124716191,22124716191,0,1307,1425,0
22127822263,22127822263,0,975,1156,0
22133638049,22133638054,5,1737,1627,0
22134572662,22134572662,0,1524,2231,0
22138517086,22138517087,1,1019,1326,0
22139335625,22139335625,0,1817,2175,0
22139876542,22139876542,0,976,1875,0
22142311416,22142311416,0,1591,1810,0
22144598559,22144598560,1,1276,1791,0
22145282254,22145282254,0,1428,1411,0
22153076943,22153076942,-1,1188,1613,0
22157757829,22157757818,-11,26575,13911,0
22157986470,22157986470,0,1384,2841,0
22159128345,22159128346,1,1243,1707,0
22161685062,22161685062,0,1467,2001,0
22162577881,22162577879,-2,1533,1908,0
22167709381,22167709381,0,1530,1431,0
22170873490,22170873490,0,1239,1366,0
22172975572,22172975571,-1,1225,1499,0
22173188853,22173188854,1,1329,1545,0
22175218446,22175218448,2,1232,1419,0
22184255704,22184255706,2,1988,1789,0
22191344114,22191344114,0,1054,1920,0
22191816466,22191816467,1,1558,2135,0
22193695668,22193695671,3,1263,896,0
22197683178,22197683179,1,1190,1478,0
22199921350,22199921350,0,1108,1480,0
22200451581,22200451580,-1,1902,2299,0
22200947972,22200947974,2,1727,2568,0
22201459202,22201459204,2,1090,2168,0
22203038234,22203038238,4,1955,1676,0
22203885045,22203885045,0,1287,2015,0
22205995597,22205995597,0,1198,1658,0
22206787507,22206787510,3,1129,1399,0
22212609907,22212609910,3,17668,29213,0
22213041426,22213041430,4,1811,1914,0
22213184367,22213184347,-20,1093,1290,0
22214128734,22214128735,1,1594,1840,0
22215912715,22215912714,-1,1348,2040,0
22217546554,22217546575,21,1672,2329,0
22219188517,22219188519,2,1940,1217,0
22219904158,22219904175,17,1345,1393,0
22223691269,22223691269,0,1631,1690,0
22224466487,22224466494,7,1190,1583,0
22226397922,22226397925,3,1379,2114,0
22228625613,22228625611,-2,913,2282,0
22231059194,22231059192,-2,1505,1955,0
22231926332,22231926331,-1,1196,1417,0
22237314077,22237314078,1,1518,1356,0
22240420044,22240420046,2,1365,1018,0
22243162830,22243162834,4,1090,1665,0
22247455218,22247455218,0,1799,1783,0
22248201376,22248201375,-1,1765,2317,0
22249868582,22249868584,2,1483,1435,0
22250411405,22250411405,0,1345,1642,0
22250985657,22250985653,-4,949,1864,0
22251771528,22251771529,1,1343,1356,0
22252760501,22252760505,4,2085,1679,0
22259315942,22259315945,3,1164,1644,0
22260625913,22260625915,2,1233,1055,0
22261104834,22261104836,2,1475,2073,0
22261869055,22261869055,0,844,1706,0
22262404661,22262404683,22,1653,1299,0
22263336150,22263336150,0,1472,1628,0
22264437830,22264437830,0,1387,1781,0
22267956051,22267956053,2,1606,1669,0
22269669144,22269669143,-1,1244,1614,0
22271092846,22271092847,1,1124,1276,0
22272647839,22272647839,0,1109,1641,0
22274986815,22274986816,1,1883,1623,0
22275106266,22275106264,-2,1621,1837,0
22275671646,22275671646,0,2060,1330,0
22276997418,22276997419,1,1250,1708,0
22277596549,22277596551,2,1231,1203,0
22280979963,22280979971,8,17218,47297,0
22282913645,22282913646,1,1713,1514,0
22285117208,22285117194,-14,1493,1748,0
22285568107,22285568105,-2,1106,2261,0
22285806544,22285806563,19,636,1265,0
22288522210,22288522214,4,2638,1189,0
22289084791,22289084790,-1,994,1208,0
22289810289,22289810288,-1,1558,1400,0
22297363898,22297363898,0,1143,1997,0
22302236759,22302236759,0,1059,1678,0
22302911475,22302911482,7,3120,1062,0
22306316473,22306316472,-1,1296,1771,0
22307458907,22307458906,-1,1212,1518,0
22309674765,22309674766,1,1613,2052,0
22311935847,22311935848,1,1430,2152,0
22314513167,22314513167,0,1415,1871,0
22314805667,22314805666,-1,1004,1830,0
22315067241,22315067245,4,1968,1353,0
22317074382,22317074381,-1,1498,2445,0
22317283684,22317283706,22,945,1056,0
22319721546,22319721544,-2,1632,2379,0
22321674838,22321674816,-22,124,1252,0
22322015282,22322015285,3,1496,1618,0
22322504750,22322504753,3,1579,1659,0
22323481455,22323481458,3,1035,1192,0
22326911491,22326911491,0,1148,1693,0
22330664623,22330664622,-1,983,1328,0
22331495453,22331495454,1,1582,2169,0
22333790940,22333790945,5,2389,1573,0
22336253357,22336253358,1,1097,1385,0
22337094701,22337094705,4,3141,2897,0
22337365474,22337365472,-2,1450,2702,0
22344098873,22344098873,0,1820,2404,0
22345390385,22345390386,1,1300,2493,0
22350577425,22350577425,0,1609,2527,0
22351083741,22351083742,1,990,1161,0
22352506019,22352506018,-1,1393,1664,0
22353257881,22353257882,1,1186,1520,0
22353733582,22353733575,-7,1269,1630,0
22353905949,22353905951,2,1165,1778,0
22356364905,22356364904,-1,1730,1587,0
22358331971,22358331965,-6,2094,8601,0
22358605698,22358605698,0,1276,1500,0
22359762058,22359762058,0,1560,1844,0
22361438181,22361438179,-2,1469,1795,0
22361929127,22361929126,-1,1491,1905,0
22362873794,22362873799,5,1966,921,0
22367077037,22367077039,2,1528,2049,0
22367270550,22367270552,2,908,1494,0
22368404370,22368404370,0,1918,1707,0
22368517493,22368517492,-1,1308,2454,0
22372962038,22372962038,0,880,1610,0
22373061215,22373061217,2,1274,1315,0
22374590687,22374590688,1,1227,1404,0
22377562495,22377562495,0,1012,1027,0
22383142887,22383142886,-1,1721,1988,0
22383592578,22383592576,-2,1268,1214,0
22385257151,22385257170,19,695,1049,0
22387386078,22387386081,3,1053,1894,0
22388212895,22388212894,-1,1077,1367,0
22394273089,22394273089,0,1396,1793,0
22399445734,22399445735,1,1889,1941,0
22399900271,22399900270,-1,1150,2266,0
22402085764,22402085764,0,1559,1632,0
22402467054,22402467052,-2,1616,2492,0
22403849182,22403849184,2,920,1163,0
22406063066,22406063066,0,1181,1352,0
22406184334,22406184332,-2,1626,2042,0
22407894690,22407894690,0,1183,1693,0
22408242567,22408242566,-1,1207,2367,0
22408577290,22408577293,3,2088,2232,0
22411430775,22411430789,14,1360,1251,0
22411471485,22411471485,0,1272,1513,0
22419051415,22419051408,-7,1368,4666,0
22420933342,22420933342,0,1590,2293,0
22421814711,22421814711,0,1066,2127,0
22426379327,22426379330,3,1436,1834,0
22427597484,22427597485,1,1073,835,0
22429971861,22429971861,0,1123,1978,0
22432258581,22432258584,3,1691,1517,0
22437851859,22437851862,3,1552,1262,0
22440587550,22440587543,-7,1706,9062,0
22442440163,22442440163,0,1538,1422,0
22444688150,22444688150,0,1129,1579,0
22450196998,22450197000,2,1463,1958,0
22460422707,22460422710,3,1494,1612,0
22462850537,22462850537,0,1831,2403,0
22463228278,22463228279,1,1342,1782,0
22468080193,22468080194,1,1731,1761,0
22469481519,22469481520,1,2425,2121,0
22469621604,22469621605,1,1745,1677,0
22473544767,22473544766,-1,1044,1650,0
22480114171,22480114173,2,1105,1695,0
22480372661,22480372667,6,4329,2354,0
22483054894,22483054894,0,1674,1546,0
22484306550,22484306531,-19,1698,1854,0
22484658664,22484658666,2,1276,1353,0
22486776423,22486776425,2,2021,1718,0
22487122799,22487122803,4,2290,1575,0
22488787734,22488787735,1,1673,2052,0
22488962198,22488962205,7,2931,1767,0
22489847775,22489847775,0,1202,1499,0
22491903613,22491903614,1,1133,1391,0
22491939285,22491939285,0,1142,1883,0
22492175364,22492175364,0,803,1841,0
22492517360,22492517360,0,1434,1889,0
22492627865,22492627866,1,1663,954,0
22495616669,22495616669,0,1287,1065,0
22495812658,22495812678,20,2174,1215,0
22497383661,22497383662,1,2041,1736,0
22500846501,22500846501,0,1728,1775,0
22501715381,22501715381,0,1649,2383,0
22505993363,22505993357,-6,1052,2667,0
22506727103,22506727103,0,1280,2004,0
22509071365,22509071366,1,1012,1322,0
22509285448,22509285450,2,2020,1252,0
22509627642,22509627661,19,1175,2214,0
22510177113,22510177114,1,1679,2044,0
22510285915,22510285915,0,1229,1690,0
22510980836,22510980835,-1,1450,2225,0
22513904415,22513904413,-2,1393,1468,0
22517255974,22517255976,2,1449,2105,0
22518137878,22518137879,1,1433,2091,0
22519786042,22519786042,0,1045,1714,0
22521757346,22521757345,-1,1458,1779,0
22522363549,22522363551,2,1323,1168,0
22524587317,22524587317,0,1118,1808,0
22524889583,22524889581,-2,1037,1755,0
22527942878,22527942878,0,1588,2179,0
22528524723,22528524723,0,1185,1177,0
22531030094,22531030095,1,1329,2267,0
22532863518,22532863519,1,1366,1393,0
22536350681,22536350682,1,957,1284,0
22538523314,22538523315,1,1395,1558,0
22538899298,22538899301,3,1026,1332,0
22543772210,22543772211,1,842,1097,0
22551086673,22551086673,0,1765,1822,0
22552635885,22552635885,0,1615,1626,0
22554188506,22554188508,2,1564,1517,0
22555833337,22555833336,-1,1146,1868,0
22556355919,22556355919,0,1481,1267,0
22556461323,22556461300,-23,1503,1772,0
22557076982,22557076981,-1,1333,1931,0
22557817541,22557817547,6,5984,2187,0
22561407944,22561407944,0,1342,1902,0
22562977936,22562977933,-3,682,2998,0
22568099816,22568099818,2,1377,1394,0
22568279840,22568279842,2,1428,1817,0
22568488982,22568488982,0,2033,1260,0
22569653741,22569653741,0,941,1435,0
22569929586,22569929586,0,1429,1518,0
22570388729,22570388730,1,1414,1413,0
22573201265,22573201265,0,1870,1737,0
22574410961,22574410961,0,1226,1512,0
22575095113,22575095114,1,1827,1838,0
22576097014,22576097013,-1,1137,1720,0
22576606786,22576606786,0,1387,1320,0
22577389836,22577389834,-2,1097,1477,0
22578875221,22578875223,2,1445,1786,0
22579137786,22579137787,1,1593,1685,0
22581446331,22581446332,1,1080,1702,0
22582951219,22582951218,-1,1533,1467,0
22586598674,22586598674,0,1601,1355,0
22593472087,22593472088,1,819,1352,0
22595839911,22595839911,0,1347,1399,0
22596239258,22596239257,-1,1076,1688,0
22597025549,22597025547,-2,851,1389,0
22597949955,22597949954,-1,1012,1566,0
22600084573,22600084574,1,1633,1828,0
22600865562,22600865563,1,964,1522,0
22601588087,22601588087,0,1302,1251,0
22601860610,22601860608,-2,1401,2048,0
22603356610,22603356609,-1,1289,1713,0
22605054901,22605054899,-2,1025,1065,0
22607465766,22607465766,0,2072,2308,0
22607512952,22607512952,0,1723,1552,0
22612372753,22612372753,0,1504,2174,0
22612567321,22612567323,2,2023,1162,0
22615475441,22615475442,1,1884,2726,0
22615631402,22615631402,0,1383,1561,0
22618424334,22618424334,0,1848,2606,0
22619526244,22619526245,1,1487,2115,0
22624158330,22624158332,2,1471,1641,0
22627901338,22627901339,1,1059,2109,0
22628053536,22628053540,4,1734,1505,0
22628231434,22628231438,4,1727,1717,0
22628784009,22628784009,0,1528,1800,0
22630637835,22630637839,4,1873,1135,0
22631348175,22631348175,0,959,1364,0
22633363594,22633363604,10,794,2131,0
22634823070,22634823091,21,734,635,0
22635675579,22635675578,-1,1174,1822,0
22637453110,22637453109,-1,1667,2140,0
22637941253,22637941255,2,1622,1924,0
22641664111,22641664110,-1,1009,1665,0
22642753256,22642753257,1,1251,1473,0
22645663300,22645663302,2,1267,1626,0
22647019227,22647019224,-3,846,1097,0
22647761521,22647761522,1,1644,1767,0
22649351456,22649351458,2,1199,1836,0
22649670412,22649670410,-2,1136,1529,0
22651407393,22651407393,0,1046,805,0
22652081862,22652081862,0,1274,1643,0
22654387939,22654387942,3,1099,1799,0
22654966830,22654966830,0,2693,3207,0
22657314858,22657314859,1,825,1115,0
22659122119,22659122119,0,1119,1265,0
22662387223,22662387225,2,1491,1498,0
22662462434,22662462412,-22,676,1247,0
22665656177,22665656175,-2,1889,2621,0
22667395814,22667395814,0,1228,1233,0
22669936661,22669936663,2,1241,1170,0
22672626197,22672626199,2,2193,2028,0
22675765922,22675765922,0,1434,1177,0
22676376110,22676376110,0,1491,1407,0
22685716201,22685716201,0,1445,1951,0
22689361663,22689361665,2,1122,1530,0
22690110727,22690110726,-1,1508,1988,0
22692294324,22692294325,1,1458,1914,0
22700251686,22700251686,0,1016,1492,0
22701549095,22701549097,2,1392,1750,0
22702569237,22702569233,-4,3281,13702,0
22704467273,22704467274,1,1164,1392,0
22707220416,22707220398,-18,2335,839,0
22707328848,22707328850,2,1281,1296,0
22708187352,22708187349,-3,1022,2328,0
22708737018,22708737019,1,985,1306,0
22714082648,22714082649,1,1386,1713,0
22716259050,22716259050,0,1626,1836,0
22731038951,22731038951,0,1178,1417,0
22731306909,22731306911,2,155,1066,0
22731822898,22731822897,-1,1558,2119,0
22740516991,22740516990,-1,1297,2020,0
22741352792,22741352793,1,1958,1654,0
22742617593,22742617594,1,1113,1585,0
22744197318,22744197318,0,1266,1876,0
22746752615,22746752619,4,1431,1310,0
22747344421,22747344430,9,1134,1628,0
22749359431,22749359435,4,1868,1641,0
22750556142,22750556147,5,1333,1396,0
22750691978,22750691958,-20,1245,1150,0
22750969341,22750969338,-3,1134,1958,0
22752804150,22752804154,4,1081,1277,0
22753681270,22753681273,3,1501,1857,0
22755051016,22755051017,1,1412,1842,0
22755308686,22755308702,16,1205,1570,0
22757179326,22757179327,1,1305,1828,0
22761982003,22761982002,-1,861,1331,0
22762261206,22762261205,-1,1867,2733,0
22763297350,22763297351,1,1485,2237,0
22764784513,22764784514,1,1837,1417,0
22767266110,22767266107,-3,1125,2532,0
22768655753,22768655751,-2,1176,1752,0
22769778846,22769778846,0,1178,1408,0
22770552205,22770552206,1,1269,1363,0
22771645066,22771645065,-1,1615,2462,0
22774517762,22774517763,1,1017,1682,0
22777263595,22777263601,6,3458,1465,0
22782067289,22782067290,1,1260,1500,0
22785341422,22785341422,0,957,1140,0
22786986708,22786986701,-7,1698,7933,0
22787535284,22787535286,2,827,2016,0
22789820650,22789820647,-3,1066,1028,0
22791513452,22791513451,-1,1498,1124,0
22793261139,22793261141,2,1800,2283,0
22794218039,22794218042,3,1529,1658,0
22795663061,22795663064,3,1462,1388,0
22795839024,22795839025,1,1774,2115,0
22796515155,22796515155,0,1137,1243,0
22797188826,22797188825,-1,1865,2427,0
22798356166,22798356167,1,1514,1255,0
22802026887,22802026890,3,1633,984,0
22802936618,22802936618,0,1151,1550,0
22804343539,22804343539,0,1490,1581,0
22806078165,22806078167,2,1054,1241,0
22809615038,22809615038,0,1255,1613,0
22812940985,22812940986,1,780,1448,0
22814908474,22814908475,1,1239,1432,0
22817282853,22817282853,0,1453,2331,0
22818677270,22818677270,0,1450,1673,0
22819574770,22819574773,3,1317,1447,0
22819706028,22819706014,-14,1073,1214,0
22820447587,22820447585,-2,1144,1164,0
22822969306,22822969307,1,1247,2001,0
22823748760,22823748766,6,1374,1041,0
22824184494,22824184493,-1,1949,2051,0
22825610065,22825610066,1,1445,2241,0
22825878090,22825878091,1,1385,2116,0
22826220156,22826220155,-1,1331,1412,0
22826687755,22826687758,3,1320,1168,0
22828689277,22828689278,1,1428,1907,0
22830038840,22830038834,-6,30049,12255,0
22831304859,22831304858,-1,1205,2047,0
22832550135,22832550135,0,1275,1565,0
22834094125,22834094124,-1,1157,1560,0
22835125466,22835125463,-3,1500,2721,0
22835411913,22835411915,2,1603,1516,0
22837859422,22837859426,4,1505,1674,0
22840400402,22840400402,0,1722,2048,0
22841310309,22841310306,-3,1289,1725,0
22848501035,22848501036,1,1280,1788,0
22849950054,22849950053,-1,1137,1399,0
22851461225,22851461228,3,2007,1627,0
22854319193,22854319194,1,1161,1090,0
22856258918,22856258920,2,1065,1850,0
22856934670,22856934671,1,1076,2006,0
22858535790,22858535785,-5,903,3481,0
22861091343,22861091346,3,1258,1553,0
22861412333,22861412335,2,1265,1821,0
22861969641,22861969635,-6,1483,5377,0
22863604311,22863604312,1,1007,1458,0
22864266498,22864266503,5,1427,1550,0
22864503573,22864503571,-2,1000,1715,0
22864545118,22864545137,19,1244,1589,0
22868294878,22868294878,0,1317,1328,0
22874713382,22874713381,-1,1551,2798,0
22878631540,22878631541,1,1240,1278,0
22878918646,22878918658,12,715,1285,0
22881603814,22881603813,-1,1263,2115,0
22887580179,22887580179,0,964,1284,0
22888067160,22888067166,6,4932,1750,0
22889413879,22889413878,-1,1061,1817,0
22893470795,22893470794,-1,1446,1996,0
22894096669,22894096670,1,1887,1721,0
22896982410,22896982413,3,2367,2227,0
22899110878,22899110878,0,2020,2412,0
22900210333,22900210331,-2,1355,1654,0
22901087822,22901087824,2,1939,1772,0
22903765503,22903765503,0,1050,1502,0
22909166572,22909166575,3,1356,1543,0
22910901198,22910901199,1,1979,1737,0
22911648005,22911648004,-1,859,1962,0
22912530723,22912530724,1,1787,2146,0
22912776189,22912776189,0,953,1907,0
22919199381,22919199380,-1,2760,2560,0
22920143533,22920143533,0,1043,1544,0
22922618858,22922618857,-1,1010,1633,0
22925554986,22925554985,-1,1460,1475,0
22927086360,22927086361,1,1324,1977,0
22927627230,22927627231,1,1831,1839,0
22928491714,22928491715,1,1875,1860,0
22932707401,22932707403,2,1479,2061,0
22937278802,22937278795,-7,1830,7531,0
22938508557,22938508557,0,1530,2212,0
22939960237,22939960237,0,703,1172,0
22942400438,22942400439,1,1496,1733,0
22945500142,22945500143,1,1640,1807,0
22947575057,22947575066,9,1839,1463,0
22949072463,22949072461,-2,917,2166,0
22956039231,22956039234,3,2523,1661,0
22961678434,22961678433,-1,820,1115,0
22963177501,22963177499,-2,1052,2335,0
22965038399,22965038417,18,812,215,0
22965256801,22965256802,1,1050,1843,0
22969809254,22969809254,0,1360,1891,0
22970620594,22970620597,3,1824,1658,0
22971311113,22971311112,-1,931,2642,0
22971561000,22971560998,-2,1720,1427,0
22972125887,22972125886,-1,1219,1864,0
22975477627,22975477622,-5,1248,4522,0
22976331696,22976331694,-2,1291,1725,0
22977521615,22977521618,3,1551,1214,0
22978259207,22978259209,2,1226,1297,0
22979033302,22979033282,-20,2864,2467,0
22979564288,22979564288,0,1333,1212,0
22981214647,22981214648,1,844,1190,0
22983302331,22983302330,-1,1440,1922,0
22983346875,22983346875,0,1294,1861,0
22983784458,22983784456,-2,55993,31917,0
22985818927,22985818929,2,1511,1599,0
22988131800,22988131799,-1,1279,1574,0
22990467315,22990467315,0,1242,1767,0
22993347134,22993347134,0,1720,1432,0
22994059023,22994059025,2,1472,1302,0
22996691027,22996691027,0,1445,1334,0
23001444929,23001444938,9,12100,42559,0
23001896991,23001896992,1,1283,1516,0
23003049079,23003049072,-7,562,3203,0
23004331791,23004331789,-2,1291,1462,0
23004981930,23004981931,1,932,1518,0
23006209805,23006209805,0,1260,1550,0
23011987206,23011987206,0,1379,1877,0
23012358529,23012358530,1,1743,1971,0
23013740580,23013740576,-4,1576,1718,0
23014459985,23014459968,-17,898,631,0
23016573231,23016573233,2,858,1091,0
23017454178,23017454181,3,1330,1542,0
23021948614,23021948614,0,1662,2424,0
23021997877,23021997879,2,969,1437,0
23022242282,23022242282,0,1628,1780,0
23024970757,23024970757,0,1261,1241,0
23025013520,23025013522,2,1334,1552,0
23029881516,23029881516,0,1348,1571,0
23032126786,23032126787,1,1264,1796,0
23033040781,23033040781,0,1340,1319,0
23034071113,23034071115,2,1764,2060,0
23034599718,23034599718,0,1219,1806,0
23037262817,23037262814,-3,1321,1316,0
23040086294,23040086293,-1,1231,1653,0
23040701225,23040701226,1,1344,1613,0
23042363703,23042363705,2,1285,1584,0
23048036775,23048036777,2,1385,1762,0
23049754339,23049754338,-1,1748,1838,0
23050395730,23050395731,1,1225,1736,0
23051713648,23051713651,3,1613,1637,0
23052687568,23052687570,2,1609,2322,0
23053614102,23053614102,0,930,1587,0
23053869751,23053869750,-1,1124,961,0
23057000798,23057000798,0,1542,1851,0
23057741585,23057741586,1,897,1013,0
23058059023,23058059023,0,1309,1337,0
23058530394,23058530393,-1,1327,1906,0
23059184097,23059184097,0,1415,2005,0
23060351475,23060351475,0,1466,1915,0
23063256290,23063256291,1,1623,1477,0
23065179474,23065179474,0,1195,1625,0
23065762809,23065762809,0,1229,2529,0
23070648355,23070648357,2,1305,1524,0
23074695022,23074695028,6,3005,1222,0
23077632534,23077632534,0,1328,1474,0
23079964155,23079964149,-6,1337,5021,0
23081616781,23081616780,-1,1242,1886,0
23082623450,23082623449,-1,1105,1207,0
23086460365,23086460365,0,1343,2179,0
23088277283,23088277283,0,1441,1866,0
23092054879,23092054881,2,1620,1976,0
23094739625,23094739620,-5,1476,5619,0
23095025011,23095025013,2,1680,1345,0
23095057682,23095057681,-1,1116,1431,0
23095738891,23095738890,-1,1137,1455,0
23101234789,23101234794,5,1901,1738,0
23101289808,23101289807,-1,1043,1310,0
23104246235,23104246234,-1,1305,1502,0
23104351290,23104351290,0,1456,1866,0
23104692686,23104692686,0,1569,1508,0
23107406770,23107406771,1,1281,1358,0
23112470089,23112470092,3,1758,2291,0
23112904694,23112904694,0,1248,2071,0
23113178024,23113178031,7,22978,21734,0
23115176894,23115176896,2,2275,1766,0
23117507327,23117507327,0,913,1513,0
23119415846,23119415847,1,1697,2436,0
23120287238,23120287239,1,1711,2310,0
23128257554,23128257555,1,1126,901,0
23132275211,23132275211,0,1394,2652,0
23133853690,23133853697,7,2621,1323,0
23135826518,23135826516,-2,1037,2152,0
23136015470,23136015454,-16,1604,1982,0
23137347241,23137347242,1,1012,1705,0
23140845381,23140845386,5,1928,1471,0
23141967342,23141967339,-3,1742,2827,0
23142617443,23142617442,-1,1304,1354,0
23144642634,23144642634,0,876,961,0
23145940939,23145940939,0,1175,1802,0
23146353646,23146353645,-1,1314,2143,0
23147069778,23147069778,0,1031,1465,0
23151075059,23151075059,0,936,923,0
23155301467,23155301467,0,1110,1460,0
23158755514,23158755514,0,1598,1728,0
23159074574,23159074580,6,3443,1742,0
23159280485,23159280485,0,1532,1172,0
23160143105,23160143107,2,1024,1631,0
23160615664,23160615666,2,1327,1375,0
23171048475,23171048474,-1,1421,1579,0
23174445899,23174445899,0,1611,1739,0
23174612504,23174612502,-2,673,1788,0
23175901614,23175901617,3,2460,2089,0
23179261363,23179261363,0,1007,1389,0
23182215830,23182215826,-4,1388,3521,0
23188769983,23188769983,0,1447,1195,0
23189862198,23189862200,2,1453,1685,0
23193300690,23193300691,1,1224,1582,0
23194298981,23194298982,1,1723,2476,0
23194880538,23194880538,0,1521,1309,0
23195725890,23195725890,0,1501,1774,0
23196366643,23196366643,0,1040,2030,0
23196859810,23196859809,-1,1265,1345,0
23198845231,23198845233,2,1177,1662,0
23200745577,23200745578,1,949,1773,0
23202247429,23202247429,0,1848,1709,0
23209212877,23209212877,0,1511,1739,0
23210123706,23210123709,3,2110,2439,0
23212406429,23212406430,1,1692,1604,0
23213658203,23213658201,-2,598,757,0
23215562075,23215562077,2,1234,1653,0
23219125828,23219125827,-1,1004,1073,0
23219244117,23219244124,7,2100,1609,0
23219783190,23219783191,1,1679,1615,0
23223958793,23223958791,-2,1512,1424,0
23226753416,23226753415,-1,1843,1995,0
23227250946,23227250946,0,2592,2349,0
23228627601,23228627602,1,1103,1711,0
23229468702,23229468701,-1,1442,1484,0
23231133665,23231133667,2,1297,2217,0
23232431043,23232431044,1,837,1433,0
23232896126,23232896126,0,1780,2158,0
23236843985,23236843985,0,892,1194,0
23240262377,23240262377,0,1114,1369,0
23243591228,23243591226,-2,789,1548,0
23245438880,23245438881,1,1816,1666,0
23246938237,23246938237,0,1117,1477,0
23247918170,23247918171,1,2997,4071,0
23248965733,23248965734,1,1513,1998,0
23250712570,23250712569,-1,1215,1479,0
23256525070,23256525069,-1,1295,1341,0
23256680159,23256680157,-2,1160,2413,0
23257482402,23257482397,-5,962,2644,0
23257666959,23257666958,-1,874,1489,0
23260061568,23260061568,0,1682,2579,0
23264497131,23264497133,2,1187,1792,0
23266732498,23266732500,2,1629,1691,0
23267091161,23267091162,1,1056,1079,0
23268681986,23268681984,-2,1589,1909,0
23271825800,23271825800,0,1085,1330,0
23272377123,23272377127,4,1614,1446,0
23275835775,23275835776,1,1019,1984,0
23280946846,23280946847,1,1150,1947,0
23283137694,23283137698,4,2190,1426,0
23285191398,23285191400,2,1740,1316,0
23288227733,23288227733,0,1168,1760,0
23288554733,23288554754,21,1341,1550,0
23289714071,23289714068,-3,1290,2148,0
23293261934,23293261941,7,6551,2877,0
23294055217,23294055216,-1,1466,2155,0
23294103985,23294103987,2,1234,1118,0
23296001177,23296001177,0,2100,2095,0
23296202617,23296202617,0,1364,1592,0
23298932434,23298932435,1,1973,2483,0
23300101458,23300101460,2,1693,1651,0
23300814551,23300814550,-1,1562,1578,0
23302795880,23302795882,2,1517,1663,0
23306655816,23306655813,-3,1172,2698,0
23307632893,23307632893,0,1932,2186,0
23312951887,23312951866,-21,1451,1041,0
23313480202,23313480202,0,1406,1931,0
23314831683,23314831683,0,1732,1959,0
23315737208,23315737207,-1,1331,1663,0
23315874871,23315874872,1,1041,2036,0
23319155147,23319155146,-1,1402,2539,0
23323613011,23323613013,2,1098,1917,0
23324941820,23324941821,1,1899,1768,0
23325633030,23325633031,1,1143,1603,0
23332876368,23332876368,0,1411,1776,0
23335810711,23335810716,5,1483,1327,0
23336178991,23336178989,-2,35,1061,0
23338268417,23338268417,0,1539,1218,0
23338546969,23338546962,-7,1037,2884,0
23341159750,23341159751,1,2087,1843,0
23343546006,23343546002,-4,1537,2391,0
23347766230,23347766231,1,1141,1843,0
23350252686,23350252685,-1,1156,1737,0
23355256895,23355256894,-1,1046,2251,0
23356396536,23356396544,8,12703,23671,0
23357466455,23357466454,-1,1093,1512,0
23359055622,23359055625,3,1228,1292,0
23359671213,23359671214,1,1842,1634,0
23362447822,23362447824,2,1497,2108,0
23363411630,23363411629,-1,1626,1540,0
23364191900,23364191901,1,1435,2057,0
23364973713,23364973720,7,10469,39133,0
23367914905,23367914907,2,1350,2284,0
23369826145,23369826145,0,1320,1606,0
23377415170,23377415170,0,1579,1870,0
23377530049,23377530049,0,1591,2335,0
23379161710,23379161713,3,1121,1403,0
23379437551,23379437553,2,1369,1326,0
23382314866,23382314868,2,1068,1428,0
23383415369,23383415369,0,1431,1452,0
23383629936,23383629934,-2,1273,1897,0
23383733870,23383733878,8,1242,1652,0
23387139257,23387139257,0,1017,1809,0
23387903055,23387903053,-2,1257,1612,0
23393402173,23393402173,0,1411,1819,0
23394293862,23394293864,2,1398,1738,0
23395016687,23395016687,0,1666,2242,0
23401665798,23401665799,1,1137,1601,0
23402175821,23402175822,1,1761,1764,0
23404254298,23404254298,0,1258,1513,0
23405476711,23405476715,4,2101,1782,0
23408487634,23408487642,8,3541,1693,0
23409588995,23409589009,14,12750,48644,0
23410446950,23410446954,4,2130,1168,0
23410481938,23410481920,-18,1442,1738,0
23410887488,23410887487,-1,1750,2083,0
23411178411,23411178411,0,1218,1784,0
23415404120,23415404119,-1,1598,1279,0
23418605975,23418605968,-7,708,5079,0
23419459551,23419459550,-1,1570,2340,0
23420291842,23420291838,-4,806,1026,0
23421086147,23421086150,3,1566,1838,0
23422085682,23422085685,3,2036,1460,0
23423401245,23423401246,1,1179,1181,0
23423865057,23423865057,0,1365,1380,0
23424600206,23424600206,0,1432,1835,0
23425496273,23425496278,5,1870,1667,0
23427041897,23427041896,-1,1255,1907,0
23428563870,23428563867,-3,1345,1262,0
23429868295,23429868294,-1,1407,1888,0
23435246254,23435246258,4,1485,1292,0
23435545434,23435545416,-18,1841,1830,0
23436428231,23436428231,0,1728,2285,0
23437899087,23437899090,3,1964,1267,0
23438991390,23438991389,-1,1362,1971,0
23439454422,23439454401,-21,1476,2158,0
23440408334,23440408327,-7,1098,1035,0
23443478842,23443478841,-1,1491,2023,0
23446175742,23446175743,1,1239,1252,0
23447247949,23447247950,1,1943,1864,0
23447541931,23447541931,0,1171,1099,0
23449164179,23449164177,-2,1114,1369,0
23449778704,23449778704,0,1432,1888,0
23451841946,23451841946,0,1761,1313,0
23452602195,23452602189,-6,2011,7801,0
23453637917,23453637913,-4,926,1633,0
23454178911,23454178913,2,729,881,0
23455102866,23455102867,1,2526,1609,0
23455162895,23455162893,-2,1634,1925,0
23455320444,23455320465,21,1594,1765,0
23456579766,23456579766,0,1069,1673,0
23458977216,23458977217,1,1934,2272,0
23460532217,23460532218,1,1561,1624,0
23462222658,23462222659,1,1408,1133,0
23466718654,23466718655,1,1249,1642,0
23467761920,23467761921,1,2142,1994,0
23470197231,23470197229,-2,853,1804,0
23471112998,23471112998,0,1824,1759,0
23471257352,23471257355,3,1574,1594,0
23472413418,23472413418,0,1484,1133,0
23475234865,23475234865,0,1469,1567,0
23475384167,23475384161,-6,1306,1688,0
23477689105,23477689108,3,999,2003,0
23481756893,23481756894,1,1498,1630,0
23483115653,23483115654,1,1480,1764,0
23485500486,23485500487,1,1390,1787,0
23492848181,23492848182,1,2093,2085,0
23493517019,23493517036,17,1397,1861,0
23496213276,23496213274,-2,984,1429,0
23498408499,23498408499,0,848,965,0
23503547876,23503547877,1,1976,1931,0
23504844010,23504844010,0,1273,1227,0
23506628013,23506628007,-6,1584,6015,0
23507646889,23507646886,-3,1313,1135,0
23508092854,23508092854,0,1913,1784,0
23511669118,23511669119,1,1203,1996,0
23512343749,23512343749,0,1274,1933,0
23515203610,23515203608,-2,1259,2533,0
23516535639,23516535639,0,1156,2211,0
23517734595,23517734595,0,915,1372,0
23518039773,23518039775,2,1026,1773,0
23518394854,23518394874,20,1107,1822,0
23523031166,23523031166,0,1724,1337,0
23523801386,23523801386,0,1287,1676,0
23524828601,23524828602,1,1479,1817,0
23525736814,23525736810,-4,1307,1900,0
23528010643,23528010645,2,1625,1790,0
23528549046,23528549047,1,1409,1665,0
23528989446,23528989449,3,1174,1592,0
23534859430,23534859430,0,1392,1321,0
23535655264,23535655262,-2,1310,1654,0
23536475307,23536475286,-21,1057,1078,0
23536669790,23536669791,1,1201,2111,0
23537490614,23537490615,1,1392,1650,0
23540961575,23540961577,2,1585,1382,0
23541029039,23541029037,-2,1490,1671,0
23542975835,23542975837,2,2026,1362,0
23543661696,23543661698,2,1361,1503,0
23545913777,23545913778,1,1206,1588,0
23550416957,23550416958,1,1129,1282,0
23552500966,23552500965,-1,1358,1746,0
23554496453,23554496455,2,1618,1575,0
23556303882,23556303882,0,1709,1700,0
23556716210,23556716211,1,626,1307,0
23557194509,23557194508,-1,1473,1949,0
23557693056,23557693058,2,2581,1413,0
23558105328,23558105349,21,1456,1236,0
23563898079,23563898081,2,1372,2183,0
23566635969,23566635969,0,1013,1335,0
23568241005,23568241006,1,1340,1849,0
23568285093,23568285087,-6,74,1317,0
23569813543,23569813545,2,1538,1654,0
23573468590,23573468587,-3,1223,1600,0
23578843412,23578843413,1,1270,1425,0
23581247695,23581247690,-5,654,2481,0
23581380440,23581380440,0,949,2028,0
23582286972,23582286973,1,1156,1541,0
23582645073,23582645072,-1,1147,1435,0
23584810368,23584810371,3,1802,2157,0
23585324533,23585324534,1,1231,1660,0
23586478819,23586478819,0,1296,1916,0
23586562985,23586562986,1,1537,1082,0
23588559789,23588559787,-2,1700,1735,0
23592988719,23592988717,-2,962,2436,0
23593518998,23593519001,3,1677,1332,0
23594066742,23594066740,-2,1245,2173,0
23598314631,23598314633,2,1453,1704,0
23598654647,23598654650,3,940,951,0
23599049137,23599049137,0,1074,1838,0
23601394470,23601394470,0,1395,2131,0
23601729710,23601729711,1,1894,2239,0
23602731768,23602731766,-2,1256,1490,0
23603813646,23603813637,-9,1336,1179,0
23606191495,23606191495,0,1269,1360,0
23606639359,23606639344,-15,799,1376,0
23606909380,23606909381,1,1505,2184,0
23607323944,23607323945,1,1118,1394,0
23608280038,23608280039,1,887,1380,0
23609782553,23609782553,0,748,1697,0
23610231223,23610231221,-2,1365,1703,0
23612333430,23612333429,-1,955,1217,0
23612359038,23612359038,0,1166,1639,0
23612372598,23612372598,0,216,189,0
23613388019,23613388021,2,1449,1627,0
23614201778,23614201777,-1,1067,1540,0
23614357658,23614357658,0,1582,1485,0
23614567751,23614567743,-8,937,1045,0
23615194558,23615194579,21,1337,2105,0
23619941426,23619941431,5,2384,1825,0
23621089096,23621089095,-1,1541,1469,0
23622079384,23622079386,2,1557,1391,0
23622364050,23622364050,0,1682,2516,0
23622703471,23622703471,0,1886,1736,0
23623996836,23623996836,0,1740,2360,0
23625461211,23625461213,2,1653,1308,0
23627846101,23627846102,1,1382,1709,0
23627932487,23627932487,0,1398,1545,0
23630164658,23630164658,0,1112,1215,0
23635878883,23635878891,8,3250,992,0
23641429696,23641429698,2,1582,1393,0
23643198494,23643198497,3,1675,2331,0
23648977799,23648977798,-1,1462,1760,0
23652508883,23652508883,0,1294,1390,0
23657649217,23657649217,0,1217,1801,0
23660157839,23660157837,-2,1087,2095,0
23661280409,23661280409,0,1859,2093,0
23661815845,23661815846,1,1507,1156,0
23663424494,23663424494,0,1151,1657,0
23665569798,23665569799,1,1182,2160,0
23670790665,23670790665,0,1378,1896,0
23672091546,23672091546,0,1335,2472,0
23672397470,23672397469,-1,1388,1634,0
23672883282,23672883283,1,1046,1387,0
23675179646,23675179647,1,1313,1756,0
23675665444,23675665446,2,1182,1633,0
23676010204,23676010206,2,1249,2023,0
23682085036,23682085035,-1,1593,1778,0
23684340941,23684340941,0,839,1446,0
23684919487,23684919485,-2,1371,1672,0
23685884526,23685884527,1,1430,1329,0
23692162206,23692162207,1,1820,1850,0
23692679909,23692679909,0,1503,1815,0
23694069049,23694069049,0,1775,2875,0
23695336937,23695336939,2,1258,1151,0
23697881345,23697881341,-4,951,1768,0
23700232038,23700232038,0,1343,2127,0
23703434508,23703434508,0,1397,1718,0
23704323251,23704323254,3,1570,1714,0
23704842774,23704842774,0,1399,1611,0
23704935865,23704935866,1,1211,1709,0
23710438395,23710438396,1,2005,2279,0
23717331512,23717331510,-2,1150,2015,0
23718559448,23718559450,2,1086,1316,0
23720032914,23720032913,-1,1385,1601,0
23720291856,23720291854,-2,1371,1863,0
23723464006,23723464019,13,1189,1465,0
23725929502,23725929504,2,1603,2142,0
23728082601,23728082602,1,977,1813,0
23735782218,23735782219,1,1551,2115,0
23739009187,23739009185,-2,2062,2092,0
23740114367,23740114367,0,1166,1542,0
23741373395,23741373394,-1,976,2005,0
23741982088,23741982087,-1,1489,2839,0
23744713150,23744713154,4,48334,33228,0
23745731914,23745731916,2,1187,2162,0
23746066041,23746066042,1,2881,3403,0
23746319255,23746319256,1,1599,1706,0
23746818646,23746818646,0,1577,1667,0
23747037795,23747037795,0,1468,1376,0
23749049742,23749049745,3,2064,1822,0
23749094334,23749094334,0,1166,1358,0
23749635270,23749635270,0,1175,1569,0
23751183693,23751183691,-2,1329,2485,0
23751834650,23751834650,0,1662,1363,0
23752690571,23752690558,-13,586,254,0
23758869074,23758869070,-4,3420,7238,0
23759900594,23759900595,1,779,1227,0
23766235406,23766235407,1,1357,1333,0
23767109159,23767109160,1,1806,2244,0
23768717144,23768717145,1,1558,1608,0
23768791410,23768791420,10,1768,1162,0
23769055594,23769055594,0,1960,2437,0
23775018814,23775018814,0,1070,1610,0
23775316873,23775316875,2,1269,1765,0
23782067632,23782067632,0,1232,1509,0
23784045383,23784045377,-6,1974,7528,0
23786572975,23786572977,2,1705,1654,0
23787692895,23787692894,-1,1263,1698,0
23788246027,23788246026,-1,1188,1134,0
23789030170,23789030170,0,1835,2021,0
23794535090,23794535092,2,541,360,0
23795511095,23795511094,-1,1391,1376,0
23797686735,23797686735,0,1280,1423,0
23797855495,23797855495,0,1282,1635,0
23800768065,23800768066,1,1570,2050,0
23802214990,23802214991,1,1491,1608,0
23802464465,23802464466,1,603,1172,0
23810990900,23810990901,1,3343,4233,0
23813345664,23813345666,2,1242,1408,0
23814667996,23814667997,1,2129,2240,0
23814810882,23814810882,0,1563,1628,0
23816391754,23816391753,-1,1548,1668,0
23817844750,23817844751,1,1576,2302,0
23818481537,23818481539,2,2141,1824,0
23821818930,23821818930,0,1000,1204,0
23822153241,23822153241,0,1211,1348,0
23825085373,23825085372,-1,1760,2359,0
23827991245,23827991245,0,1166,1703,0
23828450002,23828450001,-1,1481,1761,0
23838011417,23838011419,2,1655,2098,0
23841278149,23841278147,-2,1896,2003,0
23841867612,23841867613,1,1186,1259,0
23842209819,23842209827,8,11727,26654,0
23842338367,23842338371,4,1868,1499,0
23847649521,23847649527,6,2815,1527,0
23849740908,23849740910,2,1168,1358,0
23850669339,23850669340,1,1227,1059,0
23853710374,23853710376,2,1408,1766,0
23855544033,23855544034,1,1591,1603,0
23855793649,23855793650,1,1454,1367,0
23857780652,23857780658,6,7219,2927,0
23859313024,23859313022,-2,830,1862,0
23859992664,23859992664,0,1813,2492,0
23860880555,23860880555,0,1282,1871,0
23866538882,23866538883,1,1074,1878,0
23867325202,23867325196,-6,1013,3576,0
23867903731,23867903730,-1,1317,1296,0
23868519489,23868519486,-3,1376,2558,0
23869129210,23869129210,0,1137,1335,0
23871228741,23871228742,1,1394,1692,0
23871299217,23871299223,6,2933,1285,0
23872812431,23872812430,-1,1207,1377,0
23873548558,23873548558,0,1903,1892,0
23874077224,23874077223,-1,1576,1887,0
23875399205,23875399204,-1,1396,1535,0
23878791728,23878791729,1,1339,2381,0
23881481821,23881481822,1,1164,1934,0
23881680714,23881680716,2,1216,1299,0
23882258344,23882258346,2,1243,2258,0
23883713202,23883713203,1,1275,1757,0
23886507875,23886507873,-2,1476,1219,0
23887860260,23887860261,1,1261,1937,0
23887998915,23887998915,0,1397,1835,0
23889228090,23889228078,-12,1086,1336,0
23891145428,23891145429,1,1224,2052,0
23894562479,23894562477,-2,1471,1605,0
23896047243,23896047243,0,934,1534,0
23896210902,23896210901,-1,1656,1384,0
23902941543,23902941539,-4,1071,3016,0
23904636523,23904636524,1,1836,1992,0
23907822571,23907822571,0,1729,1865,0
23912571600,23912571605,5,2532,1547,0
23913062553,23913062553,0,1771,1990,0
23913977982,23913977981,-1,1560,1695,0
23917160814,23917160815,1,1419,2011,0
23919528079,23919528078,-1,2184,2503,0
23919956326,23919956327,1,866,1656,0
23921645773,23921645774,1,1016,1514,0
23923733645,23923733645,0,1672,2965,0
23924815418,23924815418,0,1729,2230,0
23925229526,23925229526,0,1436,1100,0
23928068839,23928068839,0,1117,1800,0
23929411465,23929411466,1,536,1070,0
23932603535,23932603536,1,1995,2520,0
23932735097,23932735098,1,1582,1495,0
23934567129,23934567120,-9,1321,2281,0
23934629981,23934629975,-6,898,2120,0
23938522269,23938522270,1,1224,1401,0
23941449063,23941449069,6,4932,2520,0
23941577208,23941577208,0,1235,1579,0
23943356351,23943356350,-1,1123,1720,0
23951710190,23951710191,1,702,926,0
23953177834,23953177835,1,1205,1648,0
23954328519,23954328518,-1,787,1855,0
23956415768,23956415767,-1,1205,2111,0
23958099275,23958099274,-1,1108,1581,0
23958258919,23958258923,4,981,1570,0
23958347310,23958347321,11,474,2859,0
23963198045,23963198047,2,1157,1046,0
23964007489,23964007489,0,1180,1830,0
23965593529,23965593529,0,1411,1933,0
23976784461,23976784459,-2,1333,1301,0
23978304595,23978304596,1,1192,1544,0
23979295449,23979295447,-2,1346,1358,0
23981253970,23981253971,1,842,1237,0
23984610343,23984610343,0,1396,1220,0
23984662606,23984662609,3,1451,1568,0
23985064054,23985064074,20,1897,2404,0
23986083513,23986083524,11,1450,1626,0
23988085165,23988085163,-2,1478,1436,0
23988386191,23988386189,-2,677,1667,0
23988580283,23988580282,-1,1297,1512,0
23989028459,23989028460,1,1085,1460,0
23990468290,23990468291,1,1107,1742,0
23996350777,23996350779,2,1080,1855,0
23997537609,23997537610,1,1669,1826,0
24002813146,24002813145,-1,1303,1932,0
24006447217,24006447214,-3,1314,2559,0
24010401290,24010401290,0,1572,1737,0
24014232490,24014232490,0,1252,1279,0
24017077874,24017077874,0,1396,1749,0
24019481508,24019481508,0,245,71,0
24022700523,24022700523,0,1445,2132,0
24026443661,24026443661,0,1363,1668,0
24029338319,24029338319,0,1229,1117,0
24029713114,24029713125,11,1325,1779,0
24033820987,24033820985,-2,1291,2222,0
24035447677,24035447677,0,1083,863,0
24037140471,24037140473,2,1986,1390,0
24038510822,24038510822,0,1084,1573,0
24043318515,24043318516,1,1389,1977,0
24044048314,24044048314,0,837,1397,0
24045293097,24045293119,22,456,329,0
24046393487,24046393485,-2,925,1048,0
24050309287,24050309287,0,1249,1184,0
24051847267,24051847271,4,1021,1071,0
24055767900,24055767901,1,1382,1445,0
24057165441,24057165442,1,1152,1441,0
24057601714,24057601715,1,1665,2225,0
24064636825,24064636825,0,1319,1765,0
24069835734,24069835735,1,1209,1870,0
24070198980,24070198981,1,2198,2240,0
24070752776,24070752778,2,1211,1919,0
24074850983,24074850984,1,1687,2337,0
24077026670,24077026671,1,1207,1192,0
24078239138,24078239138,0,1758,2210,0
24080782132,24080782133,1,1733,1956,0
24085924424,24085924422,-2,1571,2857,0
24086117178,24086117174,-4,24355,11683,0
24086161498,24086161498,0,1657,1528,0
24091658759,24091658759,0,838,1522,0
24092723221,24092723222,1,2062,1515,0
24095009490,24095009491,1,2059,1851,0
24096677708,24096677709,1,1644,1286,0
24104075730,24104075730,0,1530,1247,0
24107384858,24107384858,0,1316,1551,0
24107856553,24107856554,1,1421,1646,0
24109072890,24109072890,0,1485,2003,0
24110307787,24110307785,-2,1367,2618,0
24110747830,24110747834,4,1706,974,0
24116243841,24116243842,1,2021,2200,0
24117096558,24117096560,2,977,1746,0
24117271014,24117271014,0,1209,1509,0
24119149143,24119149143,0,1223,1857,0
24119607239,24119607237,-2,1195,3071,0
24121490177,24121490179,2,1407,1649,0
24124507897,24124507880,-17,708,604,0
24126011708,24126011708,0,17342,13325,0
24126480722,24126480723,1,1309,1590,0
24132400006,24132400006,0,1145,2299,0
24133355825,24133355828,3,1262,1173,0
24136447354,24136447352,-2,761,1857,0
24137340071,24137340073,2,1150,1422,0
24138843701,24138843699,-2,1312,1978,0
24139155069,24139155070,1,1243,1326,0
24140244582,24140244581,-1,624,1193,0
24147050333,24147050332,-1,1637,1553,0
24151109933,24151109935,2,1106,1372,0
24152948373,24152948369,-4,963,2515,0
24156561775,24156561774,-1,1041,2436,0
24161486111,24161486115,4,3810,2917,0
24163080055,24163080052,-3,880,2122,0
24164280082,24164280074,-8,1535,4967,0
24165713433,24165713434,1,988,1516,0
24166380582,24166380584,2,1322,1137,0
24166707919,24166707917,-2,1326,1894,0
24168450665,24168450666,1,1504,1161,0
24170795635,24170795634,-1,1125,1393,0
24171329865,24171329864,-1,1897,2293,0
24174628800,24174628799,-1,1183,1335,0
24178075001,24178075001,0,1043,1174,0
24179980544,24179980543,-1,1401,1494,0
24184974129,24184974129,0,1359,1236,0
24188967586,24188967586,0,1677,1641,0
24189176506,24189176506,0,1096,1706,0
24189459950,24189459953,3,1354,1973,0
24194572318,24194572320,2,1772,1855,0
24196159207,24196159208,1,1214,1144,0
24196913602,24196913605,3,1080,1326,0
24197001853,24197001847,-6,1225,1706,0
24197378010,24197378010,0,1271,2010,0
24198570484,24198570482,-2,1632,2027,0
24201194278,24201194278,0,1325,831,0
24205546477,24205546477,0,1253,1438,0
24205906722,24205906721,-1,1155,1544,0
24207944749,24207944748,-1,1474,1973,0
24212916055,24212916054,-1,1037,1406,0
24214186634,24214186635,1,1866,1864,0
24215039390,24215039394,4,1188,1042,0
24216820479,24216820478,-1,1233,1392,0
24219187317,24219187317,0,1670,1851,0
24220576737,24220576738,1,1733,2165,0
24220618243,24220618246,3,1109,1190,0
24227140279,24227140277,-2,1195,2325,0
24228548669,24228548669,0,783,1194,0
24230529409,24230529410,1,1237,862,0
24231144955,24231144958,3,1334,2009,0
24232692514,24232692514,0,1266,1554,0
24233997477,24233997478,1,1869,2126,0
24235995701,24235995701,0,1623,1963,0
24237189115,24237189114,-1,2133,2074,0
24237836971,24237836973,2,1505,1778,0
24247211938,24247211933,-5,28614,4634,0
24247275383,24247275381,-2,1530,2699,0
24250916158,24250916156,-2,1162,1976,0
24252702602,24252702616,14,13643,51628,0
24253351346,24253351346,0,1204,1760,0
24254016602,24254016603,1,1658,2061,0
24256271966,24256271963,-3,1269,2022,0
24258780014,24258780015,1,1283,1546,0
24262343680,24262343680,0,1110,1429,0
24264751476,24264751480,4,2262,1977,0
24265000894,24265000896,2,1587,1490,0
24270370159,24270370159,0,618,943,0
24279328004,24279328002,-2,2010,1891,0
24280729909,24280729909,0,2036,2070,0
24281348229,24281348230,1,1671,2557,0
24282889062,24282889062,0,1559,1914,0
24284700239,24284700241,2,1089,1031,0
24284951482,24284951492,10,1258,1314,0
24286095842,24286095845,3,1446,1298,0
24288669742,24288669743,1,663,943,0
24289734715,24289734716,1,1250,1568,0
24291039710,24291039711,1,1325,2176,0
24291582170,24291582171,1,924,1374,0
24292497391,24292497391,0,1416,2876,0
24293266323,24293266323,0,1008,1302,0
24295778914,24295778895,-19,1293,1914,0
24299436374,24299436374,0,1867,2105,0
24299771454,24299771453,-1,1329,1547,0
24303081110,24303081112,2,1696,2142,0
24307959534,24307959534,0,1623,1771,0
24310366468,24310366470,2,1878,2592,0
24312741355,24312741353,-2,1194,1247,0
24316153794,24316153794,0,1183,1237,0
24316815513,24316815521,8,2818,1617,0
24317064599,24317064606,7,2972,1240,0
24323287338,24323287341,3,1167,1278,0
24325171738,24325171739,1,1214,1734,0
24325282326,24325282327,1,1708,1612,0
24327887558,24327887558,0,1511,2348,0
24329520757,24329520757,0,1782,1587,0
24329996274,24329996274,0,1178,1522,0
24334237255,24334237254,-1,1529,1692,0
24335590963,24335590963,0,988,1314,0
24338065957,24338065957,0,1069,1532,0
24340365399,24340365402,3,1532,1530,0
24341309926,24341309927,1,1423,1796,0
24346259367,24346259368,1,1354,1907,0
24348008173,24348008175,2,1270,1138,0
24348084612,24348084634,22,1219,2063,0
24348498027,24348498023,-4,1037,1776,0
24349237433,24349237435,2,1031,1355,0
24352563202,24352563204,2,1528,1454,0
24353058970,24353058971,1,1575,1413,0
24353452601,24353452601,0,1389,2531,0
24353948954,24353948957,3,1890,1577,0
24356305025,24356305025,0,1130,1529,0
24358155897,24358155894,-3,2477,5453,0
24358631251,24358631252,1,1325,1278,0
24360353389,24360353390,1,1579,1503,0
24362720879,24362720878,-1,1604,1594,0
24367246130,24367246124,-6,771,3231,0
24369622502,24369622504,2,909,1647,0
24371634459,24371634462,3,1281,1462,0
24375857909,24375857917,8,13964,10989,0
24379922090,24379922090,0,1415,1943,0
24386242503,24386242498,-5,726,1936,0
24394624381,24394624379,-2,1017,2004,0
24394770095,24394770097,2,1358,1571,0
24395958359,24395958358,-1,939,1598,0
24398591171,24398591174,3,1622,1518,0
24399170435,24399170435,0,1618,1244,0
24402629064,24402629065,1,1472,2031,0
24405418784,24405418783,-1,966,1665,0
24405450439,24405450426,-13,866,1199,0
24407728232,24407728233,1,1742,1846,0
24410504655,24410504655,0,776,1122,0
24411455046,24411455047,1,1799,1662,0
24412017214,24412017214,0,1355,1824,0
24420355033,24420355033,0,1630,2143,0
24420454919,24420454918,-1,1225,1802,0
24421454195,24421454197,2,1514,1504,0
24428089846,24428089845,-1,1057,1632,0
24428877839,24428877839,0,1194,1771,0
24432300567,24432300569,2,1521,2100,0
24434673848,24434673850,2,1279,1702,0
24437407838,24437407838,0,2165,2137,0
24437825219,24437825218,-1,845,1655,0
24438996097,24438996097,0,1353,1901,0
24440460001,24440460001,0,1150,1788,0
24442741526,24442741529,3,1886,1572,0
24444669577,24444669579,2,1262,1344,0
24445461255,24445461255,0,2867,3467,0
24448198323,24448198326,3,1104,1664,0
24450226310,24450226313,3,1007,1215,0
24455565910,24455565917,7,1473,1579,0
24456712662,24456712665,3,1591,1926,0
24456873575,24456873574,-1,1177,1772,0
24457796982,24457796982,0,1593,1931,0
24457990311,24457990311,0,1664,2045,0
24461186771,24461186771,0,574,1380,0
24462807698,24462807699,1,2017,1962,0
24463468675,24463468673,-2,938,2716,0
24466967482,24466967481,-1,1491,2115,0
24469614335,24469614336,1,1197,1134,0
24471700321,24471700323,2,1163,1423,0
24473238433,24473238434,1,1383,1334,0
24478144956,24478144956,0,1358,1730,0
24478509195,24478509196,1,1219,1580,0
24479284789,24479284789,0,1113,1299,0
24480244878,24480244878,0,1366,1956,0
24483624798,24483624798,0,967,905,0
24485935083,24485935084,1,1348,1686,0
24486869668,24486869675,7,1612,1413,0
24491571906,24491571916,10,1079,1644,0
24492363431,24492363432,1,2028,1761,0
24497094053,24497094051,-2,910,1741,0
24498281416,24498281415,-1,2177,2167,0
24499935191,24499935190,-1,1310,1456,0
24503909546,24503909545,-1,1467,1588,0
24507587662,24507587662,0,1423,1623,0
24508127806,24508127806,0,1395,1568,0
24508242043,24508242043,0,1879,1905,0
24508405121,24508405118,-3,663,941,0
24512120386,24512120388,2,1562,1830,0
24516094925,24516094926,1,1019,1420,0
24520162317,24520162316,-1,1183,1847,0
24520554164,24520554164,0,27126,37344,0
24521406577,24521406578,1,1109,1981,0
24522391266,24522391267,1,1262,1202,0
24523111779,24523111760,-19,1292,1712,0
24524722954,24524722955,1,2031,1793,0
24525090431,24525090423,-8,1357,2344,0
24527081254,24527081255,1,1090,1761,0
24529156936,24529156936,0,1262,1260,0
24531294708,24531294706,-2,1724,2584,0
24537386391,24537386392,1,1077,2019,0
24538563514,24538563514,0,1455,1569,0
24540246937,24540246938,1,1439,2111,0
24540478874,24540478875,1,1536,1584,0
24542874647,24542874650,3,1794,1733,0
24544484158,24544484158,0,1237,1565,0
24544601541,24544601558,17,902,962,0
24545221115,24545221115,0,1678,3259,0
24546791922,24546791922,0,1718,2211,0
24549305981,24549305981,0,1456,1376,0
24553741939,24553741939,0,1149,1906,0
24554475562,24554475563,1,843,1051,0
24558873445,24558873446,1,1151,1614,0
24559032182,24559032182,0,1534,2122,0
24559188855,24559188854,-1,1627,1710,0
24561903587,24561903585,-2,1160,2234,0
24563443471,24563443471,0,1161,1463,0
24569399003,24569399009,6,2274,1316,0
24570738258,24570738258,0,1411,1618,0
24572492867,24572492870,3,1136,1513,0
24572989609,24572989609,0,1038,1913,0
24574192047,24574192046,-1,1157,1373,0
24577741131,24577741131,0,1894,2053,0
24577943533,24577943534,1,1059,1759,0
24578431388,24578431387,-1,1355,1357,0
24580810024,24580810025,1,2178,1730,0
24582719704,24582719704,0,1424,1906,0
24583190011,24583190015,4,1210,916,0
24584572103,24584572105,2,1134,1815,0
24588036884,24588036885,1,1488,1317,0
24589424320,24589424327,7,3280,1845,0
24590025046,24590025043,-3,952,2628,0
24590444045,24590444046,1,1253,2285,0
24593292352,24593292350,-2,1096,1413,0
24593600048,24593600048,0,1759,1889,0
24597196802,24597196798,-4,915,1287,0
24598242606,24598242605,-1,2082,1989,0
24598627658,24598627659,1,1253,2285,0
24599304874,24599304873,-1,1335,1722,0
24599379417,24599379418,1,1338,1004,0
24601476770,24601476771,1,1070,1113,0
24604915128,24604915128,0,1265,2094,0
24606932556,24606932557,1,1284,1262,0
24607591969,24607591967,-2,1171,1569,0
24609202516,24609202514,-2,1274,1466,0
24610759447,24610759447,0,914,1825,0
24617586094,24617586094,0,1149,1551,0
24618110590,24618110590,0,1383,1424,0
24618853948,24618853948,0,876,1412,0
24619267012,24619267013,1,1244,1668,0
24620940447,24620940448,1,1077,1398,0
24628277547,24628277559,12,1611,1581,0
24629317185,24629317185,0,1723,1838,0
24630787177,24630787174,-3,1222,2220,0
24634213015,24634213015,0,1305,1075,0
24635151349,24635151347,-2,997,1022,0
24638200683,24638200682,-1,1110,1524,0
24640764979,24640764979,0,1842,1957,0
24640904388,24640904383,-5,27610,13697,0
24641185883,24641185885,2,852,1264,0
24642345855,24642345855,0,1306,1745,0
24642639454,24642639451,-3,1798,1803,0
24645142262,24645142267,5,1072,765,0
24648970306,24648970307,1,1098,1218,0
24650653207,24650653207,0,1590,1405,0
24655661266,24655661266,0,956,1229,0
24657781973,24657781975,2,1049,1443,0
24659198726,24659198727,1,1150,1497,0
24660086354,24660086353,-1,1067,1363,0
24661459066,24661459066,0,1313,1320,0
24664905814,24664905814,0,1704,1857,0
24669720857,24669720855,-2,1705,1490,0
24672211538,24672211516,-22,1678,1599,0
24677322878,24677322880,2,1578,1764,0
24677629527,24677629531,4,1205,1802,0
24678745939,24678745939,0,2070,2067,0
24678789336,24678789337,1,1807,2125,0
24679075890,24679075891,1,1290,1494,0
24685121138,24685121139,1,1191,1614,0
24686654605,24686654604,-1,1761,1617,0
24688616367,24688616365,-2,928,1607,0
24689195274,24689195274,0,1239,2095,0
24694031420,24694031426,6,26437,27390,0
24694658763,24694658765,2,1512,1314,0
24695954152,24695954151,-1,1147,1089,0
24697365031,24697365029,-2,865,2749,0
24698654879,24698654879,0,1418,2109,0
24698894759,24698894761,2,1815,1308,0
24699278151,24699278151,0,949,1123,0
24699705614,24699705614,0,1366,1401,0
24701066997,24701066998,1,1880,1550,0
24702535599,24702535602,3,1663,1653,0
24702738212,24702738229,17,1248,1221,0
24703635249,24703635251,2,1050,1053,0
24706227849,24706227847,-2,1301,1869,0
24707347242,24707347242,0,1021,1388,0
24711100401,24711100399,-2,1311,2114,0
24711441735,24711441737,2,1277,1291,0
24714838524,24714838522,-2,1101,1156,0
24718713115,24718713113,-2,1023,1382,0
24720931978,24720931978,0,1348,1699,0
24722961558,24722961559,1,627,708,0
24723922311,24723922311,0,1249,1898,0
24724534481,24724534482,1,2048,1498,0
24724619231,24724619230,-1,1767,1971,0
24725119767,24725119770,3,6563,23262,0
24725229702,24725229702,0,1405,1100,0
24725450957,24725450957,0,1663,2244,0
24730236589,24730236586,-3,1262,1469,0
24733537986,24733537987,1,1356,1811,0
24733725711,24733725713,2,1784,1948,0
24734646302,24734646303,1,1254,1255,0
24735686841,24735686845,4,1071,1504,0
24736727056,24736727054,-2,1332,1405,0
24740255569,24740255570,1,1349,1567,0
24740317261,24740317261,0,1408,1885,0
24741473731,24741473731,0,1254,1128,0
24741785749,24741785769,20,1088,1932,0
24741814699,24741814700,1,1325,930,0
24742953001,24742953002,1,1903,1872,0
24744086014,24744086014,0,1061,1472,0
24747147806,24747147807,1,1359,1534,0
24748086176,24748086175,-1,1772,1597,0
24748113145,24748113144,-1,1589,1209,0
24753103852,24753103852,0,1503,2168,0
24753569819,24753569820,1,1141,1566,0
24754088013,24754088013,0,1179,2014,0
24756177293,24756177295,2,1096,1019,0
24757362617,24757362615,-2,1320,1571,0
24758279775,24758279771,-4,26774,12178,0
24758960751,24758960752,1,1218,1398,0
24759289110,24759289111,1,1252,1203,0
24761780482,24761780482,0,1132,2152,0
24766137466,24766137471,5,957,1335,0
24767074523,24767074526,3,1570,1904,0
24767373443,24767373446,3,1702,1671,0
24771516473,24771516473,0,1288,2587,0
24772229898,24772229897,-1,1359,1919,0
24772847295,24772847294,-1,1136,1357,0
24785323636,24785323636,0,1214,1691,0
24786428189,24786428187,-2,1068,1813,0
24786863662,24786863662,0,1397,1637,0
24786920719,24786920720,1,2038,2311,0
24791716197,24791716198,1,1183,1802,0
24795043556,24795043558,2,1279,1625,0
24797407013,24797407012,-1,1235,1207,0
24802585390,24802585389,-1,1278,1979,0
24806134343,24806134345,2,1437,1680,0
24806471306,24806471306,0,877,1642,0
24806605551,24806605554,3,2079,1640,0
24806699343,24806699346,3,1166,1449,0
24809098394,24809098395,1,1728,2101,0
24815676893,24815676898,5,13728,25490,0
24816404674,24816404675,1,1539,1540,0
24821667486,24821667487,1,1938,1429,0
24821799699,24821799700,1,1841,2496,0
24829812974,24829812975,1,1524,1507,0
24834229326,24834229326,0,1215,1212,0
24835043457,24835043455,-2,1389,1806,0
24837701367,24837701369,2,1262,1723,0
24839401001,24839401001,0,1127,1519,0
24844154688,24844154689,1,1395,2040,0
24844773530,24844773533,3,1686,1549,0
24849014066,24849014068,2,1377,2009,0
24850683829,24850683829,0,1394,1474,0
24852822840,24852822840,0,1458,1921,0
24854431743,24854431746,3,1872,2113,0
24856906467,24856906469,2,1813,2050,0
24859988283,24859988284,1,723,995,0
24865187531,24865187533,2,1818,1935,0
24865369421,24865369422,1,1702,1329,0
24867160375,24867160373,-2,734,1473,0
24868215768,24868215768,0,1563,1166,0
24871269609,24871269609,0,1419,1695,0
24872736395,24872736397,2,1793,1459,0
24872813210,24872813212,2,1428,1800,0
24874711951,24874711951,0,1296,1497,0
24875815546,24875815547,1,1101,1527,0
24882000172,24882000171,-1,1469,1710,0
24882793399,24882793398,-1,753,1231,0
24883460811,24883460808,-3,673,2022,0
24889664223,24889664223,0,1799,1742,0
24892300471,24892300471,0,1493,1531,0
24892749154,24892749154,0,1337,2166,0
24893043510,24893043502,-8,1439,1771,0
24893560402,24893560405,3,1794,1847,0
24897982607,24897982599,-8,1072,1811,0
24899627719,24899627722,3,3178,3571,0
24903179096,24903179096,0,1263,1555,0
24904541139,24904541138,-1,1109,1451,0
24905017588,24905017589,1,2099,2050,0
24906759009,24906759001,-8,1031,6659,0
24907043500,24907043501,1,848,1181,0
24907784086,24907784094,8,1391,1512,0
24910281036,24910281037,1,1971,2140,0
24911214542,24911214541,-1,1457,2304,0
24922117378,24922117378,0,2148,4553,0
24922463733,24922463733,0,1718,1667,0
24923570927,24923570927,0,1500,2432,0
24926959578,24926959578,0,1324,1814,0
24927286334,24927286318,-16,1480,2284,0
24927343287,24927343279,-8,735,1332,0
24930365505,24930365505,0,1472,2016,0
24932740778,24932740778,0,1737,1538,0
24933146670,24933146670,0,1413,1397,0
24935363147,24935363146,-1,1584,2567,0
24935553438,24935553437,-1,1026,981,0
24936621434,24936621436,2,2049,2104,0
24937352858,24937352863,5,2832,1268,0
24938647034,24938647035,1,1254,1329,0
24940635105,24940635103,-2,1481,1948,0
24940827833,24940827833,0,1183,979,0
24944816461,24944816462,1,1512,1939,0
24946002215,24946002216,1,1642,2194,0
24948772746,24948772746,0,1672,2576,0
24950030249,24950030249,0,1760,1657,0
24952364566,24952364566,0,1553,1698,0
24952851932,24952851930,-2,2036,2839,0
24955435023,24955435026,3,1272,1269,0
24963157585,24963157587,2,1801,2099,0
24969797268,24969797267,-1,1566,1633,0
24970743181,24970743182,1,2131,1716,0
24971687398,24971687398,0,1458,1607,0
24972079742,24972079743,1,1466,1592,0
24972658414,24972658415,1,1422,1313,0
24973953725,24973953727,2,1418,1091,0
24977599453,24977599454,1,2066,2542,0
24978274108,24978274110,2,1716,1617,0
24980120896,24980120897,1,1642,2204,0
24980708578,24980708578,0,1407,1555,0
24980943309,24980943312,3,2072,2126,0
24984175791,24984175794,3,2464,2530,0
24985894827,24985894827,0,1560,1831,0
24987719825,24987719826,1,852,1441,0
24988738982,24988738981,-1,1175,1237,0
24990134980,24990134986,6,2049,1180,0
24994778198,24994778199,1,1814,1707,0
24995172463,24995172461,-2,775,2152,0
24999411060,24999411058,-2,1719,1671,0
25002240929,25002240929,0,1491,1455,0
25005091573,25005091575,2,1397,1239,0
25005203906,25005203906,0,1485,1349,0
25007905154,25007905154,0,1560,1504,0
25009941140,25009941138,-2,986,1271,0
25013135191,25013135192,1,1472,1515,0
25014532166,25014532166,0,1413,1220,0
25016762777,25016762778,1,1834,2360,0
25024474676,25024474676,0,1473,1684,0
25024640650,25024640650,0,1013,1603,0
25025235485,25025235487,2,1599,1390,0
25026063227,25026063231,4,1863,1607,0
25027818718,25027818720,2,787,1163,0
25029639526,25029639529,3,23329,19486,0
25032719765,25032719767,2,1690,1630,0
25035795267,25035795266,-1,1635,2056,0
25037323406,25037323408,2,1387,2136,0
25038005701,25038005687,-14,1235,1232,0
25039713385,25039713383,-2,1786,1830,0
25041142291,25041142291,0,1057,1760,0
25042421406,25042421406,0,1865,1498,0
25044373517,25044373517,0,1003,1016,0
25045756001,25045756003,2,1310,1493,0
25049331070,25049331072,2,1515,1617,0
25051565725,25051565725,0,1445,1477,0
25053471738,25053471738,0,1629,2820,0
25054814052,25054814051,-1,1274,1740,0
25055132830,25055132830,0,1408,1582,0
25056652465,25056652467,2,1350,1510,0
25058538608,25058538608,0,1766,1876,0
25059264461,25059264461,0,1671,2698,0
25059670338,25059670342,4,2243,1183,0
25061000711,25061000704,-7,3518,13908,0
25061160006,25061160006,0,1255,1826,0
25062174101,25062174094,-7,868,3582,0
25064657574,25064657577,3,1239,1395,0
25068020594,25068020594,0,1179,1419,0
25070508003,25070508005,2,1635,1327,0
25071379829,25071379829,0,2082,1878,0
25072028786,25072028785,-1,1451,2393,0
25072415279,25072415278,-1,1138,1625,0
25078569193,25078569193,0,1320,1742,0
25082583649,25082583651,2,1482,1501,0
25084335090,25084335088,-2,1454,1599,0
25086759005,25086759003,-2,1269,1904,0
25090810606,25090810605,-1,1746,1652,0
25092602305,25092602306,1,1494,1743,0
25095096865,25095096867,2,1532,1333,0
25095493587,25095493588,1,1393,1677,0
25096480550,25096480551,1,1478,1303,0
25096620075,25096620075,0,1164,1737,0
25101123153,25101123155,2,1382,1600,0
25102270283,25102270286,3,1053,1423,0
25104484350,25104484350,0,1286,1768,0
25104763088,25104763087,-1,1318,1677,0
25109588237,25109588236,-1,1528,1894,0
25111168848,25111168852,4,1693,1922,0
25113306698,25113306696,-2,1116,2262,0
25116402010,25116402011,1,1330,1480,0
25118014943,25118014943,0,1570,1667,0
25118129006,25118129007,1,873,1177,0
25123765394,25123765394,0,1577,2319,0
25125967926,25125967923,-3,1513,1775,0
25126617730,25126617710,-20,33,1473,0
25127871724,25127871723,-1,1574,1669,0
25133017379,25133017382,3,1708,906,0
25134458094,25134458094,0,826,817,0
25139462494,25139462494,0,1120,876,0
25139536356,25139536357,1,1096,928,0
25141416240,25141416241,1,1517,1441,0
25141443558,25141443575,17,1033,1436,0
25142582013,25142582014,1,2047,2088,0
25144413051,25144413045,-6,817,2895,0
25150456866,25150456867,1,1093,1275,0
25152574683,25152574681,-2,1037,1540,0
25152939401,25152939401,0,1429,2361,0
25153193380,25153193381,1,1948,1429,0
25154992496,25154992498,2,1629,1546,0
25155111100,25155111102,2,1280,1307,0
25155582205,25155582210,5,1628,1303,0
25159625221,25159625222,1,1847,1550,0
25161225027,25161225026,-1,801,1168,0
25165180494,25165180495,1,1411,1717,0
25167712965,25167712966,1,1237,1936,0
25172040206,25172040206,0,1450,1950,0
25176809270,25176809271,1,1373,1132,0
25177067571,25177067570,-1,1112,1279,0
25178587967,25178587966,-1,1758,2033,0
25179520473,25179520475,2,1375,1482,0
25180024906,25180024905,-1,886,1552,0
25180135285,25180135286,1,2393,2223,0
25180245696,25180245700,4,4206,32908,0
25182740011,25182740010,-1,1315,1858,0
25184944003,25184944003,0,1254,1373,0
25187543331,25187543337,6,5007,2728,0
25188295584,25188295586,2,1544,1696,0
25189990998,25189990997,-1,1253,1422,0
25193346802,25193346803,1,1749,1897,0
25195403162,25195403164,2,1248,1376,0
25207405279,25207405281,2,1432,1482,0
25208425558,25208425560,2,1938,2044,0
25209083871,25209083871,0,1359,2014,0
25210052783,25210052782,-1,592,1425,0
25210838703,25210838702,-1,1434,2258,0
25212572777,25212572778,1,2128,1731,0
25213735160,25213735163,3,1941,1531,0
25215956675,25215956674,-1,1628,1356,0
25218565226,25218565225,-1,1242,1673,0
25222234510,25222234511,1,1745,1824,0
25223016234,25223016236,2,778,1678,0
25224203396,25224203394,-2,1641,1484,0
25225692474,25225692476,2,1120,1021,0
25226494407,25226494407,0,1548,1983,0
25227846759,25227846761,2,1619,1490,0
25228100712,25228100713,1,1582,1424,0
25228525634,25228525635,1,1271,1502,0
25233516474,25233516477,3,1709,1907,0
25235978400,25235978401,1,1552,1523,0
25236538726,25236538747,21,491,800,0
25237618461,25237618461,0,1007,1193,0
25239017657,25239017655,-2,1679,2318,0
25241670647,25241670647,0,1107,1183,0
25242945925,25242945925,0,1298,1437,0
25244201818,25244201818,0,1136,1680,0
25249540567,25249540565,-2,970,1188,0
25253236015,25253236013,-2,1818,1574,0
25257079130,25257079129,-1,1565,1787,0
25258486231,25258486233,2,2082,1407,0
25258717370,25258717373,3,1103,1208,0
25259299714,25259299715,1,1263,1162,0
25268149322,25268149321,-1,1156,1552,0
25270372170,25270372166,-4,22317,75778,0
25271171847,25271171847,0,1046,1802,0
25275015149,25275015143,-6,965,1581,0
25276007962,25276007964,2,1393,1838,0
25276723056,25276723057,1,1065,1682,0
25278471885,25278471886,1,1790,1460,0
25282386789,25282386789,0,1380,1093,0
25283558111,25283558111,0,1453,1688,0
25286141984,25286141986,2,1085,1517,0
25289122363,25289122361,-2,1096,1666,0
25289203552,25289203570,18,1128,1475,0
25290406235,25290406237,2,1413,1712,0
25293055194,25293055195,1,1220,1506,0
25297951633,25297951633,0,1367,2414,0
25300081375,25300081374,-1,944,1106,0
25304914938,25304914940,2,1564,1526,0
25305242023,25305242038,15,873,1106,0
25305700351,25305700353,2,981,1581,0
25306689141,25306689141,0,1284,2043,0
25307967140,25307967139,-1,1555,1973,0
25308802783,25308802783,0,738,1394,0
25310400388,25310400389,1,1178,1610,0
25310535007,25310535007,0,1143,1370,0
25311124929,25311124929,0,1533,1855,0
25315168924,25315168923,-1,1442,2009,0
25315552037,25315552038,1,2320,2219,0
25315796822,25315796821,-1,1052,1712,0
25316364824,25316364819,-5,1679,2417,0
25321823386,25321823386,0,1610,2218,0
25323846125,25323846126,1,1025,1002,0
25327272390,25327272389,-1,1409,1522,0
25332504707,25332504709,2,1862,1464,0
25332710433,25332710434,1,1661,1892,0
25335404358,25335404366,8,6449,1691,0
25335489015,25335489017,2,1607,1345,0
25339345094,25339345096,2,1817,1894,0
25339545733,25339545731,-2,1252,1868,0
25339940605,25339940602,-3,994,1781,0
25340015795,25340015794,-1,1432,1685,0
25340299606,25340299606,0,1190,1563,0
25340337851,25340337858,7,5103,1740,0
25341679855,25341679845,-10,38675,15452,0
25343509984,25343509984,0,1282,2521,0
25344723191,25344723192,1,1424,1891,0
25348122786,25348122779,-7,590,155,0
25349469788,25349469789,1,1680,1714,0
25350097963,25350097965,2,1487,1602,0
25352444227,25352444226,-1,1119,1163,0
25355178642,25355178642,0,1787,1920,0
25357015440,25357015445,5,2023,1108,0
25359276418,25359276418,0,921,1442,0
25361877007,25361877002,-5,743,2806,0
25362164817,25362164819,2,1624,1362,0
25364230585,25364230585,0,693,1893,0
25367232119,25367232119,0,2103,2075,0
25370144290,25370144291,1,1358,1395,0
25370186794,25370186795,1,1078,911,0
25370446681,25370446681,0,1549,1401,0
25371696994,25371696993,-1,1934,2074,0
25372960477,25372960482,5,1066,1293,0
25373668401,25373668403,2,1587,1392,0
25379786050,25379786050,0,1558,1323,0
25380067928,25380067930,2,1095,1473,0
25380226089,25380226090,1,1935,3142,0
25380618176,25380618176,0,1730,1876,0
25381000957,25381000958,1,2340,2043,0
25389424726,25389424727,1,1368,1952,0
25391492473,25391492475,2,979,1312,0
25392713771,25392713769,-2,1187,2165,0
25395545681,25395545682,1,1521,1662,0
25398454822,25398454823,1,1360,1569,0
25398693106,25398693117,11,1133,1129,0
25399868886,25399868886,0,727,786,0
25400511932,25400511933,1,1171,1892,0
25401595555,25401595554,-1,1952,2958,0
25401751161,25401751160,-1,1178,1719,0
25404100806,25404100805,-1,836,967,0
25407197265,25407197266,1,1660,2377,0
25407892266,25407892265,-1,1516,1793,0
25408868394,25408868397,3,1185,2070,0
25411648878,25411648876,-2,1234,1700,0
25412296590,25412296591,1,1205,1436,0
25417052689,25417052691,2,1854,1568,0
25420871882,25420871883,1,1735,1469,0
25423186422,25423186418,-4,973,1266,0
25424053855,25424053854,-1,1319,1356,0
25425433411,25425433414,3,1436,2174,0
25426425439,25426425442,3,1766,1658,0
25426500743,25426500742,-1,1172,1918,0
25428482766,25428482765,-1,1116,2004,0
25429438802,25429438801,-1,1664,1685,0
25430406517,25430406513,-4,1878,3080,0
25430609775,25430609777,2,1376,1458,0
25432908601,25432908603,2,1466,1696,0
25436169978,25436169978,0,1388,2039,0
25436592520,25436592521,1,1455,1945,0
25438896698,25438896698,0,1172,1852,0
25441448443,25441448440,-3,1900,3698,0
25446050427,25446050428,1,1310,1795,0
25452111478,25452111479,1,1490,1247,0
25455248293,25455248294,1,1402,1825,0
25459634471,25459634469,-2,964,979,0
25461159422,25461159426,4,1410,1528,0
25461503973,25461503974,1,1683,1606,0
25464162719,25464162722,3,1759,2512,0
25465299545,25465299547,2,2924,1197,0
25466055246,25466055247,1,787,1289,0
25470788360,25470788363,3,1875,1552,0
25470887607,25470887607,0,903,1321,0
25471841977,25471841979,2,1398,1750,0
25473896699,25473896699,0,1893,2248,0
25476178862,25476178863,1,1012,1120,0
25479626780,25479626781,1,1749,1304,0
25483487255,25483487253,-2,1163,1930,0
25484323543,25484323542,-1,1037,2014,0
25487074059,25487074057,-2,1117,2370,0
25488899102,25488899102,0,1224,1841,0
25488945687,25488945691,4,1742,1777,0
25489964771,25489964770,-1,1774,1643,0
25491294605,25491294602,-3,1405,2216,0
25491997460,25491997461,1,1169,1694,0
25492651826,25492651827,1,2165,1914,0
25493644363,25493644367,4,1536,1274,0
25495660579,25495660578,-1,826,1339,0
25496209805,25496209806,1,1394,2047,0
25496733278,25496733278,0,1590,1812,0
25500289754,25500289754,0,1234,2136,0
25500801181,25500801180,-1,1492,1605,0
25501823034,25501823034,0,1266,1817,0
25502373518,25502373502,-16,56,2492,0
25505607983,25505607983,0,1396,1769,0
25509132738,25509132738,0,1350,2115,0
25509750734,25509750735,1,1519,1922,0
25516098643,25516098644,1,1588,1736,0
25517953701,25517953701,0,1321,1430,0
25521193538,25521193538,0,1202,1788,0
25523451096,25523451097,1,1283,1946,0
25524447522,25524447522,0,1444,2321,0
25524640992,25524640991,-1,1641,1254,0
25527456638,25527456647,9,1300,1155,0
25530767903,25530767903,0,1737,1629,0
25533058097,25533058096,-1,1286,2203,0
25534934355,25534934354,-1,1689,1625,0
25539085500,25539085519,19,911,1245,0
25539476178,25539476178,0,1471,1882,0
25539625933,25539625933,0,987,1213,0
25541938088,25541938088,0,1688,1816,0
25545325761,25545325767,6,2962,1194,0
25545513166,25545513165,-1,2060,2405,0
25553485456,25553485454,-2,1380,1587,0
25558750970,25558750970,0,1359,1295,0
25563229225,25563229226,1,1108,1490,0
25563521306,25563521307,1,1059,1389,0
25565871249,25565871258,9,15413,34437,0
25566408190,25566408193,3,1204,1631,0
25566553801,25566553803,2,620,1476,0
25568018706,25568018706,0,915,1323,0
25569277521,25569277522,1,741,1309,0
25570733174,25570733175,1,1275,1687,0
25572161727,25572161728,1,1371,2511,0
25574720580,25574720581,1,1705,1870,0
25576043753,25576043753,0,1278,1622,0
25580460520,25580460520,0,1458,2079,0
25581586061,25581586065,4,1944,1579,0
25585350353,25585350352,-1,1950,1955,0
25589697728,25589697730,2,1801,1979,0
25589890847,25589890847,0,1445,2203,0
25593709626,25593709626,0,1124,1446,0
25594698183,25594698177,-6,1913,7100,0
25595509634,25595509635,1,1485,2014,0
25597693322,25597693323,1,1691,2384,0
25599302769,25599302770,1,2415,2297,0
25599877700,25599877702,2,1079,1861,0
25600848071,25600848068,-3,859,1602,0
25601721677,25601721675,-2,1415,1710,0
25603779719,25603779719,0,1160,1560,0
25603920622,25603920624,2,1726,1900,0
25605541423,25605541423,0,1631,1762,0
25609474772,25609474771,-1,21155,9963,0
25609990970,25609990970,0,896,1332,0
25610557009,25610557009,0,1588,2061,0
25611366438,25611366438,0,1236,1889,0
25614245713,25614245713,0,1292,1651,0
25616679044,25616679043,-1,1562,1560,0
25617972503,25617972503,0,1072,1381,0
25620230329,25620230330,1,1418,1683,0
25620419935,25620419935,0,1264,1739,0
25621389926,25621389926,0,1265,1596,0
25623816649,25623816651,2,1654,1942,0
25624294288,25624294286,-2,1592,2084,0
25624714915,25624714917,2,1852,1892,0
25625358098,25625358100,2,2490,1822,0
25625693562,25625693565,3,3537,2322,0
25629999862,25629999855,-7,708,4503,0
25631771859,25631771857,-2,1180,1885,0
25632907131,25632907130,-1,1615,1967,0
25634035648,25634035647,-1,1764,1341,0
25637089586,25637089585,-1,1506,1976,0
25638743671,25638743674,3,1202,1406,0
25639263498,25639263498,0,1241,1556,0
25639829274,25639829275,1,1296,1908,0
25642488842,25642488846,4,1648,1091,0
25642985092,25642985093,1,1419,1346,0
25647504872,25647504872,0,1080,1412,0
25650146924,25650146925,1,1351,1777,0
25650968017,25650968018,1,1044,1610,0
25653200170,25653200170,0,1717,2189,0
25656322442,25656322442,0,1309,1598,0
25656904833,25656904834,1,1811,1671,0
25657830582,25657830581,-1,36874,16841,0
25659518988,25659519006,18,1873,1391,0
25660447206,25660447221,15,13968,52527,0
25666629947,25666629946,-1,1204,1461,0
25669339533,25669339532,-1,1473,2096,0
25671351935,25671351937,2,1453,1807,0
25671790869,25671790869,0,1778,1537,0
25680641395,25680641394,-1,1352,1500,0
25681097666,25681097665,-1,1502,2015,0
25682227505,25682227504,-1,1323,1429,0
25682926260,25682926241,-19,1145,1464,0
25683497691,25683497691,0,1636,1431,0
25685180231,25685180233,2,2411,2302,0
25688824560,25688824561,1,1717,1993,0
25690298678,25690298686,8,3615,1058,0
25691813147,25691813147,0,1584,1790,0
25692153449,25692153450,1,1426,2313,0
25697422085,25697422086,1,1710,1722,0
25699806594,25699806595,1,1367,1562,0
25702921582,25702921583,1,1258,1439,0
25706305107,25706305106,-1,1417,2421,0
25707020270,25707020268,-2,592,1520,0
25708464509,25708464510,1,1676,1534,0
25709314187,25709314187,0,1254,1687,0
25710508375,25710508378,3,1117,2173,0
25717711756,25717711751,-5,932,1592,0
25718995855,25718995854,-1,899,1728,0
25720676670,25720676669,-1,1674,1489,0
25723979486,25723979487,1,1330,1711,0
25725104527,25725104527,0,1234,1239,0
25727093063,25727093063,0,1267,1224,0
25728859150,25728859152,2,1022,1487,0
25730701018,25730701021,3,1765,2229,0
25734770882,25734770882,0,1396,1789,0
25735084822,25735084818,-4,1382,1468,0
25736014381,25736014381,0,1284,1777,0
25736989110,25736989111,1,2024,2015,0
25739082361,25739082361,0,1680,1992,0
25746422179,25746422182,3,1869,1277,0
25748273442,25748273444,2,2205,1664,0
25748683686,25748683686,0,1666,1746,0
25749368772,25749368770,-2,972,2251,0
25750874399,25750874397,-2,1082,1549,0
25751409059,25751409060,1,1169,1890,0
25755998786,25755998786,0,1552,1864,0
25757231973,25757231975,2,1445,1534,0
25760642114,25760642110,-4,1206,3816,0
25761170553,25761170553,0,951,1672,0
25764892981,25764892980,-1,1555,1927,0
25767524867,25767524865,-2,1720,1923,0
25768217465,25768217465,0,1637,1705,0
25768777458,25768777459,1,1143,1757,0
25768995014,25768995007,-7,1006,1629,0
25772085028,25772085027,-1,1675,1481,0
25772119610,25772119615,5,1845,1542,0
25778294946,25778294945,-1,1127,1180,0
25786927351,25786927351,0,1359,1819,0
25787043405,25787043405,0,1223,1534,0
25791301783,25791301784,1,1486,2180,0
25792575483,25792575485,2,1261,1178,0
25797966937,25797966938,1,1143,1362,0
25800112013,25800112014,1,1715,2000,0
25800663513,25800663512,-1,1515,1881,0
25802927833,25802927836,3,1699,1500,0
25804839322,25804839327,5,5930,3017,0
25806964230,25806964233,3,1558,2050,0
25809935086,25809935086,0,1106,1603,0
25818505323,25818505331,8,13516,24282,0
25820155641,25820155642,1,976,1665,0
25820211536,25820211554,18,41155,17520,0
25822899257,25822899254,-3,1330,1441,0
25823039741,25823039741,0,1158,1997,0
25827299675,25827299674,-1,1200,1158,0
25829514846,25829514850,4,1073,1412,0
25831381069,25831381070,1,1278,2271,0
25835731974,25835731973,-1,1388,2594,0
25842003427,25842003426,-1,773,1809,0
25842516915,25842516910,-5,894,1981,0
25842847414,25842847397,-17,1281,1820,0
25845845584,25845845584,0,1472,1956,0
25847538915,25847538914,-1,1484,1373,0
25847780359,25847780362,3,952,1220,0
25850006526,25850006526,0,3220,3769,0
25850216921,25850216921,0,1355,1787,0
25852122595,25852122595,0,1847,3435,0
25852392565,25852392566,1,1486,1683,0
25852461858,25852461858,0,1319,1885,0
25853890637,25853890640,3,2009,1533,0
25858201914,25858201915,1,1036,1350,0
25860955562,25860955565,3,1019,2191,0
25861742425,25861742426,1,1227,2089,0
25862393412,25862393413,1,1337,1732,0
25862628806,25862628807,1,1168,1469,0
25863749475,25863749474,-1,1166,1587,0
25863995030,25863995031,1,1125,1713,0
25865407271,25865407273,2,33222,31924,0
25867180590,25867180589,-1,1290,1629,0
25870037855,25870037855,0,1128,1911,0
25870477959,25870477957,-2,1924,3973,0
25871194433,25871194434,1,1408,1650,0
25871460418,25871460418,0,1179,1117,0
25872181183,25872181182,-1,1586,1603,0
25873421686,25873421687,1,1535,2173,0
25873708333,25873708335,2,1571,1529,0
25876265195,25876265198,3,1010,1151,0
25879139108,25879139106,-2,1581,2109,0
25881327595,25881327593,-2,1221,2204,0
25885985313,25885985314,1,1268,1088,0
25886754770,25886754769,-1,1620,1619,0
25889743330,25889743331,1,1504,1833,0
25890919997,25890919998,1,1373,1719,0
25892781076,25892781078,2,1649,1503,0
25895963556,25895963556,0,1512,2118,0
25896349985,25896349985,0,1418,1494,0
25896407125,25896407125,0,1574,1397,0
25897533354,25897533372,18,2087,1249,0
25898849511,25898849511,0,1183,947,0
25900295018,25900295019,1,1080,1263,0
25900628359,25900628365,6,12664,36597,0
25901363354,25901363355,1,953,2234,0
25901898766,25901898750,-16,1809,2172,0
25901956490,25901956494,4,897,1087,0
25907251475,25907251475,0,1126,1737,0
25908502386,25908502387,1,1363,1580,0
25914465774,25914465774,0,1608,2130,0
25915012039,25915012045,6,5904,1981,0
25915300045,25915300058,13,10313,43217,0
25917104825,25917104828,3,1536,1437,0
25918695628,25918695629,1,937,1742,0
25922013481,25922013480,-1,1656,2419,0
25924501162,25924501161,-1,2200,2761,0
25924655966,25924655966,0,1454,1856,0
25925975403,25925975401,-2,1262,2362,0
25926477869,25926477868,-1,1111,1462,0
25927514826,25927514825,-1,1207,1595,0
25928459930,25928459930,0,1512,1347,0
25936480878,25936480882,4,1679,1925,0
25937940778,25937940781,3,1403,2227,0
25938402758,25938402759,1,1409,1759,0
25939071502,25939071503,1,577,336,0
25940221489,25940221489,0,1331,1718,0
25940268322,25940268321,-1,1696,1726,0
25940654180,25940654179,-1,1646,1841,0
25952391451,25952391450,-1,2725,4020,0
25952470529,25952470530,1,1275,1402,0
25954465562,25954465569,7,1203,754,0
25957532270,25957532270,0,1122,1620,0
25961963232,25961963232,0,2045,2307,0
25962975521,25962975521,0,1369,1909,0
25963193168,25963193168,0,1829,1523,0
25963665298,25963665294,-4,852,1072,0
25964956516,25964956517,1,1238,1843,0
25967734206,25967734207,1,1741,2059,0
25974752752,25974752752,0,945,1949,0
25977048762,25977048762,0,1357,1689,0
25981230310,25981230313,3,1859,1688,0
25984893857,25984893861,4,7999,5531,0
25985907521,25985907520,-1,1176,1374,0
25990367255,25990367256,1,1628,2238,0
25993315694,25993315694,0,887,1450,0
25996017538,25996017538,0,1587,1825,0
25998784168,25998784169,1,1183,1551,0
26002607797,26002607798,1,2462,2017,0
26004879688,26004879690,2,1023,1576,0
26005788910,26005788909,-1,1456,1556,0
26008264593,26008264595,2,1443,1437,0
26008525347,26008525342,-5,739,4062,0
26008622572,26008622573,1,1077,1995,0
26009924762,26009924762,0,1278,1666,0
26011269170,26011269171,1,765,1605,0
26012160568,26012160569,1,1049,1402,0
26018044701,26018044702,1,1384,2346,0
26020576547,26020576545,-2,1197,1215,0
26022646706,26022646707,1,969,1489,0
26023817105,26023817104,-1,1319,2064,0
26025319905,26025319905,0,1307,1551,0
26026071403,26026071405,2,1844,2750,0
26026263967,26026263967,0,1223,1321,0
26026658447,26026658445,-2,1301,2022,0
26027099350,26027099352,2,1393,2012,0
26031778842,26031778843,1,982,1787,0
26034235428,26034235428,0,1703,2171,0
26034831881,26034831881,0,1965,2187,0
26042215823,26042215824,1,1266,1561,0
26043734162,26043734161,-1,1342,2271,0
26045602073,26045602072,-1,1788,1951,0
26046168850,26046168849,-1,1402,1101,0
26046226823,26046226821,-2,1227,1457,0
26048166270,26048166270,0,1394,1666,0
26049181614,26049181613,-1,1076,2099,0
26050309947,26050309925,-22,983,979,0
26052215782,26052215782,0,1313,2021,0
26056860181,26056860182,1,1123,830,0
26061594533,26061594534,1,1864,1294,0
26064308753,26064308753,0,1223,1156,0
26065415110,26065415111,1,1204,1854,0
26068579875,26068579885,10,9991,44495,0
26068905725,26068905728,3,1436,2017,0
26069188733,26069188734,1,1627,2344,0
26072034166,26072034167,1,1229,1440,0
26072421798,26072421798,0,1867,1857,0
26074917249,26074917250,1,1539,1780,0
26075200854,26075200848,-6,1334,1469,0
26075240716,26075240714,-2,108,2012,0
26077245057,26077245057,0,752,1536,0
26080493887,26080493883,-4,1508,5214,0
26080645118,26080645119,1,1182,1606,0
26083653634,26083653636,2,1560,1321,0
26085485765,26085485764,-1,1309,1793,0
26088754498,26088754497,-1,1344,1797,0
26091517001,26091517002,1,1505,1854,0
26091926337,26091926338,1,1164,1194,0
26094285640,26094285639,-1,1100,1584,0
26095469760,26095469758,-2,1607,1600,0
26096283630,26096283630,0,1419,1843,0
26098643909,26098643909,0,1359,2455,0
26102628806,26102628806,0,1066,1771,0
26106380882,26106380881,-1,910,1770,0
26109509257,26109509260,3,2396,2243,0
26109546586,26109546586,0,1212,1386,0
26117931928,26117931929,1,2000,1997,0
26118945029,26118945030,1,801,1242,0
26123266207,26123266207,0,1828,2386,0
26123524334,26123524334,0,1181,1184,0
26125063930,26125063930,0,1273,1672,0
26125552734,26125552734,0,1219,1371,0
26126336759,26126336758,-1,774,1076,0
26127008266,26127008268,2,1759,1662,0
26128429270,26128429270,0,773,861,0
26129739833,26129739834,1,1449,1656,0
26131369134,26131369134,0,857,1512,0
26133147171,26133147171,0,1518,1776,0
26135537590,26135537590,0,938,1092,0
26141581592,26141581598,6,1875,1356,0
26152629783,26152629783,0,974,1191,0
26153590418,26153590419,1,1509,2070,0
26160168456,26160168456,0,1234,2164,0
26161280839,26161280839,0,1076,1328,0
26162972999,26162972998,-1,1148,1554,0
26164368555,26164368557,2,1581,2032,0
26164499597,26164499598,1,1521,1430,0
26166614609,26166614610,1,1535,2647,0
26166665510,26166665508,-2,1507,2259,0
26166928959,26166928960,1,859,1458,0
26167615834,26167615832,-2,1628,2442,0
26170231158,26170231158,0,1151,1370,0
26172472382,26172472382,0,1116,1727,0
26173561787,26173561788,1,1467,1589,0
26173725539,26173725542,3,1927,2037,0
26174785698,26174785700,2,2244,2196,0
26174914630,26174914627,-3,932,1649,0
26175475177,26175475177,0,1219,1376,0
26175572061,26175572062,1,1249,1721,0
26177886458,26177886456,-2,950,1788,0
26181817865,26181817883,18,1059,1476,0
26183539583,26183539582,-1,745,1013,0
26185473305,26185473305,0,1386,1765,0
26196000049,26196000046,-3,856,2117,0
26202401495,26202401497,2,1942,1704,0
26204786719,26204786720,1,1191,2452,0
26205007587,26205007589,2,1384,2223,0
26206450915,26206450913,-2,729,1490,0
26206814359,26206814349,-10,1056,3700,0
26211063626,26211063627,1,1172,2039,0
26212636199,26212636200,1,919,1354,0
26215277439,26215277432,-7,2666,6946,0
26217739294,26217739294,0,1584,2146,0
26218294463,26218294462,-1,1282,1933,0
26219538580,26219538578,-2,1118,1743,0
26220741515,26220741510,-5,1290,4587,0
26221167690,26221167691,1,1773,1276,0
26224102354,26224102363,9,10687,30639,0
26225060951,26225060952,1,1402,1714,0
26228768399,26228768398,-1,1172,1857,0
26232641719,26232641718,-1,1246,1674,0
26232879498,26232879499,1,1423,1957,0
26233955775,26233955774,-1,969,1765,0
26241827861,26241827862,1,936,1206,0
26243680875,26243680874,-1,980,1130,0
26246538609,26246538610,1,1524,1343,0
26250635451,26250635457,6,2506,1121,0
26255786283,26255786283,0,1229,1604,0
26256299734,26256299738,4,1857,2598,0
26258736355,26258736370,15,669,2605,0
26258839675,26258839674,-1,1680,2345,0
26259372862,26259372865,3,858,1220,0
26264146816,26264146816,0,1331,1635,0
26269646702,26269646702,0,1063,1549,0
26271622992,26271622989,-3,2532,5054,0
26274893985,26274893987,2,812,1280,0
26275237522,26275237521,-1,1729,1589,0
26275678972,26275678965,-7,942,4460,0
26276204263,26276204262,-1,1607,2014,0
26277406555,26277406555,0,1637,1867,0
26278739203,26278739205,2,1812,2084,0
26278856069,26278856067,-2,1526,2757,0
26280752942,26280752941,-1,1444,2005,0
26282419138,26282419138,0,795,1086,0
26283062095,26283062094,-1,1377,1294,0
26285235507,26285235512,5,2473,1336,0
26286703076,26286703082,6,2591,1512,0
26287899727,26287899731,4,679,1147,0
26289778627,26289778630,3,1473,1440,0
26290215478,26290215479,1,1301,2056,0
26291807723,26291807723,0,1055,1058,0
26294056724,26294056724,0,2057,2843,0
26294092437,26294092436,-1,976,1613,0
26295102503,26295102504,1,1872,2348,0
26296756720,26296756718,-2,1289,1886,0
26297460002,26297460002,0,1513,1678,0
26300454830,26300454830,0,1016,1095,0
26300538250,26300538258,8,5721,1329,0
26302390843,26302390845,2,1120,1613,0
26306543181,26306543174,-7,815,3845,0
26307194361,26307194362,1,1011,1349,0
26307897682,26307897681,-1,1032,1265,0
26312238702,26312238702,0,755,1612,0
26312945683,26312945684,1,1103,1675,0
26313342093,26313342094,1,1498,1458,0
26313562635,26313562637,2,1266,1364,0
26314290340,26314290342,2,1635,1784,0
26315527277,26315527278,1,1200,1413,0
26320843433,26320843433,0,1501,1790,0
26323227046,26323227046,0,2057,1707,0
26325157225,26325157222,-3,1905,2085,0
26326582611,26326582610,-1,1127,1176,0
26328427244,26328427244,0,1372,2079,0
26335048778,26335048777,-1,1492,1932,0
26336615567,26336615567,0,1481,2007,0
26337539583,26337539577,-6,1259,3348,0
26337862782,26337862784,2,733,1566,0
26338760050,26338760050,0,1596,1669,0
26339431285,26339431286,1,1687,1707,0
26340195270,26340195270,0,1227,1908,0
26341386971,26341386971,0,1119,1460,0
26342731625,26342731625,0,1113,1816,0
26345593465,26345593467,2,1589,1031,0
26345967446,26345967447,1,1626,2508,0
26346104257,26346104258,1,1568,1340,0
26348387491,26348387494,3,971,1209,0
26351818981,26351818982,1,1427,1794,0
26353091367,26353091367,0,1414,1762,0
26353774723,26353774724,1,2187,2000,0
26355387404,26355387405,1,1271,1861,0
26359447641,26359447641,0,995,1397,0
26361816718,26361816719,1,1273,1105,0
26364028303,26364028302,-1,1548,1812,0
26364662267,26364662266,-1,1089,1534,0
26367505453,26367505453,0,1133,1641,0
26369039706,26369039709,3,1270,1700,0
26369769682,26369769684,2,950,1453,0
26372417116,26372417115,-1,828,1268,0
26373472210,26373472210,0,1077,1203,0
26375970613,26375970614,1,1002,1076,0
26377132045,26377132045,0,1158,2299,0
26379666254,26379666275,21,1153,1436,0
26382813487,26382813487,0,1554,1847,0
26382980155,26382980154,-1,1634,2273,0
26383265729,26383265727,-2,1578,1956,0
26384151015,26384151022,7,3215,1589,0
26384403569,26384403574,5,1133,1473,0
26392379271,26392379270,-1,1339,1606,0
26393989026,26393989025,-1,1641,1816,0
26395531247,26395531246,-1,1437,1891,0
26396054880,26396054882,2,1442,1650,0
26397482270,26397482270,0,925,1321,0
26398262220,26398262220,0,1754,2417,0
26401907515,26401907514,-1,1840,2360,0
26403135918,26403135919,1,1618,1883,0
26409401014,26409401015,1,1651,1606,0
26410046009,26410046006,-3,976,1474,0
26413008458,26413008459,1,1001,1426,0
26417859737,26417859739,2,1156,1525,0
26419579790,26419579790,0,1886,2524,0
26424114033,26424114034,1,1473,1761,0
26425873144,26425873144,0,905,1205,0
26428189882,26428189883,1,1290,1377,0
26432818264,26432818264,0,1148,1211,0
26432964126,26432964126,0,1781,2494,0
26435118735,26435118737,2,1217,1572,0
26437260789,26437260789,0,1404,1392,0
26438827238,26438827234,-4,25229,14244,0
26439951170,26439951175,5,1248,1052,0
26441725242,26441725245,3,1421,1238,0
26443702542,26443702547,5,4869,2162,0
26446627990,26446627990,0,1513,2036,0
26450201949,26450201949,0,1376,1487,0
26450601361,26450601362,1,1108,1572,0
26452705383,26452705385,2,1954,2166,0
26457040936,26457040936,0,1605,1616,0
26458155425,26458155424,-1,1048,1493,0
26459670838,26459670837,-1,1878,1948,0
26461645133,26461645135,2,12811,10018,0
26461737183,26461737182,-1,713,1367,0
26464252134,26464252131,-3,1121,2426,0
26465724116,26465724117,1,1126,1197,0
26465858654,26465858656,2,1413,1511,0
26466139314,26466139314,0,1251,909,0
26466856307,26466856308,1,1374,2323,0
26467564535,26467564536,1,1480,2112,0
26468926101,26468926101,0,1873,1625,0
26473712763,26473712766,3,944,878,0
26474861110,26474861109,-1,1335,1344,0
26476000505,26476000506,1,1273,1189,0
26480210391,26480210394,3,1272,1328,0
26482132489,26482132490,1,1732,2024,0
26483871322,26483871322,0,1525,1872,0
26484087965,26484087965,0,1636,1555,0
26486130361,26486130362,1,1150,1422,0
26486849714,26486849714,0,973,1715,0
26489885307,26489885306,-1,898,1260,0
26493596265,26493596265,0,1199,1416,0
26494174465,26494174465,0,1462,1306,0
26497556427,26497556426,-1,1215,1074,0
26498366419,26498366418,-1,1255,1724,0
26499462993,26499462994,1,1121,1869,0
26500101798,26500101798,0,1225,1388,0
26502281313,26502281314,1,1272,1939,0
26503353790,26503353791,1,1172,1487,0
26508317910,26508317910,0,1176,1728,0
26510882757,26510882757,0,1434,1953,0
26511999143,26511999143,0,1316,1966,0
26519331344,26519331345,1,1509,2114,0
26522588383,26522588383,0,620,832,0
26526062357,26526062358,1,1410,1705,0
26526669234,26526669234,0,1028,1446,0
26526941877,26526941877,0,1053,1497,0
26527354330,26527354330,0,1110,1396,0
26527667490,26527667489,-1,1433,1805,0
26528100168,26528100166,-2,915,1563,0
26529102927,26529102926,-1,792,943,0
26530419614,26530419616,2,1885,1972,0
26531230993,26531230994,1,1732,1720,0
26538574248,26538574248,0,1319,1972,0
26538820097,26538820094,-3,1042,1373,0
26540834354,26540834354,0,1234,1214,0
26542761283,26542761284,1,1148,1559,0
26544417419,26544417417,-2,1301,946,0
26544583727,26544583731,4,1229,1524,0
26545952739,26545952740,1,1392,1586,0
26550103514,26550103510,-4,1209,3281,0
26551665093,26551665093,0,1099,2197,0
26554009318,26554009319,1,1315,1347,0
26556258974,26556258974,0,1638,2462,0
26556489759,26556489759,0,1230,1023,0
26556578436,26556578438,2,1656,2129,0
26558975556,26558975556,0,1479,1647,0
26563725391,26563725390,-1,1321,1358,0
26564632093,26564632094,1,1348,1809,0
26564963653,26564963652,-1,1152,1242,0
26565108628,26565108627,-1,1864,2576,0
26565292688,26565292707,19,1298,1434,0
26566482513,26566482513,0,1422,1531,0
26567599210,26567599211,1,2311,2067,0
26568776337,26568776336,-1,1458,2040,0
26577629646,26577629647,1,1316,1566,0
26580975162,26580975162,0,1305,1854,0
26581410798,26581410797,-1,1328,1584,0
26585059588,26585059591,3,1477,1152,0
26591017335,26591017337,2,1736,1438,0
26591741200,26591741201,1,1182,1552,0
26601194466,26601194465,-1,1097,1517,0
26603129158,26603129158,0,1076,1809,0
26605399203,26605399205,2,1330,1549,0
26605921089,26605921091,2,1566,2237,0
26606050858,26606050858,0,1764,1449,0
26609428353,26609428351,-2,1817,2367,0
26610687821,26610687821,0,1231,1666,0
26611439138,26611439138,0,1588,2285,0
26612850300,26612850302,2,1265,1657,0
26618436808,26618436809,1,1511,2101,0
26619495341,26619495341,0,1774,2031,0
26620075974,26620075975,1,1889,1975,0
26620168674,26620168673,-1,1195,2367,0
26620708367,26620708369,2,1108,922,0
26622370820,26622370825,5,2291,1840,0
26622821621,26622821622,1,1307,1592,0
26625136050,26625136050,0,896,1531,0
26629320202,26629320184,-18,1661,1674,0
26632499406,26632499403,-3,1067,2872,0
26633395834,26633395834,0,1950,1514,0
26640131426,26640131427,1,1108,1224,0
26642283181,26642283181,0,1124,1839,0
26643091924,26643091925,1,1855,1489,0
26645763923,26645763926,3,1245,1568,0
26648833355,26648833355,0,1937,2630,0
26650827729,26650827729,0,1568,2078,0
26659941262,26659941263,1,1065,762,0
26662807733,26662807729,-4,1215,1653,0
26664730793,26664730794,1,2069,2150,0
26665931679,26665931678,-1,1696,2607,0
26667904002,26667904002,0,1094,1628,0
26669190922,26669190923,1,1834,1388,0
26670969078,26670969079,1,1826,1509,0
26671257371,26671257388,17,956,906,0
26683427786,26683427787,1,2576,2954,0
26685833897,26685833902,5,3123,1664,0
26690368277,26690368256,-21,1024,1438,0
26690549598,26690549598,0,1567,1661,0
26691832631,26691832634,3,1427,1069,0
26692079644,26692079643,-1,1191,2005,0
26693513024,26693513026,2,1602,1643,0
26695710918,26695710918,0,662,1159,0
26699773445,26699773448,3,1759,944,0
26704560001,26704560000,-1,1957,2727,0
26705560135,26705560136,1,2073,2753,0
26711257060,26711257061,1,1294,1305,0
26716152686,26716152679,-7,1413,5040,0
26716499294,26716499294,0,1192,1377,0
26717652158,26717652160,2,1399,1559,0
26720320787,26720320787,0,1055,1746,0
26722854017,26722854018,1,1573,1718,0
26723135229,26723135231,2,1068,1008,0
26724596648,26724596646,-2,1568,1434,0
26726401978,26726401981,3,1438,1919,0
26726432859,26726432861,2,1501,2151,0
26728902910,26728902910,0,1518,2056,0
26732500991,26732500994,3,1250,1577,0
26732764502,26732764503,1,1353,1427,0
26734678725,26734678725,0,1875,1209,0
26736036173,26736036170,-3,1330,3175,0
26737357931,26737357926,-5,1696,5251,0
26737450640,26737450639,-1,1745,1876,0
26738136472,26738136472,0,1390,1837,0
26739367359,26739367358,-1,1452,1364,0
26741013390,26741013391,1,915,2029,0
26741742919,26741742937,18,1388,1387,0
26750953438,26750953438,0,1716,1803,0
26751623406,26751623405,-1,1430,1647,0
26752919962,26752919962,0,2127,2967,0
26753200763,26753200763,0,1414,1937,0
26755738209,26755738210,1,921,1482,0
26758936005,26758936001,-4,782,1883,0
26760808503,26760808502,-1,1599,1909,0
26762114590,26762114589,-1,1107,1625,0
26763707049,26763707048,-1,1292,1925,0
26764739336,26764739336,0,1227,1649,0
26765158651,26765158652,1,1508,1699,0
26766376686,26766376687,1,1566,1399,0
26767074557,26767074557,0,1490,1607,0
26774869882,26774869883,1,1202,1790,0
26776311238,26776311238,0,1322,1318,0
26776498521,26776498522,1,1390,1581,0
26779990020,26779990021,1,1072,1752,0
26781750730,26781750730,0,1664,1674,0
26782502107,26782502107,0,2433,1466,0
26783321039,26783321040,1,1627,2006,0
26783788157,26783788157,0,617,1326,0
26788605418,26788605419,1,1468,2000,0
26794569470,26794569470,0,1129,1956,0
26797398138,26797398138,0,1156,1870,0
26797425825,26797425827,2,1142,1422,0
26797754915,26797754917,2,1366,1880,0
26798885985,26798885986,1,995,1413,0
26810762882,26810762881,-1,1971,1886,0
26811484437,26811484437,0,1605,1737,0
26815137410,26815137410,0,1952,2268,0
26817826159,26817826159,0,1014,1599,0
26819127382,26819127381,-1,1311,1945,0
26819195104,26819195105,1,1052,1149,0
26819668569,26819668571,2,1306,1584,0
26819905914,26819905892,-22,927,1103,0
26821127064,26821127063,-1,1444,1547,0
26824730201,26824730201,0,1519,2161,0
26825039878,26825039878,0,1281,1306,0
26825363987,26825363985,-2,1151,2295,0
26826276386,26826276385,-1,1761,1824,0
26827560181,26827560181,0,1404,1730,0
26827973630,26827973630,0,1452,1932,0
26828843502,26828843507,5,2359,1266,0
26829966545,26829966545,0,1146,1233,0
26830419613,26830419614,1,1100,2106,0
26830996693,26830996691,-2,1002,1606,0
26831217543,26831217544,1,1434,1512,0
26831354633,26831354634,1,1026,1251,0
26832663574,26832663575,1,1073,1142,0
26835581597,26835581597,0,1393,1861,0
26836160870,26836160870,0,1299,1542,0
26839315651,26839315631,-20,1562,2256,0
26840631485,26840631486,1,856,1623,0
26843566294,26843566296,2,1371,1062,0
26844483514,26844483513,-1,1017,1657,0
26846540601,26846540602,1,1503,1276,0
26852252885,26852252885,0,945,1143,0
26856664570,26856664568,-2,1497,1843,0
26860913982,26860913989,7,2967,3037,0
26861631886,26861631885,-1,1608,1398,0
26868659069,26868659071,2,1437,1595,0
26869324491,26869324494,3,1240,1272,0
26871896530,26871896531,1,1636,1900,0
26875644511,26875644509,-2,1339,2227,0
26876662130,26876662129,-1,1235,1523,0
26877286636,26877286637,1,843,1636,0
26879363150,26879363153,3,1846,1633,0
26881272877,26881272879,2,1478,1551,0
26884196582,26884196582,0,1709,1969,0
26884789335,26884789337,2,1106,1615,0
26886727698,26886727697,-1,1992,3309,0
26888314327,26888314326,-1,1543,2126,0
26889694353,26889694353,0,1345,1495,0
26890636328,26890636329,1,1608,1934,0
26893964098,26893964083,-15,1005,604,0
26897116095,26897116090,-5,1605,1985,0
26899690195,26899690193,-2,1227,1795,0
26901359885,26901359883,-2,1655,1990,0
26903753826,26903753825,-1,919,1100,0
26907465801,26907465802,1,1525,2111,0
26907602804,26907602804,0,1839,1641,0
26909484595,26909484594,-1,2299,4235,0
26909761817,26909761817,0,946,1462,0
26910357340,26910357340,0,1887,1960,0
26911121666,26911121665,-1,1470,1861,0
26912610260,26912610256,-4,1246,1107,0
26917222123,26917222123,0,1457,1562,0
26921640953,26921640953,0,1617,1630,0
26923834973,26923834980,7,2543,939,0
26929995318,26929995314,-4,1590,5849,0
26931423983,26931423983,0,1127,1710,0
26937119853,26937119859,6,2437,1070,0
26941037082,26941037082,0,1948,2412,0
26942651317,26942651319,2,1463,1752,0
26944814014,26944814014,0,1298,2079,0
26945990770,26945990769,-1,1188,1831,0
26948427831,26948427810,-21,1641,1549,0
26949324705,26949324705,0,1667,1632,0
26953878815,26953878817,2,1254,1712,0
26954905398,26954905399,1,1547,1603,0
26955196419,26955196418,-1,1677,2019,0
26957685253,26957685253,0,1759,1999,0
26963559250,26963559252,2,948,1347,0
26966015609,26966015610,1,1777,2221,0
26970901754,26970901754,0,2249,2202,0
26972745762,26972745763,1,1102,1323,0
26978704194,26978704194,0,1213,2173,0
26979348085,26979348067,-18,945,1289,0
26982236327,26982236326,-1,1002,1936,0
26982842417,26982842419,2,1170,2034,0
26983174663,26983174664,1,1548,2176,0
26983993730,26983993730,0,1281,2214,0
26984844133,26984844134,1,1703,2704,0
26985315186,26985315188,2,1480,1748,0
26988362538,26988362534,-4,1485,2000,0
26989451439,26989451439,0,1171,2094,0
26990898521,26990898522,1,1888,2412,0
26992715714,26992715713,-1,1232,1820,0
26993181527,26993181527,0,1053,1488,0
26994595998,26994595999,1,1245,1420,0
26996138802,26996138802,0,1661,1529,0
26997013210,26997013211,1,918,1058,0
27000498047,27000498045,-2,1100,1955,0
27000648283,27000648283,0,1302,1458,0
27002533585,27002533581,-4,2437,5242,0
27003169546,27003169548,2,1939,1933,0
27003436801,27003436802,1,927,1264,0
27005847811,27005847813,2,1367,1242,0
27006162110,27006162111,1,1122,1363,0
27006335332,27006335333,1,1253,1457,0
27006797088,27006797088,0,1181,1752,0
27011331365,27011331367,2,99,895,0
27011817173,27011817173,0,1424,1745,0
27013441519,27013441521,2,1066,1195,0
27016269373,27016269373,0,1278,1424,0
27016438658,27016438659,1,1218,1748,0
27023605243,27023605243,0,1855,1370,0
27025703007,27025703009,2,1375,1657,0
27026727533,27026727533,0,1371,1585,0
27026775758,27026775757,-1,1140,1039,0
27027711974,27027711972,-2,1974,1978,0
27030587445,27030587444,-1,1599,1878,0
27032344986,27032344985,-1,1349,1203,0
27037759523,27037759525,2,1373,1660,0
27038454367,27038454366,-1,2255,2404,0
27040355295,27040355297,2,1417,1747,0
27041268838,27041268839,1,1471,1663,0
27050781338,27050781339,1,1692,1632,0
27050955984,27050955985,1,1712,1693,0
27052960881,27052960883,2,1246,1297,0
27053676658,27053676659,1,1526,1416,0
27056996867,27056996868,1,1244,1229,0
27061350954,27061350953,-1,1563,1752,0
27064090409,27064090410,1,1015,1415,0
27064844723,27064844722,-1,1353,1854,0
27065773926,27065773926,0,2071,2411,0
27066268901,27066268902,1,1220,1368,0
27071223379,27071223381,2,1085,1875,0
27074790315,27074790315,0,1292,1493,0
27077538545,27077538546,1,1259,1871,0
27077739409,27077739411,2,1667,1946,0
27084121382,27084121384,2,1557,1717,0
27085018559,27085018558,-1,1431,1337,0
27085582704,27085582704,0,1707,1653,0
27085814442,27085814422,-20,1024,2127,0
27090527305,27090527306,1,1400,2113,0
27093516167,27093516165,-2,927,975,0
27099058322,27099058323,1,1520,1393,0
27100237317,27100237317,0,2065,1531,0
27103177716,27103177717,1,1191,1928,0
27105169783,27105169782,-1,1208,1725,0
27112646591,27112646579,-12,10299,27106,0
27113458555,27113458554,-1,1026,933,0
27113681006,27113681006,0,1340,1317,0
27114438861,27114438861,0,1109,1209,0
27116389758,27116389758,0,1303,2053,0
27120221762,27120221761,-1,1219,2436,0
27123473585,27123473585,0,1529,1811,0
27125107670,27125107670,0,1394,1595,0
27125635571,27125635570,-1,1898,2063,0
27127109601,27127109601,0,916,1461,0
27128771777,27128771778,1,1455,1956,0
27129358822,27129358821,-1,957,2023,0
27131005969,27131005970,1,1316,2038,0
27135737599,27135737599,0,870,1829,0
27137756879,27137756875,-4,948,1391,0
27138160244,27138160226,-18,1142,2138,0
27138937994,27138937995,1,1118,1570,0
27139649673,27139649672,-1,1831,1858,0
27139685183,27139685184,1,1371,1726,0
27139982431,27139982433,2,1327,1641,0
27140447874,27140447872,-2,1644,2545,0
27141943730,27141943731,1,1332,1661,0
27143826057,27143826058,1,1630,2002,0
27144439381,27144439382,1,1652,1764,0
27146926694,27146926694,0,1471,1777,0
27147342802,27147342802,0,1529,1120,0
27149116826,27149116829,3,1114,1242,0
27149488726,27149488729,3,1666,1773,0
27151471455,27151471456,1,1749,1377,0
27154436274,27154436275,1,1348,1655,0
27159581761,27159581760,-1,1500,2130,0
27160649494,27160649494,0,864,1426,0
27162607474,27162607474,0,1810,2440,0
27163619195,27163619197,2,1160,1980,0
27169634580,27169634582,2,1389,1248,0
27172339166,27172339166,0,1113,1349,0
27174007017,27174007019,2,1534,1714,0
27176532899,27176532901,2,1444,1944,0
27177958318,27177958317,-1,907,1237,0
27179498207,27179498206,-1,1241,1333,0
27180700474,27180700478,4,2646,1639,0
27181702970,27181702972,2,1589,1298,0
27184070598,27184070599,1,1550,1662,0
27184970054,27184970050,-4,1380,4204,0
27188661711,27188661713,2,1513,1442,0
27193779381,27193779382,1,1197,1921,0
27201804454,27201804454,0,1109,1618,0
27204118103,27204118105,2,1638,2140,0
27205770458,27205770457,-1,1685,2213,0
27205995345,27205995346,1,1905,1916,0
27206284313,27206284315,2,1418,1593,0
27208371445,27208371445,0,1701,2094,0
27211058402,27211058401,-1,1282,1804,0
27212217001,27212216999,-2,978,1560,0
27213894454,27213894453,-1,2145,2428,0
27214781179,27214781169,-10,40014,14418,0
27215704557,27215704554,-3,1312,1438,0
27216324764,27216324768,4,1768,1693,0
27217245462,27217245462,0,1679,2116,0
27219026990,27219026991,1,1420,1306,0
27219712475,27219712475,0,1084,1501,0
27220166098,27220166100,2,1295,1332,0
27221003315,27221003314,-1,1441,1307,0
27221278685,27221278691,6,1894,1223,0
27225702719,27225702720,1,867,1764,0
27226552905,27226552903,-2,1596,2142,0
27231287923,27231287921,-2,976,1878,0
27232064193,27232064194,1,1426,1875,0
27232894550,27232894552,2,771,1236,0
27233737429,27233737429,0,1720,2204,0
27234473005,27234473006,1,1733,1943,0
27235036234,27235036228,-6,961,4265,0
27236471517,27236471518,1,1104,838,0
27238982346,27238982346,0,1272,1087,0
27240373127,27240373127,0,834,1711,0
27244870932,27244870931,-1,1334,1904,0
27246388655,27246388654,-1,1081,1368,0
27247509339,27247509358,19,383,3418,0
27248425042,27248425043,1,1490,1468,0
27253140195,27253140195,0,1071,1371,0
27254228084,27254228082,-2,1456,1797,0
27256757574,27256757576,2,993,1560,0
27259083200,27259083204,4,2092,1415,0
27262902699,27262902702,3,2111,1128,0
27264179872,27264179873,1,886,1349,0
27268556142,27268556146,4,7193,5472,0
27269826919,27269826921,2,1254,1719,0
27281234955,27281234954,-1,740,1897,0
27282538971,27282538972,1,1320,1655,0
27283250842,27283250841,-1,1182,1843,0
27284313538,27284313539,1,1239,1312,0
27285226223,27285226224,1,882,1570,0
27285977645,27285977646,1,1384,1837,0
27286586526,27286586526,0,1629,1603,0
27287001574,27287001574,0,1678,2224,0
27288591123,27288591122,-1,1650,2425,0
27292731568,27292731569,1,1160,1521,0
27298479325,27298479321,-4,783,1821,0
27298571866,27298571866,0,1162,1933,0
27298716166,27298716166,0,1546,2010,0
27298996794,27298996794,0,1396,1469,0
27299197594,27299197595,1,1724,1720,0
27301593722,27301593722,0,1442,1687,0
27302331153,27302331155,2,1193,1585,0
27305427969,27305427970,1,1878,1838,0
27306228968,27306228969,1,1705,1714,0
27309164477,27309164478,1,1517,1832,0
27310939946,27310939946,0,975,1806,0
27313135335,27313135335,0,927,1720,0
27313883293,27313883285,-8,154,1433,0
27314301662,27314301663,1,1316,1334,0
27317106792,27317106792,0,699,901,0
27320584504,27320584505,1,1401,1726,0
27321315060,27321315061,1,2012,1520,0
27321645970,27321645971,1,1007,1402,0
27323234462,27323234462,0,1302,1189,0
27325875203,27325875201,-2,1272,2680,0
27328140882,27328140882,0,1249,1478,0
27335973306,27335973308,2,1432,1788,0
27337656147,27337656135,-12,3700,14704,0
27341608140,27341608141,1,1623,1628,0
27341671667,27341671669,2,1379,2020,0
27343751255,27343751255,0,1326,2049,0
27347337270,27347337271,1,1100,1743,0
27348666064,27348666067,3,1822,1572,0
27349893854,27349893858,4,1508,1365,0
27350097732,27350097733,1,1039,1616,0
27351646170,27351646171,1,1399,2183,0
27353453482,27353453482,0,1093,1549,0
27353734921,27353734923,2,1502,1320,0
27354549056,27354549056,0,1839,2060,0
27355151611,27355151613,2,1701,2171,0
27360212663,27360212664,1,1538,1321,0
27360875364,27360875363,-1,1303,972,0
27364054600,27364054597,-3,1400,3200,0
27365678883,27365678882,-1,1100,2461,0
27366900750,27366900752,2,873,1643,0
27369013969,27369013970,1,1331,1430,0
27370198974,27370198974,0,819,1320,0
27371232850,27371232850,0,1290,1543,0
27373410550,27373410551,1,10568,11782,0
27375409065,27375409065,0,1186,1432,0
27375519554,27375519557,3,1746,1593,0
27378067275,27378067276,1,1117,1692,0
27380229083,27380229081,-2,1463,1992,0
27381896622,27381896620,-2,1080,1363,0
27382686978,27382686978,0,1402,1281,0
27385013134,27385013135,1,1489,1204,0
27386049262,27386049262,0,2103,2405,0
27386276054,27386276056,2,1587,1562,0
27386520955,27386520955,0,1641,1830,0
27387413742,27387413742,0,1266,1355,0
27389524141,27389524143,2,1771,1499,0
27390145378,27390145381,3,1393,2445,0
27390989168,27390989175,7,2606,1092,0
27391800921,27391800919,-2,1388,1783,0
27396568362,27396568365,3,1070,1642,0
27400640559,27400640559,0,631,944,0
27400968133,27400968135,2,1142,1256,0
27401905178,27401905178,0,1096,1524,0
27402151526,27402151526,0,1526,2088,0
27412251038,27412251037,-1,1104,1586,0
27412497638,27412497637,-1,1188,1197,0
27412924703,27412924704,1,1731,2453,0
27416706377,27416706380,3,1870,1467,0
27418570725,27418570726,1,1828,1760,0
27418708918,27418708918,0,1727,1410,0
27420764382,27420764383,1,1533,1240,0
27422443683,27422443683,0,824,1781,0
27423914603,27423914605,2,1358,1470,0
27428148513,27428148514,1,1242,1682,0
27428900567,27428900569,2,1599,1813,0
27431871090,27431871089,-1,1472,2339,0
27432452022,27432452021,-1,1336,1970,0
27434697690,27434697691,1,2185,2282,0
27436500653,27436500635,-18,1424,1764,0
27437390782,27437390790,8,9267,2628,0
27438131669,27438131670,1,1810,2167,0
27438692441,27438692441,0,1275,1772,0
27440131755,27440131754,-1,1153,1903,0
27447733894,27447733895,1,700,1633,0
27449298621,27449298627,6,3389,746,0
27454802754,27454802754,0,1511,1719,0
27457226257,27457226258,1,1121,1190,0
27459473898,27459473897,-1,1982,3405,0
27465545952,27465545952,0,1917,1396,0
27467158666,27467158666,0,1530,1941,0
27469115798,27469115798,0,1570,1929,0
27471077304,27471077306,2,1524,2159,0
27474284423,27474284423,0,1402,1965,0
27476763649,27476763649,0,2035,2283,0
27478150126,27478150125,-1,1145,1758,0
27479484692,27479484696,4,2171,1476,0
27482007310,27482007310,0,1507,1596,0
27483248054,27483248054,0,1263,1581,0
27487059519,27487059518,-1,1257,1493,0
27488784008,27488784010,2,1141,1209,0
27492157821,27492157825,4,3035,1146,0
27492624138,27492624138,0,1421,1643,0
27493085573,27493085575,2,1506,1975,0
27493139755,27493139753,-2,758,2031,0
27494312027,27494312026,-1,1180,1575,0
27495268650,27495268651,1,1709,1738,0
27499874625,27499874619,-6,1016,6527,0
27499947393,27499947394,1,1312,1775,0
27502004318,27502004319,1,1317,2268,0
27504287146,27504287147,1,1431,1814,0
27504908971,27504908972,1,999,1275,0
27509274327,27509274329,2,1777,1441,0
27511185606,27511185606,0,818,1029,0
27511412571,27511412571,0,1196,1771,0
27511792394,27511792396,2,1042,1797,0
27514433971,27514433972,1,1222,1004,0
27515334929,27515334930,1,1616,1401,0
27515885078,27515885063,-15,1512,1837,0
27516756887,27516756884,-3,1085,1184,0
27517798573,27517798574,1,1718,1582,0
27519191798,27519191798,0,1571,1999,0
27519294474,27519294476,2,1391,1498,0
27520679199,27520679200,1,1896,2924,0
27521623618,27521623618,0,1197,1503,0
27522083874,27522083871,-3,1167,1424,0
27522675766,27522675780,14,1194,1300,0
27523256714,27523256713,-1,1154,1261,0
27523886474,27523886476,2,2307,2330,0
27524486026,27524486025,-1,1641,2357,0
27527556472,27527556470,-2,22776,45847,0
27528298578,27528298579,1,1519,1286,0
27535840307,27535840307,0,1219,1600,0
27536374394,27536374393,-1,1705,2125,0
27536629311,27536629311,0,1465,1246,0
27536934378,27536934379,1,1702,1869,0
27537937706,27537937707,1,1675,1010,0
27540910597,27540910599,2,964,1800,0
27546188750,27546188751,1,1420,1640,0
27555953691,27555953692,1,1064,21356,0
27555996593,27555996597,4,3060,1573,0
27557601788,27557601770,-18,1878,1885,0
27558668206,27558668206,0,1065,1725,0
27560687255,27560687256,1,7351,17359,0
27561156959,27561156958,-1,946,1359,0
27562194015,27562194024,9,779,1145,0
27564403447,27564403446,-1,1986,2074,0
27565788097,27565788090,-7,2139,8198,0
27568321057,27568321057,0,1533,2066,0
27569330402,27569330402,0,2604,2608,0
27569443326,27569443320,-6,1014,3551,0
27570984778,27570984780,2,1719,1680,0
27571994017,27571994017,0,752,911,0
27574127569,27574127571,2,1469,1504,0
27580870974,27580870974,0,1326,1927,0
27582549229,27582549230,1,1209,1604,0
27583860062,27583860061,-1,1716,1779,0
27584091015,27584091014,-1,1083,1942,0
27584189996,27584189999,3,1498,1198,0
27589025777,27589025779,2,1916,1981,0
27589347583,27589347581,-2,1238,1646,0
27592888521,27592888515,-6,1260,3671,0
27593264620,27593264620,0,1885,2446,0
27596624058,27596624059,1,2078,2246,0
27599752118,27599752119,1,1810,1783,0
27601738529,27601738527,-2,1136,2105,0
27602574695,27602574694,-1,1216,1675,0
27602775651,27602775652,1,1694,1875,0
27603343657,27603343658,1,1531,1438,0
27604264383,27604264383,0,1106,1499,0
27606835403,27606835402,-1,1501,1652,0
27608291782,27608291783,1,1288,1945,0
27611625220,27611625218,-2,1208,1484,0
27612371425,27612371425,0,920,1706,0
27616289496,27616289497,1,1798,2058,0
27617011183,27617011183,0,1675,1944,0
27617152810,27617152810,0,1702,1419,0
27618855130,27618855130,0,1377,1608,0
27619350654,27619350654,0,1455,1923,0
27621354254,27621354256,2,1330,2306,0
27625889153,27625889153,0,1110,1530,0
27626493074,27626493075,1,1122,1969,0
27628832731,27628832730,-1,1557,1605,0
27630063622,27630063622,0,1314,1555,0
27630160105,27630160106,1,1067,915,0
27631564890,27631564888,-2,1211,2465,0
27635624626,27635624626,0,1496,2156,0
27637107113,27637107114,1,1677,1727,0
27638763650,27638763650,0,1335,1803,0
27640752014,27640752015,1,1340,1231,0
27642759127,27642759129,2,1988,2125,0
27644998518,27644998518,0,1363,1528,0
27646363703,27646363706,3,1323,1726,0
27646531490,27646531490,0,1305,1661,0
27647714311,27647714310,-1,1216,2402,0
27649302411,27649302411,0,1138,1684,0
27650592386,27650592385,-1,1152,1520,0
27654065823,27654065815,-8,1411,5629,0
27655106535,27655106526,-9,1005,1121,0
27655798880,27655798880,0,1505,2130,0
27656953887,27656953887,0,1218,1220,0
27661793723,27661793721,-2,1136,1612,0
27668404065,27668404066,1,1142,1013,0
27670653325,27670653325,0,1444,1970,0
27670889516,27670889514,-2,1460,2855,0
27672050460,27672050453,-7,1749,4727,0
27674608610,27674608610,0,1114,2034,0
27676515307,27676515309,2,1470,1952,0
27678293447,27678293449,2,1263,826,0
27679327270,27679327271,1,1630,2347,0
27679910396,27679910382,-14,1580,1629,0
27680888481,27680888482,1,1547,1894,0
27682903894,27682903898,4,3887,2113,0
27683683858,27683683858,0,1629,1472,0
27684171022,27684171024,2,913,1591,0
27691095978,27691095980,2,1808,1885,0
27692387966,27692387967,1,1605,1596,0
27695241985,27695241986,1,1847,2705,0
27702811433,27702811435,2,1407,1873,0
27706088034,27706088032,-2,1458,1710,0
27710365638,27710365635,-3,946,2076,0
27710715287,27710715286,-1,973,1683,0
27713754009,27713754010,1,1543,1723,0
27714492516,27714492510,-6,1793,2257,0
27717498441,27717498442,1,1325,2018,0
27726214105,27726214107,2,662,1001,0
27727267094,27727267095,1,1221,1534,0
27728992973,27728992974,1,1483,1833,0
27732504810,27732504810,0,1376,2158,0
27735154960,27735154959,-1,1140,1872,0
27735444722,27735444721,-1,1020,2267,0
27735789627,27735789628,1,1317,1786,0
27740713776,27740713775,-1,1425,1834,0
27741492314,27741492310,-4,1506,3530,0
27742396340,27742396341,1,1600,1514,0
27746060900,27746060900,0,1380,1371,0
27746787240,27746787241,1,1737,1528,0
27750554310,27750554309,-1,1332,2197,0
27752285752,27752285753,1,1984,2230,0
27755263581,27755263579,-2,1157,1355,0
27755712635,27755712647,12,1016,1598,0
27759450949,27759450946,-3,1693,1884,0
27761418635,27761418633,-2,1461,2565,0
27761736298,27761736298,0,1377,1408,0
27763659649,27763659649,0,1382,1437,0
27766697329,27766697330,1,1982,1779,0
27770085962,27770085962,0,1728,1442,0
27770421990,27770421990,0,1195,1631,0
27771862678,27771862677,-1,1662,1951,0
27773437505,27773437504,-1,1364,1574,0
27776318473,27776318491,18,1282,1276,0
27776879182,27776879184,2,1187,2147,0
27777677512,27777677512,0,1445,1925,0
27779189306,27779189307,1,1599,2023,0
27779798559,27779798565,6,2704,1490,0
27781488217,27781488218,1,1078,1413,0
27785358646,27785358647,1,1075,1240,0
27786127528,27786127529,1,1338,1424,0
27789227279,27789227279,0,884,1015,0
27789349230,27789349229,-1,1026,1376,0
27791341392,27791341392,0,1115,1614,0
27792275250,27792275247,-3,1704,3016,0
27792728088,27792728089,1,1381,1355,0
27799442166,27799442169,3,2293,1724,0
27799710223,27799710222,-1,1322,1199,0
27800090391,27800090398,7,4476,1905,0
27804178229,27804178230,1,1317,1435,0
27805922586,27805922586,0,1557,1872,0
27807173474,27807173474,0,655,1366,0
27811306746,27811306746,0,1648,1616,0
27814057824,27814057826,2,1541,1865,0
27816432405,27816432403,-2,1277,2134,0
27818402714,27818402716,2,1478,1557,0
27821366884,27821366884,0,832,927,0
27821652654,27821652654,0,1320,1580,0
27822225199,27822225203,4,1169,1361,0
27823347247,27823347247,0,2020,2587,0
27826238837,27826238836,-1,1088,1482,0
27831292262,27831292265,3,1623,1443,0
27833134261,27833134262,1,1966,1889,0
27833294198,27833294199,1,1116,1675,0
27836130641,27836130641,0,1199,1350,0
27837112302,27837112302,0,1255,1513,0
27838050586,27838050587,1,1677,1936,0
27838646883,27838646881,-2,1397,2216,0
27839621478,27839621474,-4,2288,4934,0
27839704563,27839704565,2,1562,1600,0
27841137776,27841137777,1,1163,1275,0
27847868870,27847868870,0,1041,1555,0
27847906431,27847906425,-6,1272,1595,0
27853462144,27853462145,1,1244,1409,0
27853985830,27853985827,-3,1199,3187,0
27854660784,27854660803,19,622,835,0
27856762411,27856762411,0,1323,1402,0
27857655479,27857655479,0,1201,1822,0
27859714577,27859714577,0,1221,1387,0
27864456590,27864456590,0,1316,1619,0
27869691082,27869691083,1,1720,2370,0
27871731470,27871731469,-1,746,1990,0
27872837966,27872837966,0,1292,1655,0
27873713346,27873713346,0,959,1876,0
27874729730,27874729731,1,1694,1833,0
27874870884,27874870885,1,1064,1522,0
27875358761,27875358761,0,987,2004,0
27878517467,27878517469,2,1397,1261,0
27879845482,27879845482,0,1546,1686,0
27881986450,27881986448,-2,1177,1958,0
27883161655,27883161642,-13,1370,2100,0
27884312845,27884312839,-6,771,2986,0
27885106281,27885106282,1,1406,1288,0
27886711541,27886711540,-1,1126,1158,0
27888618367,27888618367,0,1061,1432,0
27892869551,27892869551,0,1059,1465,0
27895500555,27895500557,2,1842,1976,0
27895538897,27895538895,-2,7061,13020,0
27895969337,27895969338,1,1743,1819,0
27898512885,27898512885,0,1035,1758,0
27901427989,27901427990,1,1874,1891,0
27903487632,27903487633,1,1567,1465,0
27904168573,27904168579,6,1490,1206,0
27906694439,27906694430,-9,1492,1435,0
27907543444,27907543446,2,1604,2104,0
27907751870,27907751870,0,1661,1438,0
27909511263,27909511264,1,1197,1088,0
27910297074,27910297075,1,1698,1145,0
27911064778,27911064779,1,1181,1101,0
27911193668,27911193670,2,1744,1385,0
27911330795,27911330797,2,1339,2115,0
27912931454,27912931454,0,1426,1491,0
27916316182,27916316184,2,1315,1611,0
27916946154,27916946151,-3,1504,2580,0
27917165471,27917165473,2,1182,1628,0
27917435098,27917435099,1,962,1692,0
27919726664,27919726648,-16,1297,1212,0
27921374525,27921374547,22,1008,1435,0
27921788539,27921788540,1,1144,1619,0
27924138440,27924138439,-1,1631,1593,0
27925054827,27925054826,-1,922,1577,0
27925129786,27925129786,0,1518,1836,0
27926434267,27926434266,-1,1977,1379,0
27928751558,27928751551,-7,1946,5461,0
27932313685,27932313684,-1,1181,1515,0
27932465859,27932465861,2,1752,1811,0
27935119913,27935119914,1,944,1372,0
27937370598,27937370601,3,1404,1052,0
27939726279,27939726282,3,2039,1305,0
27943574674,27943574673,-1,909,1047,0
27946560627,27946560629,2,1428,1300,0
27947777739,27947777738,-1,1204,1905,0
27947986416,27947986432,16,1433,2329,0
27950007682,27950007681,-1,1387,1918,0
27951172299,27951172299,0,1554,1287,0
27959714452,27959714456,4,1437,1462,0
27960919835,27960919838,3,1402,1613,0
27964600266,27964600262,-4,1054,3177,0
27967567151,27967567153,2,553,736,0
27969913542,27969913543,1,1365,1691,0
27972988030,27972988030,0,1984,1802,0
27975203681,27975203677,-4,1130,1829,0
27975374394,27975374393,-1,1319,1433,0
27977381818,27977381818,0,1256,1388,0
27981225974,27981225974,0,1333,1318,0
27982568497,27982568497,0,1708,1819,0
27986528216,27986528215,-1,1534,2151,0
27989188415,27989188417,2,1021,1333,0
27991021762,27991021762,0,1497,1799,0
27993005562,27993005561,-1,1134,896,0
27993832275,27993832274,-1,1066,1561,0
27999342922,27999342924,2,1217,1402,0
28002728274,28002728274,0,1383,2120,0
28003699201,28003699201,0,1451,2219,0
28004019101,28004019104,3,1946,1512,0
28004374905,28004374909,4,2530,1779,0
28010429129,28010429131,2,1376,1915,0
28012033710,28012033690,-20,932,1367,0
28013352346,28013352353,7,8525,969,0
28015583187,28015583185,-2,928,1350,0
28016496546,28016496545,-1,1725,1717,0
28018850186,28018850186,0,1089,1754,0
28022762281,28022762281,0,1506,1893,0
28024801199,28024801199,0,1100,1760,0
28025779463,28025779482,19,1394,1596,0
28026707450,28026707450,0,1196,1729,0
28028138928,28028138928,0,1682,1720,0
28028897198,28028897198,0,938,1507,0
28030211265,28030211265,0,1017,1079,0
28032224016,28032224018,2,1417,1627,0
28038064083,28038064085,2,1266,1317,0
28038723883,28038723882,-1,952,1563,0
28040871647,28040871649,2,1015,1596,0
28051622399,28051622402,3,1632,1336,0
28051995682,28051995682,0,1675,1886,0
28052568417,28052568417,0,1235,1477,0
28057930913,28057930913,0,1705,1608,0
28059814672,28059814670,-2,1598,2485,0
28062871395,28062871396,1,1401,2046,0
28062969002,28062969001,-1,1028,1683,0
28072450662,28072450662,0,917,1301,0
28074042000,28074042000,0,1759,2286,0
28074566336,28074566338,2,1005,1271,0
28076031521,28076031522,1,1387,2010,0
28076562931,28076562929,-2,1252,1877,0
28076991374,28076991375,1,2185,1720,0
28077458761,28077458761,0,1269,1479,0
28078299601,28078299605,4,2318,1858,0
28080063353,28080063355,2,18789,18996,0
28083968787,28083968786,-1,1017,1378,0
28085073908,28085073910,2,1256,1446,0
28089459745,28089459746,1,1126,1762,0
28091155886,28091155886,0,1456,1551,0
28093172529,28093172530,1,1207,1759,0
28093957813,28093957813,0,1445,2199,0
28095002220,28095002219,-1,1196,1723,0
28097575718,28097575719,1,1230,950,0
28100832514,28100832515,1,1160,1334,0
28103624298,28103624297,-1,1464,2287,0
28105228758,28105228759,1,1572,1577,0
28110340092,28110340092,0,1408,2027,0
28112594029,28112594027,-2,1442,1706,0
28114557129,28114557130,1,1413,1711,0
28114907534,28114907534,0,1403,1453,0
28115668131,28115668135,4,1673,1342,0
28116077177,28116077177,0,1175,1559,0
28117889462,28117889458,-4,2632,6567,0
28119550624,28119550623,-1,1420,2696,0
28119842066,28119842067,1,1303,1639,0
28120533157,28120533155,-2,1863,1854,0
28121579033,28121579032,-1,1441,1707,0
28123118494,28123118495,1,780,1447,0
28125790194,28125790191,-3,1360,3157,0
28126850645,28126850646,1,1311,1719,0
28128908038,28128908040,2,771,1287,0
28130282290,28130282287,-3,1713,3438,0
28130971901,28130971902,1,1016,1189,0
28131175759,28131175759,0,1099,1729,0
28132247278,28132247279,1,1037,1228,0
28132326946,28132326945,-1,1190,1776,0
28133188106,28133188108,2,1424,1396,0
28133727800,28133727801,1,1647,1965,0
28134161414,28134161420,6,3577,1602,0
28134484635,28134484634,-1,1054,1193,0
28137496714,28137496714,0,631,1381,0
28139114731,28139114729,-2,1120,1343,0
28140178767,28140178765,-2,2026,4283,0
28141007010,28141007009,-1,1105,1402,0
28142612016,28142612018,2,1617,1837,0
28143309469,28143309470,1,1229,1582,0
28147512851,28147512851,0,1301,1835,0
28147741854,28147741856,2,1386,2322,0
28147926734,28147926736,2,1563,1716,0
28150345710,28150345706,-4,1105,1133,0
28153613966,28153613966,0,1731,2344,0
28155260125,28155260124,-1,1078,1647,0
28156770338,28156770340,2,1151,1472,0
28157572130,28157572129,-1,1553,1720,0
28159592616,28159592603,-13,1453,1744,0
28161691752,28161691747,-5,1471,4152,0
28165425913,28165425914,1,1129,1696,0
28165788874,28165788876,2,1485,1489,0
28165819386,28165819386,0,1174,1310,0
28167973080,28167973078,-2,984,1971,0
28173495979,28173495978,-1,1455,1481,0
28177533864,28177533866,2,1159,1585,0
28177946540,28177946540,0,1378,1376,0
28179233767,28179233765,-2,636,1285,0
28179853748,28179853739,-9,1272,1527,0
28180067810,28180067807,-3,1864,1690,0
28180805441,28180805442,1,1719,3427,0
28183141669,28183141671,2,1430,1524,0
28183526977,28183526978,1,1022,1343,0
28184913545,28184913545,0,1778,2106,0
28185354101,28185354102,1,1696,1794,0
28187700850,28187700851,1,1129,1752,0
28190170806,28190170806,0,1436,1999,0
28196467325,28196467321,-4,3837,10631,0
28196669442,28196669444,2,1174,1737,0
28198239133,28198239134,1,990,1501,0
28204677705,28204677705,0,1556,1565,0
28205133853,28205133854,1,1330,1216,0
28205801911,28205801911,0,1191,2219,0
28207888426,28207888426,0,1411,1293,0
28214118586,28214118569,-17,1388,1659,0
28218786333,28218786334,1,1255,1555,0
28219415359,28219415357,-2,696,940,0
28221276453,28221276436,-17,1034,1052,0
28223544606,28223544607,1,1734,1643,0
28223827887,28223827891,4,2905,1381,0
28225649837,28225649837,0,2790,3538,0
28228107218,28228107219,1,2110,2196,0
28228300858,28228300859,1,1421,1396,0
28230477995,28230477994,-1,1174,1873,0
28231944978,28231944978,0,1411,2094,0
28232128283,28232128294,11,13982,43976,0
28233433652,28233433653,1,1221,1569,0
28235118103,28235118103,0,1458,1376,0
28236095540,28236095540,0,1332,1479,0
28236711656,28236711657,1,1403,1701,0
28237743029,28237743028,-1,1120,1585,0
28242981702,28242981702,0,687,875,0
28245592337,28245592337,0,1456,1466,0
28246018814,28246018821,7,2227,1285,0
28254096258,28254096260,2,1366,1858,0
28254171034,28254171034,0,1128,1029,0
28256803355,28256803356,1,1229,1836,0
28256937220,28256937219,-1,1478,1581,0
28262558050,28262558051,1,1124,1869,0
28265695277,28265695284,7,12645,25833,0
28268737395,28268737395,0,1620,1526,0
28272872288,28272872288,0,31430,23468,0
28273021962,28273021962,0,1470,1782,0
28273351980,28273351980,0,1609,1708,0
28274439254,28274439253,-1,1752,1396,0
28276158120,28276158121,1,1333,1984,0
28280520654,28280520655,1,1283,1411,0
28282412786,28282412787,1,1443,1079,0
28282821675,28282821668,-7,1868,9483,0
28284258703,28284258703,0,1615,1709,0
28288880793,28288880794,1,1005,947,0
28293408738,28293408741,3,3502,2882,0
28293839642,28293839636,-6,1198,3566,0
28297223970,28297223974,4,1480,1256,0
28297612675,28297612677,2,1227,1779,0
28297825334,28297825333,-1,1127,1302,0
28299790161,28299790165,4,589,477,0
28302797023,28302797023,0,1048,955,0
28308138983,28308138982,-1,1035,1969,0
28310159726,28310159727,1,1390,1764,0
28310870393,28310870391,-2,1383,1733,0
28313286877,28313286877,0,1445,2077,0
28318942619,28318942619,0,1328,1799,0
28320948065,28320948046,-19,1390,1719,0
28321128372,28321128352,-20,1277,1685,0
28322367202,28322367205,3,1258,1619,0
28325144664,28325144664,0,998,1500,0
28328034734,28328034737,3,1639,1886,0
28329374813,28329374814,1,2012,2509,0
28329907847,28329907846,-1,984,2890,0
28332648218,28332648221,3,1351,1097,0
28334894575,28334894574,-1,1020,1558,0
28335969151,28335969151,0,1057,1271,0
28341734650,28341734650,0,1480,1799,0
28342649137,28342649154,17,1233,1386,0
28348260673,28348260673,0,26784,31996,0
28348520955,28348520954,-1,1045,1568,0
28351786733,28351786734,1,1356,1900,0
28352599515,28352599517,2,1680,2136,0
28352704778,28352704780,2,1401,1204,0
28352963367,28352963368,1,1087,1910,0
28353723903,28353723904,1,1235,1853,0
28355804542,28355804542,0,796,932,0
28356170784,28356170784,0,1506,1625,0
28357423416,28357423415,-1,1503,1979,0
28357732210,28357732209,-1,1724,2673,0
28359065775,28359065775,0,1761,2119,0
28360762289,28360762291,2,1490,1711,0
28364657794,28364657795,1,1494,1572,0
28364768458,28364768454,-4,1204,1793,0
28366356246,28366356252,6,1745,1069,0
28372319185,28372319187,2,1464,1613,0
28378104282,28378104282,0,1715,1985,0
28380086086,28380086086,0,1600,1884,0
28384415143,28384415144,1,1041,2047,0
28385142037,28385142037,0,1074,1773,0
28385769515,28385769511,-4,1895,5672,0
28386237766,28386237766,0,997,1540,0
28386398073,28386398074,1,1184,1150,0
28387072087,28387072086,-1,1612,1504,0
28389399155,28389399158,3,6035,5565,0
28389531197,28389531195,-2,1596,2772,0
28392778699,28392778713,14,774,814,0
28395104262,28395104266,4,2062,1876,0
28396101171,28396101169,-2,1411,1397,0
28397077878,28397077878,0,1591,2242,0
28398418488,28398418487,-1,1628,1475,0
28402431980,28402431983,3,1755,896,0
28406438303,28406438305,2,1564,2125,0
28407574431,28407574433,2,1107,978,0
28409314711,28409314710,-1,1536,1672,0
28414245780,28414245773,-7,362,1251,0
28414512710,28414512698,-12,833,980,0
28416159286,28416159284,-2,1119,1635,0
28416768177,28416768178,1,1746,1958,0
28418082104,28418082105,1,1334,1353,0
28419409372,28419409370,-2,1279,1689,0
28420884922,28420884925,3,1307,1811,0
28421859762,28421859765,3,1206,1513,0
28422898058,28422898059,1,1475,1650,0
28423886682,28423886683,1,1530,1314,0
28425257545,28425257524,-21,1324,594,0
28428385927,28428385926,-1,1444,1933,0
28434829129,28434829124,-5,2643,7837,0
28439282786,28439282787,1,1465,1276,0
28441981107,28441981104,-3,1085,2653,0
28444091086,28444091086,0,1348,1760,0
28444539434,28444539433,-1,1345,1926,0
28445105419,28445105420,1,1692,1692,0
28446703779,28446703779,0,1094,1202,0
28447224562,28447224563,1,1462,1242,0
28448160490,28448160488,-2,2161,1359,0
28448984314,28448984315,1,1135,1495,0
28449616582,28449616583,1,1190,1621,0
28451453039,28451453041,2,1574,1587,0
28453350963,28453350963,0,1244,1758,0
28455698752,28455698753,1,1678,1694,0
28464069379,28464069378,-1,2175,2053,0
28468058758,28468058758,0,1502,2081,0
28468490913,28468490924,11,1854,1539,0
28473419339,28473419341,2,1302,1446,0
28475190666,28475190666,0,1058,1845,0
28475537162,28475537164,2,1512,1701,0
28480429759,28480429759,0,1826,1633,0
28481869282,28481869281,-1,1035,1758,0
28489295657,28489295660,3,1834,1299,0
28498985907,28498985906,-1,1524,2462,0
28500922639,28500922641,2,1452,1535,0
28503864071,28503864066,-5,1136,3025,0
28507135567,28507135568,1,1259,1529,0
28509339855,28509339856,1,1063,1472,0
28509910771,28509910770,-1,1627,2173,0
28510179061,28510179062,1,1370,1688,0
28510511626,28510511625,-1,2291,2111,0
28511627785,28511627784,-1,32685,42606,0
28517059198,28517059199,1,1804,2651,0
28517306437,28517306439,2,2012,1975,0
28520601291,28520601291,0,811,1690,0
28521913830,28521913830,0,1069,2003,0
28523831813,28523831813,0,2105,3124,0
28528326170,28528326169,-1,1288,1464,0
28528652417,28528652417,0,1205,1520,0
28532778723,28532778721,-2,27147,21180,0
28535577310,28535577312,2,1303,1772,0
28544445869,28544445862,-7,1280,5874,0
28544613311,28544613313,2,1793,1627,0
28550196722,28550196721,-1,806,1441,0
28551184964,28551184946,-18,1127,1673,0
28552855066,28552855066,0,1627,2269,0
28553983759,28553983758,-1,834,1079,0
28559299619,28559299619,0,1874,1778,0
28560574094,28560574097,3,1713,1566,0
28561615447,28561615450,3,4526,2832,0
28562256490,28562256490,0,1287,1686,0
28564483306,28564483306,0,1616,1801,0
28566379990,28566379991,1,1070,1510,0
28567205546,28567205547,1,1275,1275,0
28568836337,28568836338,1,1672,1400,0
28570182672,28570182674,2,980,1072,0
28573090691,28573090689,-2,1346,1612,0
28574843697,28574843690,-7,1825,8457,0
28574958374,28574958376,2,2189,2375,0
28582238602,28582238602,0,1509,2276,0
28587740773,28587740774,1,1265,1857,0
28595138887,28595138887,0,749,1731,0
28597151887,28597151888,1,1587,1876,0
28601667338,28601667316,-22,1798,1382,0
28606075486,28606075485,-1,1191,1781,0
28607904633,28607904633,0,1498,1683,0
28608851054,28608851061,7,1766,1301,0
28609476605,28609476602,-3,999,1502,0
28611553116,28611553103,-13,310,628,0
28614495742,28614495743,1,1492,1602,0
28618628795,28618628796,1,926,1614,0
28619875266,28619875266,0,1160,1628,0
28621666282,28621666285,3,1337,1881,0
28623221610,28623221613,3,1454,1305,0
28624721642,28624721642,0,1603,1466,0
28626503151,28626503153,2,1661,2277,0
28627704215,28627704220,5,10667,8155,0
28627885391,28627885390,-1,1574,1566,0
28628073813,28628073813,0,1072,1890,0
28629081726,28629081724,-2,1354,2436,0
28631409377,28631409378,1,985,1646,0
28632147250,28632147249,-1,1578,1924,0
28636562016,28636562018,2,1376,1721,0
28641597954,28641597954,0,1082,1425,0
28648311661,28648311662,1,1627,1918,0
28648862903,28648862904,1,1691,1951,0
28649654205,28649654207,2,1253,1660,0
28656482206,28656482210,4,1891,1892,0
28659438001,28659437996,-5,1077,2954,0
28660225010,28660225009,-1,1116,1822,0
28665894969,28665894968,-1,1318,1820,0
28669386837,28669386841,4,2795,1139,0
28673224814,28673224807,-7,839,2454,0
28674154227,28674154229,2,1529,1611,0
28675908068,28675908071,3,33446,23636,0
28678959991,28678959991,0,1065,2285,0
28683636033,28683636033,0,1451,2302,0
28685469686,28685469687,1,564,796,0
28686020779,28686020781,2,1432,1812,0
28686335065,28686335066,1,1292,1280,0
28690745299,28690745299,0,1572,1565,0
28693231819,28693231818,-1,1256,1298,0
28694371720,28694371724,4,1737,1775,0
28695449347,28695449346,-1,1469,1209,0
28696342189,28696342193,4,20799,33521,0
28697561524,28697561523,-1,1682,2087,0
28699989018,28699989017,-1,1129,1678,0
28703015378,28703015376,-2,1293,2846,0
28704854085,28704854086,1,670,1208,0
28704944940,28704944941,1,1353,1373,0
28705331124,28705331116,-8,1097,1473,0
28706287357,28706287357,0,1169,1872,0
28707553065,28707553066,1,1547,1606,0
28708741937,28708741939,2,1649,2399,0
28710645940,28710645939,-1,1823,1459,0
28711932542,28711932542,0,850,2240,0
28718246613,28718246610,-3,1380,3243,0
28719762950,28719762952,2,1839,2004,0
28724689441,28724689441,0,1394,1440,0
28727883394,28727883395,1,1358,1199,0
28729986007,28729986006,-1,1592,1750,0
28731239955,28731239956,1,1092,1018,0
28733134130,28733134130,0,1097,1639,0
28735625096,28735625094,-2,2090,1859,0
28735968825,28735968826,1,1538,1657,0
28743882354,28743882354,0,1306,1668,0
28745866818,28745866818,0,1268,1517,0
28747943604,28747943606,2,1614,1452,0
28748127498,28748127499,1,1437,1931,0
28748606544,28748606543,-1,1182,1794,0
28752210662,28752210660,-2,1220,1476,0
28755793155,28755793156,1,1749,2397,0
28756312718,28756312719,1,1866,2317,0
28759645226,28759645227,1,1821,2153,0
28760812244,28760812243,-1,1456,2205,0
28760991899,28760991901,2,1898,1820,0
28761146751,28761146753,2,1267,1509,0
28761908095,28761908095,0,1395,1425,0
28763288693,28763288695,2,1197,1355,0
28764756534,28764756537,3,1100,1443,0
28766341955,28766341957,2,1514,1418,0
28768347293,28768347293,0,1249,1659,0
28771372219,28771372218,-1,1133,1874,0
28779825710,28779825710,0,704,941,0
28781729799,28781729800,1,1424,1393,0
28783627098,28783627099,1,1701,2662,0
28787455710,28787455711,1,770,1005,0
28791502422,28791502422,0,1717,1551,0
28792802394,28792802398,4,2510,1226,0
28792832374,28792832375,1,1845,1888,0
28794680681,28794680681,0,1754,1601,0
28795464947,28795464950,3,1206,1909,0
28795663313,28795663320,7,13541,36335,0
28797841210,28797841207,-3,1227,2420,0
28798186429,28798186430,1,967,1648,0
28800703811,28800703812,1,1189,1862,0
28806255391,28806255394,3,1025,1754,0
28807964300,28807964281,-19,1291,1318,0
28808834638,28808834641,3,1296,1327,0
28811914523,28811914530,7,3102,1217,0
28812019382,28812019383,1,1703,1809,0
28812596505,28812596505,0,1714,1960,0
28814537695,28814537695,0,1620,2034,0
28817295805,28817295806,1,1384,1085,0
28819410571,28819410569,-2,1111,1134,0
28820343790,28820343793,3,1142,1517,0
28820752931,28820752932,1,1181,1912,0
28824050286,28824050287,1,1606,1821,0
28824703989,28824703988,-1,1055,1737,0
28826118033,28826118034,1,1260,1322,0
28826325419,28826325418,-1,1383,1510,0
28826501474,28826501477,3,1425,1322,0
28829732714,28829732735,21,930,1012,0
28831941411,28831941411,0,931,1511,0
28832381729,28832381740,11,17096,46463,0
28832583754,28832583753,-1,1349,2052,0
28833461149,28833461155,6,2389,1518,0
28833876946,28833876944,-2,1155,1763,0
28837052341,28837052342,1,1635,1999,0
28837721498,28837721501,3,1040,1180,0
28838666818,28838666817,-1,1166,1342,0
28839188486,28839188486,0,1655,2500,0
28841464194,28841464194,0,1513,1737,0
28841661610,28841661605,-5,824,3928,0
28842081775,28842081770,-5,1529,3742,0
28848354497,28848354498,1,1112,1719,0
28848551886,28848551889,3,1158,2251,0
28852453265,28852453265,0,1269,1672,0
28853578390,28853578390,0,1496,2107,0
28853873046,28853873048,2,1631,1842,0
28857796902,28857796902,0,1490,1341,0
28861598914,28861598915,1,1525,2347,0
28863293343,28863293346,3,1459,1688,0
28863422266,28863422267,1,952,1183,0
28863533609,28863533610,1,1123,1425,0
28863615676,28863615676,0,1764,1841,0
28864131423,28864131424,1,1192,2121,0
28867683182,28867683180,-2,1203,1715,0
28869120499,28869120498,-1,985,1895,0
28875069776,28875069777,1,1672,2111,0
28876069025,28876069023,-2,1499,2249,0
28876548506,28876548505,-1,1784,2177,0
28876604356,28876604357,1,1681,1537,0
28878340181,28878340178,-3,1167,2011,0
28878721626,28878721626,0,864,933,0
28882309802,28882309806,4,10356,5841,0
28882623101,28882623103,2,1084,1151,0
28886678902,28886678899,-3,16023,16688,0
28887298875,28887298874,-1,1389,1804,0
28888130824,28888130824,0,2010,1785,0
28890087143,28890087143,0,777,1013,0
28897131198,28897131198,0,1244,1195,0
28899278454,28899278451,-3,1333,1441,0
28903861386,28903861385,-1,1101,1766,0
28908217038,28908217040,2,1506,1489,0
28917605217,28917605217,0,1742,1836,0
28918764995,28918764997,2,1473,1581,0
28918884269,28918884271,2,991,1395,0
28924424349,28924424349,0,1298,1762,0
28926474030,28926474030,0,1461,2294,0
28932358027,28932358028,1,1948,1883,0
28936483833,28936483833,0,2017,1879,0
28944601607,28944601608,1,776,1130,0
28945999295,28945999296,1,1172,1468,0
28948243897,28948243898,1,995,1080,0
28955003626,28955003625,-1,1377,1747,0
28955563479,28955563479,0,1532,1336,0
28958901395,28958901396,1,1561,2488,0
28962906579,28962906579,0,1493,2585,0
28963524357,28963524357,0,1246,1249,0
28964480893,28964480893,0,1518,1891,0
28965012057,28965012055,-2,1526,1604,0
28970180611,28970180613,2,842,828,0
28971981180,28971981181,1,1582,2303,0
28972991591,28972991591,0,1454,2016,0
28978913134,28978913134,0,1433,1840,0
28979855534,28979855537,3,1744,1611,0
28980988726,28980988725,-1,1504,1755,0
28981277033,28981277035,2,2131,2004,0
28981491292,28981491287,-5,1574,4976,0
28983700230,28983700226,-4,1171,1536,0
28984419302,28984419306,4,1702,1583,0
28985257698,28985257697,-1,1222,1529,0
28989914142,28989914143,1,1219,1680,0
28990481211,28990481210,-1,1371,2368,0
28990534259,28990534262,3,1087,1079,0
28993240114,28993240116,2,1389,1454,0
28993563446,28993563441,-5,1324,1437,0
28996797205,28996797205,0,1407,1749,0
28997222721,28997222720,-1,932,1157,0
28998477822,28998477819,-3,350,1100,0
28998504774,28998504790,16,1162,2336,0
28999800042,28999800039,-3,1513,1805,0
29001684959,29001684959,0,1834,1876,0
29003878169,29003878169,0,1190,1748,0
29008004454,29008004463,9,12757,29122,0
29008697147,29008697147,0,1418,2082,0
29009360534,29009360534,0,1060,1903,0
29011228137,29011228138,1,926,1179,0
29012735158,29012735159,1,1359,1359,0
29015376167,29015376167,0,1922,2232,0
29017075519,29017075520,1,1045,1185,0
29017227774,29017227774,0,1758,2143,0
29018909695,29018909694,-1,1702,2178,0
29027128366,29027128367,1,1470,1808,0
29027884615,29027884614,-1,1047,1757,0
29028334879,29028334883,4,1282,1631,0
29032930944,29032930944,0,1377,1478,0
29037593314,29037593314,0,1307,1790,0
29038873762,29038873762,0,1179,872,0
29040453947,29040453950,3,1628,2045,0
29046153534,29046153534,0,993,1628,0
29048923583,29048923585,2,1329,1651,0
29052831103,29052831105,2,1518,1547,0
29055351518,29055351516,-2,1063,1638,0
29063643090,29063643091,1,1119,1012,0
29065993534,29065993537,3,1810,1868,0
29068511997,29068511998,1,1320,2203,0
29071069227,29071069228,1,1364,2010,0
29071863203,29071863205,2,1111,1605,0
29073285286,29073285287,1,757,1361,0
29075410870,29075410871,1,2008,2094,0
29075611982,29075611983,1,1357,2099,0
29077185166,29077185166,0,833,1516,0
29077724622,29077724622,0,1332,1704,0
29081872173,29081872174,1,1629,2073,0
29083022196,29083022193,-3,1251,1357,0
29084379082,29084379084,2,1332,2001,0
29086271330,29086271330,0,1094,983,0
29094910061,29094910062,1,1535,1966,0
29100322298,29100322297,-1,1129,1871,0
29100642411,29100642413,2,1502,1702,0
29101590131,29101590134,3,1146,1102,0
29103739718,29103739717,-1,1050,2294,0
29104021734,29104021735,1,1149,1672,0
29108017058,29108017058,0,1291,1444,0
29113050507,29113050509,2,1428,1534,0
29113455264,29113455264,0,1664,2021,0
29114735800,29114735800,0,1405,1899,0
29117038034,29117038034,0,1626,1307,0
29118642644,29118642638,-6,863,2818,0
29124737418,29124737418,0,1345,2513,0
29125897750,29125897753,3,1069,1622,0
29129841038,29129841038,0,1407,1804,0
29130440553,29130440554,1,1339,1444,0
29131145695,29131145693,-2,1168,1220,0
29131546827,29131546826,-1,1649,1707,0
29132284747,29132284748,1,1247,1878,0
29133210167,29133210166,-1,1325,1917,0
29136571143,29136571138,-5,963,4188,0
29136779246,29136779266,20,881,1749,0
29140719651,29140719651,0,1424,1883,0
29142096946,29142096946,0,1629,2396,0
29144245026,29144245028,2,1045,1317,0
29145728309,29145728309,0,1466,2087,0
29146483278,29146483281,3,989,1192,0
29150672574,29150672567,-7,2165,7041,0
29154169869,29154169871,2,1690,1888,0
29155266268,29155266267,-1,1455,1215,0
29157764499,29157764500,1,753,1214,0
29159505371,29159505371,0,1312,1485,0
29159964822,29159964823,1,1401,1159,0
29160948274,29160948274,0,787,970,0
29165806006,29165806005,-1,1200,1893,0
29166981658,29166981659,1,691,1302,0
29167445598,29167445598,0,1103,1887,0
29167966901,29167966883,-18,1157,1196,0
29169388021,29169388026,5,2588,1638,0
29170383071,29170383074,3,1082,1584,0
29174191846,29174191846,0,1306,1025,0
29175996256,29175996256,0,1809,1411,0
29179242801,29179242805,4,1340,1212,0
29179967972,29179967973,1,1794,2080,0
29180390575,29180390578,3,1876,1935,0
29180585474,29180585475,1,1334,1890,0
29180907981,29180907982,1,1374,1688,0
29181595286,29181595284,-2,845,1927,0
29183239547,29183239546,-1,1135,1569,0
29188180537,29188180537,0,2400,1609,0
29190237935,29190237935,0,1504,1197,0
29190593737,29190593737,0,1667,1728,0
29191607897,29191607898,1,1250,1718,0
29193997534,29193997535,1,1468,2090,0
29195422846,29195422846,0,1591,1917,0
29197061807,29197061807,0,942,1232,0
29200085110,29200085113,3,1339,1507,0
29206194790,29206194790,0,905,1488,0
29207538322,29207538336,14,16019,53630,0
29208353510,29208353511,1,1250,1865,0
29208497343,29208497343,0,823,1533,0
29210898830,29210898830,0,822,1449,0
29210933221,29210933239,18,165,884,0
29211619231,29211619230,-1,1106,1713,0
29212295478,29212295481,3,1746,1705,0
29214911751,29214911751,0,1415,1903,0
29217360253,29217360255,2,1782,2038,0
29217700819,29217700822,3,1409,1766,0
29218233812,29218233813,1,1362,1541,0
29220266206,29220266206,0,2517,4545,0
29221427395,29221427393,-2,1271,1471,0
29224623914,29224623920,6,1581,2145,0
29228013198,29228013201,3,943,1558,0
29232223909,29232223912,3,1724,1889,0
29233271210,29233271191,-19,1164,1598,0
29234169481,29234169482,1,1561,1639,0
29237954148,29237954153,5,2250,1569,0
29242221814,29242221810,-4,1083,2960,0
29253111262,29253111263,1,1364,1395,0
29257056770,29257056770,0,1356,1536,0
29257895187,29257895188,1,1584,1784,0
29258403282,29258403282,0,1656,1827,0
29260806823,29260806822,-1,1521,1668,0
29261995367,29261995365,-2,856,1401,0
29267456685,29267456686,1,1436,1751,0
29268078034,29268078034,0,2101,2592,0
29269793228,29269793228,0,1723,1646,0
29270873730,29270873731,1,1150,1768,0
29271862900,29271862900,0,1259,1778,0
29280472937,29280472938,1,1100,1457,0
29281917189,29281917187,-2,22566,8977,0
29285329738,29285329739,1,1664,1984,0
29287970894,29287970894,0,1424,1375,0
29288910470,29288910472,2,2010,2358,0
29300201178,29300201179,1,854,956,0
29300789198,29300789199,1,1645,1830,0
29302821962,29302821964,2,1041,1238,0
29304391738,29304391738,0,1142,2127,0
29308595970,29308595970,0,1010,989,0
29312869348,29312869349,1,1313,1542,0
29313086239,29313086227,-12,1157,1195,0
29313534578,29313534577,-1,1306,2312,0
29322090405,29322090406,1,1167,1756,0
29324423130,29324423130,0,1428,1934,0
29324766116,29324766117,1,734,1260,0
29326111496,29326111498,2,1424,1711,0
29330586438,29330586438,0,1053,1749,0
29331716662,29331716661,-1,1777,2200,0
29331847184,29331847185,1,1392,1328,0
29333272496,29333272487,-9,1310,1875,0
29334523745,29334523749,4,1791,1397,0
29335028551,29335028549,-2,1257,2902,0
29335491385,29335491383,-2,1449,3331,0
29335967179,29335967178,-1,1433,1516,0
29336841881,29336841881,0,1552,2017,0
29337783107,29337783108,1,1814,1547,0
29338981333,29338981334,1,1218,2156,0
29343538252,29343538250,-2,1301,1339,0
29343810147,29343810147,0,1475,1733,0
29344117898,29344117901,3,1581,2377,0
29345638795,29345638793,-2,966,1733,0
29346963386,29346963384,-2,1320,1655,0
29358079482,29358079481,-1,1009,1622,0
29365130302,29365130305,3,1745,2159,0
29367229157,29367229159,2,1604,1840,0
29369931398,29369931397,-1,36204,38333,0
29373633030,29373633030,0,1434,1823,0
29375573027,29375573019,-8,1083,891,0
29377852166,29377852168,2,1293,972,0
29378499715,29378499717,2,1365,1683,0
29378914306,29378914308,2,1709,2091,0
29379345363,29379345361,-2,1577,1834,0
29379919714,29379919714,0,1927,2155,0
29380671658,29380671659,1,1423,1429,0
29386616565,29386616565,0,1388,2009,0
29386930382,29386930383,1,898,1312,0
29389132498,29389132498,0,1559,1849,0
29392369060,29392369055,-5,1386,1713,0
29392524796,29392524798,2,1189,1033,0
29393833399,29393833399,0,829,1069,0
29394107174,29394107174,0,1283,1481,0
29396953337,29396953338,1,1092,1559,0
29399244413,29399244417,4,1433,1638,0
29403294694,29403294694,0,1233,1724,0
29406162408,29406162411,3,1158,1479,0
29407970784,29407970785,1,1438,1707,0
29409943558,29409943558,0,2568,2191,0
29412813819,29412813819,0,1352,1933,0
29413260915,29413260914,-1,1604,1546,0
29419797478,29419797482,4,1488,1432,0
29427094533,29427094525,-8,35825,13201,0
29429439015,29429439017,2,1177,1645,0
29432373469,29432373470,1,1420,2624,0
29434363080,29434363080,0,1875,2245,0
29435011852,29435011853,1,1533,1675,0
29436724683,29436724684,1,1541,1843,0
29440004081,29440004082,1,1600,1860,0
29449839144,29449839144,0,1203,1617,0
29453759410,29453759407,-3,1188,1947,0
29454834453,29454834453,0,1495,1341,0
29455105130,29455105130,0,1484,1191,0
29459101774,29459101773,-1,1543,1662,0
29460751775,29460751775,0,1159,1520,0
29463095647,29463095647,0,1187,1377,0
29463228221,29463228222,1,1626,1648,0
29464113478,29464113480,2,1542,1409,0
29464589841,29464589842,1,1333,1606,0
29468913151,29468913150,-1,910,1491,0
29473406212,29473406206,-6,37606,13308,0
29473456478,29473456478,0,655,925,0
29475086478,29475086477,-1,1226,1875,0
29475350341,29475350357,16,2407,10559,0
29479341985,29479341986,1,1157,1335,0
29480629314,29480629332,18,790,1202,0
29482744893,29482744893,0,1925,2108,0
29484407598,29484407598,0,1321,1309,0
29485083695,29485083682,-13,1190,1573,0
29486197918,29486197918,0,947,1744,0
29486229212,29486229214,2,1484,1352,0
29488603486,29488603485,-1,1746,2083,0
29489904535,29489904536,1,1278,1279,0
29492811885,29492811882,-3,1092,1810,0
29493027104,29493027107,3,1462,1348,0
29494111031,29494111033,2,1452,2448,0
29502613506,29502613509,3,1160,1776,0
29505522085,29505522085,0,1603,2120,0
29509499579,29509499579,0,751,1122,0
29512247712,29512247711,-1,2113,1858,0
29515574965,29515574966,1,1358,1336,0
29516677742,29516677743,1,1182,1591,0
29521749925,29521749926,1,23409,21797,0
29525110259,29525110260,1,1073,1329,0
29527989663,29527989661,-2,1853,2035,0
29528580064,29528580065,1,1725,2124,0
29531629115,29531629115,0,1524,1533,0
29533151703,29533151703,0,1397,1546,0
29535524699,29535524697,-2,1081,1427,0
29535779408,29535779408,0,1731,2013,0
29540388585,29540388583,-2,651,782,0
29542068101,29542068106,5,3012,1628,0
29545450929,29545450930,1,1429,1444,0
29548665956,29548665955,-1,932,1182,0
29549218722,29549218721,-1,1080,1678,0
29549867701,29549867723,22,1193,1426,0
29551326301,29551326294,-7,1451,4707,0
29553315287,29553315287,0,1842,1822,0
29555174719,29555174718,-1,1825,1703,0
29555639295,29555639296,1,1011,1920,0
29556793158,29556793159,1,1110,1261,0
29558659696,29558659686,-10,997,2283,0
29563090363,29563090365,2,1229,1795,0
29563258518,29563258520,2,1319,1687,0
29566333274,29566333275,1,1153,1844,0
29568446447,29568446446,-1,1597,1611,0
29569495743,29569495743,0,1633,1748,0
29582070525,29582070524,-1,1455,1434,0
29584139446,29584139447,1,1117,1352,0
29587505197,29587505199,2,35137,22296,0
29589908131,29589908131,0,1456,1122,0
29590759691,29590759693,2,942,1341,0
29593080383,29593080382,-1,1227,1464,0
29594752873,29594752875,2,1327,1191,0
29595116918,29595116926,8,1728,1252,0
29595453649,29595453649,0,1248,2097,0
29596749922,29596749920,-2,1291,1985,0
29596785617,29596785618,1,1031,1234,0
29597903517,29597903522,5,1765,709,0
29599916697,29599916697,0,1641,2169,0
29601708414,29601708415,1,1118,1566,0
29603053007,29603053014,7,3092,1539,0
29606209606,29606209606,0,1331,1466,0
29608765675,29608765678,3,1243,1849,0
29614176151,29614176154,3,1395,1747,0
29614267395,29614267397,2,1647,1559,0
29616856610,29616856606,-4,7403,13841,0
29618723207,29618723210,3,2524,1667,0
29624673082,29624673078,-4,996,1333,0
29626295687,29626295688,1,1279,1543,0
29629935197,29629935197,0,1330,1825,0
29642187025,29642187026,1,1853,2243,0
29643313653,29643313654,1,1454,1166,0
29645212327,29645212326,-1,1294,1570,0
29646145765,29646145768,3,1140,1540,0
29648497711,29648497713,2,1762,1409,0
29649978547,29649978527,-20,1472,1872,0
29651730282,29651730283,1,1666,1799,0
29652765311,29652765311,0,832,1815,0
29652870836,29652870848,12,157,4412,0
29653710150,29653710170,20,1233,1911,0
29655000874,29655000876,2,1199,1631,0
29657716585,29657716583,-2,1492,1818,0
29660401447,29660401446,-1,1268,1640,0
29661878330,29661878330,0,1416,1598,0
29662066066,29662066067,1,1211,1874,0
29666037238,29666037237,-1,1232,2110,0
29666304690,29666304691,1,1515,1529,0
29672138453,29672138452,-1,1367,2092,0
29674628191,29674628185,-6,1281,6432,0
29675004439,29675004432,-7,1489,1257,0
29681560876,29681560877,1,1490,1482,0
29681871073,29681871073,0,1100,1891,0
29683913645,29683913646,1,1474,1371,0
29684656807,29684656806,-1,1423,1609,0
29685098425,29685098423,-2,1322,1501,0
29685187056,29685187042,-14,1069,997,0
29685610542,29685610543,1,1339,1557,0
29687917575,29687917577,2,1214,1358,0
29689696779,29689696780,1,1231,1991,0
29691325250,29691325251,1,1195,1437,0
29694373650,29694373649,-1,1358,1834,0
29694426186,29694426190,4,3086,1605,0
29695034309,29695034312,3,1403,1719,0
29696325643,29696325643,0,1477,1711,0
29696785307,29696785311,4,3377,1711,0
29698569506,29698569509,3,717,1794,0
29699002259,29699002261,2,1415,2133,0
29700606267,29700606278,11,15190,28444,0
29700943638,29700943631,-7,6919,28526,0
29702377950,29702377952,2,1385,1454,0
29702981426,29702981427,1,1269,1517,0
29704315983,29704315982,-1,1323,1303,0
29711642866,29711642865,-1,1714,2039,0
29712338689,29712338689,0,1464,1333,0
29716165083,29716165084,1,1695,1838,0
29716533511,29716533511,0,1245,1911,0
29718723915,29718723913,-2,1347,2251,0
29719337759,29719337778,19,1548,1695,0
29720505226,29720505220,-6,1247,2029,0
29720583533,29720583532,-1,1106,1262,0
29721584525,29721584525,0,1509,1566,0
29725614502,29725614502,0,1226,1631,0
29726682733,29726682734,1,765,1224,0
29727275669,29727275671,2,1922,1575,0
29733144654,29733144654,0,2063,2406,0
29733692915,29733692916,1,1122,1225,0
29736078750,29736078750,0,831,1218,0
29742102980,29742102981,1,1281,1623,0
29743158079,29743158081,2,1372,1517,0
29745028475,29745028475,0,1342,1905,0
29745560231,29745560232,1,1402,1651,0
29749031744,29749031745,1,12813,14023,0
29754763564,29754763565,1,1743,1854,0
29758072470,29758072466,-4,1501,4078,0
29764576609,29764576615,6,1663,951,0
29767610666,29767610665,-1,1183,1618,0
29770697414,29770697413,-1,1295,1651,0
29775946002,29775946000,-2,979,1800,0
29777370663,29777370659,-4,1014,1956,0
29778564542,29778564541,-1,1352,1933,0
29783758263,29783758260,-3,46588,32866,0
29784122073,29784122072,-1,1436,1618,0
29784517880,29784517877,-3,2486,3292,0
29786615042,29786615041,-1,827,862,0
29789485936,29789485938,2,1519,1247,0
29791360774,29791360774,0,1532,2081,0
29791452763,29791452764,1,1051,1438,0
29793708131,29793708129,-2,1333,1425,0
29796037543,29796037544,1,1059,1312,0
29800427686,29800427684,-2,1638,1667,0
29800851441,29800851441,0,17831,6825,0
29801326238,29801326232,-6,684,3803,0
29808991911,29808991912,1,1560,1887,0
29809028866,29809028863,-3,1383,1911,0
29812264649,29812264650,1,1410,1266,0
29814537165,29814537166,1,1448,1627,0
29816819975,29816819976,1,1375,1550,0
29821747678,29821747679,1,1240,1657,0
29822474277,29822474274,-3,2351,4564,0
29823956830,29823956831,1,2385,2179,0
29826693475,29826693476,1,1233,1714,0
29827508053,29827508054,1,1156,1555,0
29829691364,29829691366,2,1687,1670,0
29829836057,29829836058,1,1489,1811,0
29838672599,29838672598,-1,1589,1202,0
29838873150,29838873151,1,1344,1303,0
29839243501,29839243503,2,1871,2276,0
29840858731,29840858732,1,1495,1636,0
29843612448,29843612449,1,1476,1476,0
29844385601,29844385598,-3,1167,2151,0
29848191019,29848191020,1,846,1704,0
29850372546,29850372549,3,2611,1913,0
29853062713,29853062721,8,1837,1137,0
29853222943,29853222943,0,983,1889,0
29854972142,29854972141,-1,918,1462,0
29855868194,29855868194,0,1150,1891,0
29858357976,29858357976,0,1854,1781,0
29860699755,29860699763,8,759,785,0
29861798634,29861798629,-5,765,4066,0
29862542442,29862542442,0,1346,1535,0
29865848734,29865848747,13,1207,1741,0
29867444913,29867444914,1,2988,2958,0
29868568281,29868568282,1,1420,1663,0
29869505294,29869505298,4,1640,1178,0
29873587887,29873587889,2,2355,1449,0
29874455806,29874455810,4,926,1390,0
29876362123,29876362118,-5,2050,5625,0
29879697431,29879697435,4,945,991,0
29882381093,29882381094,1,1330,1947,0
29887999617,29887999619,2,1051,1022,0
29889030110,29889030111,1,1489,1663,0
29891017587,29891017587,0,815,1654,0
29891362149,29891362149,0,105,1285,0
29895480161,29895480162,1,1582,1627,0
29899660678,29899660678,0,1655,1821,0
29900678073,29900678071,-2,1034,1355,0
29900915206,29900915206,0,970,1699,0
29900983006,29900983012,6,2359,803,0
29903953515,29903953514,-1,1723,2154,0
29905689781,29905689781,0,1790,2321,0
29906502295,29906502296,1,1393,1682,0
29912338250,29912338250,0,962,1155,0
29915600453,29915600454,1,1961,1758,0
29920020151,29920020152,1,686,1044,0
29920969195,29920969205,10,589,1661,0
29921605638,29921605623,-15,91,410,0
29926195657,29926195657,0,1516,1866,0
29929108278,29929108275,-3,915,1574,0
29929281079,29929281081,2,1549,1517,0
29930034807,29930034809,2,1832,1891,0
29930891981,29930891985,4,1381,1202,0
29933139664,29933139663,-1,1177,1534,0
29933889219,29933889219,0,1685,1973,0
29934943092,29934943092,0,1164,1790,0
29935227802,29935227780,-22,2231,814,0
29936556985,29936556986,1,2239,1771,0
29936610985,29936610984,-1,890,2114,0
29937477338,29937477337,-1,1520,1694,0
29937752686,29937752686,0,1318,1742,0
29942034735,29942034735,0,1305,1378,0
29943554346,29943554346,0,1453,1885,0
29943829308,29943829306,-2,1335,2161,0
29944694410,29944694409,-1,1539,2029,0
29944952666,29944952648,-18,1024,1489,0
29946241877,29946241877,0,1905,2217,0
29948125682,29948125682,0,1094,1591,0
29949067468,29949067470,2,1805,1784,0
29949326605,29949326605,0,1219,1890,0
29950403365,29950403365,0,1610,1759,0
29953599475,29953599476,1,1760,2404,0
29954050074,29954050074,0,1357,982,0
29956587491,29956587493,2,1391,1594,0
29956747957,29956747957,0,1131,1143,0
29957983810,29957983810,0,1012,2250,0
29960012138,29960012138,0,1415,2331,0
29960808622,29960808623,1,1111,1376,0
29963192597,29963192598,1,1366,1488,0
29963406978,29963406978,0,1063,1256,0
29963845441,29963845443,2,1612,1253,0
29966921795,29966921795,0,1373,1960,0
29967078831,29967078831,0,1547,1431,0
29969762841,29969762839,-2,1413,1465,0
29971224127,29971224126,-1,2647,3324,0
29972750957,29972750956,-1,1015,2099,0
29975150468,29975150468,0,1875,2403,0
29979909973,29979909974,1,684,1436,0
29982028098,29982028098,0,1304,1390,0
29985582654,29985582655,1,1609,2099,0
29986111946,29986111949,3,1175,1329,0
29986639797,29986639797,0,1128,1262,0
29987460018,29987460017,-1,938,1195,0
29988534978,29988534980,2,1454,1898,0
29989292503,29989292502,-1,1301,1585,0
29990015491,29990015494,3,1794,1371,0
29990371048,29990371048,0,1266,1769,0
29990809296,29990809296,0,1383,1921,0
29991702736,29991702739,3,2587,1832,0
30001816787,30001816785,-2,1439,1836,0
30002133822,30002133824,2,2342,1493,0
30002795645,30002795644,-1,1235,1457,0
30003565910,30003565911,1,1542,1624,0
30005022143,30005022142,-1,1371,2141,0
30007340411,30007340413,2,1631,1821,0
30009589738,30009589741,3,1132,1668,0
30010349803,30010349805,2,1108,1575,0
30011382061,30011382062,1,1919,1568,0
30020109047,30020109047,0,1364,1294,0
30021040951,30021040942,-9,30394,13981,0
30023131951,30023131951,0,1948,1371,0
30025086134,30025086133,-1,1525,2125,0
30025283802,30025283810,8,1225,1266,0
30029382158,30029382158,0,1522,1490,0
30030525151,30030525151,0,1395,1324,0
30032990633,30032990634,1,1953,2098,0
30039856009,30039856009,0,1588,2386,0
30040030128,30040030104,-24,1469,1974,0
30040616770,30040616770,0,2584,3313,0
30053991876,30053991879,3,1874,1469,0
30056907190,30056907189,-1,1296,2533,0
30057986493,30057986495,2,1153,1319,0
30058926010,30058926010,0,1716,2482,0
30059520336,30059520336,0,1419,1463,0
30060310494,30060310497,3,1747,2104,0
30061002413,30061002415,2,1635,1402,0
30064508197,30064508197,0,1513,2316,0
30066430293,30066430294,1,1546,2215,0
30066623517,30066623514,-3,1403,1724,0
30068132618,30068132615,-3,1734,3348,0
30073595757,30073595758,1,1473,1829,0
30073726855,30073726856,1,1302,1477,0
30074259561,30074259553,-8,1112,6566,0
30076015735,30076015736,1,1493,1978,0
30077478887,30077478887,0,1093,1008,0
30077606067,30077606067,0,1817,1594,0
30080801430,30080801430,0,619,1682,0
30083356105,30083356105,0,1229,1721,0
30083535237,30083535239,2,1737,1705,0
30084613527,30084613528,1,913,967,0
30086308949,30086308950,1,1468,1834,0
30086764589,30086764588,-1,1234,1342,0
30093780175,30093780175,0,1139,1616,0
30094269560,30094269557,-3,62,1026,0
30094567889,30094567903,14,18362,30987,0
30103312242,30103312243,1,1530,1918,0
30103733265,30103733263,-2,1690,1537,0
30108016393,30108016390,-3,1133,2443,0
30109123070,30109123071,1,1906,1768,0
30110817409,30110817409,0,1274,1696,0
30111224418,30111224417,-1,1290,2016,0
30111508394,30111508394,0,1299,1443,0
30111667245,30111667231,-14,764,1375,0
30116457193,30116457173,-20,1756,1923,0
30121397127,30121397129,2,1984,1752,0
30122841017,30122841018,1,1733,1542,0
30123030853,30123030854,1,1538,1327,0
30129777905,30129777905,0,1905,1873,0
30130930086,30130930087,1,1117,1867,0
30131720214,30131720215,1,1578,1997,0
30132613426,30132613426,0,1267,1473,0
30138053250,30138053251,1,2113,2236,0
30141729802,30141729803,1,1036,1049,0
30142620599,30142620576,-23,4047,2400,0
30143291511,30143291513,2,1287,2246,0
30147286165,30147286164,-1,1554,1890,0
30149623350,30149623354,4,2533,1566,0
30151120614,30151120615,1,1211,1699,0
30153033979,30153033985,6,1609,1353,0
30154525401,30154525402,1,1275,1897,0
30157013838,30157013840,2,1169,1885,0
30161750251,30161750250,-1,1633,1986,0
30162305581,30162305577,-4,1173,2567,0
30164696291,30164696291,0,1662,2326,0
30167871280,30167871279,-1,1231,1700,0
30168044990,30168044990,0,1596,1486,0
30169642809,30169642811,2,954,898,0
30172830797,30172830798,1,1244,1858,0
30174113982,30174113981,-1,827,1143,0
30175176230,30175176230,0,901,1570,0
30175911901,30175911894,-7,888,1268,0
30177814244,30177814245,1,1396,2115,0
30178761180,30178761180,0,1184,1553,0
30179214578,30179214581,3,829,2247,0
30183554329,30183554330,1,1200,919,0
30184774850,30184774852,2,1375,1764,0
30189139047,30189139050,3,1041,799,0
30189754823,30189754819,-4,760,1796,0
30192677213,30192677212,-1,1704,1693,0
30193708903,30193708902,-1,936,1319,0
30193861438,30193861439,1,980,1238,0
30195415614,30195415615,1,1269,2279,0
30195473798,30195473798,0,1349,1132,0
30196113148,30196113128,-20,1335,1462,0
30198749289,30198749294,5,1889,849,0
30199063007,30199063009,2,1247,1876,0
30199134290,30199134287,-3,1202,1627,0
30200576470,30200576466,-4,802,1184,0
30201654422,30201654422,0,1306,2159,0
30203285210,30203285209,-1,1022,1210,0
30203577983,30203577970,-13,1108,1174,0
30204409878,30204409874,-4,1091,1741,0
30210356021,30210356026,5,3055,1673,0
30211626145,30211626143,-2,1279,1762,0
30212708074,30212708074,0,854,1301,0
30213560603,30213560606,3,1305,1770,0
30218474241,30218474240,-1,748,1797,0
30219209778,30219209778,0,1881,1976,0
30223546775,30223546776,1,1676,1850,0
30225088288,30225088286,-2,1974,2010,0
30228287849,30228287855,6,6183,1687,0
30231937654,30231937654,0,1223,1502,0
30234220792,30234220793,1,1355,1305,0
30240935442,30240935442,0,1476,1388,0
30241585846,30241585846,0,1322,2267,0
30241726023,30241726022,-1,1676,1582,0
30242380086,30242380087,1,1199,1153,0
30242887417,30242887419,2,1082,1533,0
30243831700,30243831702,2,1550,1910,0
30245380818,30245380818,0,1354,1270,0
30248255692,30248255694,2,1704,1795,0
30248362765,30248362766,1,1869,1929,0
30249547441,30249547442,1,1597,1205,0
30250484539,30250484538,-1,1167,2194,0
30253776130,30253776130,0,1028,1256,0
30255262710,30255262708,-2,1394,1845,0
30257387286,30257387293,7,1590,1083,0
30259302819,30259302821,2,1453,1241,0
30262208218,30262208218,0,1424,1711,0
30263457750,30263457746,-4,1274,4160,0
30264423622,30264423623,1,1787,1826,0
30264970507,30264970509,2,1210,1655,0
30267847073,30267847074,1,1816,1807,0
30271115769,30271115775,6,3723,1220,0
30273498642,30273498642,0,1051,1678,0
30273699464,30273699466,2,1306,1729,0
30280765979,30280765979,0,856,1467,0
30289353103,30289353105,2,1484,2047,0
30290971395,30290971398,3,2295,965,0
30294497386,30294497391,5,1548,1346,0
30300536329,30300536330,1,1375,1663,0
30303872142,30303872141,-1,1226,1513,0
30305826122,30305826123,1,1141,1804,0
30306062452,30306062453,1,1947,1636,0
30308376378,30308376379,1,35664,16838,0
30309310040,30309310033,-7,1932,7763,0
30310064270,30310064270,0,1303,1450,0
30313261659,30313261660,1,1140,1509,0
30316107613,30316107614,1,671,1292,0
30317430739,30317430740,1,1293,1531,0
30318427121,30318427125,4,678,1512,0
30319898725,30319898726,1,1157,1040,0
30322080680,30322080681,1,1059,1458,0
30323093378,30323093378,0,1745,1541,0
30323294836,30323294835,-1,1229,1938,0
30323703338,30323703337,-1,1569,1740,0
30324856327,30324856325,-2,1572,1817,0
30326037050,30326037048,-2,1110,2064,0
30327075073,30327075074,1,1269,1628,0
30329052093,30329052079,-14,244,680,0
30329841190,30329841188,-2,1149,1833,0
30335883365,30335883361,-4,1424,4138,0
30336148098,30336148098,0,1365,1608,0
30336453926,30336453919,-7,1073,1300,0
30338595097,30338595098,1,1284,1614,0
30341624939,30341624939,0,1631,1791,0
30342636481,30342636479,-2,1089,1464,0
30344007931,30344007930,-1,1138,1772,0
30347750462,30347750463,1,1370,1739,0
30349287910,30349287912,2,1467,2006,0
30351284023,30351284023,0,1385,1572,0
30353352660,30353352663,3,1793,1782,0
30356197870,30356197871,1,2152,2186,0
30357863334,30357863334,0,1481,1999,0
30359011705,30359011710,5,1343,1180,0
30361410326,30361410327,1,1325,1225,0
30361562758,30361562759,1,1465,2036,0
30362907152,30362907149,-3,1027,1450,0
30363677753,30363677754,1,1322,1326,0
30365812053,30365812054,1,1113,2397,0
30367499939,30367499940,1,1362,1739,0
30369558730,30369558729,-1,1486,2144,0
30370147518,30370147537,19,1189,1148,0
30372543820,30372543820,0,1237,1519,0
30374971524,30374971524,0,1171,1400,0
30375566562,30375566561,-1,818,1460,0
30378090418,30378090417,-1,4286,6788,0
30379708489,30379708489,0,1300,1172,0
30381153426,30381153426,0,1076,1712,0
30386044455,30386044454,-1,1695,1450,0
30387205538,30387205541,3,1285,1273,0
30387288719,30387288720,1,1459,1673,0
30387380789,30387380791,2,1248,1593,0
30390882163,30390882157,-6,728,1434,0
30396540307,30396540306,-1,1018,1150,0
30397322789,30397322790,1,1769,1679,0
30397803778,30397803778,0,1230,1388,0
30397977579,30397977580,1,921,1458,0
30400860389,30400860395,6,3145,1161,0
30402841851,30402841852,1,1509,1421,0
30405375469,30405375449,-20,1668,1480,0
30411085023,30411085026,3,2223,1675,0
30411326013,30411326014,1,1184,1214,0
30412441557,30412441563,6,2184,1047,0
30413587058,30413587057,-1,1554,1655,0
30415171779,30415171780,1,1092,1606,0
30416779955,30416779957,2,863,931,0
30419548816,30419548818,2,1973,1629,0
30419675422,30419675438,16,1165,1365,0
30422235699,30422235698,-1,1308,1456,0
30423612662,30423612663,1,1550,1425,0
30424274110,30424274109,-1,1596,1538,0
30426639155,30426639150,-5,29399,13143,0
30427523006,30427523009,3,1631,1902,0
30429830919,30429830921,2,1629,1485,0
30430246678,30430246679,1,1362,1253,0
30430550178,30430550175,-3,1606,1872,0
30433899990,30433899991,1,1368,1708,0
30436238001,30436238002,1,1059,1523,0
30436397916,30436397915,-1,986,1005,0
30437195754,30437195757,3,1228,1292,0
30439698337,30439698337,0,1082,921,0
30443436475,30443436476,1,1021,1475,0
30445928446,30445928445,-1,1415,1510,0
30447269030,30447269031,1,898,1700,0
30448291565,30448291564,-1,834,1589,0
30452611034,30452611034,0,1571,2139,0
30453140423,30453140423,0,1571,2363,0
30453544490,30453544492,2,1604,1261,0
30453888986,30453888986,0,1572,1397,0
30456504221,30456504222,1,1597,1560,0
30456549061,30456549066,5,3995,1234,0
30456968935,30456968919,-16,1141,1100,0
30457187806,30457187807,1,1298,1730,0
30458965643,30458965646,3,1928,2348,0
30459838719,30459838718,-1,1377,2102,0
30460296064,30460296062,-2,1557,2351,0
30461251747,30461251746,-1,1118,1865,0
30461991353,30461991353,0,1067,1644,0
30462110858,30462110857,-1,903,1261,0
30462397934,30462397934,0,1416,1586,0
30465417361,30465417363,2,1149,1127,0
30467380614,30467380614,0,1440,1911,0
30467737614,30467737615,1,1271,1588,0
30467850691,30467850689,-2,1379,2163,0
30468942220,30468942222,2,1534,1083,0
30469626356,30469626357,1,1178,2250,0
30475850383,30475850381,-2,1074,2891,0
30478193511,30478193511,0,960,1899,0
30478533927,30478533927,0,829,1534,0
30478988989,30478988969,-20,1450,1631,0
30479055127,30479055126,-1,1217,2169,0
30487210854,30487210855,1,1834,1242,0
30489086839,30489086841,2,952,1039,0
30490865933,30490865934,1,1685,1861,0
30492880867,30492880868,1,1268,1577,0
30498109199,30498109179,-20,1265,1558,0
30498999629,30498999651,22,1193,1255,0
30500983957,30500983959,2,1145,1925,0
30504034682,30504034681,-1,979,1542,0
30509454411,30509454411,0,971,1232,0
30512393456,30512393457,1,1524,2027,0
30514406067,30514406065,-2,742,1904,0
30516217103,30516217105,2,1300,1474,0
30516775635,30516775634,-1,1680,2108,0
30518928437,30518928430,-7,1899,11087,0
30523716259,30523716260,1,904,965,0
30524370097,30524370099,2,1326,1840,0
30525437107,30525437106,-1,1121,1796,0
30525486427,30525486426,-1,1526,1743,0
30526493210,30526493214,4,1410,1342,0
30526800350,30526800352,2,1294,1823,0
30531335886,30531335887,1,1283,2242,0
30534429062,30534429062,0,1480,2066,0
30535273882,30535273883,1,1263,1575,0
30540474097,30540474097,0,1333,1476,0
30541276535,30541276536,1,1262,1376,0
30543977644,30543977646,2,1847,1588,0
30544492278,30544492281,3,1270,1862,0
30547441207,30547441208,1,1082,1282,0
30549647968,30549647971,3,8704,16402,0
30549872091,30549872091,0,1455,1998,0
30550369695,30550369695,0,1048,1486,0
30550560245,30550560246,1,1396,1429,0
30551296002,30551296002,0,1099,1747,0
30553346046,30553346042,-4,925,1815,0
30553495538,30553495537,-1,1037,1329,0
30560308067,30560308068,1,1017,1433,0
30561335558,30561335559,1,1264,1538,0
30564258727,30564258729,2,1719,1760,0
30564391788,30564391790,2,1259,1797,0
30566649445,30566649445,0,1424,1508,0
30567744966,30567744964,-2,1090,1175,0
30569252792,30569252794,2,1514,1479,0
30569867571,30569867569,-2,1183,1977,0
30570304628,30570304629,1,1501,1986,0
30572993494,30572993490,-4,1879,2496,0
30576052675,30576052674,-1,996,1072,0
30576752997,30576752995,-2,1183,1768,0
30582196448,30582196449,1,1297,1588,0
30582648230,30582648229,-1,2215,2135,0
30583040111,30583040113,2,1658,1825,0
30583593415,30583593417,2,1252,1563,0
30583956850,30583956849,-1,2170,2349,0
30592034026,30592034026,0,8645,11366,0
30598783339,30598783340,1,727,951,0
30601945353,30601945354,1,1261,1623,0
30602097485,30602097507,22,2025,2096,0
30603235909,30603235909,0,1114,1740,0
30606954294,30606954294,0,1502,2015,0
30608461981,30608461980,-1,1389,1805,0
30612237770,30612237771,1,975,1486,0
30619603420,30619603413,-7,1269,2959,0
30619677029,30619677026,-3,263,560,0
30620902510,30620902509,-1,1640,2143,0
30623448219,30623448221,2,1251,1221,0
30624500712,30624500719,7,2050,876,0
30627265822,30627265823,1,1044,1833,0
30629837470,30629837474,4,1816,1143,0
30629869838,30629869838,0,1379,1850,0
30630768186,30630768188,2,1469,1651,0
30630959696,30630959688,-8,51222,13678,0
30633397442,30633397443,1,1521,2022,0
30633954819,30633954821,2,1109,1325,0
30634624172,30634624156,-16,1249,674,0
30636439634,30636439634,0,1051,1673,0
30637990764,30637990763,-1,1401,1545,0
30639054482,30639054489,7,3966,1123,0
30642418645,30642418645,0,1205,1624,0
30644471398,30644471398,0,1250,1519,0
30645526913,30645526918,5,3556,1638,0
30647133765,30647133766,1,1366,1752,0
30648977937,30648977931,-6,1135,4052,0
30650473503,30650473506,3,4246,3369,0
30651430158,30651430157,-1,1569,1592,0
30653214426,30653214426,0,1517,1469,0
30656326287,30656326287,0,464,913,0
30659863689,30659863689,0,1094,1487,0
30660613953,30660613956,3,2255,1988,0
30663247669,30663247670,1,1574,975,0
30668324737,30668324739,2,1124,1413,0
30672374202,30672374202,0,1361,1097,0
30673900426,30673900436,10,1094,1443,0
30676517578,30676517579,1,1896,2201,0
30678239283,30678239284,1,1464,1695,0
30678470982,30678470982,0,1557,2050,0
30679474880,30679474881,1,1116,589,0
30686064401,30686064400,-1,1311,1755,0
30690037186,30690037187,1,1233,2144,0
30690181827,30690181827,0,1244,1194,0
30690952115,30690952113,-2,896,1238,0
30693924054,30693924053,-1,1154,1129,0
30697307714,30697307716,2,1508,1411,0
30702423405,30702423408,3,3907,3004,0
30702480041,30702480040,-1,1786,2107,0
30702817535,30702817535,0,1335,1514,0
30705191815,30705191815,0,1344,1554,0
30705645569,30705645569,0,1647,2692,0
30707874323,30707874326,3,783,654,0
30713214348,30713214348,0,1701,1619,0
30713284854,30713284853,-1,1226,2411,0
30715152211,30715152209,-2,1161,2242,0
30716314350,30716314347,-3,1027,1591,0
30717700854,30717700837,-17,90,1289,0
30718126203,30718126211,8,2688,1035,0
30723649706,30723649705,-1,798,1534,0
30728029343,30728029345,2,1707,1566,0
30728264978,30728264956,-22,998,1693,0
30728877237,30728877241,4,1074,1260,0
30729701937,30729701939,2,2249,2352,0
30729829835,30729829835,0,701,1177,0
30731237386,30731237387,1,1225,1306,0
30732641669,30732641670,1,1370,1527,0
30734317293,30734317295,2,1798,1654,0
30734405408,30734405408,0,1844,1961,0
30740235490,30740235489,-1,917,926,0
30742043894,30742043894,0,1183,1608,0
30742275937,30742275938,1,1031,1463,0
30745085334,30745085335,1,1278,1678,0
30746896831,30746896834,3,1108,1560,0
30747237429,30747237429,0,1814,2309,0
30747947634,30747947632,-2,1282,2073,0
30750609866,30750609866,0,1051,1487,0
30750736147,30750736146,-1,709,865,0
30752001425,30752001427,2,1513,1811,0
30752603613,30752603615,2,979,1229,0
30756927295,30756927295,0,1833,1836,0
30757210628,30757210630,2,1317,1750,0
30763532128,30763532131,3,2222,1388,0
30764133790,30764133790,0,2060,2213,0
30764998454,30764998453,-1,1486,1670,0
30767381408,30767381409,1,1168,1561,0
30769716026,30769716026,0,1195,1701,0
30771579650,30771579649,-1,1053,1812,0
30771725890,30771725890,0,1457,1386,0
30771780025,30771780026,1,1398,1345,0
30772699500,30772699502,2,1715,1516,0
30773105414,30773105411,-3,2441,5302,0
30773229366,30773229367,1,1267,1612,0
30775862571,30775862570,-1,1286,1958,0
30781035440,30781035441,1,1623,2024,0
30782689741,30782689744,3,967,1197,0
30785579871,30785579871,0,1103,1414,0
30785923188,30785923186,-2,993,1666,0
30789854530,30789854529,-1,2102,2021,0
30791386363,30791386362,-1,1404,2162,0
30793045365,30793045369,4,1499,1771,0
30793108809,30793108806,-3,963,2875,0
30795140341,30795140340,-1,1755,1355,0
30797643550,30797643549,-1,1325,1693,0
30799853647,30799853653,6,4757,3107,0
30804015246,30804015245,-1,1417,2219,0
30805288426,30805288426,0,1177,1642,0
30810705106,30810705106,0,1258,1751,0
30812370991,30812370991,0,1157,1668,0
30814467746,30814467767,21,460,82,0
30816166311,30816166314,3,1895,1132,0
30816894967,30816894966,-1,2041,2113,0
30823424510,30823424510,0,1324,1863,0
30825946081,30825946082,1,1268,1378,0
30827154380,30827154382,2,2181,1846,0
30828338097,30828338098,1,1544,1913,0
30828427386,30828427389,3,1277,2077,0
30832236542,30832236543,1,1435,1326,0
30835680621,30835680624,3,1662,1528,0
30836387563,30836387563,0,1236,2142,0
30839625840,30839625841,1,1563,2446,0
30840959643,30840959642,-1,1659,2187,0
30842327346,30842327349,3,1392,1076,0
30845834123,30845834123,0,1531,1787,0
30846185995,30846185996,1,1490,1559,0
30847268670,30847268673,3,1468,1159,0
30848135239,30848135218,-21,1418,1957,0
30848662983,30848662983,0,1881,2094,0
30853533249,30853533250,1,1500,1614,0
30857174770,30857174770,0,1754,1982,0
30857717294,30857717298,4,1715,1587,0
30861234879,30861234880,1,1342,1632,0
30869681752,30869681754,2,3339,2353,0
30870859830,30870859829,-1,1012,1307,0
30871805207,30871805207,0,1479,2223,0
30873174701,30873174701,0,1441,1601,0
30873853032,30873853050,18,354,1707,0
30873996541,30873996542,1,2155,2318,0
30874440766,30874440769,3,1315,1697,0
30875025862,30875025863,1,1419,1388,0
30875078236,30875078252,16,1021,1793,0
30875523217,30875523217,0,1245,1978,0
30883586498,30883586499,1,1513,2029,0
30885521030,30885521032,2,1359,1621,0
30889925870,30889925869,-1,1103,1427,0
30890707663,30890707662,-1,1441,2958,0
30891438198,30891438199,1,1844,1710,0
30894735580,30894735583,3,1730,2003,0
30895491984,30895491985,1,2387,2085,0
30896233060,30896233061,1,1043,1771,0
30899060835,30899060835,0,1221,1451,0
30899609310,30899609311,1,1227,1206,0
30900351217,30900351219,2,1435,920,0
30900744002,30900744002,0,776,1706,0
30903335789,30903335791,2,1312,1652,0
30905659945,30905659942,-3,2234,4894,0
30906362209,30906362211,2,1260,1479,0
30906491541,30906491544,3,1272,1638,0
30906719041,30906719046,5,2497,1080,0
30907443639,30907443639,0,1056,1375,0
30908523639,30908523639,0,715,1264,0
30913144749,30913144748,-1,1072,1558,0
30914572173,30914572177,4,910,923,0
30918764393,30918764395,2,1181,1240,0
30922972755,30922972752,-3,1192,3289,0
30932081814,30932081817,3,14918,13112,0
30932428029,30932428031,2,1556,1435,0
30937756180,30937756178,-2,982,2286,0
30938928498,30938928497,-1,1004,1185,0
30939164682,30939164690,8,60721,129917,0
30939801959,30939801960,1,1417,1901,0
30940376419,30940376418,-1,1360,2058,0
30942172270,30942172269,-1,923,1670,0
30943437566,30943437567,1,762,1329,0
30944640691,30944640686,-5,1173,2866,0
30951406293,30951406291,-2,1517,2028,0
30952398047,30952398046,-1,1491,1991,0
30954039634,30954039632,-2,1343,1913,0
30954254777,30954254779,2,1001,1066,0
30955043528,30955043530,2,1512,1151,0
30955867283,30955867283,0,1852,1914,0
30958361672,30958361670,-2,1926,2135,0
30960163677,30960163679,2,1508,1650,0
30962711021,30962711024,3,1403,1389,0
30963838117,30963838114,-3,1258,1101,0
30965656454,30965656453,-1,1270,1907,0
30969518201,30969518198,-3,1042,1344,0
30971945302,30971945302,0,973,1893,0
30975123459,30975123459,0,858,1295,0
30976274650,30976274652,2,1556,1494,0
30977541893,30977541894,1,1192,1304,0
30980024854,30980024859,5,3328,3051,0
30981261198,30981261182,-16,129,5232,0
30983290421,30983290422,1,1664,1165,0
30984859472,30984859471,-1,1298,1839,0
30987054417,30987054415,-2,1151,1483,0
30988769784,30988769786,2,2058,2780,0
30992406044,30992406038,-6,27427,16290,0
30994460821,30994460822,1,1535,1789,0
30999858436,30999858442,6,1661,987,0
31000717644,31000717645,1,1206,1410,0
31004090619,31004090616,-3,1111,2618,0
31004621586,31004621586,0,2015,2298,0
31004907841,31004907843,2,1475,1646,0
31007736030,31007736031,1,1182,1123,0
31010573369,31010573371,2,1019,1538,0
31012071895,31012071897,2,1271,1281,0
31017466816,31017466817,1,1534,1715,0
31020273138,31020273141,3,2079,1010,0
31022182974,31022182977,3,1617,1537,0
31023160995,31023160995,0,1511,2097,0
31023762329,31023762330,1,1446,1949,0
31024883832,31024883833,1,1239,1297,0
31026150992,31026150995,3,2271,1573,0
31026664028,31026664028,0,1277,1895,0
31038642461,31038642460,-1,929,1435,0
31040048563,31040048558,-5,954,2628,0
31040206007,31040206009,2,1144,1804,0
31044385787,31044385788,1,1729,2212,0
31044870890,31044870892,2,1227,1728,0
31045590665,31045590666,1,1545,1680,0
31048212847,31048212848,1,1218,1916,0
31049533642,31049533643,1,1298,1724,0
31049986398,31049986400,2,1461,1764,0
31050535661,31050535662,1,1184,1497,0
31051981030,31051981019,-11,3456,1446,0
31052757898,31052757899,1,1002,1672,0
31055262125,31055262127,2,1768,1618,0
31056180639,31056180640,1,1283,1767,0
31056799498,31056799498,0,1099,1342,0
31060763406,31060763394,-12,1398,616,0
31061425430,31061425431,1,1396,1427,0
31065486515,31065486522,7,1420,1528,0
31066106958,31066106959,1,1631,1915,0
31067088679,31067088680,1,2052,2487,0
31067768994,31067769002,8,2444,1269,0
31076652987,31076652984,-3,1034,2370,0
31078155202,31078155204,2,2379,2233,0
31090163717,31090163718,1,1925,2211,0
31095463110,31095463108,-2,1390,1983,0
31095622934,31095622936,2,1120,1594,0
31098118893,31098118894,1,1357,1797,0
31100064181,31100064182,1,1582,2011,0
31102831925,31102831927,2,1279,926,0
31104134410,31104134413,3,1293,1967,0
31104484238,31104484240,2,1368,1995,0
31106827667,31106827667,0,1023,914,0
31109485027,31109485027,0,1585,1624,0
31110034730,31110034731,1,2291,1651,0
31110253273,31110253278,5,66046,90344,0
31111588220,31111588218,-2,1288,1503,0
31113478814,31113478810,-4,1424,2671,0
31121438446,31121438446,0,1122,1584,0
31123895699,31123895701,2,1513,1089,0
31124844166,31124844167,1,1319,2253,0
31125173127,31125173122,-5,2385,5969,0
31127847098,31127847098,0,1475,1607,0
31129047698,31129047702,4,3342,2603,0
31130344326,31130344328,2,1539,2129,0
31134971197,31134971198,1,1239,1647,0
31136360682,31136360684,2,1354,1685,0
31138337390,31138337390,0,1647,1534,0
31140151362,31140151360,-2,1273,1901,0
31141943162,31141943166,4,1853,1305,0
31142216230,31142216231,1,1705,1618,0
31146635886,31146635889,3,767,1216,0
31148814648,31148814646,-2,1044,1168,0
31150642061,31150642080,19,2181,1249,0
31152818733,31152818734,1,2168,2463,0
31155350729,31155350730,1,1545,2017,0
31156134065,31156134067,2,1818,1816,0
31157935722,31157935722,0,1360,1347,0
31158774543,31158774543,0,1235,1721,0
31160154931,31160154930,-1,935,1433,0
31160820055,31160820052,-3,808,1732,0
31164880765,31164880766,1,1531,1604,0
31165703693,31165703694,1,1492,1532,0
31170156580,31170156580,0,941,1818,0
31172960335,31172960335,0,1925,2619,0
31173786390,31173786391,1,1035,1418,0
31175026085,31175026089,4,1409,1768,0
31175345039,31175345038,-1,2029,1969,0
31176051628,31176051627,-1,1644,1730,0
31178150652,31178150656,4,2898,1637,0
31179579588,31179579589,1,1395,1398,0
31181676495,31181676495,0,1447,1628,0
31184088463,31184088459,-4,1100,1813,0
31186835903,31186835897,-6,1070,4558,0
31188152318,31188152310,-8,1496,8376,0
31192657116,31192657117,1,1755,1718,0
31193034681,31193034682,1,1527,2253,0
31194680477,31194680499,22,1330,1514,0
31196469942,31196469944,2,1271,1054,0
31198450518,31198450517,-1,922,1645,0
31199696327,31199696326,-1,1370,1665,0
31200099673,31200099673,0,1648,1769,0
31201132508,31201132510,2,1263,1574,0
31202023786,31202023785,-1,1364,1656,0
31205789979,31205789980,1,1193,1929,0
31208814294,31208814294,0,1296,1434,0
31209666302,31209666303,1,1183,1370,0
31211223623,31211223625,2,620,1000,0
31211611514,31211611514,0,1361,1536,0
31213784350,31213784349,-1,1390,1864,0
31214370288,31214370290,2,1211,1163,0
31215421902,31215421902,0,1387,1562,0
31220528277,31220528278,1,1476,2351,0
31221345839,31221345838,-1,1009,1108,0
31222317262,31222317265,3,1276,1890,0
31222588894,31222588895,1,1434,1986,0
31231607068,31231607061,-7,1659,4354,0
31240106070,31240106069,-1,1114,1390,0
31242349334,31242349334,0,1275,1651,0
31243779144,31243779143,-1,955,1348,0
31245794307,31245794307,0,1247,1223,0
31248491201,31248491200,-1,1782,2464,0
31249689912,31249689912,0,1250,1353,0
31250233855,31250233858,3,1174,1983,0
31252789274,31252789275,1,1234,1259,0
31254232750,31254232750,0,951,1133,0
31254774489,31254774488,-1,1693,1821,0
31255208145,31255208145,0,1347,1600,0
31257780541,31257780544,3,1207,1564,0
31259785437,31259785437,0,1198,1609,0
31260768501,31260768494,-7,333,1026,0
31262848154,31262848150,-4,1256,1490,0
31264038142,31264038141,-1,1216,1509,0
31265542451,31265542454,3,1263,1498,0
31266007278,31266007278,0,4555,16244,0
31267505638,31267505638,0,1646,1724,0
31271352935,31271352934,-1,824,1207,0
31274845093,31274845094,1,1810,2152,0
31280615370,31280615373,3,1422,1952,0
31284952679,31284952678,-1,887,1112,0
31286002988,31286002969,-19,587,1747,0
31286736631,31286736633,2,2751,3176,0
31288014986,31288014985,-1,1570,1317,0
31289561828,31289561828,0,1329,1394,0
31290883838,31290883839,1,1143,1477,0
31292125905,31292125908,3,1373,1602,0
31298423148,31298423149,1,1201,1162,0
31299659033,31299659034,1,1561,1830,0
31301922664,31301922665,1,1460,2101,0
31302292549,31302292549,0,1147,1698,0
31313500362,31313500366,4,1484,1636,0
31319327423,31319327427,4,1806,1657,0
31322560162,31322560159,-3,1189,1802,0
31325782042,31325782043,1,2052,1884,0
31328201633,31328201633,0,1357,1519,0
31328822663,31328822663,0,1166,1719,0
31329539472,31329539472,0,1328,1816,0
31335139790,31335139790,0,1090,1049,0
31335767968,31335767970,2,1232,1760,0
31335841101,31335841103,2,1542,1883,0
31335977858,31335977857,-1,1270,1818,0
31337135730,31337135731,1,1286,1689,0
31339118334,31339118335,1,1168,1270,0
31342586924,31342586924,0,652,1012,0
31343627615,31343627617,2,1247,1226,0
31346687241,31346687242,1,1490,2351,0
31348635842,31348635838,-4,784,3566,0
31349343886,31349343885,-1,1420,1581,0
31349581133,31349581134,1,1228,1342,0
31352266966,31352266967,1,1303,1260,0
31353369297,31353369297,0,1765,1370,0
31357535410,31357535409,-1,1018,1105,0
31358705817,31358705817,0,1071,1476,0
31360586818,31360586818,0,1417,1826,0
31364471242,31364471241,-1,2090,2306,0
31368212637,31368212638,1,1028,2159,0
31368825402,31368825402,0,810,1651,0
31370908591,31370908590,-1,597,942,0
31371713886,31371713887,1,1309,1755,0
31375530775,31375530776,1,1204,945,0
31376649213,31376649213,0,1464,2345,0
31378893315,31378893317,2,1881,1215,0
31382916461,31382916461,0,2081,2359,0
31383633620,31383633621,1,1258,1528,0
31384098957,31384098945,-12,1346,2206,0
31385170761,31385170761,0,1763,1937,0
31386670387,31386670386,-1,1392,1862,0
31389423946,31389423947,1,2379,2164,0
31390709883,31390709884,1,1736,1905,0
31393689873,31393689870,-3,1402,2302,0
31394002845,31394002844,-1,1625,1521,0
31397130905,31397130907,2,1459,2105,0
31400840932,31400840931,-1,1965,2455,0
31402004307,31402004308,1,775,1098,0
31402807610,31402807614,4,1153,1095,0
31404285846,31404285847,1,1485,1459,0
31410534989,31410534988,-1,1049,1584,0
31411390997,31411390999,2,2422,2640,0
31413001065,31413001066,1,1859,1544,0
31415098347,31415098347,0,1030,1644,0
31417643918,31417643917,-1,1414,2006,0
31418116990,31418116990,0,1274,1773,0
31420695973,31420695979,6,2959,1830,0
31423176821,31423176825,4,1125,1674,0
31425875006,31425875008,2,1263,1810,0
31431799745,31431799745,0,1142,1465,0
31435572491,31435572495,4,2005,1546,0
31435743891,31435743889,-2,4,252,0
31436122335,31436122335,0,1229,1972,0
31436793552,31436793551,-1,1559,1371,0
31438586063,31438586061,-2,828,1643,0
31439656251,31439656251,0,858,1652,0
31446230338,31446230340,2,1153,1317,0
31449724226,31449724227,1,1497,1651,0
31451839094,31451839092,-2,1046,1295,0
31454701622,31454701614,-8,576,1337,0
31454739625,31454739626,1,1097,1776,0
31457202162,31457202162,0,1786,2241,0
31457439591,31457439592,1,1291,1406,0
31458190602,31458190610,8,3397,1472,0
31460668577,31460668578,1,1400,1957,0
31461084325,31461084347,22,1420,1507,0
31462632044,31462632045,1,1713,2315,0
31463524921,31463524922,1,1642,1399,0
31463802002,31463802005,3,1072,1310,0
31464655270,31464655268,-2,1035,1668,0
31465593462,31465593463,1,590,870,0
31466414863,31466414863,0,1999,1702,0
31468777141,31468777142,1,1780,1907,0
31468844588,31468844592,4,1819,1279,0
31470884449,31470884449,0,1671,1587,0
31476557081,31476557081,0,1098,1076,0
31479997213,31479997214,1,1955,2299,0
31482162718,31482162718,0,1897,1897,0
31484111042,31484111044,2,1339,1168,0
31485154117,31485154123,6,2094,962,0
31487681489,31487681486,-3,1536,2081,0
31490137897,31490137898,1,499,1168,0
31493735537,31493735534,-3,1208,1823,0
31494450135,31494450118,-17,1508,1921,0
31497936108,31497936127,19,1413,2116,0
31499805028,31499805027,-1,1515,1620,0
31499943482,31499943485,3,2517,1707,0
31500784270,31500784270,0,1215,1172,0
31507109805,31507109806,1,1254,1714,0
31507459757,31507459761,4,1978,1576,0
31510061890,31510061889,-1,1368,1238,0
31511115003,31511115004,1,1381,1943,0
31514228290,31514228271,-19,1916,1025,0
31514481110,31514481110,0,1676,1691,0
31517705032,31517705032,0,1781,2055,0
31520673140,31520673143,3,1169,1749,0
31521404010,31521404011,1,1525,1742,0
31522493554,31522493533,-21,1211,947,0
31522979166,31522979167,1,3028,2807,0
31525287901,31525287901,0,1055,1894,0
31525613076,31525613099,23,719,932,0
31525941298,31525941298,0,1157,1327,0
31526380929,31526380933,4,1412,1227,0
31526652746,31526652745,-1,1165,1812,0
31527146245,31527146245,0,1577,1890,0
31528283648,31528283650,2,1234,1445,0
31528807181,31528807181,0,1411,880,0
31534574259,31534574260,1,1398,1365,0
31536965750,31536965749,-1,1141,2533,0
31538326446,31538326447,1,1564,1689,0
31544224398,31544224398,0,1429,2046,0
31545517769,31545517769,0,1584,1498,0
31545989550,31545989554,4,4307,1604,0
31547425182,31547425174,-8,824,2026,0
31547832146,31547832146,0,1730,1776,0
31552037796,31552037795,-1,1343,2196,0
31553729126,31553729125,-1,893,1432,0
31554062382,31554062381,-1,1367,1331,0
31554657468,31554657466,-2,936,913,0
31555942570,31555942573,3,1619,1840,0
31557879792,31557879790,-2,1852,1227,0
31558520847,31558520846,-1,1482,1999,0
31561272367,31561272369,2,1013,1588,0
31562129326,31562129327,1,1409,1579,0
31565506381,31565506382,1,1374,1558,0
31565969654,31565969654,0,1616,1907,0
31566469313,31566469314,1,1732,1586,0
31574843871,31574843873,2,1190,1668,0
31575009787,31575009788,1,1585,2173,0
31575054735,31575054735,0,1312,1629,0
31575877409,31575877411,2,1877,2206,0
31577930513,31577930513,0,1315,1571,0
31578621673,31578621675,2,1241,1275,0
31583354376,31583354377,1,968,1975,0
31585041183,31585041185,2,1508,1884,0
31585696117,31585696118,1,2063,1596,0
31586769828,31586769829,1,1481,1798,0
31593652828,31593652832,4,1391,1034,0
31599783432,31599783434,2,1613,2021,0
31599899714,31599899715,1,1041,1176,0
31606194067,31606194066,-1,1202,1352,0
31608553418,31608553419,1,1386,1653,0
31612692083,31612692086,3,1802,1264,0
31614927467,31614927470,3,1535,1638,0
31616895876,31616895875,-1,941,1324,0
31617138773,31617138775,2,1236,1215,0
31618722935,31618722935,0,1082,1841,0
31623218243,31623218221,-22,1446,1775,0
31626102376,31626102378,2,2454,3087,0
31626847574,31626847575,1,1808,1879,0
31630618466,31630618473,7,4434,2064,0
31631861186,31631861186,0,1396,1830,0
31635147806,31635147806,0,1602,2002,0
31635382435,31635382430,-5,2316,7429,0
31635983916,31635983918,2,1438,1563,0
31637124895,31637124894,-1,1766,2143,0
31640187131,31640187130,-1,3882,4341,0
31642864834,31642864828,-6,2809,7920,0
31643192294,31643192314,20,1478,2123,0
31644560546,31644560545,-1,1811,1520,0
31652844265,31652844263,-2,1249,1372,0
31654771953,31654771953,0,1361,1656,0
31656480177,31656480181,4,1563,1823,0
31657623844,31657623838,-6,1348,4798,0
31657809874,31657809876,2,1928,2078,0
31658419821,31658419819,-2,1295,1696,0
31662797943,31662797946,3,1399,1491,0
31663311522,31663311523,1,1472,2157,0
31665531879,31665531882,3,26423,37625,0
31671522835,31671522835,0,1563,2231,0
31674158837,31674158835,-2,795,2031,0
31676398195,31676398197,2,1911,1783,0
31679980462,31679980465,3,1514,1368,0
31680511223,31680511225,2,1259,1653,0
31680564060,31680564060,0,1035,1560,0
31681212064,31681212063,-1,1053,1516,0
31683848380,31683848379,-1,1326,1363,0
31684529559,31684529559,0,895,1370,0
31691060226,31691060226,0,1017,1874,0
31692781627,31692781627,0,1027,1780,0
31695452850,31695452851,1,1142,1509,0
31696471922,31696471917,-5,951,2022,0
31696616326,31696616327,1,768,1038,0
31699502278,31699502279,1,1424,1639,0
31701247673,31701247673,0,1823,2078,0
31704804882,31704804881,-1,1319,1376,0
31708101550,31708101552,2,1607,2101,0
31709765476,31709765478,2,1499,1781,0
31711645826,31711645828,2,2081,2051,0
31713143914,31713143914,0,1301,1572,0
31713687187,31713687187,0,1096,1308,0
31713888661,31713888657,-4,1293,1175,0
31716067891,31716067893,2,1685,1981,0
31717640590,31717640589,-1,1262,1386,0
31718000418,31718000417,-1,887,1989,0
31718336025,31718336026,1,1823,2396,0
31721828010,31721828010,0,1044,1846,0
31723961044,31723961041,-3,1338,2654,0
31725207811,31725207811,0,1190,1188,0
31726919257,31726919258,1,1210,1299,0
31727141835,31727141835,0,1397,1939,0
31727196459,31727196461,2,1174,1558,0
31727979630,31727979631,1,1384,2244,0
31732214537,31732214538,1,827,1615,0
31735123034,31735123045,11,1298,1261,0
31735633947,31735633947,0,2106,1970,0
31739843512,31739843510,-2,1666,2228,0
31740129401,31740129402,1,2007,1959,0
31741240348,31741240359,11,1215,1701,0
31745633932,31745633934,2,1945,1469,0
31752056570,31752056573,3,1336,1426,0
31752483113,31752483111,-2,945,838,0
31753513757,31753513757,0,1735,1775,0
31757339165,31757339167,2,1257,1604,0
31757683398,31757683392,-6,1848,1385,0
31758389452,31758389451,-1,1348,1635,0
31761467191,31761467194,3,1673,824,0
31762347325,31762347325,0,1279,1952,0
31764189638,31764189639,1,1525,2076,0
31769273666,31769273648,-18,1297,936,0
31771749494,31771749494,0,1201,1851,0
31773247823,31773247824,1,1502,1640,0
31774864886,31774864889,3,1211,1356,0
31775286135,31775286136,1,885,1050,0
31777276707,31777276714,7,9595,32315,0
31780951866,31780951865,-1,2641,4286,0
31783667559,31783667561,2,890,1169,0
31784094029,31784094028,-1,1579,1750,0
31784149353,31784149353,0,1411,1529,0
31784242385,31784242399,14,1148,1732,0
31791077858,31791077858,0,892,1200,0
31791641015,31791641014,-1,1430,1633,0
31794229237,31794229238,1,1415,857,0
31798027709,31798027711,2,1454,1654,0
31800254977,31800254977,0,1646,1842,0
31801526639,31801526640,1,1111,1396,0
31802716262,31802716261,-1,1106,1201,0
31803698364,31803698387,23,957,1291,0
31805896518,31805896517,-1,1446,1650,0
31807043709,31807043708,-1,1238,2209,0
31809812638,31809812639,1,1529,1948,0
31813379065,31813379066,1,749,1660,0
31823593509,31823593509,0,1406,1891,0
31823701487,31823701485,-2,946,2164,0
31825856478,31825856479,1,1020,1096,0
31826199054,31826199057,3,1384,1384,0
31829010077,31829010078,1,1308,1784,0
31832861391,31832861391,0,1394,1300,0
31833795130,31833795109,-21,1735,2151,0
31834240686,31834240692,6,1073,710,0
31835434119,31835434118,-1,1291,1971,0
31835654952,31835654950,-2,1100,1226,0
31836584649,31836584650,1,1042,1255,0
31836947820,31836947817,-3,231,4295,0
31837763477,31837763473,-4,916,2346,0
31839824995,31839824996,1,1210,1738,0
31840434192,31840434193,1,1114,2617,0
31841042011,31841042017,6,3093,1143,0
31842541956,31842541958,2,34664,17304,0
31843808894,31843808895,1,1155,1111,0
31844236994,31844236994,0,1503,1215,0
31849076659,31849076658,-1,1677,1968,0
31849326099,31849326099,0,2122,2009,0
31852829571,31852829571,0,1244,1729,0
31853550534,31853550533,-1,1784,1843,0
31858259412,31858259413,1,1736,1986,0
31860594411,31860594414,3,2857,1417,0
31861167804,31861167806,2,1617,1440,0
31867293994,31867293995,1,1224,1175,0
31868990430,31868990430,0,1110,1943,0
31869110037,31869110038,1,1792,1474,0
31873261615,31873261614,-1,1926,2163,0
31875221327,31875221326,-1,1510,2509,0
31875660993,31875660993,0,1375,1942,0
31876507528,31876507529,1,2410,1542,0
31880788943,31880788943,0,828,800,0
31881549728,31881549728,0,1732,2331,0
31882521777,31882521799,22,1463,1959,0
31883406413,31883406412,-1,1941,2273,0
31884711266,31884711267,1,1364,1394,0
31884858158,31884858159,1,1729,1570,0
31886224333,31886224334,1,1306,1316,0
31889425812,31889425813,1,1704,1529,0
31891957715,31891957714,-1,926,1025,0
31893461463,31893461461,-2,901,1679,0
31893931694,31893931710,16,371,1394,0
31895220935,31895220935,0,1015,925,0
31896250390,31896250390,0,984,1189,0
31900335338,31900335339,1,1278,1548,0
31904159596,31904159595,-1,595,1362,0
31905619176,31905619175,-1,913,1293,0
31907999981,31907999980,-1,2539,2920,0
31910367590,31910367593,3,1825,1684,0
31911556602,31911556603,1,986,1596,0
31912127725,31912127710,-15,1150,1795,0
31912469387,31912469386,-1,1371,1071,0
31913772457,31913772459,2,1726,1878,0
31914072420,31914072427,7,2663,1084,0
31914438934,31914438934,0,1580,2140,0
31915046740,31915046741,1,1892,1439,0
31918016508,31918016509,1,1477,1476,0
31919019550,31919019551,1,1331,1488,0
31922724243,31922724243,0,755,1050,0
31929845818,31929845819,1,1778,1579,0
31929942957,31929942959,2,1523,1730,0
31931043487,31931043486,-1,1185,1858,0
31933418496,31933418490,-6,1203,4624,0
31933466375,31933466354,-21,1432,1499,0
31935328921,31935328920,-1,999,1562,0
31937699351,31937699351,0,1562,2791,0
31939437656,31939437655,-1,1007,1230,0
31941779314,31941779313,-1,1636,2029,0
31942241446,31942241449,3,1304,1363,0
31943754791,31943754793,2,1146,1292,0
31944022251,31944022251,0,1880,1600,0
31945540728,31945540732,4,1418,1277,0
31951897503,31951897503,0,766,1006,0
31952016068,31952016070,2,1402,1142,0
31952567579,31952567579,0,1303,1799,0
31954449077,31954449071,-6,1330,5146,0
31955297298,31955297297,-1,1149,2068,0
31958593474,31958593475,1,1431,1811,0
31966620171,31966620173,2,2061,2622,0
31969565871,31969565871,0,1545,1440,0
31970195209,31970195210,1,1238,1681,0
31971219165,31971219164,-1,1759,1811,0
31971304806,31971304821,15,1561,1357,0
31973133962,31973133962,0,1323,1371,0
31974759258,31974759262,4,1237,724,0
31977403767,31977403767,0,1633,1625,0
31983749218,31983749217,-1,2022,2472,0
31983904769,31983904769,0,1060,1625,0
31987000225,31987000230,5,1711,1060,0
31990086542,31990086543,1,682,1021,0
31994229349,31994229351,2,1874,1262,0
31998965806,31998965805,-1,945,1986,0
31999555882,31999555883,1,1242,2035,0
32000700254,32000700254,0,1576,1308,0
32006088355,32006088356,1,1378,1465,0
32007165644,32007165666,22,1009,1562,0
32007336445,32007336443,-2,1201,1776,0
32009673487,32009673489,2,1734,1654,0
32012905105,32012905104,-1,1579,2551,0
32013615235,32013615236,1,1886,2407,0
32013677519,32013677517,-2,1036,1795,0
32018539550,32018539550,0,892,1114,0
32019779527,32019779526,-1,1039,1791,0
32020840818,32020840837,19,2091,1307,0
32021888826,32021888827,1,1265,1775,0
32024807670,32024807679,9,1201,1126,0
32025587236,32025587238,2,1395,1975,0
32026368186,32026368189,3,1770,1562,0
32026543243,32026543237,-6,1466,4785,0
32027598270,32027598269,-1,1921,1570,0
32028126042,32028126046,4,1511,1346,0
32028885927,32028885922,-5,1178,2279,0
32037226906,32037226907,1,943,2032,0
32038991466,32038991467,1,1997,1989,0
32039090321,32039090327,6,1884,947,0
32039682106,32039682108,2,1476,1037,0
32043230758,32043230761,3,1387,1078,0
32044308267,32044308286,19,687,711,0
32046637444,32046637454,10,14224,20081,0
32047565779,32047565778,-1,1863,1969,0
32048246807,32048246809,2,1704,1887,0
32049909558,32049909551,-7,1530,8301,0
32055409218,32055409219,1,1335,1659,0
32055641973,32055641973,0,1088,1449,0
32057114166,32057114165,-1,1758,2208,0
32058003479,32058003477,-2,1394,2402,0
32062210098,32062210099,1,1475,1620,0
32062448530,32062448529,-1,1528,1510,0
32065430051,32065430051,0,1775,1703,0
32071352273,32071352274,1,1131,1877,0
32073392097,32073392098,1,1646,2161,0
32081631242,32081631241,-1,1077,1983,0
32082191007,32082191007,0,1142,1912,0
32085487641,32085487641,0,1788,2279,0
32085726462,32085726470,8,2658,1089,0
32086850931,32086850929,-2,1161,1481,0
32087775347,32087775343,-4,1020,3044,0
32087978213,32087978211,-2,1690,1901,0
32091283023,32091283026,3,1582,1867,0
32091407805,32091407804,-1,1125,1953,0
32091883126,32091883129,3,1418,1288,0
32093020697,32093020697,0,1241,1754,0
32093435766,32093435770,4,1575,1426,0
32096108863,32096108863,0,2169,2494,0
32096574965,32096574967,2,1669,1458,0
32097306999,32097307001,2,1997,1696,0
32098461365,32098461366,1,1519,2268,0
32098815926,32098815927,1,1372,2021,0
32099486165,32099486165,0,1491,1936,0
32101730375,32101730375,0,1197,1356,0
32107385675,32107385675,0,1805,1531,0
32112402333,32112402334,1,1327,1667,0
32117319389,32117319390,1,1182,1526,0
32117770373,32117770366,-7,106,4561,0
32119242011,32119242011,0,903,855,0
32124593456,32124593455,-1,1224,1635,0
32130184141,32130184142,1,984,1275,0
32134338302,32134338303,1,1161,1265,0
32136380718,32136380720,2,2511,1725,0
32140587048,32140587047,-1,1712,1881,0
32141264822,32141264819,-3,1320,1856,0
32142870070,32142870071,1,1337,1739,0
32143090954,32143090957,3,1669,1278,0
32145467202,32145467202,0,1065,2506,0
32148122302,32148122303,1,1842,1819,0
32148247531,32148247530,-1,902,1106,0
32149085433,32149085433,0,1975,2289,0
32153425529,32153425530,1,1245,2208,0
32156032611,32156032615,4,8077,28583,0
32156533833,32156533833,0,1116,1525,0
32157866539,32157866540,1,936,961,0
32159873890,32159873888,-2,1593,1616,0
32161232561,32161232566,5,8747,2223,0
32167310069,32167310070,1,1738,1597,0
32168470981,32168470981,0,1419,1880,0
32169323443,32169323443,0,1196,1675,0
32169625144,32169625145,1,859,1481,0
32170683982,32170683985,3,1497,1537,0
32170950610,32170950608,-2,1326,2171,0
32172209893,32172209894,1,1328,1216,0
32178335901,32178335899,-2,2086,2178,0
32179190678,32179190680,2,1868,1940,0
32183437552,32183437553,1,2196,1878,0
32183797034,32183797033,-1,974,1409,0
32187128923,32187128922,-1,1363,2112,0
32187901926,32187901925,-1,1601,1459,0
32188680771,32188680774,3,1390,1760,0
32192330199,32192330197,-2,1281,1712,0
32193211206,32193211208,2,1163,1134,0
32198530288,32198530295,7,944,893,0
32199294472,32199294476,4,1155,1041,0
32200173678,32200173679,1,1472,1794,0
32201593977,32201593978,1,1300,1689,0
32203640906,32203640908,2,921,1784,0
32204509661,32204509660,-1,1149,1802,0
32207058737,32207058741,4,2263,1782,0
32208041634,32208041614,-20,1383,1686,0
32210654994,32210654997,3,3535,3365,0
32215609136,32215609139,3,12618,11842,0
32216158933,32216158935,2,1191,1139,0
32219977682,32219977681,-1,900,1654,0
32224238558,32224238561,3,1088,1050,0
32225028623,32225028623,0,1837,1783,0
32225143350,32225143351,1,1024,1873,0
32225685833,32225685833,0,1402,1177,0
32227750626,32227750627,1,1747,1582,0
32227909678,32227909677,-1,1112,1313,0
32229380654,32229380654,0,1373,1691,0
32230039739,32230039741,2,1215,1777,0
32231299319,32231299318,-1,1185,1885,0
32232609564,32232609565,1,1025,1726,0
32233350647,32233350650,3,1576,1581,0
32234263587,32234263587,0,1031,2175,0
32238489544,32238489543,-1,1147,1488,0
32238728946,32238728948,2,1189,1399,0
32241927096,32241927097,1,1510,1709,0
32242173325,32242173326,1,1579,1876,0
32242333415,32242333415,0,828,945,0
32244147393,32244147397,4,1478,1200,0
32249107400,32249107400,0,1653,2498,0
32255659971,32255659970,-1,899,1160,0
32255889110,32255889112,2,1081,1772,0
32257555294,32257555294,0,1161,1932,0
32257697352,32257697370,18,1414,2064,0
32257796127,32257796130,3,1423,1177,0
32259916505,32259916509,4,5690,26743,0
32260244832,32260244831,-1,3038,4261,0
32262214336,32262214338,2,1103,1039,0
32266489326,32266489330,4,1347,1098,0
32269615732,32269615732,0,1240,1823,0
32269990638,32269990642,4,1398,1628,0
32277125643,32277125643,0,2201,2509,0
32278913194,32278913199,5,6042,23864,0
32280101530,32280101533,3,1335,824,0
32285485963,32285485961,-2,1017,1960,0
32286596621,32286596622,1,2189,2036,0
32289085965,32289085965,0,1146,1313,0
32289898642,32289898655,13,1182,1740,0
32293377917,32293377918,1,1251,1646,0
32294400271,32294400269,-2,971,1472,0
32295179142,32295179141,-1,1420,2769,0
32298063307,32298063307,0,1050,1556,0
32302232585,32302232585,0,1634,1831,0
32306637786,32306637789,3,1258,1495,0
32308018207,32308018210,3,1067,1171,0
32308337111,32308337111,0,1278,1377,0
32311298365,32311298366,1,1360,2345,0
32314210443,32314210442,-1,1296,1905,0
32314599780,32314599779,-1,1895,1634,0
32315694199,32315694199,0,1708,1853,0
32320579301,32320579301,0,1098,1741,0
32321301997,32321301998,1,1104,1608,0
32323183184,32323183187,3,1287,1402,0
32323895315,32323895315,0,1224,2179,0
32327757790,32327757788,-2,2488,5650,0
32330767338,32330767334,-4,1198,1881,0
32331303520,32331303539,19,1492,1512,0
32334408338,32334408341,3,1099,1690,0
32334840966,32334840968,2,1185,2154,0
32336362098,32336362093,-5,1521,2687,0
32337004648,32337004664,16,722,1491,0
32338357293,32338357294,1,2082,2270,0
32339117650,32339117649,-1,1559,2444,0
32339591490,32339591490,0,950,1371,0
32343291080,32343291081,1,1625,1438,0
32346044047,32346044046,-1,1289,1388,0
32346818103,32346818106,3,1395,1574,0
32347865353,32347865353,0,1796,1937,0
32350315922,32350315923,1,1073,1887,0
32351380222,32351380223,1,1080,1818,0
32356023087,32356023083,-4,1008,2886,0
32360859282,32360859282,0,1348,1998,0
32362133930,32362133930,0,827,1040,0
32363325863,32363325862,-1,779,1704,0
32367062522,32367062522,0,1089,1552,0
32371035278,32371035278,0,2205,1787,0
32374599257,32374599257,0,1702,1506,0
32378711703,32378711706,3,885,1017,0
32386656426,32386656426,0,1448,1556,0
32391811601,32391811602,1,1467,2532,0
32393046298,32393046297,-1,989,1606,0
32394157803,32394157803,0,1034,2337,0
32396175634,32396175634,0,1233,1372,0
32396794092,32396794087,-5,1543,1625,0
32397571535,32397571534,-1,1068,1569,0
32397607706,32397607706,0,1115,1484,0
32400293376,32400293377,1,1692,1844,0
32400975913,32400975912,-1,979,1994,0
32403930193,32403930194,1,1287,1460,0
32405763416,32405763415,-1,24423,9961,0
32409307820,32409307821,1,1024,1439,0
32410036079,32410036078,-1,802,986,0
32410372445,32410372442,-3,1861,4694,0
32410457925,32410457926,1,1278,1652,0
32410595660,32410595646,-14,949,1187,0
32410712905,32410712907,2,1030,1832,0
32413451457,32413451457,0,1208,1312,0
32415216896,32415216895,-1,1179,1650,0
32419609417,32419609417,0,1799,2013,0
32421203244,32421203246,2,1739,2311,0
32423592167,32423592167,0,1213,1173,0
32423862458,32423862459,1,2832,3067,0
32425588497,32425588500,3,1736,1836,0
32434116934,32434116936,2,1704,1848,0
32434348294,32434348295,1,1571,1705,0
32435197082,32435197082,0,1452,2432,0
32437198870,32437198870,0,1228,1823,0
32450383613,32450383613,0,1521,2283,0
32454427389,32454427390,1,1149,1745,0
32454811167,32454811167,0,1124,1576,0
32455184340,32455184339,-1,1496,1823,0
32456358799,32456358798,-1,1484,1784,0
32456948485,32456948484,-1,1360,1881,0
32457405936,32457405934,-2,1172,653,0
32459014691,32459014691,0,2097,2011,0
32459963261,32459963260,-1,1267,1865,0
32460377671,32460377673,2,1988,1780,0
32460569682,32460569683,1,1698,2006,0
32460690198,32460690201,3,1708,1841,0
32461693718,32461693722,4,2734,2328,0
32462881074,32462881074,0,1228,1703,0
32463214418,32463214419,1,1071,1804,0
32463445358,32463445356,-2,2132,4122,0
32464582831,32464582831,0,1423,2151,0
32465494662,32465494664,2,1380,1915,0
32467448335,32467448337,2,1019,1304,0
32468274146,32468274146,0,1185,1366,0
32468380073,32468380075,2,1342,1953,0
32468857275,32468857277,2,1326,1678,0
32472953130,32472953133,3,1277,1851,0
32473494626,32473494626,0,1517,1995,0
32474618578,32474618578,0,1102,1266,0
32474801878,32474801885,7,5593,2237,0
32478141290,32478141292,2,1206,1450,0
32478988389,32478988390,1,1198,970,0
32480267950,32480267954,4,1734,1493,0
32482711907,32482711906,-1,1180,2078,0
32485334098,32485334100,2,1483,1704,0
32486028680,32486028681,1,1468,1775,0
32486969726,32486969726,0,1224,1661,0
32487615601,32487615595,-6,1037,5742,0
32489660554,32489660553,-1,1134,1539,0
32492314754,32492314755,1,1294,1630,0
32494485142,32494485141,-1,1487,1555,0
32495706825,32495706827,2,1141,1926,0
32496410013,32496410010,-3,1465,1960,0
32497548591,32497548591,0,1255,1395,0
32498009973,32498009973,0,1351,1820,0
32498211022,32498211023,1,1007,1503,0
32511774007,32511774005,-2,1024,1249,0
32512856829,32512856848,19,944,1436,0
32512972589,32512972591,2,1635,1540,0
32515132362,32515132361,-1,1291,1845,0
32515835422,32515835428,6,4432,2904,0
32516674860,32516674845,-15,1286,1684,0
32519728185,32519728189,4,1948,1479,0
32521207628,32521207628,0,1552,1945,0
32523181427,32523181433,6,2600,1726,0
32525029715,32525029713,-2,1556,1692,0
32526507974,32526507972,-2,1134,2221,0
32530114587,32530114587,0,1635,1880,0
32531448080,32531448079,-1,1705,2050,0
32532082886,32532082887,1,1190,1363,0
32532715377,32532715375,-2,2175,1785,0
32534084372,32534084369,-3,2752,4503,0
32535609371,32535609373,2,1676,2250,0
32536766601,32536766603,2,1674,1819,0
32539099734,32539099734,0,1164,1586,0
32540571982,32540571986,4,1378,1962,0
32540760818,32540760819,1,1720,1746,0
32542473231,32542473233,2,1454,2095,0
32543468979,32543468979,0,1645,1371,0
32544116845,32544116845,0,1189,1608,0
32545232663,32545232664,1,1204,988,0
32546682778,32546682777,-1,753,1116,0
32549440786,32549440790,4,1696,1668,0
32552581885,32552581886,1,1702,2156,0
32554058590,32554058593,3,1734,1540,0
32554990266,32554990266,0,1486,2494,0
32555724330,32555724328,-2,1516,1587,0
32556399758,32556399775,17,174,1790,0
32564032841,32564032841,0,1273,1678,0
32564973210,32564973210,0,1844,1990,0
32571437132,32571437132,0,1677,2091,0
32573565536,32573565535,-1,1256,1346,0
32577539614,32577539615,1,1676,1870,0
32578618039,32578618041,2,1030,1624,0
32579950810,32579950812,2,1292,1326,0
32581764095,32581764095,0,1720,1910,0
32582903641,32582903663,22,783,1079,0
32583223166,32583223165,-1,1352,1928,0
32584007702,32584007703,1,1977,2097,0
32586154698,32586154698,0,1048,1031,0
32590533346,32590533346,0,1017,1597,0
32590683031,32590683029,-2,1175,1940,0
32591169817,32591169817,0,1685,1820,0
32591721342,32591721343,1,1130,1232,0
32592223616,32592223635,19,1366,1051,0
32595459317,32595459321,4,2141,1456,0
32603020224,32603020225,1,1746,1560,0
32604150430,32604150430,0,1330,1769,0
32604806990,32604806990,0,1882,1339,0
32606845775,32606845775,0,1743,2390,0
32615849886,32615849887,1,1060,1799,0
32617221134,32617221135,1,885,1494,0
32618859547,32618859560,13,1122,1265,0
32626734302,32626734305,3,1198,1416,0
32629849230,32629849230,0,864,940,0
32631174749,32631174753,4,4620,2852,0
32634102968,32634102962,-6,3283,9371,0
32637502610,32637502609,-1,1132,1162,0
32637722434,32637722437,3,1104,1062,0
32641056677,32641056666,-11,1423,2205,0
32641591901,32641591903,2,991,1827,0
32644162186,32644162185,-1,954,1310,0
32645781461,32645781463,2,211,1647,0
32648690998,32648691000,2,1427,1824,0
32651288731,32651288731,0,805,1191,0
32651386795,32651386795,0,960,1264,0
32653975358,32653975352,-6,3178,7227,0
32656671175,32656671176,1,1348,2094,0
32659639424,32659639426,2,1327,1625,0
32661496430,32661496431,1,1260,1615,0
32664241250,32664241253,3,740,1721,0
32668116989,32668116991,2,1695,1302,0
32669680812,32669680813,1,1664,2088,0
32672230652,32672230655,3,1696,1351,0
32676028741,32676028738,-3,1101,1356,0
32676908593,32676908593,0,1426,2108,0
32678093091,32678093091,0,1428,1538,0
32681127065,32681127052,-13,596,473,0
32684257170,32684257170,0,1434,1252,0
32686437761,32686437761,0,1918,2277,0
32686829595,32686829593,-2,1634,1630,0
32687603907,32687603907,0,944,1394,0
32688522734,32688522733,-1,568,766,0
32692086827,32692086830,3,839,814,0
32701763528,32701763533,5,1649,1181,0
32701881093,32701881093,0,2047,2509,0
32703515644,32703515642,-2,1429,1890,0
32705448489,32705448488,-1,1250,1828,0
32706310164,32706310163,-1,1136,2081,0
32706353061,32706353066,5,3124,1179,0
32710736170,32710736170,0,1147,1678,0
32711803210,32711803211,1,1146,1614,0
32712288414,32712288413,-1,946,1668,0
32713521173,32713521172,-1,1966,1881,0
32720539405,32720539406,1,1389,1563,0
32722835043,32722835045,2,1408,1616,0
32728610528,32728610527,-1,1259,2089,0
32729229382,32729229381,-1,1020,2476,0
32734085910,32734085911,1,1517,1752,0
32736050155,32736050154,-1,1723,1957,0
32737562691,32737562691,0,1132,1919,0
32743848391,32743848391,0,1346,2323,0
32745603094,32745603092,-2,2107,1902,0
32747611211,32747611211,0,1114,1038,0
32749241693,32749241693,0,1557,1933,0
32751644914,32751644913,-1,912,1928,0
32752602662,32752602660,-2,1504,2387,0
32753131599,32753131598,-1,1478,1519,0
32758673755,32758673757,2,1238,1107,0
32760673902,32760673902,0,1244,1610,0
32761518277,32761518279,2,1371,1611,0
32766200109,32766200109,0,1090,1798,0
32766985348,32766985351,3,1456,1156,0
32770911808,32770911813,5,2331,1918,0
32777203441,32777203442,1,1285,1674,0
32777437962,32777437961,-1,1146,1316,0
32778148832,32778148825,-7,1959,8578,0
32779038804,32779038805,1,1784,2005,0
32779213377,32779213381,4,2081,1961,0
32779532301,32779532316,15,1949,1691,0
32779915996,32779916002,6,4249,1408,0
32783650994,32783650994,0,1866,1906,0
32784073395,32784073394,-1,1996,2251,0
32784942179,32784942178,-1,1056,2351,0
32788263441,32788263442,1,1173,1280,0
32790837500,32790837505,5,1344,1877,0
32794868635,32794868635,0,1596,1776,0
32795819574,32795819554,-20,1042,1272,0
32799210330,32799210330,0,1222,2426,0
32810714346,32810714345,-1,1496,1773,0
32811016619,32811016620,1,1320,1441,0
32813010473,32813010473,0,2144,2457,0
32814147177,32814147178,1,1369,1927,0
32816009421,32816009422,1,1236,1851,0
32817238838,32817238839,1,1092,1328,0
32821386382,32821386384,2,1714,2299,0
32824013746,32824013745,-1,1266,1581,0
32824047654,32824047675,21,1000,1239,0
32824121993,32824121991,-2,1920,2366,0
32825679177,32825679178,1,1074,1387,0
32826924826,32826924826,0,1426,1300,0
32828892377,32828892376,-1,976,1477,0
32829197215,32829197217,2,1359,1771,0
32830704582,32830704581,-1,1510,1854,0
32830812029,32830812030,1,1449,1846,0
32835201088,32835201089,1,1562,1440,0
32836332830,32836332829,-1,1249,1593,0
32836942507,32836942484,-23,1628,1518,0
32838978630,32838978626,-4,1380,2130,0
32839168466,32839168466,0,1697,2282,0
32842296537,32842296538,1,1219,1620,0
32842834201,32842834206,5,1206,1799,0
32843296087,32843296086,-1,1402,2225,0
32844817487,32844817490,3,1806,2207,0
32845787023,32845787024,1,1024,1317,0
32848893054,32848893054,0,1504,2066,0
32853660076,32853660077,1,1660,1621,0
32857855978,32857855977,-1,1632,2156,0
32857927908,32857927909,1,1766,1576,0
32858631010,32858631010,0,1356,1349,0
32859760715,32859760717,2,1648,1635,0
32861149306,32861149306,0,1023,2167,0
32863465698,32863465700,2,1197,1998,0
32863731643,32863731642,-1,1093,1894,0
32865099476,32865099483,7,3174,1144,0
32865663126,32865663126,0,1209,2209,0
32868358191,32868358191,0,1534,1107,0
32869011245,32869011246,1,1212,1661,0
32871487566,32871487567,1,1548,1141,0
32882632292,32882632292,0,1093,1758,0
32883152298,32883152298,0,1189,1590,0
32887979331,32887979332,1,1535,1331,0
32888539598,32888539598,0,837,980,0
32895707298,32895707301,3,986,1000,0
32899250083,32899250078,-5,1066,2073,0
32899606933,32899606933,0,1941,1352,0
32913058329,32913058330,1,1648,1842,0
32914205302,32914205303,1,1116,1155,0
32914530333,32914530334,1,1579,2218,0
32917691790,32917691791,1,2073,1550,0
32917735226,32917735204,-22,1568,1979,0
32922873922,32922873924,2,1518,1839,0
32925078898,32925078899,1,865,1137,0
32926349242,32926349243,1,1324,2059,0
32926750879,32926750872,-7,651,988,0
32929716220,32929716222,2,1178,1441,0
32932713194,32932713194,0,1676,1846,0
32934160935,32934160937,2,900,1579,0
32934608169,32934608170,1,1025,1295,0
32934920970,32934920970,0,1220,1386,0
32937070575,32937070578,3,1261,1272,0
32939077743,32939077742,-1,1367,1909,0
32939651941,32939651939,-2,4007,5288,0
32940371780,32940371784,4,1479,1741,0
32940539659,32940539655,-4,1176,2216,0
32941086269,32941086270,1,1197,1865,0
32946661068,32946661070,2,1955,1765,0
32950769548,32950769545,-3,1445,1407,0
32953946945,32953946945,0,1379,1960,0
32955848126,32955848126,0,1755,1476,0
32956444027,32956444026,-1,1200,1769,0
32958889953,32958889953,0,1531,1723,0
32963106672,32963106671,-1,1411,2043,0
32963200845,32963200846,1,1695,1120,0
32963798634,32963798633,-1,1303,1649,0
32964437009,32964437008,-1,1269,1685,0
32966364102,32966364103,1,917,1505,0
32966682325,32966682333,8,3754,1315,0
32968443533,32968443533,0,1145,1426,0
32970426661,32970426660,-1,1346,2273,0
32973706946,32973706946,0,706,1543,0
32974846318,32974846316,-2,1271,1947,0
32974924402,32974924403,1,1466,1205,0
32976752959,32976752956,-3,1046,3155,0
32984713523,32984713525,2,1425,1422,0
32988205129,32988205130,1,1618,2139,0
32990270586,32990270586,0,2241,2038,0
32990674073,32990674073,0,1298,2098,0
32994320634,32994320635,1,708,1055,0
32996307238,32996307238,0,1575,1472,0
32997159114,32997159116,2,1682,1640,0
32997967818,32997967819,1,1505,843,0
32998735708,32998735709,1,1002,2791,0
33000663548,33000663567,19,406,2306,0
33001407226,33001407226,0,1043,1094,0
33002746071,33002746072,1,826,993,0
33007925679,33007925680,1,1393,2045,0
33013774187,33013774188,1,1550,1734,0
33014031134,33014031142,8,2827,856,0
33015883535,33015883531,-4,1028,2616,0
33017405702,33017405701,-1,1608,1873,0
33022205282,33022205285,3,1489,1521,0
33023203548,33023203547,-1,1256,1691,0
33027699490,33027699490,0,1219,1454,0
33030196181,33030196182,1,1597,2042,0
33032616054,33032616056,2,1300,2083,0
33035228954,33035228953,-1,1270,1979,0
33038348784,33038348785,1,1551,1694,0
33041365554,33041365554,0,1376,1441,0
33043147407,33043147403,-4,1237,2958,0
33043465940,33043465937,-3,1305,1515,0
33043532138,33043532156,18,1506,1866,0
33043694148,33043694146,-2,1654,1612,0
33048328728,33048328727,-1,972,1645,0
33050268750,33050268753,3,927,1788,0
33050577990,33050577995,5,955,1290,0
33051249815,33051249817,2,1202,1660,0
33052863143,33052863143,0,1119,2063,0
33053293509,33053293513,4,1281,1788,0
33055026110,33055026110,0,633,1911,0
33055380871,33055380869,-2,930,1685,0
33055902939,33055902935,-4,896,1504,0
33059420294,33059420293,-1,1762,2433,0
33061476234,33061476235,1,1759,2048,0
33061513150,33061513151,1,1130,1940,0
33062265227,33062265230,3,1465,1151,0
33064181736,33064181738,2,1802,1636,0
33065343586,33065343583,-3,1037,2520,0
33069441909,33069441909,0,2019,1589,0
33074202159,33074202159,0,679,1264,0
33074554323,33074554325,2,1461,1935,0
33077105026,33077105024,-2,1138,2199,0
33080879945,33080879945,0,797,1030,0
33082425891,33082425889,-2,988,2633,0
33082643201,33082643202,1,1019,1132,0
33083487222,33083487220,-2,1667,2019,0
33084645486,33084645485,-1,1848,1948,0
33084831095,33084831096,1,1481,1090,0
33085946814,33085946813,-1,1093,1873,0
33087221554,33087221553,-1,1575,1936,0
33093110447,33093110448,1,1585,1998,0
33093739789,33093739787,-2,1145,1892,0
33094185365,33094185366,1,1813,1723,0
33095314745,33095314747,2,2219,1588,0
33096379087,33096379089,2,1154,2061,0
33102291648,33102291647,-1,1768,2223,0
33104146227,33104146229,2,1044,1548,0
33111679423,33111679422,-1,1511,2533,0
33114678457,33114678458,1,1833,2270,0
33116465959,33116465961,2,1033,1441,0
33116645510,33116645509,-1,907,2037,0
33118799562,33118799562,0,1084,1568,0
33119063246,33119063266,20,1260,1558,0
33121261927,33121261927,0,1768,1857,0
33121301477,33121301478,1,1189,1340,0
33121469002,33121469001,-1,1358,1867,0
33121508306,33121508307,1,1749,1442,0
33122142870,33122142871,1,1187,1962,0
33126362991,33126362993,2,1882,1103,0
33126685833,33126685840,7,2012,43287,0
33126750229,33126750249,20,1548,1409,0
33127172330,33127172310,-20,805,752,0
33131939512,33131939513,1,1528,1861,0
33136810691,33136810692,1,1512,1785,0
33137122942,33137122942,0,1497,1916,0
33137445175,33137445175,0,1838,1825,0
33137680305,33137680305,0,1710,2149,0
33143137734,33143137737,3,1958,2102,0
33145427094,33145427093,-1,2048,1696,0
33146763057,33146763059,2,1869,2386,0
33148486484,33148486483,-1,1317,2001,0
33149419375,33149419377,2,918,849,0
33149528274,33149528274,0,1402,1575,0
33152685214,33152685211,-3,1381,2716,0
33156898661,33156898662,1,1459,1598,0
33163427242,33163427241,-1,1421,1878,0
33167568263,33167568262,-1,560,1562,0
33168392300,33168392301,1,1594,1756,0
33169760238,33169760243,5,1204,1308,0
33170070389,33170070390,1,1645,2030,0
33173522718,33173522718,0,1250,2203,0
33175227607,33175227606,-1,1863,2382,0
33179998926,33179998910,-16,939,996,0
33182293213,33182293213,0,1537,1478,0
33184230659,33184230659,0,1532,2132,0
33184750454,33184750457,3,1451,1317,0
33185083634,33185083634,0,1137,1789,0
33186048097,33186048097,0,1713,1662,0
33186217646,33186217645,-1,1211,1481,0
33187025378,33187025377,-1,1082,1660,0
33188590032,33188590030,-2,1598,1982,0
33190415922,33190415922,0,1369,957,0
33191540028,33191540030,2,1426,1537,0
33196511086,33196511086,0,1461,2205,0
33198360045,33198360049,4,1370,1287,0
33204040113,33204040113,0,1317,1638,0
33204992334,33204992336,2,1461,1999,0
33205223959,33205223937,-22,1225,5450,0
33207393514,33207393515,1,1243,1561,0
33209013534,33209013534,0,889,1147,0
33210744074,33210744074,0,2076,1908,0
33212174714,33212174715,1,1630,2134,0
33213037962,33213037963,1,3963,3950,0
33217485178,33217485181,3,1626,1545,0
33217651142,33217651143,1,1260,1889,0
33217711951,33217711953,2,845,1693,0
33218265513,33218265514,1,1252,1541,0
33219599618,33219599618,0,1056,1285,0
33220684254,33220684254,0,1471,1487,0
33222584981,33222584984,3,1548,1441,0
33224762213,33224762219,6,1644,1238,0
33227119692,33227119694,2,2599,2634,0
33227636913,33227636915,2,1390,1459,0
33229893724,33229893724,0,1373,1415,0
33231927539,33231927540,1,1177,2071,0
33234582190,33234582190,0,1248,1312,0
33235063242,33235063242,0,1953,2022,0
33238775179,33238775198,19,650,1061,0
33238864338,33238864339,1,1888,3038,0
33241348874,33241348873,-1,1727,2004,0
33241889859,33241889863,4,1355,1706,0
33246631130,33246631130,0,1479,1672,0
33248104685,33248104685,0,1161,1824,0
33248427935,33248427935,0,965,1267,0
33250051778,33250051757,-21,211,694,0
33253140410,33253140409,-1,1424,1661,0
33254636314,33254636316,2,1456,1858,0
33258493934,33258493930,-4,911,1729,0
33260171583,33260171583,0,1067,1577,0
33266307161,33266307169,8,1361,1196,0
33266649758,33266649758,0,1652,1927,0
33269601714,33269601714,0,1186,1698,0
33270019298,33270019299,1,1417,1316,0
33271070273,33271070271,-2,1006,1209,0
33276967728,33276967730,2,1245,2120,0
33279885139,33279885139,0,1100,1129,0
33280911299,33280911302,3,2391,2107,0
33282193746,33282193747,1,2088,1826,0
33285513963,33285513965,2,1194,1372,0
33289419033,33289419032,-1,1423,1889,0
33293162654,33293162654,0,503,1042,0
33294057361,33294057362,1,1800,2465,0
33296839039,33296839038,-1,1560,1163,0
33298639690,33298639689,-1,1139,2030,0
33299181758,33299181758,0,1535,1151,0
33302275884,33302275882,-2,1387,1902,0
33303052312,33303052311,-1,1046,1583,0
33305012729,33305012729,0,1339,1607,0
33307121436,33307121437,1,1689,2334,0
33312063253,33312063258,5,2379,1445,0
33314687571,33314687573,2,1919,1501,0
33319503426,33319503427,1,1539,1721,0
33320064026,33320064028,2,1150,1414,0
33320375329,33320375335,6,1874,1360,0
33321562174,33321562173,-1,2726,4758,0
33324019210,33324019212,2,1306,1797,0
33324762901,33324762898,-3,615,1364,0
33327923414,33327923414,0,1795,2240,0
33329494822,33329494821,-1,1510,2221,0
33329771534,33329771533,-1,1319,2226,0
33331973917,33331973917,0,1689,1873,0
33332621525,33332621541,16,1252,1646,0
33336011713,33336011709,-4,981,2535,0
33336247319,33336247314,-5,603,975,0
33343043090,33343043090,0,834,883,0
33343604271,33343604273,2,1117,1194,0
33346674538,33346674541,3,1339,1403,0
33347942750,33347942750,0,1290,1381,0
33348048380,33348048379,-1,1753,1898,0
33351545082,33351545082,0,1103,1477,0
33356354144,33356354143,-1,1099,1563,0
33358077779,33358077779,0,1833,1615,0
33360718546,33360718549,3,2895,1326,0
33362065699,33362065701,2,1473,1507,0
33364659008,33364659009,1,1634,1955,0
33369014242,33369014242,0,1353,1350,0
33369392987,33369392989,2,1364,1975,0
33369819110,33369819111,1,1731,1585,0
33371921712,33371921711,-1,1240,1009,0
33373427836,33373427834,-2,1711,2264,0
33374621254,33374621254,0,816,1508,0
33377505243,33377505245,2,1416,1694,0
33378324937,33378324938,1,1513,1861,0
33379550697,33379550696,-1,1341,1980,0
33380740364,33380740363,-1,1700,1905,0
33382184785,33382184785,0,1314,1565,0
33385156120,33385156122,2,2012,2661,0
33386441071,33386441071,0,1350,1615,0
33390028807,33390028803,-4,1108,3065,0
33393156828,33393156828,0,1797,1822,0
33393538522,33393538523,1,1260,1984,0
33401934932,33401934931,-1,787,1506,0
33405118448,33405118449,1,1481,1658,0
33405706009,33405706008,-1,1086,1518,0
33406014486,33406014486,0,992,2280,0
33407020351,33407020354,3,1706,2349,0
33408915302,33408915303,1,1430,2677,0
33410256642,33410256642,0,1025,1235,0
33413947632,33413947632,0,1510,1203,0
33415817892,33415817893,1,1133,976,0
33416541815,33416541806,-9,1399,6960,0
33417535690,33417535692,2,1088,1752,0
33418725984,33418725989,5,1642,1189,0
33424298819,33424298819,0,1814,2334,0
33426912290,33426912289,-1,1771,1850,0
33428156683,33428156683,0,1163,1455,0
33431861959,33431861959,0,1362,1686,0
33434191344,33434191345,1,1533,2139,0
33439846878,33439846877,-1,920,1329,0
33440194698,33440194704,6,10089,36351,0
33449387410,33449387411,1,1236,1503,0
33451004180,33451004180,0,1136,1590,0
33454882966,33454882963,-3,1349,2917,0
33455889731,33455889731,0,1754,1599,0
33456183521,33456183519,-2,2049,2607,0
33461118946,33461118947,1,981,1869,0
33464879289,33464879297,8,11101,34927,0
33465046013,33465046013,0,1569,1774,0
33467803182,33467803181,-1,2107,2310,0
33474107658,33474107658,0,1840,1584,0
33476534602,33476534601,-1,1424,1652,0
33476922511,33476922505,-6,901,1671,0
33477985686,33477985688,2,1656,1818,0
33481377351,33481377354,3,1270,1595,0
33482197770,33482197765,-5,2674,4195,0
33486702857,33486702857,0,1858,2054,0
33488185222,33488185223,1,795,1367,0
33490682863,33490682862,-1,896,1748,0
33494052229,33494052230,1,1523,1599,0
33497907995,33497907995,0,1566,1617,0
33500569090,33500569089,-1,1292,1518,0
33501987990,33501987992,2,1831,1838,0
33503868578,33503868579,1,1230,1681,0
33503897938,33503897941,3,1995,957,0
33507662857,33507662858,1,1335,2013,0
33509736830,33509736847,17,864,2509,0
33517654134,33517654136,2,1870,1540,0
33517828938,33517828938,0,1154,1221,0
33517939203,33517939203,0,1160,1105,0
33519532990,33519532990,0,1127,1903,0
33520681289,33520681287,-2,1232,1458,0
33521098641,33521098638,-3,48747,21415,0
33528947583,33528947581,-2,1029,1639,0
33529092622,33529092630,8,7083,2552,0
33535099082,33535099082,0,1708,2267,0
33535544863,33535544856,-7,1894,8803,0
33535961258,33535961258,0,1371,1688,0
33536896508,33536896507,-1,2082,1840,0
33538152658,33538152658,0,1122,1750,0
33538413659,33538413654,-5,1194,4851,0
33539402492,33539402493,1,1005,1265,0
33544635397,33544635392,-5,982,1410,0
33544973338,33544973341,3,1203,1679,0
33545428928,33545428927,-1,1249,1263,0
33549334261,33549334262,1,728,1020,0
33550879278,33550879280,2,956,1063,0
33552122558,33552122559,1,1487,1658,0
33552274171,33552274173,2,1825,2185,0
33552488442,33552488442,0,1469,1660,0
33552652304,33552652309,5,2989,1657,0
33555526587,33555526587,0,1292,2234,0
33556406909,33556406910,1,1244,1501,0
33556525689,33556525690,1,1589,2241,0
33556829843,33556829845,2,787,1479,0
33562713741,33562713743,2,1052,1515,0
33564238938,33564238938,0,1757,1774,0
33565526534,33565526534,0,927,1846,0
33565775466,33565775466,0,1134,1533,0
33569708293,33569708289,-4,1431,2258,0
33570515131,33570515130,-1,1538,1884,0
33574360930,33574360918,-12,20099,19198,0
33574540486,33574540489,3,1685,1436,0
33574923551,33574923550,-1,1915,2740,0
33575451253,33575451251,-2,1569,1683,0
33575571739,33575571738,-1,1363,2012,0
33576329725,33576329747,22,1325,1265,0
33577928824,33577928823,-1,1089,1748,0
33578850245,33578850247,2,2426,2020,0
33585590135,33585590136,1,1483,1757,0
33588219610,33588219610,0,1753,2043,0
33588631701,33588631698,-3,2109,3675,0
33589948524,33589948525,1,1470,1967,0
33590009154,33590009154,0,1653,1946,0
33590252693,33590252691,-2,1692,1824,0
33590851502,33590851502,0,1411,1453,0
33593254932,33593254934,2,1214,1406,0
33594341358,33594341360,2,1734,1968,0
33595105346,33595105346,0,1001,1222,0
33599066681,33599066683,2,1772,2397,0
33600757847,33600757845,-2,1149,1554,0
33601498799,33601498791,-8,794,3699,0
33601652086,33601652096,10,57,5641,0
33603398101,33603398101,0,1345,1712,0
33606375002,33606375004,2,1251,1623,0
33607226689,33607226688,-1,1591,1665,0
33609523202,33609523201,-1,1159,1489,0
33610389678,33610389678,0,1290,1444,0
33613829997,33613829993,-4,1019,1977,0
33614426976,33614426984,8,13089,45285,0
33615176937,33615176938,1,1014,1717,0
33615278298,33615278298,0,1261,1635,0
33622862284,33622862286,2,1800,1997,0
33623512626,33623512629,3,2045,1916,0
33627242831,33627242830,-1,1731,1907,0
33629989383,33629989380,-3,1281,1515,0
33636692914,33636692913,-1,1487,1916,0
33636877910,33636877908,-2,1996,1860,0
33638902497,33638902497,0,1424,2521,0
33640976394,33640976392,-2,1382,1213,0
33644322456,33644322454,-2,1427,1832,0
33647166946,33647166947,1,1913,1814,0
33653049566,33653049571,5,1285,1223,0
33656817071,33656817072,1,1259,1665,0
33657999424,33657999425,1,1473,1162,0
33660797510,33660797515,5,993,1512,0
33664606523,33664606523,0,1442,1558,0
33669595506,33669595506,0,1393,1290,0
33671485469,33671485470,1,1157,1715,0
33672762277,33672762280,3,1291,1191,0
33674738661,33674738663,2,1286,1680,0
33680925510,33680925508,-2,667,1525,0
33683195982,33683195983,1,2048,1449,0
33683767507,33683767504,-3,815,1319,0
33686047506,33686047506,0,1350,1865,0
33686555740,33686555739,-1,1382,1278,0
33686961272,33686961271,-1,1530,1777,0
33689334418,33689334418,0,1554,1153,0
33690663400,33690663402,2,1567,1825,0
33690867334,33690867336,2,1714,1312,0
33693067719,33693067718,-1,1292,1373,0
33693178310,33693178313,3,1279,2155,0
33697922547,33697922550,3,1370,1028,0
33698759146,33698759146,0,698,981,0
33702032689,33702032688,-1,992,1706,0
33704597606,33704597605,-1,978,1550,0
33708180298,33708180305,7,2232,981,0
33708903460,33708903462,2,1427,1995,0
33709546652,33709546653,1,2013,2319,0
33710664433,33710664431,-2,996,1388,0
33711990514,33711990514,0,1404,2079,0
33715870801,33715870799,-2,1427,2315,0
33716358825,33716358823,-2,1278,2316,0
33718466363,33718466364,1,1471,1472,0
33719316575,33719316576,1,1201,1637,0
33721488032,33721488033,1,1324,1341,0
33722469413,33722469414,1,1394,2095,0
33723967836,33723967837,1,1476,1465,0
33725889033,33725889035,2,1603,1854,0
33726495837,33726495836,-1,1084,1035,0
33731735854,33731735857,3,904,1251,0
33733019854,33733019858,4,3174,1409,0
33734586265,33734586262,-3,1142,2911,0
33735260833,33735260832,-1,1785,2639,0
33735738813,33735738813,0,1790,1973,0
33736167330,33736167330,0,1500,2041,0
33738058686,33738058686,0,1583,1635,0
33739917596,33739917598,2,1451,1913,0
33740482570,33740482568,-2,1010,1332,0
33741732298,33741732300,2,1803,2132,0
33743377997,33743377997,0,824,1111,0
33744954979,33744954978,-1,627,992,0
33746611507,33746611507,0,1174,1384,0
33747728233,33747728236,3,1252,1550,0
33751704513,33751704514,1,1121,1675,0
33753082712,33753082731,19,404,667,0
33754914966,33754914971,5,15278,7736,0
33756016854,33756016853,-1,2089,1553,0
33756480597,33756480596,-1,1334,1458,0
33757257831,33757257831,0,1326,1503,0
33758578613,33758578614,1,1578,1413,0
33759472037,33759472038,1,1427,1509,0
33763035934,33763035933,-1,892,2539,0
33763918605,33763918607,2,1300,1183,0
33766345341,33766345341,0,1370,2081,0
33767701590,33767701590,0,1171,1689,0
33767904083,33767904082,-1,1215,1657,0
33768017215,33768017212,-3,923,1844,0
33768644836,33768644837,1,1766,1688,0
33768739434,33768739433,-1,1411,1338,0
33770829400,33770829406,6,3710,1390,0
33778238315,33778238317,2,1066,992,0
33779609185,33779609185,0,1377,1269,0
33780937364,33780937364,0,1666,2529,0
33781837867,33781837869,2,1105,1654,0
33785475582,33785475585,3,1496,1144,0
33785534441,33785534442,1,1244,1455,0
33785611134,33785611136,2,1151,1620,0
33787288930,33787288930,0,930,1239,0
33793764076,33793764078,2,1785,1633,0
33795068013,33795068013,0,1241,1486,0
33795625022,33795625021,-1,1577,1738,0
33798544934,33798544949,15,1136,1380,0
33806533290,33806533290,0,1167,2326,0
33807599255,33807599255,0,44714,5065,0
33807680063,33807680062,-1,1400,1745,0
33811048977,33811048977,0,905,1580,0
33813055396,33813055382,-14,1370,1257,0
33814431655,33814431657,2,938,1203,0
33819901475,33819901474,-1,1418,1913,0
33820154166,33820154166,0,1363,1696,0
33823088066,33823088065,-1,1120,1818,0
33824377949,33824377949,0,1063,1092,0
33826047529,33826047529,0,1227,1479,0
33826880137,33826880135,-2,1213,1642,0
33827066264,33827066265,1,1897,1737,0
33834532438,33834532440,2,33713,87313,0
33839745815,33839745819,4,909,1635,0
33842961275,33842961267,-8,2181,9584,0
33845916791,33845916792,1,898,1631,0
33846715549,33846715549,0,1544,2029,0
33849188252,33849188254,2,1580,1376,0
33849317273,33849317273,0,955,1074,0
33849664925,33849664925,0,1228,1801,0
33851223561,33851223561,0,1039,1348,0
33851763110,33851763110,0,1316,1500,0
33852993898,33852993898,0,1181,1466,0
33853248194,33853248194,0,1904,2075,0
33853372241,33853372242,1,1440,1219,0
33856080001,33856080002,1,1001,1337,0
33857308763,33857308762,-1,858,2145,0
33859035938,33859035951,13,1215,1405,0
33859621636,33859621637,1,1450,2027,0
33860337175,33860337174,-1,1422,2186,0
33860796297,33860796305,8,2934,1372,0
33864136445,33864136446,1,1095,1938,0
33867156583,33867156582,-1,2176,2308,0
33871283958,33871283959,1,1275,1779,0
33873395563,33873395561,-2,1742,5062,0
33874145639,33874145637,-2,703,966,0
33876676487,33876676464,-23,870,1906,0
33878183453,33878183453,0,1588,1008,0
33880856030,33880856029,-1,1250,2202,0
33883929974,33883929975,1,1059,1841,0
33884242404,33884242405,1,1516,1900,0
33897510462,33897510462,0,1162,1720,0
33898334758,33898334760,2,1572,1818,0
33900873742,33900873744,2,1453,2375,0
33903226743,33903226745,2,2354,2614,0
33903735778,33903735780,2,1632,1602,0
33905836087,33905836087,0,1763,2362,0
33907349486,33907349488,2,2157,1937,0
33908218482,33908218482,0,1275,1411,0
33909526205,33909526205,0,1705,2258,0
33910127862,33910127864,2,1720,1670,0
33910757178,33910757179,1,1437,1381,0
33912455345,33912455344,-1,1226,1944,0
33912735239,33912735254,15,1427,1604,0
33914266322,33914266325,3,1758,2105,0
33914974940,33914974941,1,1819,2144,0
33916519893,33916519895,2,1111,1681,0
33917449658,33917449658,0,1371,1350,0
33917508168,33917508169,1,1512,2099,0
33917760239,33917760239,0,1614,2299,0
33918968545,33918968546,1,1111,1307,0
33923490201,33923490201,0,1792,2045,0
33927682436,33927682442,6,3555,1730,0
33928518096,33928518083,-13,1347,2905,0
33930289030,33930289027,-3,924,2315,0
33930814845,33930814825,-20,969,1786,0
33932276523,33932276526,3,1249,2607,0
33932890210,33932890211,1,2195,3337,0
33933036866,33933036866,0,1547,1860,0
33936372443,33936372439,-4,456,1667,0
33938382705,33938382706,1,986,1349,0
33938744218,33938744218,0,1710,1685,0
33942178602,33942178600,-2,1371,1617,0
33943071576,33943071577,1,782,1873,0
33945703857,33945703857,0,1486,1557,0
33951722600,33951722600,0,1262,1906,0
33951976283,33951976290,7,2523,1188,0
33952192172,33952192172,0,2027,2412,0
33953448918,33953448919,1,1491,2243,0
33955997470,33955997471,1,928,1317,0
33957812778,33957812783,5,1260,1300,0
33960393744,33960393746,2,1707,2160,0
33971161322,33971161318,-4,871,1242,0
33971767881,33971767882,1,1169,1101,0
33973372221,33973372220,-1,1597,1824,0
33976346579,33976346575,-4,686,1834,0
33977164542,33977164544,2,1789,1410,0
33979489878,33979489883,5,1212,1279,0
33980292966,33980292966,0,1496,1982,0
33981430689,33981430689,0,1684,2550,0
33986994149,33986994151,2,1798,1859,0
33987572981,33987572983,2,2108,2397,0
33988536638,33988536637,-1,1632,1788,0
33988599282,33988599282,0,1626,1665,0
33988816146,33988816147,1,1539,1690,0
33992997986,33992997986,0,1324,1462,0
33993056019,33993056013,-6,28452,11606,0
33997444718,33997444721,3,1312,1248,0
34000249750,34000249747,-3,1482,1479,0
34005225219,34005225221,2,1276,1452,0
34005267186,34005267186,0,1141,1862,0
34006407299,34006407298,-1,1661,2502,0
34007124750,34007124750,0,1235,2218,0
34008199901,34008199901,0,1714,1718,0
34009003995,34009004000,5,2926,1313,0
34017058056,34017058055,-1,1214,1605,0
34017759111,34017759112,1,1995,1929,0
34018030002,34018030002,0,1342,1220,0
34021336526,34021336528,2,1312,1507,0
34024477079,34024477067,-12,287,1226,0
34026762783,34026762783,0,1186,1211,0
34027295247,34027295227,-20,1394,1825,0
34029602426,34029602426,0,2552,3616,0
34030865353,34030865358,5,10447,21661,0
34031609635,34031609636,1,1501,1988,0
34031713392,34031713393,1,1515,1452,0
34037911931,34037911930,-1,1165,1682,0
34040960382,34040960381,-1,1221,1895,0
34042385250,34042385250,0,1131,1429,0
34046451063,34046451062,-1,1177,2609,0
34047971605,34047971605,0,1763,2442,0
34049307077,34049307078,1,1684,2156,0
34051472643,34051472641,-2,562,1396,0
34052793911,34052793912,1,785,1127,0
34053746066,34053746067,1,1116,1141,0
34056403013,34056403010,-3,980,1460,0
34056580141,34056580141,0,993,916,0
34057520156,34057520157,1,958,1561,0
34061864738,34061864740,2,1346,1916,0
34062868510,34062868510,0,1248,1352,0
34063867568,34063867567,-1,1065,1443,0
34064776636,34064776638,2,1523,1945,0
34065709862,34065709861,-1,1331,1807,0
34066020076,34066020072,-4,1304,2956,0
34068192218,34068192217,-1,1216,2302,0
34068972329,34068972329,0,1445,1473,0
34069060614,34069060615,1,1363,1712,0
34070403577,34070403578,1,1501,1986,0
34071860027,34071860025,-2,1834,4079,0
34072082319,34072082318,-1,1290,1483,0
34073501625,34073501631,6,3971,1530,0
34074467372,34074467373,1,1723,1728,0
34074652541,34074652542,1,1739,1919,0
34078534447,34078534447,0,1080,1293,0
34083492247,34083492249,2,1922,2418,0
34084856699,34084856700,1,1720,1494,0
34086529627,34086529626,-1,1091,1391,0
34087225746,34087225746,0,1167,1791,0
34087483421,34087483423,2,1983,1940,0
34088135569,34088135569,0,1560,1614,0
34091191213,34091191214,1,960,1243,0
34092068798,34092068797,-1,1042,1484,0
34092472225,34092472225,0,1624,1735,0
34094783930,34094783930,0,874,1178,0
34096392469,34096392470,1,1438,1974,0
34097152816,34097152817,1,1107,1028,0
34101384185,34101384186,1,1378,1172,0
34102954470,34102954469,-1,1123,1527,0
34109344338,34109344338,0,1440,1269,0
34109389469,34109389476,7,5156,2183,0
34111413257,34111413258,1,1624,1167,0
34113834247,34113834248,1,1289,2415,0
34115989524,34115989523,-1,1140,1235,0
34116425038,34116425039,1,1419,1534,0
34118912782,34118912784,2,1884,2530,0
34119841453,34119841454,1,1500,1475,0
34121589762,34121589763,1,1137,1241,0
34121752685,34121752686,1,1597,1515,0
34124529274,34124529275,1,1233,1143,0
34125171421,34125171420,-1,1323,1185,0
34126866053,34126866052,-1,1005,1566,0
34127869578,34127869574,-4,1186,3119,0
34129134469,34129134471,2,1160,2195,0
34130004567,34130004567,0,1935,1434,0
34132676890,34132676887,-3,950,1510,0
34134345224,34134345223,-1,1275,1349,0
34135513931,34135513934,3,1556,1767,0
34137281500,34137281501,1,1726,1828,0
34143644260,34143644266,6,5567,2976,0
34147015992,34147015992,0,1630,1802,0
34147494169,34147494175,6,1401,1068,0
34151479331,34151479331,0,1324,1122,0
34155038646,34155038645,-1,1162,1415,0
34159717792,34159717792,0,1216,2325,0
34160103098,34160103098,0,1069,2045,0
34160899922,34160899919,-3,1686,1819,0
34161190625,34161190625,0,1325,1983,0
34165771209,34165771209,0,1393,1735,0
34171694842,34171694841,-1,982,999,0
34174546741,34174546742,1,1411,1784,0
34177322597,34177322599,2,1778,1558,0
34177914357,34177914357,0,1228,2258,0
34178860277,34178860278,1,1075,1955,0
34183197129,34183197130,1,1098,1801,0
34183326382,34183326384,2,1712,1711,0
34184039865,34184039866,1,1320,1708,0
34187696557,34187696553,-4,3212,6972,0
34193562601,34193562599,-2,853,1252,0
34193994929,34193994933,4,2262,1383,0
34194773783,34194773782,-1,1276,2571,0
34197033102,34197033099,-3,1158,2225,0
34198626886,34198626886,0,1253,1221,0
34201156878,34201156878,0,674,1174,0
34202023614,34202023617,3,1736,1997,0
34203101934,34203101939,5,1423,1816,0
34205915525,34205915527,2,2011,1965,0
34210556750,34210556750,0,1389,1579,0
34212651634,34212651633,-1,1221,1057,0
34217290373,34217290374,1,1091,1974,0
34218245116,34218245115,-1,1215,1477,0
34218918603,34218918604,1,1516,2345,0
34219641025,34219641025,0,2048,2120,0
34220985559,34220985559,0,1415,2301,0
34221135582,34221135580,-2,914,1116,0
34224235510,34224235513,3,1879,1831,0
34227320713,34227320712,-1,1461,1754,0
34237876407,34237876412,5,1183,1375,0
34240764823,34240764822,-1,1061,1740,0
34240865530,34240865530,0,1490,2181,0
34240934442,34240934442,0,782,953,0
34242434865,34242434866,1,1319,1307,0
34250556001,34250555999,-2,1542,1494,0
34251549965,34251549966,1,1486,1430,0
34254132029,34254132030,1,1580,1459,0
34254940290,34254940291,1,1339,1543,0
34258040998,34258040998,0,2066,2044,0
34258747158,34258747164,6,3363,1394,0
34261190005,34261190006,1,2246,1844,0
34261419286,34261419292,6,2877,1064,0
34261944311,34261944314,3,1736,1767,0
34266916766,34266916769,3,1139,978,0
34267155457,34267155458,1,1822,1743,0
34270038376,34270038378,2,1622,1579,0
34270492147,34270492148,1,1583,1337,0
34272220242,34272220247,5,2121,1160,0
34272284095,34272284108,13,873,841,0
34272987143,34272987146,3,1560,1793,0
34274835013,34274835006,-7,931,4618,0
34276601921,34276601922,1,1079,1080,0
34277684169,34277684169,0,1127,1913,0
34278253437,34278253438,1,792,1064,0
34282908846,34282908845,-1,1337,1507,0
34289856026,34289856028,2,1389,1410,0
34290452774,34290452776,2,1584,2241,0
34291330618,34291330620,2,1182,1320,0
34292284192,34292284193,1,1542,1698,0
34292601151,34292601156,5,1618,1354,0
34293643079,34293643060,-19,1176,433,0
34295606402,34295606403,1,1074,1082,0
34300164470,34300164469,-1,1799,2421,0
34300716863,34300716862,-1,1693,1807,0
34302543877,34302543878,1,1318,1452,0
34303343594,34303343594,0,1509,2238,0
34306511243,34306511245,2,1133,1360,0
34308032717,34308032719,2,1411,1741,0
34308750050,34308750051,1,1698,1566,0
34309108617,34309108628,11,1199,1181,0
34310587813,34310587815,2,2089,1922,0
34310714196,34310714197,1,1611,1760,0
34318867988,34318867988,0,1499,2183,0
34321275997,34321275998,1,1728,1950,0
34322250261,34322250262,1,1492,2025,0
34323188286,34323188286,0,1454,2012,0
34325264901,34325264900,-1,1312,1843,0
34326199531,34326199543,12,112,2623,0
34327459603,34327459604,1,1133,1965,0
34328068527,34328068527,0,1371,1981,0
34328754582,34328754581,-1,1335,1247,0
34329235138,34329235139,1,1125,1097,0
34331922086,34331922085,-1,1805,2254,0
34335042485,34335042485,0,1128,2186,0
34337594886,34337594888,2,1219,1068,0
34340179330,34340179331,1,1082,1945,0
34341510466,34341510465,-1,1170,2004,0
34343529551,34343529550,-1,1894,1641,0
34344948411,34344948412,1,845,1120,0
34346488496,34346488481,-15,1478,1877,0
34346689588,34346689589,1,1518,1564,0
34351041779,34351041778,-1,1588,2006,0
34351812350,34351812349,-1,1178,1911,0
34351872450,34351872450,0,1094,1565,0
34354588714,34354588714,0,1396,1475,0
34354616960,34354616961,1,1238,1664,0
34354880431,34354880430,-1,1181,2082,0
34355058716,34355058714,-2,1026,1537,0
34355850250,34355850251,1,1175,1647,0
34356751846,34356751844,-2,1282,1343,0
34361079107,34361079109,2,1488,1601,0
34364783794,34364783795,1,1071,992,0
34365650967,34365650966,-1,1774,1935,0
34367739622,34367739622,0,1125,1581,0
34370698233,34370698234,1,1077,1105,0
34371451319,34371451322,3,687,1538,0
34373159563,34373159562,-1,1512,1913,0
34376044802,34376044806,4,2058,1480,0
34376191211,34376191213,2,1214,1423,0
34377546907,34377546907,0,1316,1892,0
34377661819,34377661821,2,1023,1819,0
34377794771,34377794774,3,1249,1514,0
34379769310,34379769311,1,2591,2019,0
34384736937,34384736937,0,1686,1715,0
34385585474,34385585475,1,2238,2690,0
34386123944,34386123942,-2,1844,2123,0
34388952802,34388952802,0,1178,2030,0
34390139831,34390139831,0,1430,1491,0
34391626926,34391626928,2,2154,2173,0
34393369995,34393369997,2,1236,1573,0
34393957862,34393957864,2,1176,1997,0
34394233695,34394233681,-14,1185,1832,0
34394539716,34394539709,-7,1215,1639,0
34395981968,34395981966,-2,1600,1646,0
34396419698,34396419700,2,1692,1665,0
34397511733,34397511734,1,877,1376,0
34400258234,34400258236,2,2414,2033,0
34401688230,34401688232,2,1725,1131,0
34402625514,34402625513,-1,1341,2255,0
34405582787,34405582786,-1,1578,1241,0
34407596669,34407596671,2,1482,1584,0
34410081204,34410081204,0,1627,1960,0
34410440331,34410440330,-1,1073,1721,0
34411076659,34411076659,0,1369,2342,0
34412958759,34412958759,0,1057,1131,0
34413971857,34413971858,1,1351,1706,0
34418839679,34418839678,-1,1309,1867,0
34421295458,34421295465,7,2759,1660,0
34424034785,34424034782,-3,1248,1954,0
34425186858,34425186858,0,814,1071,0
34425854497,34425854498,1,1236,1500,0
34426167859,34426167858,-1,1184,1318,0
34426680386,34426680387,1,1217,1619,0
34428955048,34428955054,6,2904,1609,0
34431310897,34431310898,1,1389,1369,0
34431823046,34431823047,1,1494,1634,0
34432600950,34432600950,0,1715,1560,0
34435399946,34435399945,-1,1057,1699,0
34436012722,34436012723,1,1126,1353,0
34442891911,34442891910,-1,1283,1301,0
34449069399,34449069399,0,1493,1646,0
34449409187,34449409186,-1,1175,1278,0
34450343907,34450343908,1,1412,1153,0
34450577342,34450577344,2,877,1441,0
34451863962,34451863961,-1,945,1122,0
34455913205,34455913203,-2,1129,1469,0
34462727753,34462727753,0,1338,1701,0
34474065819,34474065820,1,731,1130,0
34475739625,34475739626,1,1512,1889,0
34482954635,34482954635,0,2022,2364,0
34489543594,34489543595,1,1086,1851,0
34489703506,34489703506,0,1877,1745,0
34490601591,34490601594,3,1230,1489,0
34495390306,34495390309,3,1841,2212,0
34500385454,34500385455,1,1668,1776,0
34503156410,34503156411,1,13130,13560,0
34504006242,34504006242,0,1636,1839,0
34505059714,34505059714,0,1232,1512,0
34506917881,34506917883,2,1441,1448,0
34507525670,34507525671,1,1339,1579,0
34513962974,34513962975,1,1637,1980,0
34515574099,34515574099,0,1789,2524,0
34517889787,34517889786,-1,1270,1535,0
34519652267,34519652269,2,711,1496,0
34522610415,34522610416,1,2154,2689,0
34523591182,34523591184,2,1258,1545,0
34525179493,34525179491,-2,1629,1712,0
34525363058,34525363057,-1,1698,1887,0
34526052815,34526052816,1,953,1705,0
34528870204,34528870205,1,1350,2071,0
34539200534,34539200530,-4,1353,1975,0
34541801029,34541801030,1,1455,2259,0
34545396746,34545396748,2,947,1518,0
34547921909,34547921908,-1,1777,2239,0
34549017856,34549017859,3,2199,1515,0
34551585297,34551585298,1,1925,1748,0
34553556522,34553556524,2,1989,1638,0
34554891351,34554891350,-1,1374,1364,0
34556595514,34556595515,1,1386,1825,0
34556651298,34556651300,2,2023,1858,0
34559903062,34559903069,7,1411,2182,0
34559951606,34559951603,-3,776,1578,0
34560351438,34560351440,2,1268,1526,0
34561999015,34561999014,-1,915,1749,0
34563451665,34563451666,1,1637,1790,0
34564146939,34564146919,-20,937,969,0
34564895661,34564895683,22,1315,1400,0
34565040653,34565040654,1,1224,1525,0
34566459859,34566459859,0,1019,2147,0
34570293581,34570293582,1,1089,913,0
34577140494,34577140495,1,1477,1864,0
34580002390,34580002386,-4,933,2543,0
34580486809,34580486811,2,1650,1344,0
34583374473,34583374474,1,1128,1489,0
34584509463,34584509460,-3,1007,2141,0
34585693327,34585693324,-3,1199,2074,0
34588406815,34588406813,-2,1306,2125,0
34588541188,34588541189,1,1535,1769,0
34590280760,34590280758,-2,1262,2059,0
34591890586,34591890592,6,2972,1232,0
34594307775,34594307775,0,1646,1833,0
34595257859,34595257865,6,1415,1444,0
34596278861,34596278860,-1,1440,1937,0
34598245758,34598245758,0,2116,2628,0
34599617370,34599617355,-15,42919,16706,0
34604549485,34604549486,1,2498,2590,0
34607219401,34607219404,3,1658,2164,0
34608518535,34608518534,-1,1050,2340,0
34610389075,34610389073,-2,1031,1732,0
34612775343,34612775343,0,866,1073,0
34613310183,34613310163,-20,1529,1453,0
34614832697,34614832709,12,1819,1234,0
34616250220,34616250220,0,1264,1487,0
34617185412,34617185412,0,1340,1550,0
34618120041,34618120040,-1,1249,1959,0
34620115631,34620115630,-1,990,1299,0
34620896735,34620896735,0,1043,1341,0
34621832359,34621832369,10,1287,1601,0
34623185670,34623185669,-1,1290,2059,0
34623231629,34623231626,-3,1177,2201,0
34627702171,34627702171,0,1422,1812,0
34631221706,34631221704,-2,1013,1557,0
34631583871,34631583870,-1,1787,3520,0
34631775078,34631775081,3,1182,1545,0
34635817975,34635817974,-1,1222,1576,0
34636622738,34636622732,-6,1997,7079,0
34636972735,34636972738,3,1949,1444,0
34641438919,34641438918,-1,756,1269,0
34643242246,34643242247,1,1468,1684,0
34644537069,34644537070,1,1305,1495,0
34645151859,34645151860,1,1540,1629,0
34645601082,34645601084,2,2207,1599,0
34646787028,34646787022,-6,1265,1691,0
34655000894,34655000895,1,1686,1673,0
34667239335,34667239334,-1,877,2152,0
34667299615,34667299614,-1,920,1514,0
34668151934,34668151934,0,972,1528,0
34668314443,34668314443,0,1281,2216,0
34673313914,34673313917,3,2035,1661,0
34676766382,34676766383,1,825,1466,0
34678671381,34678671382,1,1185,1760,0
34679431654,34679431655,1,1857,1706,0
34682121803,34682121805,2,992,1543,0
34683868035,34683868042,7,1133,1338,0
34684088094,34684088092,-2,1789,2151,0
34684814526,34684814527,1,1358,1827,0
34685012250,34685012251,1,1784,1794,0
34688497570,34688497570,0,1486,1909,0
34693355629,34693355627,-2,953,1565,0
34695947115,34695947117,2,1352,1892,0
34696257676,34696257670,-6,1255,4590,0
34697919001,34697918994,-7,1505,8030,0
34697992810,34697992811,1,1419,1444,0
34699742285,34699742288,3,1603,2034,0
34701343909,34701343908,-1,1377,1845,0
34701948541,34701948541,0,1115,856,0
34703545478,34703545478,0,1708,1933,0
34705719153,34705719153,0,1006,1843,0
34705764117,34705764119,2,1485,1503,0
34705881034,34705881033,-1,876,788,0
34707812558,34707812559,1,1786,1950,0
34711227915,34711227914,-1,1741,2533,0
34714080910,34714080910,0,1739,770,0
34714115206,34714115207,1,2080,1621,0
34715915590,34715915590,0,1601,2253,0
34716398138,34716398145,7,2406,825,0
34717619537,34717619537,0,1629,2339,0
34718197773,34718197773,0,1662,1548,0
34721313898,34721313901,3,873,1105,0
34727992551,34727992552,1,1275,2024,0
34730131422,34730131425,3,1882,1764,0
34730183391,34730183389,-2,1108,1938,0
34731170557,34731170555,-2,942,1512,0
34732433463,34732433465,2,1667,1806,0
34733379178,34733379179,1,1110,1874,0
34736187492,34736187493,1,1462,1468,0
34740293942,34740293942,0,964,1343,0
34742140915,34742140915,0,2052,2325,0
34742365123,34742365122,-1,906,1306,0
34742755191,34742755173,-18,1029,1857,0
34744517153,34744517153,0,1633,1730,0
34745530022,34745530025,3,1084,1174,0
34746082169,34746082169,0,791,1344,0
34747191950,34747191950,0,791,1296,0
34747384069,34747384068,-1,1577,1923,0
34749002927,34749002926,-1,16764,2321,0
34751392435,34751392435,0,1729,1557,0
34751839088,34751839089,1,1458,1431,0
34754467692,34754467693,1,1308,1718,0
34755286026,34755286021,-5,768,2252,0
34761021391,34761021390,-1,1001,1549,0
34763292042,34763292049,7,2945,1787,0
34763340563,34763340563,0,821,1501,0
34763839987,34763839989,2,1354,1666,0
34765610314,34765610313,-1,1456,1519,0
34766030129,34766030128,-1,1412,1849,0
34766955670,34766955665,-5,2019,7716,0
34770625642,34770625641,-1,1463,1751,0
34770864453,34770864455,2,2296,1636,0
34775802874,34775802871,-3,1341,1529,0
34778368147,34778368146,-1,1525,1419,0
34778409369,34778409348,-21,762,798,0
34779494157,34779494163,6,6460,2302,0
34783455359,34783455358,-1,2155,1905,0
34784222728,34784222729,1,2363,2182,0
34784863188,34784863188,0,1596,1743,0
34786458746,34786458746,0,1596,2534,0
34787449703,34787449705,2,1264,1785,0
34789397135,34789397135,0,1275,1430,0
34790390346,34790390345,-1,2839,2627,0
34794508050,34794508045,-5,1141,3900,0
34795651793,34795651794,1,1072,1712,0
34798424930,34798424931,1,1258,1174,0
34798720807,34798720809,2,1294,1663,0
34802944235,34802944234,-1,1177,1560,0
34803954655,34803954674,19,857,1235,0
34806589009,34806589010,1,1895,2056,0
34809608094,34809608093,-1,1043,1644,0
34813760314,34813760315,1,1486,2448,0
34817342310,34817342310,0,921,1529,0
34817639026,34817639027,1,1404,2087,0
34825636235,34825636235,0,2185,2151,0
34826144608,34826144608,0,1610,1384,0
34826417476,34826417478,2,2598,3070,0
34827459757,34827459754,-3,1053,1990,0
34831507850,34831507850,0,1604,1788,0
34832822601,34832822601,0,2230,1991,0
34835758874,34835758874,0,1011,1296,0
34841441015,34841441013,-2,1256,1399,0
34843400983,34843400985,2,1290,1516,0
34847541193,34847541190,-3,1059,2453,0
34848058223,34848058222,-1,1549,2070,0
34850681353,34850681353,0,1266,2080,0
34851583605,34851583606,1,1662,1367,0
34854946083,34854946085,2,1440,2339,0
34857236765,34857236766,1,1974,1247,0
34857802491,34857802491,0,1176,1368,0
34860763760,34860763761,1,1853,2277,0
34866048991,34866048990,-1,1135,1284,0
34867414835,34867414834,-1,1017,1511,0
34870129876,34870129877,1,1431,1467,0
34870363125,34870363135,10,464,345,0
34871283869,34871283871,2,1259,1761,0
34873817206,34873817204,-2,1342,2104,0
34880303518,34880303517,-1,1272,2066,0
34883753918,34883753918,0,1346,1543,0
34886228674,34886228674,0,1181,1758,0
34887347519,34887347521,2,1904,1447,0
34890187902,34890187903,1,891,933,0
34890633090,34890633093,3,1436,1670,0
34891659917,34891659918,1,1034,1576,0
34893239414,34893239414,0,1223,1645,0
34895086002,34895086002,0,1258,1450,0
34895185214,34895185214,0,1126,1482,0
34895970492,34895970493,1,1930,1609,0
34896322834,34896322834,0,1648,1415,0
34897794772,34897794773,1,1302,1907,0
34899333281,34899333285,4,1550,1638,0
34904498865,34904498866,1,1381,2196,0
34905606562,34905606561,-1,1446,1693,0
34905875422,34905875410,-12,1421,2059,0
34908675601,34908675602,1,1678,2149,0
34909243898,34909243898,0,1436,1882,0
34911236818,34911236820,2,1276,1233,0
34912674233,34912674239,6,6603,2685,0
34913671654,34913671654,0,930,1217,0
34914503786,34914503786,0,1384,1707,0
34916699469,34916699469,0,1152,1256,0
34918350453,34918350454,1,1795,2495,0
34920055180,34920055178,-2,1027,1645,0
34922049907,34922049907,0,1705,1179,0
34935702534,34935702535,1,1243,1786,0
34935854114,34935854096,-18,1462,2262,0
34936547942,34936547943,1,975,2259,0
34941110446,34941110448,2,1008,1080,0
34947817670,34947817670,0,1561,1569,0
34949883310,34949883311,1,1863,2034,0
34950972031,34950972031,0,1181,1586,0
34951566946,34951566947,1,1021,1222,0
34953388969,34953388970,1,1737,2207,0
34956350616,34956350634,18,751,11100,0
34956469295,34956469294,-1,1272,2406,0
34959001482,34959001481,-1,816,1586,0
34966508942,34966508941,-1,1231,1543,0
34969084830,34969084834,4,1456,1514,0
34977691187,34977691188,1,1629,2657,0
34979844954,34979844954,0,1606,1600,0
34981061342,34981061343,1,807,1561,0
34983713934,34983713935,1,1691,1125,0
34986162406,34986162406,0,1119,1772,0
34988638428,34988638428,0,1341,1582,0
34992002738,34992002720,-18,2324,2405,0
34995655998,34995655999,1,1259,1633,0
34997758379,34997758378,-1,1034,1964,0
35003351963,35003351965,2,1495,1957,0
35005045182,35005045181,-1,1224,1564,0
35008846541,35008846537,-4,1328,3147,0
35009667906,35009667900,-6,1827,6995,0
35011797501,35011797500,-1,919,1232,0
35012513648,35012513650,2,1430,1693,0
35013874544,35013874543,-1,1068,1404,0
35016218631,35016218631,0,1103,1061,0
35021534078,35021534077,-1,1108,1809,0
35022071272,35022071271,-1,1882,2314,0
35026311242,35026311242,0,632,1708,0
35027739178,35027739179,1,1397,1912,0
35029345053,35029345059,6,1355,1632,0
35031578178,35031578179,1,1636,2296,0
35031689238,35031689238,0,1045,1377,0
35032090246,35032090253,7,1224,1108,0
35034782091,35034782091,0,1479,2322,0
35034895660,35034895661,1,1195,1906,0
35040515145,35040515145,0,1846,1626,0
35041157178,35041157177,-1,1210,2504,0
35041627443,35041627429,-14,1232,574,0
35042145812,35042145794,-18,942,1235,0
35045719855,35045719857,2,1379,1283,0
35049363449,35049363450,1,1468,1802,0
35050894854,35050894853,-1,1102,1672,0
35052339701,35052339700,-1,1271,1521,0
35052828345,35052828346,1,1339,1578,0
35055195678,35055195679,1,1099,993,0
35055851815,35055851819,4,1547,1408,0
35062075397,35062075396,-1,1589,1714,0
35065208193,35065208193,0,14052,15632,0
35066081731,35066081731,0,1064,1893,0
35068782662,35068782662,0,1092,1295,0
35070486866,35070486867,1,1420,1887,0
35072525562,35072525559,-3,1130,2543,0
35074408618,35074408617,-1,1538,2168,0
35074909166,35074909166,0,1103,1676,0
35075636183,35075636182,-1,1036,1521,0
35076296816,35076296816,0,1573,1691,0
35077698846,35077698846,0,1578,1979,0
35079278521,35079278525,4,1440,1245,0
35080100849,35080100848,-1,829,1940,0
35090339534,35090339534,0,1551,1554,0
35095185037,35095185038,1,2034,1618,0
35095871046,35095871046,0,2205,2152,0
35097981938,35097981939,1,2095,2049,0
35098957146,35098957147,1,1297,1648,0
35100363451,35100363453,2,1342,1750,0
35105539884,35105539885,1,2054,1423,0
35109258585,35109258584,-1,1129,1795,0
35110652639,35110652638,-1,1088,1461,0
35113131222,35113131223,1,1688,1678,0
35117488206,35117488206,0,1089,1766,0
35117611507,35117611508,1,1398,1577,0
35119602632,35119602633,1,1227,1794,0
35121059701,35121059702,1,1146,1833,0
35129079429,35129079429,0,795,1630,0
35129464395,35129464398,3,1750,1557,0
35130988505,35130988506,1,1124,1465,0
35131865117,35131865117,0,1097,2136,0
35137758278,35137758277,-1,1233,1213,0
35139984769,35139984770,1,1127,1843,0
35140191548,35140191550,2,1861,1611,0
35143462866,35143462866,0,1384,2710,0
35148468735,35148468736,1,963,1344,0
35150247075,35150247074,-1,1493,1653,0
35152310195,35152310194,-1,1192,1312,0
35152739112,35152739105,-7,1199,4936,0
35153154955,35153154957,2,1366,1406,0
35156995695,35156995695,0,1148,1502,0
35157322133,35157322132,-1,1186,1983,0
35157953069,35157953071,2,922,1127,0
35158489294,35158489296,2,1251,1947,0
35159186594,35159186594,0,681,1036,0
35159762095,35159762097,2,2158,2020,0
35161145475,35161145477,2,1415,1534,0
35161618387,35161618387,0,684,1388,0
35161920385,35161920394,9,44711,99575,0
35163421986,35163421986,0,1215,2043,0
35163901178,35163901178,0,881,1506,0
35167269794,35167269798,4,1415,1241,0
35169126258,35169126261,3,1196,2040,0
35170272121,35170272122,1,1462,1844,0
35173396549,35173396550,1,1403,2034,0
35173840671,35173840677,6,511,10323,0
35173940022,35173940021,-1,1154,1559,0
35174120497,35174120497,0,1161,2264,0
35177001939,35177001940,1,1979,2462,0
35180920771,35180920770,-1,1483,2122,0
35181195832,35181195834,2,1664,1817,0
35183355650,35183355649,-1,1195,1610,0
35185429402,35185429404,2,1075,1880,0
35187768090,35187768092,2,1253,1244,0
35188018431,35188018432,1,1111,1721,0
35188115973,35188115973,0,1605,2040,0
35189005637,35189005638,1,1760,1632,0
35189717329,35189717329,0,1093,1321,0
35192715430,35192715435,5,2396,1222,0
35193607618,35193607619,1,1184,1585,0
35195962301,35195962301,0,1504,1827,0
35201490850,35201490850,0,1228,1522,0
35202753301,35202753302,1,1343,1542,0
35210989702,35210989705,3,2190,2256,0
35212655651,35212655650,-1,3322,3935,0
35214346202,35214346203,1,1836,1891,0
35214815624,35214815625,1,1472,2169,0
35215359446,35215359454,8,1229,1342,0
35216019380,35216019381,1,1290,1463,0
35217003271,35217003279,8,4698,1692,0
35219039571,35219039573,2,1278,1342,0
35219241094,35219241094,0,1672,2508,0
35220272263,35220272278,15,1467,8136,0
35227447885,35227447887,2,1687,2031,0
35229017390,35229017390,0,1302,1787,0
35229247167,35229247166,-1,1441,1904,0
35229441308,35229441307,-1,1360,1891,0
35229799467,35229799466,-1,1609,1683,0
35233860541,35233860540,-1,1458,2245,0
35240628126,35240628126,0,1260,1983,0
35240790457,35240790458,1,1059,1523,0
35243817116,35243817117,1,1038,2010,0
35245558398,35245558399,1,987,1299,0
35245980927,35245980927,0,1137,1564,0
35249359314,35249359316,2,1807,2098,0
35250476710,35250476709,-1,1438,1401,0
35251215740,35251215739,-1,1140,2169,0
35253492922,35253492921,-1,826,1645,0
35254292791,35254292790,-1,1703,1873,0
35257013934,35257013915,-19,1508,1492,0
35257185230,35257185231,1,1445,1744,0
35259419573,35259419573,0,1404,2368,0
35259757503,35259757503,0,1510,1913,0
35266274785,35266274785,0,1143,1114,0
35267024201,35267024202,1,1442,1202,0
35269498265,35269498265,0,1078,1961,0
35271430638,35271430636,-2,1217,1295,0
35271897176,35271897175,-1,1362,2157,0
35274100623,35274100625,2,1459,1595,0
35274473082,35274473083,1,1338,937,0
35275492898,35275492899,1,1290,1838,0
35277383943,35277383945,2,1682,1545,0
35277564614,35277564614,0,1788,1130,0
35278091262,35278091264,2,1727,1819,0
35278310242,35278310242,0,1383,2230,0
35283021609,35283021611,2,1558,1624,0
35286680275,35286680274,-1,1855,1524,0
35288894154,35288894155,1,1450,1824,0
35290254419,35290254421,2,1668,1877,0
35290426201,35290426198,-3,1739,2326,0
35290913181,35290913181,0,1087,1488,0
35291301811,35291301813,2,1127,1311,0
35291368979,35291368975,-4,927,3629,0
35293618146,35293618146,0,1064,1369,0
35296920281,35296920283,2,1442,1867,0
35297869622,35297869634,12,1276,1590,0
35301307789,35301307789,0,1430,1978,0
35302288270,35302288270,0,1427,1391,0
35302935619,35302935621,2,1261,1826,0
35303084110,35303084130,20,1041,3341,0
35306990263,35306990265,2,1565,1639,0
35309012274,35309012275,1,2021,1886,0
35312287671,35312287672,1,1187,1100,0
35313969595,35313969596,1,1541,1119,0
35314191601,35314191599,-2,1298,1234,0
35314831970,35314831970,0,1274,1582,0
35317693778,35317693777,-1,1765,1704,0
35319874470,35319874470,0,1023,1598,0
35322712222,35322712223,1,1052,1411,0
35323092931,35323092931,0,1301,1425,0
35323944609,35323944609,0,1428,1539,0
35325624481,35325624483,2,1249,1530,0
35327996775,35327996777,2,1275,1356,0
35332731429,35332731422,-7,2404,8319,0
35333007438,35333007438,0,594,1025,0
35334047711,35334047730,19,1338,1741,0
35335118945,35335118942,-3,781,1530,0
35335469808,35335469810,2,1799,1541,0
35335575834,35335575846,12,625,691,0
35335960091,35335960092,1,1294,1548,0
35336716566,35336716571,5,1363,1090,0
35337451740,35337451738,-2,1289,1957,0
35337881077,35337881066,-11,1377,2082,0
35338512108,35338512105,-3,1710,1877,0
35339844674,35339844676,2,1235,1650,0
35341105161,35341105162,1,1635,1473,0
35344243221,35344243222,1,1015,1253,0
35344482598,35344482601,3,1907,2235,0
35345334233,35345334233,0,1124,1543,0
35348281654,35348281655,1,1260,1322,0
35350121238,35350121239,1,2251,2854,0
35351812934,35351812934,0,1542,1836,0
35352537571,35352537574,3,1268,1202,0
35352794378,35352794376,-2,47049,24760,0
35360925558,35360925559,1,843,1130,0
35362954237,35362954244,7,5015,1432,0
35363865674,35363865674,0,1762,1911,0
35364062638,35364062638,0,1443,2540,0
35366700920,35366700923,3,1833,1450,0
35370431007,35370431011,4,2184,1956,0
35370595622,35370595625,3,1581,1495,0
35371739810,35371739810,0,728,1030,0
35372647631,35372647625,-6,1001,6445,0
35372753219,35372753217,-2,1355,2009,0
35373974686,35373974689,3,1971,1678,0
35377115929,35377115930,1,1064,1683,0
35378038749,35378038748,-1,1564,2247,0
35379230937,35379230942,5,5689,2885,0
35380890994,35380890997,3,1115,1468,0
35380921175,35380921174,-1,1684,1570,0
35381147158,35381147159,1,1211,1685,0
35381649548,35381649567,19,1016,3199,0
35382578022,35382578023,1,1413,1840,0
35385314921,35385314922,1,881,1314,0
35387103014,35387103015,1,1471,1811,0
35387501652,35387501653,1,1582,2101,0
35389831920,35389831921,1,1354,1954,0
35393721085,35393721084,-1,937,1400,0
35398185017,35398185017,0,1091,1716,0
35401274809,35401274814,5,1671,1310,0
35405371923,35405371922,-1,1170,1682,0
35409132481,35409132477,-4,1125,2183,0
35410489199,35410489200,1,1421,1618,0
35410746034,35410746034,0,1664,1685,0
35411213029,35411213029,0,1277,1607,0
35413007074,35413007075,1,1654,1852,0
35413765658,35413765658,0,1416,2040,0
35414136084,35414136083,-1,1314,1806,0
35415846163,35415846162,-1,1027,2069,0
35422135781,35422135780,-1,1481,2084,0
35424731301,35424731302,1,1503,1364,0
35427648369,35427648369,0,1866,2115,0
35427942485,35427942503,18,2389,6245,0
35430866819,35430866819,0,1384,1289,0
35431902529,35431902529,0,1080,1847,0
35432463953,35432463953,0,1700,2534,0
35433588135,35433588134,-1,1313,1791,0
35438606367,35438606366,-1,1413,1690,0
35440530027,35440530024,-3,39766,17174,0
35442430088,35442430087,-1,1443,1590,0
35443857984,35443857994,10,9813,40152,0
35446053569,35446053576,7,3952,2050,0
35449421281,35449421281,0,1835,1769,0
35452130029,35452130030,1,1577,1369,0
35453330944,35453330945,1,1873,1803,0
35456782986,35456782986,0,1944,1823,0
35461688883,35461688885,2,935,1076,0
35464210423,35464210422,-1,1997,1973,0
35466385710,35466385711,1,904,1366,0
35466762088,35466762088,0,1416,1613,0
35469707722,35469707720,-2,935,1878,0
35476550713,35476550713,0,984,1464,0
35477151590,35477151588,-2,1585,1496,0
35480298525,35480298524,-1,1123,1935,0
35480442653,35480442653,0,995,1055,0
35481662714,35481662712,-2,1000,1812,0
35482684797,35482684776,-21,1087,1506,0
35483246083,35483246085,2,752,1103,0
35483997196,35483997196,0,2241,2891,0
35487527008,35487527007,-1,1544,2038,0
35488501933,35488501937,4,2438,1825,0
35489571043,35489571043,0,1168,1641,0
35490978117,35490978117,0,1470,1468,0
35492686586,35492686587,1,1136,1308,0
35492784895,35492784895,0,1181,1757,0
35493687967,35493687966,-1,1448,2230,0
35494231099,35494231100,1,1565,1671,0
35495474785,35495474783,-2,1392,2084,0
35505242509,35505242509,0,1761,1591,0
35506411389,35506411390,1,1268,1613,0
35507475611,35507475612,1,889,1745,0
35509182263,35509182262,-1,1027,1709,0
35513111899,35513111901,2,1754,1760,0
35513702605,35513702606,1,1341,1821,0
35513994644,35513994643,-1,1024,1741,0
35517451204,35517451200,-4,1120,1577,0
35522078197,35522078180,-17,870,521,0
35524993065,35524993066,1,1607,1327,0
35529455331,35529455348,17,378,849,0
35529731270,35529731279,9,2059,1531,0
35530706093,35530706094,1,2439,1954,0
35532481039,35532481040,1,922,1757,0
35535167009,35535167015,6,3142,1432,0
35535752661,35535752662,1,1596,1555,0
35538758872,35538758872,0,1539,2244,0
35538921229,35538921250,21,1746,1787,0
35539513193,35539513193,0,1459,1244,0
35542567614,35542567613,-1,1142,1005,0
35544263483,35544263485,2,1045,1979,0
35544613750,35544613755,5,1163,1003,0
35544890899,35544890899,0,1723,2059,0
35549529984,35549529986,2,2039,1806,0
35557288129,35557288125,-4,879,1660,0
35561947575,35561947576,1,1875,1879,0
35562416010,35562416009,-1,1404,1964,0
35562885293,35562885295,2,2232,1751,0
35563095233,35563095233,0,1765,2017,0
35565518491,35565518493,2,1206,2398,0
35565687797,35565687797,0,914,1637,0
35568223298,35568223298,0,1412,1729,0
35568956655,35568956655,0,1165,1503,0
35570426912,35570426913,1,1678,1889,0
35574291132,35574291125,-7,1960,6054,0
35576328014,35576328010,-4,982,1577,0
35577401153,35577401150,-3,1358,1304,0
35579688961,35579688962,1,1218,1585,0
35580186551,35580186551,0,768,785,0
35580344871,35580344872,1,1883,2627,0
35582951261,35582951261,0,1123,1476,0
35587697866,35587697867,1,1373,1764,0
35592059530,35592059531,1,1919,1174,0
35592875232,35592875214,-18,1173,926,0
35593169633,35593169629,-4,1787,6814,0
35594525534,35594525536,2,1633,2025,0
35597524434,35597524434,0,1130,1164,0
35597663575,35597663579,4,1950,1423,0
35599364435,35599364434,-1,912,1211,0
35604868475,35604868473,-2,1295,2052,0
35606295611,35606295620,9,725,1002,0
35607178463,35607178462,-1,1357,2382,0
35607967054,35607967054,0,1246,2036,0
35608752253,35608752254,1,1209,1366,0
35609351700,35609351695,-5,664,1129,0
35612582005,35612582004,-1,1415,1304,0
35613671373,35613671373,0,1335,1655,0
35616706978,35616706980,2,1183,1755,0
35619084665,35619084662,-3,1285,3331,0
35620506229,35620506229,0,1245,1992,0
35621636241,35621636242,1,1633,2025,0
35623257726,35623257725,-1,1403,2262,0
35625143348,35625143349,1,1178,1152,0
35626367685,35626367685,0,1905,2323,0
35627794253,35627794253,0,712,1135,0
35629778810,35629778809,-1,1501,1850,0
35631215135,35631215136,1,1564,2071,0
35631851473,35631851473,0,1269,2165,0
35632544608,35632544610,2,2138,2058,0
35637686443,35637686444,1,1215,1848,0
35637724406,35637724405,-1,2122,1977,0
35638580820,35638580821,1,1519,1448,0
35639417343,35639417345,2,1318,1461,0
35640859682,35640859681,-1,1312,2035,0
35642592686,35642592689,3,1523,1812,0
35643198674,35643198671,-3,1203,1855,0
35645138671,35645138674,3,1242,1339,0
35646172682,35646172682,0,1564,1892,0
35646654709,35646654707,-2,1526,2191,0
35647328978,35647328979,1,1702,2110,0
35647964959,35647964958,-1,959,1386,0
35650387716,35650387715,-1,1142,1531,0
35662130828,35662130827,-1,1600,1655,0
35662654988,35662654981,-7,1761,11748,0
35665415749,35665415749,0,1329,1790,0
35668028116,35668028117,1,1629,2155,0
35669220507,35669220509,2,2421,2181,0
35671148934,35671148935,1,1025,1466,0
35673403427,35673403427,0,1352,1742,0
35673430144,35673430145,1,1596,1704,0
35674640857,35674640856,-1,1553,1862,0
35675483087,35675483065,-22,1111,1950,0
35675725261,35675725261,0,1315,2093,0
35677765136,35677765138,2,781,1355,0
35679493179,35679493180,1,1097,1487,0
35681417401,35681417402,1,1521,1984,0
35682475034,35682475038,4,1351,1358,0
35683246287,35683246290,3,1299,1871,0
35683737650,35683737646,-4,1083,2472,0
35685762344,35685762345,1,1021,1326,0
35689189718,35689189719,1,1608,1452,0
35689856994,35689856997,3,1457,1728,0
35691345837,35691345836,-1,1654,1393,0
35693964398,35693964399,1,1464,1660,0
35697763227,35697763226,-1,2137,1900,0
35698096422,35698096423,1,1931,1849,0
35698451246,35698451247,1,1598,1721,0
35702258346,35702258345,-1,605,1093,0
35702714978,35702714978,0,1774,1595,0
35704821997,35704821999,2,1174,1236,0
35706302654,35706302655,1,1101,1426,0
35706653742,35706653743,1,1165,1004,0
35710277639,35710277640,1,1422,2305,0
35712643867,35712643866,-1,1450,1529,0
35715718974,35715718974,0,1587,1784,0
35716003590,35716003590,0,896,1593,0
35716159276,35716159277,1,1492,2193,0
35718227598,35718227600,2,888,1016,0
35724162586,35724162588,2,1126,1636,0
35726716582,35726716598,16,954,1601,0
35727784029,35727784035,6,4011,2595,0
35728574797,35728574799,2,1217,1447,0
35729312726,35729312724,-2,833,2861,0
35729362382,35729362385,3,810,1141,0
35733181409,35733181410,1,1292,1081,0
35734512212,35734512214,2,1809,1749,0
35738536523,35738536525,2,880,1046,0
35740747046,35740747041,-5,26235,8843,0
35742574525,35742574526,1,1064,1193,0
35747569550,35747569549,-1,2097,1998,0
35748722496,35748722482,-14,136,1447,0
35749911858,35749911859,1,880,1931,0
35756041581,35756041581,0,1987,1777,0
35757447279,35757447282,3,1701,1493,0
35757571597,35757571598,1,1942,1778,0
35757858369,35757858370,1,1550,1645,0
35759050923,35759050924,1,1688,2262,0
35762205954,35762205954,0,1366,1786,0
35766293459,35766293459,0,1922,2166,0
35768416837,35768416836,-1,1476,1529,0
35768878773,35768878772,-1,1390,1621,0
35771783667,35771783667,0,1245,1602,0
35775538265,35775538266,1,1639,1388,0
35776263660,35776263658,-2,1521,2201,0
35778912842,35778912842,0,1688,2019,0
35779133679,35779133677,-2,865,1437,0
35780960991,35780960990,-1,1489,1333,0
35790595843,35790595843,0,960,1578,0
35791041689,35791041688,-1,908,1155,0
35792094581,35792094580,-1,1159,1598,0
35792341011,35792341013,2,1536,1534,0
35795034846,35795034846,0,1098,1866,0
35795663190,35795663190,0,1778,1774,0
35797530055,35797530055,0,1389,1634,0
35797771323,35797771322,-1,1079,1440,0
35803476875,35803476876,1,1339,1479,0
35805960957,35805960958,1,1606,1799,0
35808385264,35808385269,5,1075,1516,0
35815046079,35815046082,3,1467,1769,0
35816814270,35816814272,2,1506,2151,0
35823346729,35823346729,0,1479,1566,0
35827556562,35827556562,0,1576,1788,0
35827974532,35827974532,0,1468,1751,0
35830857568,35830857568,0,1399,1853,0
35833837669,35833837670,1,1483,1794,0
35835444442,35835444443,1,1427,1349,0
35842801982,35842801982,0,1094,1667,0
35843760246,35843760247,1,1179,1315,0
35846746923,35846746922,-1,1142,2458,0
35847933837,35847933858,21,966,1529,0
35848387274,35848387278,4,3076,2980,0
35849156370,35849156369,-1,783,1456,0
35851167549,35851167550,1,1773,1604,0
35852585019,35852585017,-2,1217,2002,0
35856601053,35856601057,4,1039,1511,0
35860606615,35860606613,-2,1121,1773,0
35866991514,35866991519,5,2231,906,0
35867480344,35867480346,2,1414,1145,0
35868255763,35868255766,3,2238,1626,0
35870839507,35870839506,-1,1300,2201,0
35870889282,35870889282,0,898,1707,0
35873609942,35873609950,8,1649,679,0
35879469065,35879469065,0,1317,1683,0
35880903381,35880903381,0,1682,1806,0
35881884951,35881884952,1,1254,1138,0
35885412445,35885412447,2,1932,1440,0
35888605055,35888605056,1,1067,1637,0
35891508718,35891508721,3,1129,1067,0
35891780216,35891780217,1,1788,1829,0
35896169458,35896169460,2,1754,2556,0
35896397860,35896397861,1,1390,2004,0
35897933418,35897933419,1,1345,1824,0
35901709270,35901709270,0,1974,2028,0
35906597137,35906597137,0,813,1616,0
35907818461,35907818462,1,1164,1874,0
35909213522,35909213523,1,1065,1478,0
35910625671,35910625672,1,1058,1657,0
35911434547,35911434546,-1,453,464,0
35913272355,35913272356,1,1346,2515,0
35917364746,35917364747,1,1375,1716,0
35917444279,35917444276,-3,1288,2521,0
35919415743,35919415741,-2,1442,1794,0
35924052895,35924052894,-1,1699,1769,0
35925868070,35925868069,-1,795,1486,0
35927244626,35927244626,0,1296,1939,0
35927825695,35927825695,0,759,1070,0
35928036258,35928036259,1,1374,1174,0
35930711373,35930711374,1,1540,1631,0
35931308127,35931308128,1,1485,1481,0
35932332895,35932332895,0,630,692,0
35938101798,35938101798,0,1431,2326,0
35941597498,35941597498,0,1187,1693,0
35944077289,35944077289,0,1432,1985,0
35944141402,35944141402,0,1516,1736,0
35945352614,35945352614,0,1675,1843,0
35955424926,35955424927,1,1124,1677,0
35957857687,35957857687,0,1137,2927,0
35958862961,35958862960,-1,1446,1820,0
35961542581,35961542582,1,1285,1623,0
35963439507,35963439506,-1,871,1744,0
35967995728,35967995729,1,942,1514,0
35968949316,35968949316,0,1408,1679,0
35973305199,35973305205,6,2047,1184,0
35976257185,35976257186,1,2078,2641,0
35983784201,35983784201,0,1214,1617,0
35987126215,35987126215,0,1189,1187,0
35987951348,35987951350,2,1508,1577,0
35989011005,35989011001,-4,1537,2925,0
35989426958,35989426958,0,1243,1449,0
35990991173,35990991174,1,1427,2228,0
35994694231,35994694227,-4,22216,12116,0
35998243814,35998243818,4,2514,1752,0
35998914434,35998914436,2,1752,1658,0
35999126864,35999126865,1,1645,1622,0
36000899503,36000899502,-1,1061,1822,0
36001000516,36001000499,-17,1035,1944,0
36001727770,36001727771,1,860,1129,0
36003057733,36003057734,1,1444,1648,0
36006726516,36006726518,2,2222,2333,0
36007044991,36007044990,-1,925,1343,0
36008467640,36008467642,2,2441,2044,0
36010666161,36010666160,-1,1795,2321,0
36011890605,36011890609,4,1747,1500,0
36012722981,36012722981,0,1132,1057,0
36014080858,36014080858,0,1425,1643,0
36014891090,36014891089,-1,1635,2676,0
36017851497,36017851502,5,1849,1349,0
36017895844,36017895844,0,2133,1810,0
36018075592,36018075593,1,1397,1978,0
36022973454,36022973448,-6,872,3168,0
36024590642,36024590643,1,2074,2843,0
36025232651,36025232649,-2,1420,1754,0
36029183142,36029183139,-3,1038,1639,0
36030386363,36030386365,2,1479,1907,0
36031204398,36031204410,12,17089,26899,0
36034545539,36034545540,1,1389,1226,0
36035585901,36035585902,1,1058,1216,0
36037634127,36037634126,-1,1436,1768,0
36042588686,36042588685,-1,1479,1768,0
36049141926,36049141933,7,5422,1473,0
36050026302,36050026302,0,1563,2549,0
36050958857,36050958857,0,1763,2100,0
36053522631,36053522630,-1,1572,1406,0
36053912579,36053912556,-23,972,699,0
36056307830,36056307831,1,1851,2498,0
36056517593,36056517592,-1,1178,2059,0
36058964818,36058964817,-1,1200,1883,0
36059149077,36059149081,4,3900,2253,0
36059890763,36059890761,-2,956,1547,0
36060718027,36060718027,0,1212,1755,0
36062816755,36062816754,-1,1292,1372,0
36064521687,36064521685,-2,1077,1481,0
36064821441,36064821443,2,1969,1918,0
36066532155,36066532157,2,1170,1605,0
36073060551,36073060553,2,1591,1683,0
36074233944,36074233945,1,2013,1677,0
36074576025,36074576025,0,1070,1714,0
36076154418,36076154418,0,996,1831,0
36076726596,36076726597,1,2194,2080,0
36078687334,36078687337,3,1227,1449,0
36080513740,36080513739,-1,1345,1583,0
36086415614,36086415614,0,1540,2101,0
36089757681,36089757679,-2,1461,1780,0
36091326764,36091326766,2,2115,1319,0
36093794986,36093794984,-2,1538,2763,0
36094050230,36094050229,-1,1135,1953,0
36096028618,36096028619,1,1762,2007,0
36096449214,36096449214,0,1073,1384,0
36097401456,36097401457,1,1333,1683,0
36099679386,36099679388,2,840,1306,0
36103971169,36103971170,1,1037,1717,0
36104413428,36104413425,-3,1097,1674,0
36104710835,36104710835,0,917,1932,0
36106420566,36106420565,-1,942,1376,0
36108800345,36108800347,2,1487,1255,0
36111767868,36111767867,-1,1491,1781,0
36112252790,36112252793,3,1320,1752,0
36115924265,36115924266,1,1403,2342,0
36116353569,36116353570,1,1601,1562,0
36125338060,36125338059,-1,2130,2663,0
36126046177,36126046178,1,1989,2113,0
36127470965,36127470965,0,1587,1944,0
36129003866,36129003866,0,1181,1547,0
36133093166,36133093167,1,1272,1388,0
36137657146,36137657146,0,5699,9210,0
36138049370,36138049370,0,2013,1672,0
36138639330,36138639333,3,1534,1784,0
36147735151,36147735152,1,1581,2087,0
36148809434,36148809430,-4,1376,3021,0
36148947090,36148947092,2,836,1689,0
36149413091,36149413095,4,1173,1219,0
36150122130,36150122134,4,2046,1713,0
36151210930,36151210934,4,1552,1076,0
36155445273,36155445274,1,1397,1963,0
36155651427,36155651427,0,906,1512,0
36156297146,36156297147,1,1744,2665,0
36157650972,36157650975,3,1567,1509,0
36160721781,36160721781,0,1338,2062,0
36160752125,36160752125,0,1471,1868,0
36161316926,36161316925,-1,1450,1656,0
36161791830,36161791831,1,1565,1476,0
36162655593,36162655590,-3,2228,2018,0
36165146154,36165146154,0,911,1505,0
36166888851,36166888845,-6,1091,3550,0
36167745574,36167745572,-2,1191,1690,0
36168252412,36168252431,19,1475,1628,0
36168296003,36168296006,3,1349,1574,0
36169366250,36169366250,0,1150,1277,0
36172312162,36172312169,7,2435,1380,0
36173123512,36173123513,1,2522,2361,0
36173274182,36173274187,5,3755,3367,0
36177916430,36177916432,2,1699,1818,0
36179181976,36179181978,2,2116,2161,0
36188117695,36188117695,0,776,1562,0
36190965271,36190965271,0,995,1508,0
36192110094,36192110094,0,1618,2517,0
36193282287,36193282286,-1,1158,1574,0
36193371541,36193371522,-19,1217,940,0
36195611901,36195611901,0,1399,968,0
36198831193,36198831192,-1,1609,1951,0
36199563060,36199563064,4,1014,1206,0
36200744667,36200744666,-1,1034,1415,0
36201294578,36201294581,3,2384,1590,0
36202003858,36202003859,1,1378,1556,0
36207919750,36207919752,2,1548,1707,0
36208240133,36208240133,0,1252,1415,0
36208362844,36208362841,-3,1161,1815,0
36209091530,36209091534,4,2989,2685,0
36210464112,36210464115,3,1602,1106,0
36211206745,36211206745,0,1076,1536,0
36211551218,36211551219,1,1453,2334,0
36212670277,36212670277,0,1105,1954,0
36212749694,36212749678,-16,1148,1336,0
36214264103,36214264106,3,1854,1789,0
36215283801,36215283800,-1,1041,1843,0
36217609350,36217609350,0,1645,1957,0
36220508661,36220508662,1,1033,1800,0
36221736903,36221736903,0,719,1084,0
36224400878,36224400878,0,1163,1369,0
36233662200,36233662201,1,1855,2208,0
36236264034,36236264034,0,1517,1969,0
36242555878,36242555880,2,1095,1639,0
36245440458,36245440457,-1,1164,1599,0
36246623309,36246623312,3,1222,1725,0
36249279770,36249279770,0,1387,1668,0
36249356046,36249356046,0,1556,1757,0
36249982838,36249982838,0,1361,1791,0
36251368530,36251368530,0,1058,1185,0
36251885457,36251885456,-1,1450,1822,0
36254675610,36254675611,1,1358,1458,0
36256559739,36256559741,2,1621,1410,0
36257781425,36257781429,4,23380,52590,0
36259180680,36259180680,0,1479,1559,0
36260194331,36260194330,-1,1587,1899,0
36260962777,36260962778,1,1111,1179,0
36261977171,36261977171,0,1647,1836,0
36266398188,36266398190,2,1373,1655,0
36267174126,36267174127,1,1210,2149,0
36267308598,36267308594,-4,1147,1478,0
36267499903,36267499906,3,1020,1269,0
36272088903,36272088905,2,1098,1639,0
36272574989,36272574986,-3,1442,1374,0
36273507651,36273507650,-1,1249,1400,0
36274113141,36274113142,1,1681,1575,0
36275083370,36275083370,0,1188,1606,0
36277947464,36277947464,0,1381,1940,0
36283203072,36283203069,-3,1941,4855,0
36293604108,36293604108,0,1593,1454,0
36298213662,36298213661,-1,887,1104,0
36298396323,36298396321,-2,548,1025,0
36302021467,36302021470,3,1423,1417,0
36302996807,36302996807,0,1389,2126,0
36309810586,36309810589,3,1919,2038,0
36310383826,36310383826,0,1733,1840,0
36313937597,36313937597,0,1708,2405,0
36316128065,36316128065,0,1371,2540,0
36316602014,36316602017,3,1637,1892,0
36316716372,36316716373,1,1244,1941,0
36319827822,36319827818,-4,539,2295,0
36323162891,36323162890,-1,1230,1660,0
36324192095,36324192094,-1,1227,1288,0
36325025819,36325025818,-1,1474,1432,0
36327461597,36327461598,1,1646,1772,0
36328283322,36328283322,0,1182,1353,0
36331120729,36331120730,1,1218,1559,0
36334878497,36334878497,0,1264,1511,0
36340488736,36340488736,0,2624,2503,0
36341751890,36341751885,-5,1874,8446,0
36342139065,36342139069,4,1423,1377,0
36347426270,36347426267,-3,867,1825,0
36351076494,36351076491,-3,1270,2069,0
36353173065,36353173065,0,2024,2405,0
36355436226,36355436226,0,1543,1673,0
36364247982,36364247982,0,1251,1155,0
36364611363,36364611363,0,1326,1731,0
36364725262,36364725265,3,1761,1656,0
36366342215,36366342218,3,1487,1087,0
36369291130,36369291132,2,1804,2019,0
36369729367,36369729367,0,835,1032,0
36369762759,36369762765,6,3987,1397,0
36370086633,36370086639,6,1344,1293,0
36370211231,36370211233,2,1235,1481,0
36370388332,36370388331,-1,1495,2037,0
36370905947,36370905946,-1,1387,1665,0
36371353465,36371353465,0,1058,2344,0
36375405431,36375405434,3,1029,1664,0
36375797814,36375797813,-1,1372,2213,0
36377880303,36377880306,3,1130,1485,0
36381069046,36381069047,1,956,1127,0
36382234549,36382234549,0,1853,1497,0
36389794014,36389794014,0,1130,1871,0
36390494258,36390494259,1,1527,1999,0
36393423078,36393423079,1,1394,1694,0
36396484491,36396484493,2,992,1523,0
36396566495,36396566494,-1,1549,2230,0
36396647312,36396647310,-2,1419,1795,0
36399239322,36399239323,1,1550,2592,0
36401167755,36401167754,-1,954,1297,0
36402076536,36402076538,2,1597,1709,0
36402236738,36402236739,1,1152,1564,0
36403048846,36403048849,3,1423,1427,0
36404978405,36404978406,1,1818,1466,0
36408575218,36408575218,0,1225,1579,0
36408768690,36408768692,2,26872,25936,0
36409351859,36409351858,-1,1197,1929,0
36409526262,36409526249,-13,1155,1690,0
36412446766,36412446767,1,1803,1977,0
36417647687,36417647689,2,938,1356,0
36424287875,36424287875,0,721,1207,0
36429736993,36429736994,1,1219,1528,0
36430893466,36430893466,0,760,1247,0
36433394335,36433394334,-1,1047,1370,0
36435393727,36435393728,1,1777,2036,0
36436249318,36436249318,0,1612,1398,0
36441710813,36441710814,1,1366,1354,0
36442463098,36442463098,0,1908,2052,0
36443988621,36443988624,3,1374,1253,0
36444706169,36444706150,-19,1479,1315,0
36449685445,36449685445,0,1532,1871,0
36449877232,36449877233,1,1664,2032,0
36451967586,36451967592,6,14463,21144,0
36452687303,36452687303,0,1485,1539,0
36453108163,36453108161,-2,1526,2760,0
36455372742,36455372742,0,1082,1642,0
36457162111,36457162113,2,1090,1524,0
36458720293,36458720298,5,3339,1530,0
36459086987,36459086989,2,1177,1658,0
36460571466,36460571465,-1,1469,1929,0
36464025063,36464025063,0,1025,2063,0
36465967490,36465967490,0,797,1019,0
36468180694,36468180695,1,1273,1146,0
36470265675,36470265677,2,1479,1484,0
36471003001,36471003001,0,1485,1523,0
36471653619,36471653619,0,1080,870,0
36474038036,36474038033,-3,940,2337,0
36474068739,36474068738,-1,1681,1836,0
36476035213,36476035214,1,1102,2129,0
36476677038,36476677039,1,1816,2141,0
36484961991,36484961993,2,1201,1363,0
36485984523,36485984524,1,1449,1789,0
36488004215,36488004215,0,1290,1215,0
36490610782,36490610781,-1,977,1598,0
36491891093,36491891093,0,1357,1358,0
36494221309,36494221310,1,1306,1670,0
36495368828,36495368829,1,2111,2056,0
36496116175,36496116175,0,1003,1689,0
36497755474,36497755478,4,1285,1416,0
36501623481,36501623483,2,1257,1339,0
36501678561,36501678562,1,1493,1914,0
36503045522,36503045525,3,1553,1504,0
36503628200,36503628202,2,1229,1187,0
36504527686,36504527686,0,1539,1888,0
36513187291,36513187284,-7,726,3791,0
36513887499,36513887499,0,949,1828,0
36516635861,36516635862,1,1465,1504,0
36519503498,36519503497,-1,1442,2234,0
36521208091,36521208094,3,1637,1658,0
36522720358,36522720359,1,1343,1412,0
36522835202,36522835205,3,1486,1593,0
36524670434,36524670435,1,1780,1916,0
36525973281,36525973281,0,1393,1442,0
36527230242,36527230246,4,4456,3575,0
36529180567,36529180567,0,1067,1549,0
36530153116,36530153117,1,731,2330,0
36532315163,36532315162,-1,1169,1491,0
36532548814,36532548815,1,1892,1422,0
36536220038,36536220037,-1,1594,1476,0
36538266530,36538266529,-1,1291,1717,0
36538607127,36538607128,1,1876,2202,0
36539336259,36539336260,1,1771,2390,0
36540912714,36540912714,0,1188,1636,0
36542359139,36542359139,0,856,1105,0
36544224863,36544224862,-1,1517,1880,0
36545959591,36545959589,-2,780,1527,0
36546292974,36546292994,20,1128,1995,0
36546749080,36546749079,-1,1425,1718,0
36549438151,36549438153,2,1027,1261,0
36550974585,36550974589,4,5176,4097,0
36551758458,36551758460,2,1666,1722,0
36552093312,36552093334,22,954,1177,0
36554444879,36554444875,-4,1084,2264,0
36555066655,36555066656,1,1723,2007,0
36555671364,36555671364,0,939,1826,0
36556822250,36556822250,0,1479,1568,0
36559527262,36559527262,0,850,2021,0
36564177437,36564177440,3,930,1161,0
36564375947,36564375943,-4,1184,2637,0
36567715776,36567715781,5,3915,3180,0
36568640315,36568640323,8,3314,1164,0
36568887265,36568887265,0,1466,1921,0
36569831197,36569831198,1,1375,2077,0
36570457966,36570457966,0,1301,2194,0
36574102765,36574102772,7,4288,1576,0
36576925720,36576925721,1,1725,1818,0
36577683643,36577683642,-1,1807,2017,0
36579312731,36579312729,-2,677,1640,0
36581734850,36581734851,1,1613,1559,0
36584355876,36584355875,-1,1159,1938,0
36584789922,36584789922,0,928,1190,0
36585332333,36585332332,-1,1040,1299,0
36588201585,36588201585,0,1780,1911,0
36588485179,36588485187,8,541,326,0
36590242634,36590242634,0,1108,2715,0
36590398413,36590398402,-11,1042,1421,0
36591022331,36591022332,1,1953,2236,0
36597954647,36597954647,0,2117,2064,0
36598873034,36598873033,-1,1486,2093,0
36598938081,36598938084,3,5859,23103,0
36602354182,36602354186,4,2238,1683,0
36603352347,36603352347,0,1543,1781,0
36603525115,36603525114,-1,1079,1397,0
36605180157,36605180145,-12,1185,2107,0
36606285910,36606285910,0,915,1862,0
36606472589,36606472590,1,1262,1454,0
36609500985,36609500986,1,1140,1537,0
36610514041,36610514041,0,2347,2597,0
36611256313,36611256313,0,1701,1944,0
36613205670,36613205671,1,1682,2945,0
36616231998,36616231997,-1,1932,1758,0
36617918262,36617918263,1,1475,1293,0
36618963750,36618963750,0,1169,2174,0
36621376342,36621376342,0,1276,1198,0
36624231327,36624231327,0,1306,1170,0
36626418396,36626418415,19,1263,1212,0
36627221815,36627221817,2,1311,1821,0
36627659300,36627659302,2,1363,1521,0
36628201390,36628201391,1,1587,2031,0
36630510623,36630510623,0,1652,2030,0
36632576791,36632576792,1,1381,1486,0
36634311049,36634311049,0,1791,2080,0
36637539107,36637539113,6,1307,1067,0
36638157346,36638157345,-1,1300,1476,0
36641627465,36641627467,2,972,1121,0
36642778702,36642778704,2,1436,1203,0
36643723010,36643723010,0,1266,1329,0
36645184150,36645184167,17,1799,761,0
36648498834,36648498835,1,1314,1500,0
36648552776,36648552777,1,1488,1819,0
36650005625,36650005626,1,2697,2078,0
36650413701,36650413702,1,1123,1644,0
36650908087,36650908087,0,1043,1223,0
36651051534,36651051536,2,1341,1601,0
36652974510,36652974510,0,1323,1738,0
36654024541,36654024541,0,1165,1967,0
36654400114,36654400120,6,12653,36758,0
36656863377,36656863378,1,970,1541,0
36657801235,36657801238,3,1742,1247,0
36659546641,36659546638,-3,1093,1408,0
36661525130,36661525132,2,1803,1721,0
36663373785,36663373786,1,1300,1708,0
36663788909,36663788910,1,1679,3029,0
36665094491,36665094491,0,1515,1817,0
36665469151,36665469150,-1,1193,1537,0
36667547002,36667547001,-1,1328,1957,0
36668745039,36668745039,0,1144,1400,0
36669380095,36669380093,-2,1042,1286,0
36671352955,36671352956,1,1993,2039,0
36671533154,36671533154,0,1055,1540,0
36673091186,36673091187,1,1581,1798,0
36674182344,36674182344,0,940,1640,0
36681643145,36681643154,9,959,1450,0
36683316750,36683316750,0,1497,2004,0
36684302926,36684302927,1,1876,2210,0
36686422379,36686422379,0,1044,1169,0
36694287326,36694287329,3,1864,1378,0
36696449574,36696449577,3,1904,1323,0
36697315671,36697315672,1,1141,1323,0
36698029318,36698029317,-1,1227,1767,0
36700270128,36700270134,6,1650,1420,0
36700593506,36700593507,1,1269,1569,0
36701324407,36701324405,-2,1186,1776,0
36701551055,36701551058,3,3747,2410,0
36705627935,36705627935,0,2155,2040,0
36707798040,36707798041,1,1772,2438,0
36708710941,36708710940,-1,846,1152,0
36709624451,36709624451,0,27345,22505,0
36715056975,36715056976,1,1240,1661,0
36716239569,36716239569,0,1781,2240,0
36717632946,36717632944,-2,1006,1018,0
36719944277,36719944275,-2,858,2357,0
36723212514,36723212514,0,1609,1534,0
36724483731,36724483731,0,1187,1245,0
36725400299,36725400303,4,2137,2313,0
36727479426,36727479426,0,1286,1798,0
36728099205,36728099205,0,1130,1175,0
36729260617,36729260618,1,1321,1682,0
36730264349,36730264350,1,1120,1315,0
36733886062,36733886062,0,1189,1896,0
36737726610,36737726609,-1,1388,1435,0
36737923654,36737923655,1,1642,1508,0
36739215830,36739215830,0,944,1001,0
36744980198,36744980198,0,1289,1339,0
36747064031,36747064030,-1,1469,1460,0
36749189346,36749189347,1,830,1438,0
36752406790,36752406790,0,1427,1394,0
36753772876,36753772874,-2,1022,1687,0
36756894983,36756894983,0,1681,2439,0
36757707595,36757707598,3,1387,1286,0
36758737571,36758737572,1,1320,1498,0
36759965376,36759965377,1,939,1543,0
36760424053,36760424053,0,968,1867,0
36762390233,36762390234,1,1726,1769,0
36762444282,36762444282,0,1437,1322,0
36765852937,36765852936,-1,1737,2281,0
36766793313,36766793313,0,1152,1729,0
36766877461,36766877462,1,1570,1829,0
36767702339,36767702340,1,1315,1713,0
36767750614,36767750609,-5,1216,4603,0
36773544615,36773544615,0,848,1596,0
36773792187,36773792183,-4,1280,1743,0
36776650041,36776650042,1,2484,2230,0
36777665351,36777665352,1,1625,1879,0
36777993239,36777993242,3,2153,2594,0
36783294652,36783294650,-2,907,1511,0
36791245175,36791245174,-1,1503,2016,0
36792804202,36792804205,3,4961,22659,0
36794759900,36794759902,2,1244,1501,0
36796328886,36796328904,18,4047,1356,0
36798288606,36798288606,0,1239,1489,0
36798742922,36798742925,3,945,1068,0
36800419728,36800419729,1,1403,1408,0
36801932302,36801932301,-1,1268,1575,0
36805048054,36805048055,1,1376,1720,0
36806229401,36806229402,1,1562,1394,0
36806626518,36806626518,0,1407,1872,0
36807280866,36807280866,0,1471,1700,0
36807623534,36807623536,2,1518,2253,0
36807734338,36807734339,1,1278,1819,0
36809779546,36809779545,-1,973,1404,0
36810702276,36810702278,2,1335,1782,0
36812338849,36812338849,0,1267,1546,0
36815763522,36815763522,0,1069,1092,0
36816364823,36816364836,13,1220,1664,0
36816867593,36816867593,0,1172,1655,0
36819076705,36819076703,-2,1297,1111,0
36820809609,36820809611,2,1020,1340,0
36820837857,36820837858,1,1224,1523,0
36822918192,36822918194,2,1580,2081,0
36823399497,36823399496,-1,1681,2340,0
36824737320,36824737321,1,1442,1755,0
36826802734,36826802734,0,1383,2004,0
36829806265,36829806266,1,1727,1618,0
36830924278,36830924279,1,1203,1383,0
36831075085,36831075084,-1,2100,2499,0
36833370630,36833370628,-2,1989,2411,0
36835880806,36835880806,0,2166,1892,0
36836243744,36836243746,2,1564,1961,0
36838580247,36838580246,-1,1046,1661,0
36839057688,36839057686,-2,1514,1683,0
36841077926,36841077927,1,848,1254,0
36844038798,36844038802,4,1631,1847,0
36844695956,36844695957,1,1814,2082,0
36847831895,36847831903,8,3362,1189,0
36851107477,36851107477,0,1898,1433,0
36854074923,36854074923,0,1474,1992,0
36854762342,36854762346,4,1831,1504,0
36859169974,36859169977,3,949,1752,0
36859645364,36859645365,1,1681,2736,0
36861076810,36861076811,1,1432,1294,0
36862987757,36862987759,2,1841,1275,0
36864218403,36864218401,-2,1711,2382,0
36865530138,36865530139,1,1328,1451,0
36867404446,36867404449,3,1720,1687,0
36868465439,36868465438,-1,1291,1983,0
36868791370,36868791370,0,1070,1446,0
36871998566,36871998563,-3,702,1695,0
36875322633,36875322635,2,1630,1106,0
36876391437,36876391437,0,1232,1049,0
36877716519,36877716513,-6,591,1853,0
36877907488,36877907491,3,2389,1360,0
36879188394,36879188409,15,1207,1465,0
36881262451,36881262453,2,1333,1593,0
36883973846,36883973845,-1,1523,1527,0
36888601475,36888601478,3,1792,1999,0
36889809441,36889809440,-1,1176,1450,0
36891753511,36891753512,1,1814,1552,0
36892022232,36892022233,1,1462,1111,0
36894507617,36894507618,1,2023,1994,0
36898840693,36898840695,2,1171,1558,0
36899676978,36899676978,0,1406,1858,0
36899896957,36899896961,4,964,1601,0
36901062442,36901062442,0,1161,1669,0
36903317231,36903317235,4,1543,1143,0
36915791412,36915791413,1,1326,1621,0
36916131046,36916131046,0,1630,2290,0
36918576451,36918576451,0,1023,1540,0
36920250654,36920250655,1,1302,1288,0
36925452410,36925452410,0,1721,1727,0
36926572151,36926572153,2,5411,6465,0
36930160117,36930160116,-1,1473,1790,0
36932246950,36932246952,2,1407,1609,0
36932634648,36932634650,2,2039,1623,0
36934127027,36934127028,1,1106,1777,0
36937380641,36937380643,2,1281,1654,0
36945619842,36945619841,-1,1673,2444,0
36953018436,36953018437,1,2379,2079,0
36958720149,36958720142,-7,1301,9081,0
36959244378,36959244378,0,1537,1820,0
36959761932,36959761934,2,901,1346,0
36968440126,36968440130,4,2744,1442,0
36973917331,36973917335,4,2216,1332,0
36975571782,36975571784,2,1797,2208,0
36975673858,36975673862,4,1928,1479,0
36975780374,36975780371,-3,1531,2503,0
36977148143,36977148145,2,1418,1362,0
36977554514,36977554514,0,1417,1308,0
36978933800,36978933823,23,1102,2008,0
36979925054,36979925051,-3,1213,2570,0
36981261424,36981261426,2,1240,972,0
36981558257,36981558259,2,1944,2276,0
36983814076,36983814076,0,1924,1742,0
36984722427,36984722427,0,1233,1650,0
36987554328,36987554326,-2,1443,1131,0
36987879923,36987879923,0,1106,1355,0
36987965392,36987965392,0,1271,1488,0
36991301136,36991301135,-1,1012,1574,0
36999063294,36999063293,-1,1413,1147,0
37005540161,37005540162,1,1394,1493,0
37008419162,37008419166,4,2131,1488,0
37013969071,37013969071,0,1233,2206,0
37014163574,37014163574,0,1223,1759,0
37015856298,37015856298,0,1147,1234,0
37019568554,37019568555,1,1650,1492,0
37022928511,37022928510,-1,1894,2560,0
37023451412,37023451414,2,1415,1510,0
37024022550,37024022549,-1,661,1477,0
37025234201,37025234205,4,1936,1936,0
37025845607,37025845600,-7,616,1267,0
37027231133,37027231133,0,1530,1556,0
37028621140,37028621133,-7,1210,1894,0
37029985677,37029985678,1,1761,1654,0
37033289246,37033289244,-2,907,1519,0
37034959212,37034959231,19,502,689,0
37038319283,37038319282,-1,1948,2656,0
37039168783,37039168785,2,2092,1660,0
37045237015,37045237015,0,1197,1613,0
37045747802,37045747804,2,1003,1593,0
37045944476,37045944484,8,900,1164,0
37047622549,37047622554,5,2830,1185,0
37048442247,37048442246,-1,1628,1640,0
37050452467,37050452469,2,904,902,0
37051032966,37051032967,1,1321,1484,0
37053889786,37053889785,-1,977,1345,0
37058564690,37058564689,-1,1697,2215,0
37060466889,37060466890,1,14,385,0
37061364497,37061364494,-3,1123,2163,0
37064221686,37064221686,0,1784,2413,0
37069070379,37069070379,0,1536,1830,0
37075328397,37075328398,1,1776,1322,0
37076751085,37076751083,-2,1618,1322,0
37078300205,37078300207,2,1356,1161,0
37079109379,37079109381,2,1206,1008,0
37081702634,37081702635,1,1426,1454,0
37086543827,37086543827,0,1062,1588,0
37088114923,37088114923,0,1537,1218,0
37094884485,37094884487,2,3811,2810,0
37098117875,37098117874,-1,1278,1692,0
37100884849,37100884849,0,1663,2102,0
37105856218,37105856223,5,1178,1409,0
37107469659,37107469661,2,1974,2165,0
37111183993,37111183993,0,1399,1476,0
37112496672,37112496672,0,1844,2325,0
37112969421,37112969419,-2,946,1503,0
37115028526,37115028527,1,966,1728,0
37116623621,37116623620,-1,1157,2339,0
37119549889,37119549890,1,1767,1893,0
37121408031,37121408032,1,1130,1585,0
37124742053,37124742058,5,3325,2057,0
37124972979,37124972956,-23,1763,1341,0
37126307642,37126307642,0,1302,1982,0
37127473365,37127473365,0,1616,2380,0
37128152049,37128152048,-1,1462,1838,0
37129729315,37129729314,-1,1521,1738,0
37131558504,37131558505,1,1257,1918,0
37131665426,37131665426,0,1339,2146,0
37133772857,37133772857,0,1113,1720,0
37134355324,37134355328,4,1514,1435,0
37137542682,37137542683,1,1090,1456,0
37142067909,37142067908,-1,1635,1960,0
37152102573,37152102573,0,1515,1730,0
37158116344,37158116343,-1,957,1601,0
37158446806,37158446806,0,1775,2513,0
37158759106,37158759106,0,1213,1790,0
37161367689,37161367690,1,1197,1821,0
37161807166,37161807167,1,1086,1094,0
37163164063,37163164063,0,1355,1577,0
37163876780,37163876778,-2,1151,1428,0
37164921778,37164921779,1,887,1353,0
37174826499,37174826499,0,1306,1861,0
37176234645,37176234646,1,1043,1351,0
37176364294,37176364313,19,393,816,0
37176747295,37176747295,0,1568,1895,0
37177730826,37177730828,2,1143,1988,0
37179496867,37179496869,2,1369,1680,0
37182297809,37182297810,1,1557,1363,0
37185001991,37185001989,-2,1958,1711,0
37189725476,37189725477,1,1307,1221,0
37193276239,37193276238,-1,1306,1650,0
37194407436,37194407437,1,1616,2072,0
37194841891,37194841891,0,930,823,0
37195277945,37195277942,-3,4046,8864,0
37199948406,37199948407,1,1153,1343,0
37200067391,37200067393,2,1415,1218,0
37205155901,37205155902,1,1653,1685,0
37206322177,37206322174,-3,1124,3079,0
37207738137,37207738138,1,1219,1341,0
37209159822,37209159810,-12,1119,1836,0
37212331210,37212331211,1,1238,1401,0
37216904311,37216904311,0,1360,1207,0
37217926900,37217926898,-2,1631,2089,0
37218598536,37218598538,2,1649,1214,0
37219161501,37219161494,-7,1140,2126,0
37219646967,37219646968,1,1253,941,0
37227720962,37227720966,4,5051,2576,0
37230988978,37230988978,0,2717,4191,0
37231475863,37231475862,-1,1338,1980,0
37231947331,37231947333,2,635,1214,0
37238168395,37238168397,2,2000,1509,0
37238311556,37238311556,0,1176,1646,0
37239016826,37239016827,1,1984,1596,0
37244337061,37244337059,-2,870,1443,0
37244690962,37244690962,0,1386,2088,0
37246823183,37246823182,-1,1806,2018,0
37250625111,37250625110,-1,1229,1585,0
37252791151,37252791150,-1,1188,1781,0
37255269021,37255269022,1,1529,1502,0
37258672743,37258672743,0,1065,2045,0
37259779462,37259779462,0,2072,2262,0
37262453234,37262453238,4,1321,1370,0
37264904278,37264904279,1,1746,1622,0
37270873826,37270873829,3,2202,1907,0
37275685595,37275685595,0,1219,1409,0
37276281214,37276281213,-1,1471,1696,0
37281300501,37281300503,2,1703,1681,0
37283580123,37283580125,2,1497,1585,0
37286278658,37286278660,2,2191,1340,0
37288157314,37288157316,2,1562,2316,0
37288717683,37288717682,-1,892,845,0
37289343214,37289343214,0,1140,2105,0
37290564307,37290564290,-17,1644,1138,0
37295443962,37295443962,0,1879,1595,0
37297807101,37297807105,4,1850,1462,0
37299964963,37299964967,4,1816,1135,0
37305311430,37305311430,0,1412,1331,0
37305378401,37305378399,-2,898,1207,0
37306867031,37306867031,0,1261,1904,0
37307946756,37307946774,18,964,1034,0
37308807242,37308807242,0,1488,1301,0
37320771153,37320771151,-2,2117,2319,0
37322903282,37322903283,1,1499,1662,0
37327442955,37327442955,0,1201,1677,0
37328403301,37328403304,3,1238,1478,0
37328939817,37328939815,-2,979,1243,0
37332883971,37332883970,-1,1355,1733,0
37337557441,37337557444,3,1862,2357,0
37345530176,37345530177,1,1249,1729,0
37349678630,37349678631,1,1091,1770,0
37349795802,37349795803,1,1716,1992,0
37350344073,37350344072,-1,1555,1046,0
37354812391,37354812393,2,1480,1860,0
37356747954,37356747933,-21,1020,1081,0
37357955185,37357955187,2,1226,1567,0
37358597074,37358597073,-1,1149,2265,0
37359111336,37359111336,0,1332,1938,0
37363928528,37363928527,-1,1951,2140,0
37365521250,37365521249,-1,1575,1727,0
37367273890,37367273891,1,1356,1825,0
37369670987,37369670987,0,1637,1509,0
37375043657,37375043658,1,1637,1540,0
37376616818,37376616822,4,997,1552,0
37380701724,37380701722,-2,1341,1392,0
37382636045,37382636045,0,1617,1829,0
37383217678,37383217679,1,1968,1346,0
37383538605,37383538606,1,1176,2101,0
37383999142,37383999143,1,1907,2218,0
37386008632,37386008630,-2,1241,1844,0
37387368636,37387368636,0,1284,1431,0
37388201986,37388201988,2,858,1684,0
37389185312,37389185315,3,1674,1559,0
37390599337,37390599338,1,1353,1739,0
37390804233,37390804234,1,1624,1659,0
37392654629,37392654628,-1,801,1412,0
37395308111,37395308113,2,1244,1672,0
37396256848,37396256852,4,3844,2091,0
37398137596,37398137597,1,1674,1848,0
37401129286,37401129288,2,948,848,0
37401343802,37401343803,1,1309,1965,0
37402293528,37402293527,-1,1432,2186,0
37403177094,37403177095,1,1322,1316,0
37404165402,37404165403,1,1262,1301,0
37406543182,37406543185,3,2338,1648,0
37407047663,37407047665,2,1097,842,0
37409396280,37409396282,2,1966,1804,0
37409874966,37409874969,3,1580,939,0
37410012347,37410012347,0,1178,1409,0
37410212726,37410212729,3,1825,1398,0
37410387419,37410387420,1,1262,1285,0
37415669165,37415669165,0,1305,1538,0
37418578679,37418578680,1,1305,1180,0
37419369423,37419369425,2,1420,1669,0
37422666637,37422666639,2,1393,1251,0
37423973878,37423973884,6,3884,1708,0
37424495125,37424495127,2,1700,1424,0
37426451769,37426451769,0,1515,2061,0
37426649921,37426649921,0,2397,2034,0
37427760065,37427760064,-1,1136,1493,0
37429976825,37429976826,1,1056,1249,0
37432737514,37432737513,-1,1793,1587,0
37435460082,37435460082,0,1219,2193,0
37435570990,37435570991,1,1310,1569,0
37436089709,37436089709,0,928,1606,0
37437619747,37437619746,-1,1045,2106,0
37439425246,37439425246,0,1959,1477,0
37440859598,37440859599,1,1009,1081,0
37444108187,37444108189,2,1490,1828,0
37446020989,37446020987,-2,1385,1362,0
37446615786,37446615786,0,1072,1455,0
37449347473,37449347474,1,1190,1233,0
37449534902,37449534901,-1,1607,1874,0
37449874200,37449874200,0,1900,2336,0
37450442995,37450442996,1,1342,1310,0
37452609395,37452609397,2,1168,1095,0
37458048163,37458048163,0,1370,1814,0
37459623393,37459623393,0,1508,2543,0
37463692722,37463692724,2,1455,2184,0
37465441951,37465441952,1,2148,3298,0
37468287362,37468287363,1,1540,1702,0
37468444550,37468444555,5,25685,21812,0
37469579368,37469579367,-1,1466,1526,0
37473884116,37473884116,0,2119,2095,0
37476449407,37476449409,2,1871,1987,0
37478789351,37478789331,-20,2386,1396,0
37480256828,37480256831,3,1425,1269,0
37480353197,37480353197,0,1099,2069,0
37485818952,37485818952,0,2232,2263,0
37487085010,37487085011,1,1555,2079,0
37487392014,37487392014,0,1547,1266,0
37488662935,37488662935,0,1239,1389,0
37491053847,37491053847,0,1473,1695,0
37493259191,37493259192,1,1485,1693,0
37495010469,37495010471,2,1453,1520,0
37496100197,37496100198,1,918,1273,0
37497375154,37497375163,9,2908,1338,0
37498225682,37498225682,0,1474,2013,0
37499081103,37499081105,2,1110,1848,0
37500524596,37500524594,-2,1721,1656,0
37503482786,37503482782,-4,999,2246,0
37503521134,37503521134,0,1214,996,0
37505472538,37505472537,-1,1934,2571,0
37507086240,37507086239,-1,1160,1569,0
37516068958,37516068958,0,942,1274,0
37519090899,37519090898,-1,1658,1611,0
37521754792,37521754794,2,1696,1597,0
37522085235,37522085240,5,2901,1389,0
37522596685,37522596685,0,1065,1984,0
37525290268,37525290270,2,1232,1671,0
37525733145,37525733144,-1,1356,1518,0
37526963548,37526963549,1,1418,1798,0
37533686140,37533686137,-3,1071,1577,0
37534776111,37534776112,1,1040,1490,0
37538140071,37538140072,1,920,1985,0
37538267921,37538267924,3,2510,2157,0
37542231515,37542231515,0,1738,2292,0
37545402873,37545402876,3,1499,2033,0
37546841058,37546841053,-5,924,2259,0
37547912342,37547912343,1,1485,1543,0
37548957717,37548957717,0,1756,1255,0
37550706233,37550706234,1,1422,1658,0
37552922436,37552922437,1,1303,1581,0
37554809961,37554809962,1,1886,1482,0
37557005100,37557005106,6,340,2228,0
37560043328,37560043328,0,1022,1260,0
37561324478,37561324479,1,1192,1844,0
37562078196,37562078188,-8,250,4792,0
37562149118,37562149118,0,1697,2150,0
37562334254,37562334254,0,985,1236,0
37563271602,37563271602,0,1596,2072,0
37564606481,37564606482,1,1423,1446,0
37564996294,37564996294,0,1477,1215,0
37569454044,37569454044,0,1545,1430,0
37570265431,37570265435,4,1289,1493,0
37572401937,37572401938,1,1529,1954,0
37574473704,37574473697,-7,1094,5031,0
37577419574,37577419569,-5,983,2019,0
37579662324,37579662325,1,1561,1751,0
37580895431,37580895431,0,765,1282,0
37583040765,37583040763,-2,1170,1804,0
37584077683,37584077682,-1,1339,1795,0
37587726034,37587726034,0,817,1275,0
37588663584,37588663584,0,754,1667,0
37591267829,37591267833,4,2405,1512,0
37592719847,37592719845,-2,582,1422,0
37593866618,37593866617,-1,1266,2349,0
37596353270,37596353270,0,1094,1087,0
37599439262,37599439263,1,2008,1603,0
37599906794,37599906797,3,1740,2002,0
37602548634,37602548637,3,1481,1737,0
37603274330,37603274329,-1,1099,2051,0
37605417356,37605417353,-3,1226,1434,0
37608539403,37608539401,-2,761,1216,0
37609521694,37609521693,-1,1449,2099,0
37610939827,37610939827,0,1172,1626,0
37615883614,37615883617,3,1176,1043,0
37619322050,37619322051,1,2118,2170,0
37619559878,37619559879,1,1225,1557,0
37622020428,37622020429,1,1739,2185,0
37622547813,37622547814,1,990,1336,0
37633544775,37633544774,-1,708,1126,0
37638327613,37638327613,0,1364,1770,0
37640951632,37640951631,-1,1132,1030,0
37641950190,37641950188,-2,1050,2053,0
37643527530,37643527532,2,831,1095,0
37645542354,37645542354,0,1262,1984,0
37645733089,37645733090,1,1226,2024,0
37646698406,37646698398,-8,1660,10448,0
37646793767,37646793769,2,1270,1753,0
37647576397,37647576397,0,1216,1408,0
37649057397,37649057397,0,1112,1269,0
37652061927,37652061927,0,1011,1720,0
37657103191,37657103191,0,1165,1303,0
37661732247,37661732247,0,1274,1728,0
37666178569,37666178570,1,1185,1897,0
37667986810,37667986810,0,1281,1739,0
37668445478,37668445478,0,1394,1764,0
37671503867,37671503866,-1,1816,1816,0
37676372503,37676372503,0,1641,1987,0
37677970046,37677970040,-6,1089,1653,0
37680064706,37680064708,2,686,1501,0
37680419923,37680419930,7,2444,1466,0
37681454598,37681454597,-1,1605,1957,0
37681606165,37681606166,1,1625,2237,0
37682501503,37682501503,0,1109,1573,0
37683034846,37683034845,-1,1089,1815,0
37684180093,37684180093,0,1751,2131,0
37684787005,37684787005,0,1695,1643,0
37687028188,37687028186,-2,1230,3324,0
37688812246,37688812246,0,916,1152,0
37689947054,37689947054,0,1078,1889,0
37692722265,37692722266,1,1045,840,0
37695296753,37695296755,2,1236,1347,0
37696504193,37696504195,2,2842,1649,0
37697744423,37697744422,-1,1255,1912,0
37700059744,37700059744,0,1273,1627,0
37701270362,37701270361,-1,1046,1634,0
37704573765,37704573762,-3,1364,2175,0
37705360370,37705360369,-1,529,802,0
37705497966,37705497968,2,1544,1885,0
37706509529,37706509527,-2,1206,2157,0
37706925244,37706925247,3,1502,1869,0
37707531971,37707531974,3,916,1148,0
37711719497,37711719497,0,1393,1623,0
37714021286,37714021287,1,1363,1180,0
37715753873,37715753870,-3,2175,5382,0
37718442877,37718442877,0,1450,1460,0
37722025959,37722025962,3,1172,1946,0
37723398282,37723398285,3,1542,1771,0
37723620154,37723620154,0,994,1612,0
37723945635,37723945637,2,845,1595,0
37725215450,37725215452,2,3181,2883,0
37726076761,37726076762,1,1388,1808,0
37728370570,37728370571,1,1656,1870,0
37732149353,37732149355,2,1237,1803,0
37732335606,37732335605,-1,1414,1350,0
37732730657,37732730656,-1,1111,1275,0
37734561465,37734561462,-3,777,1709,0
37736442527,37736442526,-1,1437,1812,0
37741696239,37741696243,4,2314,1684,0
37743534502,37743534503,1,1410,1221,0
37751260694,37751260695,1,2215,1986,0
37754029187,37754029186,-1,1303,1609,0
37754774520,37754774521,1,1678,1624,0
37756357489,37756357490,1,1360,1848,0
37765016128,37765016135,7,813,1738,0
37765209228,37765209230,2,1650,2313,0
37765939680,37765939682,2,1484,1717,0
37766968849,37766968846,-3,1383,2333,0
37768572345,37768572345,0,1840,2297,0
37770948450,37770948450,0,1934,2228,0
37771864482,37771864480,-2,974,1143,0
37774729973,37774729973,0,1581,1941,0
37775662348,37775662341,-7,811,6254,0
37776069808,37776069807,-1,1103,1663,0
37776220213,37776220235,22,1847,6293,0
37778889694,37778889693,-1,1383,2346,0
37782527922,37782527921,-1,1062,1781,0
37787246283,37787246285,2,1170,1601,0
37787534311,37787534308,-3,721,1733,0
37799693575,37799693579,4,1523,1680,0
37800213756,37800213756,0,1759,2003,0
37800806821,37800806821,0,1241,1731,0
37801901259,37801901262,3,1272,1635,0
37802570411,37802570413,2,958,1710,0
37802673380,37802673382,2,1616,1550,0
37804210770,37804210770,0,1139,1671,0
37806390618,37806390616,-2,1521,2409,0
37806521108,37806521109,1,885,1390,0
37807590507,37807590507,0,1457,1836,0
37809898100,37809898101,1,1868,1115,0
37810498842,37810498841,-1,1640,2325,0
37812004487,37812004481,-6,1732,5444,0
37815831491,37815831491,0,1280,1911,0
37820966275,37820966277,2,1906,1930,0
37821462908,37821462911,3,3005,2383,0
37823717510,37823717509,-1,1037,1697,0
37827374635,37827374638,3,1378,1453,0
37829292859,37829292859,0,1399,1676,0
37830275694,37830275694,0,1478,2238,0
37831662202,37831662206,4,1194,1318,0
37832920594,37832920595,1,1215,2060,0
37836298967,37836298967,0,1692,1822,0
37838174986,37838174984,-2,19785,26978,0
37838838550,37838838550,0,985,1276,0
37840541910,37840541916,6,1455,1634,0
37841036166,37841036167,1,1375,1288,0
37843528375,37843528377,2,2283,1816,0
37845381762,37845381763,1,908,1154,0
37847520199,37847520201,2,1403,2138,0
37848612488,37848612485,-3,20680,13294,0
37849374989,37849374989,0,1929,1502,0
37854993945,37854993945,0,1620,1752,0
37855410688,37855410685,-3,1506,2655,0
37858049230,37858049230,0,1156,2053,0
37862035686,37862035680,-6,1258,4623,0
37862825753,37862825755,2,859,834,0
37863368734,37863368733,-1,1266,1414,0
37863494758,37863494759,1,690,1387,0
37864371423,37864371425,2,1069,1899,0
37867965178,37867965177,-1,1379,1318,0
37869852066,37869852066,0,1532,1869,0
37869948355,37869948353,-2,1716,2909,0
37871618324,37871618325,1,1107,1141,0
37872655440,37872655446,6,2650,1205,0
37877387806,37877387812,6,2396,1191,0
37878408113,37878408110,-3,999,1508,0
37881136665,37881136661,-4,1141,3250,0
37883368087,37883368077,-10,39339,14845,0
37884086334,37884086334,0,1316,1709,0
37885678341,37885678340,-1,994,1114,0
37886675355,37886675359,4,2383,2622,0
37906539822,37906539822,0,692,1322,0
37907980071,37907980073,2,1275,1524,0
37910435273,37910435274,1,1308,929,0
37916747984,37916747985,1,1682,1281,0
37917770001,37917770002,1,1523,1216,0
37920348218,37920348219,1,1602,1987,0
37922481526,37922481528,2,1049,2036,0
37923396744,37923396743,-1,1858,1647,0
37923499922,37923499927,5,2224,1153,0
37924079290,37924079289,-1,1284,1556,0
37928496167,37928496169,2,1472,1696,0
37936123377,37936123377,0,1613,1951,0
37938627692,37938627694,2,1653,2087,0
37938841326,37938841327,1,1042,1845,0
37939809261,37939809262,1,1302,1608,0
37941451641,37941451641,0,1459,1593,0
37942243809,37942243810,1,1595,1530,0
37944537437,37944537439,2,1826,2058,0
37944998706,37944998705,-1,1461,1409,0
37948367211,37948367213,2,1037,1558,0
37951574493,37951574493,0,1102,1583,0
37952853375,37952853377,2,993,1869,0
37953452950,37953452950,0,1960,1723,0
37953493498,37953493497,-1,927,1718,0
37955322053,37955322053,0,1463,2420,0
37955782807,37955782807,0,1392,2110,0
37958361409,37958361405,-4,4801,12517,0
37960326730,37960326730,0,1618,1716,0
37960833784,37960833782,-2,1864,2539,0
37962860309,37962860315,6,14010,5208,0
37963895702,37963895702,0,1538,1966,0
37965524053,37965524053,0,1482,2596,0
37965578102,37965578102,0,997,1534,0
37966864441,37966864442,1,1298,1614,0
37968983473,37968983474,1,1346,1616,0
37971664154,37971664155,1,1594,1645,0
37974204491,37974204486,-5,1699,5419,0
37974655397,37974655398,1,1683,1604,0
37977606993,37977606998,5,1927,929,0
37978697925,37978697926,1,1214,1322,0
37985753619,37985753622,3,1091,1685,0
37986104585,37986104587,2,1606,2011,0
37987223931,37987223934,3,1699,1701,0
37988802753,37988802755,2,2253,2128,0
37989120163,37989120165,2,1022,1438,0
37991040515,37991040517,2,1119,1496,0
37992591544,37992591544,0,1351,1582,0
37994872387,37994872390,3,2397,1296,0
37994998710,37994998711,1,1629,1040,0
37995343609,37995343609,0,1574,1876,0
37996723167,37996723166,-1,1167,1604,0
37997077244,37997077246,2,1544,1195,0
37997862326,37997862326,0,1508,1989,0
38001113348,38001113349,1,1692,1236,0
38001425101,38001425102,1,1216,1181,0
38002961283,38002961286,3,1538,1725,0
38003507616,38003507618,2,1539,1426,0
38004242900,38004242910,10,1519,1766,0
38005265292,38005265309,17,1814,1643,0
38008632859,38008632858,-1,1099,1520,0
38010873463,38010873463,0,1262,1669,0
38011444418,38011444421,3,1447,1619,0
38012861360,38012861360,0,1740,2094,0
38014230342,38014230343,1,1329,1756,0
38016243458,38016243457,-1,1430,1920,0
38016540515,38016540514,-1,990,1759,0
38022021669,38022021671,2,1787,2578,0
38022941854,38022941859,5,1606,2015,0
38027000191,38027000193,2,1316,1523,0
38028218292,38028218294,2,1143,1680,0
38028329314,38028329314,0,1507,1522,0
38029392685,38029392682,-3,1974,2911,0
38029463910,38029463913,3,1646,2090,0
38032068658,38032068659,1,4266,2589,0
38034083398,38034083397,-1,931,1130,0
38034777503,38034777503,0,866,930,0
38035098497,38035098497,0,1181,2225,0
38038420638,38038420643,5,2744,1405,0
38038843639,38038843641,2,844,1295,0
38042135036,38042135036,0,38165,22708,0
38043777965,38043777966,1,1433,1803,0
38052089357,38052089358,1,1781,1662,0
38056051494,38056051492,-2,1153,2345,0
38056379486,38056379486,0,1390,1778,0
38058358971,38058358969,-2,1266,2411,0
38059376362,38059376364,2,915,1464,0
38062841746,38062841746,0,1533,2125,0
38063827566,38063827561,-5,996,2463,0
38064433212,38064433213,1,1457,1560,0
38064486639,38064486635,-4,713,2031,0
38066405101,38066405098,-3,1823,1975,0
38066997165,38066997165,0,1530,1772,0
38070622821,38070622819,-2,1001,1433,0
38071843401,38071843412,11,935,1473,0
38074326882,38074326882,0,1606,1889,0
38077661176,38077661181,5,2488,1659,0
38077865843,38077865845,2,1363,1163,0
38078033946,38078033964,18,1330,1326,0
38083758684,38083758683,-1,2319,3078,0
38086266804,38086266806,2,1325,1474,0
38086380466,38086380467,1,918,1046,0
38087167956,38087167954,-2,901,1930,0
38087806542,38087806542,0,987,1342,0
38089285606,38089285606,0,1142,1962,0
38091664593,38091664594,1,1683,1695,0
38094604079,38094604077,-2,903,1315,0
38094786525,38094786521,-4,1464,1630,0
38095462264,38095462266,2,2040,2029,0
38096207859,38096207858,-1,940,1016,0
38096637231,38096637231,0,1200,1187,0
38096845061,38096845060,-1,1391,1454,0
38097818101,38097818102,1,1416,1422,0
38102447033,38102447036,3,1225,1164,0
38102566973,38102566974,1,529,681,0
38107591814,38107591814,0,1648,1995,0
38109252231,38109252230,-1,1411,1975,0
38115335698,38115335699,1,1294,1762,0
38116045493,38116045492,-1,1256,1119,0
38118117705,38118117705,0,1111,1675,0
38119039988,38119039990,2,1157,1463,0
38120241828,38120241829,1,2036,1846,0
38122752070,38122752066,-4,1148,1412,0
38123412451,38123412450,-1,815,2248,0
38124716160,38124716159,-1,1150,1711,0
38128813414,38128813415,1,1403,1666,0
38130379851,38130379851,0,1574,1982,0
38131674621,38131674618,-3,1755,1974,0
38133066318,38133066320,2,1312,1813,0
38133917299,38133917298,-1,904,1236,0
38134882373,38134882373,0,1280,1911,0
38139459530,38139459530,0,2268,2897,0
38142596498,38142596498,0,1404,1942,0
38145947058,38145947058,0,1914,2636,0
38146814013,38146814013,0,1526,2058,0
38150729013,38150729014,1,1285,1903,0
38151864399,38151864405,6,4263,2450,0
38157926153,38157926150,-3,1109,891,0
38158150625,38158150629,4,1069,1251,0
38158190188,38158190204,16,1468,1482,0
38158703224,38158703222,-2,1401,1871,0
38159161822,38159161822,0,630,1149,0
38164966517,38164966519,2,1188,1317,0
38165855980,38165855979,-1,1627,2543,0
38169848283,38169848285,2,1624,1405,0
38180693998,38180694013,15,732,2384,0
38186633490,38186633487,-3,1294,1021,0
38187746763,38187746762,-1,1311,1974,0
38192652825,38192652826,1,1495,2369,0
38194120885,38194120886,1,1522,1474,0
38195789755,38195789754,-1,1441,1500,0
38195928015,38195928006,-9,1076,1109,0
38196476569,38196476569,0,2139,1699,0
38199086653,38199086662,9,1600,811,0
38200209626,38200209626,0,1481,2137,0
38202070563,38202070562,-1,1307,1947,0
38202732643,38202732644,1,1535,2258,0
38203344255,38203344257,2,1487,1053,0
38204633730,38204633730,0,1395,1629,0
38205659508,38205659498,-10,210,1332,0
38206375003,38206375009,6,15876,14591,0
38208625035,38208625038,3,1796,1227,0
38214428590,38214428597,7,3246,1449,0
38214838832,38214838833,1,1361,1568,0
38218050432,38218050432,0,1624,1504,0
38219027122,38219027118,-4,1472,2342,0
38219327951,38219327953,2,1429,1073,0
38223203835,38223203834,-1,1374,1673,0
38224890344,38224890342,-2,1307,1591,0
38226261273,38226261275,2,792,1256,0
38226348893,38226348894,1,1448,1629,0
38227890740,38227890738,-2,1422,1294,0
38227917070,38227917070,0,1702,1679,0
38227990558,38227990559,1,1510,1549,0
38228345195,38228345194,-1,1076,987,0
38232823431,38232823432,1,904,1681,0
38232939613,38232939605,-8,1114,1702,0
38233926814,38233926814,0,788,987,0
38234761959,38234761962,3,11309,8745,0
38237027218,38237027220,2,1427,1339,0
38238136102,38238136103,1,1167,1893,0
38238475676,38238475665,-11,1211,1169,0
38238636623,38238636622,-1,779,1411,0
38240889558,38240889558,0,837,1433,0
38241384730,38241384727,-3,1960,2116,0
38243461463,38243461461,-2,1446,2102,0
38245671941,38245671944,3,2065,2352,0
38245908630,38245908634,4,1411,1545,0
38248420271,38248420266,-5,1514,4019,0
38250174141,38250174139,-2,1332,1402,0
38251957162,38251957163,1,1123,1269,0
38254084676,38254084674,-2,5406,7601,0
38255352131,38255352131,0,1233,1433,0
38255524039,38255524039,0,1234,1645,0
38260920340,38260920339,-1,17031,8342,0
38261576737,38261576738,1,1209,2451,0
38262060497,38262060497,0,1447,1844,0
38262637691,38262637691,0,1708,2823,0
38262913467,38262913469,2,1324,1318,0
38268712991,38268712995,4,1309,999,0
38269129410,38269129413,3,713,776,0
38271821186,38271821187,1,1014,1433,0
38272083198,38272083201,3,1269,1520,0
38275176806,38275176806,0,1604,2668,0
38275396190,38275396192,2,1854,2062,0
38275873523,38275873526,3,1179,1204,0
38276680782,38276680783,1,1720,2537,0
38277340552,38277340552,0,1991,2386,0
38280070519,38280070518,-1,1252,1477,0
38281196459,38281196461,2,1703,2532,0
38281739607,38281739608,1,1745,1540,0
38283331654,38283331654,0,1552,1464,0
38286819122,38286819123,1,1374,1671,0
38291916354,38291916353,-1,1573,1926,0
38295442202,38295442204,2,1246,1580,0
38295857063,38295857062,-1,1699,2350,0
38297568106,38297568108,2,2094,2549,0
38298855943,38298855941,-2,1071,2023,0
38304936644,38304936646,2,1061,1013,0
38305571162,38305571162,0,1581,1842,0
38306883039,38306883039,0,1432,910,0
38312547338,38312547339,1,1268,1930,0
38314203238,38314203238,0,976,1522,0
38315283299,38315283301,2,1121,1350,0
38316017290,38316017285,-5,32130,14367,0
38320774283,38320774282,-1,841,1053,0
38321646262,38321646263,1,1567,1230,0
38323387217,38323387219,2,1299,1832,0
38324851410,38324851413,3,956,1549,0
38325701310,38325701289,-21,937,391,0
38327127278,38327127278,0,1477,1828,0
38330720002,38330720003,1,1297,1605,0
38336244408,38336244407,-1,1255,1518,0
38337024059,38337024057,-2,1470,2176,0
38338562489,38338562491,2,1156,896,0
38343683262,38343683261,-1,846,1332,0
38343972474,38343972485,11,1428,1816,0
38346210455,38346210457,2,1133,1299,0
38346525356,38346525358,2,2204,1373,0
38349520235,38349520236,1,1947,2044,0
38354501030,38354501027,-3,1640,2020,0
38356448342,38356448343,1,1197,1744,0
38357800854,38357800858,4,1139,1312,0
38359233318,38359233321,3,1426,1380,0
38361253735,38361253733,-2,1269,1568,0
38365317274,38365317274,0,1328,1635,0
38365946735,38365946735,0,712,998,0
38367784556,38367784555,-1,1115,1326,0
38372867495,38372867494,-1,949,1371,0
38377074364,38377074365,1,1895,2176,0
38378849900,38378849900,0,2032,2084,0
38383455599,38383455597,-2,1519,1749,0
38385404861,38385404865,4,1345,1540,0
38385633962,38385633963,1,910,1341,0
38386366599,38386366599,0,1653,1237,0
38386446846,38386446846,0,1063,984,0
38389544829,38389544829,0,1015,1710,0
38391311623,38391311619,-4,950,2393,0
38393680145,38393680146,1,1509,2128,0
38396142146,38396142153,7,953,410,0
38403009783,38403009782,-1,2749,3322,0
38408047566,38408047566,0,1264,1534,0
38408706303,38408706305,2,1110,997,0
38410740336,38410740338,2,1929,1370,0
38411204141,38411204149,8,18698,54920,0
38413999302,38413999303,1,1977,2282,0
38414563400,38414563399,-1,1765,1873,0
38414987998,38414987998,0,1339,2096,0
38417230989,38417230993,4,1396,1668,0
38418769434,38418769434,0,1427,2113,0
38418831662,38418831654,-8,641,925,0
38418870231,38418870224,-7,1177,2018,0
38418921473,38418921473,0,57721,48017,0
38420351062,38420351065,3,2359,1360,0
38420414949,38420414950,1,1201,1368,0
38420965761,38420965761,0,2173,2116,0
38424991746,38424991746,0,1374,2155,0
38425222969,38425222965,-4,576,1489,0
38428401327,38428401327,0,865,1054,0
38433199044,38433199043,-1,1389,1513,0
38433263836,38433263839,3,1543,1242,0
38434871203,38434871203,0,803,1155,0
38435482582,38435482585,3,1846,2133,0
38436794710,38436794710,0,1405,2372,0
38437874236,38437874246,10,13871,33535,0
38439296306,38439296305,-1,1527,1774,0
38441885134,38441885129,-5,2316,7311,0
38444367058,38444367057,-1,1707,1672,0
38444503376,38444503378,2,1460,1465,0
38445627063,38445627063,0,1003,1529,0
38446379970,38446379969,-1,1449,1957,0
38451051942,38451051941,-1,1038,1730,0
38452709986,38452709987,1,1830,2304,0
38452777854,38452777855,1,1145,1393,0
38453174272,38453174271,-1,1629,2085,0
38458216846,38458216852,6,3350,1278,0
38461454078,38461454080,2,1387,1581,0
38461704863,38461704865,2,2071,2292,0
38462364801,38462364802,1,1168,1182,0
38467308397,38467308397,0,1519,1889,0
38469961422,38469961426,4,1277,1693,0
38472694522,38472694523,1,1182,1793,0
38474364250,38474364250,0,2545,2155,0
38478870938,38478870939,1,1376,1689,0
38485984022,38485984021,-1,1296,1289,0
38488613758,38488613763,5,815,521,0
38489475990,38489475991,1,1392,1795,0
38492905867,38492905865,-2,962,1287,0
38499371846,38499371839,-7,1695,1635,0
38500219337,38500219337,0,1716,2125,0
38501000697,38501000699,2,1279,1801,0
38504499334,38504499336,2,1173,917,0
38504911729,38504911731,2,1286,1756,0
38507540689,38507540682,-7,2531,8595,0
38508131197,38508131196,-1,1391,1487,0
38508568470,38508568453,-17,741,285,0
38509703367,38509703367,0,1493,1155,0
38515499927,38515499926,-1,1040,1309,0
38517209622,38517209622,0,1374,1539,0
38518288200,38518288196,-4,1995,4340,0
38518957084,38518957083,-1,1270,1312,0
38520510361,38520510360,-1,1744,1671,0
38521433437,38521433440,3,1474,1244,0
38524508530,38524508533,3,1706,1288,0
38525005118,38525005119,1,1869,2014,0
38525090762,38525090764,2,1488,1713,0
38525997081,38525997082,1,1302,1233,0
38527264433,38527264436,3,1643,1553,0
38528025732,38528025731,-1,1093,1613,0
38529683869,38529683851,-18,1329,1686,0
38530097704,38530097702,-2,1249,2018,0
38530393882,38530393883,1,1272,1609,0
38531052151,38531052152,1,1170,1129,0
38531606585,38531606583,-2,1313,1631,0
38532613338,38532613338,0,892,1989,0
38534126729,38534126730,1,917,1418,0
38538673483,38538673482,-1,1381,1539,0
38540239946,38540239946,0,1449,1660,0
38542019415,38542019419,4,1507,1190,0
38545923491,38545923492,1,1510,1982,0
38547221008,38547221008,0,2008,2095,0
38548857322,38548857320,-2,1168,2836,0
38550456946,38550456946,0,1176,1594,0
38553921689,38553921690,1,1192,1572,0
38556417914,38556417913,-1,1642,2149,0
38556807472,38556807471,-1,1444,2062,0
38559018367,38559018367,0,1265,1678,0
38560337589,38560337590,1,1211,840,0
38566195601,38566195603,2,1092,1652,0
38570211833,38570211834,1,2104,2098,0
38576016078,38576016078,0,1199,1299,0
38577618139,38577618145,6,4397,2031,0
38578842174,38578842181,7,2229,1547,0
38585187934,38585187933,-1,1390,1937,0
38586391588,38586391587,-1,1540,1344,0
38587634862,38587634861,-1,1253,1937,0
38587752052,38587752033,-19,1130,1507,0
38589894339,38589894339,0,837,1026,0
38590948443,38590948442,-1,1473,1312,0
38591223653,38591223652,-1,1541,1877,0
38597470762,38597470762,0,1760,2485,0
38598142771,38598142770,-1,813,904,0
38599531222,38599531223,1,1163,1880,0
38600059286,38600059286,0,1273,1440,0
38605147776,38605147775,-1,1517,1707,0
38605909179,38605909180,1,1153,1733,0
38608820249,38608820251,2,1904,1416,0
38610221820,38610221819,-1,1529,1624,0
38612463126,38612463126,0,1008,1333,0
38615506922,38615506922,0,1374,1440,0
38616896293,38616896294,1,1589,1526,0
38617216938,38617216939,1,902,1652,0
38618034331,38618034329,-2,1980,1937,0
38618390451,38618390453,2,1093,1696,0
38619208918,38619208916,-2,1324,1761,0
38625969095,38625969095,0,1317,2254,0
38628261189,38628261190,1,1540,1962,0
38628409522,38628409522,0,1598,2001,0
38630029042,38630029041,-1,652,1732,0
38631514243,38631514245,2,1996,2029,0
38636947255,38636947257,2,1713,1981,0
38639253190,38639253190,0,1191,1320,0
38641311462,38641311462,0,2195,1798,0
38643917850,38643917850,0,1942,1655,0
38646094626,38646094627,1,1341,1678,0
38646328663,38646328680,17,1027,954,0
38647384974,38647384978,4,3248,1920,0
38649163347,38649163346,-1,1426,1524,0
38651433585,38651433586,1,1301,1595,0
38653178502,38653178502,0,1386,1824,0
38656578531,38656578530,-1,1318,1308,0
38657031874,38657031875,1,1842,1698,0
38658924245,38658924251,6,2384,878,0
38659244005,38659244011,6,2795,1505,0
38659619379,38659619377,-2,1742,2049,0
38661057191,38661057192,1,1518,2279,0
38668507397,38668507399,2,787,928,0
38668670383,38668670366,-17,886,1265,0
38669871997,38669871997,0,1450,1487,0
38670474793,38670474797,4,1258,1027,0
38670520407,38670520406,-1,1361,2048,0
38671022420,38671022422,2,1202,1558,0
38672163655,38672163656,1,2241,1810,0
38672751555,38672751553,-2,1369,1172,0
38674573552,38674573548,-4,5090,14893,0
38675491602,38675491604,2,1009,1342,0
38677190228,38677190229,1,1061,1015,0
38677401190,38677401185,-5,1520,6266,0
38682446376,38682446377,1,1911,1720,0
38685111822,38685111825,3,1387,2141,0
38687004007,38687004006,-1,1177,1596,0
38687474227,38687474229,2,1421,1553,0
38689405613,38689405614,1,1073,1650,0
38691543517,38691543517,0,1424,1959,0
38691770506,38691770504,-2,1373,2420,0
38695889141,38695889143,2,1138,1207,0
38696851232,38696851232,0,901,1290,0
38702498761,38702498762,1,1007,1829,0
38703557109,38703557107,-2,1185,1383,0
38705726281,38705726279,-2,1513,2161,0
38706667730,38706667730,0,931,1471,0
38708028863,38708028871,8,2446,752,0
38711130602,38711130605,3,2464,2218,0
38711480035,38711480039,4,1181,1320,0
38713893686,38713893685,-1,1889,2202,0
38714688210,38714688211,1,1451,1784,0
38715418138,38715418137,-1,1183,1457,0
38716787782,38716787783,1,1419,1488,0
38719662451,38719662445,-6,1312,4032,0
38720125537,38720125536,-1,1456,1535,0
38721797158,38721797158,0,1151,1347,0
38728606801,38728606802,1,1280,1532,0
38728724090,38728724090,0,1423,2406,0
38729829128,38729829127,-1,1665,2132,0
38733564006,38733564008,2,1559,1542,0
38733870690,38733870698,8,21317,36963,0
38737823382,38737823381,-1,705,741,0
38740595783,38740595786,3,1180,1103,0
38741692406,38741692409,3,1700,2006,0
38742121574,38742121578,4,2892,1689,0
38744147229,38744147230,1,1402,1670,0
38748515145,38748515146,1,1103,2026,0
38750678721,38750678721,0,1333,1764,0
38755302882,38755302883,1,1206,1173,0
38757845355,38757845355,0,930,1485,0
38758416143,38758416129,-14,1282,1505,0
38762695126,38762695127,1,1472,2008,0
38763041277,38763041278,1,980,1102,0
38764516372,38764516371,-1,907,1577,0
38764649622,38764649621,-1,1398,1333,0
38765166176,38765166175,-1,1439,1885,0
38768823835,38768823834,-1,1577,2235,0
38771713187,38771713188,1,896,1741,0
38776132983,38776132983,0,1860,2506,0
38778143718,38778143724,6,1722,1638,0
38779624845,38779624842,-3,974,2048,0
38781101915,38781101917,2,1103,1549,0
38785980119,38785980121,2,1672,2018,0
38787554485,38787554487,2,1440,1507,0
38787752708,38787752709,1,1569,2667,0
38788564566,38788564566,0,858,1705,0
38789888253,38789888254,1,1638,1985,0
38798100498,38798100491,-7,1074,4405,0
38803619590,38803619593,3,1698,1665,0
38805819185,38805819184,-1,1812,2121,0
38807778906,38807778906,0,923,1243,0
38809651342,38809651341,-1,796,935,0
38810149301,38810149300,-1,1172,1188,0
38816423826,38816423846,20,1343,1437,0
38819164203,38819164202,-1,754,1306,0
38819542463,38819542447,-16,1411,1625,0
38823268409,38823268410,1,1470,1796,0
38825090226,38825090225,-1,1285,1615,0
38826919946,38826919942,-4,619,1628,0
38829512881,38829512879,-2,1556,2754,0
38829983213,38829983214,1,1700,1836,0
38834599663,38834599664,1,2018,1882,0
38836234779,38836234779,0,1230,1456,0
38836986501,38836986502,1,1837,1680,0
38847234026,38847234025,-1,1261,1941,0
38847336737,38847336737,0,1346,1464,0
38850154716,38850154717,1,1333,1796,0
38850727882,38850727882,0,1329,1197,0
38851049603,38851049605,2,1678,2326,0
38853014241,38853014243,2,1827,1284,0
38853795100,38853795099,-1,1653,2286,0
38854543589,38854543590,1,1205,1819,0
38856151398,38856151398,0,1339,1410,0
38857746602,38857746602,0,1692,1932,0
38859756962,38859756963,1,1093,1174,0
38861169206,38861169207,1,1362,1498,0
38865390193,38865390194,1,1370,2054,0
38869149675,38869149674,-1,1642,1985,0
38869198926,38869198926,0,1408,1289,0
38869354235,38869354233,-2,1226,1669,0
38870651543,38870651543,0,1427,1652,0
38877160860,38877160860,0,1156,919,0
38881374450,38881374446,-4,1049,1809,0
38883330388,38883330393,5,1911,1342,0
38883829342,38883829341,-1,1634,1973,0
38884638906,38884638906,0,1525,1408,0
38885643029,38885643029,0,1460,1793,0
38886569917,38886569918,1,1789,1872,0
38890631087,38890631089,2,1480,1436,0
38891319988,38891319987,-1,1161,2055,0
38892093223,38892093226,3,979,791,0
38894947340,38894947326,-14,1714,2101,0
38895259750,38895259754,4,1349,1511,0
38896998054,38896998055,1,1609,1768,0
38899167530,38899167529,-1,1724,1600,0
38900004230,38900004230,0,1393,2040,0
38901023719,38901023728,9,1447,1159,0
38902955566,38902955563,-3,853,1542,0
38903261689,38903261689,0,1193,1858,0
38903654299,38903654307,8,3874,1434,0
38904711426,38904711427,1,1518,1979,0
38906148508,38906148510,2,1339,1554,0
38908916471,38908916470,-1,1287,1975,0
38910568911,38910568911,0,1413,1413,0
38912963038,38912963036,-2,1698,1619,0
38914532209,38914532211,2,1346,1679,0
38915707950,38915707954,4,2466,1386,0
38917723298,38917723304,6,4098,2289,0
38921547733,38921547733,0,1443,1489,0
38922876774,38922876774,0,1140,2024,0
38924325371,38924325372,1,1696,2023,0
38925022520,38925022521,1,949,1379,0
38925585499,38925585498,-1,1402,1553,0
38926084089,38926084094,5,1209,1033,0
38928474601,38928474603,2,1019,1126,0
38928884380,38928884381,1,1120,1534,0
38929480558,38929480561,3,2369,1368,0
38930189794,38930189796,2,1122,1258,0
38933709511,38933709511,0,1383,1813,0
38934095615,38934095617,2,1433,1585,0
38939914693,38939914694,1,1584,1438,0
38942233922,38942233925,3,1806,2000,0
38945716271,38945716269,-2,1491,2493,0
38951396752,38951396741,-11,1171,1395,0
38954119604,38954119606,2,1247,1812,0
38957918151,38957918151,0,1695,1817,0
38957973993,38957973994,1,1501,1319,0
38960642182,38960642183,1,1642,2070,0
38963425027,38963425027,0,1103,2236,0
38967246770,38967246771,1,1363,1114,0
38969379121,38969379123,2,1686,1950,0
38973153454,38973153457,3,1826,1443,0
38974366898,38974366903,5,2388,1096,0
38978755018,38978755017,-1,1212,1604,0
38979139280,38979139282,2,2155,1927,0
38980273642,38980273645,3,4272,2474,0
38980701938,38980701940,2,1209,1432,0
38982001658,38982001659,1,1842,2011,0
38982068138,38982068132,-6,2209,5822,0
38984956646,38984956650,4,1295,1402,0
38985360735,38985360734,-1,1546,1957,0
38985606316,38985606313,-3,1295,1469,0
38986335081,38986335082,1,925,1323,0
38990374522,38990374523,1,1972,2234,0
38992361463,38992361462,-1,966,1348,0
38996089621,38996089626,5,1208,1218,0
38996492954,38996492956,2,1192,2223,0
38998714946,38998714949,3,1237,1723,0
39000177681,39000177682,1,1836,2016,0
39003405956,39003405957,1,1361,1693,0
39003835514,39003835515,1,1443,1916,0
39004078629,39004078611,-18,922,1056,0
39006313678,39006313672,-6,1611,10079,0
39012305206,39012305205,-1,1353,1500,0
39014721257,39014721257,0,1169,1535,0
39015841947,39015841947,0,976,1392,0
39018160454,39018160454,0,1450,2157,0
39018441722,39018441721,-1,1341,1397,0
39019912934,39019912935,1,2252,1632,0
39020271077,39020271074,-3,1012,1914,0
39022112986,39022113007,21,1011,1005,0
39024582331,39024582328,-3,1237,1708,0
39025186186,39025186187,1,1106,1202,0
39027228123,39027228124,1,1413,1848,0
39028995706,39028995706,0,1000,967,0
39029383470,39029383466,-4,816,1214,0
39032551195,39032551195,0,1841,1616,0
39034623057,39034623057,0,1238,1838,0
39034971639,39034971637,-2,1212,1524,0
39039432507,39039432510,3,1602,1545,0
39039529077,39039529078,1,1998,2164,0
39041759251,39041759251,0,1273,1360,0
39044188975,39044188974,-1,700,1144,0
39044552834,39044552835,1,1264,1642,0
39046916194,39046916195,1,1597,1588,0
39049488877,39049488874,-3,1407,1526,0
39050081513,39050081513,0,2094,1814,0
39050289130,39050289130,0,1282,1095,0
39050704763,39050704764,1,878,985,0
39054403846,39054403846,0,1560,1282,0
39056392721,39056392723,2,1239,21248,0
39057535651,39057535652,1,1352,1388,0
39058831505,39058831508,3,2156,1281,0
39059233885,39059233885,0,1519,2335,0
39060877207,39060877209,2,1125,1630,0
39065435935,39065435935,0,1529,2111,0
39065732281,39065732282,1,1131,1600,0
39067320780,39067320783,3,2657,1983,0
39068509630,39068509630,0,1401,1986,0
39073082726,39073082727,1,1094,1324,0
39074106192,39074106194,2,1589,1368,0
39075402401,39075402402,1,1609,1884,0
39078177401,39078177401,0,995,1410,0
39079501357,39079501358,1,874,1031,0
39083890886,39083890886,0,526,965,0
39088146419,39088146417,-2,1738,1994,0
39090264246,39090264242,-4,1053,2410,0
39090317839,39090317831,-8,1465,1893,0
39090856304,39090856304,0,861,1234,0
39093306537,39093306542,5,3006,1450,0
39093779062,39093779060,-2,1014,1641,0
39094555139,39094555139,0,1224,1861,0
39094676633,39094676633,0,1107,1601,0
39095789068,39095789066,-2,1549,2698,0
39098198740,39098198737,-3,1099,1495,0
39100416593,39100416594,1,716,1184,0
39106543756,39106543755,-1,1245,1967,0
39108619777,39108619775,-2,1243,1246,0
39109728107,39109728110,3,995,1653,0
39109810318,39109810319,1,1138,1493,0
39117486602,39117486604,2,1104,1885,0
39122328395,39122328397,2,1195,1297,0
39123768521,39123768522,1,2118,1813,0
39124074526,39124074513,-13,984,1061,0
39124541895,39124541895,0,1295,1760,0
39124913805,39124913805,0,1339,1849,0
39125711097,39125711100,3,2480,1868,0
39125936571,39125936571,0,1915,2183,0
39127258069,39127258056,-13,1078,434,0
39127671913,39127671912,-1,1310,1866,0
39130091234,39130091235,1,1380,1745,0
39130985267,39130985267,0,1194,1342,0
39131270880,39131270881,1,1324,1949,0
39133469679,39133469680,1,1114,1946,0
39133997006,39133997006,0,1089,1621,0
39134937926,39134937905,-21,1178,1206,0
39135338905,39135338905,0,1322,1982,0
39138630256,39138630257,1,1648,2505,0
39139777393,39139777393,0,1581,1304,0
39140774739,39140774742,3,1836,1437,0
39140870034,39140870046,12,1182,1339,0
39141716438,39141716437,-1,1166,1730,0
39142917673,39142917673,0,1286,1884,0
39143301574,39143301567,-7,963,5284,0
39143703404,39143703405,1,1743,2027,0
39147450536,39147450530,-6,918,3680,0
39149714210,39149714208,-2,789,1243,0
39154359926,39154359927,1,1070,1534,0
39156234347,39156234349,2,1184,1370,0
39161806038,39161806038,0,1540,2404,0
39164413313,39164413313,0,1207,1829,0
39166634602,39166634602,0,1285,1240,0
39169000834,39169000834,0,1150,1450,0
39169196900,39169196902,2,2033,2603,0
39169800821,39169800820,-1,1122,1269,0
39172373491,39172373491,0,25970,19910,0
39173059776,39173059783,7,4876,1193,0
39173570730,39173570730,0,1364,1877,0
39173949143,39173949145,2,1407,2030,0
39174763281,39174763283,2,1240,1795,0
39177800355,39177800354,-1,1308,1476,0
39178961518,39178961516,-2,1578,2081,0
39179324943,39179324939,-4,988,2488,0
39180485799,39180485787,-12,949,1214,0
39184818806,39184818808,2,994,1756,0
39186538351,39186538354,3,1055,1062,0
39189013273,39189013274,1,1488,1872,0
39189560854,39189560854,0,1076,1722,0
39190588196,39190588195,-1,1388,1403,0
39192353975,39192353975,0,1692,2383,0
39198338031,39198338031,0,809,1471,0
39199242710,39199242703,-7,1196,1451,0
39201077114,39201077114,0,1202,1256,0
39208032998,39208032998,0,697,1361,0
39211068950,39211068950,0,2078,2066,0
39212464951,39212464945,-6,860,3016,0
39213440764,39213440759,-5,924,1109,0
39214209090,39214209089,-1,1110,1689,0
39215562760,39215562762,2,1385,1393,0
39217273904,39217273903,-1,1360,1563,0
39219293610,39219293610,0,1211,1901,0
39219790986,39219790988,2,2882,3486,0
39220700118,39220700118,0,940,1137,0
39223458238,39223458237,-1,1553,2481,0
39226918691,39226918691,0,1689,1547,0
39227767925,39227767926,1,898,1050,0
39230608747,39230608742,-5,716,1341,0
39231403290,39231403290,0,1767,1552,0
39235727173,39235727173,0,1617,1290,0
39236512182,39236512181,-1,1542,2526,0
39243250343,39243250342,-1,1071,1767,0
39243282249,39243282250,1,1418,1604,0
39243426916,39243426917,1,1782,2863,0
39246284462,39246284463,1,1412,1489,0
39247207287,39247207282,-5,2215,4762,0
39247497694,39247497694,0,1539,1732,0
39251396510,39251396510,0,1170,1431,0
39252209097,39252209097,0,1553,1687,0
39255757543,39255757541,-2,1176,1913,0
39256584959,39256584957,-2,1190,1784,0
39257603545,39257603549,4,914,1457,0
39258039366,39258039367,1,1720,1933,0
39258417494,39258417495,1,1283,1858,0
39258612829,39258612851,22,934,1693,0
39259504490,39259504491,1,1072,1437,0
39267201145,39267201138,-7,26,6197,0
39269456598,39269456599,1,2075,1943,0
39273196541,39273196523,-18,1431,2118,0
39273705439,39273705444,5,3239,1953,0
39275128565,39275128564,-1,1625,1956,0
39275384337,39275384340,3,2581,2125,0
39275440205,39275440206,1,1542,1502,0
39276974757,39276974761,4,1425,1325,0
39280605168,39280605169,1,2141,2369,0
39282392193,39282392194,1,1840,2039,0
39283351948,39283351949,1,1049,1468,0
39294663348,39294663350,2,1281,1215,0
39295328355,39295328356,1,1286,1409,0
39296218415,39296218415,0,884,1279,0
39302999322,39302999317,-5,661,1839,0
39303883418,39303883418,0,1360,1763,0
39307742581,39307742579,-2,1708,2660,0
39309023650,39309023646,-4,1480,1541,0
39310371594,39310371600,6,11226,36379,0
39311766988,39311766990,2,1437,1808,0
39316534382,39316534381,-1,2072,2231,0
39316871970,39316871970,0,1607,1920,0
39317074295,39317074294,-1,1721,1560,0
39323592746,39323592746,0,1895,2016,0
39323660417,39323660414,-3,1029,4056,0
39323739013,39323739034,21,1097,1781,0
39324543622,39324543623,1,1596,2106,0
39325878549,39325878550,1,2102,2017,0
39326578659,39326578659,0,1173,1428,0
39327878306,39327878305,-1,1409,2020,0
39328741486,39328741487,1,1637,1937,0
39329301625,39329301625,0,1290,1246,0
39330370774,39330370776,2,1109,1823,0
39331060601,39331060602,1,1267,1841,0
39336087561,39336087561,0,1682,1951,0
39338862714,39338862712,-2,1301,1442,0
39340632791,39340632789,-2,1295,1407,0
39341907489,39341907489,0,1699,1666,0
39342316063,39342316069,6,2458,1425,0
39344065492,39344065490,-2,754,1616,0
39345368533,39345368530,-3,1680,3265,0
39347320031,39347320032,1,1335,1580,0
39351092381,39351092379,-2,1561,2073,0
39352304986,39352304990,4,4135,2532,0
39352353232,39352353232,0,1821,1954,0
39354432180,39354432182,2,714,1191,0
39354783107,39354783107,0,1808,1387,0
39355224613,39355224614,1,1493,1943,0
39355533921,39355533922,1,1443,1818,0
39355630750,39355630753,3,1257,1588,0
39355737343,39355737342,-1,870,1583,0
39361308147,39361308149,2,1510,2116,0
39366339735,39366339734,-1,1311,1793,0
39366796016,39366796015,-1,1697,2044,0
39367109337,39367109343,6,2307,973,0
39368205433,39368205437,4,1730,2054,0
39373571905,39373571907,2,1449,1715,0
39376544239,39376544239,0,972,1234,0
39381064918,39381064918,0,1254,1030,0
39383148382,39383148382,0,1251,2269,0
39383224348,39383224349,1,1248,2124,0
39383983156,39383983163,7,19682,19300,0
39384526678,39384526678,0,1436,2139,0
39384615627,39384615645,18,371,271,0
39385547182,39385547181,-1,1289,1491,0
39388234212,39388234210,-2,1563,1388,0
39389626246,39389626253,7,11626,7035,0
39393797463,39393797463,0,1747,2440,0
39397951221,39397951222,1,1270,1594,0
39401083119,39401083118,-1,1785,2103,0
39401969594,39401969594,0,1566,2089,0
39402139707,39402139705,-2,1037,1616,0
39402457850,39402457849,-1,1805,1848,0
39403577315,39403577314,-1,1486,1422,0
39405251188,39405251187,-1,1333,1743,0
39405889586,39405889587,1,1500,1756,0
39406666981,39406666981,0,1335,1895,0
39410443897,39410443897,0,1039,2044,0
39412152986,39412152989,3,1065,1791,0
39413480636,39413480641,5,2734,1964,0
39414023098,39414023098,0,1822,2074,0
39416497663,39416497663,0,1732,2152,0
39419630646,39419630646,0,987,1539,0
39419933853,39419933852,-1,1167,1591,0
39428665738,39428665738,0,1212,1490,0
39431701057,39431701058,1,809,1081,0
39435179592,39435179590,-2,1594,1489,0
39436074207,39436074205,-2,1357,3051,0
39436564166,39436564166,0,1359,1615,0
39437638322,39437638324,2,2072,1557,0
39439856214,39439856216,2,2093,2287,0
39441219835,39441219846,11,11783,28691,0
39441954647,39441954648,1,1238,1797,0
39443765437,39443765438,1,1300,898,0
39444699133,39444699133,0,1280,1620,0
39444809401,39444809401,0,1236,2065,0
39446992562,39446992561,-1,1129,1879,0
39447274967,39447274949,-18,708,1156,0
39451737346,39451737352,6,5404,3122,0
39454684270,39454684263,-7,1104,5037,0
39454978591,39454978593,2,1300,1718,0
39458503743,39458503742,-1,708,1366,0
39459403995,39459403995,0,1216,1306,0
39461708302,39461708303,1,1563,1535,0
39465530350,39465530351,1,2084,2052,0
39465678882,39465678883,1,1788,1182,0
39466027084,39466027101,17,935,3060,0
39466148292,39466148293,1,1014,1722,0
39468408620,39468408642,22,780,1464,0
39475688127,39475688126,-1,1354,1386,0
39476627627,39476627627,0,1636,1675,0
39476859778,39476859777,-1,1684,2517,0
39478039318,39478039322,4,2194,1169,0
39478094305,39478094306,1,1474,1774,0
39478122381,39478122374,-7,1248,2336,0
39481538798,39481538800,2,1861,1340,0
39482667147,39482667126,-21,1408,2111,0
39484505702,39484505701,-1,1395,1284,0
39486496090,39486496090,0,1240,2033,0
39488400568,39488400569,1,1117,1438,0
39488742245,39488742245,0,938,1967,0
39490602017,39490602010,-7,2583,6600,0
39492674894,39492674895,1,1672,2067,0
39493829549,39493829550,1,1661,1284,0
39506401768,39506401767,-1,1338,1198,0
39510960332,39510960332,0,1348,1793,0
39512984826,39512984826,0,971,1341,0
39514747450,39514747455,5,1372,1155,0
39517402208,39517402209,1,1472,1198,0
39518563121,39518563121,0,1739,1815,0
39522913669,39522913667,-2,1615,1567,0
39525512241,39525512250,9,2187,1212,0
39526418963,39526418963,0,1831,1683,0
39528240963,39528240964,1,1109,1141,0
39528739728,39528739721,-7,1750,9038,0
39529242091,39529242091,0,1092,1502,0
39529548546,39529548547,1,1193,2076,0
39530974462,39530974462,0,1560,1945,0
39532995920,39532995917,-3,1001,3796,0
39534960767,39534960768,1,1135,1096,0
39536860530,39536860530,0,1658,1624,0
39541835158,39541835160,2,1149,1620,0
39550995527,39550995529,2,1886,2435,0
39556720530,39556720530,0,1644,1488,0
39557016374,39557016374,0,1527,1697,0
39557675197,39557675183,-14,901,1921,0
39560287766,39560287773,7,2146,988,0
39561756313,39561756314,1,1625,1601,0
39561975551,39561975546,-5,625,1799,0
39562617525,39562617524,-1,1324,1551,0
39563370190,39563370192,2,852,846,0
39567185670,39567185670,0,1528,1918,0
39567409278,39567409280,2,1712,1568,0
39569427215,39569427217,2,1374,1981,0
39570380917,39570380917,0,1729,1520,0
39570822174,39570822174,0,1124,1603,0
39571374048,39571374048,0,1335,2226,0
39573563099,39573563100,1,1506,2016,0
39574274207,39574274207,0,1386,1753,0
39575757813,39575757814,1,1173,1358,0
39579126466,39579126464,-2,1741,1887,0
39581113142,39581113143,1,1632,2087,0
39585779612,39585779611,-1,1795,1628,0
39590136779,39590136783,4,399,1143,0
39593019651,39593019651,0,1445,1349,0
39593044942,39593044944,2,982,1730,0
39594313735,39594313737,2,1468,1458,0
39595735745,39595735743,-2,1001,1524,0
39598235348,39598235339,-9,1074,2633,0
39600150830,39600150832,2,955,1480,0
39600597810,39600597811,1,1358,1285,0
39602925321,39602925322,1,597,1424,0
39603069917,39603069918,1,1269,1644,0
39608017387,39608017387,0,1315,1709,0
39609789798,39609789800,2,6612,5916,0
39610184827,39610184829,2,1342,1246,0
39613165938,39613165941,3,1013,1209,0
39613890009,39613890011,2,2633,1080,0
39614637743,39614637745,2,1458,1822,0
39615391482,39615391482,0,1584,1672,0
39616361894,39616361889,-5,1879,6132,0
39617085982,39617085983,1,1001,1390,0
39619475828,39619475828,0,1548,1846,0
39619883210,39619883205,-5,549,3092,0
39620284753,39620284750,-3,1060,3164,0
39623190827,39623190827,0,859,1127,0
39625693955,39625693957,2,1914,1893,0
39626931433,39626931434,1,1577,1772,0
39626990893,39626990894,1,2738,3068,0
39627835930,39627835929,-1,1477,1776,0
39630034911,39630034914,3,2052,1631,0
39631111414,39631111414,0,2577,4318,0
39633240965,39633240966,1,1691,1300,0
39637445162,39637445162,0,1277,1211,0
39638959246,39638959240,-6,1846,7856,0
39643862697,39643862697,0,1058,1309,0
39644006434,39644006434,0,1361,1800,0
39646517900,39646517898,-2,1630,2029,0
39650995956,39650995957,1,1056,1431,0
39652465145,39652465143,-2,912,1121,0
39656317911,39656317911,0,2091,1955,0
39657575961,39657575961,0,1370,1702,0
39657926954,39657926956,2,1553,2013,0
39658467307,39658467305,-2,1467,1715,0
39658543561,39658543562,1,1681,1389,0
39659217786,39659217788,2,1397,2272,0
39660088093,39660088088,-5,1047,2694,0
39661100243,39661100241,-2,1160,1253,0
39667414774,39667414778,4,1690,1290,0
39671679658,39671679658,0,1614,1910,0
39673057374,39673057375,1,2743,1943,0
39673312683,39673312663,-20,2751,1162,0
39678554721,39678554719,-2,1449,2022,0
39679878075,39679878074,-1,1116,1505,0
39680166233,39680166238,5,845,1319,0
39680618975,39680618970,-5,1737,1965,0
39681223913,39681223911,-2,1218,1556,0
39683410624,39683410624,0,1595,1573,0
39688057526,39688057528,2,1448,2160,0
39689343642,39689343641,-1,1159,1761,0
39689597167,39689597166,-1,1381,1552,0
39692677317,39692677318,1,1179,1899,0
39695075999,39695075999,0,1386,2346,0
39699778126,39699778125,-1,1416,1468,0
39700784471,39700784473,2,1498,1460,0
39702058925,39702058925,0,35690,43435,0
39709908036,39709908034,-2,1509,1986,0
39710024722,39710024723,1,1212,1317,0
39710843796,39710843794,-2,1077,1349,0
39716581451,39716581444,-7,1303,1270,0
39720103878,39720103878,0,1324,1577,0
39721613670,39721613673,3,951,1236,0
39721838155,39721838155,0,1326,1331,0
39722604896,39722604898,2,1449,1197,0
39725576670,39725576669,-1,1292,2351,0
39731426657,39731426658,1,1194,2040,0
39732690150,39732690151,1,1994,1250,0
39733454258,39733454258,0,1502,1422,0
39736798148,39736798150,2,1382,1432,0
39739144938,39739144941,3,1119,1351,0
39743393297,39743393300,3,1524,1808,0
39744726798,39744726799,1,944,1451,0
39746864049,39746864047,-2,1318,1916,0
39746984134,39746984133,-1,1335,2113,0
39747305631,39747305631,0,1450,1689,0
39753261422,39753261419,-3,1171,4543,0
39756225194,39756225193,-1,969,1483,0
39759577738,39759577740,2,1587,1548,0
39761985487,39761985488,1,2098,1757,0
39764142383,39764142380,-3,1206,1170,0
39765113423,39765113423,0,1368,1929,0
39768938270,39768938270,0,1362,1779,0
39769632354,39769632355,1,1754,2548,0
39769905876,39769905872,-4,1834,5500,0
39770925130,39770925129,-1,1193,2255,0
39772494742,39772494742,0,895,1553,0
39773786033,39773786033,0,1123,1789,0
39774427639,39774427642,3,1592,1895,0
39775160662,39775160662,0,1563,2117,0
39778664606,39778664609,3,2419,1410,0
39779518714,39779518715,1,1302,1626,0
39782784511,39782784511,0,1673,1739,0
39784216604,39784216605,1,1606,2165,0
39785758132,39785758134,2,1943,1859,0
39786785579,39786785579,0,1493,1864,0
39788288003,39788288003,0,910,1841,0
39790100691,39790100682,-9,986,1133,0
39792242486,39792242486,0,1293,1831,0
39795287173,39795287174,1,1367,1529,0
39796062590,39796062590,0,1952,1884,0
39798620426,39798620427,1,1382,1559,0
39799640538,39799640537,-1,1539,1845,0
39800472674,39800472674,0,1093,1559,0
39801791847,39801791849,2,1123,1158,0
39805666910,39805666907,-3,1342,2133,0
39808677476,39808677475,-1,1630,1774,0
39808739230,39808739214,-16,1212,1540,0
39810597931,39810597933,2,1412,1642,0
39811011402,39811011403,1,1830,1658,0
39812725039,39812725039,0,978,1318,0
39812891267,39812891261,-6,28893,11458,0
39814728259,39814728260,1,3452,3324,0
39816532998,39816532998,0,1803,2639,0
39817831413,39817831411,-2,1415,2143,0
39818070290,39818070291,1,1265,1999,0
39818165433,39818165434,1,1620,2200,0
39820278029,39820278027,-2,615,1439,0
39829743442,39829743443,1,908,1228,0
39833021595,39833021595,0,1527,1573,0
39833423273,39833423273,0,1579,2718,0
39834298381,39834298383,2,1616,1118,0
39834846694,39834846694,0,974,937,0
39835453842,39835453824,-18,1107,1253,0
39839917491,39839917490,-1,1599,2107,0
39844269649,39844269649,0,1346,1722,0
39844326462,39844326461,-1,1257,1533,0
39846302186,39846302186,0,1369,1203,0
39847200514,39847200513,-1,1106,2022,0
39847257656,39847257674,18,861,1363,0
39850204085,39850204087,2,1463,2067,0
39850403610,39850403610,0,1538,2385,0
39857706937,39857706935,-2,1393,2702,0
39857952036,39857952038,2,1249,980,0
39859280788,39859280787,-1,1185,1556,0
39862768042,39862768063,21,1359,1811,0
39864215815,39864215817,2,1595,1776,0
39866924749,39866924747,-2,1140,1744,0
39869459916,39869459916,0,1605,1947,0
39870848488,39870848490,2,1361,1573,0
39871333486,39871333488,2,1908,1693,0
39872068576,39872068574,-2,988,1256,0
39875706620,39875706620,0,1259,1623,0
39876848248,39876848249,1,1415,1467,0
39878942972,39878942972,0,1735,1693,0
39879686310,39879686311,1,1404,1402,0
39880364017,39880364017,0,1696,2838,0
39882840177,39882840177,0,1818,2038,0
39884837211,39884837214,3,2087,2304,0
39886564435,39886564434,-1,1121,971,0
39892027853,39892027853,0,611,1112,0
39892678130,39892678131,1,1521,1692,0
39894693173,39894693174,1,1451,1907,0
39895829398,39895829399,1,1003,1086,0
39900508310,39900508310,0,1171,1865,0
39901657359,39901657358,-1,1113,1833,0
39901722238,39901722240,2,1763,2042,0
39902693878,39902693879,1,1213,1366,0
39903308905,39903308909,4,2639,2193,0
39904356130,39904356130,0,1497,1936,0
39909107271,39909107270,-1,1322,1615,0
39909341422,39909341421,-1,1145,1945,0
39910265234,39910265234,0,1479,2334,0
39911285992,39911285986,-6,1250,1938,0
39915389746,39915389748,2,1505,1510,0
39915648703,39915648701,-2,1128,1319,0
39918133259,39918133262,3,850,1029,0
39919026038,39919026033,-5,1229,2309,0
39919861278,39919861284,6,2071,1093,0
39920222198,39920222198,0,1542,1467,0
39920696666,39920696666,0,1461,1349,0
39921151778,39921151779,1,1325,1476,0
39923013820,39923013818,-2,1378,1990,0
39923997108,39923997105,-3,1169,2614,0
39925926554,39925926553,-1,1439,2099,0
39927812616,39927812616,0,1732,2264,0
39928292090,39928292089,-1,1317,2195,0
39929643107,39929643114,7,1715,726,0
39929834498,39929834510,12,1554,1282,0
39932540988,39932540989,1,1798,1598,0
39934812916,39934812914,-2,997,1549,0
39935012074,39935012077,3,1641,1783,0
39935156203,39935156201,-2,831,1823,0
39936857671,39936857659,-12,1448,2154,0
39938321940,39938321938,-2,1671,1947,0
39939748733,39939748733,0,1321,1638,0
39940520610,39940520614,4,1343,1379,0
39948415185,39948415185,0,1444,1536,0
39953418433,39953418438,5,1863,1239,0
39957228734,39957228733,-1,1066,1305,0
39958710431,39958710429,-2,1254,1558,0
39963540714,39963540719,5,4122,3015,0
39964983265,39964983264,-1,2270,1992,0
39969228174,39969228167,-7,944,4676,0
39972967696,39972967694,-2,1285,1650,0
39974521957,39974521957,0,1100,1695,0
39975154789,39975154779,-10,897,1120,0
39978331083,39978331062,-21,1513,1611,0
39979188847,39979188847,0,981,1181,0
39981783430,39981783427,-3,792,3953,0
39982399870,39982399870,0,1409,2694,0
39984579961,39984579962,1,1639,1669,0
39988583602,39988583601,-1,1015,1162,0
39992081798,39992081798,0,1500,2180,0
39994958788,39994958787,-1,1251,1395,0
39995566936,39995566936,0,1503,1578,0
39995689571,39995689571,0,1642,1486,0
39995724210,39995724209,-1,1729,1922,0
39997698946,39997698946,0,1045,1347,0
39998428413,39998428415,2,837,1559,0
40000100610,40000100610,0,1147,1249,0
40001366363,40001366364,1,1694,1783,0
40001966449,40001966454,5,2273,794,0
40011349872,40011349875,3,1272,772,0
40013931814,40013931815,1,910,1787,0
40014128743,40014128742,-1,1303,1996,0
40014427656,40014427657,1,1326,1542,0
40014856579,40014856581,2,1538,2113,0
40019873507,40019873508,1,1555,1291,0
40020559748,40020559749,1,1675,2023,0
40021558094,40021558093,-1,1144,1573,0
40022272730,40022272730,0,1968,2193,0
40023859559,40023859562,3,1445,1564,0
40028870647,40028870646,-1,890,1817,0
40029630659,40029630659,0,1628,2583,0
40033924562,40033924563,1,1115,1692,0
40037492982,40037492987,5,2683,1948,0
40039159741,40039159740,-1,1443,1560,0
40039713058,40039713058,0,1246,1254,0
40044378433,40044378433,0,1320,1461,0
40048051438,40048051439,1,1240,1281,0
40048242505,40048242510,5,4478,2088,0
40054453255,40054453256,1,2301,2345,0
40056886916,40056886915,-1,1215,1446,0
40057301685,40057301685,0,1119,1949,0
40057462069,40057462068,-1,1773,2145,0
40064845735,40064845736,1,1163,1158,0
40066138500,40066138501,1,1730,1614,0
40069503150,40069503149,-1,1072,1545,0
40074919590,40074919593,3,1474,1847,0
40075451084,40075451083,-1,1546,1510,0
40076329757,40076329754,-3,847,1252,0
40076462299,40076462298,-1,1116,2064,0
40077628779,40077628781,2,1075,1597,0
40078847891,40078847891,0,1330,1530,0
40083437239,40083437241,2,1352,1055,0
40086162330,40086162329,-1,1192,1916,0
40089215830,40089215828,-2,104,3615,0
40090404910,40090404893,-17,1238,1647,0
40091900753,40091900753,0,941,814,0
40092794111,40092794110,-1,951,1460,0
40095925961,40095925957,-4,4060,11620,0
40096488093,40096488094,1,4049,22428,0
40096593245,40096593243,-2,1628,2077,0
40097222186,40097222187,1,1184,951,0
40098249503,40098249505,2,1662,1886,0
40098484600,40098484601,1,1350,1648,0
40100250811,40100250811,0,1575,2309,0
40111911501,40111911502,1,1264,1495,0
40112328597,40112328598,1,1321,1445,0
40113725368,40113725369,1,1955,1670,0
40114177790,40114177778,-12,1199,1559,0
40117821961,40117821961,0,965,1343,0
40118670009,40118670010,1,1793,2182,0
40120802926,40120802927,1,1496,1649,0
40122603753,40122603756,3,1431,1628,0
40126502415,40126502413,-2,1578,1887,0
40127710702,40127710701,-1,1033,1590,0
40127787240,40127787241,1,1725,1687,0
40128225451,40128225452,1,1221,1680,0
40137755698,40137755701,3,1258,1519,0
40140217719,40140217714,-5,696,3607,0
40142374939,40142374941,2,915,1378,0
40145901150,40145901144,-6,776,2289,0
40147056119,40147056121,2,968,1202,0
40147715695,40147715698,3,1068,1228,0
40148524131,40148524133,2,1203,1481,0
40149729818,40149729817,-1,1236,1648,0
40151202541,40151202538,-3,787,1726,0
40155290387,40155290387,0,1251,2047,0
40155471917,40155471918,1,1315,1375,0
40156138890,40156138890,0,1133,1415,0
40156529602,40156529581,-21,1152,1341,0
40160651012,40160651011,-1,1350,1498,0
40166402434,40166402435,1,1691,2110,0
40166829251,40166829251,0,811,1194,0
40172445910,40172445910,0,1316,1561,0
40172992340,40172992339,-1,1208,1163,0
40178849751,40178849752,1,1146,1696,0
40178907890,40178907902,12,1262,1514,0
40180127104,40180127104,0,1468,2302,0
40180264033,40180264034,1,1216,1626,0
40180509206,40180509207,1,1429,1209,0
40183729029,40183729029,0,1517,2119,0
40184087132,40184087123,-9,1520,2261,0
40184515721,40184515721,0,1662,2269,0
40185818041,40185818042,1,1774,1954,0
40187367210,40187367211,1,1163,1087,0
40189754018,40189754022,4,1474,1345,0
40189939390,40189939390,0,1440,2592,0
40192445098,40192445099,1,719,778,0
40192596107,40192596110,3,1656,1366,0
40194422958,40194422938,-20,1405,1139,0
40195935418,40195935425,7,1706,841,0
40197892283,40197892284,1,2111,2176,0
40198288138,40198288138,0,1153,1426,0
40199647560,40199647561,1,995,2072,0
40202411914,40202411913,-1,1057,1786,0
40204417858,40204417859,1,1141,1320,0
40209878426,40209878425,-1,975,1509,0
40211607079,40211607081,2,810,1542,0
40212622207,40212622206,-1,1470,1319,0
40217789149,40217789149,0,1086,2200,0
40218710070,40218710071,1,1384,1780,0
40218939128,40218939151,23,1067,1313,0
40220775589,40220775587,-2,1523,1895,0
40221430219,40221430216,-3,711,3846,0
40221547618,40221547618,0,1221,1735,0
40222322947,40222322946,-1,1399,1580,0
40224416580,40224416581,1,1965,1639,0
40226867011,40226867013,2,1109,1087,0
40228699165,40228699165,0,1088,1617,0
40229417867,40229417868,1,1344,1600,0
40232429841,40232429847,6,2951,1068,0
40233140827,40233140825,-2,1096,1444,0
40238717847,40238717849,2,1530,1935,0
40238998893,40238998894,1,1361,1563,0
40243130466,40243130464,-2,1697,2004,0
40244100630,40244100631,1,1179,1483,0
40244158236,40244158236,0,2014,1913,0
40245460892,40245460892,0,1853,2175,0
40251362143,40251362141,-2,907,1093,0
40253660528,40253660526,-2,1096,1489,0
40253757037,40253757037,0,1608,1842,0
40256024934,40256024934,0,1651,1753,0
40257781874,40257781876,2,1421,1600,0
40259589841,40259589842,1,1605,2169,0
40264713490,40264713491,1,1504,2042,0
40270285943,40270285943,0,1893,1781,0
40271694150,40271694156,6,3912,1953,0
40273470562,40273470563,1,2261,1688,0
40277000501,40277000510,9,1108,746,0
40277680990,40277680991,1,1271,1747,0
40279878098,40279878098,0,837,1654,0
40279935485,40279935485,0,937,1591,0
40281894311,40281894313,2,1443,1731,0
40283760085,40283760086,1,1204,1865,0
40286217381,40286217381,0,1389,1815,0
40288486758,40288486758,0,1517,1350,0
40289594966,40289594968,2,1351,1359,0
40291334214,40291334214,0,955,1881,0
40292527052,40292527053,1,1044,1622,0
40295897922,40295897923,1,1633,1478,0
40296348980,40296348979,-1,1519,1350,0
40299901750,40299901749,-1,921,796,0
40300272288,40300272289,1,1160,1381,0
40302690883,40302690887,4,2070,2408,0
40304521014,40304521014,0,1763,2563,0
40312262221,40312262221,0,1504,1935,0
40314556989,40314556990,1,1852,2083,0
40314988113,40314988112,-1,1411,1504,0
40321360389,40321360389,0,1402,1670,0
40322232014,40322232014,0,1892,2360,0
40324053853,40324053851,-2,1404,2435,0
40324923223,40324923223,0,598,750,0
40326276538,40326276540,2,1874,1842,0
40327038359,40327038359,0,991,1541,0
40335144270,40335144274,4,1272,1572,0
40335619095,40335619097,2,1455,1843,0
40336856206,40336856207,1,807,742,0
40339985671,40339985670,-1,1832,2087,0
40342749041,40342749045,4,2118,1459,0
40344800130,40344800130,0,1164,2162,0
40344864529,40344864529,0,1678,1686,0
40344900463,40344900463,0,1020,1768,0
40346048225,40346048227,2,1297,1647,0
40347453804,40347453804,0,1197,1629,0
40350162601,40350162601,0,1129,1998,0
40352442038,40352442038,0,1236,1494,0
40353083434,40353083434,0,1389,1657,0
40354412345,40354412345,0,1391,1457,0
40354762127,40354762126,-1,1182,1414,0
40355781017,40355781018,1,1572,1942,0
40358429037,40358429043,6,2167,1228,0
40360247589,40360247589,0,1857,2258,0
40364258314,40364258317,3,1266,1308,0
40366448565,40366448567,2,1456,1950,0
40367865958,40367865958,0,2034,2406,0
40371190043,40371190043,0,1096,2114,0
40374002405,40374002406,1,1071,1071,0
40374747107,40374747105,-2,1719,2010,0
40375250911,40375250911,0,1498,1938,0
40383001061,40383001077,16,643,2067,0
40383239243,40383239243,0,1273,1932,0
40383855797,40383855797,0,1558,1970,0
40387559130,40387559130,0,1176,1673,0
40387683325,40387683318,-7,1130,939,0
40391850487,40391850466,-21,1486,2721,0
40392496642,40392496644,2,1499,1493,0
40393366646,40393366646,0,1273,1734,0
40393815902,40393815881,-21,984,1543,0
40396440946,40396440947,1,990,1327,0
40400809914,40400809915,1,965,1600,0
40401847645,40401847646,1,1429,1926,0
40405115897,40405115898,1,927,1403,0
40406360619,40406360622,3,1418,2339,0
40414071801,40414071804,3,1678,1673,0
40414158548,40414158541,-7,1878,6254,0
40415504355,40415504356,1,1008,1047,0
40417351693,40417351693,0,1528,1560,0
40422017082,40422017082,0,1370,1613,0
40423142046,40423142046,0,1588,1822,0
40423390421,40423390417,-4,17678,11285,0
40425119195,40425119197,2,731,1325,0
40432019350,40432019351,1,1620,2430,0
40432540903,40432540902,-1,1693,1543,0
40434996917,40434996917,0,1601,2240,0
40441027185,40441027186,1,1944,2527,0
40442039343,40442039342,-1,572,1194,0
40444501846,40444501849,3,1358,1741,0
40445012774,40445012773,-1,1909,1855,0
40445271901,40445271910,9,37,5118,0
40448221562,40448221564,2,7392,31439,0
40448269137,40448269136,-1,1479,2219,0
40453109450,40453109450,0,1825,2340,0
40454428154,40454428156,2,1203,1547,0
40455681290,40455681291,1,980,1278,0
40462499539,40462499539,0,1038,1407,0
40465623294,40465623294,0,792,1336,0
40467403122,40467403119,-3,942,1934,0
40467970378,40467970377,-1,921,1682,0
40468030210,40468030213,3,1411,1844,0
40479463839,40479463839,0,1144,1327,0
40480126218,40480126221,3,1918,2000,0
40481641209,40481641210,1,1403,1530,0
40483621629,40483621630,1,1258,1680,0
40488957152,40488957150,-2,1248,1873,0
40492985609,40492985610,1,1062,1381,0
40498435265,40498435266,1,941,1083,0
40502722327,40502722327,0,1923,1578,0
40503108265,40503108266,1,1281,1827,0
40504215581,40504215582,1,1005,1566,0
40505198624,40505198626,2,1313,1710,0
40507786866,40507786867,1,1737,1235,0
40508644566,40508644573,7,59242,21635,0
40510397316,40510397317,1,1367,1636,0
40514722391,40514722390,-1,943,1753,0
40515673911,40515673912,1,968,1347,0
40517479162,40517479163,1,913,1364,0
40519684530,40519684532,2,1258,1370,0
40520210663,40520210663,0,1273,1769,0
40522889535,40522889533,-2,1400,1728,0
40524020678,40524020683,5,1171,1254,0
40526520890,40526520890,0,1245,1441,0
40528996819,40528996820,1,1036,1424,0
40530149981,40530149982,1,1273,1605,0
40530610326,40530610325,-1,1217,1399,0
40532702636,40532702635,-1,1400,2033,0
40533340917,40533340920,3,2661,2411,0
40534047237,40534047237,0,1431,2006,0
40537302034,40537302037,3,2076,1261,0
40539757742,40539757742,0,1981,2078,0
40540472026,40540472027,1,1115,1168,0
40543368937,40543368944,7,2584,1215,0
40544765433,40544765433,0,1728,1878,0
40546655933,40546655918,-15,1282,2026,0
40549072798,40549072799,1,1354,1492,0
40549164400,40549164398,-2,1379,1485,0
40551441026,40551441025,-1,1523,1192,0
40552054353,40552054355,2,1370,1392,0
40553918331,40553918333,2,1431,1830,0
40554822394,40554822394,0,1118,1157,0
40558534076,40558534077,1,1339,1884,0
40560360894,40560360898,4,1387,1064,0
40560898981,40560898965,-16,72,474,0
40564287382,40564287381,-1,1075,1559,0
40566839582,40566839562,-20,1545,1344,0
40568943571,40568943570,-1,1371,2200,0
40569877850,40569877852,2,1892,2019,0
40570406854,40570406856,2,1886,2032,0
40572413057,40572413064,7,2707,1380,0
40573961150,40573961149,-1,1718,2818,0
40575105886,40575105886,0,1214,1467,0
40580889627,40580889622,-5,1166,6363,0
40583931506,40583931506,0,1526,2183,0
40598943599,40598943601,2,1637,1900,0
40603158150,40603158153,3,3333,3240,0
40606944554,40606944554,0,1878,2083,0
40607896527,40607896526,-1,1399,1724,0
40617771178,40617771179,1,1094,1721,0
40620788681,40620788682,1,1842,1392,0
40624321558,40624321558,0,1384,1505,0
40626624934,40626624937,3,1557,2031,0
40626909688,40626909684,-4,2128,5491,0
40628756528,40628756529,1,1295,1505,0
40630138581,40630138582,1,1011,1094,0
40631067924,40631067925,1,1136,2037,0
40632639187,40632639187,0,1702,2434,0
40632829880,40632829879,-1,1550,1837,0
40634129075,40634129077,2,2279,1219,0
40634970022,40634970022,0,1266,1947,0
40635774968,40635774967,-1,1065,1142,0
40636472347,40636472350,3,2282,1144,0
40636524502,40636524502,0,1148,1403,0
40642856876,40642856875,-1,1265,1416,0
40645940256,40645940255,-1,1630,1533,0
40647185342,40647185342,0,1107,1932,0
40647615234,40647615236,2,1418,1430,0
40650118473,40650118467,-6,949,2889,0
40650381729,40650381730,1,1710,1331,0
40656939850,40656939850,0,1377,1430,0
40657554638,40657554634,-4,1127,1438,0
40658417790,40658417768,-22,1318,2120,0
40659153869,40659153872,3,2304,1528,0
40660098183,40660098185,2,1610,1705,0
40663347941,40663347942,1,1573,1768,0
40667682102,40667682102,0,2039,3378,0
40677003182,40677003183,1,997,1342,0
40677538945,40677538947,2,2813,1961,0
40680162674,40680162674,0,1344,1868,0
40681318472,40681318473,1,1562,1722,0
40684357631,40684357633,2,1570,1685,0
40684714196,40684714197,1,1432,1451,0
40686511758,40686511757,-1,1664,2416,0
40692228655,40692228657,2,1641,1760,0
40692872894,40692872895,1,1534,1539,0
40693058492,40693058492,0,1271,1605,0
40694688250,40694688253,3,1208,1605,0
40695245900,40695245903,3,1581,2034,0
40697746127,40697746127,0,1368,1515,0
40699916011,40699916011,0,1755,1751,0
40701072694,40701072694,0,950,1510,0
40703405373,40703405374,1,1800,2380,0
40704068458,40704068458,0,2111,1873,0
40706975843,40706975845,2,1425,1557,0
40710827402,40710827402,0,1186,1883,0
40712720470,40712720468,-2,958,1210,0
40713706017,40713706018,1,1238,1412,0
40716772622,40716772621,-1,1519,2192,0
40719436655,40719436655,0,1721,1615,0
40724618673,40724618673,0,1350,1959,0
40725362374,40725362374,0,1568,1730,0
40728357981,40728357982,1,1134,1915,0
40728734953,40728734956,3,2122,1260,0
40729870558,40729870565,7,1094,1195,0
40729938539,40729938540,1,1107,1260,0
40732107388,40732107381,-7,985,3852,0
40734890761,40734890769,8,1951,1189,0
40738263319,40738263321,2,1146,1129,0
40739104647,40739104646,-1,1576,2166,0
40739852576,40739852575,-1,1257,1858,0
40739922196,40739922196,0,1370,2143,0
40740562500,40740562499,-1,1168,1899,0
40741872111,40741872111,0,1254,1715,0
40742249958,40742249961,3,1707,1684,0
40742527715,40742527714,-1,2084,2687,0
40743003073,40743003074,1,1201,1697,0
40743073174,40743073167,-7,1023,1478,0
40745289060,40745289063,3,1600,1553,0
40747912198,40747912201,3,1311,1232,0
40748725342,40748725347,5,1420,890,0
40752720242,40752720244,2,1577,2144,0
40752978234,40752978233,-1,1376,1841,0
40753688148,40753688146,-2,922,1671,0
40754449759,40754449758,-1,1445,1477,0
40755681649,40755681649,0,1502,1670,0
40756421771,40756421769,-2,1095,2632,0
40759951693,40759951698,5,2743,1403,0
40762018742,40762018741,-1,862,1339,0
40765579781,40765579782,1,1475,1654,0
40773560884,40773560885,1,1245,1708,0
40775079394,40775079394,0,1427,1516,0
40777774460,40777774462,2,1550,1941,0
40778911559,40778911557,-2,1237,1825,0
40782124285,40782124285,0,1125,2183,0
40783263295,40783263294,-1,715,1218,0
40783358354,40783358354,0,1382,1752,0
40785833549,40785833549,0,1788,2269,0
40788610335,40788610338,3,1313,1429,0
40790359091,40790359093,2,1289,2148,0
40790489432,40790489431,-1,1502,1606,0
40793775214,40793775216,2,1412,2077,0
40795188238,40795188231,-7,1611,9458,0
40797871825,40797871826,1,1566,1802,0
40799972985,40799972982,-3,1387,1636,0
40805847927,40805847926,-1,864,1900,0
40806559485,40806559485,0,1326,1810,0
40808362982,40808362986,4,1393,1514,0
40809622245,40809622247,2,1271,1493,0
40813797154,40813797153,-1,1085,2390,0
40814570386,40814570386,0,952,1358,0
40818286805,40818286805,0,1624,1960,0
40819656897,40819656897,0,1604,1443,0
40819999207,40819999207,0,1604,1142,0
40821391988,40821391989,1,1030,971,0
40821799116,40821799111,-5,1368,1665,0
40825117388,40825117386,-2,2729,4307,0
40827074146,40827074145,-1,1338,1599,0
40834795965,40834795968,3,1111,1357,0
40836169305,40836169306,1,1510,2672,0
40836861639,40836861642,3,1480,1135,0
40838802850,40838802853,3,1581,1406,0
40839926977,40839926980,3,1684,1311,0
40842856661,40842856663,2,2050,1487,0
40843971951,40843971955,4,1220,1070,0
40844280502,40844280503,1,1060,1356,0
40847057238,40847057238,0,1811,2328,0
40847173698,40847173697,-1,1294,1855,0
40848133745,40848133745,0,1885,1686,0
40849462802,40849462797,-5,2124,7507,0
40850100923,40850100922,-1,1514,2043,0
40851007626,40851007627,1,1709,1256,0
40852867010,40852867011,1,836,1243,0
40853441953,40853441932,-21,1495,1788,0
40854757646,40854757646,0,1388,2008,0
40855849157,40855849157,0,1468,2028,0
40857869341,40857869342,1,2047,2521,0
40860169185,40860169185,0,1694,1697,0
40861301379,40861301382,3,1423,1411,0
40866543984,40866543986,2,1044,1678,0
40866935060,40866935050,-10,1168,985,0
40868668341,40868668343,2,1009,2009,0
40869343766,40869343766,0,1436,1728,0
40871210667,40871210669,2,1574,1885,0
40871384442,40871384446,4,1387,1156,0
40873051430,40873051430,0,1438,2075,0
40873862325,40873862327,2,1630,1636,0
40875112851,40875112851,0,1496,1724,0
40876767523,40876767522,-1,1635,2011,0
40876888188,40876888189,1,1416,1863,0
40878759954,40878759953,-1,1309,1818,0
40880089402,40880089402,0,1211,1720,0
40880722664,40880722666,2,1803,1482,0
40884484421,40884484419,-2,1418,2109,0
40886184166,40886184165,-1,1433,2427,0
40888664083,40888664082,-1,1336,2109,0
40892422748,40892422747,-1,1994,2113,0
40894090942,40894090941,-1,1421,2202,0
40894922243,40894922245,2,1143,1459,0
40900973806,40900973807,1,1245,2135,0
40903396347,40903396347,0,1334,1757,0
40904890115,40904890117,2,1010,1495,0
40906176202,40906176202,0,1308,1576,0
40906569543,40906569542,-1,945,946,0
40907351234,40907351236,2,1173,1711,0
40907673916,40907673911,-5,1441,1648,0
40908986625,40908986625,0,1307,1528,0
40915923714,40915923714,0,1623,2207,0
40919915417,40919915421,4,1864,1115,0
40920756875,40920756876,1,2169,2139,0
40921884747,40921884748,1,1225,1494,0
40922067853,40922067857,4,2423,1393,0
40926195465,40926195464,-1,1034,1320,0
40927686711,40927686717,6,2016,1228,0
40930898301,40930898301,0,1294,1523,0
40933922867,40933922869,2,1299,1482,0
40936036890,40936036890,0,1311,2399,0
40946146420,40946146421,1,1427,1709,0
40946371049,40946371048,-1,1399,1713,0
40947487467,40947487467,0,2013,2227,0
40950536681,40950536682,1,1598,1203,0
40954414748,40954414748,0,1578,1731,0
40957230789,40957230786,-3,1342,2744,0
40962171949,40962171950,1,2227,1519,0
40963011608,40963011621,13,167,1532,0
40965434872,40965434874,2,1648,2261,0
40972244207,40972244210,3,1649,1843,0
40974440951,40974440953,2,1554,1578,0
40974557146,40974557145,-1,1167,1807,0
40975860026,40975860033,7,1843,1005,0
40979905103,40979905102,-1,1389,1733,0
40979948866,40979948866,0,1173,1848,0
40983315103,40983315105,2,1070,1330,0
40989259547,40989259546,-1,1462,1560,0
40991154134,40991154134,0,1489,1566,0
40992395435,40992395441,6,2244,1677,0
40995076797,40995076797,0,1723,2071,0
40996909876,40996909875,-1,1671,1764,0
40997079917,40997079918,1,850,1033,0
40999485897,40999485898,1,1934,2699,0
40999916225,40999916227,2,1439,1047,0
41002966167,41002966166,-1,830,1080,0
41006803856,41006803853,-3,884,1458,0
41007033813,41007033815,2,1583,1322,0
41009848760,41009848761,1,2016,1947,0
41012480575,41012480573,-2,1668,1726,0
41014479411,41014479413,2,1497,1901,0
41017295555,41017295554,-1,1251,1246,0
41019888194,41019888196,2,2475,2287,0
41021187655,41021187656,1,1345,1230,0
41027251561,41027251558,-3,855,1182,0
41028314806,41028314809,3,1547,1708,0
41033102114,41033102116,2,1193,1729,0
41033336348,41033336351,3,2424,1514,0
41034662721,41034662722,1,1681,2433,0
41036834012,41036834013,1,1324,1815,0
41037196726,41037196725,-1,1424,1811,0
41040630334,41040630332,-2,825,2064,0
41043713934,41043713935,1,1516,1453,0
41043782023,41043782021,-2,1059,1377,0
41045387518,41045387519,1,1058,965,0
41045950446,41045950454,8,4942,1659,0
41046014258,41046014259,1,1011,1096,0
41046504897,41046504898,1,1620,1471,0
41047507883,41047507879,-4,852,1259,0
41048590676,41048590677,1,1212,1768,0
41049484268,41049484270,2,1464,1301,0
41051683262,41051683261,-1,1046,2097,0
41054335166,41054335167,1,1620,1645,0
41059449699,41059449693,-6,2230,9612,0
41061149546,41061149546,0,1135,1983,0
41065603733,41065603734,1,1346,1166,0
41070656851,41070656855,4,1142,1608,0
41071316589,41071316590,1,1658,1950,0
41072590970,41072590973,3,1207,1409,0
41073853214,41073853217,3,1263,1329,0
41074344864,41074344865,1,876,986,0
41075483386,41075483387,1,1287,1798,0
41076696389,41076696387,-2,1797,1299,0
41077830685,41077830686,1,1073,1885,0
41077927756,41077927756,0,845,1442,0
41080231737,41080231737,0,979,1586,0
41082047871,41082047871,0,1129,1636,0
41085848625,41085848634,9,10480,26284,0
41089786247,41089786247,0,1357,1824,0
41091566293,41091566294,1,1725,2369,0
41091767530,41091767530,0,1336,1648,0
41095645132,41095645133,1,1438,1883,0
41096741823,41096741823,0,590,965,0
41100716170,41100716172,2,1722,2221,0
41101341935,41101341935,0,1418,1487,0
41103555737,41103555722,-15,1427,2334,0
41104713022,41104713024,2,2178,1875,0
41106215117,41106215117,0,1174,1556,0
41106464747,41106464746,-1,965,1347,0
41109958120,41109958121,1,1709,1838,0
41110941952,41110941951,-1,1139,1359,0
41113022843,41113022842,-1,1043,1957,0
41113506007,41113506008,1,1447,1853,0
41113649050,41113649050,0,826,2082,0
41113677397,41113677396,-1,1408,1651,0
41116038893,41116038893,0,1267,1185,0
41116633659,41116633659,0,810,1139,0
41119035702,41119035699,-3,1378,1211,0
41120280574,41120280574,0,1323,969,0
41121818704,41121818703,-1,1683,2441,0
41127078573,41127078573,0,1557,1525,0
41129595081,41129595081,0,1564,1807,0
41132654649,41132654648,-1,1281,1707,0
41137417461,41137417463,2,2415,1988,0
41137744031,41137744031,0,1579,2040,0
41138144944,41138144940,-4,1815,2163,0
41139911702,41139911702,0,1269,1358,0
41143321443,41143321438,-5,1346,2077,0
41144020605,41144020606,1,1130,1470,0
41144395046,41144395050,4,1129,1261,0
41146060425,41146060426,1,1561,1585,0
41147518904,41147518905,1,1389,1990,0
41149208648,41149208648,0,1320,1336,0
41149898118,41149898133,15,32,1839,0
41152567629,41152567619,-10,334,541,0
41153127031,41153127034,3,1398,1395,0
41154332121,41154332121,0,1112,1698,0
41155771619,41155771624,5,2231,1595,0
41158459959,41158459958,-1,1440,2081,0
41159399116,41159399118,2,1149,1243,0
41160379321,41160379319,-2,1563,1992,0
41162472647,41162472651,4,1868,1156,0
41162959637,41162959638,1,1491,1608,0
41168982042,41168982042,0,1314,1656,0
41169805007,41169805000,-7,978,4455,0
41169867539,41169867539,0,1799,2063,0
41170365614,41170365619,5,1986,1290,0
41174112746,41174112746,0,1421,1971,0
41177275045,41177275047,2,1152,1233,0
41179525318,41179525320,2,1230,1328,0
41182686928,41182686927,-1,1487,2059,0
41183505064,41183505065,1,1639,2024,0
41183586878,41183586879,1,1320,1398,0
41184922188,41184922188,0,1456,1885,0
41186753738,41186753735,-3,1051,2030,0
41187951692,41187951678,-14,950,1406,0
41188272970,41188272969,-1,1201,1972,0
41195263978,41195263977,-1,1316,2504,0
41199449147,41199449148,1,1335,1511,0
41200505792,41200505793,1,1008,1099,0
41202445638,41202445638,0,1353,1481,0
41207204103,41207204104,1,1739,2409,0
41209033921,41209033918,-3,1113,3102,0
41210239038,41210239038,0,926,1746,0
41212586942,41212586943,1,1095,1393,0
41213893093,41213893093,0,1405,2366,0
41216331706,41216331702,-4,1334,1759,0
41222403752,41222403753,1,2043,2194,0
41222619106,41222619106,0,1181,1743,0
41223077675,41223077676,1,883,1293,0
41224682222,41224682223,1,1896,2375,0
41225179800,41225179802,2,1700,1739,0
41226420341,41226420341,0,1382,1158,0
41230460270,41230460269,-1,1263,1786,0
41232184008,41232184006,-2,1536,1959,0
41241147075,41241147075,0,2349,2991,0
41243072077,41243072077,0,1284,1216,0
41245133606,41245133614,8,3650,1227,0
41246931922,41246931923,1,2673,2524,0
41247576210,41247576211,1,1557,1408,0
41250525053,41250525054,1,1094,1762,0
41258291402,41258291403,1,1634,1491,0
41261351273,41261351274,1,1404,1307,0
41262356642,41262356644,2,1851,1474,0
41262939529,41262939529,0,1270,1875,0
41264515200,41264515209,9,17187,43972,0
41267391621,41267391620,-1,1673,2150,0
41267453431,41267453435,4,1365,1066,0
41269497131,41269497133,2,1732,1345,0
41270776186,41270776186,0,1042,1485,0
41273755339,41273755333,-6,1481,1752,0
41275788492,41275788492,0,1290,1579,0
41277124311,41277124310,-1,1409,2474,0
41278906378,41278906378,0,1239,1771,0
41279382941,41279382940,-1,913,885,0
41279475221,41279475220,-1,1244,1927,0
41284671033,41284671035,2,1086,1280,0
41287634303,41287634302,-1,907,1116,0
41297929560,41297929561,1,1122,2131,0
41301094594,41301094594,0,1243,1977,0
41303613736,41303613735,-1,1342,1720,0
41306147154,41306147157,3,1466,1575,0
41307955317,41307955301,-16,40962,13157,0
41309013306,41309013308,2,1704,1758,0
41309585156,41309585149,-7,2057,6060,0
41309628881,41309628882,1,1272,1982,0
41312282861,41312282862,1,1209,1644,0
41312590330,41312590330,0,1041,1323,0
41315822649,41315822650,1,3371,4021,0
41318621201,41318621201,0,1375,1266,0
41323885521,41323885521,0,1764,1355,0
41328495538,41328495538,0,2051,1946,0
41328998536,41328998535,-1,1317,1297,0
41339402611,41339402611,0,1443,1895,0
41341857406,41341857406,0,1073,1455,0
41344421961,41344421962,1,1637,1752,0
41346535210,41346535213,3,1350,1180,0
41348018364,41348018365,1,995,1399,0
41348218415,41348218417,2,1287,1578,0
41350239271,41350239277,6,1788,1795,0
41350691990,41350691990,0,2093,1644,0
41350769579,41350769578,-1,1636,2346,0
41352876901,41352876901,0,1336,1830,0
41353745754,41353745756,2,1563,1428,0
41354712770,41354712770,0,1408,1792,0
41355024216,41355024209,-7,1043,1470,0
41359489221,41359489203,-18,1358,1346,0
41359987802,41359987804,2,955,1764,0
41363797798,41363797798,0,886,805,0
41367735110,41367735108,-2,1660,2049,0
41369425630,41369425632,2,1890,1900,0
41369613251,41369613251,0,1444,2258,0
41371627654,41371627655,1,1325,2002,0
41372133835,41372133835,0,1560,1185,0
41372778854,41372778856,2,1737,1873,0
41373191110,41373191109,-1,739,1692,0
41377115095,41377115098,3,1218,1407,0
41377686614,41377686614,0,1217,1993,0
41377892941,41377892923,-18,1317,1691,0
41378527249,41378527250,1,1789,2118,0
41381222413,41381222417,4,2909,1481,0
41381681921,41381681921,0,1203,1112,0
41382167129,41382167130,1,1653,1348,0
41386077885,41386077886,1,1569,1977,0
41386821971,41386821974,3,1184,1480,0
41388562462,41388562463,1,1351,1569,0
41395652714,41395652715,1,1330,1672,0
41398706886,41398706886,0,1014,1156,0
41399751010,41399751010,0,1304,1429,0
41406514764,41406514766,2,1213,1086,0
41406879317,41406879318,1,1440,1644,0
41407071702,41407071703,1,1223,1619,0
41407979271,41407979273,2,863,1893,0
41411837531,41411837530,-1,1270,1960,0
41412489685,41412489686,1,1403,1689,0
41414087738,41414087736,-2,1491,1467,0
41414775945,41414775951,6,2749,1271,0
41418271509,41418271509,0,1870,2529,0
41419074377,41419074385,8,11134,1348,0
41419453447,41419453445,-2,36997,23977,0
41420781293,41420781294,1,1597,1712,0
41421299493,41421299494,1,1459,1892,0
41423672905,41423672905,0,1226,1660,0
41426280857,41426280858,1,1464,1853,0
41427104043,41427104044,1,1555,1501,0
41432024835,41432024834,-1,1896,2703,0
41435280023,41435280024,1,1504,1382,0
41436318627,41436318627,0,1073,1348,0
41439774323,41439774326,3,1383,1950,0
41440372358,41440372358,0,1435,1562,0
41444915908,41444915909,1,1553,1400,0
41446599491,41446599493,2,1406,1386,0
41450747582,41450747582,0,1688,1798,0
41453728847,41453728849,2,1354,1555,0
41456559015,41456559013,-2,1523,1681,0
41459007303,41459007305,2,1764,2259,0
41459166350,41459166351,1,984,883,0
41460676026,41460676026,0,1408,1771,0
41463994379,41463994380,1,1678,1372,0
41464878563,41464878563,0,40204,12580,0
41466117853,41466117859,6,23479,26185,0
41468338097,41468338097,0,1986,1529,0
41472069564,41472069561,-3,1769,1641,0
41473186049,41473186053,4,1379,1501,0
41473240163,41473240175,12,1206,1640,0
41473471564,41473471556,-8,1145,323,0
41473550647,41473550649,2,1392,1300,0
41477553325,41477553306,-19,1345,1560,0
41480061046,41480061047,1,1370,2687,0
41481121506,41481121501,-5,1848,4246,0
41481289993,41481289998,5,1304,1099,0
41482541397,41482541398,1,1266,1285,0
41485379951,41485379950,-1,1418,2595,0
41485410650,41485410651,1,667,1439,0
41486179290,41486179292,2,1744,2122,0
41488434667,41488434669,2,1091,1788,0
41489478030,41489478032,2,1524,2016,0
41489800320,41489800321,1,1512,2566,0
41491263013,41491263013,0,1298,2214,0
41491425057,41491425057,0,1608,1604,0
41491452304,41491452303,-1,1574,1901,0
41492193366,41492193366,0,792,1989,0
41497323802,41497323801,-1,1142,1335,0
41497976882,41497976882,0,1330,2057,0
41501240182,41501240185,3,1411,1303,0
41503401718,41503401720,2,1578,1708,0
41506012221,41506012224,3,984,1104,0
41506720470,41506720470,0,1273,2072,0
41508790637,41508790635,-2,1056,1397,0
41510438013,41510438015,2,1425,1660,0
41510517121,41510517121,0,1263,1419,0
41511871215,41511871213,-2,987,1424,0
41514548548,41514548547,-1,814,1458,0
41515897684,41515897687,3,2201,1006,0
41516185778,41516185778,0,1383,2059,0
41519496544,41519496546,2,1721,1500,0
41520541454,41520541454,0,1867,1595,0
41522781582,41522781583,1,1534,1590,0
41523059811,41523059811,0,1784,2188,0
41523269969,41523269970,1,1611,1005,0
41525761363,41525761362,-1,1393,1993,0
41526052125,41526052125,0,1307,1726,0
41527774913,41527774934,21,1519,1201,0
41529030857,41529030858,1,1499,1641,0
41530522881,41530522881,0,1321,1854,0
41531939476,41531939478,2,841,1193,0
41532762769,41532762768,-1,1501,1722,0
41537494630,41537494629,-1,931,1239,0
41537970985,41537970984,-1,1424,1679,0
41538488710,41538488710,0,1234,1704,0
41542776962,41542776961,-1,1173,1833,0
41543007357,41543007357,0,1641,1832,0
41544248393,41544248392,-1,1971,1994,0
41544514833,41544514813,-20,1440,2228,0
41544833478,41544833474,-4,287,624,0
41547653367,41547653367,0,1446,1435,0
41549002202,41549002201,-1,826,1201,0
41549718581,41549718585,4,1580,1958,0
41552152639,41552152639,0,1221,1348,0
41552487754,41552487754,0,1391,1884,0
41552530902,41552530905,3,1150,2299,0
41554234708,41554234701,-7,1357,6109,0
41555094537,41555094538,1,1152,1581,0
41557735558,41557735558,0,1773,2173,0
41558449668,41558449669,1,1165,1926,0
41559397030,41559397031,1,1522,1555,0
41559714944,41559714950,6,1812,872,0
41569888366,41569888377,11,12206,43303,0
41570891716,41570891711,-5,940,1399,0
41572742584,41572742568,-16,865,329,0
41576545673,41576545675,2,1169,1878,0
41578779192,41578779194,2,1135,1636,0
41580078858,41580078859,1,1019,1366,0
41581497301,41581497301,0,1526,2208,0
41583599655,41583599656,1,1725,1658,0
41585641623,41585641626,3,926,1184,0
41587154762,41587154762,0,1944,1664,0
41587182807,41587182807,0,1651,1886,0
41587852703,41587852702,-1,651,1152,0
41588635690,41588635687,-3,1672,1546,0
41593360270,41593360270,0,1547,2257,0
41597429735,41597429736,1,945,1568,0
41597823490,41597823494,4,13146,9079,0
41600165355,41600165356,1,17,1864,0
41601760647,41601760648,1,1110,1422,0
41602914168,41602914191,23,1770,1051,0
41602950038,41602950039,1,1188,1820,0
41607604709,41607604712,3,1137,1290,0
41609051758,41609051759,1,983,1623,0
41609243214,41609243214,0,1076,1864,0
41609669633,41609669634,1,1871,1851,0
41611599890,41611599890,0,2533,3549,0
41613297178,41613297178,0,1326,1803,0
41615348074,41615348073,-1,1590,1911,0
41616216975,41616216977,2,1440,1406,0
41616288268,41616288269,1,1590,2114,0
41616375903,41616375904,1,1408,1530,0
41621133326,41621133326,0,1622,1510,0
41621765339,41621765337,-2,1396,2129,0
41624808909,41624808915,6,3108,1424,0
41625269895,41625269893,-2,1631,1537,0
41626175506,41626175514,8,14599,23517,0
41630583903,41630583906,3,1010,1040,0
41631294902,41631294904,2,1145,1471,0
41635047130,41635047129,-1,1554,1797,0
41638536499,41638536498,-1,1549,1725,0
41639742486,41639742487,1,1211,1351,0
41643662896,41643662898,2,1460,1574,0
41644485074,41644485075,1,1445,1809,0
41644806115,41644806115,0,1436,1411,0
41645216877,41645216877,0,1298,1213,0
41645505478,41645505477,-1,1227,1397,0
41647822427,41647822427,0,866,2040,0
41655790433,41655790433,0,1098,1668,0
41659542586,41659542585,-1,1717,1591,0
41660890182,41660890183,1,1341,1563,0
41661175782,41661175782,0,1511,1448,0
41667449814,41667449834,20,16110,39222,0
41669846362,41669846364,2,1290,1583,0
41672546295,41672546298,3,1372,1196,0
41672806419,41672806420,1,1671,1346,0
41675071571,41675071576,5,1635,820,0
41677376081,41677376079,-2,791,1406,0
41680474506,41680474485,-21,1478,1894,0
41680894594,41680894593,-1,1646,2227,0
41682405953,41682405950,-3,1182,1897,0
41686537234,41686537233,-1,1405,1388,0
41687368397,41687368398,1,841,700,0
41687511353,41687511353,0,1271,1443,0
41689188231,41689188231,0,1466,1557,0
41691148349,41691148351,2,1158,1290,0
41692775249,41692775249,0,1532,2191,0
41692979647,41692979647,0,1363,1948,0
41697825562,41697825580,18,551,1185,0
41698009521,41698009522,1,1379,1878,0
41698673189,41698673178,-11,1200,2453,0
41699599034,41699599038,4,11767,8527,0
41699782682,41699782682,0,1138,1222,0
41701174848,41701174846,-2,1605,1510,0
41702323334,41702323334,0,1482,1514,0
41703563209,41703563209,0,1421,1832,0
41704411391,41704411391,0,1449,1831,0
41705569973,41705569972,-1,1268,1638,0
41706453749,41706453750,1,1057,1361,0
41710682430,41710682430,0,1060,928,0
41715726110,41715726114,4,1308,1543,0
41715816106,41715816126,20,375,1201,0
41716588510,41716588508,-2,1093,1947,0
41718487519,41718487498,-21,1326,2320,0
41724047487,41724047487,0,1213,1134,0
41724107124,41724107112,-12,1362,1834,0
41725534407,41725534407,0,1807,2483,0
41726621908,41726621910,2,1340,1258,0
41731308568,41731308566,-2,1043,2032,0
41732211273,41732211274,1,1253,1910,0
41734379318,41734379318,0,1226,1270,0
41734792891,41734792886,-5,1564,3002,0
41735903987,41735903982,-5,924,2561,0
41736483471,41736483471,0,1697,1872,0
41736608540,41736608541,1,1476,2138,0
41736656039,41736656018,-21,1032,1631,0
41738139607,41738139611,4,1446,1826,0
41743603263,41743603261,-2,778,963,0
41745023239,41745023238,-1,1538,1809,0
41746983922,41746983922,0,1125,1902,0
41749410093,41749410090,-3,1636,1774,0
41750053751,41750053752,1,1727,2299,0
41750935614,41750935614,0,1757,2281,0
41751272478,41751272478,0,1437,1994,0
41754897396,41754897394,-2,1748,2123,0
41755998234,41755998235,1,1436,1873,0
41759977606,41759977605,-1,2190,2802,0
41760803152,41760803154,2,1401,1570,0
41763118501,41763118502,1,1182,1437,0
41765729890,41765729891,1,1502,1414,0
41769904654,41769904655,1,1158,1064,0
41771227627,41771227626,-1,1209,1568,0
41771315277,41771315276,-1,1054,1120,0
41772840688,41772840689,1,1456,1630,0
41776311729,41776311729,0,1134,1143,0
41776487206,41776487205,-1,1317,2943,0
41780260991,41780260993,2,1602,2025,0
41782891983,41782891985,2,1536,1427,0
41783168549,41783168549,0,1411,1908,0
41785171716,41785171718,2,1728,1685,0
41785816151,41785816154,3,1798,1151,0
41786404977,41786404977,0,1909,2120,0
41786654293,41786654294,1,1442,1193,0
41789754269,41789754265,-4,1173,1260,0
41791350826,41791350829,3,1386,1214,0
41791684655,41791684657,2,2094,2293,0
41792144186,41792144186,0,945,997,0
41794517362,41794517362,0,1216,1209,0
41795751618,41795751619,1,1183,1839,0
41796947581,41796947580,-1,1129,1654,0
41798604152,41798604154,2,1329,1517,0
41800182456,41800182456,0,1178,1352,0
41801207326,41801207328,2,1129,1546,0
41812843802,41812843801,-1,1540,1474,0
41813790153,41813790154,1,1385,1173,0
41814223386,41814223386,0,1122,908,0
41815494984,41815494985,1,1702,2579,0
41819284970,41819284970,0,1266,1726,0
41819613730,41819613731,1,786,1535,0
41821921059,41821921060,1,725,1193,0
41823317862,41823317860,-2,1142,1790,0
41824302351,41824302353,2,2065,2496,0
41824393899,41824393901,2,1256,1754,0
41828858926,41828858926,0,2026,1801,0
41837976737,41837976738,1,1184,1066,0
41840202718,41840202718,0,1057,2278,0
41842437558,41842437559,1,778,1423,0
41843012046,41843012066,20,1084,3075,0
41843404741,41843404741,0,1338,1805,0
41845481710,41845481711,1,671,1585,0
41845978814,41845978817,3,1691,1087,0
41850001014,41850001013,-1,1578,1845,0
41851844537,41851844538,1,1100,1705,0
41852562029,41852562031,2,1147,2094,0
41856098526,41856098525,-1,2368,3220,0
41857175681,41857175682,1,1415,1570,0
41857601093,41857601093,0,1501,1277,0
41858243696,41858243696,0,1979,2058,0
41858886629,41858886630,1,1126,1628,0
41863158454,41863158454,0,1014,1060,0
41865059962,41865059962,0,1258,1548,0
41865816695,41865816697,2,873,1489,0
41866926539,41866926541,2,1400,1602,0
41869951721,41869951720,-1,1189,1192,0
41870766159,41870766161,2,1331,1626,0
41873009510,41873009510,0,1359,2186,0
41874466617,41874466617,0,1495,1279,0
41875429983,41875429982,-1,1654,2109,0
41878161105,41878161106,1,1635,2126,0
41878205960,41878205969,9,501,2527,0
41883821359,41883821361,2,1476,1787,0
41887813135,41887813135,0,1171,1563,0
41890489380,41890489378,-2,1686,1856,0
41891706659,41891706657,-2,1501,1298,0
41893948469,41893948469,0,1129,1028,0
41894487445,41894487448,3,1774,1739,0
41895976069,41895976072,3,1592,1579,0
41897731947,41897731947,0,2067,1674,0
41906294905,41906294904,-1,1665,1785,0
41911618390,41911618389,-1,1083,1990,0
41912226823,41912226823,0,1211,1748,0
41914044446,41914044447,1,2196,2225,0
41915584680,41915584686,6,6373,3211,0
41917290014,41917290018,4,1963,1501,0
41917853330,41917853331,1,1144,1186,0
41918725391,41918725393,2,1246,1280,0
41918814375,41918814373,-2,1375,1577,0
41920559506,41920559507,1,1238,1373,0
41925547793,41925547793,0,1540,2763,0
41926234499,41926234500,1,1244,1607,0
41927612502,41927612501,-1,668,921,0
41929439954,41929439947,-7,1205,11590,0
41933076646,41933076646,0,1322,1786,0
41936351589,41936351590,1,1164,1493,0
41938082291,41938082293,2,1710,2099,0
41938174397,41938174398,1,1307,1828,0
41938868059,41938868061,2,1157,1141,0
41939741710,41939741713,3,1271,1926,0
41940529170,41940529174,4,2338,1294,0
41942165448,41942165449,1,1372,2113,0
41942227293,41942227272,-21,1087,1442,0
41945969779,41945969781,2,3359,2043,0
41948744181,41948744190,9,9117,34209,0
41949503014,41949503017,3,1578,2158,0
41949582634,41949582640,6,4622,2409,0
41949924289,41949924290,1,1207,2186,0
41951063606,41951063602,-4,1405,3081,0
41952516394,41952516395,1,981,1515,0
41952555485,41952555482,-3,1838,1773,0
41952909083,41952909085,2,1458,1498,0
41953520865,41953520871,6,3632,1906,0
41953961950,41953961950,0,1379,1316,0
41955993125,41955993123,-2,988,901,0
41960383399,41960383398,-1,1550,1624,0
41960972234,41960972237,3,1446,1953,0
41966195445,41966195445,0,1613,1777,0
41967042853,41967042858,5,1504,1352,0
41967552117,41967552117,0,1207,1028,0
41968512370,41968512376,6,1584,1060,0
41969706561,41969706560,-1,1327,1531,0
41974230284,41974230285,1,1073,1641,0
41975762157,41975762155,-2,1380,1666,0
41976362647,41976362647,0,1044,1631,0
41978686554,41978686555,1,1161,1673,0
41982271135,41982271137,2,1325,1789,0
41983556090,41983556092,2,931,1563,0
41983920545,41983920546,1,1590,2466,0
41984780393,41984780393,0,1516,1511,0
41985019490,41985019492,2,1261,1368,0
41986697579,41986697579,0,1249,2182,0
41987292482,41987292481,-1,875,947,0
41987353726,41987353726,0,752,1460,0
41988115406,41988115406,0,1248,1461,0
41989084365,41989084367,2,1163,1371,0
41991368066,41991368067,1,1047,1499,0
41991447865,41991447866,1,1772,1545,0
41991758133,41991758135,2,700,848,0
41993001020,41993001022,2,1314,2347,0
41996657689,41996657689,0,1436,1597,0
41996707409,41996707411,2,1242,1835,0
41999442655,41999442637,-18,995,1024,0
41999551806,41999551807,1,1382,1977,0
42002276420,42002276418,-2,1283,1617,0
42003105041,42003105042,1,1457,2074,0
42008498270,42008498269,-1,1788,1739,0
42010092031,42010092033,2,1503,2006,0
42012136349,42012136350,1,1714,1781,0
42015517436,42015517442,6,2362,1116,0
42017068713,42017068713,0,1475,1653,0
42017348034,42017348034,0,1164,2063,0
42022366624,42022366626,2,1013,1386,0
42024880598,42024880598,0,1139,2138,0
42025625534,42025625537,3,1895,1280,0
42027796961,42027796963,2,1638,1605,0
42031783459,42031783459,0,783,1118,0
42033053364,42033053366,2,1691,1396,0
42034578781,42034578802,21,1663,1841,0
42035436529,42035436530,1,771,1324,0
42037050786,42037050786,0,944,1781,0
42037515869,42037515869,0,1728,1927,0
42038363661,42038363660,-1,896,1948,0
42040386217,42040386216,-1,1456,2214,0
42040959845,42040959849,4,1236,1803,0
42041856130,42041856131,1,1599,1572,0
42041991282,42041991283,1,1479,1504,0
42042310356,42042310354,-2,1547,1685,0
42042901050,42042901050,0,1065,1639,0
42044893106,42044893108,2,1803,1748,0
42047938814,42047938815,1,1724,1977,0
42048759861,42048759860,-1,10580,13792,0
42052653309,42052653307,-2,1327,1524,0
42055074971,42055074973,2,1216,1645,0
42058395803,42058395785,-18,1180,1273,0
42060117617,42060117617,0,1420,1904,0
42062645372,42062645371,-1,1676,2075,0
42064474441,42064474442,1,1073,1651,0
42064903466,42064903467,1,1540,2221,0
42068056182,42068056181,-1,1400,1558,0
42068158885,42068158878,-7,1503,4801,0
42069521554,42069521554,0,1761,1725,0
42073462109,42073462102,-7,1184,3748,0
42078635027,42078635026,-1,1235,1596,0
42079803253,42079803258,5,2147,1153,0
42084440758,42084440750,-8,1119,7390,0
42085007714,42085007715,1,874,974,0
42087894180,42087894200,20,1693,1185,0
42091960898,42091960899,1,1693,1998,0
42092524031,42092524030,-1,1409,1942,0
42093450247,42093450246,-1,1826,2026,0
42094882261,42094882262,1,1504,1562,0
42097524869,42097524870,1,1781,1646,0
42099382665,42099382666,1,1850,1406,0
42104699317,42104699317,0,1267,1794,0
42106232521,42106232519,-2,2023,1544,0
42110055716,42110055715,-1,1573,2717,0
42112181022,42112181026,4,1423,1589,0
42112397777,42112397782,5,3279,1841,0
42115473212,42115473211,-1,1322,1518,0
42117116214,42117116214,0,1155,1316,0
42117481987,42117481987,0,1602,1520,0
42117798672,42117798672,0,1170,1539,0
42118785819,42118785821,2,1494,1756,0
42123582327,42123582330,3,1610,1928,0
42126733126,42126733126,0,1813,3343,0
42126947994,42126947994,0,812,1626,0
42127967330,42127967331,1,1661,1987,0
42128365196,42128365198,2,1391,1296,0
42129809410,42129809409,-1,2071,2141,0
42129925405,42129925406,1,1733,1916,0
42132808146,42132808127,-19,35775,61914,0
42134540254,42134540254,0,1186,2114,0
42137267183,42137267183,0,1445,2151,0
42140477605,42140477609,4,1703,1443,0
42147541302,42147541283,-19,1009,1406,0
42150075570,42150075570,0,2050,1866,0
42153493253,42153493254,1,640,1326,0
42160274264,42160274264,0,1568,1700,0
42161278478,42161278479,1,1724,2569,0
42164953886,42164953886,0,1346,1628,0
42166665371,42166665372,1,1581,1402,0
42169452423,42169452424,1,1764,1477,0
42169934469,42169934470,1,1096,1610,0
42170677971,42170677969,-2,1216,1790,0
42172299563,42172299559,-4,1095,1539,0
42176923075,42176923074,-1,1368,1750,0
42177490858,42177490858,0,1002,1286,0
42178067034,42178067034,0,1135,1829,0
42180951453,42180951454,1,1699,2467,0
42181324574,42181324575,1,3444,4180,0
42183458011,42183458015,4,1513,1924,0
42183870248,42183870254,6,3066,1052,0
42184553187,42184553188,1,1164,1028,0
42185084795,42185084797,2,1491,2304,0
42185839798,42185839800,2,1830,1957,0
42187285857,42187285851,-6,2287,6566,0
42187834953,42187834954,1,2039,1051,0
42189094617,42189094618,1,1430,1344,0
42189633745,42189633746,1,2051,2008,0
42189664614,42189664614,0,1590,2383,0
42190420079,42190420078,-1,1270,1176,0
42196412642,42196412642,0,1069,1324,0
42196660775,42196660769,-6,1361,1385,0
42198384586,42198384588,2,1530,1998,0
42198898614,42198898613,-1,1670,2119,0
42200883238,42200883237,-1,1876,2137,0
42202544534,42202544535,1,932,1299,0
42207572401,42207572402,1,1005,1543,0
42209690087,42209690086,-1,1243,1401,0
42214919841,42214919841,0,1696,1602,0
42220042981,42220042984,3,1422,1598,0
42220978925,42220978931,6,2822,933,0
42222434564,42222434565,1,1372,2205,0
42227751999,42227751999,0,826,1284,0
42229806570,42229806551,-19,1840,1404,0
42233069621,42233069621,0,1076,935,0
42234501725,42234501726,1,1368,1088,0
42241467920,42241467921,1,1948,2708,0
42242314791,42242314790,-1,949,1998,0
42243250592,42243250601,9,1860,1448,0
42244836548,42244836550,2,1523,1831,0
42246030599,42246030598,-1,1460,2031,0
42246965770,42246965770,0,1580,1670,0
42247415955,42247415954,-1,1722,1440,0
42250203599,42250203599,0,1136,1602,0
42251430075,42251430075,0,1288,1631,0
42251888222,42251888222,0,1438,2694,0
42253294299,42253294298,-1,1151,2213,0
42257017862,42257017862,0,1290,1585,0
42257515513,42257515521,8,9252,43458,0
42258160221,42258160221,0,1399,1650,0
42261404352,42261404353,1,1786,1909,0
42261660127,42261660126,-1,1996,1671,0
42265148058,42265148057,-1,1888,2578,0
42265831866,42265831866,0,1185,1774,0
42266503313,42266503314,1,1284,1267,0
42271460465,42271460466,1,1202,1894,0
42273625449,42273625450,1,1719,2009,0
42274075107,42274075108,1,1548,2259,0
42275259839,42275259841,2,1076,1608,0
42275389533,42275389533,0,1276,1284,0
42275781906,42275781907,1,1808,1774,0
42277784503,42277784505,2,1262,1553,0
42278136735,42278136753,18,1061,304,0
42283722250,42283722249,-1,982,822,0
42285453087,42285453086,-1,1569,1427,0
42287790934,42287790936,2,1332,1626,0
42288185899,42288185900,1,1722,1785,0
42289263305,42289263302,-3,1534,1676,0
42289303079,42289303079,0,1238,1662,0
42289400121,42289400122,1,1575,1664,0
42289728961,42289728940,-21,1338,1059,0
42291832166,42291832166,0,1310,1396,0
42293630084,42293630084,0,2062,1525,0
42294037202,42294037203,1,1615,1995,0
42294974005,42294974002,-3,1376,1746,0
42295124346,42295124346,0,1435,1821,0
42295317254,42295317255,1,1771,1428,0
42298502386,42298502383,-3,953,1130,0
42305440701,42305440705,4,4296,2931,0
42306674258,42306674258,0,1010,1467,0
42307384973,42307384971,-2,1515,1408,0
42311348637,42311348635,-2,1296,1967,0
42312154162,42312154165,3,1294,1513,0
42317060395,42317060397,2,1018,1827,0
42319905802,42319905803,1,1416,1583,0
42320634869,42320634870,1,1632,1791,0
42324760947,42324760927,-20,1445,1484,0
42328279247,42328279248,1,1347,1854,0
42330230105,42330230107,2,2114,1235,0
42330713591,42330713593,2,1118,1929,0
42332338515,42332338515,0,1995,2845,0
42335979376,42335979375,-1,1756,1938,0
42340818798,42340818778,-20,1490,1093,0
42340864039,42340864038,-1,1188,1396,0
42341865530,42341865530,0,1358,2210,0
42342834742,42342834743,1,1113,1121,0
42343111033,42343111033,0,1775,2429,0
42345997570,42345997568,-2,848,1263,0
42346635014,42346635011,-3,1538,2687,0
42358310168,42358310189,21,1940,1708,0
42360190594,42360190594,0,1191,2048,0
42363092325,42363092317,-8,1049,1741,0
42363418943,42363418938,-5,1125,1379,0
42364756806,42364756807,1,1482,2257,0
42366612466,42366612466,0,1544,1836,0
42367032057,42367032058,1,1309,1860,0
42373801320,42373801320,0,1453,1884,0
42374728410,42374728410,0,1011,1154,0
42375697281,42375697282,1,1165,1575,0
42377031578,42377031581,3,32,675,0
42378411245,42378411246,1,1147,1479,0
42382989805,42382989805,0,999,2049,0
42386655566,42386655566,0,1256,1324,0
42387451426,42387451408,-18,774,472,0
42388918427,42388918430,3,1402,1782,0
42392416255,42392416257,2,1287,1584,0
42394704043,42394704045,2,1964,2057,0
42394794051,42394794052,1,1159,1538,0
42395405924,42395405924,0,1099,1624,0
42397803503,42397803503,0,955,1512,0
42401776977,42401776977,0,1405,1603,0
42405585945,42405585943,-2,1706,2002,0
42407290554,42407290553,-1,1768,1727,0
42408851403,42408851405,2,1286,1177,0
42412481137,42412481137,0,1452,1883,0
42413692461,42413692461,0,1593,1912,0
42415715125,42415715128,3,1311,1734,0
42416946918,42416946917,-1,1295,1508,0
42426265954,42426265955,1,1976,1567,0
42430373562,42430373567,5,1261,1168,0
42439113568,42439113568,0,1463,1367,0
42440445079,42440445081,2,991,1542,0
42443199434,42443199435,1,1194,2397,0
42444690818,42444690818,0,1212,1130,0
42446108438,42446108437,-1,1488,2391,0
42446934462,42446934464,2,1408,1807,0
42449606237,42449606239,2,1022,989,0
42450810466,42450810466,0,1921,1646,0
42452279438,42452279438,0,1893,1609,0
42461140966,42461140965,-1,1318,1343,0
42462092460,42462092462,2,1472,1061,0
42462732335,42462732338,3,760,1145,0
42465576667,42465576670,3,1632,2104,0
42465655083,42465655086,3,2036,1269,0
42466290254,42466290255,1,838,1321,0
42466734484,42466734483,-1,1297,2563,0
42469415026,42469415026,0,1509,1581,0
42471369705,42471369706,1,1734,2300,0
42475660357,42475660358,1,2193,1246,0
42477998939,42477998938,-1,927,1688,0
42479427595,42479427594,-1,1452,1851,0
42480195602,42480195603,1,1328,1404,0
42486305357,42486305358,1,949,1620,0
42487368269,42487368272,3,2287,1072,0
42489111281,42489111282,1,990,1041,0
42489372814,42489372815,1,1235,2423,0
42492338574,42492338575,1,1101,1327,0
42496027945,42496027939,-6,1254,5510,0
42496375492,42496375494,2,1693,1547,0
42497395982,42497395982,0,903,1802,0
42501541846,42501541845,-1,1644,2112,0
42503415433,42503415435,2,2064,1768,0
42504875576,42504875576,0,1581,1427,0
42508377006,42508377008,2,1368,1671,0
42508576350,42508576351,1,1881,1434,0
42509843234,42509843233,-1,1309,1430,0
42512735522,42512735522,0,1242,1497,0
42517494811,42517494812,1,1623,1760,0
42518763480,42518763480,0,1471,1669,0
42519097950,42519097952,2,1473,2129,0
42522470137,42522470138,1,1213,1674,0
42525227472,42525227471,-1,1618,2163,0
42528384812,42528384816,4,1399,1645,0
42529888241,42529888244,3,1542,2174,0
42531667869,42531667870,1,1379,1849,0
42536915439,42536915439,0,1586,1387,0
42542610650,42542610651,1,1679,1462,0
42544047549,42544047549,0,1754,1331,0
42544711343,42544711343,0,1136,1393,0
42548521224,42548521225,1,2017,1734,0
42549716717,42549716718,1,1956,1601,0
42551525681,42551525684,3,1170,1415,0
42552208630,42552208631,1,1140,1015,0
42552898789,42552898788,-1,2698,3923,0
42553707517,42553707518,1,1215,1631,0
42555051564,42555051566,2,1255,1320,0
42557346288,42557346286,-2,1308,2226,0
42562004188,42562004189,1,1319,1423,0
42562589247,42562589247,0,1146,1412,0
42563301785,42563301785,0,868,894,0
42563625039,42563625025,-14,1663,1773,0
42563809909,42563809910,1,1263,1104,0
42564415597,42564415615,18,16,1319,0
42569688295,42569688295,0,1300,1355,0
42574227969,42574227969,0,1077,1661,0
42574813654,42574813649,-5,983,2446,0
42577169449,42577169450,1,1131,1720,0
42578395529,42578395527,-2,1473,1728,0
42581237673,42581237677,4,1432,1477,0
42583105010,42583105010,0,1115,1725,0
42589183973,42589183973,0,1182,1335,0
42590791602,42590791602,0,1261,1491,0
42591038005,42591038011,6,1604,917,0
42591339855,42591339857,2,1284,1544,0
42595342862,42595342862,0,1442,1706,0
42601440526,42601440528,2,1420,1955,0
42602734730,42602734731,1,967,1123,0
42606340005,42606340013,8,875,896,0
42607089427,42607089431,4,1775,1573,0
42607436305,42607436306,1,911,1435,0
42613162866,42613162865,-1,1140,1275,0
42614311003,42614310997,-6,1061,4411,0
42617577540,42617577541,1,1302,2043,0
42619930927,42619930930,3,1524,1430,0
42620242615,42620242618,3,1645,1619,0
42620319522,42620319523,1,1435,2035,0
42620448729,42620448734,5,3300,1789,0
42623732602,42623732602,0,998,1596,0
42625498951,42625498950,-1,1410,2233,0
42629167229,42629167230,1,1601,1622,0
42633782182,42633782177,-5,1445,1711,0
42634334061,42634334040,-21,1852,1880,0
42634687076,42634687077,1,1108,1280,0
42638380450,42638380451,1,1120,1339,0
42639751531,42639751529,-2,1278,1678,0
42640958595,42640958595,0,1276,1598,0
42641973173,42641973173,0,1486,1545,0
42644745994,42644745994,0,1719,2115,0
42645894730,42645894728,-2,1057,1879,0
42646672305,42646672305,0,1161,1237,0
42656231209,42656231209,0,1164,1645,0
42659271721,42659271723,2,1567,1263,0
42661575165,42661575167,2,942,1653,0
42662618778,42662618776,-2,2074,1518,0
42665998022,42665998021,-1,1611,1700,0
42669074145,42669074146,1,1668,2042,0
42670315967,42670315971,4,970,888,0
42671324383,42671324384,1,1496,1172,0
42672592346,42672592348,2,8632,8164,0
42672749989,42672749994,5,2273,1117,0
42678220950,42678220950,0,5304,7910,0
42680369951,42680369951,0,1570,2225,0
42680535921,42680535919,-2,1582,1858,0
42681517458,42681517460,2,1433,1472,0
42684226378,42684226378,0,1234,1710,0
42686300370,42686300370,0,1347,1225,0
42687967918,42687967917,-1,1766,3615,0
42689137578,42689137583,5,2734,1365,0
42690277725,42690277726,1,1500,17068,0
42691141978,42691141981,3,1262,1492,0
42698883389,42698883391,2,1175,1262,0
42699697213,42699697213,0,1453,1194,0
42700691882,42700691880,-2,1261,2006,0
42704904617,42704904619,2,1645,1574,0
42705764729,42705764725,-4,951,1040,0
42708689512,42708689513,1,1761,1547,0
42709203116,42709203116,0,1624,1390,0
42713204671,42713204670,-1,2015,2532,0
42718974835,42718974834,-1,927,1766,0
42723941366,42723941366,0,1871,1763,0
42728712810,42728712809,-1,1229,1529,0
42728773473,42728773473,0,1614,1442,0
42728969266,42728969266,0,1981,3720,0
42729569682,42729569683,1,1208,1864,0
42730710845,42730710846,1,2119,2009,0
42735295116,42735295116,0,1444,1618,0
42740613789,42740613788,-1,1154,1466,0
42742724291,42742724289,-2,1403,1493,0
42743084036,42743084035,-1,1558,1458,0
42743899391,42743899370,-21,873,1568,0
42744250685,42744250688,3,1694,1142,0
42744337176,42744337169,-7,1192,4954,0
42751320262,42751320263,1,1151,1436,0
42752986118,42752986119,1,1003,1827,0
42753323133,42753323136,3,1040,1443,0
42753923115,42753923118,3,1391,1311,0
42755509068,42755509065,-3,908,1030,0
42756626551,42756626554,3,1074,1609,0
42757249928,42757249928,0,1300,1627,0
42757648715,42757648716,1,1580,1711,0
42760766239,42760766244,5,1424,1506,0
42764685214,42764685215,1,1963,1440,0
42764845221,42764845222,1,2136,2414,0
42766077109,42766077109,0,1360,1888,0
42766650020,42766650021,1,1617,1352,0
42767936261,42767936262,1,1167,2480,0
42769205859,42769205861,2,1518,1825,0
42769604326,42769604326,0,1401,2120,0
42772187967,42772187968,1,1600,2233,0
42772765530,42772765530,0,1084,1560,0
42774060482,42774060481,-1,1127,1376,0
42775325520,42775325520,0,1336,1184,0
42782344750,42782344751,1,1389,1484,0
42782897440,42782897441,1,1813,1894,0
42783295397,42783295396,-1,1670,2229,0
42786683454,42786683454,0,1193,1059,0
42787871377,42787871380,3,1596,1861,0
42793026461,42793026461,0,2203,1525,0
42793920710,42793920709,-1,2342,1900,0
42795564898,42795564898,0,1377,1286,0
42796448117,42796448117,0,974,1596,0
42797321782,42797321783,1,1162,1699,0
42799263201,42799263200,-1,1574,2387,0
42800071745,42800071746,1,1328,1353,0
42800477070,42800477070,0,1729,1585,0
42804903798,42804903819,21,792,983,0
42807609019,42807609018,-1,1980,2315,0
42808858610,42808858613,3,1255,1286,0
42813044025,42813044027,2,2051,1655,0
42815841206,42815841206,0,1553,1581,0
42817641408,42817641407,-1,1282,1378,0
42817778533,42817778532,-1,1206,1573,0
42820398011,42820398013,2,1627,2292,0
42821770294,42821770293,-1,1542,2091,0
42825902149,42825902149,0,1340,1215,0
42828625043,42828625045,2,1038,1754,0
42835003844,42835003846,2,2283,1528,0
42839299843,42839299843,0,938,1255,0
42839363103,42839363103,0,1504,2220,0
42840777518,42840777518,0,1488,1491,0
42843319573,42843319573,0,1282,1311,0
42844190519,42844190519,0,1689,2412,0
42845924668,42845924666,-2,1903,1943,0
42850805609,42850805610,1,1158,1516,0
42852906550,42852906550,0,893,755,0
42854166141,42854166139,-2,1441,1656,0
42856615874,42856615874,0,1229,1329,0
42863245583,42863245584,1,666,1453,0
42864057347,42864057349,2,1257,1709,0
42864307226,42864307226,0,1389,1672,0
42865301365,42865301364,-1,1290,2036,0
42870335417,42870335402,-15,1520,1715,0
42870717489,42870717490,1,2419,2495,0
42870810151,42870810151,0,1212,2222,0
42871285233,42871285234,1,1202,1971,0
42872050579,42872050581,2,1297,1903,0
42873393814,42873393815,1,1711,1736,0
42873705770,42873705770,0,1502,1239,0
42878040773,42878040765,-8,992,3782,0
42882377796,42882377778,-18,1075,1872,0
42884733353,42884733353,0,1499,1758,0
42886419831,42886419830,-1,1360,2126,0
42886660653,42886660652,-1,1818,2103,0
42888572411,42888572413,2,1776,1627,0
42888726527,42888726526,-1,1596,1737,0
42892894711,42892894710,-1,1205,1447,0
42895421209,42895421210,1,1493,1250,0
42900897672,42900897673,1,1836,2288,0
42901977363,42901977363,0,1147,1398,0
42902746076,42902746078,2,1196,1321,0
42905194135,42905194137,2,1595,1637,0
42905599718,42905599720,2,1018,1002,0
42907737949,42907737949,0,1112,1746,0
42908351870,42908351870,0,1668,2040,0
42909631515,42909631516,1,1193,2244,0
42911083374,42911083377,3,654,1332,0
42915212634,42915212638,4,1033,1310,0
42915756146,42915756146,0,1834,1705,0
42917297681,42917297681,0,1110,1127,0
42921371035,42921371034,-1,1220,2193,0
42928921890,42928921889,-1,1319,1766,0
42929988390,42929988390,0,932,1211,0
42938224961,42938224959,-2,1372,1312,0
42940977558,42940977558,0,1696,2029,0
42941043682,42941043683,1,1382,1689,0
42942178090,42942178091,1,1678,1667,0
42943886361,42943886361,0,1513,2360,0
42948661802,42948661804,2,2261,1561,0
42949782277,42949782278,1,624,1067,0
42950534899,42950534899,0,1582,1491,0
42951042180,42951042181,1,2171,2256,0
42953704125,42953704126,1,1867,2138,0
42956149783,42956149774,-9,1337,1584,0
42957391500,42957391499,-1,1755,2344,0
42957428456,42957428455,-1,1555,2123,0
42960890586,42960890586,0,1535,1707,0
42965496006,42965496006,0,1502,1412,0
42966989181,42966989181,0,788,906,0
42969131309,42969131310,1,1273,1636,0
42971727299,42971727294,-5,827,1121,0
42974131169,42974131170,1,961,1499,0
42975036405,42975036393,-12,19836,16705,0
42977037601,42977037606,5,4591,1865,0
42977808948,42977808949,1,1384,1649,0
42979117962,42979117963,1,2146,1688,0
42982634285,42982634285,0,1073,1470,0
42985231987,42985231982,-5,1045,2769,0
42986506858,42986506860,2,1418,2472,0
42988408221,42988408222,1,1746,1995,0
42990149922,42990149922,0,1228,1098,0
42990988106,42990988105,-1,882,1153,0
42996649590,42996649587,-3,1127,1818,0
42999691122,42999691122,0,2308,1885,0
43001939502,43001939505,3,1123,890,0
43006470362,43006470362,0,1199,1361,0
43012607849,43012607859,10,3235,988,0
43016143253,43016143254,1,1093,1765,0
43016652748,43016652741,-7,949,1498,0
43020213276,43020213276,0,1818,1990,0
43021253549,43021253551,2,1115,1250,0
43022028227,43022028226,-1,1707,2586,0
43023659730,43023659729,-1,1273,1894,0
43025366562,43025366562,0,1638,1626,0
43028929156,43028929157,1,1521,1752,0
43041112254,43041112254,0,1263,1809,0
43042920834,43042920834,0,1782,1898,0
43044982758,43044982760,2,1128,1446,0
43047047172,43047047173,1,1274,1562,0
43052142754,43052142759,5,1330,555,0
43052711833,43052711835,2,1224,1428,0
43053947739,43053947741,2,1020,1487,0
43054349547,43054349528,-19,1730,1885,0
43059842531,43059842532,1,1361,1013,0
43061013421,43061013422,1,1269,1458,0
43062978739,43062978739,0,850,742,0
43069524262,43069524263,1,1636,1498,0
43069944861,43069944858,-3,1355,1849,0
43071467983,43071467985,2,993,2333,0
43075659290,43075659290,0,723,1619,0
43077418318,43077418319,1,1301,1766,0
43078397555,43078397558,3,2075,1902,0
43082101395,43082101394,-1,1312,2182,0
43086655785,43086655785,0,2275,2134,0
43091589302,43091589299,-3,1027,915,0
43092651869,43092651870,1,1280,1871,0
43093676762,43093676761,-1,3772,15333,0
43096648858,43096648857,-1,1610,1761,0
43099212274,43099212274,0,1322,1440,0
43099560810,43099560810,0,1344,1350,0
43100697034,43100697034,0,1385,1549,0
43101106107,43101106107,0,1750,1996,0
43101364658,43101364658,0,1316,1972,0
43103595147,43103595147,0,1313,1374,0
43105800291,43105800291,0,1083,1934,0
43107423388,43107423389,1,1545,2265,0
43108178845,43108178846,1,7938,6240,0
43109033632,43109033634,2,1708,2063,0
43111948986,43111948986,0,1407,1573,0
43114059843,43114059844,1,1652,1397,0
43124643346,43124643347,1,1751,2023,0
43124739916,43124739916,0,1056,1341,0
43126064655,43126064654,-1,946,1896,0
43130419230,43130419238,8,2464,1230,0
43133698205,43133698205,0,1643,1711,0
43135832066,43135832065,-1,855,1477,0
43137404224,43137404246,22,1451,1606,0
43139786278,43139786291,13,11581,40975,0
43142105061,43142105061,0,1264,1530,0
43145914878,43145914878,0,1531,1527,0
43149998199,43149998197,-2,1611,1811,0
43150141374,43150141375,1,1334,1714,0
43153779913,43153779917,4,1484,2009,0
43155780263,43155780250,-13,1408,1638,0
43156594326,43156594327,1,1366,1580,0
43157679286,43157679285,-1,976,1310,0
43158634220,43158634224,4,2825,1585,0
43160008571,43160008571,0,1857,1774,0
43162575810,43162575811,1,1225,1475,0
43164611145,43164611147,2,1846,2021,0
43164951315,43164951315,0,1912,1783,0
43167438651,43167438654,3,1971,1275,0
43167979210,43167979212,2,2206,2282,0
43168358897,43168358897,0,1418,1403,0
43171457025,43171457027,2,1404,2451,0
43173167927,43173167927,0,1226,2086,0
43182148135,43182148137,2,1679,2412,0
43186825965,43186825966,1,1824,2007,0
43187165730,43187165741,11,15143,33134,0
43187958951,43187958953,2,2011,2106,0
43188057193,43188057195,2,806,1422,0
43192735893,43192735893,0,1180,2141,0
43193452343,43193452343,0,1725,2188,0
43195030419,43195030422,3,1536,1428,0
43199187923,43199187922,-1,974,1856,0
43202138825,43202138824,-1,1299,1575,0
43204665386,43204665386,0,1659,1691,0
43205451995,43205451998,3,1412,1445,0
43205959890,43205959909,19,996,1273,0
43207763318,43207763318,0,1430,1656,0
43209251213,43209251209,-4,1729,1864,0
43211567105,43211567105,0,991,1764,0
43212364069,43212364070,1,1181,1593,0
43214301914,43214301913,-1,1684,1963,0
43215137585,43215137586,1,1470,1608,0
43216902014,43216902017,3,1188,2054,0
43222391562,43222391562,0,1455,1761,0
43224077416,43224077417,1,2226,2179,0
43227737031,43227737034,3,1713,1835,0
43230151803,43230151802,-1,1039,1853,0
43231972656,43231972656,0,1309,1996,0
43237147705,43237147713,8,6693,2654,0
43241970952,43241970954,2,1563,1058,0
43243529390,43243529387,-3,1488,2105,0
43247875599,43247875595,-4,1272,1320,0
43248230857,43248230858,1,3298,1836,0
43249665610,43249665613,3,1489,1239,0
43252762921,43252762921,0,1052,2016,0
43254056946,43254056946,0,1179,1444,0
43254287914,43254287922,8,3815,1285,0
43262426028,43262426022,-6,2080,7192,0
43267716281,43267716285,4,1261,682,0
43269647213,43269647212,-1,1080,1137,0
43270796210,43270796210,0,1369,1495,0
43271767746,43271767748,2,1874,1642,0
43274235943,43274235943,0,1153,1835,0
43275218890,43275218889,-1,1902,1922,0
43279416901,43279416902,1,1132,1430,0
43280072761,43280072760,-1,1599,1254,0
43289419527,43289419526,-1,1335,1309,0
43289968986,43289968966,-20,1257,1968,0
43296665555,43296665558,3,1403,1479,0
43297921698,43297921699,1,1505,1909,0
43301655731,43301655730,-1,1538,2419,0
43304137391,43304137389,-2,921,1314,0
43313909217,43313909216,-1,592,1171,0
43314028511,43314028510,-1,878,1878,0
43318068496,43318068495,-1,1719,2037,0
43319167722,43319167722,0,1254,1182,0
43327349437,43327349439,2,1583,1493,0
43329123859,43329123862,3,1244,1630,0
43330316350,43330316350,0,1260,1142,0
43332785959,43332785960,1,1485,1002,0
43334841005,43334841006,1,1584,1983,0
43342783638,43342783633,-5,47931,16510,0
43345233386,43345233387,1,1369,1077,0
43346681526,43346681532,6,2462,1237,0
43349167790,43349167808,18,1321,1247,0
43349785386,43349785386,0,2166,1635,0
43350262204,43350262204,0,1442,1895,0
43350441815,43350441814,-1,1575,1800,0
43352644702,43352644697,-5,1046,3310,0
43354111221,43354111218,-3,744,1575,0
43357303632,43357303631,-1,1529,2541,0
43358622921,43358622933,12,1479,1233,0
43359322538,43359322539,1,1418,1852,0
43365491911,43365491913,2,1583,1829,0
43366747638,43366747638,0,1316,2171,0
43368905170,43368905175,5,4344,3298,0
43369195034,43369195035,1,1337,1857,0
43374419902,43374419902,0,914,984,0
43374942479,43374942475,-4,1118,2610,0
43377635085,43377635086,1,1118,1372,0
43378989191,43378989190,-1,1186,2173,0
43384240403,43384240402,-1,913,1068,0
43386360071,43386360074,3,1413,1856,0
43391533684,43391533686,2,1271,1761,0
43394768742,43394768741,-1,1370,1570,0
43396665070,43396665070,0,1544,1702,0
43397029784,43397029782,-2,1369,1747,0
43406362126,43406362124,-2,817,1524,0
43407119649,43407119649,0,980,1315,0
43409502955,43409502955,0,795,1150,0
43412673652,43412673651,-1,1241,2286,0
43413693441,43413693441,0,1792,1811,0
43414788666,43414788666,0,1282,1321,0
43415914228,43415914245,17,945,2304,0
43417072322,43417072322,0,1338,1893,0
43418281102,43418281102,0,1353,1523,0
43423388752,43423388751,-1,1211,1795,0
43426395438,43426395437,-1,1820,1906,0
43427163395,43427163402,7,3518,1305,0
43436600495,43436600497,2,1712,1927,0
43441252558,43441252561,3,1545,1535,0
43445425325,43445425324,-1,1049,1660,0
43450555455,43450555458,3,1215,2123,0
43450686276,43450686266,-10,24,3300,0
43452405338,43452405338,0,1439,1903,0
43453146357,43453146356,-1,1289,2300,0
43455101770,43455101770,0,1036,1493,0
43456181421,43456181420,-1,1999,1754,0
43457652755,43457652755,0,1446,1194,0
43458909223,43458909223,0,1074,1120,0
43459928559,43459928560,1,1071,1318,0
43462729822,43462729842,20,1224,1249,0
43463573559,43463573561,2,1533,1984,0
43465156125,43465156125,0,1247,1366,0
43465747864,43465747858,-6,3949,13820,0
43467845709,43467845712,3,1809,2357,0
43468433367,43468433367,0,1666,2329,0
43470156893,43470156895,2,966,830,0
43470639091,43470639090,-1,1326,1317,0
43472156990,43472156991,1,1265,1799,0
43472190470,43472190475,5,1119,908,0
43473852101,43473852101,0,1162,1660,0
43474768416,43474768414,-2,1617,1911,0
43479509969,43479509967,-2,1239,1846,0
43479583626,43479583625,-1,1152,2261,0
43485866121,43485866115,-6,783,1993,0
43487211962,43487211961,-1,1395,1848,0
43487651572,43487651571,-1,1406,1839,0
43490335131,43490335132,1,993,1356,0
43491163642,43491163642,0,1410,2286,0
43496003801,43496003802,1,1339,1413,0
43497923035,43497923029,-6,565,3867,0
43499523294,43499523299,5,1609,716,0
43500265046,43500265043,-3,1046,1734,0
43501696352,43501696349,-3,17600,64300,0
43501792689,43501792689,0,1848,1677,0
43505138934,43505138934,0,1410,1619,0
43505998655,43505998655,0,792,1036,0
43506128870,43506128870,0,1850,1596,0
43508832139,43508832138,-1,2170,2778,0
43512045320,43512045320,0,1377,1427,0
43514396053,43514396052,-1,1392,1829,0
43516108737,43516108738,1,1657,1676,0
43517564894,43517564894,0,1935,2126,0
43518751625,43518751625,0,1364,1717,0
43521668773,43521668774,1,998,1437,0
43523263127,43523263131,4,1284,1483,0
43523556170,43523556173,3,1555,1818,0
43524098441,43524098441,0,1131,2217,0
43524183806,43524183810,4,3,1150,0
43524863798,43524863781,-17,1607,1607,0
43525819839,43525819823,-16,1258,1200,0
43526064086,43526064087,1,1531,2418,0
43526765842,43526765842,0,1593,1468,0
43527992065,43527992065,0,1357,1861,0
43532564807,43532564812,5,3949,3220,0
43533677479,43533677481,2,2074,1683,0
43536210605,43536210608,3,799,810,0
43536888882,43536888885,3,1362,1680,0
43537604952,43537604953,1,1374,1719,0
43545099038,43545099038,0,1427,1360,0
43545757434,43545757435,1,844,1239,0
43548049357,43548049359,2,1179,1085,0
43550151530,43550151532,2,1083,1269,0
43550635354,43550635355,1,1585,1180,0
43551532104,43551532106,2,2024,1310,0
43551730171,43551730170,-1,1713,2230,0
43552516667,43552516665,-2,1050,1651,0
43554067631,43554067630,-1,1598,2652,0
43557177050,43557177050,0,1278,1499,0
43558726362,43558726362,0,1202,1645,0
43562551861,43562551857,-4,906,1758,0
43564284873,43564284873,0,1395,2058,0
43565944103,43565944103,0,1304,2067,0
43568791653,43568791654,1,1060,1448,0
43571050416,43571050414,-2,1258,1499,0
43571259524,43571259512,-12,1395,2872,0
43572850894,43572850895,1,1020,1023,0
43576963857,43576963858,1,1341,2258,0
43579006802,43579006804,2,1445,1451,0
43581401837,43581401837,0,1565,1972,0
43581966479,43581966482,3,928,1441,0
43582933421,43582933422,1,1614,1084,0
43583137005,43583137006,1,1546,1607,0
43586238795,43586238791,-4,1758,4379,0
43588121152,43588121150,-2,1389,2012,0
43590729249,43590729249,0,969,1688,0
43591607671,43591607675,4,1519,1043,0
43591776425,43591776429,4,1711,1357,0
43602860617,43602860620,3,1397,1985,0
43603567217,43603567215,-2,1222,1543,0
43605674806,43605674806,0,1364,1699,0
43605788314,43605788314,0,1727,1133,0
43607086444,43607086446,2,1468,1609,0
43608675263,43608675263,0,1121,1085,0
43614382947,43614382947,0,1052,2347,0
43614830407,43614830406,-1,1506,2089,0
43620648627,43620648627,0,1796,1673,0
43621611820,43621611820,0,1592,2252,0
43622405266,43622405266,0,1555,2046,0
43622972395,43622972396,1,1423,1284,0
43623845500,43623845499,-1,1372,1297,0
43627016687,43627016688,1,2084,2051,0
43639183799,43639183801,2,2154,2673,0
43639366619,43639366626,7,2373,1634,0
43641618445,43641618446,1,1610,1684,0
43642545490,43642545490,0,1356,1900,0
43650194931,43650194933,2,1171,1212,0
43652632427,43652632429,2,1266,1524,0
43654147742,43654147743,1,1374,1713,0
43654816278,43654816276,-2,1134,1265,0
43656428589,43656428589,0,1384,1580,0
43657039596,43657039614,18,1089,2899,0
43657523578,43657523579,1,1213,1891,0
43658282694,43658282693,-1,1105,1852,0
43661298484,43661298485,1,1758,1831,0
43661374007,43661374004,-3,806,2394,0
43664091601,43664091622,21,675,808,0
43664685261,43664685263,2,1418,885,0
43666807941,43666807939,-2,1568,1656,0
43668603542,43668603541,-1,1087,1063,0
43668944153,43668944150,-3,2063,2619,0
43670200249,43670200250,1,1785,1733,0
43671209429,43671209429,0,816,1582,0
43671791956,43671791958,2,1421,1151,0
43672340997,43672340998,1,1480,1413,0
43677606306,43677606306,0,1247,1946,0
43680333587,43680333590,3,1581,1539,0
43681394631,43681394632,1,1417,2177,0
43681791906,43681791906,0,869,1412,0
43684105786,43684105786,0,1479,1587,0
43685270732,43685270733,1,1143,1591,0
43689497020,43689497022,2,1242,1167,0
43691952686,43691952688,2,1626,2177,0
43692624338,43692624339,1,909,1396,0
43692971803,43692971805,2,1329,1356,0
43693232145,43693232146,1,1186,1784,0
43694644895,43694644897,2,2632,2662,0
43695254596,43695254597,1,1316,1291,0
43696368914,43696368913,-1,1311,1279,0
43699793553,43699793548,-5,1338,3671,0
43702951567,43702951568,1,1267,1471,0
43713721277,43713721281,4,1553,1210,0
43713827817,43713827817,0,1491,1589,0
43713861122,43713861124,2,1632,1992,0
43719352362,43719352362,0,1465,1611,0
43721197634,43721197635,1,984,952,0
43722028406,43722028405,-1,1351,2147,0
43722592885,43722592883,-2,1733,2516,0
43723878108,43723878110,2,1932,2088,0
43728235854,43728235854,0,1612,1887,0
43728660914,43728660916,2,1293,1127,0
43731279125,43731279125,0,1464,1709,0
43733349797,43733349798,1,1050,1466,0
43735575397,43735575400,3,731,1450,0
43738057842,43738057844,2,1027,1477,0
43739635427,43739635428,1,1459,1656,0
43740495663,43740495665,2,1698,2308,0
43741024562,43741024563,1,1493,1755,0
43745499169,43745499170,1,1203,1128,0
43746585197,43746585197,0,2055,2521,0
43748070396,43748070397,1,1372,1270,0
43750059586,43750059586,0,1232,1497,0
43750798458,43750798459,1,1340,1328,0
43751044604,43751044605,1,1141,1604,0
43752138764,43752138766,2,1546,1800,0
43752178591,43752178592,1,1181,1460,0
43754352949,43754352950,1,1500,1883,0
43761094795,43761094793,-2,1210,1410,0
43761826426,43761826427,1,1683,1527,0
43768165278,43768165279,1,1514,1751,0
43769405410,43769405416,6,5934,2281,0
43772343475,43772343473,-2,1013,2076,0
43772821075,43772821075,0,932,714,0
43774385859,43774385862,3,1463,1671,0
43774560145,43774560147,2,1654,2003,0
43775099093,43775099094,1,1169,1170,0
43778658511,43778658511,0,1078,1965,0
43780338750,43780338756,6,2756,1028,0
43782428749,43782428748,-1,1167,1120,0
43784136894,43784136894,0,711,819,0
43785890245,43785890240,-5,1151,3720,0
43787482453,43787482453,0,1345,1615,0
43788914616,43788914614,-2,1605,1876,0
43789634358,43789634360,2,1682,2041,0
43789965084,43789965086,2,1310,1583,0
43795728718,43795728719,1,1457,1512,0
43795992885,43795992871,-14,692,986,0
43800246018,43800246012,-6,456,2270,0
43806726648,43806726638,-10,801,887,0
43809166654,43809166653,-1,2040,2309,0
43810457172,43810457174,2,1615,1359,0
43812325423,43812325425,2,1267,1049,0
43813865518,43813865519,1,1253,1506,0
43815240462,43815240463,1,1166,903,0
43817306112,43817306125,13,1261,980,0
43818469715,43818469714,-1,1056,1114,0
43819292500,43819292504,4,1136,1073,0
43820750438,43820750438,0,1331,1364,0
43822669758,43822669759,1,1567,1739,0
43829118982,43829118984,2,1303,1911,0
43831489992,43831489993,1,1479,1292,0
43832581043,43832581045,2,1430,1839,0
43834641814,43834641814,0,1316,1609,0
43836181794,43836181797,3,3101,2318,0
43838689782,43838689782,0,2339,1852,0
43842663977,43842663978,1,1890,2303,0
43847301643,43847301645,2,847,1404,0
43850552446,43850552446,0,1775,1660,0
43850937499,43850937498,-1,1136,897,0
43851929862,43851929860,-2,43054,19155,0
43852755498,43852755503,5,2697,1386,0
43854593762,43854593763,1,1562,1497,0
43857117091,43857117093,2,1035,1231,0
43857642752,43857642752,0,1162,1805,0
43864645779,43864645781,2,1109,1776,0
43867590413,43867590414,1,1049,1124,0
43869610319,43869610318,-1,1198,1728,0
43870398861,43870398857,-4,1500,5520,0
43872417070,43872417070,0,1441,1980,0
43875015603,43875015598,-5,1557,1532,0
43880423921,43880423923,2,1579,1294,0
43883646917,43883646914,-3,1127,2093,0
43884160542,43884160542,0,1014,1437,0
43887627979,43887627979,0,2210,2237,0
43888605839,43888605840,1,1140,1771,0
43892675173,43892675173,0,1748,1787,0
43894659026,43894659028,2,1693,1971,0
43895083070,43895083071,1,1247,1444,0
43895810170,43895810170,0,1596,2668,0
43899385298,43899385298,0,1162,1094,0
43902539858,43902539859,1,1734,1377,0
43903151842,43903151842,0,1745,1563,0
43903350168,43903350168,0,1544,2210,0
43903575399,43903575399,0,1205,1186,0
43904916834,43904916834,0,778,1871,0
43906091450,43906091449,-1,1014,1426,0
43907413123,43907413123,0,1870,2241,0
43908080335,43908080334,-1,1390,1449,0
43911708124,43911708122,-2,1292,1464,0
43912549990,43912549991,1,1595,2213,0
43917620861,43917620861,0,1117,1420,0
43919676727,43919676729,2,1240,1628,0
43921493678,43921493679,1,1391,1452,0
43923323769,43923323771,2,774,1564,0
43923790301,43923790323,22,247,608,0
43923990551,43923990552,1,1354,1473,0
43925826250,43925826250,0,1827,1615,0
43927354343,43927354343,0,1554,2326,0
43931087182,43931087182,0,1068,1435,0
43935405958,43935405959,1,1119,1397,0
43935703820,43935703803,-17,1683,1532,0
43938183263,43938183265,2,1199,1115,0
43938694237,43938694238,1,1579,1393,0
43939195410,43939195409,-1,606,2106,0
43940238766,43940238772,6,11816,7000,0
43941471965,43941471967,2,806,1145,0
43943024307,43943024309,2,1044,1252,0
43944585950,43944585949,-1,1217,1770,0
43948834002,43948834003,1,1123,1502,0
43951740119,43951740121,2,1261,1824,0
43952324433,43952324432,-1,1668,4684,0
43954265842,43954265843,1,1173,1550,0
43954505797,43954505797,0,1351,1248,0
43955823641,43955823642,1,1178,1077,0
43963077289,43963077289,0,1010,1363,0
43966813714,43966813712,-2,1136,1908,0
43967991861,43967991862,1,1504,1856,0
43968574354,43968574351,-3,1193,1281,0
43972715850,43972715851,1,1615,1442,0
43973501675,43973501677,2,1355,1575,0
43973994202,43973994184,-18,1612,1825,0
43975994145,43975994146,1,1240,1440,0
43977037365,43977037376,11,1492,1560,0
43977503889,43977503890,1,1474,1517,0
43978087677,43978087677,0,1659,1615,0
43983191946,43983191946,0,1092,1966,0
43984789086,43984789087,1,1193,1225,0
43990743935,43990743937,2,1022,1607,0
43992759723,43992759726,3,1396,1500,0
43993311726,43993311726,0,1968,1498,0
43993403490,43993403493,3,1346,1607,0
43999183403,43999183403,0,990,1736,0
43999321570,43999321569,-1,869,1482,0
44001661258,44001661257,-1,899,1947,0
44007551362,44007551359,-3,4358,7738,0
44011508403,44011508401,-2,1506,2414,0
44013702166,44013702165,-1,1106,2197,0
44015041994,44015041997,3,1194,2190,0
44018953039,44018953038,-1,1305,2032,0
44020261123,44020261125,2,1437,1549,0
44023180774,44023180774,0,1361,1600,0
44023585513,44023585513,0,1285,1422,0
44025694650,44025694651,1,1750,1383,0
44028054319,44028054324,5,3222,1709,0
44032245993,44032245995,2,1660,1764,0
44034570993,44034570993,0,1670,2656,0
44038698181,44038698174,-7,1743,6267,0
44039614430,44039614433,3,1983,2161,0
44039916744,44039916745,1,1770,1642,0
44041299293,44041299294,1,1263,2174,0
44042874555,44042874556,1,1819,1588,0
44043697653,44043697654,1,1354,1713,0
44047163249,44047163250,1,1235,924,0
44050772710,44050772710,0,1705,1605,0
44050853855,44050853835,-20,1637,1311,0
44054054923,44054054924,1,2135,2171,0
44057351126,44057351126,0,1247,1482,0
44062678801,44062678802,1,1611,2037,0
44063266550,44063266550,0,1899,2098,0
44072090447,44072090450,3,1048,1911,0
44076254462,44076254461,-1,1269,1704,0
44078170021,44078170021,0,1537,2209,0
44078924171,44078924170,-1,1062,2003,0
44079447349,44079447351,2,852,984,0
44083139118,44083139119,1,892,1318,0
44085363967,44085363968,1,1501,1508,0
44087103186,44087103187,1,1588,1082,0
44088227759,44088227759,0,1150,1659,0
44088404998,44088404992,-6,1578,1856,0
44089499793,44089499793,0,1404,2178,0
44090326018,44090326018,0,1509,1542,0
44091874135,44091874135,0,1699,1556,0
44094692793,44094692794,1,1137,947,0
44096815463,44096815466,3,1338,1566,0
44098015862,44098015862,0,1290,1912,0
44100141799,44100141799,0,878,1603,0
44103798841,44103798841,0,1621,1803,0
44104044913,44104044909,-4,1073,2620,0
44104740599,44104740583,-16,1323,1663,0
44104844935,44104844935,0,2084,1674,0
44105954214,44105954213,-1,1081,1500,0
44116024293,44116024295,2,1659,1537,0
44120133077,44120133076,-1,1385,1873,0
44120581625,44120581631,6,3593,1623,0
44121557363,44121557361,-2,788,1239,0
44122786222,44122786225,3,1301,1801,0
44123061774,44123061774,0,1942,2234,0
44123522925,44123522926,1,1177,1688,0
44124609614,44124609613,-1,1284,1256,0
44126896185,44126896185,0,1427,2208,0
44129868078,44129868081,3,1426,1265,0
44132329911,44132329911,0,1176,1921,0
44135321442,44135321443,1,1312,1751,0
44136508899,44136508899,0,1234,1600,0
44136559106,44136559105,-1,1164,1412,0
44139602927,44139602930,3,1944,1826,0
44140939159,44140939162,3,2120,1205,0
44143966330,44143966330,0,1204,1473,0
44145501909,44145501911,2,1410,1288,0
44147712402,44147712402,0,992,1377,0
44148896430,44148896429,-1,1443,1336,0
44159465866,44159465866,0,1567,1434,0
44164674894,44164674895,1,1089,1597,0
44169051385,44169051385,0,1860,2322,0
44171117710,44171117710,0,819,1100,0
44172850986,44172850986,0,1347,2608,0
44173836358,44173836359,1,1495,1402,0
44174523060,44174523057,-3,754,1217,0
44175369356,44175369358,2,1279,1419,0
44178312637,44178312638,1,1813,1523,0
44180117109,44180117108,-1,1755,2211,0
44180245441,44180245446,5,2540,1911,0
44182914045,44182914046,1,1225,1428,0
44184399402,44184399402,0,1763,2006,0
44185751880,44185751881,1,1038,1655,0
44189167030,44189167028,-2,1183,1726,0
44190127016,44190127015,-1,1342,1611,0
44191318736,44191318736,0,1311,1685,0
44192518049,44192518050,1,1142,1205,0
44194810203,44194810202,-1,672,869,0
44201247343,44201247344,1,982,1580,0
44201580970,44201580974,4,3355,1799,0
44204093877,44204093877,0,1178,1810,0
44204175089,44204175090,1,1324,1424,0
44206276937,44206276942,5,7620,34326,0
44207362478,44207362456,-22,1385,1762,0
44209039493,44209039499,6,466,8500,0
44210860850,44210860850,0,1133,1669,0
44215548035,44215548037,2,1123,956,0
44217095350,44217095349,-1,1283,1426,0
44217459180,44217459179,-1,2937,4148,0
44218397214,44218397217,3,1453,1207,0
44220252803,44220252805,2,1568,1865,0
44220429864,44220429863,-1,1751,1690,0
44221587978,44221587979,1,1398,2096,0
44224085850,44224085851,1,1376,1411,0
44225230398,44225230397,-1,539,747,0
44228321684,44228321684,0,1277,1784,0
44228839329,44228839327,-2,873,2400,0
44232631592,44232631597,5,2847,1613,0
44238571209,44238571206,-3,1075,1096,0
44242178847,44242178848,1,1147,2185,0
44244602310,44244602314,4,10646,19010,0
44244764778,44244764778,0,1281,1533,0
44245807747,44245807747,0,1390,1600,0
44248505173,44248505174,1,2155,2126,0
44257717822,44257717821,-1,1499,1796,0
44260905246,44260905246,0,1535,1415,0
44261189873,44261189874,1,1811,1353,0
44262513940,44262513941,1,1574,1631,0
44263541347,44263541347,0,1494,1682,0
44264151654,44264151654,0,1571,1807,0
44265266587,44265266591,4,1379,1189,0
44265464214,44265464214,0,1473,2658,0
44266493580,44266493582,2,1612,2207,0
44267173166,44267173163,-3,938,1567,0
44269661597,44269661599,2,56,669,0
44273195860,44273195860,0,1366,864,0
44275749715,44275749718,3,1608,1714,0
44276866438,44276866442,4,1283,1192,0
44277741259,44277741259,0,3209,3844,0
44284334754,44284334754,0,850,1570,0
44285539739,44285539745,6,2563,1334,0
44285793935,44285793934,-1,913,1418,0
44285952321,44285952323,2,1748,1904,0
44286583678,44286583680,2,1009,1497,0
44287312351,44287312351,0,1045,1746,0
44292796249,44292796249,0,1594,1611,0
44296229275,44296229276,1,1073,1456,0
44296850755,44296850761,6,1994,1547,0
44301677178,44301677178,0,1207,1677,0
44305887922,44305887922,0,2343,2132,0
44307907182,44307907185,3,1653,1787,0
44308786714,44308786714,0,1410,2003,0
44309350694,44309350701,7,9125,2113,0
44316877396,44316877398,2,1202,1690,0
44317976402,44317976396,-6,1231,5320,0
44318167528,44318167531,3,1751,1261,0
44319140602,44319140603,1,1434,1607,0
44319501394,44319501395,1,1457,1747,0
44320859731,44320859733,2,1500,2502,0
44322242243,44322242226,-17,954,1676,0
44323276421,44323276421,0,916,1625,0
44327401313,44327401313,0,1404,2021,0
44328455100,44328455101,1,1318,1680,0
44329763986,44329763986,0,1471,2158,0
44340032065,44340032066,1,828,1919,0
44341821748,44341821748,0,1587,2383,0
44343252817,44343252817,0,1417,1984,0
44343885149,44343885156,7,3192,1054,0
44345969559,44345969560,1,1649,1740,0
44347003806,44347003805,-1,1199,1212,0
44348259326,44348259329,3,1415,1850,0
44348945890,44348945894,4,1069,1302,0
44350826585,44350826583,-2,1705,2039,0
44351714430,44351714431,1,1174,1613,0
44354639867,44354639866,-1,846,1158,0
44355394018,44355394019,1,1725,1559,0
44360301479,44360301478,-1,1008,1839,0
44360670129,44360670130,1,1775,1803,0
44362572566,44362572567,1,1299,1598,0
44362866471,44362866471,0,1598,1562,0
44370068976,44370068976,0,1289,2233,0
44370672231,44370672231,0,856,1014,0
44371214081,44371214083,2,1332,1127,0
44371749994,44371749994,0,1189,2452,0
44372270403,44372270404,1,1487,1963,0
44372380561,44372380541,-20,753,1176,0
44373553741,44373553740,-1,1926,2332,0
44373751853,44373751852,-1,1643,1655,0
44377811181,44377811180,-1,1442,2191,0
44387403177,44387403177,0,1338,1324,0
44388848050,44388848050,0,1393,1196,0
44393846182,44393846183,1,1340,1728,0
44397743353,44397743355,2,1577,1573,0
44397852429,44397852430,1,842,1239,0
44398798466,44398798468,2,1295,2010,0
44400651769,44400651770,1,1405,1757,0
44401096556,44401096557,1,1714,1814,0
44402385318,44402385314,-4,2119,4412,0
44408418228,44408418221,-7,1498,7006,0
44410633590,44410633589,-1,947,977,0
44411809663,44411809649,-14,1037,2192,0
44413515611,44413515612,1,1051,1980,0
44414191906,44414191926,20,1408,2010,0
44420159678,44420159677,-1,1251,1415,0
44420756306,44420756304,-2,1217,1604,0
44422030148,44422030140,-8,1117,1835,0
44422880062,44422880081,19,786,1442,0
44423332091,44423332090,-1,2499,3264,0
44427959833,44427959834,1,1217,1936,0
44431924838,44431924838,0,1645,2331,0
44436018978,44436018977,-1,1202,1697,0
44436943572,44436943570,-2,1006,2078,0
44439652526,44439652525,-1,1309,1536,0
44440838305,44440838302,-3,1277,2299,0
44443353881,44443353883,2,1553,1482,0
44444885078,44444885078,0,1632,1736,0
44445209630,44445209634,4,1509,766,0
44450043829,44450043831,2,1266,1624,0
44453725199,44453725198,-1,1119,2555,0
44454552653,44454552649,-4,918,1732,0
44459607636,44459607641,5,2856,1906,0
44461612999,44461612999,0,1611,1984,0
44462923013,44462923013,0,1609,1937,0
44466793470,44466793475,5,1135,1559,0
44468431607,44468431608,1,1688,1725,0
44469803605,44469803603,-2,1395,2151,0
44470987799,44470987800,1,1641,1904,0
44471142189,44471142169,-20,1033,1144,0
44472360469,44472360470,1,1529,2242,0
44473220543,44473220544,1,1469,1166,0
44473456191,44473456197,6,1560,1273,0
44476281250,44476281252,2,1252,1872,0
44477212014,44477212014,0,1206,1488,0
44480984810,44480984811,1,1324,1568,0
44482623267,44482623272,5,2034,1357,0
44482776303,44482776303,0,1022,2061,0
44483337087,44483337088,1,1251,1864,0
44488597686,44488597687,1,1462,1999,0
44490760531,44490760530,-1,1420,1619,0
44491651364,44491651364,0,1273,1578,0
44493868766,44493868765,-1,2553,3954,0
44497678742,44497678740,-2,1640,2235,0
44500727050,44500727051,1,1483,2817,0
44500817932,44500817953,21,1835,2337,0
44501239784,44501239783,-1,1223,1274,0
44504002823,44504002822,-1,743,1452,0
44507766805,44507766804,-1,1967,1890,0
44508635702,44508635700,-2,1240,1432,0
44510180880,44510180880,0,997,1557,0
44511507769,44511507769,0,1053,1669,0
44514919275,44514919276,1,1252,1770,0
44515705178,44515705177,-1,1336,2616,0
44515762698,44515762697,-1,2080,2562,0
44522650414,44522650414,0,1398,1673,0
44523533882,44523533882,0,1422,974,0
44523991966,44523991973,7,40,602,0
44528017380,44528017381,1,1410,1745,0
44530536638,44530536636,-2,981,1929,0
44530860241,44530860242,1,967,1468,0
44533096628,44533096628,0,1469,2162,0
44534768307,44534768309,2,845,1548,0
44535920357,44535920358,1,1147,1299,0
44536988904,44536988901,-3,1468,2117,0
44538801754,44538801753,-1,1438,1465,0
44541336724,44541336724,0,1316,1426,0
44542200074,44542200076,2,1317,2184,0
44545573906,44545573911,5,1644,1118,0
44547321531,44547321532,1,1851,2283,0
44549338887,44549338887,0,1245,2810,0
44552028817,44552028815,-2,907,2008,0
44554077120,44554077121,1,1396,1280,0
44555702071,44555702070,-1,1377,2024,0
44555937072,44555937073,1,1434,1977,0
44557675582,44557675582,0,1259,2024,0
44558105679,44558105679,0,877,1399,0
44560160119,44560160118,-1,1238,1580,0
44567112002,44567112003,1,1738,1731,0
44569658771,44569658772,1,1315,1855,0
44573253104,44573253102,-2,1212,2144,0
44573437926,44573437921,-5,1028,1468,0
44573676883,44573676882,-1,1044,1212,0
44577109274,44577109274,0,1930,2226,0
44578149175,44578149178,3,942,1335,0
44584279562,44584279560,-2,1089,2103,0
44586282977,44586282978,1,1438,1738,0
44587307418,44587307419,1,1136,1455,0
44590311011,44590311015,4,1727,1542,0
44591839001,44591839002,1,1245,1291,0
44597568493,44597568490,-3,1323,2707,0
44601085171,44601085173,2,1966,1839,0
44604582013,44604582013,0,1758,2762,0
44608812778,44608812778,0,1124,1586,0
44608843671,44608843651,-20,40272,28310,0
44608991759,44608991759,0,1423,1590,0
44613572575,44613572575,0,2990,3399,0
44616317517,44616317516,-1,1457,2176,0
44618468519,44618468519,0,661,1063,0
44621322990,44621322990,0,1263,1797,0
44623602271,44623602269,-2,1365,2381,0
44624039789,44624039790,1,987,1482,0
44625289962,44625289967,5,1183,638,0
44625590949,44625590951,2,1330,1377,0
44626744558,44626744555,-3,1021,1267,0
44627425413,44627425406,-7,1318,1521,0
44627997211,44627997211,0,805,1450,0
44630130286,44630130303,17,16414,54037,0
44630270374,44630270377,3,1917,925,0
44632495829,44632495830,1,2282,1463,0
44634925454,44634925455,1,1096,1193,0
44635755652,44635755653,1,1181,2073,0
44637319533,44637319514,-19,1342,1115,0
44637840020,44637840022,2,1202,1308,0
44641329510,44641329518,8,1463,749,0
44642092921,44642092921,0,1505,1739,0
44643111448,44643111449,1,842,1268,0
44644052501,44644052503,2,1458,2178,0
44647123555,44647123535,-20,1167,1040,0
44647621952,44647621954,2,873,989,0
44648542618,44648542621,3,1148,1386,0
44649577660,44649577661,1,1386,1125,0
44650329430,44650329433,3,1755,1988,0
44660559097,44660559098,1,1423,1778,0
44662673470,44662673473,3,2318,1660,0
44663524566,44663524566,0,1181,1685,0
44663789178,44663789179,1,1237,1470,0
44665632283,44665632286,3,1470,904,0
44669623369,44669623373,4,1560,939,0
44671877707,44671877707,0,1709,1594,0
44674022836,44674022836,0,1614,1417,0
44675206508,44675206510,2,1551,1379,0
44679332835,44679332834,-1,1007,1754,0
44682571240,44682571246,6,3912,1561,0
44683025051,44683025040,-11,1582,1116,0
44683190912,44683190929,17,787,1410,0
44683741850,44683741851,1,958,1780,0
44684019035,44684019038,3,1446,1124,0
44685137948,44685137948,0,1961,2362,0
44688164445,44688164443,-2,1567,1558,0
44692756157,44692756158,1,1666,1340,0
44693956233,44693956233,0,1257,1484,0
44697686693,44697686693,0,1217,1695,0
44702212090,44702212090,0,878,2023,0
44702619871,44702619889,18,1237,1751,0
44702737427,44702737428,1,1028,1450,0
44704182050,44704182052,2,1825,2541,0
44704804878,44704804871,-7,1311,6578,0
44706931722,44706931720,-2,1047,2578,0
44707820524,44707820525,1,1578,2013,0
44711335673,44711335674,1,1295,1151,0
44711471689,44711471685,-4,977,1547,0
44719011370,44719011373,3,1353,1807,0
44721434194,44721434194,0,898,1483,0
44726284794,44726284786,-8,1209,419,0
44726541819,44726541820,1,958,1810,0
44727055003,44727055003,0,979,1273,0
44728901957,44728901959,2,1516,2039,0
44729146555,44729146553,-2,1379,1468,0
44729954739,44729954739,0,1348,1739,0
44731089118,44731089118,0,1332,2127,0
44733899142,44733899144,2,1352,1832,0
44736538215,44736538218,3,1284,1115,0
44737862126,44737862125,-1,1849,1679,0
44738484846,44738484847,1,860,1433,0
44739424577,44739424578,1,1399,2059,0
44740064955,44740064956,1,1100,1610,0
44741005771,44741005770,-1,1532,2105,0
44744955026,44744955023,-3,1238,1749,0
44745050151,44745050152,1,1296,1422,0
44749440845,44749440847,2,1148,914,0
44753422475,44753422474,-1,1737,1546,0
44754175917,44754175919,2,1577,1899,0
44756267791,44756267793,2,1238,1539,0
44758286043,44758286043,0,1121,1374,0
44762143725,44762143726,1,1953,2108,0
44762841727,44762841729,2,1202,1654,0
44763152947,44763152936,-11,1047,404,0
44764137447,44764137441,-6,2920,13049,0
44764166268,44764166268,0,1581,1420,0
44764643954,44764643954,0,2228,2226,0
44764689150,44764689148,-2,1466,1786,0
44768469542,44768469543,1,1375,1375,0
44770027030,44770027032,2,1379,1215,0
44773732527,44773732528,1,1304,1575,0
44775995206,44775995208,2,1427,1705,0
44778400388,44778400388,0,1676,1700,0
44785862410,44785862410,0,1311,1486,0
44790936658,44790936658,0,1246,1310,0
44791500784,44791500787,3,1213,1366,0
44794535511,44794535510,-1,1624,2143,0
44795152895,44795152894,-1,1189,1329,0
44795972045,44795972046,1,1664,1690,0
44796303813,44796303814,1,1288,1756,0
44798383246,44798383246,0,1056,1428,0
44799287492,44799287478,-14,1445,1838,0
44801139740,44801139742,2,1423,1178,0
44802841652,44802841652,0,1867,1805,0
44804217112,44804217110,-2,1077,1924,0
44806375360,44806375362,2,1220,1453,0
44806977542,44806977562,20,889,1274,0
44808520301,44808520302,1,1431,1567,0
44809444967,44809444967,0,1192,1753,0
44813438859,44813438865,6,3775,2030,0
44815111088,44815111089,1,1137,1555,0
44816573115,44816573095,-20,4882,1444,0
44818253546,44818253545,-1,884,1496,0
44818983950,44818983949,-1,1343,1802,0
44821492034,44821492033,-1,1202,1209,0
44822267778,44822267778,0,1692,1546,0
44825727458,44825727458,0,1704,1830,0
44826181306,44826181305,-1,1546,1880,0
44826282590,44826282592,2,2101,2161,0
44827109646,44827109647,1,1310,1940,0
44828334017,44828334022,5,2482,1392,0
44828368363,44828368359,-4,942,2295,0
44828804301,44828804301,0,2478,1814,0
44828871522,44828871523,1,984,1080,0
44829361374,44829361373,-1,1660,1478,0
44830196744,44830196741,-3,1389,1034,0
44836362313,44836362314,1,1112,1105,0
44837532080,44837532079,-1,1834,2095,0
44837720714,44837720710,-4,1028,1235,0
44842201599,44842201598,-1,862,1696,0
44842442835,44842442842,7,1784,1086,0
44847783090,44847783091,1,958,1226,0
44848563542,44848563541,-1,1752,1720,0
44849627230,44849627231,1,1926,1978,0
44849764500,44849764503,3,1390,1097,0
44854263574,44854263573,-1,986,1835,0
44857229800,44857229802,2,1921,2239,0
44858290411,44858290409,-2,1085,1187,0
44858539322,44858539323,1,1159,1723,0
44858867767,44858867767,0,818,1019,0
44860250453,44860250454,1,1759,2334,0
44860920087,44860920088,1,1474,1902,0
44862599003,44862599003,0,1434,2305,0
44863068104,44863068106,2,1791,2042,0
44865391930,44865391931,1,828,1472,0
44866004116,44866004114,-2,1317,1664,0
44866689489,44866689490,1,1214,2109,0
44868139426,44868139426,0,1802,1613,0
44869748313,44869748294,-19,27168,40311,0
44870631558,44870631558,0,1173,1506,0
44871477345,44871477343,-2,1289,2240,0
44873599678,44873599677,-1,1420,2144,0
44873938640,44873938640,0,1484,1679,0
44876054326,44876054326,0,1672,2258,0
44876331022,44876331022,0,1024,1360,0
44878099226,44878099226,0,1176,1928,0
44883389552,44883389554,2,1780,1571,0
44884309286,44884309290,4,1462,1122,0
44886037820,44886037822,2,1563,1505,0
44891176100,44891176100,0,940,1956,0
44894039826,44894039826,0,1739,1356,0
44896199337,44896199338,1,1969,1812,0
44897589519,44897589518,-1,928,1641,0
44897852438,44897852422,-16,826,1537,0
44898116442,44898116441,-1,1242,2039,0
44908237130,44908237129,-1,1454,1806,0
44909618695,44909618673,-22,1271,1259,0
44913757565,44913757558,-7,2129,5118,0
44916026162,44916026163,1,1049,1610,0
44918332314,44918332322,8,4678,1715,0
44919936054,44919936056,2,1370,1344,0
44920731997,44920731998,1,1606,1924,0
44922688438,44922688441,3,1337,1455,0
44922902785,44922902784,-1,1732,1828,0
44925547900,44925547902,2,1793,2505,0
44925613323,44925613324,1,1653,1882,0
44930015303,44930015297,-6,1003,3272,0
44934876005,44934876005,0,1035,1875,0
44935518512,44935518514,2,1788,1652,0
44935630326,44935630325,-1,1244,2084,0
44936245722,44936245722,0,1523,2208,0
44939473703,44939473704,1,1607,1244,0
44940506618,44940506616,-2,1958,5034,0
44941552142,44941552145,3,867,718,0
44941599635,44941599635,0,1323,1723,0
44941985234,44941985234,0,1973,1972,0
44942762108,44942762105,-3,1774,2050,0
44944603705,44944603704,-1,1262,1914,0
44949629579,44949629577,-2,1230,1783,0
44950568396,44950568396,0,1771,1737,0
44951878236,44951878237,1,35900,36354,0
44952385253,44952385253,0,3190,3755,0
44952915911,44952915910,-1,1343,1871,0
44954020654,44954020648,-6,21065,16383,0
44961165926,44961165926,0,1516,1600,0
44962027539,44962027539,0,1527,1612,0
44965739660,44965739663,3,2289,1659,0
44966836159,44966836157,-2,1198,2001,0
44970001992,44970001994,2,1106,1403,0
44970944380,44970944377,-3,1051,2508,0
44972325733,44972325734,1,1482,2260,0
44986832351,44986832353,2,1333,1441,0
44991519196,44991519196,0,1188,1206,0
44995207146,44995207147,1,1518,1222,0
44998103089,44998103088,-1,1400,1401,0
45001070842,45001070849,7,2805,1354,0
45003659041,45003659041,0,1315,1358,0
45006270115,45006270109,-6,984,5303,0
45006608798,45006608798,0,1605,2121,0
45009581230,45009581230,0,1501,1263,0
45011786122,45011786122,0,1296,1385,0
45013332150,45013332151,1,1588,1573,0
45013593482,45013593485,3,1567,2280,0
45018023211,45018023210,-1,1053,1277,0
45020761702,45020761702,0,1850,2304,0
45026967840,45026967838,-2,1494,1659,0
45027221251,45027221251,0,834,1287,0
45027755066,45027755065,-1,1305,2025,0
45029731901,45029731902,1,1424,1466,0
45029921294,45029921297,3,1233,1221,0
45030927166,45030927159,-7,812,3316,0
45031944169,45031944169,0,1198,1210,0
45034534863,45034534863,0,1396,2003,0
45037412281,45037412274,-7,2147,7788,0
45040856331,45040856332,1,1564,2270,0
45041999269,45041999270,1,2104,1923,0
45042485895,45042485890,-5,1027,1376,0
45047463488,45047463491,3,1510,1808,0
45054343586,45054343586,0,1364,1478,0
45054971827,45054971845,18,890,1152,0
45056046765,45056046766,1,1414,1933,0
45056849640,45056849650,10,223,942,0
45057634650,45057634655,5,1910,1214,0
45058983550,45058983550,0,2508,2911,0
45059379657,45059379658,1,1626,1773,0
45060937115,45060937117,2,1188,1119,0
45061691674,45061691684,10,12471,45103,0
45062539574,45062539577,3,1312,1058,0
45066085221,45066085219,-2,2253,2734,0
45066743745,45066743746,1,1688,1969,0
45067045783,45067045780,-3,762,832,0
45070619752,45070619770,18,647,1158,0
45072382216,45072382217,1,1318,1205,0
45073395519,45073395520,1,1270,1106,0
45073588827,45073588825,-2,1549,1706,0
45074278750,45074278758,8,3128,1197,0
45076585545,45076585544,-1,1484,1919,0
45076811685,45076811687,2,1391,1554,0
45082100199,45082100200,1,1274,1150,0
45088105484,45088105483,-1,1376,1334,0
45088665572,45088665571,-1,1363,1480,0
45089120022,45089120022,0,1490,1651,0
45089334829,45089334826,-3,1212,1992,0
45089409926,45089409910,-16,1057,1333,0
45090140919,45090140925,6,1343,1266,0
45091953307,45091953306,-1,1533,1448,0
45093635105,45093635106,1,1398,1189,0
45095878809,45095878810,1,1404,1806,0
45097667016,45097667018,2,947,1519,0
45097864420,45097864418,-2,1432,2422,0
45100973430,45100973427,-3,1584,2981,0
45102685273,45102685276,3,2744,1940,0
45103083866,45103083867,1,1508,1622,0
45104264229,45104264230,1,1202,1643,0
45105134413,45105134413,0,1039,1215,0
45105816580,45105816580,0,1685,1797,0
45114055954,45114055954,0,2263,2537,0
45119314637,45119314638,1,883,1008,0
45120338035,45120338033,-2,1061,2201,0
45127458891,45127458890,-1,1425,1404,0
45129455809,45129455809,0,912,1539,0
45131258420,45131258422,2,856,1307,0
45131714478,45131714483,5,3721,1378,0
45131744245,45131744244,-1,1027,1492,0
45134231910,45134231907,-3,909,1574,0
45137995486,45137995487,1,750,1720,0
45140754386,45140754384,-2,1015,2952,0
45141313475,45141313473,-2,1215,2490,0
45141504610,45141504610,0,1285,1394,0
45143749756,45143749754,-2,1486,1650,0
45144002061,45144002062,1,1222,2117,0
45144248317,45144248317,0,1436,1626,0
45145659201,45145659200,-1,1697,1991,0
45146426675,45146426679,4,3327,2041,0
45147225414,45147225416,2,1393,2322,0
45147597266,45147597266,0,1377,1757,0
45148236458,45148236460,2,1800,1378,0
45148560919,45148560917,-2,1237,1259,0
45152560075,45152560073,-2,1593,1914,0
45155059719,45155059704,-15,765,232,0
45155602977,45155602978,1,1835,1413,0
45155703301,45155703301,0,1612,1190,0
45164867506,45164867506,0,1465,1314,0
45165181718,45165181718,0,1502,1823,0
45165361394,45165361395,1,1395,1577,0
45169409518,45169409518,0,1198,1745,0
45171635168,45171635168,0,1471,1905,0
45172477808,45172477806,-2,874,2082,0
45173351471,45173351469,-2,811,1864,0
45174189794,45174189794,0,1533,1509,0
45175193274,45175193277,3,2056,1194,0
45180486534,45180486534,0,1853,2771,0
45181270404,45181270404,0,1044,1351,0
45182873122,45182873124,2,1638,2193,0
45184222093,45184222093,0,1440,1921,0
45185807098,45185807099,1,1106,1645,0
45186135819,45186135818,-1,715,1052,0
45189389831,45189389832,1,1358,1788,0
45193511236,45193511237,1,1944,2188,0
45194937888,45194937889,1,1568,1675,0
45195549802,45195549803,1,1623,966,0
45196668323,45196668326,3,2000,2405,0
45198717481,45198717482,1,788,1575,0
45198905518,45198905522,4,2951,1895,0
45199775341,45199775342,1,1125,1839,0
45202690717,45202690717,0,2235,1514,0
45203201100,45203201098,-2,1820,2479,0
45203948339,45203948339,0,1280,1408,0
45207920098,45207920098,0,1640,1991,0
45208896622,45208896623,1,1480,2133,0
45212108884,45212108886,2,1182,1333,0
45212656490,45212656493,3,1540,1777,0
45212858037,45212858037,0,1430,2156,0
45215045001,45215045002,1,1432,1292,0
45215556496,45215556497,1,1146,1100,0
45216112669,45216112668,-1,1508,1857,0
45216418126,45216418127,1,1445,2151,0
45216996268,45216996270,2,2466,2429,0
45217987169,45217987168,-1,1425,1922,0
45218406776,45218406776,0,1461,1925,0
45219650797,45219650814,17,962,1273,0
45228700707,45228700705,-2,1075,1582,0
45231233078,45231233079,1,2249,2258,0
45231649212,45231649213,1,1352,1321,0
45235210924,45235210924,0,1412,1942,0
45235497954,45235497956,2,909,829,0
45237607017,45237607017,0,1036,1571,0
45240574208,45240574207,-1,54052,20595,0
45240840777,45240840780,3,18340,36832,0
45241419830,45241419832,2,1540,1515,0
45242240346,45242240346,0,1176,1401,0
45245298674,45245298674,0,1746,1315,0
45253692942,45253692945,3,1146,1237,0
45256757878,45256757877,-1,1870,2412,0
45257507932,45257507936,4,3038,1928,0
45257551526,45257551528,2,1652,2091,0
45258166003,45258166002,-1,1119,1675,0
45258809521,45258809527,6,6728,3451,0
45264449515,45264449515,0,1199,1636,0
45264991512,45264991512,0,1261,1376,0
45265116754,45265116757,3,1137,1647,0
45266396115,45266396117,2,2142,1407,0
45269258343,45269258342,-1,980,1318,0
45270199687,45270199686,-1,1992,1960,0
45272698129,45272698128,-1,1498,1797,0
45278208079,45278208081,2,1040,1452,0
45278568698,45278568698,0,1050,1558,0
45279893422,45279893422,0,1494,1658,0
45282165395,45282165395,0,895,1551,0
45284418635,45284418636,1,1283,1755,0
45286377047,45286377045,-2,1238,1739,0
45287996449,45287996453,4,1310,1653,0
45288713050,45288713053,3,1551,1369,0
45290453246,45290453249,3,1263,2130,0
45291926958,45291926959,1,992,1360,0
45294708715,45294708713,-2,1601,1521,0
45297470291,45297470296,5,1197,1254,0
45297716769,45297716769,0,1368,1551,0
45299700316,45299700317,1,1922,2029,0
45300163599,45300163599,0,1567,1595,0
45300443130,45300443131,1,1443,1731,0
45308340607,45308340609,2,2019,1631,0
45309876747,45309876746,-1,765,1147,0
45315923647,45315923646,-1,1222,1784,0
45316074105,45316074106,1,1892,1938,0
45317186025,45317186026,1,2591,2673,0
45317475153,45317475155,2,1449,1685,0
45317786769,45317786775,6,3628,1297,0
45320694224,45320694222,-2,1229,1856,0
45325392872,45325392874,2,1793,2032,0
45326489030,45326489032,2,1416,1357,0
45327741169,45327741168,-1,1078,1564,0
45328027282,45328027283,1,1440,1552,0
45328645446,45328645447,1,1926,2303,0
45328849767,45328849769,2,1444,1701,0
45330041019,45330041020,1,1108,1550,0
45330910196,45330910196,0,1401,1589,0
45334899005,45334899005,0,1073,1270,0
45335426796,45335426798,2,2071,2047,0
45336650115,45336650118,3,1035,1702,0
45339478051,45339478051,0,1130,2182,0
45340154188,45340154190,2,1418,1927,0
45345147620,45345147619,-1,1214,2172,0
45345741164,45345741158,-6,1717,2636,0
45355494811,45355494812,1,1270,1579,0
45355655783,45355655782,-1,1816,1746,0
45357864467,45357864469,2,1166,1153,0
45358872395,45358872397,2,1490,1410,0
45359313014,45359313015,1,1243,1946,0
45360777447,45360777446,-1,1028,2044,0
45361133580,45361133577,-3,1024,1644,0
45364874449,45364874449,0,1765,1872,0
45367495050,45367495050,0,1076,1665,0
45370395626,45370395626,0,1306,2041,0
45373950238,45373950240,2,1571,1600,0
45377677940,45377677941,1,1520,1883,0
45384070307,45384070307,0,1480,1941,0
45384456548,45384456552,4,4036,2695,0
45389953665,45389953669,4,1897,1308,0
45390255298,45390255301,3,1873,1186,0
45392264098,45392264094,-4,974,1227,0
45393878194,45393878198,4,1705,1567,0
45394181454,45394181452,-2,1044,1532,0
45396180373,45396180374,1,1468,1778,0
45398787166,45398787166,0,1206,1122,0
45399550097,45399550098,1,1212,1282,0
45399980819,45399980818,-1,1125,1621,0
45404150385,45404150385,0,1616,2223,0
45404421799,45404421798,-1,1603,1730,0
45405932762,45405932762,0,1059,1293,0
45407633945,45407633949,4,1996,2340,0
45407686805,45407686809,4,2398,1364,0
45407941404,45407941406,2,1622,1730,0
45408260574,45408260575,1,1661,1962,0
45412578367,45412578367,0,1220,1517,0
45416362566,45416362567,1,991,1593,0
45420743789,45420743785,-4,1382,2180,0
45423056710,45423056711,1,1818,1962,0
45426627530,45426627529,-1,1529,1768,0
45426981898,45426981897,-1,1372,1220,0
45430496258,45430496239,-19,1311,1361,0
45431153080,45431153079,-1,1282,1811,0
45433786158,45433786159,1,1799,1595,0
45437317799,45437317797,-2,1565,2418,0
45438490342,45438490341,-1,1467,1916,0
45439875119,45439875119,0,1245,1721,0
45440666188,45440666188,0,1381,1787,0
45440972696,45440972693,-3,1921,1618,0
45441035066,45441035067,1,1265,1433,0
45444760965,45444760965,0,960,1007,0
45448030766,45448030767,1,1735,1382,0
45448346593,45448346596,3,3250,2395,0
45448411853,45448411853,0,2490,4320,0
45451981588,45451981589,1,1709,2387,0
45452518812,45452518813,1,1967,1976,0
45452595977,45452595979,2,2189,1949,0
45455800330,45455800333,3,1954,1159,0
45456150141,45456150134,-7,2332,10602,0
45456221635,45456221639,4,1133,1195,0
45458244681,45458244687,6,2802,1332,0
45460782906,45460782909,3,1774,2306,0
45464418327,45464418330,3,1172,1443,0
45468749397,45468749395,-2,8124,14169,0
45469308075,45469308074,-1,1539,1375,0
45471106137,45471106139,2,3063,2531,0
45475692696,45475692698,2,1718,1742,0
45476637531,45476637532,1,2192,2800,0
45479255463,45479255462,-1,1492,2345,0
45481140170,45481140172,2,1327,1621,0
45481291103,45481291102,-1,1543,2423,0
45481410070,45481410070,0,1513,2073,0
45482468271,45482468270,-1,935,1059,0
45482774041,45482774043,2,1413,1672,0
45483464889,45483464904,15,1503,1639,0
45484729414,45484729414,0,1486,1584,0
45485428695,45485428695,0,1036,1526,0
45486366874,45486366875,1,1465,1750,0
45486574054,45486574057,3,2323,1571,0
45489004178,45489004177,-1,1248,1574,0
45489537701,45489537702,1,1199,1764,0
45490667102,45490667101,-1,1194,2797,0
45498627977,45498627979,2,2315,2296,0
45501194246,45501194251,5,1232,1031,0
45501726591,45501726590,-1,1297,1399,0
45507458486,45507458486,0,1898,2141,0
45509149106,45509149105,-1,1013,1112,0
45510376434,45510376435,1,1006,1706,0
45511795666,45511795665,-1,1721,2924,0
45513259471,45513259472,1,558,933,0
45514619826,45514619825,-1,1394,1742,0
45517954210,45517954211,1,1374,1389,0
45518067362,45518067363,1,1925,2190,0
45520182526,45520182525,-1,1469,1878,0
45521162392,45521162393,1,1956,1897,0
45523844316,45523844316,0,1342,1689,0
45525603964,45525603961,-3,1108,1803,0
45527595093,45527595094,1,1602,1798,0
45527871838,45527871835,-3,1140,2275,0
45528109260,45528109260,0,1745,1979,0
45530207114,45530207115,1,2076,2015,0
45536294927,45536294926,-1,1896,1571,0
45538023731,45538023737,6,999,901,0
45541196204,45541196204,0,1444,1717,0
45541768385,45541768386,1,1524,2206,0
45546547697,45546547697,0,890,1353,0
45548345969,45548345970,1,1646,1488,0
45554345773,45554345776,3,917,1620,0
45557133759,45557133758,-1,1183,1794,0
45557561324,45557561326,2,2231,1751,0
45561927449,45561927450,1,1455,2267,0
45564440339,45564440342,3,1654,1625,0
45564531472,45564531473,1,1018,1397,0
45565380482,45565380478,-4,891,1985,0
45568662802,45568662802,0,1270,1192,0
45569819038,45569819038,0,1278,1528,0
45570361285,45570361283,-2,1378,1674,0
45571657438,45571657439,1,1154,1475,0
45579168028,45579168028,0,915,1627,0
45585789540,45585789546,6,4696,1447,0
45587790510,45587790509,-1,1708,3090,0
45588453607,45588453609,2,1128,1543,0
45591351032,45591351034,2,1436,1736,0
45593253887,45593253887,0,1454,1434,0
45594873081,45594873079,-2,1521,1472,0
45597227885,45597227885,0,1340,1608,0
45600346864,45600346846,-18,1219,1517,0
45601923018,45601923019,1,1131,1960,0
45607673320,45607673321,1,1060,1479,0
45608229559,45608229559,0,361,1292,0
45608513769,45608513769,0,1324,1448,0
45611246377,45611246377,0,1459,1468,0
45612274461,45612274462,1,1690,2200,0
45612355489,45612355490,1,1616,1675,0
45615483727,45615483731,4,2034,1598,0
45620396012,45620396012,0,1352,1774,0
45622294737,45622294736,-1,1447,1696,0
45627959195,45627959196,1,1135,1667,0
45630181266,45630181269,3,1629,2019,0
45631621306,45631621309,3,1256,1714,0
45634581899,45634581901,2,2048,2477,0
45636329661,45636329662,1,995,1324,0
45639378866,45639378861,-5,1426,3753,0
45640119143,45640119146,3,2015,1406,0
45645092682,45645092682,0,1517,1592,0
45646429371,45646429374,3,1741,1715,0
45648305075,45648305075,0,992,1476,0
45655494848,45655494849,1,1549,1910,0
45657345422,45657345421,-1,1575,1719,0
45660511819,45660511818,-1,1483,1348,0
45660646476,45660646475,-1,1303,2488,0
45660782190,45660782190,0,1140,1196,0
45666796818,45666796819,1,1503,2388,0
45667271273,45667271273,0,1049,1728,0
45668573513,45668573517,4,1322,1642,0
45672445375,45672445374,-1,1236,1314,0
45675348913,45675348914,1,1283,1552,0
45676006309,45676006307,-2,681,1954,0
45680263635,45680263635,0,1365,1546,0
45680471098,45680471099,1,904,1498,0
45681964847,45681964847,0,1488,1368,0
45683089471,45683089468,-3,1060,1790,0
45683649828,45683649827,-1,1497,1542,0
45683909027,45683909028,1,808,922,0
45685808566,45685808545,-21,1553,1991,0
45686307226,45686307228,2,1715,1699,0
45687099565,45687099563,-2,1461,2303,0
45692326070,45692326071,1,2129,1964,0
45697361477,45697361458,-19,1478,1129,0
45697672027,45697672029,2,1275,1376,0
45700469413,45700469395,-18,1181,1447,0
45702937823,45702937819,-4,2520,5918,0
45707182735,45707182736,1,1374,1985,0
45708413382,45708413383,1,824,1033,0
45710628743,45710628745,2,1124,1432,0
45711607969,45711607970,1,1211,1289,0
45712330669,45712330673,4,1573,1583,0
45712630311,45712630304,-7,960,1549,0
45713651775,45713651773,-2,1514,1576,0
45714765534,45714765536,2,1080,1387,0
45715792837,45715792839,2,1269,1443,0
45716755302,45716755305,3,1237,1571,0
45721108017,45721108019,2,740,1089,0
45721625537,45721625531,-6,1981,5624,0
45721879082,45721879083,1,1094,1794,0
45723644797,45723644797,0,1703,1462,0
45723680408,45723680402,-6,976,5652,0
45724383926,45724383927,1,1256,1539,0
45728260446,45728260446,0,1295,1651,0
45730836027,45730836030,3,1154,1633,0
45732680637,45732680637,0,1197,1152,0
45734127874,45734127873,-1,1780,1998,0
45734962380,45734962378,-2,1254,1264,0
45735400193,45735400195,2,1657,1068,0
45735711142,45735711142,0,1292,1808,0
45740983125,45740983126,1,2626,2199,0
45742261830,45742261831,1,1987,2129,0
45744014043,45744014043,0,1221,1842,0
45744528442,45744528437,-5,1016,4569,0
45745433331,45745433338,7,3142,1206,0
45746180390,45746180391,1,1087,691,0
45746738653,45746738674,21,673,1558,0
45751589554,45751589555,1,1789,1918,0
45756468543,45756468542,-1,2041,2275,0
45758497569,45758497569,0,1556,1608,0
45759107742,45759107741,-1,1042,1715,0
45759713516,45759713516,0,1330,1634,0
45764003115,45764003113,-2,982,1789,0
45768766622,45768766621,-1,1641,1610,0
45771227237,45771227241,4,1981,2059,0
45776105932,45776105931,-1,1666,1863,0
45779696731,45779696733,2,1383,1529,0
45787493274,45787493275,1,775,681,0
45789222319,45789222320,1,1884,1507,0
45789274746,45789274747,1,1794,1481,0
45791518658,45791518657,-1,1324,2146,0
45792844561,45792844562,1,1432,1434,0
45794286701,45794286703,2,985,618,0
45794459237,45794459225,-12,1075,1710,0
45798373303,45798373306,3,1986,2036,0
45799872387,45799872388,1,1127,1756,0
45800005516,45800005508,-8,1463,1677,0
45800534307,45800534306,-1,1907,1974,0
45802469542,45802469541,-1,760,2084,0
45807284307,45807284305,-2,1021,1575,0
45808532871,45808532873,2,2424,1731,0
45814287510,45814287510,0,1744,2056,0
45816021631,45816021633,2,1319,1092,0
45819201158,45819201158,0,1486,2232,0
45821499484,45821499485,1,1574,1923,0
45822054047,45822054046,-1,1626,1939,0
45827583322,45827583326,4,1700,1293,0
45830703629,45830703630,1,1815,1399,0
45830816229,45830816229,0,1275,1970,0
45830908704,45830908706,2,1576,1466,0
45831560135,45831560134,-1,1307,824,0
45831881663,45831881677,14,251,2414,0
45834217946,45834217946,0,1240,1592,0
45838776378,45838776380,2,1486,1640,0
45840922725,45840922725,0,1373,1311,0
45841088924,45841088905,-19,1047,1055,0
45841361396,45841361392,-4,1511,2403,0
45842576451,45842576451,0,1321,1408,0
45843651615,45843651618,3,2180,1981,0
45844567315,45844567314,-1,1173,1471,0
45847976700,45847976695,-5,1926,7940,0
45848740839,45848740841,2,1557,2332,0
45849153354,45849153355,1,1327,867,0
45850760570,45850760571,1,1509,2637,0
45851326422,45851326424,2,3165,12317,0
45851394971,45851394971,0,1478,1234,0
45852202930,45852202935,5,3341,2428,0
45853458734,45853458734,0,1486,1299,0
45854046818,45854046817,-1,1941,2427,0
45855202602,45855202602,0,1430,1899,0
45858670538,45858670538,0,1489,1981,0
45859108963,45859108963,0,1256,1683,0
45859740657,45859740658,1,1021,1873,0
45859768470,45859768471,1,1642,2032,0
45862429867,45862429867,0,1271,2662,0
45865118934,45865118935,1,1478,1892,0
45866134921,45866134921,0,1747,2348,0
45866814772,45866814773,1,2062,1951,0
45867157731,45867157730,-1,1357,1883,0
45868176041,45868176041,0,969,1229,0
45870274198,45870274198,0,1185,1529,0
45871700577,45871700576,-1,2377,2374,0
45873070664,45873070661,-3,1515,3790,0
45874799447,45874799448,1,1872,2347,0
45875568065,45875568064,-1,2318,3467,0
45877542823,45877542821,-2,1512,2165,0
45877709598,45877709595,-3,655,1045,0
45879354159,45879354158,-1,1542,1762,0
45883753721,45883753718,-3,1304,1400,0
45887611395,45887611397,2,965,1316,0
45888430568,45888430566,-2,1000,1940,0
45892490673,45892490670,-3,766,1073,0
45895728643,45895728643,0,1054,1202,0
45899237094,45899237095,1,941,1307,0
45900115866,45900115868,2,1300,1511,0
45902119930,45902119938,8,13319,23993,0
45904131250,45904131250,0,1338,1206,0
45904989882,45904989882,0,918,1502,0
45905586762,45905586765,3,1090,1759,0
45907277478,45907277477,-1,2602,1685,0
45909549786,45909549782,-4,1090,3446,0
45909819506,45909819506,0,894,1319,0
45914000118,45914000119,1,1200,1568,0
45917457149,45917457147,-2,1069,1914,0
45918078201,45918078198,-3,1541,1402,0
45918360026,45918360026,0,1709,1700,0
45919349142,45919349146,4,2344,1411,0
45922585669,45922585670,1,1705,2308,0
45924047986,45924047988,2,1396,1828,0
45925456786,45925456785,-1,1248,2372,0
45929150587,45929150587,0,1184,1925,0
45929799812,45929799811,-1,1339,1999,0
45931653051,45931653053,2,1773,1845,0
45932112026,45932112027,1,1596,1102,0
45933440455,45933440475,20,1870,1764,0
45938898314,45938898316,2,1022,1132,0
45939857919,45939857921,2,1595,1539,0
45940213766,45940213767,1,1039,1272,0
45940610179,45940610182,3,2008,746,0
45943686301,45943686299,-2,1239,1539,0
45943975908,45943975910,2,1833,1391,0
45948434716,45948434716,0,2239,3145,0
45948611650,45948611649,-1,1662,2061,0
45949035419,45949035419,0,1062,1639,0
45949121838,45949121839,1,1306,1685,0
45949388934,45949388915,-19,1325,1463,0
45952697015,45952697015,0,1010,1036,0
45953441277,45953441279,2,1261,1603,0
45954902434,45954902438,4,1746,1349,0
45955840654,45955840655,1,1231,1402,0
45956212786,45956212787,1,980,1619,0
45957254961,45957254961,0,1449,1922,0
45958627731,45958627731,0,1489,1496,0
45960559549,45960559550,1,1915,1882,0
45961040532,45961040534,2,1410,1666,0
45961534479,45961534480,1,705,894,0
45962985344,45962985351,7,3481,1512,0
45963840602,45963840603,1,870,1295,0
45963868642,45963868642,0,1182,1765,0
45966716488,45966716490,2,1922,2269,0
45967183811,45967183811,0,959,1422,0
45967648810,45967648809,-1,759,1192,0
45968866154,45968866153,-1,663,1015,0
45970030642,45970030641,-1,1137,1950,0
45974511450,45974511451,1,1491,2580,0
45974775995,45974776002,7,2589,1201,0
45976338422,45976338422,0,1535,1884,0
45991336569,45991336570,1,1120,1582,0
45995135515,45995135515,0,1141,1105,0
45996210702,45996210698,-4,1317,2725,0
45996970600,45996970602,2,1481,1757,0
45998804276,45998804276,0,1236,1682,0
46002649945,46002649947,2,2006,1652,0
46008491019,46008491019,0,1420,1925,0
46010449063,46010449071,8,3755,1893,0
46011535889,46011535889,0,2049,2087,0
46012926512,46012926514,2,1872,1598,0
46014948761,46014948757,-4,1121,3746,0
46016969946,46016969946,0,1206,2116,0
46026957045,46026957045,0,1224,1636,0
46029440615,46029440618,3,1896,1257,0
46030309443,46030309441,-2,619,948,0
46031941643,46031941642,-1,1705,1561,0
46032882056,46032882057,1,1173,2001,0
46033888557,46033888556,-1,1414,1929,0
46037948114,46037948113,-1,1477,2586,0
46039168569,46039168573,4,1337,1266,0
46046055897,46046055903,6,1176,1844,0
46047985499,46047985499,0,1392,1413,0
46049341839,46049341840,1,1092,1478,0
46051202425,46051202425,0,912,1281,0
46052140751,46052140752,1,1571,1892,0
46053137939,46053137942,3,686,1120,0
46062308851,46062308851,0,2199,2369,0
46062345665,46062345667,2,1760,1500,0
46063102285,46063102285,0,1425,1572,0
46063967922,46063967925,3,1603,1751,0
46066896014,46066896015,1,1563,2145,0
46067434058,46067434058,0,1472,1448,0
46068237477,46068237477,0,1321,1669,0
46069910199,46069910211,12,10746,35441,0
46070747190,46070747190,0,1361,1373,0
46074788160,46074788162,2,1483,1421,0
46074828450,46074828451,1,735,1145,0
46077523805,46077523806,1,1976,1413,0
46078819916,46078819921,5,977,610,0
46079871531,46079871530,-1,1085,1532,0
46080479834,46080479833,-1,1229,1368,0
46085719418,46085719418,0,963,2188,0
46087632465,46087632465,0,1629,2567,0
46088503049,46088503050,1,2198,2249,0
46089256369,46089256371,2,29886,29221,0
46089595538,46089595537,-1,1258,1947,0
46090319293,46090319290,-3,1480,3044,0
46093115988,46093115989,1,1317,1731,0
46093710598,46093710602,4,1714,1701,0
46094839990,46094839990,0,1411,2092,0
46100408698,46100408706,8,1813,958,0
46101396397,46101396419,22,1345,1158,0
46105244191,46105244191,0,1865,1787,0
46105699041,46105699039,-2,1107,1886,0
46109130821,46109130824,3,1476,2221,0
46109372087,46109372094,7,1722,1274,0
46111810413,46111810414,1,1829,2159,0
46112620477,46112620478,1,1505,1653,0
46113229334,46113229333,-1,2153,2900,0
46114031116,46114031117,1,1264,1791,0
46114433558,46114433559,1,1607,2131,0
46117443650,46117443651,1,1684,1538,0
46118741109,46118741107,-2,1134,1933,0
46118977532,46118977521,-11,1269,1809,0
46122609953,46122609955,2,2403,1750,0
46122848649,46122848649,0,1424,1741,0
46125019034,46125019034,0,1321,1834,0
46127291814,46127291817,3,1490,1558,0
46127403326,46127403331,5,5237,2221,0
46127965417,46127965419,2,1544,2794,0
46128314511,46128314511,0,1560,1945,0
46128794886,46128794883,-3,956,2204,0
46130732259,46130732279,20,1130,1293,0
46131980020,46131980006,-14,122,1571,0
46132286040,46132286046,6,2842,806,0
46133039974,46133039976,2,1551,1878,0
46133376037,46133376039,2,1192,1863,0
46134147374,46134147375,1,1439,1205,0
46134657182,46134657182,0,2161,1844,0
46135489508,46135489510,2,1425,1850,0
46136179670,46136179670,0,1677,1620,0
46138399593,46138399591,-2,1363,1550,0
46138487870,46138487870,0,1336,989,0
46140587339,46140587335,-4,1237,2009,0
46141974412,46141974412,0,2025,2406,0
46142576364,46142576365,1,1358,1425,0
46142658883,46142658878,-5,1073,3148,0
46143270885,46143270885,0,1318,2320,0
46150260579,46150260578,-1,1053,1433,0
46152806365,46152806365,0,1078,2104,0
46154653077,46154653078,1,1749,1729,0
46155550361,46155550359,-2,1246,1100,0
46159863038,46159863038,0,1103,1716,0
46162963114,46162963114,0,2072,2456,0
46163027408,46163027409,1,1265,1922,0
46165008890,46165008888,-2,1078,2002,0
46165837297,46165837298,1,1563,1721,0
46171029317,46171029315,-2,1015,1975,0
46174784757,46174784758,1,1974,1821,0
46174842924,46174842923,-1,1701,2013,0
46177291813,46177291835,22,1054,1842,0
46177438223,46177438221,-2,711,1532,0
46177903350,46177903350,0,965,1645,0
46178294479,46178294467,-12,806,1538,0
46178423830,46178423831,1,1332,1652,0
46178978294,46178978295,1,1526,1075,0
46180495466,46180495466,0,1315,1471,0
46181022298,46181022311,13,1478,1697,0
46181287759,46181287766,7,3663,1780,0
46182705749,46182705751,2,1466,1927,0
46184392610,46184392605,-5,793,1631,0
46184615174,46184615174,0,1532,1910,0
46185236509,46185236507,-2,1217,2040,0
46190544826,46190544828,2,944,1681,0
46191381638,46191381619,-19,1146,1457,0
46192098410,46192098410,0,1212,1379,0
46195114547,46195114549,2,1118,1800,0
46201177694,46201177695,1,1084,1177,0
46202949414,46202949415,1,1629,2523,0
46206887491,46206887490,-1,1195,1557,0
46207367630,46207367629,-1,2102,1863,0
46208332342,46208332343,1,1351,1574,0
46208661847,46208661846,-1,1406,1889,0
46209488530,46209488531,1,1278,1330,0
46210529034,46210529034,0,1839,2153,0
46212447294,46212447296,2,1241,1283,0
46213475715,46213475721,6,3816,1500,0
46213953806,46213953803,-3,982,1465,0
46214172309,46214172309,0,1336,1506,0
46217227394,46217227398,4,1137,1407,0
46218961724,46218961731,7,1439,1784,0
46219425602,46219425604,2,2253,1490,0
46219752223,46219752223,0,1086,1134,0
46220062206,46220062207,1,1453,2347,0
46221505806,46221505805,-1,1075,1432,0
46222037332,46222037315,-17,1244,1618,0
46223099442,46223099444,2,803,1526,0
46224225080,46224225081,1,1498,1775,0
46228594678,46228594678,0,1223,1457,0
46233296506,46233296512,6,3128,1297,0
46233971930,46233971930,0,982,1309,0
46239177804,46239177803,-1,1371,1610,0
46241377326,46241377326,0,1481,2055,0
46244043476,46244043474,-2,1293,1268,0
46244188654,46244188655,1,1273,1471,0
46250065805,46250065803,-2,731,1391,0
46250374488,46250374490,2,941,934,0
46252023279,46252023280,1,1275,2136,0
46255756085,46255756082,-3,989,1684,0
46259407446,46259407447,1,1222,1436,0
46260650384,46260650381,-3,1674,2310,0
46260973970,46260973969,-1,945,1579,0
46262954445,46262954445,0,1453,1982,0
46263122945,46263122948,3,2064,1972,0
46264267624,46264267625,1,1140,1615,0
46270438071,46270438070,-1,1518,2454,0
46273869742,46273869742,0,1913,1845,0
46277491543,46277491543,0,1115,1937,0
46280394224,46280394223,-1,1210,2180,0
46282226099,46282226103,4,863,1074,0
46283529150,46283529152,2,1495,1808,0
46285158798,46285158797,-1,1420,1583,0
46289532795,46289532797,2,1535,1720,0
46295992053,46295992055,2,1732,2141,0
46297452129,46297452129,0,38951,22850,0
46299032367,46299032367,0,1344,1377,0
46300491008,46300491008,0,1160,1849,0
46301732959,46301732962,3,952,973,0
46301853572,46301853571,-1,1627,1791,0
46304030949,46304030950,1,1730,2170,0
46304417438,46304417435,-3,1509,2288,0
46305117439,46305117441,2,1404,2189,0
46306969742,46306969742,0,1186,1563,0
46307380721,46307380723,2,1207,1662,0
46312019218,46312019202,-16,1237,1609,0
46312283102,46312283100,-2,1421,2322,0
46316781026,46316781026,0,1059,980,0
46317079035,46317079034,-1,1176,1794,0
46318673714,46318673714,0,1211,1336,0
46319513585,46319513582,-3,1269,2281,0
46320572726,46320572726,0,1750,1996,0
46324558389,46324558390,1,1695,1956,0
46325085694,46325085694,0,1656,1252,0
46325244690,46325244691,1,1408,1174,0
46327007469,46327007466,-3,1027,628,0
46331096812,46331096811,-1,1398,1341,0
46333725387,46333725385,-2,1355,1630,0
46336639048,46336639049,1,1092,2030,0
46336673058,46336673059,1,1472,1352,0
46337388798,46337388798,0,1857,1757,0
46345217885,46345217885,0,1183,1691,0
46347921366,46347921368,2,2108,2217,0
46354921423,46354921420,-3,7505,14862,0
46357168462,46357168473,11,791,1377,0
46358022717,46358022717,0,905,1828,0
46358387689,46358387687,-2,1569,1706,0
46359436147,46359436166,19,695,1176,0
46361192213,46361192214,1,1524,1845,0
46367038750,46367038749,-1,1512,1766,0
46369231834,46369231839,5,1695,1062,0
46370051021,46370051022,1,2192,1648,0
46371532089,46371532089,0,1749,2507,0
46374435346,46374435347,1,1171,1482,0
46377850833,46377850829,-4,946,3966,0
46378842198,46378842193,-5,1279,1700,0
46380083981,46380083981,0,1067,1207,0
46381551742,46381551744,2,1287,1914,0
46382386999,46382387000,1,2769,2403,0
46385518077,46385518096,19,1186,1496,0
46386278726,46386278730,4,1440,1591,0
46387692918,46387692919,1,1224,1423,0
46392267817,46392267818,1,1287,1903,0
46394362075,46394362076,1,1286,1484,0
46394931441,46394931443,2,983,1695,0
46395714926,46395714927,1,1239,1891,0
46395954828,46395954826,-2,1274,1595,0
46399648262,46399648262,0,1165,1394,0
46405930553,46405930554,1,2028,1569,0
46407127242,46407127243,1,1415,1248,0
46407581974,46407581974,0,1559,1905,0
46408104553,46408104559,6,2400,1351,0
46408254190,46408254199,9,1727,9,0
46409231909,46409231908,-1,1431,1904,0
46410561118,46410561118,0,1006,1198,0
46414214030,46414214029,-1,928,1801,0
46416393436,46416393437,1,1521,2465,0
46419479078,46419479078,0,1456,2370,0
46420844814,46420844813,-1,1318,2164,0
46424740533,46424740531,-2,1539,2388,0
46428541078,46428541077,-1,1184,1587,0
46432264434,46432264432,-2,2060,3929,0
46436901605,46436901606,1,2167,1902,0
46438378747,46438378746,-1,603,1540,0
46439398885,46439398885,0,1528,1853,0
46442111820,46442111818,-2,1175,1405,0
46449327967,46449327968,1,1494,1781,0
46452928673,46452928674,1,1491,2194,0
46458261140,46458261138,-2,1765,3113,0
46462252132,46462252129,-3,1020,2294,0
46463950415,46463950415,0,1854,1641,0
46465192054,46465192055,1,2201,2160,0
46465368671,46465368673,2,1441,1552,0
46465630783,46465630782,-1,933,1383,0
46467142949,46467142949,0,884,1177,0
46467297247,46467297246,-1,1316,1627,0
46467454541,46467454541,0,1273,1837,0
46470274701,46470274705,4,1407,1339,0
46473035201,46473035204,3,888,958,0
46473869617,46473869617,0,1551,1746,0
46479317014,46479317017,3,12183,21337,0
46479568750,46479568749,-1,1038,2131,0
46481498219,46481498218,-1,1570,1546,0
46481531609,46481531610,1,1199,1809,0
46485166982,46485166981,-1,796,1625,0
46489716340,46489716338,-2,1476,2192,0
46491660770,46491660772,2,1607,1569,0
46492836443,46492836444,1,961,1796,0
46495632991,46495632993,2,1091,1650,0
46496285769,46496285769,0,1474,1551,0
46503018034,46503018030,-4,996,2882,0
46503779302,46503779302,0,1781,1404,0
46505961847,46505961846,-1,1889,2486,0
46509272319,46509272319,0,1442,1270,0
46510559538,46510559540,2,1151,1362,0
46512992370,46512992367,-3,1582,1980,0
46513427341,46513427341,0,1128,1765,0
46513495770,46513495773,3,1228,1340,0
46514860723,46514860722,-1,1277,916,0
46515691438,46515691441,3,1319,1773,0
46518316041,46518316041,0,2128,1921,0
46519615065,46519615066,1,1561,1737,0
46525494966,46525494966,0,1293,1471,0
46530505934,46530505934,0,1510,1561,0
46532462485,46532462486,1,1652,1761,0
46532691330,46532691334,4,1937,1791,0
46533605159,46533605158,-1,1697,2456,0
46533911823,46533911824,1,1679,1500,0
46537083669,46537083670,1,1538,1891,0
46541239759,46541239761,2,1655,1648,0
46544251871,46544251872,1,1168,1341,0
46546294527,46546294526,-1,1182,1461,0
46547610868,46547610865,-3,1472,1560,0
46549713327,46549713327,0,1154,1409,0
46550627950,46550627953,3,1010,1744,0
46550952802,46550952802,0,1430,1847,0
46552226013,46552226014,1,1418,1745,0
46552994791,46552994792,1,1035,1572,0
46556722190,46556722192,2,1404,1564,0
46560106922,46560106923,1,1473,1629,0
46560725404,46560725403,-1,682,1091,0
46562395357,46562395360,3,2216,1726,0
46564099574,46564099576,2,1749,1697,0
46565059593,46565059594,1,1489,1379,0
46566202838,46566202838,0,1159,2001,0
46566958258,46566958259,1,1661,1718,0
46567233742,46567233743,1,1078,1123,0
46568204706,46568204707,1,1184,1219,0
46572790676,46572790680,4,2441,1796,0
46574289147,46574289149,2,2532,2217,0
46576047540,46576047539,-1,1758,2633,0
46576372097,46576372099,2,1259,1567,0
46577488971,46577488974,3,1434,1183,0
46580846686,46580846686,0,971,1141,0
46581200659,46581200638,-21,1138,1870,0
46583659406,46583659407,1,963,1539,0
46584969541,46584969542,1,1421,1644,0
46585577363,46585577366,3,1614,1850,0
46586862215,46586862217,2,1272,1465,0
46587897342,46587897343,1,1443,1409,0
46590669902,46590669903,1,1653,2415,0
46591476711,46591476709,-2,829,1291,0
46592959731,46592959734,3,1480,1444,0
46594195483,46594195482,-1,862,1408,0
46596526376,46596526376,0,1110,1520,0
46596815442,46596815444,2,1771,2078,0
46597766218,46597766222,4,1246,1113,0
46603624839,46603624835,-4,548,714,0
46607304874,46607304874,0,1087,1604,0
46609210625,46609210623,-2,829,1335,0
46611207543,46611207545,2,1119,1364,0
46611565286,46611565286,0,1861,1632,0
46612414873,46612414875,2,1113,1742,0
46618260337,46618260340,3,1469,1279,0
46619246398,46619246401,3,1249,1146,0
46622705556,46622705551,-5,2049,5391,0
46623205977,46623205977,0,955,1207,0
46624337659,46624337661,2,1788,1687,0
46625625010,46625625011,1,1259,1399,0
46626590993,46626590994,1,1413,1430,0
46628459869,46628459855,-14,1024,1458,0
46629156851,46629156851,0,1180,1521,0
46631099758,46631099757,-1,1489,1662,0
46631397842,46631397843,1,1303,2262,0
46632438608,46632438610,2,1895,2260,0
46638367779,46638367775,-4,861,2807,0
46642819188,46642819188,0,1590,1417,0
46643629977,46643629981,4,1493,1016,0
46644859038,46644859039,1,1245,1637,0
46646154303,46646154302,-1,1251,1264,0
46650007418,46650007418,0,1443,2202,0
46656041878,46656041877,-1,1951,2955,0
46660197814,46660197814,0,1328,1586,0
46660943239,46660943241,2,1509,1789,0
46661294813,46661294810,-3,1200,1516,0
46666541502,46666541500,-2,1321,1595,0
46666806775,46666806761,-14,1164,1701,0
46674709575,46674709574,-1,1201,2003,0
46678576759,46678576759,0,1252,1190,0
46682543955,46682543954,-1,1005,1750,0
46683119738,46683119741,3,1233,1450,0
46688740122,46688740124,2,23384,28013,0
46690445519,46690445520,1,1047,1595,0
46693069206,46693069209,3,2418,1633,0
46693676763,46693676767,4,1500,1544,0
46694698395,46694698396,1,1243,1552,0
46695204571,46695204571,0,1344,1270,0
46696593544,46696593550,6,4923,2424,0
46697008656,46697008657,1,1107,1463,0
46697071438,46697071439,1,1583,2561,0
46697585603,46697585606,3,2010,2152,0
46698412830,46698412833,3,1915,2293,0
46699631633,46699631634,1,1195,1792,0
46705845954,46705845955,1,1876,1623,0
46706816570,46706816570,0,820,1495,0
46709510001,46709510002,1,2192,2236,0
46712570523,46712570522,-1,1314,2100,0
46713353257,46713353256,-1,1520,1206,0
46717624271,46717624273,2,876,1170,0
46720734350,46720734352,2,1503,1303,0
46723329738,46723329739,1,1363,2028,0
46727165669,46727165669,0,1662,2172,0
46727302543,46727302561,18,1662,2099,0
46727769495,46727769502,7,2530,1003,0
46731294451,46731294451,0,1681,1408,0
46734397667,46734397666,-1,935,1443,0
46734560695,46734560684,-11,146,1708,0
46737291911,46737291911,0,671,1151,0
46739267747,46739267748,1,1614,1536,0
46740370493,46740370494,1,1506,1934,0
46740805489,46740805490,1,1884,1831,0
46741086579,46741086583,4,1731,1311,0
46741831576,46741831576,0,1011,1070,0
46744211075,46744211073,-2,1354,1526,0
46748169245,46748169245,0,1429,2629,0
46749066626,46749066627,1,1381,1886,0
46751011363,46751011362,-1,1044,1330,0
46754439771,46754439772,1,1376,1929,0
46755490959,46755490959,0,1208,2094,0
46759442562,46759442562,0,1494,2062,0
46763450670,46763450670,0,1441,1184,0
46763651726,46763651730,4,1926,910,0
46764386905,46764386903,-2,915,1548,0
46764990317,46764990322,5,2388,1219,0
46767216016,46767216017,1,1156,2123,0
46768148967,46768148969,2,1694,1559,0
46770035406,46770035406,0,974,2252,0
46774895922,46774895922,0,1011,1189,0
46778496765,46778496767,2,2714,2908,0
46785501350,46785501347,-3,1199,1042,0
46786627402,46786627403,1,1835,1873,0
46788120763,46788120741,-22,1027,2141,0
46788980466,46788980467,1,1280,1212,0
46789045050,46789045050,0,1316,1493,0
46790123551,46790123550,-1,904,1458,0
46792448337,46792448338,1,1781,2007,0
46793802538,46793802539,1,1537,1137,0
46797101791,46797101791,0,1188,1725,0
46798924079,46798924081,2,1315,1728,0
46799423877,46799423899,22,1336,1085,0
46803795693,46803795685,-8,1562,6723,0
46805332901,46805332902,1,1518,1407,0
46806957064,46806957065,1,1762,1938,0
46808394229,46808394223,-6,1161,3105,0
46809180005,46809180004,-1,1380,1766,0
46813005754,46813005755,1,1709,2262,0
46814097122,46814097123,1,1515,1633,0
46814807322,46814807322,0,1635,1626,0
46819540957,46819540938,-19,961,1569,0
46821159636,46821159637,1,1012,1302,0
46823455663,46823455666,3,1246,1689,0
46825056305,46825056305,0,1470,1740,0
46829637286,46829637286,0,1427,960,0
46829969433,46829969434,1,1396,1542,0
46830527478,46830527481,3,1650,2237,0
46831960313,46831960313,0,1444,1887,0
46833031501,46833031501,0,1443,1713,0
46835649061,46835649062,1,1306,1696,0
46838272559,46838272558,-1,1302,1725,0
46843728005,46843728006,1,645,1077,0
46846299803,46846299802,-1,1546,1206,0
46849396690,46849396690,0,1039,1564,0
46850554462,46850554483,21,1642,1304,0
46853032305,46853032305,0,1802,2118,0
46855977625,46855977622,-3,1126,1203,0
46856237560,46856237559,-1,1779,1756,0
46860105944,46860105946,2,1370,1491,0
46860201473,46860201475,2,1698,1537,0
46862752320,46862752309,-11,149,162,0
46867846519,46867846519,0,1007,1064,0
46869582839,46869582835,-4,1147,2312,0
46870286279,46870286278,-1,1227,1859,0
46872323113,46872323113,0,1478,1911,0
46875234902,46875234904,2,2444,2202,0
46880577118,46880577122,4,1441,1647,0
46884457454,46884457458,4,1983,1512,0
46885888346,46885888347,1,947,756,0
46886942790,46886942792,2,1630,1820,0
46887951030,46887951030,0,1412,2395,0
46890199583,46890199577,-6,1195,2225,0
46891223983,46891223983,0,1379,1125,0
46891277733,46891277735,2,1459,2102,0
46891714295,46891714296,1,1149,1419,0
46892389410,46892389410,0,1495,1794,0
46894205618,46894205617,-1,1899,2416,0
46902483635,46902483636,1,2139,1806,0
46903254641,46903254641,0,1289,1614,0
46904892218,46904892222,4,1586,1753,0
46907617923,46907617917,-6,668,1491,0
46910911562,46910911563,1,1129,940,0
46913960437,46913960438,1,1328,1277,0
46919315191,46919315191,0,2233,1946,0
46919651577,46919651578,1,1304,1363,0
46920165530,46920165530,0,1302,1879,0
46922748859,46922748858,-1,761,1470,0
46923387646,46923387650,4,1462,1338,0
46923640271,46923640271,0,940,883,0
46928956116,46928956123,7,3494,1402,0
46931696901,46931696902,1,1175,1053,0
46934666565,46934666566,1,2136,1680,0
46937791627,46937791634,7,7007,2203,0
46938761321,46938761322,1,892,1348,0
46939532047,46939532047,0,1181,1811,0
46945986111,46945986110,-1,1675,1828,0
46946276531,46946276531,0,1626,1366,0
46949235823,46949235823,0,1116,1003,0
46952453382,46952453385,3,1535,1324,0
46954236364,46954236363,-1,1444,1605,0
46954524870,46954524870,0,920,1456,0
46965607440,46965607440,0,1074,1542,0
46965849438,46965849438,0,1263,2033,0
46967504263,46967504262,-1,1147,1667,0
46969993160,46969993161,1,1920,1571,0
46970533211,46970533212,1,1265,1435,0
46972891605,46972891609,4,1172,1748,0
46974046566,46974046567,1,1198,1602,0
46975566534,46975566533,-1,1203,1483,0
46977314587,46977314586,-1,1937,2498,0
46980508644,46980508645,1,971,1283,0
46981925021,46981925022,1,1364,1746,0
46982392998,46982392995,-3,1843,3052,0
46986887291,46986887294,3,1423,1632,0
46989406302,46989406301,-1,1272,1994,0
46994569603,46994569603,0,1699,1342,0
46994771283,46994771284,1,1360,1263,0
46996937395,46996937398,3,1246,1389,0
46997883695,46997883696,1,1250,1486,0
46998560348,46998560349,1,1510,1632,0
47004511146,47004511145,-1,951,1267,0
47004978707,47004978709,2,1218,1571,0
47005577072,47005577073,1,1555,1830,0
47008216358,47008216358,0,1523,1670,0
47008268453,47008268454,1,1276,1508,0
47009300685,47009300687,2,1866,2302,0
47013761530,47013761531,1,848,1249,0
47017339917,47017339917,0,1785,2030,0
47024732540,47024732542,2,1185,1708,0
47025271065,47025271065,0,1377,2015,0
47025993639,47025993638,-1,1022,865,0
47034428926,47034428928,2,1993,1534,0
47034467915,47034467916,1,1694,1887,0
47036248749,47036248743,-6,1369,2703,0
47042829445,47042829446,1,998,1331,0
47043844389,47043844390,1,1334,1576,0
47046535142,47046535142,0,1590,2377,0
47048412163,47048412166,3,2041,2130,0
47050657999,47050657995,-4,828,2583,0
47051120346,47051120347,1,1218,1628,0
47051727179,47051727179,0,1090,1926,0
47052764085,47052764085,0,1665,2219,0
47053389047,47053389047,0,1046,1412,0
47054411203,47054411203,0,1876,1949,0
47055044579,47055044578,-1,1117,1437,0
47056602163,47056602164,1,1881,1621,0
47057852525,47057852526,1,1669,2350,0
47060793130,47060793129,-1,1108,1969,0
47064170042,47064170040,-2,1129,1318,0
47065184310,47065184310,0,1745,2590,0
47066098914,47066098911,-3,1634,2011,0
47066303754,47066303755,1,1250,1510,0
47066429587,47066429588,1,1115,1573,0
47066958867,47066958867,0,1599,1459,0
47069691099,47069691098,-1,1704,2065,0
47069736992,47069736989,-3,1654,1899,0
47070264692,47070264692,0,1373,1991,0
47070695813,47070695811,-2,1784,3345,0
47072635963,47072635964,1,1439,1785,0
47075014562,47075014563,1,1658,1720,0
47075408633,47075408634,1,1742,1672,0
47077452218,47077452213,-5,2169,6566,0
47078454725,47078454733,8,1740,1437,0
47078955973,47078955993,20,1513,1730,0
47082844974,47082844974,0,1036,1065,0
47086259386,47086259386,0,1512,1644,0
47086675497,47086675490,-7,1654,8539,0
47087079450,47087079453,3,1470,1567,0
47090720996,47090720996,0,1294,1577,0
47090866984,47090866990,6,1437,1674,0
47094903278,47094903283,5,2245,1205,0
47095405276,47095405278,2,1892,2213,0
47095648298,47095648299,1,1238,2186,0
47095811723,47095811724,1,1558,2111,0
47097599462,47097599462,0,1164,1420,0
47098650470,47098650470,0,1099,1651,0
47099800909,47099800909,0,1276,1741,0
47101257604,47101257606,2,1196,2346,0
47102800880,47102800882,2,1949,2278,0
47105626462,47105626467,5,1272,1077,0
47109236877,47109236877,0,1128,1715,0
47114007067,47114007065,-2,1460,2116,0
47114171732,47114171734,2,1179,1784,0
47114257645,47114257647,2,1066,676,0
47115022838,47115022839,1,2612,3351,0
47115080952,47115080951,-1,1609,1867,0
47115114994,47115114999,5,871,1207,0
47119069106,47119069107,1,1337,1610,0
47122517679,47122517682,3,1616,1287,0
47125445243,47125445242,-1,1425,2123,0
47126050643,47126050628,-15,1427,1076,0
47126515090,47126515090,0,1639,1612,0
47127154859,47127154861,2,1973,2164,0
47127886607,47127886606,-1,1145,1328,0
47128230703,47128230702,-1,1162,1864,0
47130003402,47130003401,-1,1863,2035,0
47136344697,47136344698,1,1739,1724,0
47136536425,47136536425,0,1550,2190,0
47137182906,47137182908,2,1438,1530,0
47139314850,47139314858,8,2485,933,0
47140088587,47140088590,3,1398,1233,0
47141648621,47141648621,0,1545,1538,0
47141940304,47141940302,-2,1450,2393,0
47143891193,47143891195,2,1038,1224,0
47147481839,47147481825,-14,841,1935,0
47148589997,47148589997,0,1169,1272,0
47151127750,47151127750,0,1443,1709,0
47153684323,47153684318,-5,752,5189,0
47159524469,47159524467,-2,1112,1606,0
47162791282,47162791281,-1,1461,1412,0
47164642017,47164642018,1,888,1562,0
47172613690,47172613689,-1,1277,2184,0
47174687005,47174686986,-19,281,873,0
47175504349,47175504347,-2,1462,2411,0
47175893291,47175893293,2,1795,1501,0
47177133331,47177133330,-1,1306,1646,0
47177279490,47177279488,-2,1604,2477,0
47179217035,47179217033,-2,879,1033,0
47182797378,47182797378,0,1499,1561,0
47186020353,47186020354,1,1260,1501,0
47189238591,47189238590,-1,1220,2199,0
47189657119,47189657118,-1,918,884,0
47191279881,47191279881,0,903,1303,0
47195691967,47195691970,3,1544,1684,0
47196580360,47196580363,3,1296,1254,0
47202981514,47202981514,0,1673,1718,0
47205479678,47205479678,0,1648,1720,0
47208634890,47208634890,0,1117,1488,0
47213698108,47213698109,1,1532,1208,0
47214763518,47214763521,3,1614,1197,0
47220126875,47220126877,2,1913,2190,0
47220544286,47220544285,-1,621,920,0
47221605306,47221605305,-1,1112,1064,0
47223067060,47223067059,-1,1579,1973,0
47223573838,47223573843,5,1913,787,0
47223948790,47223948793,3,872,865,0
47227877969,47227877969,0,1425,1912,0
47228295889,47228295891,2,1281,1432,0
47230755822,47230755823,1,1327,1987,0
47231155674,47231155675,1,1659,1379,0
47240539214,47240539213,-1,1792,2401,0
47241032813,47241032814,1,1379,1604,0
47241753823,47241753823,0,1069,2072,0
47242635306,47242635315,9,5590,2182,0
47243475090,47243475091,1,926,1974,0
47249039474,47249039473,-1,2010,1812,0
47249379623,47249379617,-6,1287,1691,0
47254212588,47254212589,1,1502,1615,0
47255240110,47255240110,0,1396,2158,0
47256969581,47256969581,0,1460,1569,0
47258530070,47258530071,1,1341,2008,0
47260029929,47260029930,1,999,859,0
47266274418,47266274420,2,1348,1782,0
47269339950,47269339950,0,1430,1334,0
47272374186,47272374185,-1,1041,1487,0
47273015786,47273015785,-1,900,1371,0
47275157334,47275157334,0,1151,1637,0
47275524263,47275524262,-1,1500,1264,0
47276368975,47276368973,-2,1199,1176,0
47277171984,47277171986,2,1541,1732,0
47284388761,47284388762,1,1041,1333,0
47287890205,47287890206,1,1211,1559,0
47288087723,47288087721,-2,815,1297,0
47291525908,47291525906,-2,1411,1924,0
47294532037,47294532037,0,1537,1772,0
47295681897,47295681897,0,1315,1827,0
47299398384,47299398384,0,1718,1844,0
47302631433,47302631433,0,1294,1928,0
47302754483,47302754483,0,980,1705,0
47303536793,47303536794,1,1778,1541,0
47307112854,47307112859,5,1703,1236,0
47308233164,47308233166,2,1535,1874,0
47309024835,47309024838,3,1071,1146,0
47311353100,47311353101,1,1287,1563,0
47312802934,47312802934,0,1330,1402,0
47313918373,47313918370,-3,1315,2515,0
47324394793,47324394794,1,914,1417,0
47324579911,47324579914,3,1452,1303,0
47326006481,47326006481,0,2122,1938,0
47328035866,47328035862,-4,935,3330,0
47328827341,47328827343,2,1135,1450,0
47329932062,47329932065,3,1096,1307,0
47331899751,47331899752,1,1363,1812,0
47336725206,47336725207,1,953,1624,0
47343235906,47343235906,0,1530,1487,0
47343345851,47343345851,0,1578,2148,0
47345849029,47345849029,0,1427,1468,0
47346819696,47346819697,1,1289,1559,0
47347371828,47347371830,2,2400,1762,0
47347738519,47347738525,6,1966,919,0
47348162002,47348162002,0,1286,1752,0
47349365068,47349365069,1,1767,1527,0
47353400086,47353400087,1,1178,1365,0
47359659318,47359659318,0,1512,2230,0
47360291902,47360291903,1,8869,9579,0
47361492159,47361492159,0,1084,1750,0
47361819185,47361819186,1,1769,2108,0
47369009383,47369009368,-15,341,508,0
47369463965,47369463966,1,300,532,0
47370758289,47370758289,0,1579,1959,0
47372644535,47372644536,1,971,1267,0
47374696807,47374696806,-1,709,1239,0
47374998066,47374998068,2,986,1196,0
47379001187,47379001187,0,949,2030,0
47379696626,47379696626,0,1510,1534,0
47382565475,47382565474,-1,1199,1821,0
47386033829,47386033829,0,1403,1960,0
47394584531,47394584529,-2,764,1610,0
47395337677,47395337678,1,1406,1330,0
47396369220,47396369221,1,1260,1613,0
47398147966,47398147967,1,1333,1378,0
47403918607,47403918606,-1,1243,1927,0
47404384734,47404384734,0,1330,1508,0
47406653333,47406653354,21,992,1343,0
47407837575,47407837577,2,932,1685,0
47412155312,47412155314,2,1344,1774,0
47413124241,47413124240,-1,1333,1827,0
47416159425,47416159426,1,1158,2197,0
47417336090,47417336091,1,1026,1652,0
47417445103,47417445104,1,1459,1769,0
47417706202,47417706202,0,1389,1565,0
47420346366,47420346369,3,1967,1887,0
47422101645,47422101645,0,1058,1682,0
47422469438,47422469440,2,1519,1976,0
47423521999,47423521997,-2,1548,1764,0
47423809590,47423809590,0,1257,1728,0
47424015937,47424015937,0,1631,2698,0
47424829397,47424829398,1,1428,2173,0
47427585743,47427585742,-1,1198,935,0
47432187179,47432187180,1,2629,1596,0
47432240804,47432240823,19,1458,1506,0
47435785059,47435785059,0,1259,1365,0
47436563568,47436563569,1,1381,1112,0
47438206268,47438206268,0,1826,2653,0
47442601008,47442601006,-2,1264,2453,0
47448754720,47448754725,5,4300,3118,0
47449209230,47449209230,0,1114,1873,0
47450250370,47450250370,0,1529,1810,0
47451501663,47451501663,0,1218,2004,0
47453510918,47453510921,3,1277,1503,0
47455219447,47455219446,-1,865,691,0
47456810231,47456810232,1,1527,2280,0
47460393126,47460393129,3,2036,1251,0
47466958349,47466958350,1,1641,1015,0
47470138564,47470138561,-3,2113,1699,0
47472029351,47472029352,1,1474,2089,0
47477434929,47477434929,0,1150,1343,0
47482301135,47482301134,-1,1390,1447,0
47486562644,47486562643,-1,1421,1702,0
47488010575,47488010574,-1,1080,1572,0
47491407991,47491407991,0,987,1575,0
47493788034,47493788030,-4,1679,3509,0
47496669495,47496669495,0,1676,1676,0
47497466662,47497466662,0,1124,1671,0
47497949238,47497949240,2,1395,1434,0
47500674218,47500674217,-1,1204,1982,0
47502035090,47502035090,0,1173,1563,0
47503758331,47503758331,0,825,1134,0
47504494137,47504494138,1,938,913,0
47510851290,47510851270,-20,1633,1936,0
47511253177,47511253175,-2,1521,2258,0
47512942403,47512942402,-1,1319,1818,0
47513114620,47513114622,2,1475,1485,0
47516142023,47516142023,0,1525,1517,0
47519902989,47519902989,0,1142,1486,0
47524169246,47524169246,0,976,846,0
47524503353,47524503354,1,1730,1804,0
47524715115,47524715117,2,1115,1610,0
47528375623,47528375623,0,1575,1448,0
47529042951,47529042952,1,1183,1307,0
47531628089,47531628090,1,1189,1619,0
47533068285,47533068289,4,11301,9783,0
47533383234,47533383216,-18,1254,1880,0
47536546631,47536546630,-1,1447,1443,0
47538033440,47538033439,-1,1148,1660,0
47539235875,47539235873,-2,1532,2659,0
47545822285,47545822285,0,1490,1651,0
47546005487,47546005486,-1,850,1632,0
47546156996,47546157010,14,419,772,0
47547474071,47547474073,2,1469,2735,0
47550324488,47550324491,3,3104,1707,0
47551376546,47551376546,0,1136,1420,0
47551532951,47551532971,20,1413,1704,0
47551838689,47551838690,1,1540,1976,0
47551897603,47551897602,-1,1248,1396,0
47552437868,47552437866,-2,1151,1386,0
47553360519,47553360518,-1,849,1183,0
47554695323,47554695325,2,949,1369,0
47560935066,47560935065,-1,1036,1302,0
47564114741,47564114741,0,2003,2342,0
47566343834,47566343823,-11,1317,1307,0
47567880262,47567880261,-1,1703,3290,0
47568329335,47568329335,0,1418,1796,0
47568561343,47568561333,-10,1341,1636,0
47569979636,47569979635,-1,1024,2292,0
47572508622,47572508623,1,1962,1558,0
47574101725,47574101726,1,1348,1996,0
47575045582,47575045582,0,978,1641,0
47575745354,47575745350,-4,1870,2872,0
47576837592,47576837593,1,1241,1540,0
47577420662,47577420664,2,1164,1098,0
47580843384,47580843382,-2,1306,2002,0
47581642525,47581642523,-2,1421,1725,0
47582243789,47582243790,1,1588,1967,0
47582711960,47582711960,0,1285,1943,0
47583017138,47583017139,1,1640,2194,0
47583813778,47583813778,0,1371,2030,0
47584779602,47584779603,1,1341,1899,0
47586131333,47586131337,4,2774,1716,0
47590774997,47590774998,1,1833,1187,0
47592041610,47592041610,0,1106,1669,0
47592625182,47592625186,4,4959,3567,0
47594170059,47594170054,-5,918,2340,0
47595315347,47595315349,2,1598,1245,0
47595814278,47595814274,-4,1401,1830,0
47599428461,47599428460,-1,1742,1698,0
47603461969,47603461970,1,1733,1392,0
47604947965,47604947966,1,1265,1685,0
47605882895,47605882911,16,1027,1429,0
47606808526,47606808527,1,1723,1690,0
47606912270,47606912270,0,1150,1158,0
47607435655,47607435654,-1,800,992,0
47610012256,47610012253,-3,2883,4564,0
47621854115,47621854118,3,1899,1949,0
47623471793,47623471803,10,1428,1260,0
47624996970,47624996970,0,996,1470,0
47626023447,47626023448,1,1432,1483,0
47628134419,47628134419,0,1318,1019,0
47630180453,47630180454,1,1691,1904,0
47639332165,47639332166,1,1330,1393,0
47644858717,47644858717,0,1425,1790,0
47648444072,47648444070,-2,1351,2220,0
47649438699,47649438700,1,1254,1357,0
47651008229,47651008231,2,1742,1646,0
47653347859,47653347858,-1,1571,2086,0
47656678198,47656678200,2,1154,1346,0
47659902114,47659902119,5,1533,1356,0
47660122567,47660122562,-5,2078,5164,0
47666938718,47666938717,-1,1412,1845,0
47670012367,47670012367,0,1231,1593,0
47671371115,47671371114,-1,1066,1235,0
47673667706,47673667704,-2,1313,1503,0
47675543423,47675543423,0,1440,1986,0
47677469739,47677469747,8,1441,1329,0
47677794741,47677794737,-4,1137,1537,0
47680049657,47680049659,2,1131,1380,0
47682357639,47682357639,0,1028,1418,0
47685641457,47685641458,1,1138,1905,0
47685903957,47685903958,1,1109,1312,0
47686847185,47686847186,1,1500,1366,0
47695436400,47695436400,0,1192,1669,0
47695503238,47695503227,-11,1029,1296,0
47696443146,47696443145,-1,1070,2053,0
47697111897,47697111898,1,1367,1490,0
47700287126,47700287128,2,1068,1010,0
47700597310,47700597306,-4,1088,2082,0
47704831844,47704831842,-2,1089,1358,0
47707173880,47707173887,7,1827,730,0
47711002330,47711002331,1,1699,2345,0
47711965470,47711965469,-1,999,1830,0
47712590307,47712590309,2,13270,12819,0
47713539078,47713539079,1,1367,1402,0
47715440169,47715440168,-1,1088,1483,0
47716176830,47716176830,0,1738,1348,0
47717409202,47717409202,0,1090,1674,0
47717900954,47717900953,-1,1293,1708,0
47719224962,47719224966,4,5087,2962,0
47723757375,47723757375,0,944,1133,0
47724517118,47724517119,1,1927,1831,0
47725350219,47725350218,-1,1488,1336,0
47728670268,47728670272,4,2251,1703,0
47732047600,47732047600,0,1240,1105,0
47736133962,47736133962,0,1297,2396,0
47736889841,47736889842,1,1302,1696,0
47739266160,47739266160,0,1156,1348,0
47741942282,47741942282,0,1413,1622,0
47744081721,47744081718,-3,1234,2896,0
47748968279,47748968280,1,1193,1724,0
47749252991,47749252994,3,173,1005,0
47751301050,47751301049,-1,1351,2112,0
47753330646,47753330646,0,1826,2186,0
47756513817,47756513818,1,2060,2495,0
47757971901,47757971902,1,1570,1347,0
47760203502,47760203504,2,1269,1423,0
47761794439,47761794436,-3,1240,2750,0
47766466387,47766466389,2,1307,2162,0
47771975639,47771975641,2,1590,2254,0
47774375158,47774375160,2,1629,1790,0
47777465370,47777465374,4,1211,1488,0
47779194241,47779194242,1,1133,1398,0
47779664998,47779665011,13,345,2888,0
47780254362,47780254362,0,1423,1679,0
47784698446,47784698447,1,1612,2291,0
47785301138,47785301138,0,964,1214,0
47787895381,47787895380,-1,1677,2175,0
47795083034,47795083036,2,1807,1962,0
47796393551,47796393552,1,1428,1864,0
47797983494,47797983497,3,1185,1520,0
47800093311,47800093311,0,1456,1455,0
47801662693,47801662695,2,1406,953,0
47803864283,47803864285,2,1470,1522,0
47806775166,47806775166,0,1072,1874,0
47810981402,47810981403,1,695,1129,0
47815406019,47815406018,-1,1767,2099,0
47818683538,47818683539,1,708,961,0
47819811272,47819811272,0,1273,1727,0
47820305548,47820305550,2,1591,2109,0
47821431424,47821431425,1,1682,2006,0
47822048242,47822048241,-1,1556,1235,0
47822926457,47822926458,1,1313,1873,0
47823736112,47823736095,-17,766,155,0
47827177854,47827177856,2,1941,2175,0
47828923921,47828923920,-1,1536,1987,0
47831607926,47831607925,-1,1282,1406,0
47832079845,47832079846,1,1156,1081,0
47838739903,47838739903,0,1430,1665,0
47840146450,47840146449,-1,1675,1953,0
47840575282,47840575281,-1,1134,1347,0
47844571054,47844571055,1,1124,1254,0
47845009493,47845009491,-2,1366,1989,0
47846135696,47846135698,2,2536,1836,0
47848158722,47848158722,0,1024,1829,0
47849038149,47849038149,0,1888,2281,0
47849084685,47849084684,-1,1737,1383,0
47849446149,47849446155,6,2784,1406,0
47852370379,47852370379,0,826,923,0
47853404879,47853404882,3,1953,2131,0
47853584849,47853584850,1,1086,1396,0
47854194154,47854194158,4,1736,1155,0
47854614709,47854614709,0,1394,1610,0
47857616197,47857616197,0,1375,1621,0
47858127866,47858127869,3,1444,1783,0
47861369920,47861369922,2,1210,1337,0
47864161227,47864161226,-1,1519,1494,0
47865269225,47865269224,-1,1285,1410,0
47865545513,47865545514,1,598,1435,0
47871900133,47871900133,0,1569,1755,0
47872813630,47872813634,4,1409,1326,0
47874632887,47874632883,-4,1048,3186,0
47874812435,47874812438,3,1683,1802,0
47876487571,47876487571,0,935,1430,0
47876651892,47876651897,5,7,2240,0
47877252386,47877252386,0,1003,1094,0
47883663541,47883663534,-7,3068,10622,0
47885380679,47885380683,4,3317,2047,0
47888595565,47888595566,1,1203,1516,0
47890329786,47890329786,0,1320,994,0
47892625458,47892625458,0,1630,2520,0
47893902857,47893902854,-3,1805,1784,0
47894450153,47894450153,0,2036,1966,0
47898602373,47898602374,1,1131,1400,0
47899683698,47899683698,0,1375,1477,0
47900633963,47900633965,2,1544,1797,0
47901836854,47901836855,1,1127,2123,0
47903160409,47903160409,0,1647,2234,0
47905543828,47905543828,0,978,1403,0
47906950080,47906950081,1,1199,1482,0
47910282406,47910282405,-1,1298,2286,0
47913852722,47913852723,1,1897,2141,0
47914576369,47914576370,1,1563,1690,0
47916092489,47916092490,1,1000,1778,0
47917554361,47917554361,0,1311,1896,0
47918530083,47918530082,-1,1644,2022,0
47919239434,47919239433,-1,1632,2174,0
47923430182,47923430181,-1,1615,1733,0
47923902998,47923902998,0,1502,1982,0
47931554634,47931554634,0,1319,2070,0
47933552579,47933552581,2,1788,1269,0
47934615270,47934615278,8,1914,924,0
47936008461,47936008461,0,1261,1552,0
47936498357,47936498357,0,1402,1766,0
47939390398,47939390399,1,882,1205,0
47939834713,47939834713,0,949,1605,0
47944548206,47944548206,0,1167,1619,0
47948809498,47948809497,-1,1508,1413,0
47949720991,47949720991,0,1306,1455,0
47951818965,47951818965,0,1036,1694,0
47955726978,47955726979,1,1276,1424,0
47956610241,47956610243,2,1703,1038,0
47962477949,47962477948,-1,1692,1603,0
47962681683,47962681684,1,1003,1213,0
47963823412,47963823413,1,1118,2016,0
47963850754,47963850755,1,2093,1493,0
47968141141,47968141143,2,1329,1850,0
47969962021,47969962022,1,1532,1512,0
47970436046,47970436046,0,1232,1792,0
47971921180,47971921182,2,1467,1169,0
47973476234,47973476236,2,1440,2278,0
47975952766,47975952744,-22,147,370,0
47977662000,47977662001,1,1328,1996,0
47981235194,47981235190,-4,1340,4610,0
47983837049,47983837050,1,968,1293,0
47984611298,47984611299,1,1048,1293,0
47986180166,47986180166,0,1313,2371,0
47988777769,47988777767,-2,1396,1310,0
47992696889,47992696887,-2,1228,2185,0
47997220525,47997220525,0,1128,1923,0
47997799729,47997799730,1,1548,1731,0
47998437123,47998437123,0,794,1573,0
47998712876,47998712878,2,1452,1407,0
47999300923,47999300901,-22,1205,1433,0
48003762435,48003762434,-1,1795,2509,0
48006581387,48006581386,-1,1519,1652,0
48006631530,48006631526,-4,1057,1652,0
48007158845,48007158846,1,1231,1099,0
48008857017,48008857014,-3,921,1322,0
48009866222,48009866221,-1,1568,2421,0
48014250153,48014250153,0,1139,854,0
48015102740,48015102743,3,1136,1620,0
48018129774,48018129774,0,1146,1214,0
48020156955,48020156955,0,1558,2057,0
48020380018,48020380022,4,2587,2174,0
48023313958,48023313957,-1,1250,1547,0
48024057071,48024057086,15,181,669,0
48025609982,48025609985,3,1657,2135,0
48031752326,48031752327,1,1815,2130,0
48035221241,48035221241,0,1197,1413,0
48040775111,48040775111,0,1175,2066,0
48043048389,48043048389,0,1253,1319,0
48043089644,48043089665,21,1397,2222,0
48043656813,48043656814,1,2047,1734,0
48044671126,48044671127,1,902,1050,0
48045638246,48045638246,0,1822,1674,0
48047246853,48047246854,1,997,1466,0
48048473237,48048473237,0,1945,1559,0
48052719476,48052719475,-1,642,1308,0
48053428197,48053428188,-9,1608,2133,0
48054834659,48054834659,0,1309,2116,0
48056830910,48056830913,3,1450,1004,0
48058696838,48058696841,3,855,1203,0
48059155932,48059155914,-18,140,8913,0
48059455820,48059455819,-1,1449,2295,0
48059899858,48059899864,6,3375,1831,0
48061960114,48061960116,2,3034,2880,0
48064291132,48064291133,1,1462,1686,0
48066227667,48066227665,-2,1353,1304,0
48066569871,48066569874,3,1728,1305,0
48067217999,48067217999,0,970,898,0
48067482079,48067482078,-1,1629,1751,0
48068724450,48068724452,2,1116,1789,0
48068904918,48068904919,1,1236,1877,0
48069073278,48069073274,-4,975,1361,0
48069709293,48069709291,-2,1030,1294,0
48071702827,48071702826,-1,1353,1439,0
48072112510,48072112510,0,915,1152,0
48072389235,48072389240,5,3492,2516,0
48073416003,48073416001,-2,1321,1780,0
48073579418,48073579417,-1,804,1433,0
48074519225,48074519226,1,1327,1384,0
48075615693,48075615692,-1,1496,1414,0
48078453279,48078453278,-1,1150,1973,0
48079005676,48079005675,-1,1780,1972,0
48080618401,48080618399,-2,997,1237,0
48081836031,48081836027,-4,933,2434,0
48084099530,48084099529,-1,2090,1396,0
48084790872,48084790869,-3,1007,1181,0
48085664732,48085664733,1,1027,1499,0
48086790880,48086790877,-3,1149,2541,0
48090256173,48090256173,0,1089,2152,0
48090780339,48090780341,2,1888,1204,0
48091353487,48091353469,-18,1510,2257,0
48092755594,48092755600,6,2522,1136,0
48092855969,48092855969,0,826,979,0
48096166199,48096166201,2,1993,1819,0
48099562339,48099562318,-21,1721,1275,0
48100429525,48100429524,-1,2001,1906,0
48101644050,48101644049,-1,1491,1457,0
48103348549,48103348550,1,1219,1854,0
48105127779,48105127778,-1,926,1733,0
48106334185,48106334186,1,1004,1822,0
48107510218,48107510221,3,6872,29700,0
48110428888,48110428889,1,1719,2256,0
48114257090,48114257088,-2,1100,1531,0
48119535374,48119535375,1,1512,1514,0
48121598647,48121598649,2,1392,1220,0
48122540637,48122540637,0,1000,1444,0
48126004331,48126004333,2,1196,1430,0
48126433649,48126433648,-1,1115,1984,0
48126694655,48126694654,-1,1576,1737,0
48127369615,48127369615,0,1711,1787,0
48128921565,48128921566,1,1647,2357,0
48129256868,48129256891,23,995,1944,0
48129542338,48129542338,0,1135,1962,0
48132640410,48132640410,0,1523,1827,0
48133551036,48133551038,2,1156,1756,0
48135511973,48135511974,1,1270,1292,0
48135537323,48135537324,1,1508,1698,0
48135595426,48135595426,0,1510,1336,0
48139070273,48139070273,0,562,953,0
48144331364,48144331365,1,2544,2173,0
48147733335,48147733339,4,12506,7221,0
48150112671,48150112679,8,3019,1360,0
48152690254,48152690253,-1,1045,1308,0
48153499819,48153499827,8,4394,1371,0
48155980120,48155980122,2,1289,2011,0
48156091410,48156091410,0,1333,1553,0
48156237398,48156237418,20,792,2184,0
48158543852,48158543850,-2,1232,2274,0
48159735161,48159735161,0,1383,1574,0
48162853098,48162853100,2,920,1162,0
48163376523,48163376523,0,729,977,0
48164046474,48164046477,3,1317,2018,0
48164336864,48164336867,3,1646,1205,0
48165399868,48165399871,3,1383,1745,0
48166899073,48166899079,6,3285,1418,0
48171239630,48171239630,0,1089,1734,0
48176732615,48176732621,6,1278,1306,0
48179611429,48179611430,1,1575,1550,0
48183382793,48183382792,-1,1527,2367,0
48188258985,48188258986,1,1708,1500,0
48189097818,48189097819,1,1583,1517,0
48189553142,48189553144,2,2154,1513,0
48192180922,48192180923,1,1121,1569,0
48193631476,48193631475,-1,1303,1844,0
48193901932,48193901954,22,2045,2168,0
48197704803,48197704802,-1,2292,1957,0
48199282259,48199282259,0,1314,1841,0
48200170989,48200170990,1,1269,1781,0
48201069925,48201069928,3,1257,2011,0
48203717250,48203717252,2,1552,1553,0
48204180803,48204180806,3,1818,1767,0
48205421102,48205421102,0,1281,1165,0
48205695822,48205695826,4,1837,1609,0
48206635730,48206635730,0,1593,2072,0
48208015879,48208015881,2,1551,1592,0
48209313545,48209313546,1,1039,1397,0
48213815710,48213815707,-3,990,2481,0
48215544562,48215544561,-1,1053,1362,0
48217342579,48217342578,-1,1031,1542,0
48218077620,48218077622,2,2007,1176,0
48219729586,48219729586,0,1531,1508,0
48219800222,48219800222,0,2135,2572,0
48222833054,48222833055,1,1347,1868,0
48223512539,48223512541,2,1384,1267,0
48225103125,48225103127,2,1693,1949,0
48225741197,48225741199,2,982,1078,0
48225974413,48225974416,3,1569,1789,0
48229753601,48229753601,0,1644,1626,0
48230525174,48230525166,-8,1073,1811,0
48234049448,48234049447,-1,1289,1619,0
48240905674,48240905673,-1,1605,1545,0
48241273194,48241273193,-1,1298,2076,0
48241523306,48241523306,0,1311,1670,0
48243173584,48243173585,1,1179,1324,0
48244869017,48244869014,-3,1240,3408,0
48246592587,48246592588,1,1059,1515,0
48246637743,48246637743,0,1516,1411,0
48247532682,48247532683,1,1032,2077,0
48248373468,48248373474,6,26809,26490,0
48248713776,48248713779,3,1569,1630,0
48249350195,48249350195,0,856,1209,0
48250229931,48250229910,-21,544,536,0
48252567828,48252567827,-1,1612,1688,0
48252819627,48252819629,2,1827,1843,0
48255001330,48255001330,0,1285,1982,0
48257442185,48257442186,1,1742,1625,0
48260251353,48260251353,0,1111,1509,0
48266846589,48266846590,1,1663,2268,0
48266997542,48266997543,1,1279,1173,0
48270874746,48270874747,1,1508,1559,0
48273631154,48273631156,2,1166,1809,0
48277782882,48277782882,0,1506,2106,0
48278469437,48278469437,0,1481,1446,0
48280628355,48280628354,-1,1359,1522,0
48281759916,48281759922,6,2869,1183,0
48284139501,48284139507,6,3621,1525,0
48285822544,48285822545,1,1253,1207,0
48288065647,48288065648,1,1317,2421,0
48288159177,48288159181,4,1989,1759,0
48288206219,48288206219,0,1089,1548,0
48288504662,48288504666,4,1224,645,0
48291933137,48291933133,-4,1227,3271,0
48295176122,48295176121,-1,1869,2563,0
48297155975,48297155977,2,981,1428,0
48302471717,48302471718,1,989,1022,0
48304893257,48304893257,0,1263,1535,0
48307217883,48307217885,2,1663,2073,0
48309439654,48309439657,3,4063,2720,0
48309787503,48309787501,-2,1485,2894,0
48313501997,48313501997,0,1043,1915,0
48315509314,48315509314,0,2014,1873,0
48316221499,48316221499,0,1742,1808,0
48316804103,48316804102,-1,1398,1721,0
48317747499,48317747499,0,996,1306,0
48322493017,48322493018,1,1539,1579,0
48325243375,48325243376,1,1397,2527,0
48326730437,48326730437,0,1865,1917,0
48328905128,48328905127,-1,1321,1327,0
48329573530,48329573532,2,801,1277,0
48333977552,48333977553,1,1436,1448,0
48334492570,48334492570,0,1744,2207,0
48334718929,48334718929,0,1538,1769,0
48337760185,48337760186,1,1347,2547,0
48338309213,48338309210,-3,1335,1505,0
48341160697,48341160697,0,1741,2670,0
48342540061,48342540061,0,1684,1534,0
48347271477,48347271478,1,1293,2044,0
48350974030,48350974031,1,1092,1306,0
48351606539,48351606539,0,1526,1567,0
48360421849,48360421847,-2,1650,1959,0
48372480515,48372480513,-2,1053,995,0
48373421447,48373421447,0,1474,1950,0
48376567933,48376567934,1,958,1671,0
48378196290,48378196292,2,1943,2136,0
48378844854,48378844858,4,1024,1580,0
48379783689,48379783690,1,1906,1938,0
48379982001,48379982002,1,1255,1889,0
48383272184,48383272185,1,1663,1591,0
48383888154,48383888154,0,1018,1633,0
48386724635,48386724634,-1,1597,1969,0
48387007547,48387007549,2,1981,2164,0
48391022993,48391022994,1,717,1097,0
48391965800,48391965798,-2,1870,2256,0
48394022895,48394022899,4,1222,1330,0
48395430082,48395430082,0,1141,1408,0
48397602914,48397602914,0,1623,1678,0
48398013211,48398013212,1,1739,1945,0
48400603870,48400603865,-5,1057,3771,0
48404215670,48404215672,2,1201,1414,0
48404606095,48404606094,-1,1249,1513,0
48405601370,48405601370,0,1224,1814,0
48406579286,48406579286,0,1180,1778,0
48407299547,48407299549,2,1251,2232,0
48407755445,48407755446,1,1678,1820,0
48413202706,48413202707,1,798,1124,0
48414479925,48414479927,2,1365,2091,0
48417588685,48417588683,-2,1454,2409,0
48418367355,48418367359,4,1255,1419,0
48418826539,48418826540,1,1377,2117,0
48419084695,48419084696,1,718,1362,0
48420309597,48420309600,3,1653,1407,0
48422194568,48422194567,-1,1323,1900,0
48425156053,48425156055,2,2025,1401,0
48428154993,48428154995,2,1630,1716,0
48428500698,48428500695,-3,12252,15119,0
48429916062,48429916062,0,1040,1704,0
48432834235,48432834234,-1,1103,1207,0
48435076701,48435076703,2,1188,1978,0
48436880832,48436880834,2,1072,1552,0
48438342108,48438342109,1,1007,1666,0
48439547106,48439547109,3,1662,1422,0
48441817982,48441817984,2,1130,1904,0
48443348871,48443348873,2,918,1266,0
48443838886,48443838886,0,989,1175,0
48444314646,48444314646,0,1194,1287,0
48445063879,48445063879,0,990,1802,0
48448619740,48448619750,10,1428,1254,0
48453794090,48453794090,0,1843,2148,0
48454006337,48454006345,8,3350,905,0
48455653590,48455653590,0,1229,1257,0
48456986773,48456986772,-1,949,2191,0
48461683450,48461683450,0,3150,3807,0
48465103962,48465103963,1,1613,1945,0
48468338869,48468338869,0,1824,1621,0
48469000962,48469000963,1,1520,1916,0
48469116769,48469116769,0,943,1481,0
48471432409,48471432411,2,1514,1763,0
48473173478,48473173478,0,1080,1151,0
48479193158,48479193159,1,1980,1350,0
48479353183,48479353186,3,797,1494,0
48480918181,48480918181,0,1049,1719,0
48482139774,48482139780,6,3060,1701,0
48483619366,48483619368,2,1354,1704,0
48485785443,48485785447,4,1658,2077,0
48489203403,48489203406,3,1413,1280,0
48490345705,48490345706,1,696,1370,0
48495901805,48495901805,0,1560,1766,0
48498251349,48498251350,1,1668,2081,0
48499387637,48499387638,1,1169,1494,0
48500772918,48500772916,-2,2154,2176,0
48504750600,48504750602,2,1484,2000,0
48507094763,48507094783,20,1290,1600,0
48507263389,48507263390,1,1133,2219,0
48508743351,48508743347,-4,941,2821,0
48510354700,48510354701,1,1380,1636,0
48511545057,48511545058,1,1308,1123,0
48514208059,48514208061,2,1482,1641,0
48514859519,48514859513,-6,1533,5626,0
48517834763,48517834762,-1,1512,1836,0
48520932847,48520932847,0,1558,1674,0
48522365395,48522365394,-1,1888,1721,0
48524511617,48524511617,0,1447,1285,0
48525449647,48525449644,-3,1508,1544,0
48525874750,48525874749,-1,1719,1989,0
48526517322,48526517328,6,3807,752,0
48526824423,48526824424,1,1117,1400,0
48529435844,48529435850,6,2503,986,0
48530621061,48530621064,3,1291,1693,0
48532784099,48532784101,2,1300,1744,0
48535787234,48535787235,1,998,1371,0
48538931210,48538931210,0,1384,984,0
48539860850,48539860850,0,1236,2041,0
48540400242,48540400241,-1,1058,1907,0
48545360894,48545360896,2,1068,1728,0
48546690486,48546690485,-1,1401,2085,0
48548358223,48548358223,0,949,1091,0
48551761123,48551761123,0,1497,1581,0
48555145679,48555145663,-16,989,402,0
48556479378,48556479377,-1,1892,2632,0
48558214678,48558214678,0,1662,2088,0
48561487290,48561487291,1,1608,2599,0
48563615902,48563615905,3,1277,1256,0
48564939381,48564939381,0,1764,1801,0
48565400976,48565400959,-17,1058,2443,0
48566232932,48566232933,1,1148,1808,0
48567981583,48567981585,2,1308,1740,0
48574741102,48574741103,1,1054,949,0
48575631139,48575631140,1,929,1754,0
48576278572,48576278555,-17,1007,200,0
48578769132,48578769134,2,1260,1849,0
48580486075,48580486075,0,1344,1362,0
48582943722,48582943720,-2,1034,2088,0
48583406747,48583406746,-1,575,1068,0
48587476490,48587476489,-1,1310,1479,0
48592444676,48592444677,1,1796,1776,0
48592586355,48592586355,0,1338,1330,0
48593545393,48593545395,2,927,1325,0
48600497054,48600497058,4,1347,1785,0
48600854155,48600854154,-1,1543,1133,0
48603405029,48603405030,1,1824,2360,0
48603859991,48603859993,2,1354,1400,0
48607143002,48607143002,0,1164,1954,0
48608146112,48608146114,2,1323,2057,0
48612859670,48612859672,2,1686,1836,0
48621008111,48621008111,0,1146,1037,0
48621870254,48621870255,1,1246,1532,0
48623923041,48623923038,-3,1577,1659,0
48628215807,48628215809,2,1225,1276,0
48629754578,48629754579,1,1302,1785,0
48631094212,48631094214,2,1345,1455,0
48633879059,48633879042,-17,886,1263,0
48634874666,48634874666,0,1128,1395,0
48640552443,48640552442,-1,1429,1689,0
48641616346,48641616351,5,2100,1152,0
48641714301,48641714297,-4,26519,9182,0
48645047226,48645047226,0,1335,1421,0
48648727380,48648727381,1,1534,1404,0
48651225087,48651225090,3,3348,2526,0
48652851996,48652851996,0,1495,1689,0
48654608077,48654608076,-1,1586,2038,0
48657019594,48657019595,1,1075,1267,0
48659372173,48659372171,-2,2139,3821,0
48659731486,48659731487,1,1841,2001,0
48662880254,48662880257,3,1784,2070,0
48666015699,48666015699,0,1097,1646,0
48671332402,48671332401,-1,1250,1875,0
48672331589,48672331589,0,1181,1368,0
48675576211,48675576212,1,1850,1612,0
48677578691,48677578695,4,1563,1556,0
48677950333,48677950334,1,1114,1141,0
48678500097,48678500100,3,1357,1721,0
48679804390,48679804389,-1,1796,2480,0
48681142594,48681142594,0,1369,2135,0
48681524376,48681524377,1,1198,1546,0
48681777085,48681777085,0,1545,2083,0
48683537205,48683537205,0,1231,1428,0
48685482322,48685482324,2,1335,2671,0
48687046613,48687046613,0,1394,1021,0
48689538406,48689538405,-1,1636,1543,0
48690217701,48690217700,-1,1756,1384,0
48691708112,48691708113,1,1643,2253,0
48693879679,48693879679,0,1111,1611,0
48697711486,48697711485,-1,748,1388,0
48698201654,48698201638,-16,679,438,0
48698910522,48698910523,1,1626,1337,0
48698954452,48698954451,-1,878,1757,0
48699698237,48699698233,-4,1594,1780,0
48702114807,48702114807,0,1643,1433,0
48704938641,48704938643,2,2078,2395,0
48706257314,48706257318,4,1301,1577,0
48710411634,48710411631,-3,828,1441,0
48711220633,48711220634,1,1305,2395,0
48715478883,48715478882,-1,1105,2016,0
48723038560,48723038561,1,948,1378,0
48727920218,48727920219,1,1278,1047,0
48734481592,48734481591,-1,1277,2385,0
48736394418,48736394419,1,913,1571,0
48736498356,48736498357,1,1596,1333,0
48736845085,48736845086,1,1810,1664,0
48739044519,48739044521,2,1255,1704,0
48744202235,48744202237,2,1658,1813,0
48744382274,48744382271,-3,848,1513,0
48747080252,48747080264,12,1398,1560,0
48748275629,48748275645,16,1111,1576,0
48749422992,48749422990,-2,1991,2523,0
48749898706,48749898711,5,13754,7522,0
48751036575,48751036576,1,1862,2262,0
48751533913,48751533914,1,1629,1619,0
48751728393,48751728391,-2,1081,1336,0
48753768295,48753768290,-5,1309,5502,0
48753968050,48753968050,0,891,1118,0
48755802195,48755802194,-1,1601,1771,0
48757486804,48757486805,1,1308,1643,0
48762461353,48762461355,2,1528,1523,0
48764930790,48764930791,1,1680,1792,0
48765853974,48765853974,0,1230,1621,0
48766371981,48766371987,6,1474,847,0
48767530010,48767530007,-3,1443,1813,0
48768453520,48768453513,-7,38072,14554,0
48772600393,48772600394,1,1665,1556,0
48773525280,48773525280,0,1610,2174,0
48775275558,48775275557,-1,1120,1549,0
48776643489,48776643490,1,1804,2003,0
48780872402,48780872403,1,1500,1369,0
48780918568,48780918572,4,2604,1240,0
48781986073,48781986074,1,1333,2394,0
48782121262,48782121261,-1,1383,1242,0
48782757919,48782757920,1,1060,1122,0
48787781835,48787781835,0,1173,1356,0
48789917985,48789917982,-3,1263,2023,0
48791325798,48791325799,1,899,1330,0
48794147769,48794147771,2,1879,1420,0
48795156167,48795156169,2,1739,1808,0
48796481982,48796481983,1,1472,1404,0
48801070393,48801070395,2,1630,1984,0
48801099370,48801099375,5,2806,1557,0
48802534162,48802534162,0,1148,1461,0
48806819829,48806819831,2,1651,1855,0
48809982577,48809982577,0,1928,1695,0
48813721415,48813721417,2,1465,1325,0
48813975655,48813975655,0,1211,1580,0
48814953274,48814953274,0,1150,1495,0
48818588606,48818588604,-2,1502,1799,0
48819214598,48819214601,3,1606,1443,0
48825153749,48825153749,0,1155,1856,0
48825699174,48825699174,0,949,1480,0
48827815336,48827815335,-1,1869,2119,0
48828392713,48828392714,1,1337,1668,0
48829367147,48829367148,1,1434,1825,0
48830327450,48830327451,1,2086,2311,0
48831967868,48831967879,11,58662,40456,0
48833213368,48833213369,1,1626,2081,0
48837852640,48837852640,0,1399,1275,0
48839095717,48839095717,0,2491,1746,0
48840883679,48840883678,-1,1923,2273,0
48844008798,48844008801,3,1659,1561,0
48844579503,48844579505,2,1780,1668,0
48845577883,48845577885,2,1672,1700,0
48850064817,48850064815,-2,1379,2676,0
48855823979,48855823979,0,1490,2206,0
48861412836,48861412833,-3,826,1576,0
48863599689,48863599691,2,1214,1769,0
48864980750,48864980749,-1,1766,1921,0
48865388491,48865388488,-3,1340,1465,0
48866158959,48866158958,-1,1708,1790,0
48867631939,48867631941,2,1077,1354,0
48870166177,48870166177,0,1613,1583,0
48871307152,48871307147,-5,57594,22313,0
48871419682,48871419685,3,1536,1487,0
48872673235,48872673234,-1,1758,2040,0
48873829239,48873829238,-1,1350,1889,0
48874092003,48874092004,1,1192,1584,0
48874924475,48874924474,-1,1366,1542,0
48875188204,48875188197,-7,135,1643,0
48875632138,48875632138,0,1403,2634,0
48875863931,48875863932,1,1743,1860,0
48876704366,48876704366,0,1507,1703,0
48880034078,48880034078,0,1028,1724,0
48887719523,48887719526,3,1156,1641,0
48887953904,48887953906,2,929,1525,0
48888379610,48888379609,-1,1500,1358,0
48895911074,48895911075,1,1445,1923,0
48896446977,48896446974,-3,1129,2066,0
48898135676,48898135675,-1,1172,1943,0
48904368299,48904368302,3,973,1851,0
48905847157,48905847158,1,1310,2142,0
48906366967,48906366967,0,813,1358,0
48906907409,48906907410,1,1965,2449,0
48908003575,48908003570,-5,1481,1654,0
48909102839,48909102842,3,3146,3028,0
48909791610,48909791610,0,1086,1426,0
48909985489,48909985490,1,1140,1227,0
48910121333,48910121332,-1,1506,1995,0
48910384469,48910384471,2,2346,1408,0
48910458311,48910458314,3,1600,1349,0
48911835393,48911835393,0,1722,1892,0
48913483891,48913483894,3,1462,1232,0
48914330395,48914330399,4,1062,1512,0
48919397503,48919397505,2,1143,1243,0
48920436847,48920436846,-1,1263,1583,0
48920952239,48920952243,4,1343,1262,0
48922251613,48922251612,-1,1134,1700,0
48923433457,48923433458,1,1950,1634,0
48926348525,48926348525,0,1759,1662,0
48927159698,48927159700,2,1292,1390,0
48928166722,48928166723,1,1559,1371,0
48929333521,48929333519,-2,1252,1456,0
48930910345,48930910346,1,1034,1754,0
48932812073,48932812066,-7,2528,7472,0
48934645287,48934645287,0,1331,1245,0
48936881983,48936881986,3,3271,2852,0
48939308966,48939308967,1,1554,1326,0
48946219841,48946219840,-1,1365,2207,0
48948785829,48948785828,-1,1427,1643,0
48949882190,48949882190,0,1337,2231,0
48958372106,48958372105,-1,1869,1765,0
48958600701,48958600712,11,358,8687,0
48958860127,48958860125,-2,1411,1708,0
48959023939,48959023941,2,1543,1691,0
48965880277,48965880275,-2,1067,2125,0
48969123285,48969123286,1,1143,1383,0
48969588945,48969588945,0,1544,1752,0
48976787697,48976787690,-7,2554,9789,0
48976974342,48976974351,9,2920,1632,0
48985008714,48985008714,0,1643,2260,0
48985922144,48985922144,0,1694,1452,0
48986704377,48986704377,0,1438,1385,0
48991671502,48991671502,0,1452,2064,0
48993068051,48993068055,4,2479,1928,0
48993923429,48993923430,1,1632,2426,0
48994669119,48994669120,1,1088,1169,0
48995175410,48995175412,2,1083,1902,0
48995818811,48995818813,2,2154,1660,0
48996671728,48996671728,0,1138,1734,0
48997349161,48997349162,1,1254,1694,0
48999307585,48999307584,-1,1077,1553,0
49001396455,49001396457,2,1587,1884,0
49001574473,49001574472,-1,1929,2438,0
49001914140,49001914126,-14,903,906,0
49003602313,49003602314,1,1466,1755,0
49007558864,49007558866,2,1578,1729,0
49008796854,49008796867,13,1655,1647,0
49010774447,49010774449,2,965,1208,0
49010816926,49010816925,-1,1016,1292,0
49012293372,49012293370,-2,1274,1402,0
49017047105,49017047105,0,1426,1621,0
49022493355,49022493354,-1,1247,1726,0
49030203286,49030203287,1,1110,1166,0
49033016685,49033016686,1,1578,1799,0
49033214893,49033214895,2,1506,1893,0
49036074570,49036074569,-1,1845,2306,0
49036576394,49036576382,-12,13806,40841,0
49038470522,49038470523,1,1418,1890,0
49038734622,49038734621,-1,1853,2280,0
49040030064,49040030066,2,1871,1064,0
49041658822,49041658822,0,1261,2173,0
49044035553,49044035557,4,1531,1972,0
49044897686,49044897685,-1,1176,1377,0
49047325284,49047325285,1,1530,1743,0
49047655194,49047655194,0,1206,1933,0
49049579277,49049579278,1,1708,1845,0
49050318887,49050318893,6,2202,968,0
49053331467,49053331467,0,2080,2743,0
49056490901,49056490902,1,2050,1766,0
49056751086,49056751086,0,1279,1210,0
49059370330,49059370332,2,2592,2529,0
49059995795,49059995794,-1,1531,1530,0
49060500056,49060500067,11,147,1235,0
49061269281,49061269281,0,1329,2003,0
49062747127,49062747127,0,1606,2089,0
49065327910,49065327909,-1,1152,2124,0
49068582587,49068582593,6,2372,1222,0
49070551799,49070551800,1,1712,1967,0
49071349541,49071349541,0,954,1734,0
49071687760,49071687761,1,859,1546,0
49072682415,49072682418,3,1182,1172,0
49079687805,49079687804,-1,1617,2344,0
49079922220,49079922220,0,1221,1326,0
49081248677,49081248682,5,1145,1669,0
49082095122,49082095122,0,800,858,0
49084040086,49084040086,0,1198,1369,0
49087613831,49087613850,19,1185,1849,0
49087906765,49087906762,-3,1501,1714,0
49089163426,49089163425,-1,1208,1278,0
49090240527,49090240528,1,1910,1812,0
49091041602,49091041602,0,1211,1681,0
49094694702,49094694701,-1,1409,1851,0
49098632255,49098632255,0,1360,2336,0
49101080742,49101080743,1,1522,1856,0
49101220070,49101220070,0,1166,1745,0
49103522979,49103522978,-1,652,1330,0
49106681981,49106681982,1,1492,1677,0
49107322893,49107322893,0,1659,2157,0
49107652487,49107652486,-1,1602,1949,0
49108913341,49108913345,4,2422,2151,0
49109313093,49109313092,-1,1956,2285,0
49110434634,49110434634,0,1165,2267,0
49112305851,49112305850,-1,1697,1658,0
49112737027,49112737026,-1,954,1548,0
49116816552,49116816551,-1,1699,1826,0
49118306190,49118306190,0,1099,1203,0
49119616025,49119616026,1,1660,1628,0
49121540665,49121540663,-2,1247,1388,0
49123009599,49123009600,1,1044,1601,0
49123951122,49123951123,1,826,1424,0
49126561084,49126561086,2,1315,1462,0
49126831718,49126831714,-4,1410,2706,0
49128051299,49128051299,0,1399,1447,0
49129132371,49129132373,2,1566,1284,0
49133785286,49133785286,0,1357,1875,0
49134776233,49134776234,1,1162,1637,0
49139291778,49139291783,5,4785,2154,0
49144296254,49144296254,0,1178,1746,0
49145123558,49145123558,0,1971,1850,0
49145724566,49145724570,4,1168,1210,0
49146259239,49146259238,-1,1138,1445,0
49150876121,49150876125,4,1422,1605,0
49152992882,49152992882,0,1557,1302,0
49156975305,49156975306,1,1757,2255,0
49158823355,49158823351,-4,1513,2561,0
49159009882,49159009876,-6,1877,4460,0
49159428810,49159428813,3,1315,1399,0
49160337418,49160337420,2,1916,1379,0
49165111278,49165111278,0,1213,1870,0
49166232018,49166232020,2,1001,1312,0
49170858914,49170858897,-17,34,7806,0
49170950629,49170950633,4,1030,938,0
49172189789,49172189790,1,1482,1450,0
49174095713,49174095714,1,1424,1863,0
49177086622,49177086623,1,1039,1820,0
49177465360,49177465366,6,49776,26175,0
49180219417,49180219418,1,972,1272,0
49181548597,49181548598,1,1123,2242,0
49182195279,49182195280,1,1682,1968,0
49182737681,49182737681,0,1473,2205,0
49183422343,49183422344,1,917,2236,0
49183535894,49183535892,-2,934,986,0
49184130211,49184130210,-1,2346,2438,0
49186354887,49186354885,-2,1457,1802,0
49190853845,49190853846,1,1438,2313,0
49192907888,49192907886,-2,1265,2053,0
49196411194,49196411194,0,1213,2176,0
49199707268,49199707269,1,1338,2015,0
49199732681,49199732679,-2,1566,2514,0
49200606250,49200606253,3,3336,2799,0
49201364156,49201364157,1,1079,2001,0
49202629151,49202629146,-5,412,1765,0
49203368854,49203368854,0,1928,1724,0
49205101626,49205101625,-1,1376,1053,0
49213802335,49213802335,0,1937,2231,0
49215345601,49215345598,-3,1264,1441,0
49215471997,49215471998,1,1145,1715,0
49215531503,49215531492,-11,35980,14710,0
49218548763,49218548766,3,1167,1521,0
49219830741,49219830742,1,1301,1483,0
49219989802,49219989802,0,1236,2154,0
49220297449,49220297451,2,1479,1865,0
49220691741,49220691741,0,1828,2379,0
49221875523,49221875523,0,1705,2395,0
49222739762,49222739761,-1,1332,1999,0
49223994135,49223994137,2,800,1380,0
49224178542,49224178541,-1,1066,1389,0
49224571361,49224571360,-1,1295,1378,0
49228093235,49228093235,0,1706,1470,0
49230655666,49230655668,2,1342,1430,0
49231901837,49231901836,-1,1307,1281,0
49234976042,49234976042,0,1292,1624,0
49239493172,49239493171,-1,1516,1792,0
49241949505,49241949507,2,1800,1896,0
49243769678,49243769679,1,1012,1106,0
49245144761,49245144761,0,1668,1467,0
49246080429,49246080430,1,1938,1906,0
49246637811,49246637810,-1,1456,2089,0
49246900731,49246900734,3,1129,1518,0
49251043532,49251043533,1,1181,1509,0
49254207758,49254207757,-1,1743,1881,0
49254702781,49254702781,0,2155,2607,0
49259811127,49259811125,-2,1751,2122,0
49265514434,49265514436,2,1109,1695,0
49267349189,49267349190,1,1051,1294,0
49271104974,49271104974,0,1278,1682,0
49272479811,49272479810,-1,1706,1940,0
49273811421,49273811429,8,3712,1242,0
49276169209,49276169208,-1,1050,1547,0
49277095141,49277095141,0,1002,2003,0
49277534946,49277534946,0,1338,1832,0
49277962806,49277962807,1,1276,1897,0
49278563847,49278563846,-1,1915,2573,0
49279444773,49279444767,-6,1099,3024,0
49280707128,49280707129,1,1471,2008,0
49281074766,49281074770,4,1723,1168,0
49283318536,49283318537,1,1598,2629,0
49286025767,49286025767,0,1230,1783,0
49286805718,49286805717,-1,1359,1743,0
49287869727,49287869729,2,1696,2263,0
49288391474,49288391474,0,1120,2121,0
49292487514,49292487513,-1,1128,1401,0
49293336177,49293336177,0,979,1732,0
49295314165,49295314165,0,1182,1567,0
49296917373,49296917363,-10,1308,1547,0
49300924833,49300924834,1,1252,1475,0
49303374866,49303374867,1,1981,2624,0
49304033929,49304033929,0,856,1794,0
49308160722,49308160722,0,1453,1467,0
49309840074,49309840074,0,1458,1652,0
49311573041,49311573043,2,1648,1583,0
49316021549,49316021550,1,1647,1744,0
49316999894,49316999894,0,1818,1768,0
49317660492,49317660492,0,1355,2284,0
49318638212,49318638213,1,1366,2141,0
49318952994,49318952994,0,1638,1704,0
49320249743,49320249741,-2,1371,1584,0
49324703321,49324703321,0,1641,1930,0
49325260519,49325260519,0,993,1687,0
49326099658,49326099657,-1,984,1399,0
49327163002,49327163001,-1,1095,1973,0
49328732249,49328732248,-1,1484,2013,0
49329592142,49329592142,0,1466,1788,0
49336060977,49336060980,3,1434,1904,0
49337198397,49337198398,1,1543,1914,0
49339829689,49339829688,-1,1165,2132,0
49340155155,49340155157,2,2525,2067,0
49347425582,49347425583,1,2146,2138,0
49348368050,49348368047,-3,1009,1424,0
49355675849,49355675846,-3,1246,1824,0
49358068238,49358068237,-1,1265,1629,0
49359261685,49359261685,0,1448,2667,0
49367461989,49367461990,1,1331,1841,0
49369233531,49369233533,2,1096,1354,0
49370837813,49370837815,2,1131,1687,0
49373812898,49373812899,1,989,1243,0
49374558907,49374558906,-1,589,1818,0
49377639019,49377639019,0,1223,1526,0
49378134579,49378134579,0,19138,23244,0
49381345542,49381345550,8,3446,1467,0
49382210526,49382210528,2,1582,1469,0
49386186807,49386186808,1,1457,1492,0
49388937614,49388937616,2,1354,1555,0
49392230130,49392230133,3,1782,2703,0
49397048914,49397048916,2,967,1266,0
49398428230,49398428231,1,1502,709,0
49399340306,49399340306,0,1164,1418,0
49401271459,49401271462,3,1699,1563,0
49404588534,49404588534,0,1297,1753,0
49406877265,49406877246,-19,1421,1524,0
49407543050,49407543050,0,1250,1792,0
49409487660,49409487659,-1,1780,2011,0
49409943841,49409943835,-6,1319,1484,0
49410422130,49410422131,1,1119,1007,0
49419236405,49419236406,1,1258,1773,0
49422853153,49422853153,0,1376,1400,0
49423143063,49423143064,1,1862,2230,0
49423936537,49423936530,-7,1602,5796,0
49426304925,49426304926,1,1564,1704,0
49427750019,49427750021,2,951,1884,0
49438760571,49438760566,-5,1694,4375,0
49440793576,49440793579,3,1587,978,0
49442267673,49442267674,1,1140,1076,0
49443416752,49443416753,1,1416,1257,0
49448303176,49448303177,1,2176,2018,0
49451775530,49451775530,0,1446,1506,0
49452627847,49452627849,2,1229,1429,0
49457036704,49457036722,18,866,1165,0
49459316299,49459316298,-1,1640,2359,0
49459926183,49459926185,2,1499,1918,0
49463047003,49463047003,0,1733,2952,0
49465264258,49465264260,2,2015,1684,0
49467311556,49467311554,-2,1235,1371,0
49467447805,49467447824,19,1259,4886,0
49471385854,49471385854,0,2086,2322,0
49473242597,49473242596,-1,1348,2537,0
49475076598,49475076603,5,2875,1380,0
49476769577,49476769577,0,1198,1403,0
49476891258,49476891258,0,1484,1482,0
49478450686,49478450685,-1,1408,1552,0
49478975754,49478975754,0,1716,2275,0
49479479574,49479479574,0,1586,1571,0
49486143138,49486143137,-1,1168,1333,0
49486408729,49486408727,-2,1772,1568,0
49490462359,49490462353,-6,1701,5218,0
49490732026,49490732030,4,1702,1551,0
49491472714,49491472716,2,1522,1674,0
49493083470,49493083471,1,1795,2322,0
49493655890,49493655891,1,1463,2041,0
49498008792,49498008786,-6,2222,8401,0
49498121706,49498121706,0,1047,1256,0
49501055825,49501055819,-6,1249,3224,0
49505164105,49505164104,-1,1609,1851,0
49508394952,49508394950,-2,1337,1534,0
49513855074,49513855074,0,1210,1791,0
49517413541,49517413543,2,1163,1253,0
49524183099,49524183096,-3,843,2354,0
49524778489,49524778490,1,873,1161,0
49526600456,49526600454,-2,2324,3417,0
49527050838,49527050839,1,602,958,0
49527852378,49527852378,0,1333,1470,0
49528918195,49528918195,0,1286,1386,0
49529031779,49529031778,-1,1228,1916,0
49529285209,49529285210,1,1556,1786,0
49531566455,49531566457,2,1340,1267,0
49532620634,49532620635,1,1545,1761,0
49533867810,49533867810,0,2050,1784,0
49535598389,49535598386,-3,1159,1845,0
49537758549,49537758548,-1,1361,1834,0
49538747762,49538747762,0,1731,2403,0
49539141902,49539141904,2,1843,2064,0
49542001311,49542001311,0,979,1677,0
49542357738,49542357732,-6,1566,9462,0
49543035059,49543035058,-1,1446,1715,0
49554475746,49554475750,4,1447,1414,0
49554910319,49554910321,2,1680,1840,0
49555352964,49555352967,3,1539,1068,0
49558789969,49558789971,2,1251,1855,0
49564611259,49564611259,0,1373,1654,0
49569930647,49569930647,0,1613,1680,0
49575204971,49575204971,0,1284,1219,0
49576316055,49576316057,2,1451,1469,0
49577138605,49577138602,-3,1542,1963,0
49577863518,49577863516,-2,1657,2353,0
49579188865,49579188865,0,1514,1678,0
49583793966,49583793966,0,989,1676,0
49583918785,49583918787,2,1404,2140,0
49584121130,49584121130,0,1322,1863,0
49585752587,49585752585,-2,606,1486,0
49586667970,49586667948,-22,1424,1653,0
49588202715,49588202716,1,1280,1107,0
49588898966,49588898967,1,1607,1806,0
49591998161,49591998159,-2,1351,1426,0
49592361400,49592361418,18,668,1306,0
49593489211,49593489210,-1,1442,1923,0
49593802623,49593802625,2,1880,1886,0
49595022382,49595022381,-1,1840,2236,0
49595735060,49595735059,-1,1467,1103,0
49595971559,49595971561,2,1066,1824,0
49596892178,49596892179,1,1331,1694,0
49599668062,49599668061,-1,1880,2253,0
49599825854,49599825857,3,1179,1508,0
49601902686,49601902686,0,1462,1706,0
49601988985,49601988983,-2,1986,1638,0
49603537982,49603537982,0,1452,1709,0
49604668659,49604668658,-1,1229,1890,0
49605256125,49605256125,0,1140,1599,0
49606111082,49606111082,0,1376,1885,0
49608273689,49608273694,5,1051,1489,0
49612675101,49612675098,-3,1565,2488,0
49612935393,49612935394,1,1212,1393,0
49614790942,49614790947,5,8129,4094,0
49617668532,49617668530,-2,1160,1057,0
49618548682,49618548679,-3,1332,3080,0
49620817346,49620817348,2,1572,1858,0
49620916215,49620916207,-8,24718,12453,0
49622889011,49622889008,-3,819,2580,0
49626770125,49626770125,0,1489,1809,0
49631762225,49631762221,-4,1493,5259,0
49632002723,49632002722,-1,1457,1739,0
49632364527,49632364527,0,1013,1871,0
49632775854,49632775859,5,1697,1161,0
49634335506,49634335507,1,1965,2253,0
49634557794,49634557794,0,1440,924,0
49635006697,49635006697,0,1261,1801,0
49636167722,49636167724,2,1277,2004,0
49638314807,49638314807,0,1599,1553,0
49640512040,49640512041,1,1046,1702,0
49641208617,49641208618,1,1649,2445,0
49641462637,49641462638,1,1980,2041,0
49642619833,49642619833,0,1009,1069,0
49644176194,49644176195,1,1538,2166,0
49649507397,49649507397,0,1947,1888,0
49651527870,49651527870,0,1421,2132,0
49656423610,49656423613,3,2170,1573,0
49659783374,49659783378,4,1045,1265,0
49665914473,49665914473,0,1718,1979,0
49666180562,49666180566,4,1166,892,0
49667058977,49667058978,1,1779,1890,0
49668510012,49668510013,1,2541,1834,0
49669882522,49669882522,0,1740,1813,0
49675995691,49675995692,1,1648,1870,0
49678382547,49678382546,-1,821,1152,0
49678964019,49678964021,2,1581,1768,0
49679487577,49679487577,0,914,1078,0
49679753019,49679753017,-2,1476,2161,0
49682251086,49682251086,0,1326,1630,0
49682513495,49682513494,-1,1443,1754,0
49684035775,49684035778,3,2246,2130,0
49684318208,49684318210,2,1749,1952,0
49685914568,49685914572,4,1044,1266,0
49687892014,49687892013,-1,1058,1414,0
49689484828,49689484829,1,1400,2184,0
49689596555,49689596554,-1,903,1175,0
49689822038,49689822037,-1,1026,1607,0
49690129410,49690129405,-5,1040,3221,0
49694559110,49694559109,-1,1769,1592,0
49695347047,49695347046,-1,1432,2106,0
49695424057,49695424061,4,2816,2191,0
49696594714,49696594713,-1,1338,1854,0
49697054338,49697054341,3,1417,1261,0
49700118713,49700118714,1,1400,1176,0
49701468482,49701468482,0,1432,1488,0
49703456533,49703456533,0,1807,1756,0
49704392658,49704392659,1,1247,2168,0
49705136109,49705136115,6,3902,2123,0
49714349154,49714349155,1,1343,2453,0
49715229955,49715229956,1,1542,1985,0
49715412736,49715412739,3,1573,1765,0
49716649020,49716649022,2,1443,2164,0
49719154146,49719154147,1,1134,1636,0
49722088725,49722088726,1,1065,1763,0
49722906169,49722906170,1,1163,1167,0
49724803423,49724803425,2,1639,1525,0
49731720147,49731720150,3,1113,1636,0
49731858894,49731858895,1,1426,1849,0
49733891389,49733891390,1,1480,1377,0
49735329758,49735329749,-9,923,6015,0
49736749418,49736749419,1,700,1226,0
49738558531,49738558531,0,1535,1736,0
49740150670,49740150665,-5,1966,7126,0
49740340126,49740340124,-2,847,1746,0
49740626841,49740626857,16,10138,56297,0
49741330053,49741330054,1,1432,1688,0
49742734595,49742734596,1,1088,1408,0
49744664214,49744664214,0,1523,1409,0
49748910494,49748910495,1,2019,1339,0
49751110432,49751110434,2,1438,1760,0
49755524175,49755524175,0,1175,1214,0
49758148036,49758148039,3,2135,1921,0
49759055346,49759055349,3,604,946,0
49760567603,49760567607,4,2065,1693,0
49761663942,49761663944,2,1569,1689,0
49763872547,49763872550,3,926,1027,0
49764293338,49764293339,1,1578,1209,0
49766655037,49766655038,1,1458,1473,0
49768765239,49768765238,-1,969,1323,0
49770791785,49770791786,1,1328,1875,0
49771370123,49771370126,3,1202,1564,0
49772177413,49772177415,2,701,1168,0
49772567101,49772567101,0,1675,2198,0
49773389991,49773389990,-1,1345,1726,0
49773748222,49773748224,2,949,1824,0
49774617213,49774617213,0,1098,2130,0
49775507072,49775507074,2,1178,1321,0
49776208337,49776208338,1,822,910,0
49777014013,49777014013,0,1294,1881,0
49777892638,49777892638,0,815,985,0
49778497528,49778497529,1,1394,1626,0
49781583562,49781583563,1,1601,2125,0
49782605766,49782605772,6,2878,1437,0
49784118753,49784118755,2,1548,1630,0
49787077898,49787077898,0,1363,1835,0
49791608758,49791608758,0,1474,2043,0
49798389961,49798389960,-1,1168,1383,0
49799147738,49799147740,2,1282,2002,0
49802071279,49802071278,-1,1748,2496,0
49805501520,49805501522,2,1476,1506,0
49805837714,49805837710,-4,1238,2325,0
49805980103,49805980095,-8,1518,2714,0
49806677438,49806677438,0,1153,1800,0
49809080322,49809080322,0,2072,2068,0
49812129114,49812129113,-1,1851,1863,0
49814482509,49814482511,2,1139,1790,0
49815683894,49815683895,1,1276,1574,0
49815739742,49815739742,0,1475,1344,0
49817993361,49817993367,6,2125,1049,0
49819046795,49819046795,0,1746,1701,0
49821563982,49821563986,4,2145,1427,0
49821750106,49821750103,-3,1458,1860,0
49829987942,49829987943,1,1073,1017,0
49836104973,49836104974,1,1992,2086,0
49836390987,49836390989,2,1739,2094,0
49836868381,49836868381,0,1216,1106,0
49837365137,49837365139,2,1459,1281,0
49844399221,49844399227,6,6374,2489,0
49846988580,49846988581,1,1256,1560,0
49848464647,49848464645,-2,1246,1748,0
49849774421,49849774420,-1,1329,1513,0
49851060206,49851060203,-3,1464,2289,0
49851523901,49851523904,3,1814,1967,0
49852393320,49852393321,1,1017,1421,0
49853263554,49853263556,2,940,811,0
49853548859,49853548859,0,1340,1498,0
49856137365,49856137366,1,1705,2607,0
49868579119,49868579120,1,1380,1793,0
49869167398,49869167399,1,1158,1122,0
49870146222,49870146205,-17,914,1512,0
49871658822,49871658822,0,1885,2821,0
49872667214,49872667215,1,1697,1673,0
49873206045,49873206045,0,1439,1932,0
49877732224,49877732223,-1,1515,1418,0
49878836042,49878836041,-1,1334,1610,0
49880763048,49880763049,1,1643,1169,0
49893720506,49893720509,3,1758,2258,0
49897710175,49897710174,-1,1101,1146,0
49900698282,49900698281,-1,1108,1709,0
49901481998,49901481999,1,1266,1986,0
49902034865,49902034866,1,1265,1564,0
49904055622,49904055622,0,1310,1374,0
49906180985,49906180983,-2,807,2037,0
49906629713,49906629720,7,4672,2419,0
49907885178,49907885176,-2,1282,2439,0
49909489394,49909489394,0,1178,1168,0
49911714166,49911714167,1,1719,2074,0
49912784413,49912784414,1,1328,1587,0
49915296350,49915296349,-1,1451,1132,0
49915388967,49915388965,-2,498,223,0
49918192563,49918192561,-2,1403,1762,0
49919057156,49919057157,1,1562,2044,0
49927849410,49927849408,-2,1300,2078,0
49929443840,49929443840,0,1343,1629,0
49932936202,49932936222,20,1386,1350,0
49937460007,49937460006,-1,1375,2312,0
49942242799,49942242800,1,1170,1041,0
49945501838,49945501839,1,1404,1256,0
49946321527,49946321528,1,1021,989,0
49949936528,49949936524,-4,1617,2373,0
49957093745,49957093746,1,1148,1425,0
49959805293,49959805293,0,1249,1570,0
49960584261,49960584262,1,926,1358,0
49962951358,49962951358,0,1574,1224,0
49965592513,49965592513,0,1826,1818,0
49969843580,49969843581,1,1558,2197,0
49973005219,49973005218,-1,1740,1402,0
49974943371,49974943371,0,1376,1461,0
49975483798,49975483798,0,1185,1710,0
49975807989,49975807990,1,1320,1800,0
49978243830,49978243830,0,1850,2619,0
49979004881,49979004880,-1,1238,1616,0
49981234031,49981234030,-1,1320,2179,0
49990677139,49990677139,0,1938,1943,0
49991796707,49991796705,-2,1457,1679,0
49992015526,49992015526,0,1544,2136,0
49993076508,49993076508,0,1202,2250,0
49993624583,49993624585,2,1516,1350,0
49995942787,49995942786,-1,1102,1854,0
49999480758,49999480758,0,1472,1868,0
50000288470,50000288470,0,1410,1489,0
50000586759,50000586767,8,3582,1540,0
50002136351,50002136352,1,1366,1921,0
50002475130,50002475111,-19,1427,1560,0
50003985777,50003985778,1,721,1485,0
50010387642,50010387642,0,1470,1818,0
50010487394,50010487394,0,1552,2061,0
50017459859,50017459855,-4,1220,1950,0
50018513701,50018513707,6,940,957,0
50022537108,50022537109,1,1709,2190,0
50023217118,50023217118,0,1439,1673,0
50023736151,50023736151,0,1488,1600,0
50024203875,50024203877,2,1524,2001,0
50024465702,50024465697,-5,2417,8510,0
50026316209,50026316209,0,1226,1685,0
50027238441,50027238443,2,1085,1455,0
50028644290,50028644289,-1,1428,1709,0
50029429294,50029429294,0,1464,2324,0
50030080407,50030080406,-1,1370,1338,0
50030171761,50030171763,2,1767,1293,0
50030756938,50030756938,0,1545,2256,0
50031016031,50031016031,0,1096,1736,0
50033508397,50033508397,0,806,1431,0
50034001158,50034001162,4,698,763,0
50034481425,50034481428,3,1243,1274,0
50039418673,50039418674,1,781,1559,0
50043015401,50043015402,1,1540,2066,0
50043537037,50043537038,1,1661,1503,0
50045347132,50045347132,0,940,1868,0
50045520103,50045520086,-17,1586,1789,0
50045928750,50045928745,-5,981,1698,0
50046487715,50046487713,-2,912,1589,0
50047320062,50047320067,5,4458,2873,0
50052352585,50052352586,1,923,1204,0
50053210198,50053210194,-4,1959,3644,0
50054118928,50054118935,7,3379,1656,0
50058213394,50058213398,4,1492,924,0
50059120794,50059120791,-3,1099,1619,0
50059716531,50059716535,4,486,807,0
50064695578,50064695577,-1,1449,1613,0
50069308453,50069308459,6,1889,892,0
50071087398,50071087404,6,2264,860,0
50072124281,50072124282,1,1035,1957,0
50075380200,50075380201,1,1685,2773,0
50076456730,50076456731,1,645,1299,0
50076993479,50076993483,4,1463,1181,0
50078068651,50078068651,0,1476,1796,0
50082324742,50082324743,1,1338,1902,0
50085086960,50085086962,2,1415,1152,0
50085152463,50085152463,0,1916,1360,0
50085907510,50085907511,1,1348,1695,0
50086642834,50086642835,1,1125,1822,0
50087593674,50087593674,0,2185,2859,0
50101366526,50101366527,1,889,948,0
50103609897,50103609896,-1,1435,1985,0
50107512762,50107512765,3,1312,1891,0
50108666362,50108666361,-1,1319,1828,0
50110348527,50110348525,-2,738,2239,0
50110517675,50110517674,-1,1192,2060,0
50110922931,50110922930,-1,1230,1768,0
50117526207,50117526206,-1,1221,2324,0
50124153166,50124153166,0,1676,2288,0
50125216489,50125216489,0,761,1563,0
50128928403,50128928402,-1,1261,1710,0
50136310951,50136310952,1,1145,1554,0
50137348567,50137348566,-1,1301,2020,0
50139175309,50139175311,2,1584,1240,0
50139572844,50139572845,1,1702,1963,0
50140272711,50140272712,1,988,1349,0
50144822399,50144822398,-1,1174,1744,0
50147938223,50147938222,-1,897,1675,0
50149160521,50149160525,4,1331,1439,0
50150388381,50150388382,1,1049,1283,0
50150955752,50150955753,1,1552,1418,0
50156056413,50156056413,0,1405,1440,0
50157633802,50157633803,1,1261,1678,0
50159103962,50159103961,-1,932,2199,0
50162808139,50162808139,0,1594,1980,0
50162977790,50162977784,-6,867,1745,0
50163377772,50163377773,1,1212,1606,0
50164136076,50164136075,-1,1562,1953,0
50164974369,50164974369,0,1513,1687,0
50165155691,50165155689,-2,1134,1206,0
50167298183,50167298185,2,914,1130,0
50172643223,50172643226,3,1161,2035,0
50178566987,50178566989,2,1525,1558,0
50180219623,50180219623,0,1510,1443,0
50180988298,50180988299,1,825,1499,0
50182221931,50182221930,-1,950,1399,0
50183156961,50183156961,0,1461,1754,0
50187967747,50187967754,7,4580,2370,0
50188834643,50188834642,-1,1547,1583,0
50190853885,50190853885,0,1409,1820,0
50191872666,50191872666,0,1580,1688,0
50193529113,50193529115,2,1337,1444,0
50198713571,50198713570,-1,1283,1642,0
50202377337,50202377339,2,1677,1801,0
50207366542,50207366542,0,1040,1701,0
50208201505,50208201506,1,1844,1810,0
50213893161,50213893161,0,1988,2210,0
50213984400,50213984398,-2,1051,1446,0
50215474421,50215474419,-2,1026,1652,0
50219018916,50219018917,1,1497,1847,0
50220328507,50220328505,-2,1534,2456,0
50220725309,50220725306,-3,1080,1380,0
50222124566,50222124566,0,1343,2296,0
50223446618,50223446618,0,1831,2362,0
50225227764,50225227765,1,1284,1648,0
50230555979,50230555979,0,1322,2133,0
50232393514,50232393516,2,1351,1816,0
50234039452,50234039454,2,1472,2146,0
50236905373,50236905374,1,1245,1572,0
50240344542,50240344543,1,1804,1788,0
50242511682,50242511682,0,1123,1211,0
50244597657,50244597658,1,1374,1526,0
50244675918,50244675905,-13,1564,1716,0
50245166600,50245166604,4,19128,29763,0
50247590471,50247590470,-1,1547,1914,0
50247627067,50247627067,0,1131,1379,0
50250383498,50250383499,1,2485,1353,0
50251424891,50251424890,-1,1656,2229,0
50253974506,50253974507,1,47297,61732,0
50257009331,50257009332,1,1781,2118,0
50260016401,50260016404,3,1348,1937,0
50260775134,50260775130,-4,1236,3611,0
50261714931,50261714932,1,1393,1286,0
50262905142,50262905144,2,972,1013,0
50265091163,50265091165,2,1577,2076,0
50266126953,50266126953,0,1519,2068,0
50267537566,50267537567,1,1167,1448,0
50269305897,50269305898,1,899,1541,0
50284026457,50284026458,1,1100,1516,0
50284751198,50284751198,0,1369,1932,0
50286348881,50286348881,0,1403,1533,0
50292021807,50292021805,-2,1294,1775,0
50292616702,50292616709,7,11394,21457,0
50294236873,50294236873,0,1517,1903,0
50294953421,50294953422,1,1189,1209,0
50297022543,50297022523,-20,1259,1243,0
50303095315,50303095312,-3,910,2267,0
50305918470,50305918470,0,1053,1493,0
50308510719,50308510719,0,1322,2287,0
50309013045,50309013046,1,1480,2048,0
50313076869,50313076868,-1,1100,1921,0
50317957082,50317957083,1,1560,2035,0
50318394098,50318394098,0,890,1439,0
50319228615,50319228626,11,978,1343,0
50323637773,50323637775,2,985,1176,0
50324570917,50324570919,2,1818,1603,0
50324790883,50324790885,2,1641,1479,0
50325399415,50325399414,-1,1374,1632,0
50328722202,50328722202,0,1114,2036,0
50329967806,50329967807,1,1556,1146,0
50330535890,50330535886,-4,1551,4338,0
50331455266,50331455261,-5,1248,3814,0
50332435594,50332435593,-1,1637,1940,0
50336179562,50336179563,1,1292,1902,0
50338058765,50338058764,-1,1156,1634,0
50340295170,50340295169,-1,1401,1723,0
50341610699,50341610701,2,1467,1771,0
50343926598,50343926602,4,2418,1579,0
50345542618,50345542618,0,2176,2217,0
50349767032,50349767030,-2,1354,1645,0
50350105351,50350105353,2,1175,1250,0
50351078232,50351078230,-2,1243,1864,0
50352326716,50352326716,0,1709,1914,0
50353053101,50353053123,22,1751,1867,0
50353404098,50353404099,1,1755,1591,0
50356241094,50356241095,1,928,1414,0
50357125105,50357125104,-1,1046,1699,0
50358579741,50358579740,-1,1210,1945,0
50359861442,50359861441,-1,772,1501,0
50367786274,50367786274,0,1496,1050,0
50367937394,50367937395,1,1737,2161,0
50370794202,50370794203,1,1659,1649,0
50371744583,50371744583,0,1066,1386,0
50372477020,50372477022,2,1674,1570,0
50374156029,50374156030,1,1612,1648,0
50374547062,50374547063,1,1380,1593,0
50376237128,50376237129,1,947,1714,0
50381060703,50381060703,0,1149,1390,0
50383648084,50383648082,-2,1100,2617,0
50383822486,50383822486,0,1890,1393,0
50386954136,50386954152,16,1168,1387,0
50388045325,50388045331,6,1960,1214,0
50389872865,50389872866,1,1166,1728,0
50400073081,50400073079,-2,1173,1397,0
50400436185,50400436185,0,1166,1463,0
50400839615,50400839618,3,2062,1725,0
50404687736,50404687735,-1,3411,4546,0
50407235930,50407235930,0,1567,2337,0
50411222851,50411222851,0,1619,1705,0
50415747553,50415747553,0,2097,2244,0
50417479910,50417479911,1,1326,1871,0
50421429569,50421429570,1,1243,1913,0
50422602370,50422602376,6,3058,1422,0
50423182097,50423182098,1,1876,2083,0
50426841867,50426841868,1,1302,1340,0
50431825414,50431825414,0,1491,1738,0
50432784314,50432784314,0,1662,1600,0
50436066197,50436066201,4,2102,1800,0
50439162691,50439162690,-1,1760,2304,0
50439952235,50439952231,-4,1409,1791,0
50442815615,50442815611,-4,952,3256,0
50443975287,50443975287,0,820,1699,0
50444601343,50444601349,6,2987,1420,0
50444960267,50444960268,1,1454,1563,0
50445595911,50445595913,2,1166,1460,0
50447442777,50447442778,1,1781,1202,0
50463063586,50463063575,-11,1377,1551,0
50465049838,50465049839,1,1712,1520,0
50466225246,50466225247,1,438,651,0
50467679739,50467679742,3,1680,1810,0
50468009606,50468009590,-16,1181,1647,0
50468244458,50468244465,7,10020,26188,0
50468489031,50468489032,1,1795,2235,0
50469350118,50469350118,0,1539,2195,0
50472783747,50472783746,-1,1407,2096,0
50477665494,50477665495,1,484,403,0
50478495979,50478495978,-1,1066,1333,0
50481990650,50481990652,2,1327,1992,0
50482193720,50482193722,2,882,1003,0
50484650938,50484650939,1,1495,1843,0
50491332087,50491332086,-1,808,1481,0
50492424022,50492424027,5,1642,755,0
50493388261,50493388260,-1,1280,1609,0
50496230794,50496230796,2,1370,1944,0
50497416707,50497416709,2,1216,1585,0
50498282624,50498282623,-1,1263,1545,0
50506527422,50506527422,0,2551,1907,0
50508804071,50508804062,-9,936,1379,0
50510603206,50510603206,0,1336,1312,0
50511715608,50511715610,2,1393,1303,0
50512778438,50512778438,0,849,1451,0
50513199281,50513199281,0,1226,1478,0
50515281010,50515281009,-1,1481,2138,0
50517062634,50517062631,-3,1320,2684,0
50517346537,50517346538,1,1981,2062,0
50519598093,50519598091,-2,1849,3700,0
50520226514,50520226515,1,1320,1676,0
50522125076,50522125076,0,992,1195,0
50523727241,50523727242,1,1313,1487,0
50532949405,50532949404,-1,1436,1571,0
50533711089,50533711092,3,1475,1631,0
50535093122,50535093124,2,2036,1888,0
50535391491,50535391495,4,1422,1397,0
50535837529,50535837535,6,2968,1816,0
50536168171,50536168173,2,1585,1726,0
50542248926,50542248927,1,1398,1626,0
50542545609,50542545601,-8,708,3939,0
50546999518,50546999518,0,1292,1558,0
50549649988,50549649990,2,1784,1440,0
50551888091,50551888095,4,1435,1543,0
50552170033,50552170034,1,1370,1795,0
50552917361,50552917359,-2,1388,2659,0
50553385199,50553385196,-3,1669,1415,0
50557230254,50557230261,7,2552,1171,0
50562237233,50562237230,-3,1227,1911,0
50564964378,50564964377,-1,691,2619,0
50567858065,50567858066,1,1344,1548,0
50572656250,50572656254,4,1213,1305,0
50574851593,50574851594,1,1441,1913,0
50577780389,50577780389,0,1722,1546,0
50581050409,50581050411,2,1638,1435,0
50581984602,50581984606,4,775,825,0
50583347246,50583347246,0,1357,1867,0
50586844878,50586844879,1,1325,1377,0
50587156269,50587156268,-1,1276,1954,0
50591358780,50591358777,-3,1068,2065,0
50592126261,50592126261,0,1375,2051,0
50593828048,50593828048,0,995,2049,0
50594246002,50594246002,0,1113,1224,0
50594736076,50594736071,-5,1128,3473,0
50597432041,50597432041,0,1522,1339,0
50598946746,50598946747,1,1113,1264,0
50600349862,50600349863,1,1642,1071,0
50601928106,50601928110,4,1926,1209,0
50602535382,50602535382,0,1400,1838,0
50605390959,50605390962,3,1822,1554,0
50606022470,50606022474,4,1465,1191,0
50608670059,50608670059,0,1361,1212,0
50612573306,50612573308,2,1615,1308,0
50613482967,50613482970,3,982,1493,0
50621298745,50621298746,1,1885,1941,0
50621722082,50621722084,2,1337,1770,0
50623760570,50623760569,-1,1603,2087,0
50624890188,50624890186,-2,1355,2074,0
50625011682,50625011684,2,1377,1686,0
50627162298,50627162298,0,1510,1436,0
50627470834,50627470833,-1,1380,1602,0
50630308674,50630308675,1,1599,1811,0
50630584469,50630584470,1,1782,2436,0
50632947190,50632947190,0,1196,1429,0
50639925810,50639925811,1,1046,1322,0
50642481100,50642481102,2,1140,1341,0
50642940811,50642940810,-1,1693,2307,0
50644886969,50644886967,-2,1109,1995,0
50647532289,50647532289,0,10216,14548,0
50649476373,50649476374,1,1159,1521,0
50650272085,50650272086,1,1070,1648,0
50651505741,50651505741,0,1287,1603,0
50653060871,50653060870,-1,942,2015,0
50653990978,50653990978,0,1454,2009,0
50654135717,50654135714,-3,1318,1830,0
50655147661,50655147663,2,1743,1663,0
50656229652,50656229649,-3,1654,2255,0
50656328572,50656328572,0,1812,2160,0
50658769549,50658769550,1,1502,1262,0
50658806351,50658806349,-2,1145,1813,0
50659396577,50659396582,5,1131,1195,0
50661253060,50661253061,1,1101,2098,0
50662505751,50662505752,1,1599,1905,0
50665379745,50665379745,0,1614,2209,0
50666099590,50666099591,1,1879,2054,0
50667210753,50667210754,1,1219,1501,0
50667870688,50667870685,-3,1657,1851,0
50667994647,50667994634,-13,997,1435,0
50669869270,50669869270,0,1447,1648,0
50670202547,50670202547,0,1567,1708,0
50670266404,50670266384,-20,1129,1085,0
50675009134,50675009130,-4,1362,2560,0
50676317185,50676317190,5,1869,1548,0
50684918289,50684918290,1,860,1553,0
50687791847,50687791847,0,1253,730,0
50689632448,50689632450,2,1541,1081,0
50690479678,50690479679,1,1640,1849,0
50691328419,50691328421,2,1206,1243,0
50694024536,50694024538,2,2048,1957,0
50696807905,50696807904,-1,1056,1365,0
50701004878,50701004872,-6,1028,4971,0
50703214332,50703214333,1,1736,1844,0
50703936021,50703936021,0,1067,1351,0
50707560498,50707560491,-7,1631,8880,0
50708196606,50708196606,0,1514,2868,0
50708624798,50708624798,0,1193,1697,0
50711999386,50711999386,0,1079,2163,0
50712570587,50712570586,-1,1258,1189,0
50713189902,50713189883,-19,654,125,0
50714242982,50714242972,-10,510,239,0
50717767279,50717767279,0,548,1585,0
50720381278,50720381277,-1,1237,3010,0
50722221405,50722221407,2,1305,1719,0
50724476001,50724476005,4,2936,1878,0
50726079041,50726079041,0,1654,1548,0
50728102698,50728102699,1,1241,1389,0
50728684002,50728684003,1,1342,2039,0
50732165982,50732165985,3,916,1308,0
50732741244,50732741243,-1,1600,2619,0
50732856148,50732856149,1,1391,2209,0
50734815653,50734815658,5,2199,1277,0
50734858405,50734858406,1,1716,1292,0
50736076748,50736076749,1,1267,1124,0
50736454148,50736454149,1,1366,1513,0
50736540092,50736540091,-1,30,742,0
50740580581,50740580583,2,1908,1741,0
50741419777,50741419781,4,1449,1628,0
50742974255,50742974250,-5,829,2759,0
50743813700,50743813701,1,1625,2067,0
50744559340,50744559339,-1,1053,1667,0
50746622599,50746622600,1,1491,1883,0
50747525669,50747525669,0,1317,1683,0
50747754602,50747754605,3,1244,1109,0
50750660666,50750660665,-1,794,962,0
50751451068,50751451067,-1,1230,1871,0
50753076521,50753076519,-2,1515,1233,0
50753920438,50753920438,0,813,1513,0
50755700222,50755700223,1,1598,1701,0
50756097634,50756097631,-3,1918,2789,0
50760314045,50760314045,0,2040,2361,0
50760456253,50760456255,2,1460,1250,0
50761435990,50761435993,3,1658,2223,0
50762202542,50762202556,14,1135,1588,0
50763965146,50763965146,0,894,1150,0
50764535356,50764535354,-2,1079,1859,0
50765505456,50765505456,0,1155,1442,0
50770406919,50770406918,-1,1232,2552,0
50771914141,50771914141,0,1579,1142,0
50773244103,50773244102,-1,1510,2573,0
50777734650,50777734650,0,1548,1596,0
50780479866,50780479862,-4,4388,11403,0
50782622852,50782622843,-9,83,1021,0
50785512345,50785512345,0,1566,2253,0
50786321405,50786321405,0,2333,2210,0
50787241942,50787241942,0,1821,2129,0
50788986102,50788986102,0,1414,1389,0
50791065194,50791065194,0,1522,2069,0
50791956572,50791956578,6,3317,1990,0
50794776698,50794776700,2,1542,1448,0
50798075397,50798075417,20,1485,1937,0
50799008662,50799008641,-21,1189,1966,0
50800088592,50800088590,-2,1607,1491,0
50803082286,50803082287,1,542,1033,0
50804459979,50804459987,8,10362,30677,0
50806223808,50806223808,0,1979,2028,0
50808045681,50808045684,3,2979,1407,0
50809225097,50809225097,0,987,1448,0
50811201234,50811201236,2,1171,1146,0
50812226854,50812226853,-1,1486,1333,0
50813009226,50813009226,0,1163,1744,0
50818315227,50818315227,0,1195,1655,0
50819231067,50819231066,-1,1536,1899,0
50822249788,50822249790,2,1823,1755,0
50822660426,50822660425,-1,1102,1966,0
50825123871,50825123871,0,769,1026,0
50825186439,50825186433,-6,927,1086,0
50826947926,50826947928,2,1312,1711,0
50829715621,50829715620,-1,1582,1853,0
50830507550,50830507545,-5,989,1813,0
50830668111,50830668110,-1,1353,1467,0
50830910157,50830910158,1,1261,1620,0
50836997043,50836997044,1,1393,2085,0
50841337405,50841337406,1,1226,1329,0
50843755893,50843755891,-2,815,586,0
50843886831,50843886835,4,1861,2001,0
50846634737,50846634739,2,1495,2009,0
50858006786,50858006788,2,1859,1553,0
50862639539,50862639541,2,1718,1361,0
50863216282,50863216286,4,1741,1567,0
50865743326,50865743329,3,871,1283,0
50866144960,50866144957,-3,20695,13627,0
50872970130,50872970129,-1,1349,1997,0
50873495495,50873495495,0,1173,1117,0
50875227180,50875227181,1,1333,1307,0
50875957146,50875957147,1,1537,1867,0
50875984590,50875984590,0,1322,2052,0
50879729888,50879729889,1,2102,1941,0
50880932478,50880932479,1,1186,1319,0
50881706528,50881706529,1,1628,1962,0
50885085803,50885085805,2,1346,2136,0
50885223602,50885223601,-1,1409,2173,0
50886298463,50886298461,-2,1130,1826,0
50887999952,50887999953,1,1751,2160,0
50888210866,50888210870,4,1589,1259,0
50889060495,50889060493,-2,1467,1494,0
50891567398,50891567398,0,1402,1821,0
50896234019,50896234018,-1,1667,1694,0
50897280014,50897280014,0,907,1749,0
50899541017,50899541016,-1,1380,1543,0
50901266617,50901266618,1,1501,1812,0
50902415425,50902415425,0,1543,1600,0
50903517190,50903517190,0,1327,1910,0
50903890196,50903890193,-3,1491,1617,0
50906044581,50906044581,0,1183,1908,0
50909834442,50909834443,1,1085,1459,0
50909971431,50909971433,2,1777,1568,0
50910237910,50910237911,1,1449,1993,0
50912670218,50912670214,-4,2226,5528,0
50913272814,50913272816,2,1328,1272,0
50919045519,50919045518,-1,1006,1686,0
50922796623,50922796622,-1,957,1057,0
50923126770,50923126770,0,1788,1463,0
50924828429,50924828430,1,1034,1279,0
50927774978,50927774979,1,1098,1416,0
50928746318,50928746322,4,1671,1182,0
50932114603,50932114603,0,785,1250,0
50937792665,50937792660,-5,1578,4555,0
50938961579,50938961578,-1,1782,2380,0
50939387422,50939387420,-2,818,1452,0
50939510804,50939510789,-15,1461,1432,0
50940066463,50940066463,0,1214,1693,0
50942330825,50942330825,0,1705,1672,0
50944663780,50944663791,11,13907,41239,0
50949149882,50949149882,0,1486,1519,0
50951390626,50951390625,-1,1330,1733,0
50953047149,50953047153,4,2105,1295,0
50953155658,50953155660,2,948,1423,0
50956648194,50956648196,2,1429,1926,0
50956919210,50956919211,1,1161,1704,0
50956968524,50956968523,-1,1353,1223,0
50957194593,50957194594,1,870,1220,0
50957598934,50957598936,2,1675,1795,0
50959121953,50959121955,2,1232,1668,0
50959410499,50959410497,-2,1221,1658,0
50960653857,50960653857,0,1193,1782,0
50964637487,50964637486,-1,1395,1109,0
50964808857,50964808856,-1,1036,1712,0
50967693371,50967693375,4,1593,1482,0
50970950550,50970950528,-22,1165,1768,0
50971902234,50971902238,4,1557,2333,0
50976034693,50976034695,2,1563,1940,0
50981355339,50981355339,0,928,1678,0
50982754838,50982754839,1,1719,2106,0
50984531299,50984531300,1,1735,1760,0
50986990170,50986990171,1,1520,2370,0
50988580221,50988580221,0,1596,1806,0
50988960461,50988960460,-1,34686,53026,0
50990864441,50990864440,-1,1692,2003,0
50997885234,50997885234,0,1497,1796,0
51009466017,51009466022,5,5016,3005,0
51013358365,51013358366,1,1121,1424,0
51015251659,51015251660,1,1437,1513,0
51018243095,51018243096,1,1416,1721,0
51018433349,51018433350,1,1561,1382,0
51018859169,51018859162,-7,1676,7558,0
51020098930,51020098930,0,1263,1162,0
51024044207,51024044206,-1,1423,1486,0
51025955478,51025955478,0,783,787,0
51026808246,51026808246,0,1396,1735,0
51027549205,51027549205,0,1522,1594,0
51028480831,51028480831,0,1720,1641,0
51030933796,51030933796,0,1654,1941,0
51031477974,51031477975,1,1581,2066,0
51031761452,51031761450,-2,1317,3104,0
51034219014,51034219019,5,1722,1440,0
51034303334,51034303335,1,1058,1594,0
51039014318,51039014318,0,997,1499,0
51042857181,51042857182,1,1612,1599,0
51043870062,51043870064,2,1970,1928,0
51044636205,51044636207,2,1882,1558,0
51045567254,51045567258,4,1374,1578,0
51045892335,51045892336,1,1294,1869,0
51046954044,51046954042,-2,1011,2031,0
51052013474,51052013474,0,1069,1204,0
51053128811,51053128814,3,761,718,0
51053929814,51053929814,0,1237,1480,0
51054731678,51054731679,1,985,1455,0
51059745955,51059745955,0,1073,1777,0
51061834437,51061834435,-2,864,1448,0
51063875330,51063875329,-1,1464,1836,0
51064620586,51064620586,0,1345,1500,0
51064998802,51064998801,-1,1977,2058,0
51065115315,51065115315,0,3091,3504,0
51066315477,51066315478,1,1639,1904,0
51068698653,51068698654,1,1368,1494,0
51069313751,51069313752,1,1561,1742,0
51072288850,51072288850,0,1402,1417,0
51072581218,51072581217,-1,1042,1036,0
51073442785,51073442787,2,2692,2521,0
51073986787,51073986788,1,1515,1657,0
51075118353,51075118346,-7,2433,7687,0
51077136875,51077136877,2,1666,1719,0
51077635586,51077635588,2,2283,1872,0
51083160373,51083160374,1,1634,2288,0
51085449159,51085449159,0,1014,885,0
51087736525,51087736531,6,3885,1847,0
51088180829,51088180830,1,2324,2520,0
51088550577,51088550585,8,5355,2521,0
51094236939,51094236940,1,1299,1680,0
51096548091,51096548091,0,1732,1483,0
51097128463,51097128463,0,1756,1844,0
51097463113,51097463114,1,1505,1200,0
51097977203,51097977203,0,794,1323,0
51098262885,51098262883,-2,1427,1958,0
51102625959,51102625958,-1,1030,1694,0
51104970090,51104970092,2,1761,1153,0
51110689223,51110689224,1,22782,36064,0
51112398535,51112398535,0,1055,960,0
51115491402,51115491403,1,772,1301,0
51117403402,51117403402,0,1253,2098,0
51121603767,51121603768,1,1199,1332,0
51123165091,51123165091,0,2216,1848,0
51125632093,51125632094,1,1501,1722,0
51134730725,51134730723,-2,1330,2246,0
51136268673,51136268675,2,1144,1934,0
51137142898,51137142900,2,1914,1961,0
51143284289,51143284290,1,1262,1440,0
51147009198,51147009199,1,1207,2089,0
51147618998,51147618997,-1,1325,1441,0
51147660539,51147660539,0,1474,1859,0
51148179876,51148179876,0,1064,1309,0
51150670513,51150670514,1,753,1170,0
51153042886,51153042889,3,1102,1505,0
51156449987,51156449990,3,1397,1477,0
51156636672,51156636674,2,759,1351,0
51159334071,51159334071,0,1295,1238,0
51160756403,51160756402,-1,1065,1115,0
51161116478,51161116478,0,1406,1570,0
51162549343,51162549342,-1,926,1793,0
51163911450,51163911449,-1,1026,1242,0
51165011350,51165011356,6,22211,53155,0
51166415828,51166415830,2,977,1185,0
51168713904,51168713904,0,1462,1354,0
51171728213,51171728213,0,1031,1850,0
51175486452,51175486450,-2,1908,2818,0
51182060745,51182060744,-1,1173,1416,0
51183762884,51183762885,1,1205,1045,0
51186529670,51186529673,3,1349,2051,0
51187280406,51187280406,0,1379,1737,0
51189306154,51189306153,-1,1185,1984,0
51191821873,51191821874,1,1433,1680,0
51195917737,51195917735,-2,1297,1700,0
51198799184,51198799186,2,1835,1495,0
51199424342,51199424356,14,1274,1159,0
51208187905,51208187906,1,1235,2084,0
51209435946,51209435946,0,1347,2009,0
51210134088,51210134088,0,1261,2079,0
51212438061,51212438062,1,1277,1347,0
51213514166,51213514164,-2,1380,2772,0
51215244235,51215244231,-4,1041,1652,0
51216018651,51216018651,0,1194,1776,0
51218482175,51218482174,-1,1669,1648,0
51218668983,51218668983,0,1939,2071,0
51221002672,51221002689,17,477,781,0
51221491687,51221491685,-2,1165,1693,0
51222521573,51222521573,0,1421,1523,0
51223461026,51223461027,1,1635,1803,0
51224772926,51224772927,1,1120,1303,0
51226074763,51226074762,-1,1652,2849,0
51231176322,51231176322,0,1425,1925,0
51232335776,51232335777,1,1581,1205,0
51234549879,51234549878,-1,1138,1509,0
51235780799,51235780801,2,1915,1014,0
51235832722,51235832721,-1,3749,4076,0
51239177548,51239177550,2,1042,1624,0
51242246872,51242246872,0,1195,2079,0
51242752437,51242752436,-1,1240,1466,0
51244619482,51244619482,0,1192,1709,0
51246093834,51246093833,-1,1330,1363,0
51248358507,51248358507,0,1209,1790,0
51248437855,51248437857,2,2327,2685,0
51250143777,51250143778,1,2355,2225,0
51250437714,51250437716,2,1994,1976,0
51253586555,51253586556,1,1883,1841,0
51254376958,51254376962,4,1069,1548,0
51254820238,51254820221,-17,986,314,0
51254952006,51254952006,0,1484,1688,0
51255019672,51255019665,-7,1319,9157,0
51255612831,51255612833,2,1152,1548,0
51258391712,51258391711,-1,1712,2455,0
51261450514,51261450519,5,1227,1485,0
51262206403,51262206405,2,2055,2101,0
51262431040,51262431038,-2,1125,1826,0
51262671089,51262671089,0,1444,1718,0
51264214942,51264214944,2,3219,2883,0
51264960422,51264960426,4,1134,2110,0
51266893953,51266893955,2,1805,2393,0
51266951876,51266951875,-1,1148,1448,0
51267278662,51267278662,0,1726,1387,0
51267404085,51267404064,-21,72,1243,0
51269992058,51269992059,1,1427,1429,0
51271949878,51271949878,0,1285,1527,0
51277648251,51277648251,0,942,1832,0
51278428003,51278428003,0,1583,1439,0
51279520735,51279520734,-1,1663,2552,0
51279790194,51279790194,0,1811,2374,0
51280383268,51280383270,2,1611,1398,0
51281024091,51281024089,-2,978,1187,0
51281448365,51281448366,1,1015,1127,0
51286798733,51286798734,1,1566,1658,0
51287560256,51287560254,-2,1022,1545,0
51290071101,51290071102,1,1654,1782,0
51291151919,51291151919,0,1376,1056,0
51291714627,51291714645,18,1165,1542,0
51292683943,51292683945,2,1132,1737,0
51293072161,51293072161,0,1980,5009,0
51294075199,51294075201,2,1271,1286,0
51294345286,51294345286,0,1066,1009,0
51294763598,51294763597,-1,894,1641,0
51296253222,51296253222,0,834,1456,0
51297607763,51297607766,3,1448,1768,0
51298372653,51298372653,0,1957,1607,0
51298537696,51298537698,2,1763,2115,0
51300878742,51300878742,0,1409,1843,0
51302097179,51302097180,1,1330,1543,0
51303175622,51303175622,0,1435,1544,0
51303947949,51303947950,1,1564,1785,0
51313194504,51313194503,-1,1489,1993,0
51313692094,51313692098,4,108,1964,0
51313785238,51313785241,3,143,3562,0
51314610287,51314610279,-8,289,599,0
51315355221,51315355222,1,1238,1272,0
51316511438,51316511439,1,1311,1692,0
51317435765,51317435762,-3,1823,1711,0
51319830862,51319830862,0,1502,2109,0
51320404151,51320404131,-20,1000,1061,0
51321724035,51321724034,-1,600,804,0
51323272871,51323272858,-13,941,4328,0
51325245768,51325245769,1,1695,1738,0
51325272909,51325272910,1,1164,1482,0
51327055861,51327055859,-2,1307,1306,0
51328841653,51328841654,1,1294,2086,0
51330444315,51330444315,0,1625,1744,0
51332297834,51332297835,1,1593,1802,0
51335059824,51335059825,1,1350,1499,0
51335392611,51335392610,-1,981,1346,0
51338342926,51338342925,-1,975,1720,0
51338388688,51338388691,3,1655,1710,0
51338918753,51338918753,0,2268,2096,0
51339815990,51339815991,1,1561,1691,0
51340679258,51340679259,1,1197,1660,0
51342679383,51342679384,1,1846,1670,0
51342881589,51342881589,0,1266,1251,0
51347587093,51347587095,2,1280,1664,0
51348281582,51348281560,-22,1000,1775,0
51349685434,51349685435,1,1031,1725,0
51349848533,51349848538,5,346,669,0
51356331367,51356331366,-1,1014,1480,0
51357620303,51357620304,1,1700,2187,0
51357724339,51357724340,1,1002,1315,0
51360182145,51360182146,1,1400,1462,0
51363489749,51363489750,1,1395,1537,0
51363934963,51363934966,3,1837,2128,0
51364978551,51364978553,2,1780,1539,0
51366594607,51366594611,4,1179,1456,0
51369584805,51369584805,0,1542,1791,0
51370541967,51370541967,0,1150,1677,0
51373078925,51373078925,0,787,1898,0
51373327866,51373327866,0,1030,1646,0
51373567163,51373567164,1,955,1195,0
51374970363,51374970365,2,1448,1208,0
51376259159,51376259163,4,1349,1742,0
51376458829,51376458827,-2,1182,1889,0
51379057883,51379057881,-2,1098,1087,0
51384503638,51384503638,0,1207,2022,0
51386679683,51386679684,1,1703,1743,0
51387227870,51387227873,3,1636,2161,0
51387330295,51387330294,-1,1109,1992,0
51391136578,51391136585,7,1734,1097,0
51391467951,51391467952,1,1236,1296,0
51397271118,51397271119,1,786,813,0
51398625492,51398625493,1,1748,1762,0
51398821011,51398821010,-1,1361,1407,0
51398998049,51398998050,1,1504,1728,0
51399779601,51399779601,0,1561,1476,0
51399812164,51399812185,21,136,1204,0
51403419289,51403419292,3,43895,40610,0
51404533740,51404533743,3,12949,10212,0
51408085178,51408085175,-3,713,1377,0
51411695518,51411695521,3,2746,1591,0
51411933241,51411933242,1,1453,1662,0
51412171641,51412171640,-1,600,1479,0
51415774297,51415774293,-4,838,1986,0
51416377374,51416377375,1,1395,1548,0
51418314750,51418314753,3,2000,1152,0
51421604066,51421604066,0,1568,2433,0
51425433579,51425433580,1,1496,1952,0
51425802293,51425802294,1,1249,1481,0
51426076791,51426076789,-2,1635,1510,0
51426383102,51426383097,-5,1065,3498,0
51431640822,51431640842,20,1382,2039,0
51432263575,51432263576,1,1526,2354,0
51435872162,51435872161,-1,1594,1918,0
51437844298,51437844302,4,19302,25076,0
51441263914,51441263918,4,1095,1040,0
51444059017,51444059022,5,3146,1697,0
51447283153,51447283155,2,1740,1849,0
51455361622,51455361621,-1,1348,2123,0
51456734230,51456734230,0,1408,1226,0
51458309066,51458309066,0,1703,2133,0
51460692357,51460692357,0,1434,1512,0
51462629887,51462629887,0,951,1816,0
51466302661,51466302661,0,2065,1447,0
51467237174,51467237174,0,1005,1257,0
51467581625,51467581625,0,8375,11130,0
51469629660,51469629646,-14,1191,1601,0
51469709623,51469709624,1,1437,2080,0
51473194951,51473194953,2,1070,1145,0
51474543465,51474543467,2,1046,736,0
51477891909,51477891910,1,1162,1614,0
51480092246,51480092246,0,1312,2206,0
51480777400,51480777417,17,1475,1636,0
51481126455,51481126455,0,1010,1433,0
51483462718,51483462719,1,1284,966,0
51486168101,51486168101,0,1372,1641,0
51487684606,51487684609,3,1074,1751,0
51488432790,51488432791,1,1709,2197,0
51491012655,51491012654,-1,1187,1874,0
51491634291,51491634296,5,3219,1947,0
51495288497,51495288498,1,1579,1551,0
51499542170,51499542170,0,1071,1445,0
51500864950,51500864951,1,1090,1348,0
51503688794,51503688791,-3,733,895,0
51507058373,51507058372,-1,1521,1902,0
51507906546,51507906547,1,1598,1503,0
51509185444,51509185442,-2,1193,1137,0
51512763804,51512763806,2,812,1540,0
51514485124,51514485124,0,1363,2435,0
51515090602,51515090603,1,1388,1638,0
51523679093,51523679093,0,1299,1574,0
51525122341,51525122347,6,1736,1405,0
51525804306,51525804306,0,1209,1067,0
51530335867,51530335867,0,1589,1661,0
51531349281,51531349281,0,1804,1576,0
51534681484,51534681486,2,1501,1598,0
51537685104,51537685107,3,1309,943,0
51539191779,51539191779,0,963,973,0
51540865689,51540865684,-5,1355,4054,0
51541450610,51541450610,0,1112,979,0
51542515099,51542515097,-2,1305,2310,0
51542671722,51542671723,1,1058,1707,0
51547199329,51547199330,1,1099,1715,0
51551190726,51551190730,4,646,1190,0
51552592048,51552592058,10,344,1180,0
51553263571,51553263577,6,3500,1937,0
51559016050,51559016052,2,1155,1798,0
51560136127,51560136129,2,1273,973,0
51561610173,51561610172,-1,1348,1707,0
51565734421,51565734420,-1,1722,1799,0
51566197566,51566197565,-1,1257,1311,0
51573709082,51573709083,1,1109,1127,0
51574982856,51574982843,-13,670,1095,0
51578141075,51578141080,5,956,1105,0
51578601677,51578601677,0,1005,1438,0
51580234620,51580234618,-2,1121,1652,0
51587185617,51587185620,3,858,1671,0
51587869119,51587869100,-19,1436,2064,0
51590556991,51590556994,3,1402,1759,0
51592382233,51592382234,1,768,1083,0
51593029573,51593029575,2,1586,1633,0
51594580346,51594580348,2,764,1618,0
51595107579,51595107582,3,2946,1502,0
51595439274,51595439275,1,894,925,0
51596808220,51596808219,-1,1310,1551,0
51596975478,51596975490,12,187,911,0
51600343178,51600343177,-1,964,1738,0
51603135262,51603135266,4,1518,1377,0
51603388017,51603388014,-3,1775,1374,0
51603872363,51603872366,3,1555,1402,0
51604956726,51604956730,4,1491,1191,0
51605479305,51605479306,1,1825,1504,0
51606661042,51606661044,2,716,1494,0
51606997702,51606997702,0,1134,1848,0
51608371874,51608371874,0,1341,1909,0
51613237871,51613237871,0,1774,2205,0
51613587961,51613587962,1,1706,1786,0
51613625430,51613625430,0,1477,1691,0
51616582170,51616582172,2,1958,1745,0
51621063622,51621063608,-14,1779,1370,0
51623159503,51623159502,-1,1050,1105,0
51624896574,51624896576,2,1120,1875,0
51625772127,51625772128,1,1213,1300,0
51627038242,51627038245,3,1626,2022,0
51633371093,51633371094,1,1316,1415,0
51634658863,51634658862,-1,1055,1094,0
51636848637,51636848635,-2,4451,7277,0
51637393118,51637393119,1,1673,1746,0
51639744967,51639744975,8,2235,1065,0
51640249447,51640249445,-2,1802,1982,0
51641757082,51641757082,0,1289,1696,0
51642729502,51642729502,0,1367,1811,0
51646617518,51646617518,0,1181,1720,0
51647913546,51647913546,0,1643,1755,0
51648776753,51648776754,1,1302,1668,0
51649746837,51649746837,0,1474,2413,0
51650856094,51650856093,-1,2344,4491,0
51651976036,51651976035,-1,1807,2276,0
51652751623,51652751624,1,1603,2160,0
51653109198,51653109198,0,1326,1587,0
51653877801,51653877799,-2,1495,1651,0
51655099041,51655099042,1,859,1282,0
51660544010,51660544005,-5,57,1645,0
51662694765,51662694765,0,1819,2157,0
51665210633,51665210635,2,1402,1608,0
51671133685,51671133664,-21,1405,1688,0
51677134094,51677134097,3,1405,1172,0
51682344602,51682344602,0,1244,2003,0
51682807151,51682807149,-2,1863,2226,0
51684823039,51684823038,-1,1135,1176,0
51687579200,51687579201,1,1232,1715,0
51687775561,51687775561,0,1128,1683,0
51688137306,51688137307,1,1249,2533,0
51690892295,51690892296,1,1691,1725,0
51690983330,51690983329,-1,1237,1554,0
51692297316,51692297318,2,1701,1366,0
51693140698,51693140700,2,1173,1700,0
51694127649,51694127651,2,1378,1859,0
51694682982,51694682986,4,2818,1328,0
51698317711,51698317710,-1,1633,1491,0
51699823227,51699823228,1,1548,1644,0
51700604042,51700604042,0,1019,1846,0
51708699583,51708699582,-1,826,895,0
51710671411,51710671410,-1,1204,1120,0
51715633394,51715633398,4,1125,1195,0
51717024681,51717024682,1,705,1226,0
51719935145,51719935149,4,2057,1782,0
51722007199,51722007201,2,1166,1567,0
51724258310,51724258309,-1,957,1812,0
51731609449,51731609448,-1,1438,1652,0
51734498926,51734498927,1,1687,2227,0
51736421901,51736421901,0,1443,1403,0
51736969534,51736969533,-1,1677,1426,0
51737496980,51737496979,-1,1118,1918,0
51737946527,51737946547,20,1187,1438,0
51738061015,51738061015,0,1021,990,0
51738430443,51738430442,-1,1011,1460,0
51742160962,51742160963,1,1319,1668,0
51745324955,51745324956,1,1607,1815,0
51747770953,51747770958,5,2682,2064,0
51749534855,51749534856,1,1225,1379,0
51754326214,51754326214,0,1520,1541,0
51759717333,51759717333,0,1144,1443,0
51761066714,51761066713,-1,1131,1191,0
51764254788,51764254788,0,1269,1372,0
51771904127,51771904128,1,1469,1687,0
51774598534,51774598532,-2,1696,1764,0
51780070644,51780070658,14,198,9960,0
51780695578,51780695571,-7,1333,4430,0
51783017326,51783017325,-1,1792,2421,0
51783137081,51783137081,0,6540,7658,0
51783283589,51783283589,0,1497,1530,0
51788135823,51788135822,-1,1312,1650,0
51788586546,51788586546,0,1059,1879,0
51791070102,51791070103,1,1438,1956,0
51791995053,51791995052,-1,874,1360,0
51793456283,51793456282,-1,1435,1371,0
51795188198,51795188199,1,1299,1619,0
51796014795,51796014797,2,1471,2256,0
51799398312,51799398313,1,1289,1861,0
51800641729,51800641730,1,1887,1930,0
51802444903,51802444905,2,1510,1397,0
51802729951,51802729952,1,887,785,0
51803839754,51803839754,0,1607,1767,0
51803911859,51803911860,1,1800,2834,0
51804047302,51804047301,-1,1179,2094,0
51808575963,51808575965,2,1874,1918,0
51812150493,51812150493,0,1705,1595,0
51814785502,51814785502,0,1127,1694,0
51817444681,51817444683,2,1764,1939,0
51818487923,51818487922,-1,1242,1356,0
51818787297,51818787298,1,1259,1355,0
51818947107,51818947106,-1,1501,1445,0
51819371782,51819371782,0,1464,1923,0
51819503678,51819503678,0,1048,951,0
51821784965,51821784965,0,839,1480,0
51823367254,51823367253,-1,1040,1823,0
51825897289,51825897290,1,1854,2200,0
51826030077,51826030078,1,1249,1454,0
51827318342,51827318342,0,1749,2364,0
51828396118,51828396118,0,1157,1719,0
51832973597,51832973596,-1,1346,1432,0
51833283105,51833283106,1,1106,1584,0
51837477757,51837477758,1,1004,1154,0
51838375763,51838375743,-20,794,880,0
51840459866,51840459865,-1,1068,1275,0
51841988771,51841988771,0,1547,2064,0
51842022199,51842022199,0,1648,1347,0
51843054754,51843054754,0,1410,2432,0
51846246542,51846246541,-1,1061,1025,0
51851439850,51851439851,1,1150,1979,0
51851780091,51851780089,-2,1073,2181,0
51852757258,51852757264,6,6964,3330,0
51858476702,51858476702,0,1962,2399,0
51858732078,51858732078,0,1271,1721,0
51861048596,51861048594,-2,1194,1466,0
51865352394,51865352391,-3,1076,1375,0
51866939323,51866939302,-21,1027,1850,0
51867311304,51867311305,1,1915,2156,0
51868094135,51868094134,-1,1316,2560,0
51868436059,51868436055,-4,2123,4089,0
51869211741,51869211740,-1,2149,2794,0
51869529325,51869529327,2,1480,2088,0
51869706059,51869706056,-3,2232,5510,0
51871570454,51871570455,1,1097,1233,0
51874546146,51874546145,-1,1522,2349,0
51875012845,51875012844,-1,1173,1044,0
51875671091,51875671091,0,1085,1357,0
51880115502,51880115505,3,1654,1799,0
51882903925,51882903904,-21,1571,1614,0
51883556890,51883556889,-1,1378,2246,0
51890614275,51890614275,0,1439,1921,0
51892254742,51892254743,1,1645,1580,0
51895324730,51895324736,6,4275,1614,0
51895495527,51895495527,0,988,1276,0
51896106857,51896106857,0,1046,1804,0
51898722293,51898722294,1,1124,1259,0
51899239414,51899239416,2,537,1167,0
51900918186,51900918187,1,1280,1340,0
51901292057,51901292057,0,1110,1687,0
51904090030,51904090028,-2,2856,3967,0
51905909621,51905909621,0,1632,1375,0
51906082362,51906082361,-1,1179,1120,0
51906132785,51906132786,1,1139,1618,0
51906381341,51906381341,0,1092,1609,0
51907536394,51907536393,-1,705,1367,0
51909131768,51909131770,2,1273,1734,0
51914236210,51914236210,0,1475,1627,0
51915362603,51915362602,-1,1329,1281,0
51919662468,51919662469,1,1604,2090,0
51920421089,51920421089,0,2082,1521,0
51921061250,51921061255,5,1993,1229,0
51921377505,51921377510,5,1062,1316,0
51923564222,51923564222,0,766,1833,0
51925540602,51925540601,-1,1157,1548,0
51933057929,51933057930,1,1440,1930,0
51935139951,51935139951,0,1378,1926,0
51935224958,51935224957,-1,1482,2005,0
51936185650,51936185649,-1,1252,1354,0
51937255017,51937255018,1,1766,1379,0
51937382088,51937382089,1,1486,1933,0
51941579722,51941579723,1,1488,1338,0
51944914020,51944914019,-1,1908,2580,0
51945366585,51945366585,0,1274,1851,0
51945660330,51945660329,-1,2579,4138,0
51947062591,51947062591,0,1307,1730,0
51948398778,51948398770,-8,912,3268,0
51948678078,51948678079,1,1252,2111,0
51948853453,51948853455,2,1432,1047,0
51949592251,51949592251,0,1141,1273,0
51952302375,51952302375,0,413,1100,0
51954132986,51954132987,1,1265,1634,0
51957664747,51957664749,2,1218,1661,0
51959601337,51959601337,0,2015,2278,0
51960424799,51960424810,11,926,1020,0
51962720756,51962720756,0,1067,1669,0
51962763848,51962763849,1,2107,1798,0
51973491236,51973491243,7,3224,1242,0
51973935339,51973935339,0,1257,2245,0
51976027861,51976027862,1,1658,2684,0
51979492131,51979492134,3,1117,1389,0
51980414007,51980414014,7,19453,56809,0
51980986736,51980986736,0,988,1470,0
51986455245,51986455246,1,1612,1604,0
51986525318,51986525321,3,2778,1570,0
51988796816,51988796817,1,1455,1815,0
51989104878,51989104878,0,1347,1749,0
51989492133,51989492131,-2,1006,1118,0
51993152333,51993152335,2,1869,1896,0
51995298854,51995298854,0,1876,2338,0
51998847230,51998847230,0,1298,1680,0
51999588682,51999588683,1,1113,1564,0
52002782299,52002782299,0,1193,890,0
52007404170,52007404172,2,1785,1717,0
52008328634,52008328634,0,1566,1770,0
52008983974,52008983974,0,1758,2346,0
52011211309,52011211309,0,1158,1698,0
52013331521,52013331523,2,1420,1286,0
52013572580,52013572579,-1,1559,1461,0
52014240190,52014240186,-4,1381,1114,0
52017587583,52017587586,3,374,776,0
52021067924,52021067932,8,46919,20139,0
52021130890,52021130892,2,1797,1057,0
52023692719,52023692719,0,1869,1896,0
52024969409,52024969410,1,1387,1490,0
52026390926,52026390928,2,669,1269,0
52027300351,52027300351,0,1448,1789,0
52028630749,52028630751,2,2313,1966,0
52029116604,52029116605,1,1811,2261,0
52029861302,52029861305,3,852,778,0
52032921039,52032921039,0,858,1715,0
52034408214,52034408215,1,1526,1505,0
52035902216,52035902223,7,9463,35143,0
52038932239,52038932237,-2,1384,1348,0
52045454232,52045454236,4,1396,1801,0
52050872233,52050872231,-2,2816,4960,0
52053793669,52053793669,0,1674,1735,0
52055994355,52055994362,7,4685,2268,0
52058915250,52058915250,0,917,1771,0
52059860313,52059860314,1,1545,1405,0
52061143893,52061143895,2,1303,2014,0
52062772678,52062772677,-1,1320,1740,0
52064766541,52064766542,1,1614,2039,0
52068338804,52068338806,2,1745,2093,0
52072798767,52072798766,-1,864,1779,0
52073401206,52073401209,3,1907,1448,0
52075985390,52075985396,6,1609,1397,0
52077010713,52077010715,2,1491,1562,0
52080495316,52080495316,0,727,1913,0
52081824154,52081824153,-1,1341,1709,0
52083305607,52083305607,0,1552,2422,0
52084149395,52084149395,0,1421,1373,0
52086206597,52086206598,1,1599,1171,0
52087457421,52087457422,1,1973,1828,0
52088682365,52088682365,0,1441,1494,0
52090093761,52090093759,-2,1948,4001,0
52090809729,52090809730,1,1972,2184,0
52092465127,52092465130,3,974,1226,0
52093511175,52093511178,3,1539,1714,0
52095012607,52095012605,-2,1248,1729,0
52096471953,52096471951,-2,1198,1898,0
52097155542,52097155542,0,1223,1093,0
52102495318,52102495315,-3,1287,2032,0
52105259679,52105259681,2,989,2039,0
52111294195,52111294197,2,1659,1584,0
52111784100,52111784096,-4,1724,5405,0
52112778038,52112778038,0,1630,1484,0
52113438544,52113438544,0,1154,1429,0
52115782513,52115782517,4,4963,27091,0
52117274222,52117274222,0,1306,1887,0
52122232494,52122232494,0,639,1448,0
52122736446,52122736446,0,992,1736,0
52126391739,52126391743,4,1772,846,0
52126538637,52126538637,0,1420,1470,0
52126827402,52126827383,-19,948,1429,0
52128198362,52128198361,-1,4169,13346,0
52130630353,52130630355,2,1672,1650,0
52131117475,52131117475,0,1225,1449,0
52131530358,52131530357,-1,1434,1895,0
52131774294,52131774292,-2,529,1225,0
52132898419,52132898418,-1,1547,1355,0
52133513085,52133513081,-4,879,1895,0
52133981150,52133981150,0,1631,1843,0
52145366750,52145366750,0,1701,2014,0
52146227939,52146227940,1,1768,1456,0
52148872026,52148872031,5,3243,1618,0
52150078049,52150078050,1,1713,1805,0
52151602793,52151602793,0,1690,1366,0
52152293147,52152293150,3,2218,2192,0
52152412458,52152412459,1,1452,1626,0
52154320482,52154320482,0,1093,1821,0
52155194438,52155194439,1,1212,1108,0
52156838652,52156838652,0,1342,1600,0
52162237563,52162237563,0,1856,1904,0
52162928442,52162928443,1,1584,1546,0
52164542866,52164542866,0,927,1003,0
52166967022,52166967020,-2,1756,1631,0
52167797818,52167797822,4,589,766,0
52171093470,52171093471,1,958,1453,0
52174241132,52174241133,1,2092,2051,0
52174644929,52174644922,-7,2252,11873,0
52175186289,52175186289,0,1374,1548,0
52181954173,52181954175,2,1814,1317,0
52184183625,52184183623,-2,1179,1660,0
52185497206,52185497207,1,2125,1334,0
52187453295,52187453302,7,3772,1470,0
52188052389,52188052389,0,2181,2198,0
52189116266,52189116267,1,2134,1827,0
52191689385,52191689385,0,1173,1108,0
52193655202,52193655203,1,1317,1766,0
52195676916,52195676916,0,1374,1347,0
52198420494,52198420494,0,1325,1898,0
52198514395,52198514396,1,1103,1391,0
52199033721,52199033735,14,1034,1577,0
52202028278,52202028281,3,1192,1551,0
52205337466,52205337465,-1,1488,1986,0
52206048889,52206048890,1,1128,1612,0
52207311018,52207311018,0,1230,1551,0
52211385635,52211385637,2,1668,1438,0
52212905426,52212905425,-1,1370,2530,0
52218513719,52218513719,0,1579,1880,0
52222065062,52222065062,0,1064,1224,0
52222381417,52222381418,1,1420,1301,0
52225607062,52225607061,-1,1726,1819,0
52226402923,52226402926,3,1405,1813,0
52229581699,52229581694,-5,1218,2790,0
52230268845,52230268841,-4,1349,2418,0
52231197181,52231197177,-4,1227,3585,0
52232381527,52232381525,-2,1268,1820,0
52233082946,52233082946,0,1720,2260,0
52234225765,52234225766,1,1629,2097,0
52238143898,52238143899,1,1520,1690,0
52239584675,52239584677,2,1937,1445,0
52246038803,52246038800,-3,1078,3095,0
52250495311,52250495309,-2,1172,1112,0
52252712334,52252712335,1,1019,1965,0
52254552356,52254552355,-1,1387,1450,0
52261931452,52261931456,4,1856,1196,0
52264824642,52264824642,0,1403,1727,0
52266455035,52266455035,0,1326,1813,0
52271023490,52271023489,-1,1479,2061,0
52271558752,52271558755,3,1382,1139,0
52273278063,52273278064,1,1839,1064,0
52274567235,52274567234,-1,1538,1644,0
52276418504,52276418507,3,2163,2509,0
52282184791,52282184790,-1,1836,2128,0
52282919616,52282919616,0,1304,1856,0
52283157634,52283157634,0,1282,1315,0
52283666069,52283666067,-2,1372,2082,0
52283836725,52283836724,-1,1198,1898,0
52292950461,52292950462,1,1673,2157,0
52294456255,52294456254,-1,2088,1596,0
52296957937,52296957944,7,3097,1682,0
52297941270,52297941269,-1,1021,1991,0
52298105402,52298105406,4,1420,2143,0
52299178377,52299178379,2,1004,1109,0
52300295107,52300295107,0,873,1709,0
52301190279,52301190278,-1,1279,1735,0
52301256940,52301256940,0,1322,1937,0
52301944966,52301944945,-21,990,1188,0
52303649038,52303649039,1,1539,1902,0
52306186555,52306186559,4,901,955,0
52306626376,52306626359,-17,1349,1158,0
52308431571,52308431570,-1,1414,1810,0
52311692474,52311692474,0,1045,1289,0
52312394622,52312394624,2,1135,1897,0
52313253589,52313253589,0,1289,1873,0
52313767078,52313767078,0,1288,1430,0
52314156105,52314156106,1,1235,1279,0
52318154066,52318154071,5,1397,1532,0
52319103806,52319103810,4,1288,900,0
52323724815,52323724814,-1,1482,1713,0
52323946487,52323946487,0,1634,1533,0
52326142333,52326142333,0,1314,2128,0
52327556345,52327556351,6,2737,1092,0
52330434119,52330434125,6,2377,1699,0
52332429079,52332429078,-1,776,2099,0
52333061936,52333061918,-18,459,1801,0
52334115145,52334115145,0,1199,1240,0
52335014365,52335014367,2,1690,1337,0
52337205850,52337205858,8,2363,988,0
52338068594,52338068591,-3,1951,1608,0
52338576856,52338576859,3,1435,1975,0
52339061109,52339061110,1,1527,1273,0
52346458834,52346458836,2,1495,1804,0
52347497686,52347497682,-4,742,1961,0
52351958565,52351958566,1,1584,2119,0
52354978419,52354978418,-1,1311,2202,0
52357898799,52357898799,0,2213,1969,0
52361151554,52361151554,0,2029,2608,0
52361358222,52361358225,3,1196,1267,0
52363634585,52363634586,1,1020,2104,0
52364880361,52364880362,1,1379,1779,0
52372985224,52372985225,1,32529,19922,0
52374919832,52374919832,0,2194,3135,0
52375227965,52375227966,1,1808,1800,0
52375454609,52375454615,6,3004,908,0
52375838587,52375838589,2,984,2018,0
52377304143,52377304142,-1,1407,1390,0
52379221314,52379221314,0,1671,2373,0
52380659544,52380659543,-1,1306,1465,0
52387461326,52387461326,0,1189,1337,0
52387871370,52387871367,-3,1604,4897,0
52390575698,52390575698,0,1552,1737,0
52390678034,52390678034,0,1524,1222,0
52391834251,52391834250,-1,952,1318,0
52392498211,52392498211,0,1325,1974,0
52395088264,52395088259,-5,820,3422,0
52395984945,52395984944,-1,825,1593,0
52398436701,52398436687,-14,1286,1542,0
52399738350,52399738354,4,715,779,0
52400912270,52400912272,2,1272,1475,0
52401320231,52401320230,-1,2182,2745,0
52409068633,52409068633,0,1008,1257,0
52409299249,52409299250,1,1618,1730,0
52409616295,52409616297,2,1048,1565,0
52410893346,52410893344,-2,779,1269,0
52412793086,52412793087,1,877,961,0
52414299532,52414299531,-1,1336,1907,0
52416329554,52416329554,0,1303,1448,0
52418625367,52418625362,-5,2012,10027,0
52420894020,52420894018,-2,1527,2086,0
52421231569,52421231569,0,1192,1914,0
52426405327,52426405329,2,1558,2367,0
52428816293,52428816295,2,1688,1189,0
52429112973,52429112975,2,1833,1467,0
52430656125,52430656125,0,1552,2142,0
52434495015,52434495016,1,1039,1672,0
52435275362,52435275365,3,1842,1453,0
52436068970,52436068972,2,1968,1888,0
52437358269,52437358269,0,1529,1625,0
52438459444,52438459446,2,1335,1443,0
52444173182,52444173183,1,2036,1733,0
52447237515,52447237515,0,1772,1882,0
52447699274,52447699273,-1,1495,1803,0
52448969798,52448969797,-1,1097,1166,0
52451329687,52451329685,-2,1207,1452,0
52453977883,52453977882,-1,954,1641,0
52455077793,52455077791,-2,1581,2185,0
52455137454,52455137454,0,1518,1720,0
52460862209,52460862209,0,1209,1237,0
52461400846,52461400847,1,1904,1650,0
52462462068,52462462065,-3,1557,1880,0
52463302332,52463302334,2,1530,1358,0
52467379891,52467379890,-1,1044,1791,0
52467694786,52467694789,3,1265,1771,0
52468278582,52468278583,1,1297,1561,0
52470073210,52470073209,-1,1220,2001,0
52480573127,52480573126,-1,1543,1717,0
52480893317,52480893318,1,1467,1793,0
52481929474,52481929474,0,1020,932,0
52483687423,52483687421,-2,1301,1551,0
52488557431,52488557432,1,1432,1401,0
52489497209,52489497205,-4,1302,3156,0
52494241926,52494241928,2,1014,1765,0
52494409090,52494409088,-2,857,1160,0
52498757373,52498757374,1,1308,1643,0
52500832436,52500832434,-2,1208,1176,0
52502152408,52502152408,0,1335,2087,0
52503666408,52503666408,0,1388,1166,0
52503739794,52503739797,3,1291,1593,0
52508832345,52508832352,7,1746,1896,0
52511508599,52511508602,3,1341,1609,0
52511932290,52511932270,-20,763,1244,0
52515072023,52515072025,2,744,1162,0
52516101767,52516101769,2,1550,1684,0
52520970895,52520970896,1,1046,1818,0
52523041555,52523041555,0,1524,1793,0
52524826411,52524826411,0,1473,1763,0
52525008817,52525008816,-1,1776,2506,0
52526786686,52526786686,0,1520,1551,0
52529798713,52529798714,1,1821,2080,0
52530498492,52530498492,0,1118,2186,0
52531877271,52531877250,-21,1393,2142,0
52532143921,52532143919,-2,1100,2239,0
52533360603,52533360581,-22,1039,1114,0
52533654766,52533654787,21,1197,1275,0
52537055392,52537055392,0,1993,2008,0
52538102104,52538102103,-1,1160,1099,0
52539013410,52539013411,1,1686,2175,0
52540842237,52540842238,1,1630,1213,0
52541012039,52541012031,-8,968,871,0
52541626962,52541626962,0,1149,1862,0
52541655078,52541655079,1,1109,1048,0
52542123994,52542123989,-5,1487,5318,0
52543031492,52543031493,1,1728,1850,0
52546880465,52546880467,2,1717,1873,0
52547042785,52547042786,1,1520,1175,0
52550523030,52550523033,3,1384,1998,0
52550828234,52550828235,1,1413,1957,0
52551786087,52551786087,0,1150,984,0
52553786586,52553786588,2,1806,1693,0
52554445930,52554445931,1,1052,1320,0
52556141942,52556141942,0,1538,1567,0
52557353075,52557353075,0,1208,1592,0
52557837626,52557837625,-1,1486,1214,0
52559794634,52559794637,3,1407,1446,0
52559890001,52559890001,0,1602,1540,0
52561538721,52561538720,-1,1159,1525,0
52568337734,52568337734,0,1526,2175,0
52568864514,52568864513,-1,1419,2225,0
52570510070,52570510072,2,1405,1601,0
52571841011,52571841011,0,1040,1867,0
52574277393,52574277393,0,1399,1645,0
52575185638,52575185638,0,938,1706,0
52585975038,52585975037,-1,1244,1715,0
52587043765,52587043766,1,1621,2208,0
52587621773,52587621777,4,769,849,0
52588930211,52588930211,0,1343,1710,0
52589834539,52589834539,0,1098,1039,0
52595765877,52595765884,7,3055,1622,0
52595943345,52595943346,1,1928,1997,0
52595974621,52595974612,-9,40596,12821,0
52596296401,52596296401,0,1444,1699,0
52598930519,52598930518,-1,1753,1297,0
52599991910,52599991910,0,1185,2218,0
52600322522,52600322525,3,2035,1929,0
52600492887,52600492889,2,937,1537,0
52602066325,52602066346,21,693,913,0
52603104237,52603104236,-1,1080,1856,0
52605117127,52605117130,3,1650,1626,0
52608182852,52608182847,-5,767,1700,0
52609773862,52609773863,1,1488,1142,0
52611809677,52611809675,-2,571,1059,0
52617845162,52617845162,0,1247,1438,0
52618162070,52618162072,2,2031,2181,0
52618275197,52618275197,0,1072,1360,0
52618811183,52618811168,-15,905,898,0
52621011162,52621011164,2,1218,1721,0
52621122657,52621122657,0,880,1569,0
52624456752,52624456755,3,1470,1990,0
52625113641,52625113642,1,1146,1347,0
52626362296,52626362298,2,1928,1943,0
52627412747,52627412746,-1,1142,1466,0
52631370015,52631370017,2,978,2044,0
52632951391,52632951390,-1,1213,1761,0
52633049489,52633049490,1,986,1302,0
52634582293,52634582279,-14,1114,1828,0
52637306258,52637306259,1,1351,1982,0
52638967306,52638967305,-1,2975,4603,0
52642128373,52642128375,2,1743,1863,0
52642203795,52642203795,0,1310,1872,0
52647963202,52647963202,0,997,1284,0
52649039514,52649039511,-3,1204,3357,0
52652055279,52652055281,2,1176,1619,0
52652822959,52652822960,1,1052,1919,0
52653166386,52653166387,1,1520,2467,0
52654498525,52654498525,0,1244,1767,0
52656127661,52656127657,-4,1343,2814,0
52661580482,52661580482,0,1912,2127,0
52661794450,52661794452,2,1629,1883,0
52662788111,52662788111,0,1875,2455,0
52663405867,52663405870,3,1627,1678,0
52664518062,52664518062,0,1637,2186,0
52664651754,52664651751,-3,1207,2402,0
52668674855,52668674858,3,1642,2299,0
52668778520,52668778519,-1,1331,1684,0
52670678062,52670678062,0,1957,2269,0
52672839579,52672839585,6,1360,1053,0
52673057763,52673057763,0,1496,1771,0
52673355363,52673355365,2,1921,1956,0
52674255672,52674255671,-1,1306,1975,0
52682702370,52682702370,0,6701,9232,0
52683429286,52683429285,-1,1702,1847,0
52685582435,52685582435,0,1023,1605,0
52688707950,52688707954,4,1896,1947,0
52691064218,52691064220,2,1105,1675,0
52692572266,52692572266,0,1300,988,0
52692849155,52692849157,2,1884,1841,0
52694220701,52694220702,1,1054,1362,0
52697962869,52697962868,-1,1605,1841,0
52699491730,52699491731,1,998,1849,0
52703572669,52703572670,1,1142,3085,0
52703717527,52703717526,-1,1152,1485,0
52705720593,52705720592,-1,1660,2108,0
52706792173,52706792172,-1,1769,1521,0
52708232981,52708232978,-3,886,1184,0
52712227634,52712227638,4,1530,1433,0
52713472359,52713472361,2,1304,1649,0
52716127290,52716127292,2,1250,1600,0
52716329583,52716329584,1,1157,1575,0
52716836325,52716836325,0,1248,2311,0
52717566495,52717566493,-2,863,1595,0
52719062446,52719062444,-2,1152,1615,0
52721423678,52721423678,0,1389,1580,0
52722824278,52722824280,2,1671,1917,0
52723265521,52723265522,1,846,1189,0
52726932930,52726932929,-1,1459,1744,0
52732145762,52732145761,-1,1289,1348,0
52734352542,52734352545,3,1358,2250,0
52739100559,52739100559,0,1419,2887,0
52740031716,52740031714,-2,1024,1363,0
52740899767,52740899766,-1,1713,2135,0
52743464838,52743464839,1,1078,1309,0
52745814058,52745814058,0,1305,1504,0
52745919366,52745919365,-1,1181,1055,0
52746751973,52746751967,-6,1098,2889,0
52747784890,52747784891,1,1939,1680,0
52748721141,52748721134,-7,1132,5630,0
52749154526,52749154528,2,974,1662,0
52750884810,52750884809,-1,1132,2260,0
52752843613,52752843611,-2,1565,1868,0
52753700543,52753700542,-1,1046,1828,0
52753927458,52753927459,1,1059,1645,0
52760500977,52760500973,-4,1472,4808,0
52762016823,52762016824,1,1213,1643,0
52764775569,52764775567,-2,2774,4308,0
52767414327,52767414322,-5,921,2208,0
52773820138,52773820138,0,1082,1662,0
52779188741,52779188741,0,1170,1206,0
52781373122,52781373123,1,1665,2324,0
52782388666,52782388669,3,976,1363,0
52783658537,52783658535,-2,1294,1622,0
52789147482,52789147481,-1,1523,1746,0
52794608085,52794608086,1,1709,2140,0
52796493931,52796493931,0,2239,2648,0
52798348930,52798348929,-1,1659,1485,0
52804354243,52804354241,-2,1453,2431,0
52814661899,52814661901,2,1139,1593,0
52816176626,52816176630,4,1675,1664,0
52816504509,52816504510,1,2046,1748,0
52816755439,52816755439,0,1116,1461,0
52816791957,52816791960,3,1349,1607,0
52817487618,52817487618,0,1513,1171,0
52817532662,52817532679,17,654,2321,0
52818452689,52818452685,-4,1867,7279,0
52820012254,52820012257,3,1444,1923,0
52823306677,52823306676,-1,1458,1903,0
52826804242,52826804241,-1,1359,1339,0
52832549807,52832549807,0,1320,1606,0
52839498835,52839498835,0,1319,1715,0
52842711583,52842711583,0,1252,1920,0
52843016426,52843016426,0,1393,1650,0
52844769266,52844769269,3,841,963,0
52848697175,52848697174,-1,1951,2391,0
52848965773,52848965758,-15,820,347,0
52849190045,52849190045,0,1130,1319,0
52849346201,52849346204,3,1226,1254,0
52850085735,52850085737,2,964,1670,0
52851569665,52851569664,-1,1424,1655,0
52851852937,52851852938,1,742,885,0
52854666025,52854666024,-1,1397,1943,0
52855743621,52855743622,1,938,1339,0
52857969780,52857969798,18,304,2301,0
52858074318,52858074320,2,1090,1462,0
52858955322,52858955325,3,1368,1805,0
52862611502,52862611501,-1,1710,2006,0
52863784131,52863784131,0,1414,1867,0
52866725093,52866725093,0,1363,1747,0
52866820830,52866820831,1,1171,931,0
52867959387,52867959386,-1,2178,2040,0
52870915507,52870915507,0,1941,2112,0
52871792030,52871792032,2,1398,1716,0
52873846878,52873846878,0,1075,1733,0
52875559647,52875559650,3,1558,1373,0
52875617366,52875617366,0,1105,1771,0
52877249110,52877249112,2,1590,1930,0
52877590797,52877590798,1,1302,1509,0
52877850519,52877850522,3,1954,1730,0
52880146782,52880146783,1,1423,1466,0
52880428232,52880428231,-1,1492,1657,0
52881630578,52881630578,0,1005,1679,0
52881690219,52881690218,-1,1305,1186,0
52882488071,52882488070,-1,1176,1324,0
52884488633,52884488634,1,900,930,0
52891139871,52891139870,-1,2012,1978,0
52892133578,52892133578,0,1489,1903,0
52894027035,52894027039,4,3123,2305,0
52895391011,52895391010,-1,1232,1912,0
52896483482,52896483482,0,1687,1913,0
52897400370,52897400370,0,1133,1304,0
52898253754,52898253754,0,1310,2644,0
52899223239,52899223239,0,1262,1133,0
52899523550,52899523558,8,359,1919,0
52900218095,52900218087,-8,1502,1434,0
52901863003,52901863002,-1,1035,1637,0
52903401335,52903401336,1,1694,1842,0
52903748742,52903748743,1,1569,1985,0
52910024437,52910024437,0,1549,1606,0
52911837977,52911837987,10,17692,16703,0
52912078075,52912078073,-2,1221,1679,0
52914306634,52914306634,0,1367,1806,0
52917323330,52917323329,-1,1279,1400,0
52923152674,52923152674,0,1238,1969,0
52925476939,52925476940,1,1427,1571,0
52926455435,52926455431,-4,1061,1642,0
52931420085,52931420088,3,1274,2156,0
52931576863,52931576867,4,4888,2796,0
52933031366,52933031365,-1,1159,2079,0
52934863783,52934863782,-1,1294,2306,0
52938737769,52938737766,-3,722,1865,0
52939070361,52939070362,1,1565,1780,0
52939662956,52939662955,-1,1408,1650,0
52939716471,52939716473,2,1195,1356,0
52940047235,52940047234,-1,1081,1476,0
52950736650,52950736650,0,1301,1687,0
52952259474,52952259474,0,1121,1542,0
52953678520,52953678522,2,1909,1477,0
52956745286,52956745285,-1,1534,1651,0
52957661178,52957661186,8,4626,1556,0
52959022289,52959022289,0,1362,1442,0
52959886287,52959886289,2,1461,1106,0
52962997590,52962997591,1,1628,1794,0
52966305935,52966305937,2,1316,1841,0
52976634187,52976634187,0,1403,2289,0
52978757678,52978757679,1,1238,972,0
52980938471,52980938471,0,858,781,0
52982797215,52982797217,2,8635,6668,0
52982922886,52982922889,3,1166,1593,0
52983162348,52983162350,2,1539,1393,0
52983315705,52983315705,0,1351,2070,0
52987090319,52987090321,2,2090,1821,0
52988179729,52988179730,1,1366,1956,0
52988447766,52988447767,1,1299,2003,0
52997035373,52997035369,-4,992,969,0
52998011289,52998011290,1,1507,1553,0
53003022003,53003021998,-5,1051,2245,0
53006880716,53006880717,1,1864,1804,0
53007238351,53007238350,-1,1359,1282,0
53014037635,53014037637,2,1043,981,0
53015597228,53015597226,-2,1331,1640,0
53016321835,53016321838,3,1929,1827,0
53017747915,53017747915,0,1054,1566,0
53017940056,53017940057,1,1192,1702,0
53018400844,53018400847,3,1785,1240,0
53018976662,53018976663,1,1504,1646,0
53020440838,53020440838,0,1206,1899,0
53026498301,53026498301,0,1270,2373,0
53027381618,53027381621,3,2042,2039,0
53030680292,53030680288,-4,1093,2753,0
53032825770,53032825772,2,1281,1693,0
53033229047,53033229049,2,1542,2403,0
53040880470,53040880470,0,1455,2174,0
53045028213,53045028213,0,1441,1645,0
53050631051,53050631051,0,1150,1075,0
53057279015,53057279013,-2,1524,1084,0
53057856898,53057856899,1,1808,1578,0
53060938908,53060938909,1,1428,1398,0
53061272146,53061272146,0,1182,2106,0
53062216402,53062216422,20,1280,1986,0
53065011123,53065011123,0,1527,1621,0
53065749604,53065749605,1,1467,2638,0
53071456906,53071456906,0,1290,1111,0
53080803219,53080803220,1,763,1543,0
53087854801,53087854802,1,1387,1654,0
53088864654,53088864654,0,2068,2316,0
53090272202,53090272203,1,1098,1256,0
53096136453,53096136452,-1,1049,2379,0
53098084331,53098084330,-1,1048,1468,0
53100033525,53100033524,-1,1247,1362,0
53101584299,53101584301,2,1456,1692,0
53102210871,53102210873,2,1401,1862,0
53103755131,53103755134,3,1425,1645,0
53104715423,53104715426,3,1055,1774,0
53108122007,53108122008,1,2368,1798,0
53111777782,53111777784,2,1418,1861,0
53116050150,53116050152,2,1467,1637,0
53116398670,53116398670,0,1765,1764,0
53122200963,53122200961,-2,1901,2348,0
53124602954,53124602955,1,1879,1214,0
53125838297,53125838298,1,942,2061,0
53128206399,53128206417,18,1182,2287,0
53139387024,53139387023,-1,1089,1522,0
53139892403,53139892403,0,1452,2063,0
53140252073,53140252074,1,1395,1297,0
53140974071,53140974070,-1,1073,1863,0
53142354973,53142354981,8,1430,1412,0
53143224343,53143224344,1,1222,1565,0
53144669214,53144669215,1,1745,1734,0
53147255331,53147255330,-1,1996,1999,0
53148326266,53148326267,1,1456,1818,0
53148438627,53148438626,-1,1213,1676,0
53150538560,53150538559,-1,2612,3317,0
53150946378,53150946378,0,1414,2169,0
53152558793,53152558795,2,1651,1399,0
53153280227,53153280229,2,1599,1711,0
53158355824,53158355826,2,1191,1968,0
53159774607,53159774609,2,1533,2537,0
53162761223,53162761226,3,1203,1810,0
53163005462,53163005462,0,1508,1759,0
53168593406,53168593408,2,1539,1105,0
53171142654,53171142654,0,1349,1609,0
53175484473,53175484478,5,1125,923,0
53177395711,53177395711,0,1680,1676,0
53177448703,53177448702,-1,840,1353,0
53178648909,53178648903,-6,1527,4771,0
53178933771,53178933770,-1,1190,1294,0
53181819608,53181819604,-4,1718,1664,0
53184265451,53184265453,2,1023,1484,0
53185302041,53185302034,-7,3020,7642,0
53187374970,53187374971,1,1632,1414,0
53192002392,53192002393,1,2225,2109,0
53196673309,53196673310,1,1163,1570,0
53197671039,53197671038,-1,1110,1387,0
53200190782,53200190783,1,933,1778,0
53204986221,53204986221,0,1106,988,0
53206395149,53206395150,1,2425,2140,0
53206809034,53206809035,1,1615,1535,0
53207390730,53207390731,1,945,1459,0
53211318973,53211318978,5,2780,1152,0
53214184518,53214184518,0,1333,1708,0
53218547237,53218547238,1,1671,1972,0
53221676642,53221676642,0,1738,2105,0
53222351112,53222351113,1,1325,1406,0
53227555637,53227555637,0,1754,1865,0
53227761351,53227761351,0,1383,2057,0
53229754811,53229754813,2,1309,1277,0
53234912396,53234912396,0,1631,2351,0
53240276614,53240276616,2,5971,26885,0
53240603262,53240603262,0,2892,3084,0
53241809058,53241809058,0,1618,2327,0
53242009161,53242009165,4,1590,1393,0
53251924694,53251924694,0,1883,2347,0
53252365638,53252365641,3,1769,1717,0
53255850595,53255850594,-1,1544,1949,0
53257325454,53257325453,-1,1290,2047,0
53257433719,53257433720,1,932,1478,0
53260751186,53260751188,2,1910,1385,0
53263948593,53263948592,-1,1435,1413,0
53270983294,53270983293,-1,1874,1989,0
53272975491,53272975492,1,1287,1571,0
53274098569,53274098570,1,2372,2328,0
53274223607,53274223607,0,946,989,0
53274460103,53274460119,16,661,1285,0
53275325150,53275325150,0,1541,1782,0
53276883863,53276883863,0,1211,1265,0
53280158506,53280158508,2,745,1256,0
53280220994,53280220994,0,1329,1581,0
53282006357,53282006358,1,877,1069,0
53282665970,53282665970,0,1399,1415,0
53282781280,53282781281,1,1459,1780,0
53283135372,53283135373,1,960,1314,0
53283387928,53283387930,2,1330,1546,0
53285108082,53285108081,-1,1015,2049,0
53285560763,53285560761,-2,839,1282,0
53286606990,53286606990,0,1716,2094,0
53287238184,53287238186,2,1169,1104,0
53288107727,53288107729,2,1577,1691,0
53292437157,53292437155,-2,1450,2246,0
53293352438,53293352438,0,1374,1767,0
53298164902,53298164903,1,1186,1699,0
53302382899,53302382898,-1,848,1042,0
53303069071,53303069089,18,33,1129,0
53305035682,53305035684,2,1306,1271,0
53307353039,53307353039,0,1785,1790,0
53310299069,53310299070,1,1528,2061,0
53310802425,53310802426,1,1276,2017,0
53310850686,53310850706,20,823,1049,0
53313388298,53313388302,4,899,1302,0
53313572359,53313572339,-20,1096,2041,0
53314107577,53314107578,1,1944,1893,0
53320804149,53320804151,2,1530,1367,0
53321504318,53321504315,-3,2274,5494,0
53323321706,53323321712,6,3323,1770,0
53325214137,53325214138,1,1313,1453,0
53326913258,53326913258,0,1259,1563,0
53327927182,53327927181,-1,1169,1899,0
53331472498,53331472498,0,1133,1221,0
53333314346,53333314347,1,2272,2562,0
53336418972,53336418970,-2,1100,2047,0
53338740919,53338740920,1,1070,1165,0
53341301975,53341301978,3,1538,1484,0
53341693582,53341693579,-3,1314,2539,0
53342784318,53342784318,0,756,1838,0
53343156498,53343156499,1,1601,1617,0
53344372797,53344372799,2,1394,1772,0
53344966817,53344966817,0,1325,1143,0
53347212628,53347212625,-3,829,1679,0
53348514457,53348514458,1,1595,1907,0
53353633603,53353633604,1,1013,1373,0
53354663121,53354663122,1,1311,1702,0
53357570773,53357570774,1,1195,1926,0
53359119143,53359119142,-1,1129,1224,0
53359351296,53359351312,16,833,2412,0
53359443685,53359443685,0,1474,1902,0
53363445467,53363445466,-1,1178,1467,0
53364497597,53364497595,-2,1169,1892,0
53369550061,53369550062,1,1235,1668,0
53370181541,53370181540,-1,1545,2248,0
53370259629,53370259631,2,1689,1907,0
53371036238,53371036240,2,1119,1895,0
53371468553,53371468551,-2,1589,1463,0
53374320347,53374320346,-1,1126,1903,0
53376151569,53376151570,1,1915,1817,0
53377185554,53377185555,1,1513,1792,0
53380221582,53380221584,2,1323,1227,0
53381616135,53381616133,-2,708,889,0
53381952977,53381952977,0,800,1534,0
53386398938,53386398938,0,1816,2350,0
53389761426,53389761427,1,1542,1530,0
53391599354,53391599359,5,4433,1312,0
53391643587,53391643585,-2,1181,1579,0
53392471952,53392471953,1,1087,1457,0
53395657639,53395657637,-2,2930,3837,0
53396517032,53396517033,1,1354,1682,0
53401631653,53401631654,1,1282,2009,0
53402008295,53402008294,-1,1561,2051,0
53407258709,53407258709,0,1778,1622,0
53408748585,53408748586,1,1519,1466,0
53410374664,53410374662,-2,1299,2019,0
53412596842,53412596842,0,1705,1310,0
53412954042,53412954043,1,1523,1770,0
53413406912,53413406913,1,1757,2238,0
53417420062,53417420062,0,953,962,0
53418209690,53418209692,2,1021,1542,0
53421794266,53421794266,0,1310,1366,0
53424689690,53424689690,0,1347,1679,0
53428283451,53428283449,-2,1810,2115,0
53438273345,53438273349,4,2283,1872,0
53441614210,53441614211,1,1783,2387,0
53442154298,53442154300,2,2159,1494,0
53442395839,53442395839,0,1478,2106,0
53443218577,53443218577,0,2001,2096,0
53447129273,53447129273,0,1302,1790,0
53453795629,53453795630,1,2100,2219,0
53453997779,53453997778,-1,1511,1601,0
53460344848,53460344848,0,1318,1325,0
53477429770,53477429766,-4,1178,1625,0
53477700770,53477700749,-21,2140,1682,0
53486020061,53486020062,1,1328,1698,0
53487178886,53487178885,-1,1418,1941,0
53488395338,53488395342,4,1546,1485,0
53496708970,53496708970,0,1363,1486,0
53501482482,53501482481,-1,1534,2214,0
53503249762,53503249763,1,1052,1888,0
53505930405,53505930406,1,1359,1254,0
53508542350,53508542346,-4,927,2721,0
53510858552,53510858566,14,18221,48009,0
53514200685,53514200686,1,848,1401,0
53514629873,53514629874,1,1495,1423,0
53515191387,53515191388,1,1397,1608,0
53515397207,53515397208,1,1840,2214,0
53524100343,53524100344,1,1255,1992,0
53525070400,53525070399,-1,1178,1565,0
53525471037,53525471035,-2,1299,1628,0
53525927983,53525927983,0,999,1278,0
53528001976,53528001977,1,2141,1914,0
53528543106,53528543102,-4,1368,2219,0
53530724763,53530724762,-1,1361,1927,0
53532916623,53532916622,-1,892,1601,0
53535094411,53535094412,1,1082,1248,0
53535643147,53535643148,1,1084,1437,0
53535996362,53535996359,-3,1391,1943,0
53537040691,53537040689,-2,1320,1913,0
53537288406,53537288405,-1,1955,2217,0
53539874590,53539874592,2,1751,2288,0
53540586822,53540586822,0,1248,1641,0
53546611677,53546611674,-3,1924,1809,0
53549151518,53549151518,0,1564,2137,0
53549482071,53549482057,-14,1579,2303,0
53551428549,53551428554,5,2537,1399,0
53552455070,53552455070,0,1326,1886,0
53553738565,53553738565,0,1375,1763,0
53554966035,53554966034,-1,1037,1351,0
53556021273,53556021274,1,1649,1969,0
53561012790,53561012790,0,1675,1525,0
53563108622,53563108621,-1,1553,1823,0
53565879362,53565879361,-1,1198,1686,0
53566708562,53566708549,-13,1172,1025,0
53567341405,53567341406,1,1294,1767,0
53570542554,53570542555,1,2348,2504,0
53571703999,53571704000,1,1179,1601,0
53572234583,53572234582,-1,1303,2080,0
53573182376,53573182376,0,1221,1474,0
53573813594,53573813595,1,1606,2464,0
53574468445,53574468448,3,1839,1813,0
53574634157,53574634159,2,1423,1435,0
53575078306,53575078306,0,1382,2029,0
53578687429,53578687426,-3,1201,1629,0
53580291701,53580291702,1,1416,2104,0
53580798249,53580798249,0,2017,1987,0
53580929056,53580929057,1,1332,1899,0
53581035545,53581035546,1,1425,1261,0
53581700463,53581700462,-1,993,1026,0
53586180481,53586180482,1,1032,1432,0
53590347715,53590347717,2,1333,1709,0
53596270278,53596270276,-2,875,1623,0
53598389443,53598389446,3,3312,2220,0
53598520574,53598520573,-1,1209,2723,0
53599169211,53599169210,-1,1887,1610,0
53600752684,53600752684,0,1604,2309,0
53601126563,53601126563,0,2617,3439,0
53602043802,53602043803,1,1036,1379,0
53603427939,53603427938,-1,2435,3276,0
53604007287,53604007289,2,1304,1645,0
53606445426,53606445430,4,2386,1580,0
53610890267,53610890266,-1,1515,1576,0
53611786608,53611786606,-2,1467,2055,0
53614466802,53614466801,-1,1574,2103,0
53615134792,53615134794,2,1039,1247,0
53617953554,53617953556,2,1327,1781,0
53623152310,53623152311,1,801,984,0
53624857599,53624857601,2,1232,1326,0
53626795150,53626795151,1,1698,2244,0
53627179433,53627179433,0,1037,1198,0
53629900016,53629900014,-2,1046,2142,0
53630552070,53630552071,1,1716,2572,0
53635805858,53635805859,1,853,1563,0
53639882865,53639882864,-1,1671,2311,0
53640779221,53640779222,1,1322,2609,0
53641981192,53641981192,0,874,1524,0
53648300169,53648300169,0,1053,1497,0
53651642544,53651642545,1,918,913,0
53652196253,53652196253,0,1528,1316,0
53657040015,53657040013,-2,884,1423,0
53660055620,53660055615,-5,804,4327,0
53660124807,53660124807,0,1767,1218,0
53663319646,53663319646,0,1628,1853,0
53665119380,53665119381,1,1249,2204,0
53668510606,53668510605,-1,1736,2333,0
53671073408,53671073409,1,1342,1721,0
53674321326,53674321328,2,1278,1402,0
53676096120,53676096122,2,1263,1175,0
53676781920,53676781929,9,289,5641,0
53679491859,53679491859,0,1872,1536,0
53681446002,53681446003,1,1364,1547,0
53682566718,53682566718,0,1801,1721,0
53682843038,53682843038,0,2122,2037,0
53685171531,53685171531,0,927,1421,0
53685751870,53685751870,0,705,685,0
53687571597,53687571597,0,1603,1710,0
53689164580,53689164584,4,4897,2710,0
53691078463,53691078465,2,1680,1651,0
53694570459,53694570455,-4,1067,2944,0
53695689567,53695689569,2,1082,1422,0
53695940819,53695940816,-3,1959,5185,0
53696961334,53696961333,-1,924,1636,0
53697954739,53697954738,-1,800,1073,0
53698807519,53698807520,1,1971,1801,0
53701377163,53701377164,1,1817,2020,0
53710314281,53710314281,0,1633,1572,0
53713478817,53713478818,1,1474,1841,0
53714505022,53714505024,2,1519,1103,0
53716122378,53716122377,-1,1128,1218,0
53721221001,53721221001,0,1665,1976,0
53722251365,53722251363,-2,1499,1590,0
53728008627,53728008627,0,2051,2950,0
53728265186,53728265187,1,1521,1974,0
53728628340,53728628341,1,1444,1788,0
53729798330,53729798330,0,1538,2282,0
53730462218,53730462218,0,1769,2604,0
53731006247,53731006248,1,1282,2095,0
53731600205,53731600206,1,1877,1530,0
53732993110,53732993111,1,1217,1785,0
53734440406,53734440404,-2,1901,3409,0
53736480655,53736480655,0,1064,1404,0
53738258771,53738258770,-1,735,1655,0
53738937980,53738937978,-2,1506,1293,0
53742876294,53742876296,2,1428,1591,0
53744677159,53744677161,2,1353,1153,0
53746499874,53746499870,-4,1125,1323,0
53747719447,53747719447,0,1443,2375,0
53747927386,53747927387,1,1319,1068,0
53748998570,53748998571,1,2060,1854,0
53750451406,53750451405,-1,1598,2380,0
53750566316,53750566316,0,1122,1608,0
53751431136,53751431129,-7,1031,5230,0
53751974967,53751974987,20,926,1443,0
53754642268,53754642273,5,2547,1794,0
53755481441,53755481441,0,1147,1703,0
53757077237,53757077218,-19,919,1914,0
53759117139,53759117141,2,1003,1666,0
53760434889,53760434892,3,1363,1594,0
53760485907,53760485907,0,1457,1522,0
53765353899,53765353902,3,1411,1658,0
53765565218,53765565221,3,1031,1287,0
53768298368,53768298368,0,41081,25777,0
53768540385,53768540383,-2,1241,2067,0
53770226807,53770226805,-2,987,1860,0
53770860349,53770860350,1,1458,1550,0
53772987277,53772987274,-3,1056,1125,0
53774442234,53774442234,0,1277,2124,0
53775646317,53775646318,1,2312,3006,0
53775923639,53775923639,0,1833,2133,0
53776802649,53776802650,1,1549,2281,0
53777214129,53777214121,-8,1231,4739,0
53777437326,53777437321,-5,1125,2560,0
53779348947,53779348946,-1,1035,1865,0
53781655309,53781655313,4,1763,1414,0
53782370338,53782370339,1,1207,1034,0
53785151830,53785151832,2,690,1210,0
53786019251,53786019251,0,1092,1716,0
53786060645,53786060647,2,1416,1673,0
53786956378,53786956378,0,1346,1501,0
53794651423,53794651421,-2,735,962,0
53800030994,53800030995,1,1487,1899,0
53803354258,53803354254,-4,1116,2902,0
53805357381,53805357381,0,2072,1921,0
53810261327,53810261326,-1,1435,1873,0
53810762978,53810762984,6,2509,1620,0
53816077279,53816077279,0,1280,1881,0
53820378838,53820378838,0,1438,1664,0
53824073221,53824073222,1,1396,1599,0
53825382524,53825382525,1,1397,1800,0
53827232252,53827232253,1,772,1097,0
53831163170,53831163171,1,932,1390,0
53831466047,53831466042,-5,1266,2648,0
53832212778,53832212778,0,1298,1279,0
53832582599,53832582599,0,1240,1325,0
53836428502,53836428503,1,1054,1566,0
53837298477,53837298476,-1,1646,1575,0
53837342777,53837342782,5,11271,5770,0
53838940551,53838940548,-3,986,1565,0
53839347374,53839347374,0,1591,1849,0
53843351583,53843351582,-1,896,1874,0
53845984241,53845984242,1,899,1519,0
53846536567,53846536567,0,2017,2939,0
53848231258,53848231259,1,1509,1334,0
53852379400,53852379398,-2,1387,1946,0
53856584006,53856584006,0,1391,1629,0
53861203867,53861203868,1,1977,1695,0
53861381306,53861381307,1,1827,2046,0
53862060062,53862060061,-1,1696,1506,0
53863148419,53863148422,3,2210,1973,0
53863353345,53863353345,0,945,1671,0
53863645823,53863645822,-1,1101,1389,0
53864103686,53864103686,0,1215,1300,0
53864859482,53864859462,-20,1635,1635,0
53864955747,53864955747,0,1204,1044,0
53867713546,53867713547,1,1239,1448,0
53869353157,53869353158,1,1330,2105,0
53873552511,53873552513,2,1655,1681,0
53879035163,53879035166,3,970,1182,0
53879773003,53879773004,1,1385,1260,0
53884085563,53884085564,1,1053,1745,0
53885193096,53885193095,-1,1168,1636,0
53888835650,53888835650,0,1939,1960,0
53889240217,53889240215,-2,1035,1507,0
53891821079,53891821078,-1,1260,2068,0
53894471129,53894471132,3,1389,1117,0
53897231678,53897231676,-2,1123,1535,0
53898585498,53898585494,-4,1074,2533,0
53899316495,53899316496,1,1330,1824,0
53908841692,53908841693,1,1420,1874,0
53911012445,53911012446,1,1236,1509,0
53913843391,53913843390,-1,1316,2493,0
53916063898,53916063898,0,1187,1653,0
53919291150,53919291149,-1,1464,2819,0
53919631023,53919631023,0,1059,2295,0
53920796637,53920796638,1,1383,1906,0
53926529990,53926529993,3,2132,1553,0
53927095630,53927095630,0,1366,2201,0
53928561278,53928561278,0,1468,1780,0
53929510077,53929510075,-2,1071,1759,0
53930142482,53930142478,-4,1351,3790,0
53934189783,53934189783,0,1173,1350,0
53937220429,53937220424,-5,1405,1514,0
53937409238,53937409219,-19,1152,2029,0
53945500192,53945500193,1,1160,2044,0
53946195725,53946195725,0,2204,2413,0
53947973308,53947973310,2,1593,1215,0
53952658277,53952658284,7,3519,1725,0
53954707621,53954707620,-1,1502,1479,0
53956499595,53956499595,0,1434,1505,0
53957352177,53957352177,0,1672,2030,0
53959928909,53959928909,0,1220,1659,0
53960750525,53960750525,0,1975,3215,0
53961718581,53961718581,0,1169,1512,0
53963150922,53963150922,0,1597,1858,0
53964143786,53964143786,0,1420,2436,0
53964286230,53964286231,1,1385,1126,0
53964682231,53964682232,1,1364,1912,0
53965955754,53965955756,2,1498,1473,0
53966298993,53966298994,1,1764,1917,0
53966638502,53966638502,0,977,1640,0
53968374710,53968374712,2,1886,2032,0
53968660742,53968660745,3,1056,1746,0
53968696067,53968696047,-20,752,808,0
53968760692,53968760693,1,1632,2294,0
53968907814,53968907815,1,681,777,0
53971065943,53971065942,-1,1227,1657,0
53972241738,53972241739,1,1597,1592,0
53972986762,53972986761,-1,1247,1498,0
53977435327,53977435326,-1,1169,2121,0
53981690193,53981690193,0,1193,2191,0
53981731310,53981731309,-1,1499,1118,0
53987361857,53987361856,-1,1335,1364,0
53992785108,53992785106,-2,1432,1857,0
53992851468,53992851462,-6,1601,1789,0
53993015077,53993015078,1,1515,1101,0
53993575275,53993575274,-1,897,1158,0
53994856321,53994856322,1,1620,1899,0
53996425940,53996425941,1,1536,2256,0
53998766289,53998766290,1,1209,1846,0
54000754966,54000754966,0,1721,1522,0
54001834098,54001834098,0,1564,1587,0
54003057483,54003057483,0,1202,2365,0
54005957492,54005957491,-1,1384,1563,0
54006677247,54006677247,0,1292,1655,0
54008360335,54008360335,0,1684,1226,0
54008416518,54008416519,1,1565,2577,0
54009864795,54009864790,-5,1342,4254,0
54010145537,54010145538,1,1628,2381,0
54010469558,54010469546,-12,1189,1573,0
54013762335,54013762334,-1,1394,1532,0
54014567314,54014567315,1,1480,2458,0
54015165897,54015165895,-2,990,1589,0
54016465574,54016465575,1,1790,1543,0
54023381986,54023381984,-2,1075,2085,0
54024433931,54024433943,12,616,2107,0
54025895266,54025895269,3,1157,1592,0
54028825169,54028825166,-3,538,829,0
54043958451,54043958453,2,2221,1741,0
54049027305,54049027306,1,17827,13196,0
54049316878,54049316878,0,1588,1612,0
54049601763,54049601762,-1,1229,1785,0
54052463475,54052463475,0,1091,2201,0
54054950824,54054950826,2,1210,1448,0
54056497635,54056497635,0,1430,1428,0
54060035325,54060035325,0,1095,1216,0
54061490734,54061490735,1,751,1310,0
54061988083,54061988062,-21,1332,1740,0
54067743855,54067743858,3,1749,1668,0
54068078395,54068078395,0,1010,1530,0
54068960631,54068960631,0,1531,1346,0
54069747842,54069747840,-2,48915,50410,0
54072444617,54072444617,0,1432,1319,0
54073909773,54073909788,15,1438,1451,0
54077882338,54077882338,0,1327,1539,0
54078748841,54078748842,1,1231,1872,0
54078803970,54078803970,0,664,1297,0
54079685695,54079685694,-1,1515,1355,0
54084260811,54084260811,0,1227,1646,0
54084914842,54084914841,-1,1113,1770,0
54085185159,54085185159,0,720,1018,0
54088669004,54088669005,1,1893,1990,0
54089217357,54089217356,-1,1208,1488,0
54094115379,54094115373,-6,1136,3415,0
54096135915,54096135915,0,1410,1506,0
54096931375,54096931376,1,1083,1754,0
54097574409,54097574411,2,1170,1542,0
54099950754,54099950755,1,1085,964,0
54101451136,54101451135,-1,1571,2005,0
54103009918,54103009918,0,1687,2504,0
54105482310,54105482310,0,1709,2495,0
54106496886,54106496886,0,1005,1306,0
54107902846,54107902846,0,1228,1370,0
54108715924,54108715924,0,2141,2138,0
54113787098,54113787101,3,884,1361,0
54113829510,54113829497,-13,928,1483,0
54115844138,54115844118,-20,799,1456,0
54119240070,54119240071,1,1124,1192,0
54120049262,54120049258,-4,1578,6187,0
54121099873,54121099873,0,1757,1669,0
54124796358,54124796359,1,1472,1615,0
54129853801,54129853802,1,1210,1257,0
54130883194,54130883197,3,1409,1580,0
54131966838,54131966838,0,1423,1928,0
54132556303,54132556301,-2,800,1441,0
54134721176,54134721179,3,1892,1184,0
54136017598,54136017599,1,1501,1663,0
54136607931,54136607931,0,705,730,0
54139476347,54139476349,2,1226,1476,0
54145777575,54145777574,-1,1180,1793,0
54145901787,54145901789,2,1072,1726,0
54147486933,54147486934,1,1528,1936,0
54154971214,54154971214,0,920,997,0
54157432544,54157432548,4,2362,1624,0
54157484404,54157484407,3,1941,1151,0
54160354631,54160354630,-1,1200,1187,0
54164647293,54164647291,-2,482,850,0
54169244569,54169244570,1,1981,2197,0
54171300741,54171300740,-1,1367,2778,0
54171965339,54171965345,6,4781,1787,0
54176545371,54176545371,0,1903,1614,0
54177157162,54177157170,8,1890,865,0
54177722038,54177722038,0,1307,1838,0
54178939739,54178939734,-5,863,3797,0
54179569454,54179569452,-2,1273,1732,0
54181463535,54181463538,3,1702,1000,0
54182750930,54182750931,1,1010,1856,0
54182996863,54182996863,0,1669,1517,0
54187289684,54187289682,-2,1418,2704,0
54187841515,54187841513,-2,1438,1878,0
54188626696,54188626697,1,1817,1821,0
54192775886,54192775886,0,1245,1961,0
54195678802,54195678802,0,1585,2493,0
54196250393,54196250395,2,996,1662,0
54199261326,54199261327,1,1865,2078,0
54199791824,54199791822,-2,955,1422,0
54200292046,54200292047,1,995,1741,0
54200999949,54200999949,0,2049,1839,0
54201771212,54201771230,18,1487,2078,0
54204772200,54204772206,6,2555,1454,0
54205126414,54205126410,-4,118116,37274,0
54206031370,54206031370,0,1292,1777,0
54208035227,54208035226,-1,1014,1407,0
54208142826,54208142826,0,1302,1884,0
54208268081,54208268085,4,2348,2003,0
54210820418,54210820431,13,1422,1413,0
54211325398,54211325398,0,1377,1564,0
54215572745,54215572745,0,1088,1678,0
54217896917,54217896919,2,1373,1530,0
54218456286,54218456277,-9,454,885,0
54219822885,54219822891,6,2915,1502,0
54220797949,54220797957,8,16048,6071,0
54224251614,54224251615,1,1439,1553,0
54224759614,54224759611,-3,1148,2126,0
54225604616,54225604615,-1,1374,1204,0
54230530962,54230530966,4,1917,1201,0
54231685169,54231685169,0,1054,1846,0
54232846431,54232846431,0,1923,2526,0
54233090321,54233090320,-1,1325,1816,0
54235042690,54235042691,1,1509,1515,0
54235257294,54235257294,0,1399,1649,0
54248268335,54248268334,-1,1085,1630,0
54250114858,54250114861,3,2104,2101,0
54252747954,54252747955,1,1648,1694,0
54252969996,54252969995,-1,1636,1286,0
54254357515,54254357517,2,1874,2109,0
54256354504,54256354510,6,7869,28231,0
54257047870,54257047871,1,1396,1338,0
54258504652,54258504655,3,1221,1215,0
54258602221,54258602221,0,1128,1453,0
54259418431,54259418431,0,1848,1762,0
54261395949,54261395950,1,1982,1894,0
54262468292,54262468294,2,1399,1084,0
54264151573,54264151572,-1,1491,1218,0
54265467395,54265467393,-2,1160,1851,0
54265886175,54265886175,0,1444,1831,0
54269917985,54269917985,0,1765,2197,0
54271977618,54271977621,3,1250,1778,0
54274612114,54274612114,0,1776,1575,0
54275083677,54275083673,-4,1482,1679,0
54277956982,54277956981,-1,1471,2521,0
54280166512,54280166511,-1,1361,1678,0
54280816599,54280816592,-7,2196,7241,0
54281236707,54281236709,2,1340,1219,0
54282278242,54282278241,-1,1020,1579,0
54283040719,54283040720,1,1332,2208,0
54283229779,54283229778,-1,1092,1310,0
54283475271,54283475256,-15,978,2297,0
54284633971,54284633970,-1,1509,1509,0
54285061033,54285061034,1,1496,1659,0
54285938810,54285938811,1,1499,1662,0
54286158890,54286158885,-5,1470,4833,0
54288891943,54288891939,-4,1392,4648,0
54289388265,54289388265,0,1185,1677,0
54291836690,54291836691,1,1762,2347,0
54294949823,54294949824,1,878,1217,0
54298575103,54298575103,0,1330,1014,0
54299881965,54299881966,1,993,1068,0
54301404690,54301404691,1,1522,2497,0
54301763961,54301763961,0,1611,2018,0
54305128171,54305128170,-1,1280,1895,0
54307452302,54307452301,-1,1528,1502,0
54309722318,54309722318,0,1566,1650,0
54312659469,54312659462,-7,1030,5034,0
54317009062,54317009061,-1,1207,1855,0
54319887778,54319887777,-1,1669,1739,0
54323557795,54323557796,1,2026,2316,0
54323725475,54323725476,1,1715,1761,0
54328875835,54328875835,0,1116,1584,0
54334200902,54334200902,0,1026,1596,0
54336516454,54336516458,4,1648,1644,0
54341374508,54341374508,0,1871,2301,0
54342845858,54342845850,-8,1101,2769,0
54343153643,54343153638,-5,2250,4650,0
54349077363,54349077370,7,3868,1198,0
54349159819,54349159820,1,1831,2223,0
54349897162,54349897163,1,1226,1123,0
54351675080,54351675077,-3,1466,3297,0
54352427519,54352427519,0,1229,1507,0
54353706701,54353706701,0,1320,1791,0
54354214472,54354214458,-14,1163,1554,0
54355065131,54355065129,-2,1297,1834,0
54357752742,54357752742,0,1265,2038,0
54358741360,54358741359,-1,1270,1379,0
54364383998,54364383993,-5,1937,5259,0
54367289389,54367289390,1,1308,1984,0
54370653831,54370653834,3,849,1230,0
54372820903,54372820905,2,1504,1578,0
54373271865,54373271866,1,1463,1621,0
54375897018,54375897015,-3,1020,1542,0
54376701714,54376701714,0,1320,1644,0
54376741394,54376741397,3,1998,1621,0
54378575362,54378575362,0,1452,1544,0
54380575422,54380575419,-3,893,1554,0
54383128999,54383129001,2,180,1565,0
54394333304,54394333306,2,1388,1853,0
54395529601,54395529600,-1,1285,2450,0
54396749000,54396749002,2,1213,1398,0
54398345816,54398345815,-1,807,2016,0
54399028478,54399028480,2,1616,2071,0
54401413020,54401413026,6,3898,1711,0
54404266236,54404266238,2,1516,1999,0
54404478825,54404478822,-3,33844,7825,0
54406758511,54406758513,2,793,1082,0
54406927293,54406927294,1,2317,1779,0
54408091949,54408091956,7,2240,1289,0
54409991782,54409991782,0,1268,1243,0
54410761057,54410761079,22,1099,1592,0
54413749126,54413749126,0,1454,1816,0
54415439590,54415439590,0,1460,2028,0
54417502520,54417502522,2,1368,1711,0
54422811663,54422811662,-1,1438,1707,0
54424688471,54424688470,-1,1480,1280,0
54426136022,54426136021,-1,9493,14342,0
54426247951,54426247951,0,984,1384,0
54428177240,54428177241,1,1374,1210,0
54429806950,54429806949,-1,1510,1644,0
54430291008,54430291015,7,9632,31487,0
54433186747,54433186746,-1,1019,1445,0
54434918351,54434918336,-15,829,594,0
54435076970,54435076970,0,1536,1895,0
54435242254,54435242246,-8,853,1394,0
54435342990,54435342991,1,1046,1641,0
54435660771,54435660763,-8,1123,5088,0
54441435710,54441435711,1,1357,1754,0
54441727430,54441727412,-18,877,3195,0
54444424750,54444424751,1,1463,1491,0
54446549942,54446549941,-1,1362,2025,0
54447147038,54447147039,1,1226,1452,0
54448069920,54448069919,-1,1727,2177,0
54451243606,54451243606,0,1607,2028,0
54453114549,54453114548,-1,1034,1324,0
54453703914,54453703917,3,20451,44412,0
54453758073,54453758071,-2,966,2321,0
54464106366,54464106362,-4,1326,2290,0
54465212936,54465212936,0,1706,2119,0
54465511915,54465511918,3,1412,1159,0
54465793094,54465793094,0,1146,2115,0
54467379477,54467379478,1,2007,2046,0
54468122110,54468122111,1,2569,3262,0
54469679686,54469679687,1,1110,1744,0
54471734274,54471734275,1,940,1060,0
54473361538,54473361539,1,1064,1701,0
54475795194,54475795193,-1,1684,1680,0
54475889373,54475889373,0,1460,2024,0
54477253422,54477253429,7,8919,32849,0
54477997522,54477997527,5,2630,1480,0
54479569070,54479569069,-1,1282,1334,0
54483141390,54483141390,0,1542,1774,0
54485712218,54485712220,2,1442,1702,0
54487003170,54487003172,2,2572,1656,0
54487201885,54487201886,1,1291,2103,0
54487253510,54487253513,3,1799,1671,0
54488677594,54488677594,0,1391,1480,0
54493414296,54493414297,1,1487,1697,0
54495608755,54495608761,6,2814,1519,0
54496106274,54496106273,-1,1636,1428,0
54497319793,54497319799,6,6680,1967,0
54499394198,54499394198,0,993,1692,0
54500284348,54500284350,2,1168,1471,0
54500895920,54500895922,2,2030,2356,0
54501463358,54501463359,1,1621,1515,0
54503235502,54503235502,0,1593,1555,0
54504833048,54504833046,-2,1345,1653,0
54505111836,54505111839,3,24818,18871,0
54505803251,54505803251,0,1421,1544,0
54505917109,54505917106,-3,2722,6648,0
54508824284,54508824282,-2,1504,2362,0
54511230638,54511230639,1,1466,1198,0
54512537442,54512537443,1,1411,1976,0
54515544321,54515544322,1,1767,1733,0
54516248419,54516248418,-1,1225,1338,0
54517676329,54517676330,1,1794,1953,0
54517894079,54517894085,6,2467,1028,0
54518571070,54518571069,-1,1178,2446,0
54521738556,54521738557,1,1429,1669,0
54523122618,54523122618,0,1269,2048,0
54526483718,54526483718,0,1098,2093,0
54528119523,54528119525,2,909,1308,0
54529974521,54529974520,-1,971,1558,0
54532909734,54532909733,-1,1351,2973,0
54537390506,54537390506,0,1504,1233,0
54539057485,54539057484,-1,967,1484,0
54539167620,54539167606,-14,874,1470,0
54541988468,54541988467,-1,1586,1608,0
54542991422,54542991421,-1,1415,2054,0
54543834126,54543834124,-2,1272,2542,0
54548280948,54548280951,3,1776,1054,0
54548366698,54548366701,3,1580,2491,0
54549694955,54549694957,2,1653,1690,0
54554093126,54554093125,-1,1287,1751,0
54559383038,54559383036,-2,1482,1312,0
54561116466,54561116474,8,11764,23363,0
54563561398,54563561399,1,1242,1300,0
54564014522,54564014522,0,1929,1914,0
54564385130,54564385131,1,1252,2028,0
54565460911,54565460911,0,1084,1976,0
54569145618,54569145625,7,26547,32659,0
54569185181,54569185182,1,1562,1856,0
54570694907,54570694908,1,7590,18430,0
54571223154,54571223154,0,1573,1663,0
54577059469,54577059471,2,951,1452,0
54580265171,54580265170,-1,1104,1436,0
54580690995,54580690994,-1,1499,2216,0
54580794369,54580794372,3,1504,1961,0
54582001790,54582001792,2,1803,2188,0
54585931057,54585931059,2,809,1555,0
54588439595,54588439597,2,842,1501,0
54590592514,54590592515,1,1860,1521,0
54591679727,54591679729,2,1817,2069,0
54594161370,54594161370,0,1535,1564,0
54607797606,54607797608,2,1521,1210,0
54608675539,54608675536,-3,1156,2348,0
54611765542,54611765544,2,1855,1781,0
54613883063,54613883069,6,3176,1666,0
54615940362,54615940364,2,1708,2299,0
54619254110,54619254088,-22,1683,2205,0
54624595852,54624595852,0,1484,1577,0
54629147830,54629147836,6,2650,1116,0
54631705520,54631705518,-2,1512,2040,0
54632238998,54632238997,-1,840,1007,0
54632332438,54632332439,1,1510,1370,0
54632682826,54632682826,0,1334,1273,0
54636927378,54636927378,0,1186,1171,0
54641169659,54641169657,-2,1411,2125,0
54643117157,54643117153,-4,910,2378,0
54645384338,54645384338,0,1763,2025,0
54645737914,54645737917,3,1143,1280,0
54646816977,54646816979,2,1165,1710,0
54650028291,54650028294,3,2257,1735,0
54651157935,54651157932,-3,1174,2288,0
54654272258,54654272261,3,1322,1802,0
54654939758,54654939761,3,2040,1842,0
54657000567,54657000566,-1,1564,2999,0
54659686005,54659686006,1,1210,1861,0
54663864238,54663864238,0,1487,1601,0
54664751318,54664751318,0,798,1922,0
54666897362,54666897363,1,1402,1466,0
54667504911,54667504914,3,1214,2068,0
54669147557,54669147558,1,1282,2062,0
54669347598,54669347578,-20,1374,1426,0
54673575074,54673575071,-3,1261,1426,0
54674109011,54674109013,2,1697,1876,0
54674839330,54674839332,2,1335,1636,0
54675593039,54675593040,1,1304,1603,0
54679167852,54679167853,1,1411,1667,0
54679991404,54679991406,2,1473,1311,0
54680915389,54680915390,1,1435,2254,0
54683657030,54683657027,-3,1711,3994,0
54683834114,54683834114,0,1693,2419,0
54685825897,54685825897,0,1498,1450,0
54686538589,54686538590,1,984,1653,0
54687067131,54687067130,-1,1511,2037,0
54688446699,54688446702,3,1609,2155,0
54689555401,54689555403,2,1560,2004,0
54689606333,54689606338,5,2492,1677,0
54690935493,54690935494,1,1517,2139,0
54692859262,54692859264,2,1870,2605,0
54693242396,54693242380,-16,1078,1119,0
54694302741,54694302742,1,1145,1153,0
54694668815,54694668829,14,267,509,0
54696488114,54696488116,2,1071,1472,0
54703711387,54703711387,0,942,1180,0
54706490522,54706490528,6,13309,23213,0
54706774419,54706774417,-2,1468,1564,0
54709327826,54709327828,2,1164,1563,0
54711697526,54711697527,1,1582,1953,0
54715594426,54715594427,1,1184,1720,0
54715675770,54715675771,1,1256,1534,0
54716330901,54716330907,6,2624,1114,0
54717995731,54717995730,-1,1321,2188,0
54720450246,54720450244,-2,1359,2257,0
54722495339,54722495340,1,1353,1900,0
54722848434,54722848432,-2,1112,1722,0
54725481654,54725481654,0,1396,1741,0
54731888761,54731888761,0,1605,2562,0
54733815255,54733815255,0,871,1507,0
54734303197,54734303186,-11,1388,1926,0
54735690926,54735690923,-3,869,1243,0
54737220717,54737220718,1,690,892,0
54737328183,54737328182,-1,1388,1547,0
54739732203,54739732205,2,1727,2300,0
54741134519,54741134521,2,1313,2118,0
54741617444,54741617443,-1,1174,1974,0
54745647445,54745647445,0,1355,1241,0
54750941496,54750941496,0,1202,1539,0
54754486231,54754486232,1,1284,1800,0
54755296598,54755296598,0,1638,2280,0
54755653010,54755653016,6,2617,1522,0
54756543370,54756543373,3,1955,2090,0
54756888179,54756888181,2,1628,1954,0
54757169021,54757169020,-1,1319,1540,0
54758311658,54758311658,0,1425,1088,0
54758756031,54758756030,-1,1159,1913,0
54760661876,54760661876,0,1781,1546,0
54762558560,54762558561,1,1199,2187,0
54766363173,54766363174,1,1519,1799,0
54768274397,54768274397,0,1488,1972,0
54769036477,54769036481,4,1552,1129,0
54770583575,54770583574,-1,1303,1748,0
54770672000,54770672001,1,1411,1117,0
54771664805,54771664794,-11,395,932,0
54772410905,54772410905,0,1496,1546,0
54773266650,54773266651,1,1097,1310,0
54774972984,54774972989,5,4784,2075,0
54775244271,54775244269,-2,1292,1512,0
54775577841,54775577841,0,1688,2419,0
54776951705,54776951705,0,1616,1117,0
54778560889,54778560890,1,1607,2532,0
54779125159,54779125155,-4,1330,3480,0
54779179384,54779179386,2,1234,1868,0
54781328288,54781328290,2,1052,1792,0
54782016109,54782016102,-7,970,3203,0
54787188998,54787188997,-1,1846,1839,0
54791120010,54791120009,-1,92,1205,0
54796664922,54796664922,0,1368,1782,0
54800787523,54800787520,-3,2198,4408,0
54801059053,54801059054,1,1636,2070,0
54804985238,54804985239,1,1277,1484,0
54806537072,54806537074,2,1710,1640,0
54806709950,54806709949,-1,1785,1854,0
54807001010,54807001010,0,1736,2109,0
54808795707,54808795709,2,784,1284,0
54810103718,54810103718,0,889,1061,0
54813774462,54813774461,-1,1121,1589,0
54815017065,54815017065,0,2150,2159,0
54816922807,54816922806,-1,1349,1872,0
54818033794,54818033793,-1,927,1338,0
54821244378,54821244380,2,1335,1900,0
54824922402,54824922402,0,1829,1860,0
54825640075,54825640071,-4,1014,1148,0
54827535154,54827535155,1,1332,1319,0
54834257912,54834257919,7,1470,908,0
54837381727,54837381732,5,1398,1505,0
54840498391,54840498390,-1,1478,1675,0
54840738611,54840738618,7,1906,727,0
54849440218,54849440218,0,1643,1969,0
54853456718,54853456719,1,1328,1266,0
54854467416,54854467417,1,1433,1707,0
54854708662,54854708663,1,1511,1408,0
54856417626,54856417633,7,13106,29077,0
54858175541,54858175542,1,1377,1559,0
54859486143,54859486142,-1,1078,1584,0
54860981087,54860981087,0,1864,2058,0
54862097926,54862097910,-16,1064,1417,0
54866077843,54866077847,4,1640,1600,0
54868781842,54868781842,0,1513,1356,0
54870130027,54870130029,2,1884,1932,0
54871119370,54871119365,-5,1043,2329,0
54871713109,54871713108,-1,1257,1350,0
54879399539,54879399541,2,2144,2672,0
54880593343,54880593344,1,1656,1627,0
54882742481,54882742480,-1,1342,1685,0
54883455660,54883455658,-2,749,1323,0
54887297330,54887297330,0,881,1434,0
54896426779,54896426781,2,1446,1819,0
54901256196,54901256195,-1,1373,2139,0
54902070145,54902070146,1,1342,1533,0
54903820062,54903820063,1,1708,2099,0
54904252161,54904252163,2,902,1163,0
54905134611,54905134606,-5,1455,2988,0
54906829275,54906829274,-1,1771,1741,0
54911643630,54911643630,0,1442,1557,0
54916437737,54916437738,1,1448,1824,0
54918094209,54918094209,0,1290,1639,0
54933275058,54933275060,2,1695,1338,0
54934645083,54934645085,2,1685,2298,0
54935806009,54935806010,1,1174,1343,0
54941316937,54941316938,1,1459,1628,0
54942465777,54942465775,-2,1304,2838,0
54944058142,54944058142,0,1364,1512,0
54948395821,54948395822,1,1361,1801,0
54953070522,54953070522,0,951,1076,0
54956530967,54956530966,-1,1107,1403,0
54959781409,54959781411,2,1495,2017,0
54959939343,54959939346,3,1030,1232,0
54962058585,54962058587,2,1549,1890,0
54964830558,54964830559,1,1356,1510,0
54968920150,54968920151,1,1549,1438,0
54972303750,54972303751,1,1104,1256,0
54973725625,54973725626,1,772,1395,0
54973819426,54973819418,-8,3075,10937,0
54977534137,54977534137,0,1193,1130,0
54984850141,54984850140,-1,815,2268,0
54989860850,54989860845,-5,1111,2815,0
54990131735,54990131726,-9,1279,1587,0
54994270506,54994270507,1,1267,1416,0
54995598294,54995598296,2,1476,1644,0
54996500838,54996500839,1,718,835,0
54999135881,54999135878,-3,2235,4782,0
55000757602,55000757602,0,1318,1739,0
55002854912,55002854913,1,1694,1646,0
55009341160,55009341163,3,1456,1387,0
55009733025,55009733023,-2,1356,1585,0
55012525241,55012525242,1,630,1360,0
55012801051,55012801068,17,773,924,0
55014020902,55014020902,0,1202,2100,0
55018720738,55018720737,-1,1360,1472,0
55019671686,55019671665,-21,1282,1650,0
55022014079,55022014077,-2,1226,1426,0
55022434070,55022434071,1,2034,2226,0
55022714038,55022714037,-1,1182,1701,0
55023839505,55023839512,7,1243,1386,0
55026330575,55026330571,-4,1217,1501,0
55030538826,55030538826,0,1330,1351,0
55034627786,55034627786,0,1475,2080,0
55035774546,55035774545,-1,1066,1563,0
55037739039,55037739044,5,1795,1174,0
55037844791,55037844789,-2,1129,1306,0
55041287229,55041287230,1,3312,4112,0
55043963506,55043963505,-1,1564,1788,0
55047432575,55047432578,3,1831,1406,0
55048622601,55048622602,1,1639,1862,0
55052651229,55052651230,1,3815,3375,0
55053795894,55053795896,2,1794,2050,0
55055258641,55055258640,-1,1552,3112,0
55057116162,55057116162,0,2248,2511,0
55057496634,55057496633,-1,1302,1536,0
55058125784,55058125785,1,999,1364,0
55059243335,55059243336,1,1549,1634,0
55060401405,55060401406,1,1064,1511,0
55061651990,55061651987,-3,1098,2360,0
55064522916,55064522918,2,1556,1653,0
55064911024,55064911024,0,1487,1818,0
55066836580,55066836581,1,1241,1496,0
55067294596,55067294596,0,1101,999,0
55067641469,55067641453,-16,1666,1215,0
55069170364,55069170365,1,1260,1817,0
55072036508,55072036507,-1,966,2016,0
55072786980,55072786981,1,1481,1857,0
55075280171,55075280175,4,1146,1193,0
55078615846,55078615847,1,1093,879,0
55079457493,55079457494,1,988,1738,0
55080329227,55080329227,0,697,803,0
55080603950,55080603949,-1,1294,1629,0
55081746946,55081746946,0,2165,2155,0
55085302104,55085302103,-1,1026,1635,0
55088789401,55088789403,2,1553,1681,0
55089012413,55089012418,5,4717,2801,0
55089451291,55089451291,0,1435,1128,0
55092316503,55092316503,0,1642,2230,0
55100351546,55100351547,1,1245,1621,0
55101170390,55101170394,4,1944,1539,0
55101288850,55101288831,-19,2439,1044,0
55104148330,55104148331,1,2035,2136,0
55106166710,55106166711,1,1394,1676,0
55107084754,55107084754,0,1049,1461,0
55109154114,55109154115,1,1047,1962,0
55109294918,55109294918,0,1325,1678,0
55111480558,55111480558,0,1683,2307,0
55112198831,55112198831,0,950,1642,0
55113044934,55113044931,-3,1099,1821,0
55114405997,55114405998,1,1501,1629,0
55118652635,55118652638,3,1186,1564,0
55123733159,55123733160,1,1095,1760,0
55124696317,55124696320,3,1774,1574,0
55125275978,55125275978,0,1442,2157,0
55125703598,55125703605,7,3055,2121,0
55127819995,55127819995,0,1829,2269,0
55129029742,55129029763,21,1789,2251,0
55129524794,55129524795,1,1322,1848,0
55129684766,55129684765,-1,1094,1199,0
55130828077,55130828075,-2,1415,1681,0
55131450311,55131450312,1,1628,2320,0
55132431246,55132431247,1,1774,1983,0
55132613622,55132613619,-3,782,935,0
55132905653,55132905655,2,1074,1949,0
55133349630,55133349631,1,1157,1633,0
55133839228,55133839229,1,1303,1662,0
55134197796,55134197799,3,2286,1330,0
55134520815,55134520817,2,1261,1581,0
55134850704,55134850705,1,1616,1810,0
55135011481,55135011482,1,1343,1579,0
55135925559,55135925560,1,1872,2490,0
55136125610,55136125610,0,1638,2392,0
55136696495,55136696496,1,2463,2135,0
55137669985,55137669983,-2,1229,1633,0
55138852546,55138852546,0,1015,1686,0
55139068600,55139068602,2,1891,1804,0
55146783570,55146783571,1,1375,2230,0
55148212471,55148212470,-1,1475,1969,0
55148689697,55148689701,4,2567,1471,0
55151090833,55151090834,1,1297,1381,0
55151321410,55151321410,0,916,1552,0
55153599801,55153599802,1,1882,1718,0
55153745998,55153745998,0,1470,1313,0
55153902202,55153902201,-1,1344,1855,0
55156795574,55156795577,3,1455,1595,0
55157626781,55157626783,2,1651,1072,0
55158033978,55158033980,2,1799,2085,0
55158339929,55158339930,1,1218,1361,0
55159015970,55159015975,5,2351,1127,0
55159849989,55159849990,1,1680,1660,0
55161716404,55161716406,2,1615,1587,0
55161905353,55161905355,2,3916,2978,0
55162980380,55162980380,0,1332,1917,0
55164914297,55164914297,0,1571,1479,0
55167340681,55167340682,1,1651,1426,0
55169505888,55169505886,-2,1436,1904,0
55171364335,55171364335,0,1389,2443,0
55172808047,55172808049,2,1481,1418,0
55177421643,55177421642,-1,1759,2146,0
55178149920,55178149919,-1,1255,1648,0
55180077412,55180077411,-1,1390,1780,0
55181844331,55181844326,-5,736,3987,0
55181877330,55181877331,1,1206,1194,0
55185665575,55185665574,-1,1019,1563,0
55189425103,55189425106,3,1181,1186,0
55189658671,55189658670,-1,1804,1529,0
55192571913,55192571914,1,1701,1991,0
55194319830,55194319830,0,1621,1852,0
55197401482,55197401484,2,2283,2376,0
55198650198,55198650198,0,1586,2117,0
55198797763,55198797764,1,1959,1788,0
55203024437,55203024438,1,1453,1471,0
55203715511,55203715510,-1,1107,944,0
55205969243,55205969245,2,1189,1341,0
55215083590,55215083590,0,1242,1996,0
55220101226,55220101227,1,1614,1505,0
55220341858,55220341858,0,1224,1833,0
55220643809,55220643809,0,1928,2250,0
55224071568,55224071574,6,8734,2663,0
55225127320,55225127318,-2,12618,25445,0
55229492611,55229492611,0,1139,1829,0
55230226043,55230226046,3,792,1320,0
55231140141,55231140146,5,1283,1731,0
55231430680,55231430687,7,2425,860,0
55233416980,55233416981,1,1372,1663,0
55234518564,55234518562,-2,1456,1413,0
55238280286,55238280286,0,1194,1764,0
55239391791,55239391793,2,1603,2113,0
55239485707,55239485709,2,1177,1519,0
55240527204,55240527203,-1,1327,1163,0
55242180062,55242180065,3,1694,1473,0
55244627881,55244627881,0,1009,1348,0
55246737786,55246737785,-1,1288,1845,0
55252047218,55252047219,1,1069,1643,0
55252366633,55252366633,0,1785,1940,0
55253339214,55253339214,0,1786,1957,0
55253919125,55253919128,3,1962,1608,0
55255282745,55255282746,1,913,1165,0
55256767336,55256767338,2,1587,1976,0
55258362238,55258362239,1,1829,1935,0
55258745760,55258745757,-3,1352,2227,0
55259782222,55259782221,-1,1200,1624,0
55262021867,55262021869,2,1464,1604,0
55262853531,55262853532,1,1332,1953,0
55266158610,55266158609,-1,1598,1508,0
55266765241,55266765243,2,1766,1988,0
55271916944,55271916947,3,1487,1196,0
55274003488,55274003487,-1,1440,1663,0
55274821411,55274821411,0,1484,2012,0
55280053449,55280053451,2,1366,1510,0
55280329679,55280329682,3,2137,1877,0
55281019115,55281019118,3,1018,1550,0
55283990047,55283990049,2,1350,1359,0
55292729769,55292729771,2,2490,2246,0
55294109763,55294109762,-1,1225,2297,0
55294649399,55294649397,-2,1348,1776,0
55295853498,55295853498,0,1377,1684,0
55299608698,55299608700,2,1437,1568,0
55307956255,55307956251,-4,1117,1648,0
55309940045,55309940044,-1,1314,1697,0
55314273857,55314273856,-1,1528,2282,0
55314697255,55314697255,0,1663,1873,0
55315554022,55315554023,1,1572,1930,0
55318276402,55318276390,-12,191,9866,0
55320005717,55320005719,2,261,721,0
55320115519,55320115514,-5,1421,1333,0
55321806695,55321806697,2,1455,1575,0
55328157556,55328157555,-1,1481,1630,0
55329001547,55329001546,-1,971,1502,0
55329130150,55329130151,1,1334,1617,0
55331289745,55331289747,2,1052,1013,0
55331967770,55331967771,1,1269,1532,0
55334419616,55334419618,2,1667,1540,0
55336535081,55336535084,3,2122,1462,0
55337726613,55337726613,0,1075,1579,0
55339475680,55339475681,1,2140,2113,0
55340163554,55340163554,0,1355,1419,0
55340458831,55340458830,-1,726,917,0
55341241493,55341241492,-1,1223,1711,0
55344490744,55344490746,2,1127,2022,0
55345574401,55345574402,1,1141,2188,0
55346737097,55346737098,1,1586,1645,0
55350954362,55350954363,1,1599,1343,0
55351638578,55351638577,-1,1311,2459,0
55353150474,55353150476,2,1600,1716,0
55354019033,55354019033,0,2035,1971,0
55360059554,55360059553,-1,1846,1682,0
55360957776,55360957777,1,1926,2338,0
55363936745,55363936738,-7,2600,7450,0
55366573442,55366573441,-1,1129,1512,0
55373788947,55373788950,3,1006,1317,0
55375366815,55375366817,2,1322,1378,0
55376595722,55376595723,1,1273,1582,0
55376642846,55376642847,1,1096,1676,0
55377850992,55377850995,3,18890,23604,0
55380084706,55380084705,-1,1175,2281,0
55385831506,55385831509,3,1556,1713,0
55387109940,55387109941,1,2334,2808,0
55388159481,55388159482,1,877,1214,0
55388768848,55388768862,14,1223,1489,0
55391434602,55391434602,0,1147,2046,0
55392116758,55392116758,0,2144,1865,0
55393474682,55393474684,2,1951,1448,0
55395633863,55395633863,0,1457,1643,0
55396507218,55396507217,-1,1634,1792,0
55396628346,55396628346,0,1817,1705,0
55398562865,55398562866,1,1087,1364,0
55398643050,55398643050,0,1024,1635,0
55398933127,55398933127,0,996,1269,0
55400471399,55400471400,1,947,1351,0
55400708594,55400708598,4,2275,1831,0
55400885594,55400885595,1,1419,1367,0
55401782795,55401782794,-1,1227,1029,0
55402956113,55402956114,1,884,1512,0
55403847750,55403847758,8,2793,1241,0
55404066651,55404066652,1,684,1337,0
55404635527,55404635546,19,1752,2708,0
55406090826,55406090828,2,1318,1657,0
55406470495,55406470496,1,1136,1705,0
55411985181,55411985178,-3,1521,1688,0
55412502799,55412502801,2,1226,1593,0
55412963681,55412963683,2,1929,1714,0
55415180653,55415180650,-3,1033,1348,0
55416079720,55416079718,-2,1075,2063,0
55419426715,55419426718,3,1043,1555,0
55419732213,55419732213,0,1504,1728,0
55420799159,55420799159,0,1439,1818,0
55424839803,55424839798,-5,1350,2938,0
55425978478,55425978480,2,1325,1921,0
55430458877,55430458878,1,1334,2029,0
55430874927,55430874927,0,1030,1638,0
55431155335,55431155337,2,1148,1659,0
55431873646,55431873646,0,1434,2254,0
55432855390,55432855388,-2,1309,1273,0
55438114875,55438114877,2,1344,1356,0
55439383869,55439383870,1,1345,1827,0
55440535201,55440535203,2,1416,1301,0
55440680683,55440680661,-22,1139,828,0
55441266823,55441266824,1,1651,2169,0
55441745063,55441745065,2,972,1901,0
55442899545,55442899545,0,843,1387,0
55443001960,55443001958,-2,1304,1318,0
55443347111,55443347110,-1,969,914,0
55444582482,55444582483,1,1453,1326,0
55446671893,55446671892,-1,1063,1243,0
55449238506,55449238505,-1,1372,2162,0
55452538425,55452538424,-1,1671,2338,0
55452969833,55452969833,0,1112,1976,0
55455734214,55455734214,0,1317,2236,0
55458530668,55458530667,-1,1267,1098,0
55458954443,55458954446,3,2106,1587,0
55460602187,55460602189,2,1363,1266,0
55462169162,55462169162,0,1413,1205,0
55463326080,55463326079,-1,1809,1463,0
55466514609,55466514611,2,1306,1620,0
55468403386,55468403385,-1,2039,1854,0
55473978520,55473978527,7,2967,1293,0
55475620957,55475620957,0,1456,2368,0
55476828202,55476828209,7,2000,1889,0
55478815316,55478815314,-2,498,1819,0
55480897786,55480897788,2,1831,2424,0
55486150690,55486150689,-1,1402,2342,0
55489900670,55489900669,-1,817,1975,0
55490271058,55490271058,0,1400,1637,0
55504712263,55504712265,2,1551,1851,0
55504744833,55504744834,1,1070,1399,0
55506777717,55506777716,-1,1409,1882,0
55507109998,55507109986,-12,1107,1352,0
55508569658,55508569658,0,1020,1432,0
55510369419,55510369418,-1,1273,1970,0
55511370414,55511370415,1,1598,1940,0
55512411350,55512411354,4,4537,3044,0
55513310015,55513310015,0,1315,1082,0
55514830422,55514830429,7,2403,1165,0
55516399256,55516399258,2,1823,1949,0
55520560885,55520560892,7,12661,35822,0
55521220694,55521220694,0,1985,1665,0
55521875674,55521875678,4,1264,934,0
55523212103,55523212103,0,1203,1393,0
55524958263,55524958263,0,1939,2450,0
55526207634,55526207634,0,1476,1332,0
55527484686,55527484686,0,1401,1364,0
55527780526,55527780524,-2,1095,1530,0
55527876426,55527876424,-2,1546,2327,0
55528592175,55528592174,-1,1344,1690,0
55528629649,55528629647,-2,1324,1884,0
55531003417,55531003419,2,1276,1521,0
55531302491,55531302501,10,239,638,0
55534526205,55534526206,1,2950,3762,0
55544094918,55544094916,-2,1465,1689,0
55544721939,55544721917,-22,978,1534,0
55544895243,55544895245,2,1682,1892,0
55548154643,55548154645,2,1064,1507,0
55549094675,55549094677,2,1495,1422,0
55551017080,55551017078,-2,2162,5125,0
55554353303,55554353304,1,1463,1867,0
55555445327,55555445326,-1,1540,1970,0
55556316456,55556316459,3,1091,1134,0
55562951277,55562951278,1,1270,1374,0
55564755093,55564755092,-1,1403,1688,0
55573335287,55573335286,-1,1377,1700,0
55575839546,55575839546,0,802,1794,0
55580682886,55580682906,20,1068,1691,0
55581370157,55581370158,1,1608,1862,0
55581882103,55581882100,-3,1177,1545,0
55582414211,55582414211,0,2091,2783,0
55589170921,55589170921,0,1436,1520,0
55590064239,55590064238,-1,1576,2079,0
55592771530,55592771530,0,1089,1192,0
55593525550,55593525549,-1,1158,1458,0
55593821291,55593821292,1,1123,1862,0
55594670797,55594670797,0,1500,2731,0
55594710819,55594710818,-1,1386,1744,0
55596102730,55596102731,1,1227,1412,0
55596811266,55596811265,-1,1847,2206,0
55602161228,55602161227,-1,957,930,0
55603488375,55603488374,-1,1917,2473,0
55603615678,55603615677,-1,1163,1335,0
55604299085,55604299091,6,1150,550,0
55606154753,55606154754,1,1447,1452,0
55609865703,55609865705,2,1266,1186,0
55614641048,55614641048,0,1615,1945,0
55615106846,55615106847,1,979,1653,0
55615761695,55615761715,20,841,6711,0
55618970009,55618970010,1,1680,1738,0
55622322034,55622322034,0,1729,1820,0
55623977232,55623977231,-1,21727,9159,0
55625733463,55625733464,1,1461,1923,0
55632104670,55632104670,0,1680,1574,0
55633730052,55633730053,1,1841,2472,0
55642247377,55642247377,0,1339,2191,0
55642506938,55642506938,0,1089,1841,0
55645167701,55645167702,1,4656,19868,0
55645889729,55645889731,2,1528,2009,0
55648300843,55648300842,-1,1073,1484,0
55651267994,55651267994,0,988,1309,0
55652434963,55652434961,-2,1041,2219,0
55655270989,55655270990,1,1390,2066,0
55655585321,55655585322,1,1419,1735,0
55660952150,55660952150,0,1159,1561,0
55665317238,55665317238,0,1411,1373,0
55666150361,55666150362,1,1529,1749,0
55666492663,55666492666,3,1810,1587,0
55671073839,55671073840,1,61,1940,0
55672075622,55672075609,-13,1231,2021,0
55672768071,55672768070,-1,1112,1349,0
55673440311,55673440309,-2,1500,2176,0
55678036754,55678036756,2,1087,1355,0
55679590053,55679590052,-1,1435,1398,0
55681823875,55681823877,2,1269,1683,0
55682316382,55682316382,0,1762,2241,0
55682876445,55682876455,10,6803,32957,0
55684884057,55684884058,1,1395,1628,0
55685492299,55685492301,2,1204,1482,0
55690719015,55690719015,0,1634,1800,0
55691484400,55691484378,-22,1178,780,0
55693184273,55693184273,0,1554,2096,0
55693553630,55693553629,-1,1141,1612,0
55694950846,55694950847,1,2287,2063,0
55695200798,55695200798,0,1714,1208,0
55695545339,55695545341,2,1573,2447,0
55700672926,55700672926,0,1648,2440,0
55703027203,55703027202,-1,1731,1854,0
55703840540,55703840524,-16,611,624,0
55704630671,55704630671,0,2110,1926,0
55705880974,55705880974,0,1337,1207,0
55708378009,55708378009,0,1385,2217,0
55709026776,55709026778,2,1452,1672,0
55713246530,55713246533,3,1474,1568,0
55713949482,55713949484,2,1628,1730,0
55714750982,55714750984,2,1548,1433,0
55717475750,55717475755,5,1464,1545,0
55718380234,55718380235,1,1593,2023,0
55718646987,55718646988,1,1207,2167,0
55719614678,55719614679,1,1402,2048,0
55722361769,55722361766,-3,1048,1655,0
55731354139,55731354137,-2,1099,1402,0
55733915582,55733915581,-1,1263,1733,0
55736109979,55736109980,1,1120,1748,0
55736427834,55736427836,2,1245,1531,0
55741871461,55741871462,1,1317,1921,0
55749376895,55749376899,4,1428,1587,0
55750436373,55750436373,0,1427,1349,0
55751794390,55751794390,0,1078,785,0
55753252942,55753252943,1,1279,1611,0
55754078442,55754078442,0,1480,1945,0
55755090531,55755090534,3,2479,1405,0
55757390234,55757390234,0,1207,2222,0
55760220370,55760220370,0,1091,1852,0
55760835961,55760835962,1,1398,1438,0
55762932195,55762932198,3,1726,1946,0
55769447757,55769447777,20,1271,2032,0
55773794931,55773794932,1,1012,1712,0
55775559938,55775559936,-2,1435,1965,0
55778381770,55778381770,0,1880,2023,0
55782252098,55782252098,0,1091,1052,0
55787618685,55787618685,0,1464,1670,0
55788673352,55788673371,19,1699,1800,0
55793589856,55793589855,-1,1539,1658,0
55797073790,55797073810,20,1809,1557,0
55799076929,55799076934,5,2334,738,0
55800114034,55800114034,0,1338,1621,0
55800605158,55800605159,1,1565,1919,0
55801684423,55801684425,2,1197,1540,0
55802246303,55802246303,0,1436,1754,0
55803539454,55803539456,2,1449,1618,0
55805014474,55805014474,0,731,1057,0
55806197408,55806197407,-1,1167,1815,0
55806609818,55806609819,1,1169,1222,0
55807102946,55807102948,2,1320,1705,0
55807445635,55807445633,-2,1211,1388,0
55808550694,55808550694,0,1432,1969,0
55809033351,55809033349,-2,1119,1268,0
55810719679,55810719682,3,1347,1541,0
55812056737,55812056738,1,1676,1910,0
55813510573,55813510575,2,1493,1114,0
55817619056,55817619056,0,2272,1861,0
55819524887,55819524887,0,1569,1680,0
55819573743,55819573741,-2,1306,1981,0
55819765827,55819765825,-2,2059,1336,0
55820289879,55820289881,2,1505,1418,0
55822164819,55822164821,2,1137,2064,0
55825411134,55825411135,1,1077,960,0
55827543281,55827543281,0,1870,1830,0
55828407248,55828407248,0,1352,2536,0
55829665318,55829665319,1,1288,1807,0
55830699872,55830699872,0,1562,2037,0
55832371870,55832371868,-2,1266,1748,0
55833708902,55833708903,1,1328,1592,0
55833883894,55833883892,-2,1413,1730,0
55835000848,55835000848,0,1689,2009,0
55839660574,55839660574,0,909,1795,0
55841352771,55841352771,0,1315,1694,0
55841517872,55841517872,0,1566,1522,0
55841872045,55841872047,2,1484,2015,0
55844991915,55844991915,0,1165,1183,0
55845560206,55845560206,0,1405,1905,0
55846040919,55846040920,1,843,1440,0
55847613762,55847613762,0,1420,1731,0
55851990572,55851990574,2,1184,1509,0
55853525229,55853525230,1,1850,2255,0
55854964982,55854964981,-1,1553,1551,0
55855623788,55855623790,2,2123,1842,0
55857047743,55857047745,2,996,1737,0
55857974143,55857974142,-1,956,1796,0
55859503794,55859503797,3,11789,11006,0
55861757683,55861757685,2,1644,2184,0
55863880695,55863880699,4,2470,1318,0
55867153782,55867153783,1,1433,1454,0
55867375921,55867375921,0,1376,1771,0
55871799327,55871799327,0,1939,1706,0
55873992774,55873992774,0,749,763,0
55874596066,55874596069,3,2531,1357,0
55874734334,55874734331,-3,1664,2554,0
55875397107,55875397109,2,1369,1332,0
55877263910,55877263912,2,1706,1879,0
55878659163,55878659162,-1,1365,1398,0
55879425702,55879425704,2,1149,1278,0
55884764874,55884764874,0,2185,1512,0
55886175131,55886175131,0,1302,1556,0
55886420477,55886420477,0,881,1265,0
55887075595,55887075597,2,1287,1391,0
55892578570,55892578570,0,1389,1791,0
55894110431,55894110430,-1,840,1311,0
55897291044,55897291046,2,1486,1681,0
55912144572,55912144578,6,2954,1322,0
55916840108,55916840107,-1,1131,1952,0
55917441714,55917441715,1,1180,1435,0
55920687025,55920687026,1,1654,1801,0
55921011957,55921011957,0,1685,1262,0
55922144522,55922144522,0,1560,1638,0
55922626697,55922626698,1,1536,1720,0
55925070518,55925070518,0,1435,1863,0
55926526252,55926526253,1,2182,1979,0
55926842350,55926842350,0,1969,2468,0
55930929674,55930929675,1,2040,1937,0
55931217420,55931217421,1,1501,1915,0
55931960422,55931960421,-1,1585,2323,0
55932257405,55932257405,0,1166,1333,0
55937473037,55937473037,0,1616,1233,0
55938733474,55938733475,1,1625,2062,0
55944624454,55944624449,-5,720,2694,0
55960753341,55960753341,0,1178,1483,0
55961920207,55961920207,0,1020,1340,0
55965697027,55965697027,0,1298,1677,0
55965842595,55965842595,0,1352,1725,0
55966984814,55966984815,1,1662,1349,0
55968097246,55968097248,2,911,1068,0
55971505319,55971505319,0,1729,2425,0
55972568885,55972568886,1,1635,1926,0
55973108790,55973108790,0,1727,2297,0
55973537684,55973537681,-3,1217,2006,0
55975359790,55975359790,0,1210,1798,0
55983853678,55983853678,0,1267,2034,0
55984607570,55984607571,1,1486,1389,0
55985798101,55985798102,1,1807,1618,0
55990121242,55990121223,-19,23489,27036,0
55990686317,55990686334,17,15359,36086,0
55990720070,55990720074,4,1423,1499,0
55994973917,55994973917,0,1125,1187,0
55998987989,55998987992,3,1159,1395,0
56001456035,56001456034,-1,799,971,0
56001782734,56001782735,1,2336,1878,0
56006258082,56006258082,0,1451,1857,0
56009009705,56009009705,0,1249,1990,0
56015938445,56015938447,2,1336,1402,0
56017740137,56017740138,1,1683,1830,0
56019848670,56019848670,0,1684,1742,0
56023081918,56023081920,2,1310,1465,0
56023639434,56023639434,0,1031,1311,0
56025245157,56025245157,0,1288,1502,0
56026515938,56026515933,-5,30436,16426,0
56026866851,56026866852,1,1848,1580,0
56028339640,56028339640,0,1721,2308,0
56029136461,56029136441,-20,1437,1583,0
56031499037,56031499039,2,1892,1464,0
56032007619,56032007623,4,26554,50016,0
56033924534,56033924532,-2,1148,1966,0
56034909267,56034909270,3,1874,1801,0
56036017430,56036017430,0,1166,1964,0
56039082914,56039082915,1,1627,2118,0
56039959124,56039959125,1,1467,2210,0
56040677990,56040677992,2,1213,1450,0
56042491937,56042491937,0,1342,1256,0
56042834754,56042834773,19,1276,1569,0
56044247169,56044247170,1,1102,955,0
56044772864,56044772882,18,834,1103,0
56046496206,56046496206,0,1509,1932,0
56047788273,56047788274,1,1185,1734,0
56049585590,56049585593,3,1637,2657,0
56052791762,56052791764,2,1377,2324,0
56053578564,56053578565,1,891,1770,0
56056810534,56056810538,4,2058,2078,0
56058710251,56058710251,0,1144,1235,0
56059169534,56059169523,-11,1218,1684,0
56059667331,56059667328,-3,1173,2831,0
56060591410,56060591410,0,1157,1751,0
56061686039,56061686038,-1,1196,1756,0
56061842405,56061842410,5,2616,1575,0
56062466892,56062466890,-2,855,1247,0
56064571786,56064571786,0,1605,1945,0
56066484361,56066484362,1,1446,1663,0
56067673257,56067673257,0,1361,1937,0
56068437578,56068437579,1,1443,1123,0
56070155613,56070155617,4,4191,1919,0
56075207049,56075207050,1,1407,1441,0
56076259778,56076259778,0,1885,2404,0
56079654434,56079654434,0,1529,2459,0
56083220093,56083220093,0,1687,2045,0
56089450242,56089450243,1,1536,1788,0
56090473282,56090473282,0,1381,1326,0
56095390341,56095390340,-1,1749,2162,0
56099314567,56099314568,1,1360,1423,0
56100121440,56100121442,2,1628,1403,0
56101168354,56101168361,7,3588,1160,0
56102017998,56102017998,0,934,1383,0
56105615249,56105615249,0,1043,1894,0
56105966004,56105966007,3,1305,1390,0
56108202658,56108202659,1,1782,2611,0
56108228783,56108228781,-2,1175,1539,0
56108444675,56108444673,-2,1547,1511,0
56110283009,56110283011,2,1388,1346,0
56111693537,56111693536,-1,1465,1628,0
56114525268,56114525272,4,1563,1213,0
56122369794,56122369793,-1,890,2361,0
56123386214,56123386214,0,627,596,0
56125632835,56125632836,1,1400,1500,0
56128555687,56128555687,0,1585,2170,0
56129908709,56129908711,2,1682,1531,0
56135725550,56135725553,3,2468,2460,0
56135781287,56135781286,-1,986,1125,0
56136488492,56136488493,1,1585,1865,0
56137498101,56137498101,0,1378,1614,0
56137628026,56137628027,1,1202,1266,0
56146280762,56146280762,0,1119,1436,0
56151508562,56151508569,7,1407,773,0
56154234007,56154234011,4,1999,1925,0
56155146539,56155146539,0,964,1462,0
56156940184,56156940182,-2,1491,1730,0
56159689841,56159689844,3,1220,1374,0
56159769107,56159769092,-15,562,464,0
56160035317,56160035319,2,950,1449,0
56163387786,56163387781,-5,1388,3060,0
56164159228,56164159229,1,1842,2024,0
56164472102,56164472105,3,938,1247,0
56165589578,56165589578,0,1561,1647,0
56166172269,56166172266,-3,2170,3347,0
56167068274,56167068275,1,1413,1665,0
56167535905,56167535906,1,1231,1487,0
56167963972,56167963972,0,916,1436,0
56171428882,56171428883,1,1630,1358,0
56172124724,56172124725,1,1131,1462,0
56172482592,56172482594,2,1889,2092,0
56173546487,56173546486,-1,1312,2355,0
56173872446,56173872448,2,1992,1712,0
56175640402,56175640403,1,1534,1938,0
56179503609,56179503610,1,1510,1232,0
56181497214,56181497216,2,1295,901,0
56181589692,56181589693,1,1516,2107,0
56182473234,56182473236,2,1211,1452,0
56185125922,56185125923,1,1031,1630,0
56186272966,56186272966,0,795,904,0
56188208108,56188208113,5,4192,2740,0
56190377814,56190377815,1,1180,1164,0
56192069374,56192069375,1,1565,1950,0
56197151255,56197151255,0,1462,2151,0
56200417183,56200417183,0,1382,1791,0
56201416778,56201416782,4,1907,1234,0
56202491990,56202491990,0,2074,1594,0
56204262291,56204262290,-1,1332,2414,0
56204781669,56204781669,0,989,1202,0
56206480453,56206480453,0,1059,1695,0
56206884853,56206884851,-2,1846,2312,0
56206970765,56206970758,-7,18737,13829,0
56208835173,56208835171,-2,1049,1182,0
56210870415,56210870416,1,1313,905,0
56216021231,56216021233,2,1713,1873,0
56218412681,56218412681,0,1237,1384,0
56219822581,56219822583,2,1978,1966,0
56220184370,56220184370,0,1372,1537,0
56221352720,56221352720,0,1522,1504,0
56224302321,56224302323,2,1656,1937,0
56228773317,56228773318,1,1504,1486,0
56230784083,56230784089,6,9189,5365,0
56233395148,56233395149,1,1489,1847,0
56234835812,56234835814,2,1557,1495,0
56235008577,56235008575,-2,873,1345,0
56238230193,56238230199,6,4194,2029,0
56238866715,56238866715,0,1247,1507,0
56240844276,56240844274,-2,997,1523,0
56247852158,56247852158,0,1515,2442,0
56249445276,56249445277,1,1822,1991,0
56253143795,56253143794,-1,1096,1485,0
56253682806,56253682807,1,1299,1787,0
56255997595,56255997594,-1,966,1239,0
56258875178,56258875191,13,1867,1009,0
56260834757,56260834758,1,1540,1270,0
56262460635,56262460636,1,1285,2372,0
56264061040,56264061046,6,1804,1347,0
56270606634,56270606634,0,1309,1665,0
56270807153,56270807154,1,1166,1696,0
56271978670,56271978673,3,3025,1554,0
56275341467,56275341466,-1,1129,1617,0
56276346875,56276346878,3,1101,1507,0
56281388057,56281388058,1,1608,2206,0
56283026183,56283026184,1,2011,1583,0
56283444794,56283444789,-5,1487,5112,0
56285149399,56285149399,0,1060,2127,0
56291042479,56291042477,-2,937,1246,0
56292615917,56292615919,2,1376,1366,0
56295257535,56295257535,0,1591,1756,0
56296297639,56296297641,2,1450,1451,0
56297680617,56297680619,2,1123,1430,0
56298134554,56298134572,18,1003,1229,0
56300991334,56300991335,1,1272,1490,0
56303195513,56303195514,1,1294,1536,0
56305698604,56305698605,1,12157,13420,0
56314224413,56314224418,5,4714,1712,0
56314724729,56314724729,0,1577,2315,0
56314818998,56314818997,-1,1002,2042,0
56315000376,56315000375,-1,1124,1047,0
56316269773,56316269769,-4,992,2504,0
56316982482,56316982481,-1,1875,1692,0
56320015537,56320015529,-8,1289,5576,0
56321296250,56321296246,-4,1157,2884,0
56321641149,56321641128,-21,1651,1814,0
56325422328,56325422330,2,1450,1336,0
56329738231,56329738230,-1,1523,2019,0
56332777203,56332777202,-1,1089,1706,0
56333196947,56333196949,2,1183,1379,0
56334863483,56334863480,-3,1022,1832,0
56338160546,56338160546,0,1036,1141,0
56341399656,56341399654,-2,1105,1421,0
56345649815,56345649812,-3,1279,1390,0
56347049363,56347049363,0,1786,1641,0
56347823822,56347823825,3,671,1098,0
56348820158,56348820158,0,1396,1689,0
56349358817,56349358838,21,908,1123,0
56349672752,56349672750,-2,1567,2043,0
56350565998,56350566002,4,1029,1539,0
56352758455,56352758449,-6,1366,5524,0
56355938355,56355938349,-6,979,1556,0
56356291382,56356291380,-2,1219,1808,0
56358611575,56358611575,0,1143,1757,0
56361235221,56361235220,-1,1565,1934,0
56362784534,56362784530,-4,1111,1361,0
56364460623,56364460625,2,1099,1391,0
56365104070,56365104070,0,1529,1512,0
56365397766,56365397748,-18,991,892,0
56367821671,56367821673,2,1054,1833,0
56368067272,56368067272,0,1739,1768,0
56371572854,56371572854,0,1515,1613,0
56372279758,56372279758,0,1446,1914,0
56376779627,56376779627,0,1089,1429,0
56377608311,56377608313,2,1723,1807,0
56378241479,56378241480,1,1213,1929,0
56378446182,56378446183,1,1150,1127,0
56380047702,56380047705,3,2173,1900,0
56382932168,56382932170,2,1570,1425,0
56387353133,56387353133,0,2065,2170,0
56391573841,56391573839,-2,1358,1579,0
56393600339,56393600340,1,1608,1722,0
56394440946,56394440946,0,1858,1400,0
56398462180,56398462181,1,1939,2041,0
56401586595,56401586597,2,1432,1972,0
56402016418,56402016419,1,2022,2285,0
56402077157,56402077158,1,981,1856,0
56409103398,56409103398,0,947,1055,0
56409668415,56409668419,4,9321,7240,0
56412371991,56412371992,1,1315,1229,0
56413550862,56413550859,-3,1558,2214,0
56414391758,56414391758,0,1126,1387,0
56418625002,56418625009,7,2426,1251,0
56419430014,56419430014,0,1066,1248,0
56421657722,56421657725,3,1648,1681,0
56422675058,56422675059,1,1458,1139,0
56423423092,56423423091,-1,1363,1397,0
56425238322,56425238322,0,1434,1905,0
56429372814,56429372815,1,1196,1462,0
56430686863,56430686863,0,1264,993,0
56433072782,56433072786,4,2414,1938,0
56440366430,56440366430,0,1084,1134,0
56442465606,56442465606,0,859,1186,0
56446221578,56446221579,1,2038,1874,0
56448638325,56448638323,-2,1447,2206,0
56452380890,56452380882,-8,2204,7245,0
56453825479,56453825479,0,1254,1559,0
56460728127,56460728127,0,714,1045,0
56464130893,56464130887,-6,2379,6014,0
56468248604,56468248606,2,1089,2128,0
56474127982,56474127980,-2,1175,2479,0
56474232385,56474232384,-1,1232,1209,0
56475233902,56475233906,4,2340,1362,0
56477593370,56477593372,2,1408,1585,0
56479233156,56479233158,2,1403,1595,0
56479433339,56479433339,0,1506,1929,0
56479777263,56479777261,-2,1288,1546,0
56480751568,56480751561,-7,1777,10590,0
56496277633,56496277640,7,1262,1324,0
56499740752,56499740736,-16,1351,1352,0
56504464557,56504464558,1,1446,1640,0
56504737137,56504737138,1,1279,2264,0
56505512848,56505512849,1,1424,1991,0
56506100830,56506100830,0,1003,1582,0
56509431278,56509431278,0,1143,1422,0
56511062236,56511062238,2,1900,1386,0
56514051434,56514051434,0,1198,1367,0
56523154314,56523154313,-1,1489,1927,0
56528537551,56528537546,-5,624,1882,0
56531681534,56531681531,-3,2381,6653,0
56534554677,56534554678,1,1895,2241,0
56535908155,56535908156,1,1649,1711,0
56536359601,56536359602,1,1195,1094,0
56538178490,56538178489,-1,1691,2249,0
56538927369,56538927371,2,1304,1207,0
56542113994,56542113997,3,2525,2616,0
56542991311,56542991310,-1,1269,1073,0
56543640893,56543640892,-1,1077,1742,0
56545424098,56545424099,1,1458,1454,0
56545941482,56545941463,-19,1351,1456,0
56546006818,56546006818,0,993,1222,0
56550545828,56550545829,1,1344,1696,0
56551180878,56551180878,0,939,1439,0
56552161606,56552161605,-1,1968,1810,0
56552225789,56552225787,-2,1385,1186,0
56553428116,56553428114,-2,1013,2135,0
56553601531,56553601531,0,1823,1588,0
56554819180,56554819195,15,558,1516,0
56555370374,56555370378,4,1842,1050,0
56556368386,56556368386,0,811,1394,0
56556921651,56556921651,0,1464,1672,0
56559732394,56559732393,-1,1401,1916,0
56560491537,56560491538,1,943,1597,0
56561041466,56561041467,1,1294,1501,0
56562308457,56562308456,-1,1224,1636,0
56569538658,56569538658,0,1344,1654,0
56569869272,56569869272,0,1569,1581,0
56570474126,56570474129,3,1005,1311,0
56571502488,56571502489,1,1368,1505,0
56571848735,56571848729,-6,1613,1675,0
56573914599,56573914602,3,1285,1831,0
56574724386,56574724387,1,1619,1366,0
56575445870,56575445872,2,2099,1761,0
56584172439,56584172438,-1,1294,1216,0
56584446138,56584446138,0,1439,1696,0
56586784586,56586784588,2,1472,2143,0
56587840402,56587840402,0,1886,1834,0
56590950627,56590950626,-1,1427,2054,0
56592224111,56592224126,15,1648,1098,0
56595158353,56595158353,0,1680,1683,0
56595348326,56595348327,1,1365,1718,0
56595966926,56595966911,-15,600,1104,0
56599038478,56599038481,3,1312,1118,0
56599264694,56599264694,0,931,1673,0
56602454478,56602454478,0,1077,1740,0
56603289221,56603289222,1,1751,1751,0
56606960626,56606960628,2,1616,2053,0
56610875437,56610875438,1,1391,1541,0
56612245505,56612245507,2,1274,1677,0
56613374174,56613374178,4,2219,2443,0
56614044470,56614044469,-1,1841,1685,0
56617121301,56617121302,1,1412,2022,0
56621494129,56621494130,1,841,1219,0
56621852325,56621852326,1,973,1174,0
56626385654,56626385655,1,1212,1002,0
56626950567,56626950569,2,1067,1984,0
56627047287,56627047288,1,891,1207,0
56628286247,56628286246,-1,1363,1845,0
56628728082,56628728083,1,1027,1598,0
56630636770,56630636770,0,925,1630,0
56631417535,56631417536,1,1233,1726,0
56633629199,56633629200,1,1528,1794,0
56634220822,56634220822,0,1002,1799,0
56635649588,56635649589,1,1352,2218,0
56640068778,56640068778,0,1727,1541,0
56640586399,56640586397,-2,1155,1277,0
56640831909,56640831911,2,1324,1340,0
56641565050,56641565050,0,1695,1211,0
56643907034,56643907038,4,2125,1025,0
56644643609,56644643609,0,1583,1467,0
56645829027,56645829026,-1,1256,1863,0
56647701863,56647701862,-1,1065,2070,0
56648113673,56648113673,0,1572,1429,0
56649355208,56649355207,-1,812,1434,0
56650212921,56650212923,2,1323,1898,0
56659494098,56659494100,2,1453,1208,0
56660683757,56660683758,1,1360,1729,0
56663106254,56663106255,1,879,1424,0
56664364641,56664364641,0,1049,1358,0
56666080038,56666080059,21,608,946,0
56669238787,56669238790,3,1301,1591,0
56669496701,56669496702,1,1150,1610,0
56669778087,56669778081,-6,968,4455,0
56672907798,56672907798,0,2363,2361,0
56675121351,56675121350,-1,1724,1728,0
56675345343,56675345358,15,751,9848,0
56676010141,56676010138,-3,1092,1867,0
56679271674,56679271673,-1,1682,2011,0
56680979366,56680979370,4,3165,1957,0
56682271886,56682271886,0,1141,1973,0
56684944492,56684944491,-1,1755,2186,0
56685693967,56685693968,1,1041,1524,0
56688040525,56688040527,2,1306,1801,0
56688739139,56688739143,4,1343,1235,0
56690360694,56690360694,0,1340,1404,0
56691112217,56691112216,-1,1567,1820,0
56698087308,56698087316,8,1220,1589,0
56699952280,56699952279,-1,1401,1929,0
56700741723,56700741723,0,1315,2197,0
56701400633,56701400635,2,1289,1052,0
56702754611,56702754614,3,3909,2071,0
56705857190,56705857194,4,3347,1579,0
56711345970,56711345970,0,1849,1859,0
56712478423,56712478419,-4,23705,11386,0
56714480594,56714480594,0,894,884,0
56720977104,56720977110,6,16832,22631,0
56723744979,56723744977,-2,1141,1569,0
56724058199,56724058214,15,259,999,0
56725551624,56725551631,7,1048,1303,0
56726613794,56726613793,-1,1234,2051,0
56726901792,56726901785,-7,1609,8773,0
56726950507,56726950486,-21,1125,1511,0
56727625412,56727625413,1,1528,2266,0
56731229453,56731229454,1,1427,1969,0
56731673338,56731673339,1,1622,899,0
56733237969,56733237974,5,3130,2024,0
56735002578,56735002576,-2,3111,6328,0
56742642199,56742642197,-2,735,948,0
56744340494,56744340499,5,1992,929,0
56745528023,56745528022,-1,1279,1667,0
56745597118,56745597137,19,641,737,0
56747189077,56747189078,1,2038,1912,0
56747346338,56747346339,1,1178,1177,0
56750290799,56750290798,-1,1309,2113,0
56751218653,56751218652,-1,996,1494,0
56752575925,56752575926,1,1509,2097,0
56753956999,56753957000,1,1448,794,0
56754782594,56754782595,1,1483,2339,0
56757114814,56757114815,1,1585,1807,0
56758514437,56758514435,-2,791,1254,0
56761522216,56761522216,0,975,1782,0
56763595203,56763595203,0,1016,2129,0
56763949834,56763949836,2,1497,2237,0
56765456042,56765456043,1,1991,1705,0
56765781270,56765781270,0,1695,1384,0
56768189654,56768189654,0,1224,1445,0
56769763310,56769763313,3,888,1404,0
56771038990,56771038991,1,1253,1064,0
56772183151,56772183153,2,1373,1835,0
56772776798,56772776798,0,872,1895,0
56773075702,56773075703,1,1459,1918,0
56773151806,56773151807,1,1355,1416,0
56776436686,56776436687,1,1416,1535,0
56786551291,56786551289,-2,929,1442,0
56787142374,56787142370,-4,1186,2334,0
56787600134,56787600134,0,1093,1331,0
56792056758,56792056758,0,1218,1605,0
56794591073,56794591074,1,1448,1690,0
56796679160,56796679161,1,1294,1943,0
56796838510,56796838509,-1,1141,1537,0
56802884999,56802885007,8,2586,1130,0
56806787290,56806787290,0,1412,1794,0
56807291090,56807291092,2,1548,1743,0
56813994573,56813994577,4,2427,1742,0
56814723727,56814723726,-1,1680,3211,0
56816669766,56816669766,0,1213,1479,0
56818449904,56818449902,-2,1292,1300,0
56820494318,56820494317,-1,1135,1314,0
56821117448,56821117446,-2,1154,1963,0
56821974606,56821974595,-11,984,1830,0
56823334368,56823334369,1,1571,2118,0
56825732183,56825732184,1,2085,1783,0
56826878766,56826878765,-1,958,1686,0
56829051958,56829051959,1,1356,1735,0
56830737667,56830737667,0,1451,1781,0
56832739169,56832739171,2,1514,1771,0
56834051862,56834051869,7,4124,1548,0
56835785249,56835785249,0,1434,1558,0
56836895365,56836895364,-1,1137,1503,0
56844772907,56844772917,10,1814,1384,0
56850506023,56850506023,0,877,1043,0
56851230650,56851230646,-4,888,2723,0
56853562720,56853562721,1,1145,1586,0
56854103700,56854103694,-6,1290,1415,0
56855733367,56855733368,1,1579,1359,0
56856604914,56856604914,0,2095,2413,0
56859054157,56859054157,0,1356,1979,0
56862182004,56862182005,1,1464,1717,0
56867406119,56867406119,0,955,1580,0
56869492114,56869492115,1,1579,2249,0
56870793686,56870793686,0,1222,1997,0
56871892836,56871892835,-1,1891,1584,0
56874484338,56874484340,2,1506,1710,0
56875603438,56875603439,1,1766,1784,0
56878677268,56878677267,-1,1215,1344,0
56879846270,56879846275,5,1206,1659,0
56880738392,56880738393,1,1560,1650,0
56881909580,56881909578,-2,1691,1590,0
56883776589,56883776590,1,1460,2446,0
56885795014,56885795016,2,1240,1796,0
56886852276,56886852274,-2,1249,1350,0
56888431770,56888431769,-1,1418,2066,0
56888826802,56888826801,-1,2778,4307,0
56894578089,56894578090,1,1209,1451,0
56902195163,56902195163,0,763,1290,0
56903683704,56903683705,1,1677,1837,0
56906464989,56906464990,1,1482,2181,0
56909287630,56909287630,0,2723,1902,0
56910723122,56910723122,0,1645,1358,0
56916142697,56916142695,-2,949,1466,0
56918652571,56918652570,-1,1428,1859,0
56918905410,56918905409,-1,1293,1772,0
56920568101,56920568102,1,1210,1230,0
56921635202,56921635203,1,1852,2384,0
56924627956,56924627957,1,1561,2456,0
56925922369,56925922370,1,1540,1644,0
56926717605,56926717606,1,1427,2057,0
56928562698,56928562697,-1,1386,1874,0
56928842715,56928842716,1,1210,2025,0
56937790126,56937790126,0,1300,2093,0
56938069941,56938069962,21,289,1050,0
56939382418,56939382399,-19,1231,1255,0
56940611730,56940611731,1,1857,2624,0
56941770643,56941770645,2,1135,1224,0
56942939531,56942939533,2,1832,1715,0
56945297453,56945297466,13,1853,1429,0
56945657587,56945657588,1,1728,1461,0
56948624834,56948624835,1,1543,1707,0
56952744791,56952744792,1,1888,2087,0
56954279981,56954279983,2,938,803,0
56959420817,56959420817,0,1459,2067,0
56959475133,56959475134,1,1252,1387,0
56960433365,56960433366,1,1253,1863,0
56968063886,56968063886,0,1254,1164,0
56970854265,56970854265,0,1812,2261,0
56971004910,56971004914,4,2646,1732,0
56974053918,56974053915,-3,1518,1282,0
56977016304,56977016305,1,1264,2004,0
56979774080,56979774078,-2,974,1619,0
56980514019,56980514019,0,1768,2213,0
56981081470,56981081470,0,1476,1523,0
56981107434,56981107412,-22,1122,963,0
56981876443,56981876442,-1,1431,1961,0
56983018730,56983018730,0,1443,1689,0
56984232714,56984232713,-1,1670,1625,0
56984363228,56984363225,-3,769,1650,0
56984871148,56984871149,1,814,1059,0
56988681164,56988681166,2,1249,1214,0
56990619025,56990619027,2,1064,1253,0
56994364411,56994364418,7,9655,2668,0
56995515967,56995515973,6,3158,1121,0
56996736647,56996736651,4,2221,1291,0
56997856626,56997856626,0,1312,1367,0
56998143812,56998143813,1,1011,1339,0
56999770677,56999770679,2,1273,1529,0
56999948591,56999948591,0,1242,1409,0
56999994148,56999994150,2,1975,1597,0
57000897313,57000897295,-18,1046,1029,0
57005181127,57005181146,19,1448,1845,0
57007921648,57007921648,0,1542,1607,0
57010516534,57010516534,0,2323,2168,0
57012497332,57012497331,-1,1149,1678,0
57013219329,57013219330,1,1011,1896,0
57013379335,57013379318,-17,1168,1234,0
57016822703,57016822706,3,808,1580,0
57018437765,57018437764,-1,1200,1535,0
57020329974,57020329973,-1,1402,1685,0
57021070412,57021070412,0,1189,2049,0
57027042033,57027042034,1,869,1603,0
57028563646,57028563645,-1,1703,1202,0
57034099759,57034099758,-1,2116,1599,0
57034469738,57034469739,1,1671,1679,0
57034864343,57034864342,-1,1958,2345,0
57035000469,57035000468,-1,1136,1074,0
57036498161,57036498163,2,1635,1637,0
57036721815,57036721835,20,1436,1839,0
57040056903,57040056901,-2,1235,1482,0
57043246030,57043246031,1,1440,1616,0
57048320537,57048320539,2,2486,1425,0
57048945918,57048945921,3,1402,1688,0
57050624125,57050624127,2,1440,1400,0
57052248663,57052248665,2,1473,1996,0
57054188070,57054188072,2,1920,1513,0
57056043080,57056043081,1,1525,2325,0
57056409112,57056409118,6,6279,2710,0
57056986449,57056986448,-1,1525,2392,0
57058251709,57058251710,1,1462,1718,0
57058457994,57058457995,1,1094,1570,0
57066794237,57066794242,5,1871,982,0
57071344899,57071344900,1,1475,2103,0
57073879527,57073879528,1,1681,1771,0
57078017279,57078017278,-1,2171,2397,0
57078155722,57078155722,0,1431,2871,0
57078896219,57078896218,-1,1170,2459,0
57080496287,57080496287,0,1419,2065,0
57082987366,57082987366,0,1384,1967,0
57083124635,57083124636,1,1606,1851,0
57083876323,57083876322,-1,1327,1808,0
57084296901,57084296902,1,1398,1735,0
57088817728,57088817728,0,1590,1182,0
57091757666,57091757664,-2,1137,1838,0
57094035000,57094035002,2,1368,1732,0
57094379561,57094379561,0,1916,2683,0
57095843447,57095843449,2,2784,3137,0
57096134617,57096134615,-2,1150,2113,0
57097755673,57097755675,2,1824,1753,0
57098674259,57098674261,2,916,1519,0
57099643979,57099643978,-1,1427,2128,0
57101423374,57101423377,3,1038,1155,0
57102205846,57102205851,5,4625,2648,0
57102301794,57102301794,0,1956,1554,0
57106247194,57106247199,5,3813,1608,0
57106467261,57106467273,12,14336,20157,0
57108869518,57108869519,1,1740,1767,0
57109841042,57109841042,0,1318,1548,0
57110739931,57110739932,1,1575,2642,0
57110988742,57110988742,0,1069,1434,0
57114033570,57114033569,-1,1245,1066,0
57116060784,57116060801,17,1220,1232,0
57118093143,57118093145,2,1184,1775,0
57120809743,57120809758,15,1107,856,0
57125560828,57125560829,1,1624,2022,0
57125903180,57125903188,8,1764,2100,0
57125953341,57125953342,1,1204,2017,0
57130322212,57130322213,1,1192,1526,0
57132066922,57132066926,4,1472,1383,0
57132290606,57132290606,0,1207,1585,0
57134382278,57134382278,0,1135,1556,0
57134408034,57134408035,1,1636,2014,0
57135046845,57135046844,-1,984,1427,0
57135529605,57135529598,-7,1127,1281,0
57135726053,57135726050,-3,1228,2287,0
57136186873,57136186874,1,1555,1650,0
57139175022,57139175022,0,1346,1522,0
57140330671,57140330670,-1,1618,2282,0
57141849779,57141849789,10,10208,35892,0
57142101881,57142101881,0,1376,1697,0
57142312724,57142312721,-3,1710,1780,0
57142569402,57142569403,1,1651,1566,0
57143384120,57143384121,1,1633,2252,0
57144112802,57144112802,0,1759,1850,0
57145293833,57145293833,0,1612,1656,0
57150117446,57150117446,0,1184,1472,0
57154924935,57154924935,0,2107,2864,0
57155151894,57155151893,-1,1209,1563,0
57156534164,57156534164,0,1848,2162,0
57161805963,57161805963,0,1789,1826,0
57163371985,57163371986,1,2020,1290,0
57163936002,57163936003,1,1391,1712,0
57168023118,57168023122,4,1950,1609,0
57171523117,57171523118,1,1205,2246,0
57172264857,57172264857,0,1525,2094,0
57172765295,57172765296,1,1095,1897,0
57175538975,57175538975,0,1314,1266,0
57175897839,57175897839,0,873,1195,0
57178418442,57178418443,1,1068,1883,0
57181450321,57181450323,2,1766,1727,0
57182656772,57182656774,2,1852,1504,0
57185282162,57185282162,0,1129,1704,0
57185404358,57185404358,0,1744,1687,0
57186653375,57186653374,-1,1172,1827,0
57187379615,57187379615,0,1558,1319,0
57189085960,57189085961,1,1145,1303,0
57189374982,57189374982,0,1115,1876,0
57189773689,57189773690,1,1626,2531,0
57193954449,57193954449,0,1665,1975,0
57194713835,57194713836,1,1474,1520,0
57195144406,57195144406,0,1504,1699,0
57196991819,57196991822,3,1192,1505,0
57197634815,57197634815,0,1077,817,0
57198972322,57198972326,4,1696,1407,0
57200356529,57200356531,2,1566,1509,0
57201606189,57201606185,-4,1443,2521,0
57202367246,57202367247,1,1453,1052,0
57204581910,57204581911,1,1811,1663,0
57206291726,57206291725,-1,1453,1754,0
57206440486,57206440485,-1,1550,2512,0
57206488166,57206488164,-2,1212,1919,0
57210493113,57210493113,0,1828,2150,0
57212003613,57212003612,-1,1002,1959,0
57216062683,57216062682,-1,1473,2082,0
57216893617,57216893618,1,1207,1546,0
57217347895,57217347893,-2,1002,1770,0
57221051495,57221051497,2,1396,1735,0
57223459054,57223459056,2,2030,1644,0
57223625702,57223625701,-1,1996,1885,0
57224696634,57224696635,1,828,751,0
57227373358,57227373359,1,1480,1880,0
57229077014,57229077000,-14,1166,1558,0
57229689446,57229689445,-1,964,1581,0
57230247078,57230247079,1,1813,2338,0
57231179407,57231179405,-2,1214,1908,0
57231670183,57231670183,0,1786,2622,0
57232428011,57232428011,0,1057,2033,0
57234031897,57234031895,-2,1439,2006,0
57234153080,57234153078,-2,1271,2002,0
57234359102,57234359097,-5,166,1328,0
57234731955,57234731957,2,1520,1745,0
57234825590,57234825593,3,1337,1607,0
57237105634,57237105635,1,919,1195,0
57243223910,57243223912,2,1106,2142,0
57244277431,57244277433,2,1072,975,0
57247719005,57247719004,-1,1311,2069,0
57251581475,57251581476,1,1382,1890,0
57252970946,57252970946,0,1704,1864,0
57254223204,57254223203,-1,1256,1430,0
57262457581,57262457582,1,1268,1587,0
57262951123,57262951142,19,1276,2016,0
57269265097,57269265098,1,1533,1569,0
57269417921,57269417903,-18,1373,1226,0
57270233049,57270233049,0,1951,1799,0
57276002282,57276002287,5,2198,787,0
57278842218,57278842220,2,1170,1559,0
57282531492,57282531494,2,1335,1393,0
57283200774,57283200773,-1,1224,1591,0
57287214262,57287214261,-1,1395,1420,0
57288718349,57288718354,5,4829,1667,0
57289198997,57289198998,1,1085,1585,0
57289752666,57289752667,1,1837,1984,0
57290200919,57290200921,2,1412,1513,0
57294067539,57294067541,2,1111,1713,0
57294365061,57294365063,2,1516,1244,0
57296842858,57296842859,1,1052,1661,0
57297189278,57297189278,0,1192,1296,0
57297737941,57297737941,0,1685,1773,0
57299237662,57299237666,4,900,909,0
57300056639,57300056637,-2,1052,1443,0
57301166750,57301166750,0,1435,1277,0
57302740625,57302740626,1,1596,1856,0
57303382890,57303382889,-1,1744,2038,0
57306874254,57306874255,1,1275,2049,0
57310940038,57310940039,1,1546,1450,0
57312448197,57312448198,1,946,1154,0
57312624350,57312624353,3,1631,1319,0
57316133546,57316133546,0,1186,2000,0
57317208913,57317208915,2,1216,998,0
57319272969,57319272969,0,1375,1200,0
57320740958,57320740959,1,1554,1399,0
57320956487,57320956488,1,1325,1907,0
57322404356,57322404355,-1,1183,1387,0
57330947482,57330947477,-5,667,2389,0
57333220949,57333220949,0,1145,1464,0
57333474375,57333474378,3,966,1369,0
57334883256,57334883255,-1,1151,1768,0
57337763529,57337763531,2,1450,1556,0
57341048670,57341048670,0,1259,1398,0
57343224303,57343224305,2,1264,1632,0
57343962070,57343962066,-4,2516,5352,0
57351080398,57351080398,0,1412,1583,0
57351865439,57351865442,3,896,1130,0
57352398178,57352398178,0,1593,2123,0
57357633630,57357633629,-1,17308,9924,0
57358294118,57358294117,-1,1281,1607,0
57359553798,57359553802,4,1513,1318,0
57361184791,57361184790,-1,1068,1024,0
57364101149,57364101149,0,1479,1677,0
57366385286,57366385286,0,1319,1354,0
57369590451,57369590455,4,2045,1556,0
57369633158,57369633162,4,1615,1974,0
57370695934,57370695932,-2,1266,2180,0
57371015565,57371015566,1,1766,2012,0
57373961583,57373961585,2,2253,2320,0
57375652923,57375652925,2,1670,1823,0
57378529857,57378529858,1,1650,1294,0
57379967510,57379967511,1,739,852,0
57383238293,57383238304,11,17579,30675,0
57390233411,57390233411,0,1161,1760,0
57393248898,57393248899,1,1992,1997,0
57393888499,57393888501,2,1581,2043,0
57397388919,57397388920,1,1074,1815,0
57398117221,57398117228,7,6206,2743,0
57400102346,57400102341,-5,1277,3287,0
57400735451,57400735453,2,1394,1900,0
57403555858,57403555858,0,1443,1584,0
57404220118,57404220120,2,1408,1847,0
57404422544,57404422542,-2,1160,1760,0
57405206052,57405206050,-2,2206,2132,0
57406500791,57406500791,0,657,980,0
57407381994,57407381989,-5,1847,6279,0
57407585251,57407585251,0,1162,1478,0
57407793649,57407793650,1,990,1658,0
57408587051,57408587052,1,1471,2005,0
57413860234,57413860234,0,1485,1686,0
57415779453,57415779453,0,1329,1662,0
57417380351,57417380353,2,1326,1220,0
57418100694,57418100698,4,1451,1783,0
57421854161,57421854161,0,1855,1744,0
57423563618,57423563617,-1,1031,1282,0
57425570021,57425570022,1,1389,2204,0
57426631047,57426631048,1,1421,1565,0
57427068671,57427068671,0,1468,1638,0
57427306448,57427306449,1,1667,1626,0
57429372009,57429372010,1,1299,1867,0
57431066738,57431066741,3,1251,1235,0
57434317392,57434317394,2,1393,1306,0
57435436718,57435436721,3,1016,1411,0
57435662226,57435662227,1,1707,1953,0
57437891309,57437891310,1,1363,1533,0
57439747198,57439747201,3,1275,1445,0
57441581551,57441581553,2,1605,2108,0
57443737539,57443737538,-1,1700,2410,0
57444071568,57444071566,-2,1270,1480,0
57446748333,57446748333,0,1364,1491,0
57447678729,57447678730,1,1238,1297,0
57448190486,57448190488,2,1474,1973,0
57448664621,57448664622,1,1347,1685,0
57448817992,57448818005,13,2006,1608,0
57449191901,57449191902,1,1067,1256,0
57449778558,57449778557,-1,1054,1889,0
57451304435,57451304435,0,1366,2229,0
57454303502,57454303498,-4,901,2846,0
57456086973,57456086978,5,1924,1382,0
57456939585,57456939584,-1,1299,1642,0
57461944706,57461944713,7,5328,1620,0
57462045250,57462045246,-4,1362,2059,0
57462080310,57462080290,-20,1363,1079,0
57462944772,57462944772,0,22980,9099,0
57468014973,57468014973,0,1408,1269,0
57468180958,57468180961,3,1485,1715,0
57469940615,57469940615,0,1142,1604,0
57470194964,57470194965,1,1482,1105,0
57470381466,57470381465,-1,1071,1167,0
57472932569,57472932567,-2,1566,1459,0
57476362339,57476362339,0,1107,1482,0
57478009285,57478009285,0,1189,1846,0
57479722082,57479722080,-2,1147,1252,0
57481487217,57481487218,1,1938,2318,0
57485859694,57485859694,0,1266,1697,0
57492018734,57492018737,3,1621,1586,0
57492193899,57492193901,2,1659,1769,0
57492858973,57492858970,-3,29577,10848,0
57492926641,57492926641,0,1319,1902,0
57493458364,57493458384,20,1343,1488,0
57493851878,57493851877,-1,1011,1519,0
57495166091,57495166090,-1,1603,1866,0
57495294703,57495294705,2,1619,1827,0
57495485906,57495485906,0,1259,1055,0
57495798382,57495798383,1,1319,1580,0
57496985766,57496985769,3,1153,1816,0
57498092338,57498092338,0,953,1166,0
57509486187,57509486178,-9,260,1311,0
57513103362,57513103359,-3,1401,1927,0
57516462349,57516462351,2,1204,1556,0
57517486682,57517486683,1,1601,1424,0
57518966970,57518966970,0,2013,2057,0
57519314085,57519314083,-2,1378,2085,0
57521260443,57521260442,-1,1170,1342,0
57522519262,57522519259,-3,1334,1644,0
57522965180,57522965180,0,1059,1923,0
57523543310,57523543309,-1,1161,1432,0
57524365238,57524365238,0,1918,2329,0
57526743795,57526743798,3,1508,1418,0
57527090499,57527090498,-1,1158,1918,0
57527453435,57527453437,2,1840,1902,0
57529114922,57529114923,1,1294,2069,0
57531794267,57531794262,-5,977,3133,0
57533569038,57533569050,12,17442,10290,0
57536089470,57536089480,10,1421,1275,0
57536563786,57536563792,6,3467,1623,0
57538053995,57538053996,1,1913,1660,0
57541468507,57541468508,1,1235,1784,0
57543695396,57543695394,-2,1365,1809,0
57546461518,57546461519,1,1709,1937,0
57547525955,57547525957,2,1337,1539,0
57548922561,57548922562,1,609,1830,0
57550142238,57550142238,0,1133,1190,0
57552817623,57552817626,3,1725,1225,0
57559238162,57559238163,1,2234,1005,0
57560440939,57560440939,0,1684,1692,0
57560915338,57560915338,0,1230,1317,0
57561688488,57561688492,4,2008,1935,0
57562786975,57562786976,1,1402,1995,0
57563325290,57563325290,0,1163,2092,0
57564543181,57564543181,0,1430,1680,0
57565778091,57565778089,-2,1557,1394,0
57569887055,57569887055,0,1137,1891,0
57574324403,57574324405,2,2081,1312,0
57575839324,57575839323,-1,1736,1360,0
57579110800,57579110799,-1,2051,2144,0
57581220205,57581220205,0,1115,1422,0
57582743627,57582743627,0,1856,1440,0
57582925296,57582925296,0,1706,1587,0
57584259615,57584259614,-1,1780,1964,0
57584928071,57584928072,1,1774,1760,0
57585441600,57585441601,1,1271,1581,0
57587940543,57587940544,1,1366,1656,0
57594190278,57594190274,-4,1524,2894,0
57595315893,57595315895,2,729,1234,0
57602818561,57602818562,1,1139,1289,0
57603660811,57603660811,0,1731,2049,0
57603839505,57603839508,3,1811,1090,0
57609168423,57609168424,1,1304,1555,0
57610019208,57610019209,1,1550,1804,0
57610235416,57610235414,-2,1298,1545,0
57622474468,57622474468,0,1847,2040,0
57625815247,57625815249,2,953,1718,0
57627140207,57627140207,0,880,946,0
57627784306,57627784306,0,863,1735,0
57629578589,57629578590,1,1840,2053,0
57629853619,57629853617,-2,653,1095,0
57633248609,57633248609,0,1488,1858,0
57636079962,57636079965,3,1295,1440,0
57638075338,57638075340,2,1641,1938,0
57641145495,57641145497,2,1929,1582,0
57642014464,57642014470,6,2470,1662,0
57647972943,57647972942,-1,1541,2477,0
57648788319,57648788318,-1,1210,1719,0
57650370474,57650370476,2,1473,1311,0
57650834903,57650834902,-1,1065,1406,0
57653566860,57653566862,2,1152,1380,0
57653960119,57653960120,1,1324,1140,0
57657343418,57657343414,-4,407,218,0
57658884925,57658884926,1,1404,1983,0
57660153314,57660153315,1,1567,1598,0
57661480519,57661480518,-1,1519,1740,0
57661730215,57661730218,3,1502,1560,0
57662915054,57662915054,0,1155,1342,0
57665354714,57665354715,1,1460,1623,0
57666100641,57666100642,1,1228,1664,0
57672403299,57672403299,0,1233,1622,0
57675541217,57675541218,1,1350,805,0
57675773620,57675773621,1,1416,2149,0
57679756037,57679756037,0,932,1439,0
57680650735,57680650736,1,1304,2010,0
57681468912,57681468913,1,1278,1862,0
57681627614,57681627616,2,803,767,0
57682110751,57682110752,1,1108,1605,0
57683074306,57683074306,0,1388,1750,0
57683915974,57683915974,0,1523,1376,0
57684507593,57684507591,-2,1038,2019,0
57689528623,57689528622,-1,1900,2069,0
57692192977,57692192982,5,2334,1401,0
57693847447,57693847442,-5,1053,3008,0
57698795212,57698795215,3,1807,1357,0
57699840126,57699840125,-1,1243,1644,0
57707557550,57707557553,3,1245,1776,0
57707767935,57707767930,-5,742,3021,0
57710977003,57710977003,0,1145,1492,0
57716313090,57716313090,0,1493,1077,0
57718260971,57718260973,2,2071,2157,0
57718466334,57718466333,-1,1288,1651,0
57719575769,57719575770,1,1791,1923,0
57720968663,57720968663,0,1211,1879,0
57721363744,57721363743,-1,2072,2608,0
57724595586,57724595589,3,1587,1597,0
57726188749,57726188750,1,1645,1750,0
57730081935,57730081934,-1,1317,1515,0
57731535493,57731535494,1,1161,1584,0
57732646442,57732646442,0,1391,1661,0
57734099657,57734099658,1,2845,3510,0
57734973838,57734973839,1,1181,1550,0
57735321190,57735321191,1,1540,1464,0
57736810822,57736810822,0,1472,1972,0
57737458945,57737458945,0,2010,2165,0
57738665544,57738665543,-1,1620,2388,0
57740553384,57740553383,-1,1204,1486,0
57741903045,57741903045,0,1578,1711,0
57742625997,57742625994,-3,1548,1958,0
57744970944,57744970943,-1,1151,1558,0
57745160246,57745160248,2,1535,1939,0
57748132366,57748132365,-1,740,1410,0
57748803378,57748803378,0,1379,1499,0
57749192884,57749192883,-1,1214,1350,0
57749452513,57749452514,1,1009,1238,0
57749604874,57749604874,0,1275,1954,0
57750463110,57750463109,-1,1726,1915,0
57755358610,57755358626,16,299,1467,0
57757729500,57757729486,-14,1393,1580,0
57759455530,57759455543,13,882,1293,0
57762718035,57762718037,2,1780,1017,0
57764647349,57764647349,0,1063,1509,0
57764837221,57764837224,3,1172,1309,0
57765298732,57765298731,-1,1679,2219,0
57765391989,57765391989,0,1254,1104,0
57768498842,57768498842,0,1606,1117,0
57769276794,57769276796,2,1294,1230,0
57771281035,57771281036,1,1588,1711,0
57775744472,57775744481,9,16040,34639,0
57777077758,57777077761,3,1023,1695,0
57777297862,57777297847,-15,1657,1393,0
57779664306,57779664306,0,1132,1552,0
57782909350,57782909351,1,2436,2141,0
57786042494,57786042489,-5,2586,8815,0
57786107478,57786107462,-16,1467,1009,0
57787877482,57787877478,-4,1530,3294,0
57789085143,57789085145,2,792,1895,0
57789301836,57789301818,-18,1006,1503,0
57793280856,57793280856,0,1996,1552,0
57794998489,57794998489,0,1353,2137,0
57798130703,57798130703,0,1272,1122,0
57802455986,57802455987,1,1587,1635,0
57802797911,57802797910,-1,788,1182,0
57804733578,57804733578,0,1468,1831,0
57808342463,57808342465,2,1224,2211,0
57808462302,57808462302,0,848,1001,0
57812201218,57812201218,0,1729,2074,0
57817147993,57817147994,1,1444,1424,0
57817404143,57817404126,-17,1605,1546,0
57819503685,57819503686,1,1362,1779,0
57828167668,57828167680,12,2774,1628,0
57828220021,57828220022,1,1547,2381,0
57828741978,57828741975,-3,1123,1154,0
57829840654,57829840656,2,1379,1736,0
57830237890,57830237882,-8,1583,7869,0
57831460855,57831460857,2,554,1049,0
57832509060,57832509061,1,2235,2063,0
57834862175,57834862176,1,962,1835,0
57836322396,57836322394,-2,1247,2309,0
57837735093,57837735094,1,2002,1799,0
57840559101,57840559102,1,1180,1889,0
57840632640,57840632645,5,2052,585,0
57846667506,57846667507,1,1748,1983,0
57848028926,57848028926,0,1451,1781,0
57849382222,57849382219,-3,1148,2826,0
57852379091,57852379091,0,1501,1759,0
57856703637,57856703638,1,1330,1978,0
57858831654,57858831659,5,2484,1564,0
57864964207,57864964208,1,1328,1903,0
57866876639,57866876638,-1,1684,2156,0
57866930845,57866930845,0,1368,1320,0
57867084997,57867084996,-1,1600,2082,0
57870776805,57870776805,0,1152,1462,0
57876612646,57876612646,0,1113,1688,0
57881568965,57881568966,1,1353,1522,0
57881875459,57881875459,0,1832,1683,0
57882891898,57882891903,5,2155,1244,0
57883296417,57883296423,6,1074,1308,0
57884609765,57884609766,1,1744,1727,0
57884686544,57884686545,1,1626,1442,0
57885257339,57885257339,0,1474,2141,0
57885747615,57885747615,0,1256,1534,0
57887713604,57887713606,2,857,1247,0
57890433786,57890433789,3,1644,1436,0
57890572086,57890572084,-2,1200,1470,0
57891079090,57891079089,-1,1543,1318,0
57893606062,57893606066,4,866,1057,0
57897452625,57897452627,2,1568,1299,0
57897872041,57897872042,1,1396,1844,0
57900127617,57900127618,1,1774,1767,0
57900538386,57900538384,-2,1238,1637,0
57901071141,57901071159,18,631,1931,0
57905778699,57905778699,0,1288,1693,0
57908408275,57908408275,0,1579,1565,0
57908484075,57908484086,11,1529,1729,0
57908587352,57908587358,6,1558,1410,0
57916088294,57916088296,2,1773,1520,0
57921860268,57921860269,1,1770,1267,0
57925357376,57925357374,-2,1614,2430,0
57926185614,57926185614,0,1815,2047,0
57926446685,57926446689,4,2210,1383,0
57928188905,57928188905,0,1008,1269,0
57928287522,57928287521,-1,1061,1863,0
57930602186,57930602186,0,1410,1515,0
57931214508,57931214507,-1,1332,2292,0
57932626606,57932626606,0,1129,1563,0
57934681790,57934681791,1,1441,1992,0
57935031423,57935031425,2,1280,1918,0
57935152649,57935152652,3,2448,1637,0
57935913255,57935913256,1,1320,1433,0
57937194337,57937194338,1,1439,1414,0
57938590992,57938590992,0,1641,1818,0
57941699704,57941699706,2,1591,1918,0
57951824249,57951824249,0,892,1270,0
57955636803,57955636803,0,1501,1162,0
57958149090,57958149090,0,1246,1195,0
57963047109,57963047109,0,1390,1607,0
57966563837,57966563838,1,1551,1731,0
57966755641,57966755643,2,1688,1380,0
57967342860,57967342858,-2,1167,1900,0
57968516480,57968516479,-1,1809,2595,0
57972956605,57972956605,0,1318,1930,0
57974803547,57974803546,-1,1358,1274,0
57977758810,57977758810,0,1706,1662,0
57979476894,57979476894,0,1170,1680,0
57983242507,57983242509,2,1646,1608,0
57985073290,57985073283,-7,815,2625,0
57992809116,57992809116,0,1160,1026,0
57994964728,57994964726,-2,1386,1805,0
57997889356,57997889357,1,1176,1810,0
58001133411,58001133410,-1,646,914,0
58003298377,58003298378,1,1694,1371,0
58008834983,58008834981,-2,1385,1596,0
58009436199,58009436200,1,1334,1705,0
58010267791,58010267794,3,1355,1731,0
58014545959,58014545959,0,1792,1971,0
58018838569,58018838556,-13,1039,425,0
58019433867,58019433868,1,1205,1864,0
58020855887,58020855886,-1,1901,2013,0
58023871165,58023871163,-2,948,2162,0
58025000758,58025000759,1,956,1396,0
58026239903,58026239902,-1,1223,1619,0
58027011673,58027011674,1,1157,1568,0
58033198333,58033198330,-3,1043,2462,0
58035123495,58035123497,2,1444,1678,0
58037388813,58037388815,2,1313,2026,0
58037658054,58037658054,0,1368,1519,0
58038465438,58038465425,-13,1134,1959,0
58042303882,58042303883,1,1368,1910,0
58042980109,58042980110,1,1019,1720,0
58043214381,58043214383,2,1206,1250,0
58048640895,58048640893,-2,865,2137,0
58050406164,58050406157,-7,1380,7361,0
58054390691,58054390691,0,1048,1516,0
58058589378,58058589377,-1,1245,3559,0
58059041517,58059041519,2,1293,1720,0
58060962126,58060962129,3,2063,1510,0
58061680095,58061680094,-1,1183,1419,0
58064048237,58064048238,1,1465,1910,0
58066084694,58066084694,0,1182,985,0
58066352299,58066352299,0,969,1466,0
58066996291,58066996291,0,1143,1561,0
58068823242,58068823242,0,569,1075,0
58069058301,58069058301,0,1366,1874,0
58071813786,58071813790,4,1884,1748,0
58071871004,58071871009,5,2896,1715,0
58072115912,58072115910,-2,1907,2609,0
58073439577,58073439579,2,1280,1433,0
58076585433,58076585433,0,1456,1565,0
58077044213,58077044214,1,1191,1699,0
58077923010,58077923012,2,1042,1791,0
58078260886,58078260893,7,3518,1655,0
58079350707,58079350709,2,1892,1773,0
58080589167,58080589165,-2,4636,6716,0
58081407950,58081407951,1,1818,1279,0
58082080857,58082080858,1,2071,1954,0
58082207580,58082207580,0,1369,1874,0
58082327145,58082327146,1,1651,1898,0
58082566413,58082566413,0,1161,1550,0
58084559578,58084559578,0,1620,1870,0
58085380873,58085380873,0,1390,1596,0
58086111020,58086111022,2,1682,1250,0
58087193472,58087193467,-5,3161,10153,0
58088213251,58088213251,0,1694,2641,0
58089589642,58089589643,1,1515,1282,0
58090189030,58090189033,3,1516,1826,0
58092029870,58092029871,1,1663,2523,0
58093334510,58093334506,-4,950,3209,0
58097008991,58097008992,1,1507,1831,0
58097201243,58097201243,0,1495,1910,0
58097752904,58097752907,3,2197,1808,0
58097869891,58097869885,-6,915,3086,0
58099390581,58099390582,1,917,1290,0
58102476810,58102476810,0,1465,2077,0
58105966117,58105966115,-2,1484,1793,0
58107910989,58107910993,4,1229,1640,0
58109034305,58109034306,1,1144,1321,0
58111306465,58111306465,0,1434,1150,0
58112310420,58112310421,1,1075,1908,0
58112446623,58112446641,18,1625,1699,0
58124747193,58124747194,1,1436,1363,0
58127305913,58127305915,2,1399,1311,0
58127450506,58127450507,1,2036,1330,0
58127540277,58127540287,10,5427,2424,0
58128276462,58128276464,2,1701,1318,0
58130294535,58130294538,3,2621,2006,0
58130565249,58130565250,1,1203,1341,0
58135815343,58135815342,-1,6741,9900,0
58136655365,58136655368,3,1133,1080,0
58139071820,58139071823,3,1622,1411,0
58139403531,58139403533,2,1640,1420,0
58140129966,58140129965,-1,1403,2593,0
58141580618,58141580619,1,1552,2373,0
58144096897,58144096897,0,1476,1824,0
58146160158,58146160158,0,1681,2398,0
58147527170,58147527167,-3,1172,1857,0
58149583037,58149583039,2,1606,2261,0
58154460475,58154460475,0,1202,1384,0
58157682994,58157682997,3,1166,1148,0
58161249414,58161249413,-1,937,1625,0
58162798902,58162798905,3,19559,48749,0
58167110687,58167110687,0,1736,1360,0
58168012382,58168012384,2,1070,713,0
58170573279,58170573281,2,1430,1390,0
58170873119,58170873125,6,1922,1941,0
58171978605,58171978606,1,1217,1991,0
58172402031,58172402030,-1,1242,1602,0
58179633696,58179633716,20,1687,1468,0
58180045874,58180045873,-1,1443,2315,0
58181661705,58181661703,-2,1334,1587,0
58184550378,58184550379,1,1337,1438,0
58186139205,58186139205,0,1018,1495,0
58189427605,58189427607,2,1308,1253,0
58195830478,58195830478,0,1324,1805,0
58198432349,58198432347,-2,1183,1866,0
58199470635,58199470634,-1,1353,1332,0
58199505077,58199505078,1,1647,2024,0
58199786723,58199786724,1,1576,1270,0
58202198035,58202198037,2,1278,1540,0
58202869684,58202869683,-1,1330,1577,0
58205926602,58205926596,-6,1662,5928,0
58209464495,58209464495,0,1683,2234,0
58210031810,58210031810,0,1422,1691,0
58211492900,58211492922,22,1246,1105,0
58212955843,58212955843,0,1041,1904,0
58214467611,58214467610,-1,626,905,0
58218017338,58218017338,0,939,1648,0
58222411658,58222411659,1,1616,1484,0
58223947923,58223947923,0,1145,2428,0
58225609451,58225609455,4,1735,1340,0
58230396778,58230396777,-1,1303,1892,0
58230642701,58230642701,0,1301,2119,0
58232169711,58232169710,-1,475,1207,0
58237967008,58237967008,0,1431,1846,0
58238878854,58238878854,0,1356,2142,0
58239357252,58239357253,1,1305,1823,0
58243024098,58243024090,-8,2001,11167,0
58244330282,58244330285,3,1836,1985,0
58245230860,58245230863,3,2225,1715,0
58245355793,58245355795,2,1182,1204,0
58245490563,58245490565,2,1299,1567,0
58249938301,58249938300,-1,1859,2652,0
58253305538,58253305538,0,1154,1997,0
58257575945,58257575945,0,1138,1516,0
58258246513,58258246515,2,1177,1391,0
58260457973,58260457970,-3,1010,1585,0
58262086090,58262086090,0,868,1464,0
58266360547,58266360548,1,1138,1940,0
58268574442,58268574444,2,1383,2387,0
58269132954,58269132954,0,1687,1393,0
58269589214,58269589214,0,1338,1076,0
58269796927,58269796932,5,683,977,0
58270403076,58270403076,0,1306,2038,0
58276158937,58276158938,1,1378,1992,0
58280801455,58280801448,-7,1905,9005,0
58281454742,58281454742,0,1938,1626,0
58283835033,58283835032,-1,1142,1413,0
58283872446,58283872434,-12,1425,2473,0
58284499763,58284499765,2,1034,1442,0
58286567127,58286567128,1,1971,2560,0
58289670821,58289670823,2,1497,1549,0
58292417127,58292417126,-1,1205,1666,0
58295887378,58295887375,-3,881,1376,0
58296304141,58296304141,0,1682,2677,0
58299542046,58299542045,-1,1182,1984,0
58300444135,58300444135,0,1309,2263,0
58302222059,58302222053,-6,956,3177,0
58306326198,58306326198,0,1355,1569,0
58306728411,58306728409,-2,2145,3289,0
58314069458,58314069458,0,872,1758,0
58314573363,58314573364,1,10307,14936,0
58316181871,58316181872,1,1901,1995,0
58316961329,58316961331,2,1530,1919,0
58318542148,58318542146,-2,1043,2275,0
58319112002,58319112002,0,612,1210,0
58319482698,58319482697,-1,1550,1812,0
58321763043,58321763042,-1,1716,1963,0
58331440649,58331440650,1,1557,2004,0
58331929915,58331929915,0,1300,1405,0
58333189874,58333189876,2,1397,1369,0
58336240206,58336240206,0,1388,1448,0
58346967612,58346967613,1,1775,2156,0
58352537250,58352537251,1,1158,1527,0
58354131544,58354131543,-1,1478,1818,0
58354296282,58354296283,1,973,932,0
58354564094,58354564090,-4,1903,1659,0
58355037679,58355037677,-2,1291,1105,0
58355616529,58355616529,0,1393,1859,0
58361724241,58361724241,0,1282,1431,0
58363002099,58363002101,2,891,1385,0
58364345662,58364345663,1,1304,1548,0
58365670809,58365670811,2,1927,1303,0
58366277019,58366277021,2,1715,1277,0
58369551985,58369551965,-20,4154,2234,0
58370718270,58370718272,2,1578,1984,0
58371928015,58371927994,-21,1252,1522,0
58373720568,58373720566,-2,1295,1822,0
58373764121,58373764121,0,1379,2074,0
58375876653,58375876655,2,1683,1361,0
58380594983,58380594984,1,1430,2092,0
58381174199,58381174198,-1,944,1436,0
58383178270,58383178273,3,1318,1542,0
58386301034,58386301033,-1,1345,2036,0
58387773314,58387773314,0,1601,1071,0
58388505927,58388505929,2,1423,2411,0
58391785701,58391785702,1,1689,1364,0
58393958051,58393958052,1,1615,1981,0
58396517086,58396517085,-1,1286,1929,0
58396657413,58396657435,22,1302,1978,0
58401118556,58401118556,0,1677,2157,0
58403556954,58403556950,-4,1403,2789,0
58407308495,58407308497,2,1420,1867,0
58407437101,58407437102,1,1643,1359,0
58413755294,58413755296,2,1473,1924,0
58414886533,58414886533,0,1428,2167,0
58416256659,58416256658,-1,1752,1570,0
58417160220,58417160214,-6,1269,4441,0
58422923752,58422923751,-1,1364,1267,0
58427346198,58427346199,1,613,974,0
58427919262,58427919262,0,1038,1493,0
58429814445,58429814446,1,1768,2455,0
58430383187,58430383190,3,2126,2278,0
58431767867,58431767866,-1,1580,2131,0
58432889981,58432889961,-20,658,650,0
58433759946,58433759947,1,1422,1638,0
58435929494,58435929494,0,1448,1885,0
58437529991,58437529991,0,1085,1281,0
58439425383,58439425383,0,1495,1860,0
58440288458,58440288459,1,1213,1955,0
58441990399,58441990399,0,906,1678,0
58444342781,58444342782,1,1620,2106,0
58444909114,58444909111,-3,1662,2102,0
58445810445,58445810447,2,1717,1740,0
58445878374,58445878379,5,4861,2743,0
58447317879,58447317881,2,1106,1393,0
58447763286,58447763294,8,785,793,0
58447898930,58447898935,5,1743,1440,0
58448135218,58448135218,0,1492,2292,0
58451390770,58451390769,-1,876,1496,0
58452711493,58452711494,1,1597,1511,0
58454340313,58454340301,-12,50271,13919,0
58457755371,58457755370,-1,1346,1518,0
58458341740,58458341758,18,1545,1462,0
58460007268,58460007266,-2,1223,1863,0
58463558604,58463558605,1,1212,1397,0
58464134890,58464134893,3,1074,1234,0
58467092955,58467092957,2,1276,1530,0
58469011070,58469011070,0,1796,2514,0
58472716275,58472716293,18,1314,1593,0
58473233730,58473233708,-22,2295,2051,0
58474708421,58474708424,3,1360,1874,0
58477627874,58477627875,1,1337,1669,0
58478866069,58478866067,-2,1179,1637,0
58480987894,58480987893,-1,1152,1545,0
58482220594,58482220583,-11,362,1401,0
58484559827,58484559827,0,935,1830,0
58487509844,58487509844,0,1366,1978,0
58487846313,58487846310,-3,1533,1975,0
58488412709,58488412711,2,914,1047,0
58488578958,58488578958,0,1088,1119,0
58496612564,58496612558,-6,1597,5746,0
58506326381,58506326382,1,1636,2087,0
58509943436,58509943438,2,1219,1974,0
58510708762,58510708765,3,1059,1683,0
58511340149,58511340147,-2,1634,1637,0
58514960242,58514960241,-1,1810,1683,0
58518357201,58518357198,-3,1260,2401,0
58519767158,58519767159,1,1388,1390,0
58520452494,58520452487,-7,1102,985,0
58520654851,58520654851,0,1527,1690,0
58522200182,58522200182,0,1513,2187,0
58526839955,58526839955,0,1706,1739,0
58528638270,58528638270,0,1781,1585,0
58529494614,58529494615,1,1197,1389,0
58530303783,58530303782,-1,1295,1222,0
58530409714,58530409714,0,1521,2206,0
58532057051,58532057051,0,1566,1771,0
58536932446,58536932448,2,1379,1946,0
58538171211,58538171213,2,1676,1558,0
58541696250,58541696253,3,3382,2803,0
58541905122,58541905123,1,1936,2468,0
58546561162,58546561162,0,1867,1834,0
58547107632,58547107631,-1,1734,1553,0
58552220483,58552220482,-1,1011,1473,0
58555403217,58555403225,8,1186,1776,0
58559241691,58559241691,0,1123,1672,0
58561448188,58561448170,-18,242,7544,0
58562188838,58562188839,1,1511,1632,0
58562956350,58562956352,2,1299,1477,0
58566554114,58566554115,1,934,1280,0
58567024545,58567024546,1,1136,1298,0
58568278241,58568278241,0,896,1318,0
58568849258,58568849259,1,1555,2477,0
58569095329,58569095329,0,1113,1525,0
58570696398,58570696399,1,1049,1105,0
58572134115,58572134110,-5,1725,4765,0
58580028535,58580028532,-3,1075,3248,0
58582347869,58582347870,1,1021,1142,0
58588972934,58588972936,2,1271,1555,0
58591194516,58591194519,3,1606,1360,0
58593419958,58593419952,-6,840,3382,0
58595133488,58595133487,-1,1103,1308,0
58597688387,58597688386,-1,1822,1948,0
58600509275,58600509276,1,1266,2027,0
58612618405,58612618406,1,1924,2642,0
58613888091,58613888090,-1,1206,1628,0
58615224438,58615224438,0,1246,1664,0
58615342281,58615342281,0,1564,1630,0
58616826978,58616826978,0,1621,2253,0
58617005623,58617005603,-20,1703,1646,0
58623034523,58623034528,5,3127,1211,0
58625990146,58625990146,0,1340,1263,0
58633878214,58633878213,-1,764,1315,0
58636063615,58636063615,0,1756,1936,0
58639552565,58639552566,1,1019,878,0
58641186462,58641186462,0,1876,2388,0
58642449109,58642449110,1,1503,1952,0
58643569434,58643569436,2,853,1503,0
58645924938,58645924938,0,1537,1463,0
58646741749,58646741750,1,1389,2242,0
58647372872,58647372874,2,1717,920,0
58647697622,58647697624,2,1911,2054,0
58648773780,58648773780,0,1149,2267,0
58651186771,58651186773,2,1177,1326,0
58654023934,58654023935,1,1129,1507,0
58655700873,58655700874,1,1237,1971,0
58656094397,58656094395,-2,1172,1376,0
58657956467,58657956471,4,1958,1106,0
58658792214,58658792214,0,11224,15232,0
58660319487,58660319487,0,475,1005,0
58664029019,58664029020,1,1683,1760,0
58664183947,58664183946,-1,1284,2639,0
58671388811,58671388807,-4,1544,2617,0
58673754437,58673754437,0,1345,1929,0
58674767199,58674767200,1,1341,1687,0
58677653434,58677653431,-3,2011,2257,0
58682193618,58682193618,0,1129,1913,0
58685230138,58685230137,-1,1418,1626,0
58686820043,58686820042,-1,1128,1917,0
58689542310,58689542309,-1,1664,2515,0
58689927056,58689927079,23,1119,1030,0
58689995654,58689995654,0,1109,1209,0
58698716081,58698716085,4,5320,25250,0
58699340322,58699340321,-1,1339,2480,0
58700125518,58700125519,1,1514,2054,0
58702532762,58702532763,1,1795,2043,0
58706082809,58706082811,2,1266,1624,0
58707904066,58707904065,-1,1193,1996,0
58708517017,58708517017,0,1252,1428,0
58713678782,58713678782,0,2142,2051,0
58713801611,58713801613,2,1178,1349,0
58715571695,58715571697,2,1540,1214,0
58715884150,58715884149,-1,1815,1535,0
58718959554,58718959555,1,1510,1750,0
58719131029,58719131028,-1,1592,1684,0
58719270870,58719270857,-13,21745,16259,0
58720624749,58720624751,2,1407,1388,0
58721813125,58721813125,0,1327,2219,0
58723502986,58723502986,0,910,1238,0
58725006305,58725006306,1,1405,1607,0
58730477526,58730477524,-2,1089,1524,0
58731321965,58731321965,0,990,1477,0
58733484671,58733484669,-2,812,1086,0
58734494921,58734494922,1,1051,1690,0
58735082798,58735082799,1,2243,1974,0
58735947985,58735947986,1,2013,2330,0
58741550613,58741550612,-1,1959,2152,0
58741716539,58741716537,-2,1327,1381,0
58742467473,58742467470,-3,1545,2353,0
58747156187,58747156188,1,1325,1682,0
58749301985,58749301985,0,1744,2025,0
58749455013,58749455013,0,1355,1691,0
58750809737,58750809735,-2,1138,1230,0
58752019051,58752019054,3,1587,1434,0
58754273653,58754273653,0,2823,3010,0
58755590154,58755590160,6,1708,1722,0
58757014150,58757014150,0,1356,1493,0
58760988802,58760988802,0,1783,1594,0
58762087897,58762087899,2,1234,1657,0
58764334673,58764334673,0,1531,2329,0
58769472827,58769472825,-2,1553,2575,0
58769513193,58769513191,-2,1247,1776,0
58771126331,58771126330,-1,1312,1720,0
58771268250,58771268250,0,1766,2574,0
58778423921,58778423921,0,1669,2167,0
58784176738,58784176743,5,1550,1014,0
58784518207,58784518206,-1,1478,1835,0
58790306363,58790306362,-1,893,1376,0
58793751358,58793751357,-1,1297,1552,0
58795283410,58795283410,0,1411,2412,0
58800119193,58800119194,1,1396,1224,0
58800373274,58800373254,-20,1372,1250,0
58802169443,58802169445,2,1654,2009,0
58802608130,58802608130,0,2253,2568,0
58803385971,58803385970,-1,1468,2090,0
58803469871,58803469872,1,1147,1838,0
58805102524,58805102526,2,1286,1736,0
58809006626,58809006629,3,1401,1517,0
58814488161,58814488160,-1,1614,1671,0
58817419769,58817419771,2,1108,1509,0
58819017615,58819017616,1,2165,2060,0
58821007445,58821007445,0,1197,1509,0
58821946554,58821946554,0,1168,1752,0
58824486955,58824486956,1,1434,1726,0
58824851618,58824851622,4,2290,1457,0
58828179161,58828179163,2,43715,21109,0
58828273159,58828273159,0,1204,1551,0
58828746240,58828746239,-1,1269,1757,0
58830363314,58830363317,3,1464,1678,0
58833017396,58833017397,1,1619,2196,0
58836462146,58836462143,-3,732,3274,0
58837293890,58837293890,0,1045,1493,0
58837941185,58837941185,0,1251,1669,0
58840443318,58840443324,6,1409,812,0
58844065926,58844065929,3,1066,1642,0
58847665310,58847665310,0,1476,2126,0
58852464151,58852464149,-2,1292,1302,0
58857075268,58857075268,0,1234,1884,0
58858611462,58858611462,0,873,1440,0
58859538050,58859538050,0,1108,1533,0
58863945957,58863945956,-1,1204,1613,0
58865070762,58865070762,0,1412,1895,0
58866803875,58866803872,-3,1125,2305,0
58866832402,58866832402,0,702,1602,0
58869042542,58869042542,0,1083,1269,0
58870633958,58870633955,-3,1502,2494,0
58871087781,58871087781,0,1637,1843,0
58872162081,58872162082,1,1299,1965,0
58873792771,58873792771,0,1516,2164,0
58875616909,58875616910,1,1227,1376,0
58878396677,58878396678,1,1363,1429,0
58881680143,58881680142,-1,1251,1787,0
58882335099,58882335098,-1,1307,1516,0
58883973786,58883973786,0,1308,1463,0
58885317225,58885317226,1,1621,1685,0
58886711592,58886711594,2,2140,1742,0
58886877201,58886877202,1,1571,2035,0
58888677308,58888677309,1,952,1542,0
58890113885,58890113886,1,1833,2202,0
58890794725,58890794726,1,1871,1779,0
58891615558,58891615559,1,1632,1380,0
58891761982,58891761979,-3,1210,1012,0
58897418827,58897418827,0,1326,2217,0
58897895677,58897895657,-20,796,1393,0
58899008787,58899008788,1,1388,2393,0
58901174130,58901174130,0,1836,2142,0
58902513769,58902513766,-3,1059,1478,0
58902909254,58902909251,-3,1251,1378,0
58903617037,58903617035,-2,1673,1435,0
58906290832,58906290833,1,1432,1280,0
58908140535,58908140535,0,1239,1832,0
58909577903,58909577887,-16,22999,29133,0
58910431309,58910431311,2,1428,2000,0
58911839415,58911839395,-20,1430,1690,0
58913499735,58913499734,-1,695,1120,0
58914487236,58914487234,-2,1523,1947,0
58917061127,58917061129,2,1431,1715,0
58917328165,58917328175,10,1155,1345,0
58919358151,58919358153,2,1271,1359,0
58919987361,58919987361,0,1141,1402,0
58926577782,58926577785,3,1105,1088,0
58927650518,58927650535,17,1131,1160,0
58931778090,58931778090,0,1935,1519,0
58932312309,58932312309,0,883,1474,0
58933525655,58933525651,-4,1259,1514,0
58935135566,58935135568,2,1691,1867,0
58936027922,58936027910,-12,1317,295,0
58937642274,58937642274,0,1624,1820,0
58941137934,58941137934,0,1264,1556,0
58942118232,58942118237,5,3996,1320,0
58943225871,58943225874,3,1884,1925,0
58945183607,58945183605,-2,929,1856,0
58947589797,58947589798,1,1460,1597,0
58947831612,58947831612,0,1778,1853,0
58948402518,58948402523,5,1786,904,0
58949639302,58949639302,0,1682,2116,0
58952017328,58952017350,22,911,1304,0
58958897486,58958897487,1,1106,1362,0
58960833341,58960833342,1,2223,2085,0
58962855311,58962855310,-1,1644,1935,0
58964187127,58964187126,-1,1467,1201,0
58964484462,58964484463,1,1148,1048,0
58965589890,58965589892,2,1650,2041,0
58966966990,58966966990,0,1192,1646,0
58967170464,58967170463,-1,1253,1284,0
58967835963,58967835963,0,1037,1108,0
58969866210,58969866211,1,1151,1306,0
58970728954,58970728955,1,1569,1155,0
58976048502,58976048502,0,1031,1742,0
58977087807,58977087807,0,1282,1382,0
58977892851,58977892854,3,14215,13820,0
58979676297,58979676298,1,1264,1531,0
58980639270,58980639272,2,1052,1171,0
58982463929,58982463930,1,2470,2522,0
58985116678,58985116678,0,1359,2183,0
58987748038,58987748039,1,1745,1790,0
58991008665,58991008666,1,1200,1750,0
58991713027,58991713025,-2,923,1342,0
58992622973,58992622975,2,1087,1518,0
58993357461,58993357460,-1,1204,2414,0
58993554170,58993554171,1,1599,1792,0
58994062599,58994062602,3,740,1834,0
58994347500,58994347489,-11,995,1299,0
58995930930,58995930930,0,1468,2311,0
59000609570,59000609569,-1,1162,2744,0
59006213854,59006213856,2,1537,1604,0
59009231547,59009231546,-1,1387,1732,0
59010571269,59010571270,1,1079,1236,0
59011796185,59011796186,1,1501,817,0
59016162339,59016162341,2,1349,1737,0
59016501292,59016501293,1,1718,1700,0
59017624751,59017624751,0,1554,1276,0
59019760157,59019760159,2,1688,1865,0
59020524202,59020524201,-1,1040,1824,0
59020709077,59020709080,3,1585,2334,0
59022620983,59022620984,1,1141,1863,0
59023621013,59023621014,1,778,1323,0
59025028451,59025028449,-2,966,1357,0
59025799666,59025799666,0,1913,2030,0
59027106337,59027106342,5,2463,1028,0
59027527503,59027527503,0,2029,1895,0
59030141724,59030141742,18,859,1550,0
59030558358,59030558377,19,1416,1189,0
59031008122,59031008126,4,1327,850,0
59031553714,59031553716,2,1612,1806,0
59032935201,59032935203,2,713,922,0
59037506213,59037506214,1,2051,2029,0
59041818666,59041818667,1,1562,1605,0
59043455975,59043455978,3,1609,1815,0
59043912453,59043912451,-2,1140,2071,0
59044526498,59044526499,1,903,1528,0
59046762691,59046762690,-1,956,1345,0
59046883402,59046883401,-1,1693,1844,0
59047328394,59047328393,-1,1223,1831,0
59047687925,59047687926,1,1563,1736,0
59048360535,59048360534,-1,1557,1851,0
59052478565,59052478565,0,1163,1556,0
59053068153,59053068154,1,1857,1839,0
59059362726,59059362727,1,1860,2590,0
59061786942,59061786942,0,1254,1410,0
59062138863,59062138862,-1,1465,1282,0
59062367922,59062367943,21,1436,1825,0
59064096625,59064096626,1,1520,1818,0
59069716137,59069716137,0,1223,1503,0
59070096668,59070096668,0,1217,1724,0
59073378833,59073378834,1,1362,2030,0
59075675210,59075675210,0,1496,1474,0
59079736185,59079736187,2,1354,1762,0
59080228003,59080228002,-1,1166,1320,0
59085955119,59085955117,-2,1048,2241,0
59088212430,59088212426,-4,889,2702,0
59088381622,59088381625,3,1174,1952,0
59092384638,59092384638,0,1552,2338,0
59093729281,59093729281,0,1164,1988,0
59097669376,59097669380,4,2342,1745,0
59099601207,59099601208,1,1419,2142,0
59101083533,59101083532,-1,1782,2038,0
59101137093,59101137094,1,1634,1527,0
59102849255,59102849254,-1,1644,1622,0
59103082176,59103082180,4,2562,1358,0
59103146780,59103146779,-1,1328,1747,0
59103971002,59103971003,1,1720,1980,0
59106065030,59106065030,0,1591,2608,0
59107704170,59107704169,-1,1377,1556,0
59109177987,59109177989,2,1020,1193,0
59111018957,59111018957,0,1493,2375,0
59111970231,59111970230,-1,827,1122,0
59112087518,59112087539,21,1303,1877,0
59112706081,59112706081,0,2075,2321,0
59113228810,59113228810,0,1390,1003,0
59116691338,59116691338,0,1051,1740,0
59118225274,59118225274,0,1637,1820,0
59118726943,59118726945,2,1122,1510,0
59119987041,59119987042,1,1136,1866,0
59123049970,59123049969,-1,1534,1892,0
59127169757,59127169757,0,1266,1693,0
59128120424,59128120426,2,1649,1561,0
59130121102,59130121103,1,1228,1078,0
59130965886,59130965886,0,1457,1368,0
59133853003,59133853005,2,820,1954,0
59134441489,59134441492,3,1701,1891,0
59134885395,59134885395,0,792,1336,0
59136262386,59136262386,0,1444,1912,0
59137959819,59137959820,1,784,1643,0
59139100900,59139100903,3,1772,1590,0
59142690146,59142690147,1,1774,1632,0
59142933646,59142933646,0,1185,1506,0
59143379830,59143379830,0,1356,1566,0
59146162110,59146162110,0,1890,2088,0
59153412845,59153412845,0,1621,1517,0
59153514821,59153514821,0,1392,1344,0
59155308339,59155308339,0,1078,1519,0
59155705719,59155705721,2,1231,1365,0
59160044824,59160044825,1,1212,1154,0
59166911398,59166911397,-1,2302,4002,0
59167505103,59167505102,-1,1615,2055,0
59168498704,59168498706,2,1326,1891,0
59168799078,59168799076,-2,1375,1401,0
59169656231,59169656231,0,1351,1887,0
59169748209,59169748208,-1,1460,2078,0
59171134034,59171134035,1,1731,2267,0
59171587675,59171587674,-1,1875,2606,0
59171764178,59171764175,-3,836,2138,0
59172980094,59172980094,0,1174,1227,0
59179883422,59179883417,-5,1209,3668,0
59181192018,59181192018,0,1358,1689,0
59181717941,59181717942,1,1628,1841,0
59181971846,59181971847,1,1793,1885,0
59182145338,59182145334,-4,1167,2126,0
59186537318,59186537317,-1,1539,1807,0
59187810855,59187810855,0,1418,1620,0
59188599195,59188599196,1,1538,1987,0
59189324662,59189324653,-9,613,2685,0
59198924570,59198924569,-1,1081,1886,0
59200646401,59200646402,1,1700,1316,0
59201966609,59201966609,0,1151,1341,0
59202199908,59202199909,1,1552,1884,0
59203731747,59203731749,2,1110,1299,0
59206122011,59206122013,2,2678,2251,0
59206229612,59206229611,-1,1340,2686,0
59206390966,59206390969,3,1914,1968,0
59209191164,59209191165,1,1016,1665,0
59212560552,59212560555,3,1479,1249,0
59216016528,59216016527,-1,1209,1349,0
59217384667,59217384666,-1,814,1374,0
59217951763,59217951766,3,745,1749,0
59220315821,59220315819,-2,1890,2171,0
59221365037,59221365035,-2,1297,990,0
59221745841,59221745842,1,1273,1247,0
59222423813,59222423817,4,7936,4226,0
59222782131,59222782131,0,1436,1793,0
59225563693,59225563693,0,1491,1841,0
59227353745,59227353749,4,1864,1943,0
59227917862,59227917863,1,1267,2178,0
59227993781,59227993779,-2,1419,1547,0
59232809307,59232809306,-1,821,1546,0
59233773011,59233773013,2,2017,3033,0
59234341630,59234341633,3,1580,1418,0
59234874962,59234874965,3,1162,1277,0
59241853560,59241853560,0,1272,1462,0
59242769326,59242769325,-1,1298,1667,0
59248476629,59248476628,-1,2228,2757,0
59250434314,59250434316,2,1669,1140,0
59252277127,59252277126,-1,1343,1815,0
59255043429,59255043431,2,1649,1631,0
59258669763,59258669762,-1,1593,2002,0
59259559368,59259559348,-20,1623,1877,0
59264624469,59264624470,1,1899,2216,0
59264754237,59264754236,-1,1387,2380,0
59266383325,59266383326,1,1395,1738,0
59267429191,59267429190,-1,2003,1452,0
59269057266,59269057263,-3,827,1102,0
59270075082,59270075082,0,1624,1846,0
59270812258,59270812258,0,1791,1709,0
59270865018,59270865022,4,1672,1782,0
59273202769,59273202770,1,1388,1236,0
59274176993,59274176993,0,1515,1425,0
59274637078,59274637077,-1,1264,1300,0
59279526702,59279526702,0,1275,1543,0
59280428393,59280428394,1,925,1454,0
59280571271,59280571271,0,1290,1078,0
59281449346,59281449347,1,1235,1901,0
59285237957,59285237956,-1,1134,1602,0
59286311122,59286311122,0,1325,1744,0
59286651966,59286651965,-1,1743,2123,0
59288168763,59288168761,-2,1271,2184,0
59290249071,59290249073,2,1323,1584,0
59291923567,59291923565,-2,967,1483,0
59297005599,59297005598,-1,1713,1941,0
59299492354,59299492355,1,1889,1659,0
59303026270,59303026272,2,1187,1765,0
59308612707,59308612708,1,1202,1847,0
59309294118,59309294118,0,1248,1611,0
59310722637,59310722638,1,1287,1280,0
59310794682,59310794682,0,1068,1792,0
59317713121,59317713122,1,1371,1393,0
59318699933,59318699926,-7,1191,5725,0
59319034230,59319034231,1,1561,1736,0
59319505841,59319505841,0,1615,2212,0
59323359551,59323359551,0,1610,1709,0
59324149558,59324149558,0,1160,2011,0
59325542110,59325542109,-1,784,1855,0
59326062718,59326062720,2,1938,2024,0
59328570825,59328570825,0,1332,1034,0
59330371306,59330371307,1,1104,1133,0
59334060425,59334060406,-19,1732,1734,0
59334430263,59334430263,0,972,1489,0
59337613610,59337613610,0,775,1582,0
59338943178,59338943180,2,1467,1854,0
59341413641,59341413641,0,1506,2216,0
59341520038,59341520038,0,1426,1451,0
59342838848,59342838848,0,996,2207,0
59346055276,59346055278,2,1719,2173,0
59353982449,59353982450,1,1129,1713,0
59359184181,59359184180,-1,837,871,0
59361413660,59361413662,2,1105,1542,0
59362259918,59362259919,1,1742,1441,0
59362419680,59362419677,-3,1439,2585,0
59363122806,59363122822,16,225,987,0
59363345559,59363345558,-1,1175,1523,0
59363522907,59363522904,-3,1737,3185,0
59364776358,59364776357,-1,1327,1415,0
59365021558,59365021561,3,1962,1982,0
59369314581,59369314582,1,1196,1111,0
59373505005,59373505006,1,1383,1392,0
59376370686,59376370686,0,1695,1475,0
59377000310,59377000311,1,1571,1672,0
59380800964,59380800965,1,1339,1861,0
59385077570,59385077574,4,1611,1969,0
59392884800,59392884793,-7,25375,18370,0
59393675810,59393675812,2,1228,1773,0
59394641850,59394641857,7,3605,1429,0
59398159467,59398159468,1,1154,1826,0
59402962942,59402962942,0,1102,1053,0
59404488730,59404488743,13,1449,1504,0
59406694586,59406694586,0,1264,1730,0
59411981646,59411981646,0,1510,1512,0
59414025598,59414025601,3,1948,1214,0
59416656280,59416656278,-2,1157,1740,0
59416725660,59416725645,-15,1252,1620,0
59418709137,59418709139,2,938,1730,0
59419043161,59419043163,2,1611,1913,0
59421193991,59421193990,-1,1299,1492,0
59424413966,59424413964,-2,994,1860,0
59424737896,59424737894,-2,1376,2062,0
59426408700,59426408699,-1,1558,1522,0
59428832001,59428831998,-3,989,1103,0
59428937861,59428937852,-9,994,1354,0
59429758114,59429758115,1,1558,2336,0
59434330253,59434330254,1,1257,2178,0
59442714097,59442714098,1,764,1119,0
59447266730,59447266730,0,772,1834,0
59447561673,59447561674,1,1571,2408,0
59448296322,59448296304,-18,2125,1805,0
59452411699,59452411702,3,1307,1506,0
59452554897,59452554897,0,1304,2172,0
59453990238,59453990238,0,1236,1857,0
59459400990,59459400990,0,1510,1953,0
59462688966,59462688966,0,1177,1469,0
59469282407,59469282405,-2,266,1868,0
59469425516,59469425499,-17,727,1099,0
59478090328,59478090330,2,1380,1039,0
59480168037,59480168037,0,1280,1800,0
59482351011,59482351010,-1,1568,1910,0
59487423779,59487423782,3,1502,1751,0
59487764623,59487764625,2,1355,1513,0
59488691879,59488691880,1,881,1265,0
59490405943,59490405938,-5,863,2957,0
59490693085,59490693083,-2,1976,2548,0
59492189400,59492189419,19,17595,21300,0
59492506629,59492506630,1,839,1143,0
59493552243,59493552221,-22,1238,1108,0
59500027479,59500027478,-1,1365,1787,0
59501771723,59501771704,-19,1579,2002,0
59504447445,59504447449,4,2119,1309,0
59506450374,59506450375,1,2174,2013,0
59507711190,59507711190,0,1626,2525,0
59508987578,59508987579,1,1197,1566,0
59509393940,59509393942,2,876,1095,0
59511343426,59511343426,0,713,1686,0
59512952311,59512952311,0,1175,1498,0
59514492882,59514492883,1,1785,1673,0
59514869337,59514869338,1,1371,1436,0
59519668262,59519668261,-1,1136,1659,0
59522499946,59522499946,0,1906,2408,0
59525762651,59525762652,1,898,1366,0
59526764948,59526764969,21,15362,47341,0
59528044410,59528044411,1,1691,1447,0
59531587401,59531587401,0,1240,1304,0
59532669123,59532669124,1,1712,2038,0
59534945802,59534945803,1,1561,1699,0
59535376642,59535376644,2,1636,2002,0
59535640035,59535640036,1,2187,1871,0
59536800611,59536800610,-1,1363,1734,0
59538967414,59538967414,0,1054,1504,0
59542337285,59542337289,4,1680,994,0
59542711929,59542711930,1,1185,1541,0
59545363501,59545363502,1,2058,2050,0
59545902581,59545902583,2,1850,1620,0
59547783203,59547783202,-1,1023,960,0
59550790475,59550790475,0,1251,1672,0
59550875564,59550875565,1,1996,2104,0
59551472692,59551472689,-3,1124,1716,0
59557641426,59557641426,0,1250,1590,0
59558934332,59558934330,-2,1324,1618,0
59559774647,59559774647,0,1409,1671,0
59562431198,59562431199,1,1218,1324,0
59563877847,59563877849,2,1697,1423,0
59565473611,59565473611,0,1545,1807,0
59569525990,59569525991,1,1228,1016,0
59570089910,59570089919,9,1967,1599,0
59574487070,59574487070,0,1498,2044,0
59576379487,59576379489,2,1338,1541,0
59580801765,59580801766,1,1275,1114,0
59581451222,59581451223,1,932,1098,0
59584468437,59584468437,0,1188,1781,0
59587742675,59587742675,0,1254,1066,0
59590798172,59590798172,0,51337,47266,0
59591223749,59591223750,1,1640,2183,0
59592233117,59592233115,-2,1331,1889,0
59592892371,59592892362,-9,993,10155,0
59592927446,59592927445,-1,1471,2041,0
59593616054,59593616060,6,2024,1466,0
59594350499,59594350499,0,833,1685,0
59595048372,59595048373,1,2091,2287,0
59599622398,59599622399,1,840,1302,0
59604227058,59604227058,0,1795,2807,0
59606685402,59606685400,-2,1631,1508,0
59608642191,59608642192,1,1251,1287,0
59612488482,59612488483,1,819,951,0
59612826974,59612826973,-1,956,1559,0
59615198406,59615198406,0,1265,2102,0
59616496214,59616496214,0,1171,1222,0
59616942331,59616942332,1,1763,2296,0
59618993806,59618993810,4,2190,2127,0
59622578203,59622578202,-1,920,944,0
59624254402,59624254402,0,1256,2172,0
59624941797,59624941796,-1,1532,1503,0
59625759176,59625759177,1,1556,1573,0
59626855331,59626855332,1,1039,1246,0
59633530075,59633530081,6,2690,1863,0
59633876590,59633876591,1,1537,1353,0
59634110702,59634110699,-3,1768,2502,0
59634370541,59634370543,2,1611,1068,0
59636086014,59636086013,-1,1851,2382,0
59638665415,59638665408,-7,1715,9418,0
59639577695,59639577694,-1,1208,1926,0
59643074934,59643074929,-5,1228,3441,0
59646934994,59646934996,2,1584,1716,0
59648924626,59648924625,-1,1188,2002,0
59649670101,59649670098,-3,2698,5656,0
59649757905,59649757907,2,1115,1472,0
59651307099,59651307100,1,1442,1705,0
59651964834,59651964835,1,1420,2255,0
59652852015,59652852016,1,1533,2098,0
59654694192,59654694190,-2,2028,2274,0
59656876862,59656876866,4,2429,1587,0
59658130297,59658130298,1,1646,1779,0
59658713246,59658713248,2,1446,2628,0
59659581512,59659581514,2,1431,1540,0
59663239071,59663239074,3,2112,1701,0
59664454469,59664454466,-3,887,1801,0
59666117565,59666117566,1,1683,2705,0
59667544379,59667544378,-1,1908,2165,0
59667570122,59667570122,0,1121,1658,0
59667913168,59667913171,3,1770,1553,0
59668273795,59668273796,1,1629,1673,0
59672071010,59672071014,4,2055,1597,0
59672246501,59672246501,0,1834,1739,0
59673358041,59673358041,0,1626,2033,0
59678774834,59678774833,-1,33397,47112,0
59679144706,59679144707,1,1365,1256,0
59680754038,59680754041,3,1463,1650,0
59684473207,59684473208,1,1478,1413,0
59684850834,59684850835,1,1490,2065,0
59690760086,59690760085,-1,1404,2200,0
59693789217,59693789211,-6,2149,9194,0
59696534021,59696534021,0,1165,1678,0
59699967510,59699967510,0,1857,2399,0
59702873530,59702873531,1,1362,1586,0
59703370612,59703370610,-2,1496,1300,0
59704059339,59704059342,3,1350,1147,0
59706248934,59706248933,-1,899,1180,0
59707532442,59707532442,0,1470,1646,0
59710430066,59710430067,1,1682,1836,0
59710864827,59710864826,-1,1588,1347,0
59711198627,59711198629,2,914,1291,0
59715059102,59715059102,0,1267,1400,0
59715498062,59715498063,1,836,1806,0
59719248187,59719248187,0,1408,1975,0
59723321330,59723321333,3,1232,1831,0
59723788830,59723788831,1,1430,1961,0
59723851119,59723851118,-1,1519,2163,0
59725730695,59725730698,3,1403,1814,0
59726290927,59726290914,-13,120,2896,0
59727049464,59727049465,1,1792,1857,0
59727580591,59727580589,-2,1246,1489,0
59729103980,59729103981,1,1052,1218,0
59729896433,59729896431,-2,1569,2153,0
59731287230,59731287230,0,1284,1590,0
59732523843,59732523844,1,1140,1504,0
59734206240,59734206241,1,1320,1625,0
59736026766,59736026768,2,2710,2252,0
59736434562,59736434563,1,1161,1950,0
59738468351,59738468350,-1,2146,2051,0
59742987408,59742987408,0,1657,2368,0
59743683445,59743683448,3,1180,1474,0
59744578509,59744578525,16,1513,1590,0
59747700049,59747700049,0,1293,1548,0
59752023186,59752023193,7,4057,1344,0
59752679786,59752679786,0,1484,1499,0
59754246220,59754246215,-5,1361,1651,0
59756128494,59756128490,-4,1264,1840,0
59760846777,59760846776,-1,1567,1572,0
59761690649,59761690646,-3,1077,4327,0
59768564007,59768564007,0,1974,2458,0
59769288243,59769288242,-1,1283,1196,0
59770468940,59770468942,2,1679,1971,0
59772153591,59772153592,1,1760,2098,0
59775464857,59775464855,-2,1352,2002,0
59777301158,59777301159,1,1075,1384,0
59779366906,59779366905,-1,1520,1513,0
59779645520,59779645518,-2,1813,1696,0
59780112435,59780112434,-1,1125,1587,0
59783997342,59783997343,1,1536,1240,0
59784634011,59784633988,-23,3055,4096,0
59784820131,59784820131,0,1342,1276,0
59786357498,59786357501,3,1735,1918,0
59790028365,59790028366,1,1132,1142,0
59792848004,59792848005,1,1129,911,0
59793843262,59793843262,0,1019,1584,0
59796914470,59796914467,-3,1017,2175,0
59799001978,59799001981,3,2152,2041,0
59800582950,59800582950,0,1234,1362,0
59809073853,59809073852,-1,1515,1486,0
59810481883,59810481885,2,1368,1925,0
59818620089,59818620090,1,1537,1652,0
59822914068,59822914069,1,1985,2313,0
59825648395,59825648394,-1,3123,4192,0
59836111600,59836111600,0,1369,2267,0
59837119427,59837119425,-2,787,1260,0
59839388563,59839388564,1,1984,2560,0
59839872415,59839872415,0,944,1290,0
59840167148,59840167148,0,1031,1413,0
59841804966,59841804969,3,1101,1089,0
59842645922,59842645922,0,912,1618,0
59842797434,59842797433,-1,1123,2026,0
59843341582,59843341582,0,1079,1175,0
59844731226,59844731226,0,1369,1473,0
59848072571,59848072570,-1,1238,1085,0
59851970244,59851970245,1,849,1404,0
59854251723,59854251723,0,1286,1346,0
59855266451,59855266454,3,694,1088,0
59861693151,59861693151,0,1118,1798,0
59864233859,59864233858,-1,1196,2275,0
59866041457,59866041458,1,1102,1281,0
59866980370,59866980369,-1,1121,1829,0
59867660018,59867660018,0,935,1831,0
59875735411,59875735402,-9,938,1578,0
59878149909,59878149911,2,1274,1157,0
59880021141,59880021142,1,1368,1486,0
59881935909,59881935910,1,1994,2241,0
59882365140,59882365138,-2,1322,1371,0
59887319645,59887319645,0,1887,1734,0
59888152263,59888152265,2,1228,1533,0
59890106112,59890106114,2,1404,1308,0
59890670798,59890670799,1,1454,2001,0
59893444715,59893444715,0,1344,2362,0
59894925419,59894925418,-1,1161,1103,0
59896268517,59896268514,-3,1344,1221,0
59899319928,59899319929,1,1658,1728,0
59900355519,59900355520,1,1173,1333,0
59901582454,59901582455,1,1707,1813,0
59902196086,59902196087,1,1596,1314,0
59902236628,59902236628,0,932,1330,0
59902594030,59902594031,1,815,1169,0
59902928422,59902928426,4,808,1244,0
59904339815,59904339814,-1,1216,2173,0
59908954401,59908954398,-3,1574,1989,0
59909741957,59909741941,-16,1251,1573,0
59912562772,59912562771,-1,993,988,0
59918900422,59918900415,-7,2695,6864,0
59923809223,59923809240,17,1808,1830,0
59924756207,59924756207,0,1265,2224,0
59927650511,59927650510,-1,1304,1559,0
59927750331,59927750331,0,1414,2313,0
59928093421,59928093421,0,1364,2160,0
59934164313,59934164314,1,1394,1744,0
59934376921,59934376922,1,1732,1433,0
59938289122,59938289122,0,1158,1513,0
59943450961,59943450961,0,1541,1238,0
59947069462,59947069462,0,929,1321,0
59948704993,59948704993,0,1468,2074,0
59951385151,59951385151,0,1192,1957,0
59952438981,59952438978,-3,1405,2100,0
59952824184,59952824193,9,14381,30880,0
59954071345,59954071351,6,13083,6504,0
59960066446,59960066447,1,1694,2279,0
59962449075,59962449075,0,1455,2210,0
59963102825,59963102826,1,959,1454,0
59963917283,59963917282,-1,1228,1672,0
59965598947,59965598948,1,1266,1514,0
59967604489,59967604490,1,1794,2313,0
59967710390,59967710390,0,2033,1782,0
59971711806,59971711809,3,1899,1085,0
59972300610,59972300611,1,1201,1403,0
59973786359,59973786360,1,1163,1534,0
59975158710,59975158710,0,1111,1404,0
59976606005,59976605994,-11,1201,1301,0
59976776206,59976776204,-2,1070,1435,0
59978848087,59978848087,0,1262,1380,0
59979204359,59979204362,3,1914,1630,0
59979847893,59979847895,2,1473,2347,0
59981603374,59981603374,0,1196,2341,0
59983975471,59983975471,0,1190,2043,0
59985640157,59985640158,1,1070,1489,0
59993792534,59993792537,3,1268,1357,0
59995631359,59995631356,-3,1321,2828,0
59998692035,59998692037,2,1391,1486,0
59999749553,59999749552,-1,1119,1694,0
60000097149,60000097145,-4,984,1697,0
60001104674,60001104678,4,2283,1349,0
60001168266,60001168266,0,1150,1749,0
60001246422,60001246424,2,1791,1918,0
60002426102,60002426103,1,1636,1829,0
60003959274,60003959275,1,2209,2275,0
60007176906,60007176905,-1,1038,1356,0
60008186427,60008186427,0,1184,1161,0
60008631174,60008631172,-2,1239,1987,0
60009765422,60009765422,0,1575,2246,0
60010467845,60010467844,-1,1214,1510,0
60012707542,60012707542,0,1501,1066,0
60013546578,60013546577,-1,1455,1977,0
60016945932,60016945933,1,914,1388,0
60017227442,60017227442,0,1149,1654,0
60018371749,60018371750,1,1391,1445,0
60019576181,60019576180,-1,1484,2019,0
60019911741,60019911741,0,1801,1733,0
60020276478,60020276478,0,1013,1526,0
60022846369,60022846370,1,956,1358,0
60023605029,60023605008,-21,1349,1349,0
60025557607,60025557606,-1,1687,1727,0
60031689238,60031689239,1,1503,2130,0
60032467874,60032467877,3,2083,1287,0
60035771576,60035771574,-2,1238,1904,0
60039589074,60039589078,4,20039,26152,0
60043987702,60043987705,3,948,1150,0
60048869947,60048869947,0,1447,1660,0
60050811440,60050811443,3,1563,1552,0
60053360406,60053360403,-3,934,2096,0
60053480813,60053480811,-2,75,1227,0
60053948934,60053948934,0,1559,2295,0
60056099269,60056099269,0,1159,1564,0
60060112999,60060112998,-1,1124,1761,0
60064211750,60064211750,0,1457,1504,0
60066268146,60066268145,-1,748,1378,0
60066459863,60066459866,3,2508,1295,0
60069850833,60069850835,2,1856,1650,0
60070286130,60070286130,0,1544,1849,0
60075687730,60075687731,1,1124,1507,0
60075943859,60075943854,-5,1346,4440,0
60077480137,60077480146,9,1209,1699,0
60077795001,60077795003,2,1312,1491,0
60084459797,60084459796,-1,1642,1651,0
60084697756,60084697754,-2,1147,1651,0
60085693746,60085693751,5,2191,1143,0
60087925711,60087925710,-1,951,1476,0
60089831294,60089831294,0,1549,1899,0
60090645465,60090645486,21,1594,1602,0
60092456963,60092456962,-1,1771,1970,0
60094497838,60094497838,0,1390,1753,0
60099642205,60099642207,2,1702,2085,0
60101568563,60101568562,-1,1709,2019,0
60106029306,60106029305,-1,1707,3206,0
60109786458,60109786458,0,1005,1800,0
60113892298,60113892298,0,1009,1098,0
60115837368,60115837371,3,1609,925,0
60117689914,60117689892,-22,1102,1162,0
60120781264,60120781266,2,1594,1431,0
60123574977,60123574979,2,1471,1286,0
60123669186,60123669187,1,1544,1689,0
60127328282,60127328282,0,1337,1971,0
60127450227,60127450227,0,1233,1470,0
60127854261,60127854262,1,1567,1687,0
60134502248,60134502248,0,1963,2296,0
60135695938,60135695938,0,964,1381,0
60138883927,60138883927,0,928,659,0
60141837423,60141837424,1,1914,2806,0
60141956053,60141956054,1,1484,2379,0
60142845448,60142845454,6,1608,1288,0
60142906278,60142906295,17,1597,1927,0
60143442804,60143442813,9,1572,1800,0
60144004325,60144004325,0,1223,2065,0
60145384464,60145384466,2,1170,1188,0
60148936918,60148936919,1,843,974,0
60150529713,60150529713,0,1530,2551,0
60150912563,60150912562,-1,1834,2165,0
60151493002,60151493003,1,1149,1453,0
60151680255,60151680261,6,2530,1612,0
60157298844,60157298844,0,1443,1237,0
60160464480,60160464486,6,4930,2158,0
60163794901,60163794901,0,1919,1578,0
60167238586,60167238587,1,1570,1696,0
60167351551,60167351551,0,1565,1654,0
60178145101,60178145099,-2,1365,2243,0
60179210066,60179210071,5,1127,1555,0
60179693771,60179693772,1,1854,2168,0
60180872215,60180872217,2,1295,1419,0
60182567101,60182567102,1,1289,2251,0
60185930134,60185930135,1,1617,2301,0
60189055551,60189055533,-18,1776,1621,0
60190546104,60190546106,2,1777,1737,0
60191267347,60191267349,2,995,1605,0
60191648397,60191648397,0,1650,1871,0
60192601066,60192601065,-1,1158,1277,0
60193045279,60193045281,2,1229,1814,0
60193365443,60193365442,-1,1058,1496,0
60196426246,60196426253,7,2446,1262,0
60196556638,60196556638,0,1059,2066,0
60197545864,60197545866,2,1734,1272,0
60197890770,60197890770,0,1549,1964,0
60198776453,60198776454,1,1874,1854,0
60202920814,60202920815,1,1370,1505,0
60203405718,60203405718,0,1491,1727,0
60204879400,60204879399,-1,1373,1995,0
60205876473,60205876473,0,1157,1575,0
60207861849,60207861850,1,974,1282,0
60208822373,60208822375,2,1832,1879,0
60209031813,60209031814,1,988,1591,0
60209919826,60209919825,-1,1717,2069,0
60211532562,60211532562,0,1054,1746,0
60214555890,60214555907,17,1195,1064,0
60215972181,60215972186,5,1874,1612,0
60217551427,60217551427,0,1746,1892,0
60219135446,60219135445,-1,1518,1661,0
60222395960,60222395964,4,2672,2565,0
60222561461,60222561461,0,1205,1279,0
60224768827,60224768826,-1,1505,2175,0
60225613627,60225613629,2,1767,1267,0
60227036667,60227036665,-2,1463,2415,0
60228842170,60228842172,2,1320,1725,0
60229856489,60229856489,0,1374,1556,0
60232456384,60232456385,1,1807,2120,0
60235225889,60235225891,2,1006,1333,0
60237664441,60237664442,1,1549,1856,0
60241105770,60241105770,0,1305,1626,0
60243449092,60243449094,2,1774,1610,0
60243578030,60243578031,1,1207,2046,0
60248334635,60248334634,-1,1900,2178,0
60254943162,60254943161,-1,1404,2112,0
60260136587,60260136589,2,1127,1007,0
60263195402,60263195402,0,1458,2246,0
60263574161,60263574162,1,2276,1800,0
60266535909,60266535916,7,2533,1702,0
60266675338,60266675338,0,1103,1714,0
60267192473,60267192474,1,1077,1204,0
60269343335,60269343328,-7,1193,4753,0
60271818106,60271818084,-22,1332,1578,0
60274214863,60274214862,-1,1714,1997,0
60276969621,60276969622,1,1950,1711,0
60286740344,60286740343,-1,2325,1884,0
60287187578,60287187586,8,6920,1943,0
60287582902,60287582902,0,1520,1513,0
60290888218,60290888220,2,1631,2041,0
60292851514,60292851515,1,1399,2477,0
60300347350,60300347350,0,1251,1288,0
60300847822,60300847825,3,1630,1734,0
60302184837,60302184837,0,1545,1262,0
60304288106,60304288105,-1,1871,1929,0
60305492065,60305492066,1,866,18,0
60306085614,60306085614,0,1533,1954,0
60307794624,60307794621,-3,1129,1567,0
60308447350,60308447351,1,1885,1759,0
60312984119,60312984115,-4,731,1066,0
60318789222,60318789223,1,1550,1949,0
60320254306,60320254306,0,799,1805,0
60321375789,60321375785,-4,1529,3864,0
60321761580,60321761579,-1,1173,1814,0
60322271460,60322271442,-18,371,1453,0
60323024202,60323024195,-7,977,4433,0
60323510797,60323510798,1,1434,1194,0
60324132046,60324132045,-1,1241,2107,0
60329279062,60329279063,1,1435,1039,0
60335849221,60335849221,0,1128,1291,0
60336727836,60336727839,3,1469,1489,0
60338797257,60338797259,2,988,1420,0
60340848251,60340848250,-1,643,1515,0
60342948314,60342948313,-1,1666,1605,0
60342978094,60342978097,3,1082,857,0
60344502045,60344502046,1,1055,1602,0
60346200175,60346200175,0,1369,1543,0
60346663627,60346663627,0,1767,2583,0
60347963657,60347963657,0,1055,1187,0
60350337144,60350337145,1,1150,1989,0
60351976577,60351976577,0,1025,1707,0
60354291987,60354291989,2,1067,1651,0
60355071970,60355071970,0,997,1624,0
60357063001,60357063005,4,1991,1098,0
60357307666,60357307684,18,1941,1340,0
60358917943,60358917943,0,1822,2546,0
60359003302,60359003298,-4,1740,4829,0
60364716902,60364716901,-1,1493,1896,0
60365661806,60365661808,2,1670,2090,0
60368816186,60368816188,2,1322,1662,0
60375778807,60375778807,0,1392,1820,0
60377935287,60377935289,2,1172,1895,0
60378929273,60378929277,4,1932,1561,0
60379425984,60379425998,14,12259,44611,0
60379474765,60379474765,0,2551,3886,0
60381277653,60381277659,6,4605,2526,0
60382281434,60382281434,0,1278,1564,0
60386525978,60386525982,4,2720,2398,0
60387547270,60387547270,0,1407,1846,0
60389082454,60389082453,-1,1070,946,0
60392647129,60392647129,0,1392,1502,0
60394464924,60394464927,3,1388,542,0
60394835302,60394835300,-2,1637,2320,0
60394904322,60394904321,-1,1187,1426,0
60396273872,60396273871,-1,1354,1279,0
60399224640,60399224642,2,1712,2215,0
60401040499,60401040506,7,3323,1689,0
60401402723,60401402725,2,2082,2212,0
60403690170,60403690170,0,1333,1787,0
60407035543,60407035543,0,1604,1510,0
60410216429,60410216429,0,2023,1961,0
60410632863,60410632863,0,1304,1758,0
60411273562,60411273561,-1,1435,1352,0
60416830453,60416830453,0,845,1224,0
60417936415,60417936414,-1,1255,1555,0
60418563249,60418563249,0,1803,1777,0
60419504668,60419504671,3,1488,1413,0
60421416777,60421416772,-5,1089,3194,0
60422458958,60422458954,-4,822,2098,0
60423197557,60423197571,14,157,965,0
60423539502,60423539502,0,1626,1828,0
60426448163,60426448164,1,1392,1661,0
60430445718,60430445719,1,1461,1323,0
60430900272,60430900253,-19,1178,1445,0
60433881616,60433881613,-3,1263,3133,0
60437466781,60437466782,1,1223,1409,0
60439063931,60439063930,-1,1452,1308,0
60440442238,60440442239,1,1546,1783,0
60440864852,60440864853,1,1351,1748,0
60443249451,60443249450,-1,1186,2103,0
60444958355,60444958355,0,1255,1787,0
60446865578,60446865576,-2,1600,2054,0
60448188360,60448188360,0,1036,2072,0
60448381493,60448381494,1,1426,1393,0
60449598215,60449598216,1,951,1688,0
60451193733,60451193734,1,1301,1697,0
60455106974,60455106973,-1,1042,1582,0
60455848095,60455848100,5,2260,1384,0
60456665489,60456665489,0,1002,1676,0
60461645318,60461645318,0,1464,1846,0
60461850184,60461850187,3,1736,1738,0
60464150081,60464150081,0,2062,2384,0
60464276232,60464276234,2,1732,2134,0
60464710613,60464710614,1,1508,2039,0
60464845235,60464845234,-1,1093,1830,0
60465839004,60465839006,2,1700,1914,0
60468030015,60468030017,2,1601,1432,0
60468527259,60468527263,4,1300,1005,0
60469624427,60469624428,1,1649,1557,0
60471349465,60471349463,-2,1057,1860,0
60471688962,60471688961,-1,1071,1544,0
60472278867,60472278869,2,809,869,0
60474007334,60474007334,0,1540,1560,0
60474543490,60474543490,0,1187,1608,0
60476952499,60476952498,-1,1431,2781,0
60479423155,60479423155,0,1370,1900,0
60479949129,60479949129,0,1822,1882,0
60482406147,60482406148,1,1494,1545,0
60486042874,60486042876,2,871,1269,0
60486709593,60486709593,0,33012,40515,0
60489373663,60489373663,0,1353,1565,0
60492570743,60492570746,3,1195,1562,0
60494934843,60494934846,3,1141,1507,0
60497675662,60497675659,-3,1246,1772,0
60497834767,60497834766,-1,1208,2296,0
60500503795,60500503796,1,1611,1618,0
60502724711,60502724712,1,1169,1507,0
60504336119,60504336120,1,1021,1982,0
60504568722,60504568704,-18,1050,1666,0
60505009186,60505009188,2,1769,2325,0
60507408585,60507408585,0,1188,1669,0
60507551418,60507551417,-1,1669,1835,0
60510372179,60510372182,3,1387,1294,0
60510507374,60510507372,-2,1519,2093,0
60514146742,60514146744,2,1490,2235,0
60514580458,60514580458,0,1300,2154,0
60515800038,60515800039,1,909,1434,0
60516708162,60516708162,0,1310,1778,0
60518203278,60518203275,-3,1291,2683,0
60518783609,60518783609,0,1437,1745,0
60519266746,60519266746,0,1637,1712,0
60522244298,60522244300,2,1675,1801,0
60529415668,60529415667,-1,1681,1977,0
60529563209,60529563206,-3,1382,1623,0
60532906414,60532906414,0,1898,1692,0
60540546796,60540546796,0,1445,1772,0
60540894455,60540894455,0,1022,1526,0
60540959277,60540959278,1,1782,1685,0
60541019119,60541019128,9,15089,26962,0
60541348203,60541348203,0,1348,1527,0
60543225002,60543225006,4,3744,2011,0
60543321942,60543321936,-6,1101,4001,0
60545427713,60545427714,1,1140,1590,0
60546194093,60546194094,1,1272,944,0
60547118254,60547118255,1,1031,1646,0
60550438575,60550438574,-1,1091,1520,0
60555204970,60555204961,-9,695,1407,0
60556491054,60556491055,1,1553,1348,0
60559739457,60559739459,2,1264,1512,0
60559937574,60559937557,-17,1566,1966,0
60560154880,60560154882,2,892,1620,0
60560516858,60560516859,1,1014,1247,0
60560782033,60560782034,1,1352,1699,0
60561184684,60561184687,3,1146,1038,0
60565993874,60565993876,2,1137,1562,0
60566657228,60566657230,2,1823,2501,0
60569300905,60569300911,6,3553,1537,0
60569640483,60569640485,2,1660,1572,0
60570975158,60570975159,1,1215,1270,0
60571617751,60571617758,7,1567,1879,0
60571902279,60571902282,3,1439,1188,0
60576509692,60576509692,0,1245,2440,0
60577448147,60577448146,-1,1524,2355,0
60585722956,60585722955,-1,1000,1129,0
60587531246,60587531240,-6,1384,5159,0
60588547242,60588547244,2,2323,2209,0
60589406183,60589406183,0,1891,2627,0
60590306030,60590306031,1,1975,1853,0
60590767998,60590767998,0,1296,1236,0
60591716111,60591716113,2,1245,1441,0
60595208571,60595208569,-2,1194,1514,0
60597391635,60597391631,-4,1015,1562,0
60600954266,60600954267,1,1623,2026,0
60607584817,60607584818,1,1352,1320,0
60607886981,60607886977,-4,1609,7130,0
60608605956,60608605954,-2,1361,2066,0
60609335170,60609335172,2,1875,2079,0
60609734875,60609734877,2,1151,1647,0
60610162222,60610162218,-4,1067,2253,0
60611315534,60611315534,0,1694,1808,0
60613359264,60613359262,-2,1332,1470,0
60614760934,60614760938,4,1863,1776,0
60619958544,60619958544,0,1968,2464,0
60621660724,60621660723,-1,1926,1880,0
60624118894,60624118894,0,1510,2136,0
60626218006,60626218006,0,1207,1787,0
60627331658,60627331658,0,2003,1775,0
60627828262,60627828263,1,1552,1907,0
60628364304,60628364303,-1,1293,1177,0
60629669669,60629669669,0,1597,2299,0
60632784974,60632784974,0,1320,1574,0
60633940895,60633940897,2,1816,1471,0
60638055040,60638055046,6,6040,2722,0
60638374051,60638374053,2,1978,1968,0
60643255508,60643255509,1,904,2438,0
60643466599,60643466600,1,1490,1817,0
60644884322,60644884322,0,1352,1347,0
60649363374,60649363374,0,1177,1027,0
60655090390,60655090390,0,935,1787,0
60656491479,60656491478,-1,553,1130,0
60659777334,60659777354,20,986,1825,0
60660329486,60660329485,-1,1120,1866,0
60661124874,60661124878,4,1425,1259,0
60667028141,60667028128,-13,843,582,0
60669409574,60669409577,3,1449,1590,0
60671392098,60671392097,-1,1482,1589,0
60672465256,60672465257,1,1639,2021,0
60678089786,60678089787,1,1779,2367,0
60679225947,60679225946,-1,1456,1435,0
60680787518,60680787518,0,1416,2176,0
60681907161,60681907163,2,1396,1928,0
60682178704,60682178706,2,1040,1105,0
60684238177,60684238163,-14,27056,29475,0
60684705737,60684705737,0,1497,1087,0
60687286357,60687286358,1,1174,1235,0
60689772773,60689772774,1,1043,1541,0
60695720949,60695720948,-1,1491,1581,0
60697088486,60697088486,0,1545,1167,0
60697207274,60697207274,0,1490,1252,0
60701785354,60701785358,4,875,1591,0
60701885751,60701885751,0,1379,1433,0
60703898597,60703898598,1,1080,1593,0
60704660981,60704660985,4,2057,1175,0
60705564273,60705564272,-1,1428,1844,0
60707488827,60707488805,-22,982,1668,0
60710491301,60710491297,-4,2400,7174,0
60711294877,60711294881,4,1547,1723,0
60713240253,60713240254,1,768,957,0
60714655138,60714655138,0,1211,1810,0
60714936822,60714936822,0,1199,1528,0
60716901771,60716901771,0,1955,1544,0
60717576504,60717576505,1,2819,3740,0
60718018707,60718018710,3,1146,1290,0
60720107826,60720107822,-4,1404,3050,0
60720653271,60720653270,-1,1315,1555,0
60720779079,60720779081,2,1622,1720,0
60721239703,60721239708,5,1042,1507,0
60725514193,60725514194,1,1127,1504,0
60727798614,60727798613,-1,989,1757,0
60728438502,60728438502,0,2018,2499,0
60730749220,60730749223,3,1363,2258,0
60736500570,60736500571,1,1414,1266,0
60737078241,60737078223,-18,1030,1251,0
60740243505,60740243505,0,1977,1421,0
60740518738,60740518758,20,921,1284,0
60742328682,60742328686,4,1667,1202,0
60749371504,60749371507,3,1453,1322,0
60751540545,60751540544,-1,1513,1710,0
60753675007,60753675009,2,1415,2017,0
60756015623,60756015624,1,1810,2183,0
60757236962,60757236962,0,1348,1157,0
60758781753,60758781753,0,1699,1666,0
60758809396,60758809397,1,1183,1836,0
60760344429,60760344427,-2,1604,2071,0
60762074115,60762074115,0,1351,1720,0
60771859150,60771859150,0,1279,2748,0
60775986579,60775986580,1,1255,1358,0
60776854386,60776854387,1,1253,1650,0
60778065877,60778065878,1,1285,1239,0
60780407210,60780407210,0,1314,1800,0
60786624659,60786624659,0,1704,1553,0
60787577353,60787577354,1,1993,2318,0
60788730415,60788730417,2,1348,1559,0
60791362250,60791362250,0,1172,1164,0
60796029290,60796029291,1,1636,2582,0
60796599615,60796599618,3,1300,1305,0
60796896866,60796896865,-1,1401,2014,0
60798743435,60798743434,-1,920,1490,0
60804671484,60804671484,0,1478,2019,0
60807577579,60807577581,2,1880,1302,0
60807902915,60807902915,0,3162,4373,0
60810053777,60810053777,0,1186,1912,0
60811403723,60811403723,0,1561,2040,0
60813264955,60813264950,-5,1033,1147,0
60813562245,60813562243,-2,1548,1975,0
60814134537,60814134537,0,1599,1432,0
60815232831,60815232833,2,1217,2004,0
60816719657,60816719659,2,2017,1269,0
60817550659,60817550657,-2,929,1501,0
60821578595,60821578597,2,1055,1631,0
60824271267,60824271267,0,1587,1884,0
60826734230,60826734236,6,39,1122,0
60826786822,60826786805,-17,378,526,0
60833241086,60833241084,-2,1959,2734,0
60836894840,60836894838,-2,1326,1302,0
60837657151,60837657150,-1,1095,1387,0
60838410707,60838410706,-1,1337,1740,0
60838793546,60838793546,0,1156,2316,0
60839351120,60839351119,-1,43701,20800,0
60841033748,60841033749,1,1672,2078,0
60844208764,60844208763,-1,1103,1711,0
60844718343,60844718346,3,9583,6046,0
60844872982,60844872981,-1,1457,1781,0
60850146507,60850146505,-2,1091,1596,0
60853962186,60853962187,1,1743,1067,0
60855149774,60855149778,4,1133,1282,0
60855481056,60855481054,-2,1166,1596,0
60858880510,60858880514,4,1258,946,0
60860621627,60860621627,0,1501,1955,0
60861409127,60861409129,2,1431,1846,0
60861915536,60861915536,0,1508,3009,0
60863185098,60863185098,0,1176,1671,0
60865820458,60865820458,0,1098,1548,0
60867578052,60867578055,3,1861,1734,0
60868186541,60868186538,-3,1105,1129,0
60868394125,60868394125,0,855,1470,0
60869407909,60869407908,-1,967,908,0
60870499241,60870499239,-2,1382,1967,0
60872351305,60872351305,0,1806,1949,0
60872810421,60872810422,1,2053,1816,0
60873992554,60873992558,4,2798,1421,0
60874238110,60874238114,4,985,996,0
60875020645,60875020646,1,1792,1876,0
60875276804,60875276802,-2,1285,1627,0
60876528083,60876528084,1,1482,1584,0
60880609774,60880609775,1,1459,1817,0
60881060862,60881060866,4,1787,1606,0
60884414466,60884414467,1,1161,1387,0
60885671048,60885671050,2,1447,1453,0
60886679571,60886679573,2,1463,1593,0
60887555366,60887555366,0,1175,2054,0
60888102557,60888102563,6,2992,1173,0
60889325689,60889325689,0,884,1091,0
60890150645,60890150642,-3,997,1623,0
60894318917,60894318915,-2,1345,1772,0
60895968534,60895968534,0,1198,1320,0
60896792129,60896792129,0,1063,1580,0
60897875276,60897875274,-2,1292,2232,0
60900412455,60900412455,0,1341,2038,0
60904183634,60904183640,6,4414,1574,0
60904993737,60904993738,1,1342,1684,0
60908278355,60908278356,1,1447,1762,0
60909730114,60909730114,0,1446,1802,0
60909788453,60909788474,21,1142,1089,0
60911994458,60911994459,1,842,1379,0
60928909685,60928909689,4,1780,1995,0
60930469637,60930469637,0,1550,1516,0
60931703884,60931703884,0,1515,1295,0
60935829524,60935829524,0,1320,1140,0
60936914270,60936914270,0,1385,1886,0
60941660431,60941660432,1,1910,1871,0
60942158654,60942158653,-1,1267,2470,0
60942855385,60942855390,5,1614,1526,0
60943600832,60943600825,-7,34273,14336,0
60943885002,60943885003,1,1505,1686,0
60944039554,60944039554,0,1257,1460,0
60946175144,60946175142,-2,1087,1293,0
60946539281,60946539284,3,1419,1580,0
60948292331,60948292331,0,1499,2550,0
60957635802,60957635805,3,1094,2219,0
60958238410,60958238411,1,1625,1391,0
60961210174,60961210171,-3,1295,3507,0
60963595357,60963595357,0,1940,1971,0
60966753175,60966753174,-1,845,933,0
60966870762,60966870762,0,1926,2463,0
60967625542,60967625543,1,1725,2219,0
60968075247,60968075247,0,1696,1854,0
60973745775,60973745774,-1,1132,1851,0
60979765309,60979765310,1,1408,1917,0
60980383094,60980383095,1,1788,2396,0
60980809309,60980809306,-3,1039,1441,0
60983422306,60983422306,0,1208,1585,0
60988467110,60988467110,0,978,1696,0
60990569909,60990569910,1,1176,1588,0
60992086699,60992086698,-1,1526,1444,0
60994847600,60994847598,-2,1499,1696,0
60995812501,60995812502,1,2016,1784,0
60996541573,60996541574,1,1138,1889,0
60996674607,60996674595,-12,1074,1966,0
60998411487,60998411490,3,1547,2163,0
61000686786,61000686800,14,1217,1852,0
61006181631,61006181632,1,1610,2353,0
61006365714,61006365713,-1,1076,1689,0
61007552877,61007552874,-3,993,2634,0
61007801182,61007801183,1,957,809,0
61009058494,61009058494,0,1538,1423,0
61019265023,61019265023,0,1137,2066,0
61023653855,61023653857,2,1741,1097,0
61027688345,61027688345,0,1662,1816,0
61031893714,61031893715,1,808,1127,0
61033723770,61033723770,0,1048,1312,0
61034251198,61034251198,0,535,697,0
61035341165,61035341166,1,1876,1866,0
61039361807,61039361806,-1,1608,1771,0
61039501415,61039501413,-2,1164,2064,0
61044656965,61044656964,-1,1513,1440,0
61048154637,61048154638,1,1922,1829,0
61049364499,61049364499,0,1809,1368,0
61050331763,61050331763,0,935,1252,0
61052965718,61052965721,3,1470,1101,0
61055133869,61055133869,0,1796,1819,0
61055782233,61055782234,1,960,1187,0
61057710362,61057710362,0,1245,1658,0
61058979068,61058979070,2,2126,1671,0
61063242894,61063242893,-1,1441,2496,0
61064157815,61064157809,-6,2689,8133,0
61065465892,61065465893,1,1190,1963,0
61066260146,61066260146,0,1344,1492,0
61068083620,61068083621,1,1596,1484,0
61068460868,61068460871,3,1305,902,0
61070025537,61070025535,-2,1538,1964,0
61070719005,61070719006,1,1921,2153,0
61074024593,61074024594,1,2020,2026,0
61077209226,61077209225,-1,995,1205,0
61077270577,61077270578,1,1840,1591,0
61079055175,61079055173,-2,1018,1647,0
61079355678,61079355685,7,3197,1683,0
61081166895,61081166897,2,1660,1839,0
61081975609,61081975614,5,1570,934,0
61085253782,61085253781,-1,1344,1678,0
61092311643,61092311638,-5,930,4542,0
61093354246,61093354246,0,1177,1545,0
61095444443,61095444441,-2,1513,1946,0
61100093078,61100093077,-1,1444,1775,0
61106150640,61106150641,1,1842,2318,0
61111516790,61111516790,0,1466,1328,0
61112255226,61112255226,0,1148,978,0
61112948667,61112948669,2,1434,2148,0
61113052230,61113052217,-13,1402,1264,0
61114571261,61114571263,2,1115,1255,0
61115862044,61115862042,-2,1352,1666,0
61116554513,61116554513,0,1526,1694,0
61118577951,61118577952,1,516,1512,0
61118877767,61118877767,0,1159,1812,0
61121299828,61121299826,-2,1292,1416,0
61123297817,61123297817,0,1197,1559,0
61126206414,61126206412,-2,949,1298,0
61127886862,61127886863,1,1734,2021,0
61130323467,61130323467,0,1419,2000,0
61130647657,61130647658,1,1264,1579,0
61135312681,61135312681,0,1658,2151,0
61138971690,61138971689,-1,1950,2230,0
61139806863,61139806863,0,1472,1801,0
61140168754,61140168754,0,1706,1708,0
61140391215,61140391214,-1,642,1760,0
61142153310,61142153311,1,726,1081,0
61142642270,61142642270,0,1404,1640,0
61142932036,61142932035,-1,1340,1580,0
61143385517,61143385521,4,1736,1747,0
61143757514,61143757512,-2,979,1718,0
61146020083,61146020086,3,1620,1595,0
61147395874,61147395875,1,1106,990,0
61152604323,61152604323,0,1521,2488,0
61153071242,61153071241,-1,1021,1557,0
61154225407,61154225406,-1,1415,2213,0
61155617158,61155617160,2,1451,1793,0
61161310716,61161310717,1,745,1213,0
61164188898,61164188898,0,2143,2163,0
61165113553,61165113554,1,1051,1837,0
61166649495,61166649495,0,1142,1202,0
61167099965,61167099966,1,1267,795,0
61169012970,61169012971,1,2153,1521,0
61171248847,61171248849,2,1222,1340,0
61174054437,61174054439,2,1222,1403,0
61175351511,61175351510,-1,1393,1814,0
61176540326,61176540326,0,1625,1493,0
61176702518,61176702519,1,1644,1473,0
61178044922,61178044922,0,1301,2248,0
61181119947,61181119949,2,1660,1801,0
61182112795,61182112794,-1,1302,2109,0
61190879677,61190879678,1,3868,4060,0
61191249002,61191249002,0,1122,1316,0
61195345389,61195345389,0,1621,1853,0
61195689072,61195689072,0,1335,1390,0
61195735050,61195735031,-19,1559,1638,0
61196357474,61196357471,-3,1607,1724,0
61196792765,61196792766,1,973,1536,0
61197516132,61197516131,-1,1765,2266,0
61201400974,61201400974,0,1531,2236,0
61201751206,61201751208,2,1159,1533,0
61207774549,61207774547,-2,1216,1880,0
61214877945,61214877945,0,1123,1787,0
61221245021,61221245016,-5,1422,3396,0
61222242232,61222242231,-1,1004,1792,0
61222846483,61222846481,-2,1251,1763,0
61226028869,61226028869,0,1564,1764,0
61229447024,61229447025,1,1288,1466,0
61236825102,61236825104,2,1149,1353,0
61247223465,61247223466,1,1197,1655,0
61250312449,61250312450,1,1197,1311,0
61251554539,61251554538,-1,1085,1477,0
61255338620,61255338621,1,1181,1018,0
61256556581,61256556584,3,1360,1664,0
61257533719,61257533716,-3,1283,1759,0
61259181715,61259181718,3,1246,1229,0
61262458939,61262458942,3,1257,829,0
61267858566,61267858566,0,1253,1070,0
61275101965,61275101967,2,2267,1207,0
61275635551,61275635553,2,1793,1919,0
61277796686,61277796693,7,2690,956,0
61278873481,61278873482,1,1361,1516,0
61279023311,61279023298,-13,932,714,0
61281685344,61281685345,1,1936,2057,0
61281908809,61281908810,1,1377,1203,0
61282828549,61282828549,0,784,1305,0
61283392065,61283392065,0,1706,1794,0
61284061922,61284061924,2,1287,1304,0
61286748906,61286748906,0,1676,1121,0
61287247487,61287247486,-1,1150,1319,0
61287304438,61287304439,1,1480,1556,0
61288182502,61288182502,0,1386,1348,0
61288777398,61288777394,-4,2274,5807,0
61289864441,61289864445,4,1177,1020,0
61290470674,61290470677,3,1344,1609,0
61290979968,61290979965,-3,234,646,0
61294885027,61294885030,3,1506,1653,0
61298182587,61298182591,4,726,1084,0
61299267855,61299267856,1,1114,1752,0
61299812142,61299812141,-1,982,1433,0
61301936167,61301936161,-6,1229,4033,0
61303118554,61303118554,0,1772,1834,0
61305553052,61305553054,2,1556,1463,0
61307491303,61307491302,-1,1347,1869,0
61309357462,61309357461,-1,1184,1894,0
61313394382,61313394386,4,1809,1497,0
61314605113,61314605113,0,1781,2048,0
61318494803,61318494801,-2,931,2125,0
61320346922,61320346923,1,1381,1713,0
61322502512,61322502512,0,1046,1556,0
61324008610,61324008606,-4,1508,2499,0
61326366407,61326366407,0,1426,1707,0
61334560013,61334560013,0,1248,1570,0
61334880927,61334880925,-2,1109,1590,0
61335320320,61335320342,22,1371,1256,0
61337092932,61337092933,1,1340,1456,0
61338595605,61338595603,-2,1257,1134,0
61338807264,61338807262,-2,822,1771,0
61340481965,61340481966,1,1188,1829,0
61346290281,61346290281,0,1691,1955,0
61346658562,61346658563,1,1010,1474,0
61347743632,61347743633,1,1512,1839,0
61349031042,61349031043,1,1295,1455,0
61349235606,61349235607,1,1237,1780,0
61349528167,61349528166,-1,1109,1436,0
61351971088,61351971087,-1,2218,2034,0
61354935713,61354935714,1,1686,2210,0
61355715538,61355715537,-1,1670,1979,0
61357998662,61357998662,0,1043,1237,0
61358787901,61358787880,-21,1144,1211,0
61361366997,61361366998,1,1253,1896,0
61365272666,61365272660,-6,1696,6565,0
61365761327,61365761326,-1,1230,1575,0
61367188967,61367188967,0,1835,2296,0
61367860162,61367860161,-1,1226,1521,0
61369174625,61369174626,1,1395,2047,0
61371398768,61371398769,1,1599,2271,0
61371945221,61371945221,0,1343,1681,0
61374268805,61374268808,3,1391,1863,0
61382855048,61382855049,1,1541,1539,0
61385546579,61385546582,3,2814,1781,0
61387341934,61387341935,1,1378,1644,0
61390266910,61390266909,-1,1449,1646,0
61392822499,61392822498,-1,881,1377,0
61393670646,61393670645,-1,1135,1419,0
61396681203,61396681207,4,1048,962,0
61400071094,61400071095,1,854,1899,0
61400388871,61400388855,-16,2182,78,0
61403291312,61403291312,0,1409,23078,0
61405671507,61405671510,3,1119,1375,0
61407189626,61407189625,-1,1482,1837,0
61408527023,61408527021,-2,1592,1923,0
61411078692,61411078694,2,1228,1283,0
61411217173,61411217175,2,1324,1694,0
61412767302,61412767302,0,1144,1653,0
61413811403,61413811403,0,1076,2455,0
61415014852,61415014855,3,1044,983,0
61424867452,61424867453,1,1268,1335,0
61426907922,61426907923,1,1419,2020,0
61427716287,61427716289,2,1561,1807,0
61428387449,61428387451,2,1758,1703,0
61429249326,61429249327,1,1531,1603,0
61431608027,61431608028,1,2047,2006,0
61440078701,61440078701,0,1163,2681,0
61442813386,61442813388,2,1504,1744,0
61445332669,61445332670,1,1543,1914,0
61445440041,61445440047,6,2637,1592,0
61446356818,61446356817,-1,1633,2165,0
61451883351,61451883350,-1,1146,1421,0
61457015439,61457015438,-1,1174,1865,0
61458536985,61458536989,4,2517,1825,0
61458657893,61458657885,-8,43259,14994,0
61459434241,61459434242,1,1215,989,0
61460078454,61460078454,0,1740,1699,0
61463693062,61463693061,-1,1481,1690,0
61466388706,61466388706,0,1391,1435,0
61467130588,61467130590,2,1050,1453,0
61467669143,61467669145,2,3282,2136,0
61468908973,61468908973,0,1262,1961,0
61469800530,61469800529,-1,1977,1696,0
61472714845,61472714846,1,1582,1522,0
61473501249,61473501253,4,1789,2141,0
61473846422,61473846421,-1,1199,1198,0
61475635283,61475635282,-1,414,1571,0
61479812483,61479812482,-1,1001,1443,0
61480808937,61480808916,-21,836,544,0
61481296865,61481296867,2,1727,1962,0
61482797290,61482797290,0,1035,1549,0
61489917525,61489917527,2,1166,1800,0
61492106269,61492106268,-1,1455,1936,0
61492721340,61492721341,1,1567,1678,0
61495194857,61495194857,0,1582,1563,0
61496239174,61496239174,0,1694,2764,0
61497294194,61497294193,-1,1466,1638,0
61499998321,61499998322,1,1331,1832,0
61500454255,61500454255,0,1095,1313,0
61501693648,61501693646,-2,1303,1838,0
61503076539,61503076541,2,1802,1839,0
61504794997,61504794998,1,1319,1985,0
61504856769,61504856770,1,1643,1685,0
61505173165,61505173167,2,2018,1502,0
61505514328,61505514330,2,1580,1928,0
61515242554,61515242557,3,2385,1905,0
61516302293,61516302300,7,413,682,0
61517062022,61517062021,-1,507,979,0
61520223208,61520223208,0,746,1304,0
61521567466,61521567466,0,1127,1209,0
61522081778,61522081779,1,811,1403,0
61529610412,61529610413,1,1530,2167,0
61533479302,61533479307,5,2551,1442,0
61535919921,61535919924,3,1089,1090,0
61536906102,61536906101,-1,1900,2292,0
61540101931,61540101933,2,1255,1885,0
61540889378,61540889378,0,1484,2221,0
61541267428,61541267430,2,1261,1428,0
61542362358,61542362359,1,706,1139,0
61544779503,61544779502,-1,1389,1549,0
61545448548,61545448549,1,1160,1826,0
61545951046,61545951048,2,2474,2426,0
61546349869,61546349863,-6,1284,5329,0
61547583015,61547583005,-10,1300,1677,0
61547772830,61547772829,-1,8893,17031,0
61548351743,61548351744,1,1593,1589,0
61550028601,61550028601,0,1526,1533,0
61551165969,61551165969,0,1500,1830,0
61552937090,61552937089,-1,1494,1689,0
61555292901,61555292901,0,1746,1756,0
61555507438,61555507423,-15,1362,1864,0
61556313867,61556313867,0,1437,1329,0
61557746726,61557746726,0,1298,1705,0
61562857065,61562857065,0,1848,2492,0
61566474455,61566474457,2,1592,1938,0
61568309079,61568309079,0,1660,1898,0
61570876526,61570876522,-4,1162,2220,0
61572249503,61572249506,3,1660,1383,0
61576856953,61576856948,-5,1792,4613,0
61579710250,61579710251,1,1072,947,0
61584277690,61584277690,0,1138,855,0
61586947099,61586947099,0,1941,1659,0
61587024457,61587024458,1,1908,2029,0
61587654995,61587654994,-1,1201,1616,0
61588152488,61588152506,18,370,1863,0
61589488654,61589488654,0,1282,1661,0
61590230647,61590230647,0,1162,1472,0
61595692703,61595692701,-2,1030,1138,0
61598864052,61598864049,-3,1668,3933,0
61599650172,61599650172,0,1318,1108,0
61602014516,61602014518,2,1665,1386,0
61604053450,61604053450,0,1053,1895,0
61605982533,61605982533,0,1182,1372,0
61610179861,61610179861,0,1649,1660,0
61611466848,61611466831,-17,1397,1985,0
61612201399,61612201399,0,1128,2232,0
61612390734,61612390739,5,1572,1157,0
61614954509,61614954511,2,1889,1873,0
61616064961,61616064960,-1,1216,1818,0
61619558653,61619558674,21,1328,1550,0
61620127851,61620127850,-1,1441,1625,0
61620542039,61620542037,-2,941,2839,0
61623229836,61623229835,-1,1417,2578,0
61623678998,61623678994,-4,1193,2146,0
61623851515,61623851513,-2,4050,8516,0
61625209617,61625209617,0,1296,1963,0
61625400833,61625400838,5,3536,2462,0
61627411529,61627411530,1,1417,1468,0
61628074479,61628074477,-2,743,815,0
61633849329,61633849329,0,1207,2054,0
61634876463,61634876465,2,1218,1248,0
61636087675,61636087677,2,1719,1458,0
61636329162,61636329143,-19,1168,2025,0
61637618137,61637618138,1,1242,1120,0
61640642869,61640642870,1,1562,1416,0
61641977953,61641977955,2,1696,1624,0
61643220901,61643220900,-1,1483,2136,0
61646036010,61646036010,0,1189,1727,0
61646252050,61646252046,-4,1647,1615,0
61647139347,61647139347,0,1655,2160,0
61647993781,61647993782,1,1757,1378,0
61650852028,61650852030,2,2211,1516,0
61651788837,61651788834,-3,1237,2465,0
61653249018,61653249017,-1,1217,1360,0
61658532515,61658532517,2,1106,1558,0
61661419269,61661419278,9,1409,1662,0
61665198540,61665198541,1,1726,1690,0
61665791350,61665791351,1,1544,1392,0
61668145035,61668145034,-1,1620,2019,0
61673185991,61673185989,-2,2224,4734,0
61678293009,61678293010,1,1332,1564,0
61680536001,61680536000,-1,1412,1650,0
61682256247,61682256247,0,1410,1857,0
61685846946,61685846944,-2,1518,1984,0
61686045822,61686045824,2,1938,2045,0
61687187135,61687187137,2,1067,1617,0
61688184201,61688184201,0,881,1721,0
61688397728,61688397728,0,2091,1922,0
61693269527,61693269527,0,1715,1955,0
61694418511,61694418512,1,1630,2372,0
61695713828,61695713829,1,2040,2414,0
61696559937,61696559939,2,1253,1670,0
61700285253,61700285254,1,1528,2373,0
61700531766,61700531766,0,1484,1783,0
61702132572,61702132569,-3,1344,2488,0
61703259802,61703259808,6,4704,2510,0
61703740583,61703740582,-1,1582,2091,0
61705364461,61705364464,3,1002,1320,0
61706579759,61706579758,-1,1432,1261,0
61712660497,61712660497,0,1374,1766,0
61713195882,61713195882,0,1288,1644,0
61713566786,61713566786,0,1127,1341,0
61714957551,61714957550,-1,1875,1580,0
61715533334,61715533335,1,1116,1591,0
61716027133,61716027134,1,1214,2555,0
61718022651,61718022654,3,1448,2153,0
61718416847,61718416849,2,2139,1130,0
61718951570,61718951571,1,1849,1982,0
61719157578,61719157577,-1,1424,2334,0
61720078796,61720078780,-16,1261,1767,0
61721785662,61721785663,1,1619,2352,0
61724717938,61724717939,1,1105,1326,0
61726075485,61726075486,1,880,1309,0
61728092150,61728092153,3,1219,1445,0
61729520868,61729520868,0,1596,2009,0
61734505021,61734505022,1,1067,1654,0
61738226968,61738226968,0,1547,1503,0
61740187817,61740187817,0,1118,1430,0
61740516879,61740516857,-22,1222,1555,0
61744697318,61744697318,0,919,1783,0
61745612674,61745612674,0,1362,1592,0
61748007635,61748007634,-1,956,1359,0
61752596910,61752596914,4,1497,1201,0
61760228019,61760228020,1,1271,1200,0
61760548242,61760548242,0,1481,1997,0
61761486258,61761486257,-1,1353,1571,0
61765690007,61765690006,-1,1563,1827,0
61773784143,61773784132,-11,277,1792,0
61775110591,61775110591,0,1522,1296,0
61776965941,61776965941,0,2432,2083,0
61777080402,61777080403,1,1438,1930,0
61778652297,61778652298,1,1485,2248,0
61780177898,61780177898,0,1101,1432,0
61780524025,61780524025,0,1841,2347,0
61781087697,61781087698,1,2153,2040,0
61782165094,61782165095,1,1456,1659,0
61783157865,61783157867,2,1213,1551,0
61783733970,61783733991,21,1693,1548,0
61783851923,61783851925,2,966,1152,0
61783921832,61783921830,-2,1348,1662,0
61784507117,61784507118,1,1652,2427,0
61795464687,61795464687,0,1401,1194,0
61795542106,61795542109,3,1191,1360,0
61797487799,61797487798,-1,1817,2304,0
61804201773,61804201774,1,1942,1276,0
61804445605,61804445609,4,1700,1428,0
61808322493,61808322486,-7,24133,14609,0
61810885682,61810885682,0,1483,1806,0
61812132158,61812132158,0,1395,1633,0
61818433831,61818433834,3,1338,1410,0
61818494348,61818494348,0,1585,1918,0
61819265986,61819265987,1,1214,1192,0
61821922677,61821922679,2,1122,1269,0
61824042473,61824042474,1,1681,1965,0
61824444278,61824444278,0,995,1995,0
61826133880,61826133879,-1,1019,1338,0
61834110732,61834110732,0,1683,2489,0
61836597194,61836597194,0,1477,1323,0
61842874811,61842874814,3,1942,1850,0
61848873187,61848873187,0,1022,1583,0
61852814145,61852814146,1,1327,1392,0
61855117760,61855117762,2,1254,1581,0
61857266586,61857266590,4,1645,1487,0
61858368155,61858368159,4,1723,1713,0
61860158698,61860158700,2,1191,1549,0
61860352966,61860352970,4,1878,1201,0
61864259303,61864259304,1,1349,1827,0
61867063386,61867063386,0,1350,2087,0
61867429042,61867429041,-1,1577,1383,0
61868579578,61868579578,0,1017,1328,0
61869207438,61869207437,-1,1344,1629,0
61871033316,61871033316,0,1769,1838,0
61872198121,61872198121,0,1674,1510,0
61873147246,61873147247,1,1342,1637,0
61873664009,61873664011,2,1264,1213,0
61877318915,61877318914,-1,911,1927,0
61877621856,61877621856,0,1362,1865,0
61880445039,61880445025,-14,529,450,0
61883560503,61883560502,-1,1452,2504,0
61884963843,61884963844,1,2256,3309,0
61889565550,61889565553,3,712,1302,0
61890947404,61890947405,1,1437,2009,0
61892627994,61892627995,1,1197,1803,0
61894434653,61894434655,2,1682,1614,0
61895720224,61895720226,2,1438,1859,0
61896169475,61896169479,4,1200,1883,0
61897070991,61897070995,4,1338,1309,0
61900660518,61900660519,1,1314,1289,0
61907015602,61907015603,1,1442,1461,0
61911383194,61911383194,0,1412,1876,0
61913389874,61913389869,-5,2376,6682,0
61915316631,61915316631,0,1376,1838,0
61919837658,61919837659,1,1218,1634,0
61920217879,61920217882,3,914,1732,0
61921248643,61921248622,-21,1180,1470,0
61922787624,61922787625,1,1520,1694,0
61923991230,61923991231,1,1370,1580,0
61924249396,61924249400,4,1636,2044,0
61924774445,61924774445,0,1330,1312,0
61926244843,61926244843,0,1704,1574,0
61927405166,61927405165,-1,1239,2388,0
61928838885,61928838886,1,1682,2214,0
61930647761,61930647771,10,12706,31806,0
61934055831,61934055833,2,765,1354,0
61934344577,61934344581,4,2840,1452,0
61935177382,61935177383,1,1074,1225,0
61939885391,61939885390,-1,1329,2003,0
61940036710,61940036713,3,2396,2065,0
61942383047,61942383047,0,1446,1720,0
61942910873,61942910875,2,705,968,0
61945362046,61945362046,0,1892,1341,0
61949811274,61949811278,4,2001,1201,0
61951839625,61951839625,0,1201,1494,0
61955746719,61955746721,2,1341,1393,0
61956772135,61956772138,3,1649,1887,0
61958188601,61958188602,1,1875,1873,0
61959739747,61959739745,-2,1214,1615,0
61962149634,61962149635,1,1387,1676,0
61963141744,61963141745,1,1352,1578,0
61966475089,61966475089,0,2377,1783,0
61967051360,61967051367,7,6512,2750,0
61967665521,61967665527,6,2200,783,0
61968327845,61968327847,2,1128,1179,0
61968862707,61968862706,-1,898,2169,0
61969905731,61969905731,0,1176,1824,0
61972520638,61972520638,0,1300,1364,0
61972944026,61972944028,2,1818,1257,0
61976813877,61976813878,1,1096,1558,0
61977561817,61977561814,-3,550,2447,0
61977796485,61977796486,1,2116,2315,0
61978120541,61978120542,1,1357,1520,0
61980015375,61980015377,2,1482,1842,0
61982275497,61982275496,-1,690,921,0
61983871395,61983871397,2,1450,1799,0
61984118206,61984118206,0,1658,1860,0
61984870191,61984870193,2,1818,1989,0
61985164088,61985164090,2,1627,1203,0
61985845344,61985845350,6,1278,705,0
61986274310,61986274309,-1,1938,2438,0
61987110150,61987110149,-1,1112,1560,0
61987827580,61987827579,-1,859,1420,0
61990947051,61990947050,-1,1514,1715,0
61992080645,61992080645,0,1169,1718,0
61992366655,61992366637,-18,916,1143,0
61993265765,61993265765,0,1671,1952,0
61994525417,61994525418,1,3240,3768,0
61995174293,61995174293,0,1724,1520,0
61997816074,61997816075,1,1909,1485,0
61998111151,61998111152,1,1575,2033,0
62001618636,62001618634,-2,704,892,0
62002275791,62002275791,0,1375,1123,0
62004252629,62004252627,-2,1254,1501,0
62004414942,62004414941,-1,1677,2523,0
62006362807,62006362806,-1,1432,1560,0
62007360933,62007360941,8,3259,1378,0
62007577560,62007577562,2,1373,1624,0
62008561398,62008561401,3,1301,1380,0
62012019105,62012019122,17,16543,33471,0
62015235270,62015235270,0,1291,1619,0
62017568123,62017568125,2,969,1154,0
62019836689,62019836690,1,1767,1648,0
62021362666,62021362670,4,1881,1581,0
62021580921,62021580922,1,1076,1512,0
62025881022,62025881023,1,1183,1433,0
62027650874,62027650872,-2,1351,1100,0
62032521826,62032521826,0,1482,2010,0
62034778671,62034778671,0,1666,1653,0
62035286798,62035286798,0,1550,2273,0
62037597901,62037597901,0,1549,2291,0
62037767910,62037767913,3,3137,3927,0
62040120051,62040120051,0,1785,2026,0
62046705638,62046705635,-3,902,2113,0
62049696598,62049696598,0,1608,1910,0
62050000678,62050000678,0,1340,1830,0
62050116108,62050116109,1,1765,1773,0
62055984085,62055984085,0,507,546,0
62061840164,62061840163,-1,1061,1353,0
62064786234,62064786234,0,1788,1786,0
62066258178,62066258180,2,1324,1579,0
62068265327,62068265329,2,1410,1877,0
62068645834,62068645833,-1,1119,1372,0
62070557823,62070557814,-9,975,4780,0
62071460630,62071460650,20,995,2392,0
62071500730,62071500732,2,1617,1998,0
62072921790,62072921794,4,1367,1681,0
62073494750,62073494751,1,950,1297,0
62073660128,62073660130,2,2486,2437,0
62076967425,62076967418,-7,1872,9687,0
62077632181,62077632182,1,1434,1295,0
62078593964,62078593968,4,1941,1346,0
62078861118,62078861118,0,1177,1389,0
62080250571,62080250569,-2,1399,2010,0
62080374620,62080374609,-11,1164,2004,0
62081610563,62081610561,-2,1665,2523,0
62088804412,62088804401,-11,47728,19808,0
62089232534,62089232533,-1,1283,1202,0
62092003203,62092003204,1,816,1765,0
62094422207,62094422207,0,1508,1463,0
62094932181,62094932178,-3,580,2351,0
62095846320,62095846317,-3,1209,2597,0
62099030674,62099030673,-1,1760,1749,0
62102102946,62102102945,-1,1153,1523,0
62104044071,62104044071,0,1074,835,0
62104339870,62104339869,-1,1309,1263,0
62106010314,62106010315,1,841,789,0
62106451074,62106451074,0,1109,1661,0
62107339115,62107339108,-7,1067,4796,0
62107835242,62107835241,-1,1011,2220,0
62111532192,62111532193,1,1036,1751,0
62115559342,62115559344,2,885,1100,0
62116263382,62116263398,16,730,1404,0
62116794642,62116794637,-5,958,4054,0
62119663823,62119663825,2,1260,1761,0
62120492619,62120492619,0,914,1505,0
62125343301,62125343303,2,1225,1913,0
62129029944,62129029943,-1,1520,2420,0
62131932657,62131932656,-1,2024,1825,0
62133178206,62133178206,0,1100,1585,0
62134891483,62134891486,3,788,1129,0
62135794942,62135794941,-1,1234,2088,0
62135891421,62135891421,0,1007,1089,0
62138754378,62138754378,0,2014,1976,0
62141406948,62141406950,2,1956,2146,0
62142893173,62142893175,2,1578,2061,0
62145555779,62145555781,2,1745,2205,0
62146846066,62146846066,0,1214,1788,0
62147944871,62147944872,1,1237,1530,0
62148644746,62148644750,4,1747,1579,0
62154175625,62154175626,1,1715,1819,0
62154606566,62154606571,5,851,1107,0
62155795236,62155795237,1,1652,2514,0
62159879234,62159879213,-21,1273,1562,0
62162567735,62162567734,-1,1296,1410,0
62164518170,62164518175,5,699,951,0
62165181922,62165181921,-1,1390,1629,0
62165840464,62165840465,1,948,1574,0
62166017911,62166017909,-2,1395,1345,0
62166732983,62166732983,0,1362,2349,0
62167398459,62167398471,12,11513,39489,0
62170851418,62170851424,6,10157,29771,0
62175513794,62175513798,4,1529,880,0
62176678591,62176678587,-4,940,2355,0
62179270293,62179270294,1,1729,1163,0
62179646992,62179646990,-2,991,2250,0
62184620218,62184620217,-1,1271,1295,0
62190397768,62190397769,1,1678,1774,0
62193140593,62193140593,0,1547,1548,0
62194922514,62194922516,2,1338,1984,0
62197667838,62197667838,0,1169,1437,0
62203652779,62203652791,12,3915,16240,0
62205780435,62205780434,-1,925,1270,0
62214542062,62214542061,-1,1411,1813,0
62216017831,62216017833,2,1496,2307,0
62216245483,62216245482,-1,1436,2746,0
62220845927,62220845929,2,1282,1662,0
62221495523,62221495523,0,1420,1475,0
62223353498,62223353497,-1,1173,1245,0
62224786273,62224786273,0,1109,1742,0
62225970046,62225970046,0,2071,2273,0
62227854514,62227854514,0,1672,2064,0
62229781018,62229781018,0,1307,1461,0
62230951238,62230951239,1,710,983,0
62231262119,62231262122,3,1784,1283,0
62232578256,62232578257,1,1190,1707,0
62235128965,62235128963,-2,1530,3158,0
62235990646,62235990649,3,941,1318,0
62236403673,62236403674,1,1308,1483,0
62236931034,62236931035,1,1165,1057,0
62237805479,62237805480,1,1483,1692,0
62238984811,62238984811,0,1720,1158,0
62239481833,62239481830,-3,1363,1591,0
62239857513,62239857512,-1,668,1738,0
62244874364,62244874366,2,2186,2150,0
62246237668,62246237670,2,1030,1391,0
62248948090,62248948090,0,1158,1512,0
62249798914,62249798914,0,2033,1944,0
62254975890,62254975891,1,2560,2697,0
62258395532,62258395532,0,1888,2269,0
62261637451,62261637454,3,1560,1628,0
62265243457,62265243458,1,1616,2010,0
62267855882,62267855882,0,891,1245,0
62274657974,62274657973,-1,1387,1906,0
62276061565,62276061565,0,1078,1285,0
62278320329,62278320330,1,2208,2490,0
62279604087,62279604087,0,1591,1678,0
62280630782,62280630783,1,1244,1875,0
62282288101,62282288102,1,1524,1552,0
62284710975,62284710981,6,62788,32221,0
62286555517,62286555517,0,1613,1330,0
62292006230,62292006231,1,1095,1312,0
62293869086,62293869086,0,1341,1624,0
62294560699,62294560699,0,819,856,0
62294942449,62294942451,2,1251,1394,0
62298522750,62298522750,0,1414,1680,0
62301002503,62301002504,1,972,1538,0
62308269494,62308269494,0,971,2123,0
62309598170,62309598175,5,1954,1082,0
62314621587,62314621587,0,868,1906,0
62317383207,62317383208,1,2217,1921,0
62318311654,62318311654,0,984,1765,0
62319011562,62319011562,0,1865,2052,0
62324409639,62324409639,0,1021,1497,0
62325462794,62325462794,0,1046,1630,0
62326149944,62326149945,1,1326,2053,0
62329443886,62329443885,-1,1067,1368,0
62332560006,62332560008,2,2336,2249,0
62335785111,62335785114,3,1476,1256,0
62337851817,62337851818,1,920,1133,0
62338124537,62338124539,2,1713,1858,0
62349678848,62349678829,-19,1219,1524,0
62353677319,62353677321,2,1477,1832,0
62354248395,62354248396,1,1654,2119,0
62354992670,62354992668,-2,1050,1549,0
62356060103,62356060103,0,768,890,0
62357709779,62357709781,2,1422,1412,0
62363840320,62363840319,-1,1037,1514,0
62363865589,62363865591,2,2036,2002,0
62364501495,62364501501,6,11597,4887,0
62366081290,62366081290,0,1219,1627,0
62370770249,62370770250,1,1247,1290,0
62371160313,62371160305,-8,32573,13083,0
62371262778,62371262778,0,1553,1530,0
62372666134,62372666133,-1,1153,1766,0
62374575958,62374575958,0,1027,1305,0
62376998346,62376998345,-1,1518,1350,0
62377668688,62377668689,1,1460,1243,0
62379600351,62379600346,-5,2892,10733,0
62380005978,62380005976,-2,891,1363,0
62383056800,62383056802,2,1351,1020,0
62385058005,62385058005,0,1393,1483,0
62386848114,62386848113,-1,1113,1437,0
62388001431,62388001430,-1,1217,1762,0
62390368525,62390368525,0,1443,2238,0
62391239002,62391239003,1,1998,2257,0
62392190847,62392190847,0,1310,1715,0
62392221196,62392221198,2,1739,1714,0
62393028183,62393028182,-1,1603,1636,0
62396365269,62396365271,2,2041,1950,0
62398660119,62398660121,2,2023,2093,0
62401084358,62401084358,0,1310,2108,0
62403708230,62403708231,1,1421,1873,0
62412744174,62412744175,1,1744,2124,0
62415048997,62415048995,-2,1086,1959,0
62416281336,62416281334,-2,1703,2363,0
62416974941,62416974941,0,1575,1742,0
62417044250,62417044250,0,1258,2088,0
62417330974,62417330954,-20,1491,1263,0
62421115077,62421115078,1,1330,1810,0
62424738078,62424738077,-1,1359,2625,0
62430326302,62430326303,1,1463,1727,0
62432708135,62432708135,0,1277,1689,0
62444806955,62444806954,-1,1402,1485,0
62451709623,62451709624,1,715,1208,0
62453047438,62453047441,3,1608,1411,0
62456617462,62456617463,1,1209,1670,0
62457420547,62457420549,2,1792,1226,0
62457764106,62457764108,2,1716,1529,0
62460136854,62460136854,0,1220,1534,0
62460329397,62460329403,6,41727,20327,0
62462280106,62462280106,0,1276,2026,0
62462687163,62462687163,0,1313,1414,0
62464543057,62464543059,2,1271,1661,0
62465092298,62465092298,0,1484,1633,0
62470436670,62470436669,-1,1904,2539,0
62472463450,62472463455,5,1828,873,0
62473007420,62473007416,-4,2085,5353,0
62476902362,62476902363,1,1742,2049,0
62478979091,62478979094,3,1250,995,0
62479999312,62479999307,-5,1136,2184,0
62483736674,62483736675,1,1052,997,0
62483803748,62483803746,-2,794,1010,0
62484999474,62484999474,0,998,1832,0
62485250023,62485250024,1,1056,1739,0
62486664345,62486664345,0,1615,1419,0
62488600722,62488600723,1,881,2483,0
62490577985,62490577985,0,1231,1466,0
62490811622,62490811622,0,1055,1682,0
62495724461,62495724462,1,1493,2204,0
62500274435,62500274430,-5,1047,3600,0
62500817476,62500817456,-20,1072,2328,0
62505177206,62505177206,0,1840,1606,0
62505350669,62505350670,1,1283,1006,0
62505606211,62505606209,-2,1124,1377,0
62506127317,62506127318,1,1339,2170,0
62506165837,62506165822,-15,1235,1735,0
62508920141,62508920142,1,1599,1844,0
62509669025,62509669026,1,1592,2378,0
62510200495,62510200494,-1,1497,1612,0
62513266124,62513266130,6,2026,980,0
62518367554,62518367559,5,1060,1312,0
62519570662,62519570662,0,1288,1311,0
62520714066,62520714071,5,1151,1105,0
62524878491,62524878495,4,7705,16758,0
62527669288,62527669287,-1,1425,1805,0
62528659593,62528659591,-2,1100,1443,0
62534410331,62534410333,2,1189,1365,0
62539501303,62539501301,-2,1001,1412,0
62539708427,62539708426,-1,1462,1840,0
62541004910,62541004912,2,1298,1480,0
62542408621,62542408622,1,1363,1456,0
62545107113,62545107114,1,1447,1655,0
62546871930,62546871930,0,1233,1696,0
62548037148,62548037149,1,1088,1667,0
62548170815,62548170815,0,1007,1543,0
62549617454,62549617458,4,1028,872,0
62550426741,62550426743,2,1187,1384,0
62551240646,62551240648,2,1004,1765,0
62556268819,62556268819,0,1438,1798,0
62558256421,62558256422,1,1418,1622,0
62560547427,62560547429,2,2167,2143,0
62561746878,62561746879,1,1501,1732,0
62561917255,62561917256,1,2000,1906,0
62562048142,62562048146,4,2329,1422,0
62563744962,62563744962,0,1027,1462,0
62565405061,62565405064,3,1962,1324,0
62570670896,62570670897,1,1000,1285,0
62571130986,62571130985,-1,953,1647,0
62572021747,62572021749,2,999,1713,0
62579375342,62579375342,0,965,1449,0
62580973273,62580973275,2,1282,1864,0
62584668679,62584668678,-1,1156,1515,0
62585702478,62585702479,1,1532,1764,0
62586214125,62586214124,-1,1608,1658,0
62587050115,62587050117,2,1935,2394,0
62589961354,62589961355,1,1157,1916,0
62591955054,62591955054,0,1311,1428,0
62595531110,62595531110,0,1237,1446,0
62601073355,62601073365,10,14616,21757,0
62606917586,62606917591,5,4689,3428,0
62607098694,62607098693,-1,1193,2047,0
62608000381,62608000381,0,1301,1488,0
62610670951,62610670953,2,1451,1431,0
62611243844,62611243845,1,1509,1713,0
62611342159,62611342173,14,1151,852,0
62614641627,62614641628,1,1218,2109,0
62615397615,62615397614,-1,1772,1873,0
62618369963,62618369965,2,1381,1463,0
62618959077,62618959078,1,1106,1547,0
62619495934,62619495934,0,1792,1900,0
62620945640,62620945641,1,1845,2514,0
62627058841,62627058842,1,1440,1417,0
62627642590,62627642585,-5,2280,4733,0
62629862770,62629862769,-1,1405,1558,0
62630272909,62630272911,2,892,1295,0
62630733165,62630733166,1,1584,1537,0
62635319420,62635319413,-7,1741,10892,0
62636119317,62636119317,0,1807,1592,0
62637069431,62637069420,-11,54,969,0
62638040579,62638040579,0,939,1113,0
62639801570,62639801570,0,1484,1837,0
62640967682,62640967683,1,1783,2089,0
62642202646,62642202647,1,1286,1744,0
62643305569,62643305575,6,1877,1483,0
62643736754,62643736753,-1,1182,1962,0
62643897843,62643897846,3,1668,1375,0
62648950633,62648950636,3,1277,1951,0
62654099489,62654099487,-2,680,933,0
62654921334,62654921331,-3,1576,1936,0
62658260491,62658260492,1,1192,1068,0
62659192325,62659192325,0,1292,1924,0
62660406973,62660406968,-5,1650,3438,0
62665296946,62665296947,1,969,976,0
62666446376,62666446376,0,1617,1637,0
62668184250,62668184247,-3,1433,2455,0
62671502068,62671502068,0,1841,1798,0
62676732227,62676732229,2,1278,1403,0
62677872528,62677872528,0,1579,1778,0
62677994839,62677994838,-1,1164,1279,0
62680342544,62680342543,-1,1263,1618,0
62683521454,62683521453,-1,1408,2313,0
62685582466,62685582466,0,1052,1578,0
62686381082,62686381102,20,1629,1483,0
62686917984,62686917985,1,1231,1959,0
62689340959,62689340961,2,2092,2415,0
62689519526,62689519527,1,1388,1602,0
62690559426,62690559430,4,1328,1597,0
62691978510,62691978510,0,643,849,0
62693850294,62693850296,2,1219,1128,0
62697539001,62697539004,3,1522,1524,0
62708715279,62708715279,0,1499,65,0
62714806014,62714806014,0,743,1934,0
62716032031,62716032034,3,1985,1353,0
62719473188,62719473187,-1,1462,2252,0
62721114191,62721114192,1,1760,2159,0
62724704906,62724704907,1,1414,1793,0
62727093874,62727093869,-5,1174,3119,0
62737238831,62737238834,3,1453,1725,0
62738703287,62738703287,0,1068,1586,0
62738921059,62738921059,0,1413,2112,0
62740047775,62740047775,0,1744,2225,0
62741426986,62741426985,-1,1317,1683,0
62745181011,62745181012,1,926,1099,0
62751768303,62751768301,-2,1248,1774,0
62751921683,62751921684,1,1327,1801,0
62752715038,62752715039,1,1219,1251,0
62752921597,62752921598,1,1558,1735,0
62753362030,62753362031,1,1442,1515,0
62754321535,62754321534,-1,848,1566,0
62756670187,62756670185,-2,1049,2289,0
62758203931,62758203931,0,1463,1678,0
62760322368,62760322369,1,1436,1960,0
62762078189,62762078189,0,1175,1335,0
62763369885,62763369883,-2,701,2205,0
62763886817,62763886817,0,1223,1931,0
62765171078,62765171075,-3,1179,1278,0
62765199047,62765199053,6,1599,1118,0
62766010990,62766010991,1,900,2034,0
62766094685,62766094685,0,1326,1906,0
62767774153,62767774154,1,1603,1625,0
62768330691,62768330692,1,1497,1795,0
62768385546,62768385547,1,1781,1834,0
62771267437,62771267436,-1,965,1382,0
62771974133,62771974133,0,1125,1271,0
62772292562,62772292563,1,1695,1643,0
62772656957,62772656959,2,1883,1963,0
62772891350,62772891348,-2,1685,1520,0
62774247633,62774247612,-21,1124,1341,0
62774505353,62774505364,11,1472,1611,0
62777943334,62777943338,4,1566,1354,0
62778796383,62778796383,0,1110,1314,0
62781796545,62781796557,12,489,431,0
62782044554,62782044554,0,1172,1473,0
62783830966,62783830967,1,1743,1895,0
62784060509,62784060510,1,1432,1237,0
62786377314,62786377319,5,37674,24259,0
62786749011,62786749014,3,1304,1470,0
62789428179,62789428179,0,1176,1820,0
62792798223,62792798225,2,1400,1572,0
62797353822,62797353822,0,1262,1660,0
62797575366,62797575365,-1,1380,1555,0
62800787797,62800787797,0,1144,1073,0
62801944225,62801944221,-4,1634,5333,0
62806154224,62806154241,17,1248,1272,0
62809579289,62809579285,-4,723,3211,0
62812227409,62812227410,1,1296,2079,0
62812447601,62812447602,1,1292,1678,0
62812802291,62812802288,-3,46795,43889,0
62813915530,62813915531,1,1576,1673,0
62816065673,62816065674,1,1285,1636,0
62817032079,62817032061,-18,1396,2710,0
62817541591,62817541589,-2,1459,1988,0
62823279588,62823279588,0,1506,1764,0
62823906975,62823906952,-23,377,1987,0
62825440314,62825440319,5,2085,1072,0
62826413163,62826413162,-1,1350,2320,0
62827337890,62827337889,-1,1319,1921,0
62831215087,62831215089,2,1526,1781,0
62831611297,62831611297,0,1269,1845,0
62834065017,62834065018,1,1618,1881,0
62837469898,62837469901,3,947,1058,0
62840440126,62840440126,0,2701,4374,0
62842083439,62842083439,0,1449,1110,0
62843067961,62843067962,1,1279,1983,0
62844333242,62844333243,1,720,1323,0
62845255981,62845255979,-2,901,771,0
62847830139,62847830139,0,1248,1426,0
62848759390,62848759369,-21,1057,2290,0
62851812782,62851812782,0,1862,2261,0
62854213926,62854213927,1,1926,2436,0
62858960790,62858960792,2,1571,372,0
62860567940,62860567939,-1,1017,1816,0
62861651105,62861651106,1,1424,1361,0
62864477771,62864477773,2,998,1474,0
62867302022,62867302022,0,1413,1749,0
62870961257,62870961257,0,1331,1976,0
62878476065,62878476062,-3,1123,1442,0
62881828633,62881828631,-2,1111,2249,0
62887229430,62887229431,1,1926,1667,0
62890850802,62890850808,6,4457,1829,0
62892531535,62892531525,-10,1204,1085,0
62893880685,62893880684,-1,1290,1758,0
62894965170,62894965169,-1,1209,1353,0
62900258721,62900258721,0,1850,2623,0
62901181002,62901181002,0,1113,1769,0
62903052765,62903052764,-1,832,1373,0
62903659677,62903659677,0,1163,1437,0
62904815254,62904815254,0,1128,1909,0
62905409096,62905409094,-2,1639,1573,0
62905545196,62905545193,-3,1391,1451,0
62907986013,62907986014,1,1376,1861,0
62909337337,62909337338,1,1429,1321,0
62909713110,62909713112,2,1584,1637,0
62909974621,62909974622,1,797,1608,0
62911956407,62911956407,0,1188,1217,0
62912876777,62912876777,0,1375,1401,0
62913401194,62913401193,-1,1738,1617,0
62915633356,62915633357,1,1301,1954,0
62916421398,62916421397,-1,859,1412,0
62916976398,62916976397,-1,1190,2127,0
62917916427,62917916428,1,1498,2011,0
62919168202,62919168203,1,1851,1512,0
62929032091,62929032089,-2,1296,1505,0
62930871238,62930871258,20,1452,1687,0
62931404555,62931404554,-1,1380,2103,0
62932626218,62932626216,-2,1022,1802,0
62935245955,62935245954,-1,931,1715,0
62940059802,62940059802,0,1439,1410,0
62944141240,62944141242,2,1139,1371,0
62945567590,62945567593,3,1098,1425,0
62946184979,62946184978,-1,1382,1476,0
62946712210,62946712208,-2,1122,1874,0
62949177319,62949177318,-1,1034,1482,0
62949434104,62949434106,2,1709,1563,0
62951102652,62951102651,-1,1084,1521,0
62951876315,62951876319,4,2046,1636,0
62954838442,62954838443,1,1691,2226,0
62960520879,62960520878,-1,1655,1583,0
62962898323,62962898322,-1,1751,2191,0
62964354243,62964354245,2,870,1101,0
62964542066,62964542047,-19,1224,1216,0
62966434090,62966434091,1,1311,1608,0
62972949527,62972949526,-1,1152,1445,0
62973327012,62973327013,1,1364,1612,0
62973366504,62973366512,8,5291,1497,0
62975395901,62975395899,-2,1085,1837,0
62976967861,62976967866,5,2696,957,0
62977232947,62977232947,0,1235,1727,0
62980624926,62980624925,-1,1355,2019,0
62987505171,62987505172,1,1128,2072,0
62989677622,62989677622,0,1429,1609,0
62989901397,62989901396,-1,932,1111,0
62996308936,62996308936,0,1586,1833,0
62998595061,62998595061,0,1634,1884,0
62999139239,62999139239,0,1342,1355,0
63000073863,63000073865,2,1761,1595,0
63006100303,63006100299,-4,20430,15039,0
63006942338,63006942337,-1,1177,2491,0
63008016684,63008016685,1,1629,1816,0
63010393437,63010393442,5,3413,1949,0
63013552968,63013552967,-1,709,1101,0
63015287178,63015287181,3,1378,1852,0
63017835441,63017835437,-4,946,1570,0
63018811731,63018811729,-2,1852,1819,0
63018987790,63018987792,2,1797,1697,0
63020443117,63020443120,3,1621,1642,0
63021704112,63021704113,1,1750,2222,0
63023678156,63023678151,-5,1193,1773,0
63024805568,63024805565,-3,1467,1318,0
63026098287,63026098294,7,2037,664,0
63028630158,63028630158,0,1592,1816,0
63029944850,63029944855,5,2648,1438,0
63031433978,63031433978,0,1589,1207,0
63034284887,63034284887,0,1130,1756,0
63036377616,63036377617,1,1391,1469,0
63037185429,63037185431,2,1059,1297,0
63037662438,63037662433,-5,17592,62457,0
63039065430,63039065431,1,1131,1310,0
63039836483,63039836482,-1,1344,1414,0
63042959469,63042959469,0,812,795,0
63043863331,63043863330,-1,1516,1694,0
63043919486,63043919483,-3,1142,1880,0
63044376931,63044376933,2,904,1765,0
63046002882,63046002883,1,1114,1394,0
63048513650,63048513650,0,1990,1705,0
63051098133,63051098130,-3,1096,2167,0
63055365831,63055365831,0,1729,2100,0
63056356046,63056356048,2,1489,1315,0
63057775254,63057775257,3,1558,1028,0
63059968203,63059968202,-1,1087,1119,0
63060888111,63060888112,1,1847,1719,0
63061187896,63061187898,2,1422,1275,0
63061853800,63061853799,-1,868,1204,0
63064996413,63064996414,1,1693,2347,0
63073215447,63073215449,2,1366,2125,0
63076660194,63076660194,0,1752,1726,0
63077557880,63077557882,2,1319,1299,0
63078707145,63078707146,1,912,1860,0
63079255039,63079255039,0,1209,1702,0
63079354080,63079354081,1,1296,1880,0
63082807354,63082807354,0,1207,2150,0
63084475364,63084475363,-1,1728,2598,0
63086371342,63086371342,0,1244,1652,0
63087880074,63087880068,-6,1128,3443,0
63090274653,63090274656,3,1648,2324,0
63090826174,63090826178,4,4796,3375,0
63092848276,63092848278,2,1398,1874,0
63095411077,63095411075,-2,1463,2047,0
63095873298,63095873298,0,1094,1554,0
63097458101,63097458102,1,1715,1815,0
63098377554,63098377549,-5,1704,6849,0
63100835174,63100835173,-1,1717,2312,0
63105539277,63105539277,0,1291,2346,0
63106402554,63106402555,1,1498,1630,0
63114956142,63114956121,-21,1225,1482,0
63118238743,63118238743,0,1231,1955,0
63119031978,63119031977,-1,1163,1522,0
63121342603,63121342604,1,1280,1516,0
63121454984,63121454999,15,1247,1359,0
63124494197,63124494203,6,1063,1155,0
63124796814,63124796811,-3,861,1297,0
63125087284,63125087271,-13,1056,1360,0
63125309455,63125309453,-2,600,1716,0
63126963299,63126963298,-1,1291,1411,0
63127142751,63127142752,1,1014,2176,0
63127853190,63127853190,0,1379,2403,0
63129302123,63129302122,-1,1855,1970,0
63129862875,63129862875,0,2120,1581,0
63131181582,63131181583,1,990,1297,0
63132974245,63132974246,1,1466,1426,0
63135991166,63135991168,2,1407,1717,0
63137124509,63137124510,1,1291,1621,0
63142994435,63142994433,-2,1311,1450,0
63144983328,63144983329,1,1816,2208,0
63145726820,63145726843,23,1432,1514,0
63146419162,63146419155,-7,2200,9243,0
63146634694,63146634694,0,1664,1679,0
63149408301,63149408301,0,1635,2139,0
63151013734,63151013735,1,827,1194,0
63153509878,63153509877,-1,1040,1975,0
63153970769,63153970770,1,1581,1939,0
63156441028,63156441026,-2,1366,2042,0
63158443430,63158443429,-1,1310,1846,0
63158621669,63158621669,0,2911,3451,0
63161922394,63161922395,1,818,1302,0
63166773470,63166773470,0,1010,1373,0
63167965233,63167965234,1,1480,1675,0
63171053081,63171053082,1,1119,1336,0
63176095233,63176095235,2,1413,1265,0
63176162742,63176162739,-3,687,1271,0
63177937773,63177937777,4,2513,1912,0
63181318850,63181318852,2,1480,1883,0
63184186674,63184186674,0,1445,1299,0
63187445687,63187445686,-1,726,1439,0
63188086041,63188086046,5,3541,1635,0
63190200331,63190200330,-1,1395,1219,0
63192501242,63192501242,0,1182,1765,0
63194536273,63194536279,6,3505,1089,0
63197465015,63197465018,3,1221,1712,0
63200174699,63200174702,3,1656,1749,0
63200338331,63200338334,3,2138,1682,0
63202531673,63202531677,4,4604,3018,0
63204142410,63204142408,-2,1254,1591,0
63204795762,63204795762,0,1879,2576,0
63205129716,63205129717,1,1377,1173,0
63209724309,63209724308,-1,1043,1415,0
63214698211,63214698214,3,1472,1642,0
63216149069,63216149057,-12,1005,2364,0
63216253110,63216253114,4,8532,5448,0
63217273685,63217273683,-2,1223,883,0
63218325110,63218325111,1,1423,1719,0
63220060723,63220060723,0,1560,1740,0
63222901355,63222901354,-1,1886,2470,0
63223951730,63223951730,0,1206,1826,0
63227101830,63227101825,-5,2269,6837,0
63227456034,63227456031,-3,1199,2667,0
63228267706,63228267706,0,1842,1528,0
63228440698,63228440706,8,2898,905,0
63231078781,63231078782,1,1363,1166,0
63236422449,63236422451,2,1675,1532,0
63236738573,63236738593,20,815,3119,0
63238482450,63238482446,-4,848,904,0
63240773329,63240773329,0,1125,2211,0
63243922964,63243922963,-1,1467,2366,0
63244306814,63244306807,-7,1005,5034,0
63245387713,63245387713,0,1162,1627,0
63246597781,63246597779,-2,1050,1658,0
63249893218,63249893219,1,1300,1176,0
63252075964,63252075962,-2,1641,2305,0
63252431594,63252431604,10,16490,27333,0
63254736138,63254736138,0,985,1945,0
63258422401,63258422399,-2,1050,1481,0
63261595440,63261595441,1,1134,1429,0
63262253932,63262253933,1,1388,1719,0
63267814104,63267814106,2,1301,1410,0
63273032641,63273032639,-2,1931,1735,0
63276132974,63276132968,-6,830,183,0
63279320755,63279320755,0,1866,2265,0
63280671343,63280671342,-1,1365,2580,0
63280998042,63280998042,0,1118,1671,0
63282007638,63282007639,1,1400,2129,0
63282193340,63282193346,6,2584,1193,0
63282304169,63282304169,0,1195,1374,0
63286908462,63286908462,0,779,1120,0
63288552167,63288552164,-3,1498,2849,0
63292414498,63292414498,0,1543,1433,0
63293095507,63293095498,-9,25516,14647,0
63296191570,63296191565,-5,1284,4213,0
63296517249,63296517250,1,1880,1733,0
63297170529,63297170529,0,1861,2196,0
63303696923,63303696918,-5,1118,4265,0
63305589917,63305589902,-15,1023,1533,0
63305987572,63305987557,-15,1294,1790,0
63308793570,63308793570,0,1520,1672,0
63310144874,63310144874,0,1398,1684,0
63310696623,63310696624,1,1046,1791,0
63310879927,63310879927,0,1443,1498,0
63314197635,63314197636,1,1361,1796,0
63314563361,63314563360,-1,1041,2182,0
63315518302,63315518307,5,3155,1540,0
63315813085,63315813086,1,1738,2298,0
63316102801,63316102798,-3,1364,2327,0
63320999246,63320999247,1,1769,1643,0
63322458216,63322458216,0,1918,2284,0
63322785525,63322785523,-2,971,1515,0
63322880253,63322880247,-6,1097,1381,0
63324604354,63324604356,2,1525,1892,0
63326359153,63326359154,1,1330,1680,0
63326523727,63326523728,1,1354,2307,0
63327777694,63327777693,-1,894,1634,0
63337772034,63337772034,0,1296,1674,0
63340570287,63340570291,4,1452,1452,0
63341040183,63341040182,-1,1694,2232,0
63345201933,63345201932,-1,1775,1773,0
63355799029,63355799012,-17,1385,718,0
63356159147,63356159149,2,1502,1634,0
63356929021,63356929021,0,1257,1274,0
63357744267,63357744265,-2,1536,1842,0
63359091620,63359091618,-2,1445,2730,0
63359693855,63359693857,2,1178,1485,0
63364281429,63364281408,-21,1392,2036,0
63364973913,63364973917,4,1763,1034,0
63366699043,63366699043,0,1201,1407,0
63369539009,63369539010,1,1314,1286,0
63370387623,63370387602,-21,1730,1615,0
63371835637,63371835637,0,1775,1712,0
63372837345,63372837344,-1,950,1381,0
63375013834,63375013834,0,1174,1377,0
63375328938,63375328939,1,859,1527,0
63376388842,63376388843,1,1698,1349,0
63382267382,63382267382,0,799,1337,0
63383772587,63383772589,2,1954,1521,0
63384444117,63384444119,2,965,1442,0
63384493766,63384493767,1,1207,2177,0
63384877634,63384877634,0,1496,1456,0
63386018745,63386018744,-1,1255,1635,0
63388885507,63388885509,2,1192,1599,0
63389317623,63389317624,1,1620,1653,0
63390489062,63390489063,1,1267,1688,0
63391563650,63391563651,1,904,1673,0
63394456208,63394456206,-2,883,1401,0
63399013899,63399013899,0,1613,1887,0
63399393798,63399393798,0,1194,1488,0
63401927207,63401927210,3,1504,2113,0
63406785653,63406785654,1,1772,1388,0
63414898381,63414898401,20,1112,1477,0
63415533110,63415533110,0,1458,1866,0
63417624320,63417624321,1,1678,2074,0
63419875367,63419875370,3,1919,2151,0
63420134412,63420134412,0,2056,1984,0
63421180205,63421180199,-6,2307,7976,0
63421706802,63421706809,7,5490,2899,0
63425303318,63425303318,0,1269,1154,0
63426449078,63426449078,0,1421,1922,0
63427767051,63427767053,2,1738,2700,0
63436141674,63436141675,1,1230,1625,0
63439554621,63439554622,1,1526,2018,0
63442606680,63442606681,1,1424,1970,0
63444202933,63444202935,2,1067,2039,0
63445545906,63445545906,0,1348,1585,0
63447473632,63447473630,-2,937,1866,0
63449572823,63449572822,-1,1371,1567,0
63449652307,63449652309,2,741,1196,0
63452496015,63452496014,-1,1661,1954,0
63455063611,63455063612,1,1699,1566,0
63456173162,63456173163,1,1712,1315,0
63456386630,63456386632,2,1987,2435,0
63457067859,63457067852,-7,768,3220,0
63464572737,63464572738,1,1138,1595,0
63465652906,63465652905,-1,1243,1548,0
63467023884,63467023877,-7,1126,1641,0
63469203337,63469203340,3,1020,1324,0
63475020661,63475020658,-3,1253,1841,0
63475134740,63475134741,1,637,508,0
63475541166,63475541166,0,2149,2064,0
63476166165,63476166164,-1,1108,1831,0
63477225244,63477225243,-1,1200,1903,0
63477929014,63477929016,2,1296,1461,0
63486932934,63486932934,0,744,1748,0
63489122507,63489122507,0,1249,1721,0
63489955749,63489955749,0,2138,2599,0
63490554446,63490554451,5,1220,1532,0
63491036538,63491036538,0,1428,2218,0
63492927979,63492927977,-2,1048,1147,0
63493615025,63493615025,0,1325,1403,0
63496669730,63496669729,-1,1498,1593,0
63501371984,63501371985,1,1874,2502,0
63502120748,63502120750,2,1059,1139,0
63505890631,63505890633,2,1437,1699,0
63506981578,63506981579,1,1584,1670,0
63507907876,63507907875,-1,1612,1812,0
63508645185,63508645186,1,1288,1698,0
63510125209,63510125209,0,1450,1755,0
63510884600,63510884598,-2,1816,2148,0
63512612648,63512612649,1,1445,1945,0
63513679389,63513679411,22,1531,1502,0
63514393413,63514393411,-2,1805,1377,0
63516475665,63516475667,2,942,955,0
63517644973,63517644974,1,1196,1771,0
63524021525,63524021524,-1,1157,1316,0
63524724329,63524724332,3,945,1631,0
63526694292,63526694297,5,2573,2474,0
63527759276,63527759278,2,1644,1997,0
63529538955,63529538957,2,1415,1327,0
63530630594,63530630594,0,1289,1550,0
63534525279,63534525277,-2,1552,1728,0
63535847475,63535847475,0,1349,1192,0
63539731762,63539731764,2,1027,1530,0
63540340624,63540340643,19,1134,2283,0
63540564158,63540564159,1,1407,1561,0
63543168582,63543168582,0,2182,1789,0
63546507622,63546507624,2,1538,1382,0
63552027125,63552027125,0,1452,1879,0
63556281155,63556281154,-1,969,1574,0
63556792786,63556792786,0,1185,2035,0
63558619365,63558619362,-3,1243,3360,0
63558672231,63558672233,2,1173,1342,0
63560136074,63560136075,1,1567,1413,0
63570490501,63570490502,1,1694,2061,0
63570753427,63570753428,1,1617,1637,0
63571543407,63571543406,-1,1885,2229,0
63571798526,63571798527,1,1326,1720,0
63575098929,63575098928,-1,24111,21859,0
63575412704,63575412705,1,1041,1335,0
63579535557,63579535559,2,947,1468,0
63579578751,63579578752,1,1406,1864,0
63579669215,63579669222,7,5736,2016,0
63582032571,63582032570,-1,1301,1630,0
63582246486,63582246487,1,1602,1866,0
63584271416,63584271412,-4,1882,2035,0
63586332218,63586332218,0,1092,2048,0
63586795331,63586795333,2,1385,1753,0
63587262452,63587262455,3,1687,1876,0
63588803849,63588803849,0,1299,1192,0
63592161748,63592161749,1,1024,1406,0
63593139654,63593139654,0,1750,1517,0
63593361501,63593361498,-3,45526,18270,0
63596300406,63596300409,3,1526,1747,0
63596325506,63596325507,1,1717,1745,0
63596684482,63596684483,1,1583,1960,0
63597195377,63597195379,2,1394,1758,0
63597988270,63597988271,1,1922,1993,0
63598262306,63598262307,1,1200,1987,0
63598551543,63598551544,1,1260,1737,0
63601527270,63601527268,-2,1565,2107,0
63602120890,63602120893,3,1409,1182,0
63602910319,63602910320,1,942,1448,0
63603613134,63603613134,0,783,1271,0
63604442437,63604442439,2,1375,1394,0
63609593993,63609593993,0,1549,2069,0
63610682093,63610682090,-3,1023,996,0
63612205186,63612205193,7,1507,2121,0
63618633361,63618633361,0,1627,2132,0
63620347337,63620347341,4,1568,1842,0
63621685665,63621685665,0,2673,4210,0
63622283003,63622283006,3,1280,1632,0
63625887211,63625887208,-3,23431,17662,0
63626420450,63626420451,1,1330,1967,0
63626769970,63626769970,0,1716,1477,0
63634347114,63634347115,1,1183,2156,0
63634979909,63634979909,0,1443,1192,0
63636961469,63636961472,3,1090,948,0
63638099681,63638099681,0,1810,2048,0
63639414856,63639414856,0,1421,1881,0
63641053202,63641053204,2,1652,1334,0
63641418436,63641418434,-2,1075,1689,0
63643471425,63643471425,0,2014,1821,0
63644622289,63644622286,-3,25364,68173,0
63647962259,63647962259,0,1087,1583,0
63649279698,63649279698,0,1758,1801,0
63652221441,63652221442,1,1290,2038,0
63653324275,63653324273,-2,1530,1645,0
63654885118,63654885118,0,1403,1648,0
63662669093,63662669093,0,1583,2090,0
63665802079,63665802080,1,1052,1176,0
63671082661,63671082661,0,1198,1761,0
63673666954,63673666955,1,1193,1466,0
63675349455,63675349454,-1,1229,1663,0
63675473478,63675473481,3,1286,1800,0
63677099761,63677099766,5,1908,1433,0
63677900468,63677900468,0,1694,2485,0
63678035581,63678035583,2,1537,1453,0
63678289380,63678289367,-13,1451,1528,0
63679920940,63679920941,1,1560,2029,0
63680445314,63680445314,0,1133,941,0
63681627987,63681627986,-1,1405,1968,0
63684222183,63684222184,1,1234,1344,0
63688026978,63688026984,6,2730,1745,0
63692392425,63692392424,-1,1353,1872,0
63693599410,63693599412,2,1155,1732,0
63698248347,63698248346,-1,1314,1773,0
63698704751,63698704751,0,1122,1914,0
63699267433,63699267434,1,1268,1670,0
63699692049,63699692052,3,2346,2289,0
63700167330,63700167330,0,920,880,0
63702063584,63702063583,-1,1790,1804,0
63702343383,63702343385,2,1364,1864,0
63702704371,63702704371,0,1012,1173,0
63703694650,63703694650,0,866,1149,0
63707133841,63707133842,1,1271,1586,0
63712956020,63712956013,-7,35854,15531,0
63714148146,63714148150,4,1000,1184,0
63719461769,63719461768,-1,1443,2093,0
63719921474,63719921481,7,1809,910,0
63722453363,63722453364,1,1498,1590,0
63726883341,63726883341,0,1460,1724,0
63728534226,63728534227,1,1136,1023,0
63728754372,63728754370,-2,927,3407,0
63729401538,63729401538,0,1211,1626,0
63734586887,63734586887,0,1639,2533,0
63735071695,63735071695,0,786,1045,0
63737090086,63737090085,-1,972,1593,0
63737314135,63737314133,-2,984,1903,0
63743636063,63743636064,1,856,1429,0
63744730284,63744730284,0,1390,1427,0
63745908095,63745908096,1,1425,1340,0
63746444205,63746444206,1,1075,1381,0
63750974070,63750974069,-1,1518,2306,0
63753418945,63753418946,1,1758,1700,0
63754716175,63754716181,6,1037,1642,0
63755159804,63755159805,1,2028,1576,0
63758490091,63758490089,-2,1434,1742,0
63758734371,63758734373,2,1253,2041,0
63763203767,63763203771,4,1338,2139,0
63767256241,63767256241,0,1288,1569,0
63770108881,63770108880,-1,1473,1795,0
63772319116,63772319116,0,1234,2291,0
63782060204,63782060207,3,961,1228,0
63784237516,63784237524,8,16594,22467,0
63784629433,63784629434,1,1036,1073,0
63788906368,63788906368,0,1635,1434,0
63791678163,63791678166,3,1521,1827,0
63792071324,63792071325,1,883,942,0
63792903977,63792903982,5,1499,1135,0
63795908890,63795908892,2,1545,1810,0
63798806376,63798806373,-3,51,420,0
63803336223,63803336223,0,1384,1007,0
63804459282,63804459290,8,3223,1051,0
63807279947,63807279947,0,1017,1284,0
63808345503,63808345508,5,7444,32316,0
63811073499,63811073499,0,1421,1675,0
63811279582,63811279585,3,1132,1268,0
63813286366,63813286365,-1,935,1218,0
63814817907,63814817907,0,1331,1755,0
63815289041,63815289042,1,1912,2510,0
63815569678,63815569679,1,1546,1616,0
63816554747,63816554747,0,1928,1774,0
63818826125,63818826126,1,845,796,0
63826746428,63826746446,18,1644,3425,0
63829380484,63829380481,-3,1246,16564,0
63831003631,63831003608,-23,1355,1794,0
63834483679,63834483679,0,1059,1901,0
63840956423,63840956424,1,1286,1238,0
63846271014,63846271017,3,1955,1637,0
63846984211,63846984211,0,1310,1375,0
63849489838,63849489839,1,1229,1112,0
63850663377,63850663378,1,1933,1867,0
63854060451,63854060451,0,1057,1877,0
63854901143,63854901143,0,1950,1640,0
63856715927,63856715926,-1,1214,1643,0
63857643126,63857643127,1,1149,1308,0
63858306170,63858306172,2,1630,2134,0
63862503230,63862503230,0,996,1899,0
63867000089,63867000088,-1,1288,1818,0
63867500378,63867500374,-4,861,3209,0
63868211304,63868211304,0,1435,2344,0
63869852627,63869852627,0,1489,1885,0
63873323594,63873323596,2,1850,1890,0
63873865554,63873865554,0,1934,1563,0
63874844876,63874844874,-2,1133,1411,0
63876818628,63876818630,2,1485,1673,0
63880110218,63880110217,-1,2026,2405,0
63882970919,63882970920,1,1831,1453,0
63884756950,63884756948,-2,1191,2293,0
63886391029,63886391030,1,1234,1713,0
63888372807,63888372810,3,1574,1594,0
63890139634,63890139634,0,1253,1609,0
63892588428,63892588429,1,1295,1747,0
63893912826,63893912827,1,878,1073,0
63893992869,63893992870,1,1221,1539,0
63895809975,63895809978,3,1813,1574,0
63896779042,63896779043,1,1142,2181,0
63896873241,63896873242,1,1613,1494,0
63899199578,63899199578,0,1076,1518,0
63901484949,63901484945,-4,2369,6379,0
63901665218,63901665218,0,993,1173,0
63904523957,63904523957,0,1219,1641,0
63904701265,63904701262,-3,991,3150,0
63907123886,63907123886,0,1470,2254,0
63908948078,63908948078,0,1057,1681,0
63913947241,63913947242,1,2161,1552,0
63916660646,63916660645,-1,1452,1860,0
63918269194,63918269197,3,940,1128,0
63920070003,63920070003,0,1556,1620,0
63923051206,63923051203,-3,2089,6644,0
63923231793,63923231793,0,1631,1708,0
63924015390,63924015388,-2,1703,2152,0
63924645957,63924645957,0,2029,1948,0
63926546618,63926546618,0,1160,1495,0
63928039159,63928039158,-1,646,1108,0
63929252602,63929252604,2,1201,1270,0
63930292451,63930292452,1,1610,1788,0
63931654636,63931654635,-1,1879,985,0
63932701850,63932701849,-1,1078,1718,0
63934655447,63934655447,0,1260,1583,0
63935757129,63935757130,1,1034,1251,0
63938016503,63938016504,1,1968,1953,0
63939778117,63939778116,-1,1645,1257,0
63943017181,63943017182,1,1561,1285,0
63944270398,63944270396,-2,10139,18018,0
63944863550,63944863549,-1,2249,2607,0
63945364310,63945364310,0,1074,1458,0
63945860135,63945860134,-1,1278,1215,0
63947400470,63947400470,0,1329,1716,0
63947587974,63947587975,1,1795,1826,0
63948118711,63948118714,3,1281,2126,0
63948448150,63948448151,1,1536,2091,0
63948921264,63948921263,-1,1783,2206,0
63952664167,63952664169,2,1196,1447,0
63953524922,63953524923,1,1776,1281,0
63954037483,63954037483,0,1551,1652,0
63954148189,63954148190,1,2114,1216,0
63954200794,63954200794,0,43819,32937,0
63954270083,63954270083,0,1030,2033,0
63954623929,63954623927,-2,1580,1810,0
63962412267,63962412269,2,1733,1869,0
63962544471,63962544470,-1,1290,1730,0
63962847979,63962847979,0,1830,2157,0
63970062579,63970062582,3,1453,1372,0
63973761665,63973761666,1,1895,2748,0
63977830570,63977830570,0,1623,1456,0
63980351389,63980351394,5,1886,916,0
63984105436,63984105437,1,1740,1823,0
63987734903,63987734904,1,1661,1967,0
63992170828,63992170826,-2,1287,1666,0
63994964050,63994964032,-18,1766,1749,0
64000172504,64000172502,-2,1609,2092,0
64001676742,64001676743,1,1599,1869,0
64004601570,64004601569,-1,1293,1551,0
64006055630,64006055629,-1,1807,1981,0
64009894166,64009894166,0,1836,2201,0
64017876910,64017876909,-1,1308,1693,0
64018398283,64018398283,0,1075,858,0
64018826734,64018826735,1,1350,1935,0
64021805714,64021805713,-1,1630,2185,0
64021866475,64021866475,0,1329,1776,0
64022079813,64022079812,-1,891,1384,0
64026723918,64026723918,0,2350,2410,0
64028023724,64028023727,3,1664,1581,0
64029252454,64029252454,0,1262,1564,0
64030451801,64030451802,1,1152,1602,0
64031645930,64031645930,0,1498,1833,0
64033860156,64033860156,0,978,990,0
64037776611,64037776609,-2,1696,2131,0
64038376270,64038376270,0,1439,1834,0
64039986605,64039986611,6,591,851,0
64040019909,64040019909,0,1919,1973,0
64044870989,64044870990,1,1743,1272,0
64046174212,64046174215,3,2156,799,0
64047251623,64047251622,-1,2076,2170,0
64049293295,64049293294,-1,1055,1363,0
64053236374,64053236375,1,979,1239,0
64062160826,64062160829,3,1212,2067,0
64064082127,64064082131,4,2249,1490,0
64066098708,64066098706,-2,1341,2163,0
64066373182,64066373184,2,1311,1612,0
64067465211,64067465208,-3,1277,2217,0
64071787914,64071787913,-1,1440,1754,0
64072231303,64072231303,0,976,1664,0
64074526191,64074526191,0,1401,1174,0
64074683434,64074683433,-1,1470,2906,0
64078933517,64078933509,-8,1213,5980,0
64080892499,64080892498,-1,1061,1330,0
64083029667,64083029668,1,1081,1848,0
64085567987,64085567989,2,1676,2325,0
64086149866,64086149865,-1,1209,1871,0
64089424255,64089424256,1,1164,1816,0
64090101989,64090101986,-3,1330,1942,0
64092507235,64092507235,0,917,1093,0
64093917018,64093917018,0,2042,2283,0
64095405195,64095405194,-1,1358,1920,0
64096742605,64096742606,1,1521,1529,0
64099472782,64099472782,0,1002,1581,0
64101424012,64101424014,2,1414,1582,0
64102102003,64102102002,-1,1309,1679,0
64106108197,64106108198,1,2322,2957,0
64106219899,64106219899,0,1614,1721,0
64109598651,64109598653,2,1170,1491,0
64113041399,64113041399,0,1283,981,0
64115440454,64115440453,-1,1121,1094,0
64116434052,64116434055,3,1434,1269,0
64117406703,64117406705,2,1584,2081,0
64117492622,64117492623,1,1680,1404,0
64125428788,64125428789,1,1263,1217,0
64125743047,64125743046,-1,1178,1429,0
64126778774,64126778774,0,1454,1991,0
64127013793,64127013802,9,1077,1303,0
64128061430,64128061431,1,1740,1981,0
64129907386,64129907387,1,692,1218,0
64130791779,64130791778,-1,1431,2100,0
64130918447,64130918447,0,1037,1598,0
64132672788,64132672787,-1,612,1480,0
64136207842,64136207841,-1,1633,1594,0
64136531233,64136531233,0,1232,1374,0
64138448342,64138448345,3,2959,3457,0
64138684811,64138684805,-6,1174,4633,0
64139547741,64139547750,9,2735,980,0
64140019661,64140019666,5,954,1164,0
64143299809,64143299811,2,526,978,0
64143658322,64143658322,0,1300,1920,0
64145832501,64145832503,2,1500,1661,0
64147632445,64147632450,5,5620,2679,0
64148588391,64148588391,0,1263,1678,0
64151533548,64151533542,-6,1047,3164,0
64151768107,64151768107,0,1478,1268,0
64152237075,64152237077,2,1323,1688,0
64153094995,64153094996,1,1464,2153,0
64155092459,64155092460,1,1910,1883,0
64155271158,64155271159,1,2261,2096,0
64160085410,64160085409,-1,1444,1812,0
64160479380,64160479380,0,897,1539,0
64161950680,64161950681,1,909,1791,0
64162012598,64162012601,3,2333,2124,0
64162107194,64162107195,1,1437,1948,0
64164248245,64164248245,0,1725,2021,0
64166126730,64166126731,1,10362,12729,0
64166710385,64166710385,0,1220,1725,0
64166987581,64166987583,2,1560,1356,0
64172875797,64172875798,1,1731,1886,0
64174008063,64174008065,2,1112,1729,0
64174510175,64174510175,0,1334,2142,0
64175724870,64175724869,-1,1632,1734,0
64175888204,64175888203,-1,1465,1661,0
64176286913,64176286913,0,1129,1916,0
64177368094,64177368095,1,1108,2311,0
64177560489,64177560502,13,10830,42456,0
64178982393,64178982390,-3,998,1233,0
64180439346,64180439346,0,1223,1528,0
64183099535,64183099535,0,1587,2154,0
64189221902,64189221902,0,1385,1788,0
64189660357,64189660357,0,1827,1669,0
64190586377,64190586378,1,1018,1447,0
64197615595,64197615595,0,1175,1571,0
64198535978,64198535978,0,1290,2061,0
64200588166,64200588167,1,1013,1601,0
64200750890,64200750889,-1,1367,1902,0
64204861821,64204861822,1,1487,1569,0
64205175254,64205175254,0,1251,2192,0
64205537477,64205537477,0,1689,1713,0
64206427361,64206427359,-2,3186,3289,0
64211316277,64211316276,-1,24444,27760,0
64211536987,64211536987,0,1381,1315,0
64214318789,64214318783,-6,2400,8649,0
64218276126,64218276127,1,1445,1529,0
64219987685,64219987685,0,1055,1344,0
64222645772,64222645771,-1,1021,1089,0
64225360773,64225360772,-1,1011,1675,0
64226383487,64226383487,0,1607,1534,0
64227076417,64227076419,2,1144,1370,0
64227261251,64227261255,4,1030,1012,0
64228833027,64228833027,0,1458,1784,0
64231680587,64231680588,1,1520,1782,0
64234162296,64234162298,2,1684,1514,0
64236976125,64236976125,0,1451,1526,0
64241206193,64241206194,1,1744,1569,0
64241357033,64241357033,0,1490,1454,0
64241825022,64241825021,-1,1303,1839,0
64242675275,64242675276,1,1405,1576,0
64247899205,64247899209,4,2396,1618,0
64250034237,64250034240,3,1745,2337,0
64251355782,64251355782,0,1524,1337,0
64253462597,64253462597,0,1213,1347,0
64256238414,64256238422,8,7161,38823,0
64257646378,64257646381,3,1170,1544,0
64257727862,64257727853,-9,1176,1164,0
64258900815,64258900817,2,1236,1996,0
64259450981,64259450983,2,1157,1126,0
64260150347,64260150346,-1,2300,1904,0
64262720367,64262720370,3,1079,1051,0
64264272658,64264272660,2,2018,2358,0
64264820438,64264820439,1,1452,1804,0
64267145875,64267145877,2,1332,1451,0
64270248417,64270248417,0,1458,2158,0
64271429834,64271429835,1,1183,1841,0
64278281484,64278281482,-2,1644,2850,0
64278777270,64278777270,0,977,1412,0
64283604101,64283604102,1,1234,2073,0
64284189872,64284189860,-12,1127,1625,0
64293004123,64293004122,-1,1313,2016,0
64293776940,64293776941,1,1579,1636,0
64296287058,64296287066,8,9623,29968,0
64298052122,64298052122,0,1140,1808,0
64298442016,64298442015,-1,1506,1454,0
64299308109,64299308110,1,1165,1810,0
64301228310,64301228309,-1,1267,1488,0
64301423549,64301423549,0,1479,1428,0
64306571247,64306571247,0,928,1291,0
64307718373,64307718374,1,1351,1917,0
64308472421,64308472421,0,1486,1621,0
64308693860,64308693842,-18,223,1863,0
64310961667,64310961670,3,1563,1979,0
64311686427,64311686427,0,1376,1831,0
64315420406,64315420427,21,341,314,0
64317946114,64317946114,0,2149,2018,0
64319233913,64319233912,-1,1763,1640,0
64319396803,64319396804,1,1670,2301,0
64320076861,64320076862,1,1685,1988,0
64320235590,64320235589,-1,1144,1802,0
64321217555,64321217555,0,1160,1569,0
64321565716,64321565699,-17,1347,1701,0
64322351884,64322351886,2,1787,1643,0
64323053253,64323053259,6,1249,751,0
64323782818,64323782819,1,1635,1419,0
64324916744,64324916746,2,4740,5157,0
64326088287,64326088289,2,1687,2162,0
64326811761,64326811761,0,1512,1491,0
64327140074,64327140056,-18,391,511,0
64328616664,64328616666,2,1691,1220,0
64333206535,64333206535,0,1098,1554,0
64334619247,64334619267,20,1090,1057,0
64335611313,64335611313,0,1486,2220,0
64336311774,64336311774,0,1036,1085,0
64337914490,64337914490,0,1292,2489,0
64338817821,64338817823,2,1516,1536,0
64341117790,64341117788,-2,1016,1557,0
64344433798,64344433797,-1,1133,1257,0
64344514323,64344514319,-4,1446,3805,0
64345002253,64345002253,0,2114,2201,0
64345652643,64345652623,-20,1112,1288,0
64348768530,64348768530,0,1201,1393,0
64349652133,64349652141,8,10246,43482,0
64351643167,64351643167,0,1355,1465,0
64354813369,64354813369,0,1281,2110,0
64355552327,64355552327,0,1304,1726,0
64355699852,64355699854,2,1666,1467,0
64355829650,64355829647,-3,1429,1429,0
64356070044,64356070042,-2,1139,2284,0
64356115390,64356115393,3,721,937,0
64356607386,64356607383,-3,2619,2989,0
64357577634,64357577634,0,1168,2622,0
64357666412,64357666413,1,1211,1998,0
64357722530,64357722527,-3,1426,1703,0
64359326230,64359326230,0,1558,2792,0
64359502750,64359502754,4,1432,1392,0
64361344922,64361344925,3,1122,876,0
64362716264,64362716265,1,1751,2281,0
64363102884,64363102884,0,1663,1832,0
64364079996,64364079996,0,1600,1796,0
64365116725,64365116730,5,1876,1363,0
64367766866,64367766867,1,1590,1200,0
64369519323,64369519325,2,1340,1330,0
64373288657,64373288654,-3,1794,4251,0
64373983126,64373983125,-1,1601,1576,0
64376417734,64376417737,3,1245,1518,0
64377113108,64377113107,-1,927,1196,0
64377190056,64377190059,3,1295,1221,0
64378126264,64378126276,12,8,875,0
64379481856,64379481856,0,1828,1719,0
64382540898,64382540898,0,1743,1340,0
64383156282,64383156279,-3,1192,2096,0
64384781027,64384781029,2,1287,1398,0
64385221454,64385221455,1,856,1340,0
64385517829,64385517825,-4,1229,1541,0
64386993423,64386993425,2,1656,1943,0
64392183496,64392183496,0,1710,1948,0
64397360906,64397360907,1,1321,1669,0
64399812146,64399812147,1,1322,1735,0
64401151859,64401151862,3,1688,1586,0
64403276662,64403276663,1,1297,1284,0
64403335654,64403335654,0,1499,1873,0
64404660166,64404660169,3,1378,870,0
64406671990,64406671989,-1,851,1857,0
64408639161,64408639162,1,1381,2062,0
64410101698,64410101700,2,1951,1923,0
64412802025,64412802025,0,1466,1802,0
64413670318,64413670320,2,1107,1190,0
64416390678,64416390670,-8,1360,2090,0
64419893166,64419893166,0,1100,1731,0
64424277547,64424277547,0,1524,1724,0
64425355575,64425355573,-2,1167,2016,0
64426922583,64426922584,1,1205,1865,0
64427905385,64427905387,2,1875,2244,0
64428497197,64428497196,-1,1882,2485,0
64428787257,64428787258,1,1588,1596,0
64430989359,64430989359,0,1118,1271,0
64432768952,64432768949,-3,1088,1538,0
64434034401,64434034399,-2,1533,1924,0
64437081453,64437081454,1,1892,1226,0
64439155653,64439155652,-1,2097,2442,0
64439472862,64439472875,13,890,1204,0
64440317659,64440317662,3,1448,1645,0
64442580943,64442580942,-1,1228,1390,0
64443942174,64443942174,0,884,1741,0
64444723737,64444723738,1,1431,1115,0
64446340636,64446340634,-2,1154,1426,0
64448212527,64448212525,-2,1289,1912,0
64450364389,64450364391,2,1072,1335,0
64452587171,64452587170,-1,804,1441,0
64456162628,64456162629,1,846,1192,0
64456581703,64456581698,-5,887,1561,0
64456846013,64456846014,1,1602,1422,0
64458395411,64458395412,1,1362,2002,0
64462977246,64462977246,0,1888,1562,0
64465239311,64465239311,0,1087,1263,0
64467354953,64467354954,1,1383,1518,0
64471005951,64471005946,-5,1535,1972,0
64483520506,64483520506,0,1221,1884,0
64483965522,64483965517,-5,1292,4676,0
64487847547,64487847550,3,2059,1780,0
64489432901,64489432901,0,1451,1566,0
64490180661,64490180662,1,1568,2224,0
64491472726,64491472726,0,828,1395,0
64494422340,64494422339,-1,1287,2221,0
64495051562,64495051563,1,1172,1307,0
64499186205,64499186205,0,1402,1952,0
64502058375,64502058374,-1,1430,1723,0
64503930153,64503930153,0,1187,1388,0
64505170657,64505170658,1,1459,1777,0
64516119839,64516119841,2,1204,1839,0
64518306039,64518306040,1,1495,1752,0
64518675847,64518675847,0,1585,1719,0
64519602081,64519602081,0,961,1190,0
64522622267,64522622269,2,1617,1271,0
64523055827,64523055827,0,1531,2115,0
64523458677,64523458679,2,1386,1219,0
64523914038,64523914038,0,1596,1696,0
64524271107,64524271085,-22,1054,1823,0
64528430470,64528430474,4,1587,1839,0
64536761038,64536761038,0,1293,1457,0
64539926394,64539926396,2,1649,1629,0
64545493402,64545493402,0,2345,2181,0
64547038877,64547038876,-1,1614,1488,0
64549126338,64549126319,-19,1266,1583,0
64549217469,64549217461,-8,522,1602,0
64553220568,64553220568,0,1620,1451,0
64554028746,64554028749,3,1588,1450,0
64555120258,64555120259,1,1838,1289,0
64555507695,64555507693,-2,1249,1111,0
64555707378,64555707397,19,542,1107,0
64558106320,64558106326,6,3692,1748,0
64560509748,64560509742,-6,2961,12748,0
64564002308,64564002309,1,1453,2312,0
64564601178,64564601177,-1,1148,1539,0
64566153071,64566153073,2,1413,1398,0
64568847281,64568847282,1,1004,1746,0
64572513186,64572513186,0,1577,1903,0
64575369515,64575369514,-1,1819,2408,0
64576607073,64576607072,-1,1661,1469,0
64579584402,64579584402,0,1229,1978,0
64580191294,64580191294,0,2003,1484,0
64581417446,64581417450,4,2233,1108,0
64583000214,64583000214,0,1119,1502,0
64584205870,64584205874,4,1639,1154,0
64585818914,64585818915,1,1427,1580,0
64588486443,64588486445,2,839,1252,0
64596095278,64596095279,1,1645,1188,0
64596264109,64596264109,0,1195,1584,0
64599681626,64599681626,0,1131,1728,0
64601225430,64601225430,0,1603,2213,0
64602356102,64602356103,1,1375,2474,0
64603625518,64603625517,-1,1745,1559,0
64603794693,64603794694,1,1410,1017,0
64604698741,64604698738,-3,1152,2324,0
64605019498,64605019498,0,1017,1942,0
64611378451,64611378458,7,2276,2013,0
64612639390,64612639391,1,1838,1914,0
64613092962,64613092957,-5,1336,5838,0
64616193186,64616193186,0,1221,1537,0
64616303230,64616303233,3,845,1158,0
64616405157,64616405159,2,1222,1471,0
64619701829,64619701829,0,1353,1362,0
64620463862,64620463861,-1,1082,1562,0
64621398700,64621398699,-1,1124,1952,0
64621954913,64621954913,0,1237,1345,0
64625390739,64625390741,2,1739,2181,0
64627446304,64627446303,-1,1608,1584,0
64628203331,64628203330,-1,1351,1152,0
64629822116,64629822118,2,1958,1352,0
64630931335,64630931321,-14,1377,1634,0
64633071231,64633071231,0,1081,1560,0
64633386227,64633386226,-1,1403,1199,0
64634719444,64634719444,0,1507,1776,0
64636722345,64636722345,0,1561,1931,0
64640494307,64640494306,-1,1412,1296,0
64640761510,64640761512,2,1510,1925,0
64641333770,64641333769,-1,1177,1885,0
64642917331,64642917330,-1,1487,1932,0
64644783432,64644783433,1,1804,2480,0
64645014837,64645014839,2,1007,1845,0
64649939973,64649939973,0,1329,1673,0
64651195466,64651195470,4,1717,1447,0
64653560102,64653560105,3,2074,2194,0
64653789485,64653789465,-20,864,1013,0
64654053552,64654053554,2,1519,1513,0
64654982774,64654982772,-2,1699,2007,0
64655811733,64655811732,-1,1343,1908,0
64658755953,64658755951,-2,815,1648,0
64658940554,64658940554,0,1392,1705,0
64659579810,64659579811,1,1028,1534,0
64660549845,64660549844,-1,1087,1754,0
64660630087,64660630089,2,1020,1885,0
64666904606,64666904613,7,3082,1499,0
64668267428,64668267431,3,1718,1703,0
64669806870,64669806870,0,1088,1401,0
64670822707,64670822706,-1,1646,1964,0
64674020229,64674020233,4,1620,1371,0
64679873559,64679873559,0,1013,1641,0
64681274889,64681274890,1,1313,1611,0
64688324746,64688324749,3,1329,1494,0
64689312916,64689312917,1,1077,1221,0
64693672184,64693672185,1,1248,1587,0
64694945519,64694945518,-1,1936,1886,0
64696681106,64696681107,1,2008,2082,0
64701907167,64701907166,-1,1140,1786,0
64702147586,64702147588,2,1293,1725,0
64704347118,64704347138,20,85,732,0
64705304517,64705304521,4,4188,2600,0
64709028602,64709028594,-8,960,4756,0
64711265534,64711265534,0,1942,2145,0
64711687567,64711687568,1,2206,1995,0
64713491871,64713491870,-1,1261,1908,0
64713995106,64713995107,1,2227,1974,0
64715094624,64715094626,2,1755,2386,0
64717858370,64717858368,-2,1115,1382,0
64720162552,64720162551,-1,1705,1184,0
64720459654,64720459655,1,973,1471,0
64723925033,64723925031,-2,1250,2005,0
64726134806,64726134807,1,1432,1510,0
64733921550,64733921549,-1,1136,1574,0
64738213438,64738213439,1,1340,1224,0
64739152275,64739152275,0,1780,2294,0
64739630609,64739630609,0,1078,1873,0
64741958669,64741958662,-7,961,1887,0
64744807142,64744807142,0,1073,1444,0
64746178975,64746178974,-1,1000,1933,0
64747603741,64747603740,-1,1183,1786,0
64748353225,64748353225,0,1962,1621,0
64756891045,64756891045,0,1473,2056,0
64757365624,64757365623,-1,1700,2310,0
64758062401,64758062403,2,1948,2121,0
64759919202,64759919180,-22,1753,1564,0
64764202650,64764202652,2,1640,1864,0
64764640493,64764640494,1,1446,1186,0
64766033028,64766033029,1,1320,1867,0
64769677510,64769677514,4,1999,1374,0
64771987433,64771987435,2,1760,1202,0
64772038107,64772038105,-2,1656,1830,0
64780438460,64780438461,1,5669,7210,0
64784923514,64784923517,3,2693,1770,0
64785919036,64785919038,2,1411,1729,0
64788046591,64788046574,-17,309,906,0
64789103706,64789103709,3,1499,1074,0
64790147858,64790147859,1,974,1342,0
64791367809,64791367808,-1,1297,1802,0
64794374449,64794374446,-3,804,1066,0
64801744655,64801744656,1,1338,1409,0
64805114642,64805114642,0,967,1182,0
64809830661,64809830662,1,1439,1423,0
64815857910,64815857910,0,1698,1496,0
64819208215,64819208218,3,1654,1171,0
64820763671,64820763672,1,1314,1729,0
64821630737,64821630739,2,1438,1977,0
64825040857,64825040857,0,1560,1578,0
64825494332,64825494331,-1,1252,1391,0
64827602150,64827602149,-1,1239,2636,0
64830339073,64830339074,1,2016,1780,0
64830688848,64830688849,1,1966,2441,0
64831089099,64831089097,-2,833,1313,0
64838964208,64838964202,-6,2259,11684,0
64839050794,64839050793,-1,1331,1738,0
64839663802,64839663803,1,1231,1437,0
64841546894,64841546898,4,4113,2596,0
64842415005,64842415006,1,1838,1493,0
64845525850,64845525850,0,916,1281,0
64847174190,64847174192,2,1488,2031,0
64847292006,64847292001,-5,1154,1261,0
64847740836,64847740835,-1,1717,2710,0
64853193946,64853193950,4,3247,1918,0
64853542260,64853542260,0,1170,1688,0
64854092742,64854092751,9,2123,1763,0
64858870110,64858870110,0,1391,1707,0
64861012305,64861012303,-2,1336,1746,0
64862503234,64862503235,1,1438,1640,0
64868936129,64868936134,5,4384,2098,0
64875159551,64875159555,4,1309,1458,0
64877167122,64877167123,1,1897,1656,0
64877586167,64877586167,0,1974,1850,0
64881246277,64881246278,1,1390,1781,0
64885401554,64885401555,1,530,1115,0
64886138697,64886138697,0,1393,1099,0
64887642206,64887642205,-1,1014,1897,0
64889196303,64889196306,3,659,1411,0
64890981730,64890981731,1,1305,1472,0
64892787197,64892787198,1,1483,1853,0
64892973048,64892973050,2,1375,1274,0
64894243599,64894243600,1,1460,1420,0
64894444452,64894444452,0,1638,1456,0
64897252095,64897252097,2,1050,1755,0
64897377927,64897377911,-16,1337,1675,0
64899161207,64899161207,0,1454,2194,0
64899465394,64899465394,0,1412,1897,0
64900358745,64900358745,0,1057,1554,0
64903596853,64903596853,0,1474,1848,0
64905669981,64905669982,1,1079,2001,0
64906398554,64906398555,1,1418,1548,0
64907231635,64907231641,6,2015,1337,0
64910036397,64910036395,-2,1228,2139,0
64910250682,64910250678,-4,780,1297,0
64917556693,64917556694,1,1918,2730,0
64919997738,64919997738,0,1578,903,0
64920136801,64920136802,1,1756,2052,0
64920210683,64920210685,2,1307,1408,0
64927124811,64927124811,0,1631,1905,0
64938584303,64938584301,-2,824,1132,0
64940582493,64940582493,0,1301,1458,0
64940901326,64940901326,0,1186,1563,0
64942219388,64942219389,1,1485,1735,0
64946420706,64946420706,0,604,1587,0
64947198770,64947198770,0,1596,2229,0
64948394246,64948394247,1,2045,2300,0
64949656545,64949656545,0,1126,2052,0
64951670780,64951670796,16,889,2070,0
64951972718,64951972718,0,1002,1479,0
64952906733,64952906730,-3,1182,1933,0
64956833131,64956833130,-1,1917,1787,0
64959961939,64959961941,2,1395,2041,0
64962679952,64962679951,-1,1014,1343,0
64970085019,64970085018,-1,1836,2097,0
64970948854,64970948854,0,1050,1254,0
64971545469,64971545491,22,1036,1164,0
64974039054,64974039054,0,2157,2610,0
64976734710,64976734713,3,2999,1397,0
64981846325,64981846326,1,1341,1499,0
64983223924,64983223925,1,2528,2622,0
64984710805,64984710806,1,2075,2111,0
64987236426,64987236428,2,1203,1342,0
64987627300,64987627302,2,1507,2213,0
64989819452,64989819451,-1,1236,1268,0
64990315018,64990315021,3,1153,1305,0
64991580177,64991580176,-1,1453,1497,0
64993015450,64993015456,6,1638,1127,0
64993219011,64993219011,0,1255,2449,0
64994540133,64994540133,0,1712,1976,0
65000106106,65000106106,0,1099,2115,0
65009390530,65009390530,0,1759,1909,0
65012139514,65012139514,0,999,1136,0
65014306356,65014306354,-2,1295,1861,0
65016102005,65016102006,1,1390,1331,0
65023066002,65023066001,-1,1200,1871,0
65024566767,65024566765,-2,1194,1432,0
65025585926,65025585927,1,1040,1911,0
65025859375,65025859371,-4,1148,2738,0
65029794590,65029794570,-20,1743,2199,0
65040563002,65040563006,4,4167,2420,0
65048318564,65048318566,2,1269,1415,0
65048887105,65048887105,0,1562,1715,0
65049000024,65049000025,1,1853,2136,0
65050013117,65050013115,-2,1568,1288,0
65050848681,65050848682,1,1031,1451,0
65051033302,65051033303,1,1265,1436,0
65051355399,65051355398,-1,1428,1986,0
65052761565,65052761567,2,1148,1380,0
65053163215,65053163219,4,797,839,0
65054149739,65054149739,0,1571,1665,0
65055648384,65055648385,1,1092,1866,0
65056308259,65056308258,-1,771,2067,0
65056955754,65056955755,1,1340,1707,0
65057168833,65057168837,4,1182,1206,0
65058318199,65058318200,1,1547,2129,0
65062221677,65062221678,1,1558,1905,0
65063556305,65063556309,4,1828,1264,0
65069499727,65069499726,-1,1446,1513,0
65074465185,65074465185,0,1341,2063,0
65076390454,65076390452,-2,956,1860,0
65079633574,65079633558,-16,942,1378,0
65080023269,65080023270,1,1167,1408,0
65081563842,65081563834,-8,713,3901,0
65082565678,65082565678,0,913,1451,0
65083105513,65083105513,0,1213,1888,0
65083510142,65083510141,-1,1603,1835,0
65084048177,65084048174,-3,1152,1974,0
65084296990,65084296969,-21,1393,1534,0
65085692133,65085692135,2,1623,1661,0
65088391800,65088391801,1,1406,1871,0
65091916298,65091916298,0,1692,1573,0
65097495103,65097495105,2,1062,1541,0
65097549314,65097549310,-4,1467,2328,0
65105755602,65105755598,-4,1199,3332,0
65107359878,65107359881,3,821,1779,0
65108452953,65108452954,1,1259,1392,0
65111471828,65111471829,1,1260,1672,0
65112053354,65112053355,1,793,1158,0
65112444263,65112444261,-2,1493,1977,0
65113305649,65113305649,0,1218,1505,0
65113521731,65113521733,2,2038,1436,0
65114737264,65114737265,1,1267,1352,0
65115296364,65115296366,2,1513,1687,0
65117130303,65117130305,2,1716,1700,0
65123596286,65123596282,-4,1528,5204,0
65127349503,65127349498,-5,878,2812,0
65128941659,65128941658,-1,1103,1814,0
65132134097,65132134099,2,1795,1775,0
65134073003,65134073003,0,1051,1797,0
65137261221,65137261219,-2,1341,2522,0
65140726974,65140726973,-1,1324,1341,0
65141435127,65141435124,-3,1097,1848,0
65141987276,65141987278,2,1413,1415,0
65144423166,65144423167,1,965,1370,0
65147180309,65147180310,1,1085,1577,0
65153503430,65153503431,1,1130,1517,0
65155692698,65155692702,4,1547,1499,0
65155737770,65155737770,0,2243,2794,0
65158042137,65158042136,-1,1320,1732,0
65160444020,65160444020,0,1106,1567,0
65161330492,65161330492,0,941,1271,0
65162928106,65162928106,0,943,1559,0
65164493961,65164493961,0,1963,1824,0
65167618921,65167618920,-1,1061,1119,0
65169571899,65169571889,-10,1105,5289,0
65171321195,65171321197,2,1232,1203,0
65174210550,65174210553,3,2123,1861,0
65176345756,65176345757,1,1192,1949,0
65178586126,65178586120,-6,1565,9075,0
65179782282,65179782276,-6,556,3363,0
65180135968,65180135987,19,974,2137,0
65180570411,65180570413,2,2373,2282,0
65182670810,65182670808,-2,1055,1990,0
65187903390,65187903391,1,1467,2472,0
65189584685,65189584686,1,1423,1696,0
65189813531,65189813533,2,1080,1091,0
65195037911,65195037911,0,1239,1473,0
65195149570,65195149575,5,2582,1480,0
65202641998,65202641997,-1,1814,2293,0
65203887137,65203887132,-5,27618,16021,0
65204122884,65204122885,1,904,1572,0
65205993023,65205993023,0,1915,1978,0
65209116751,65209116750,-1,685,801,0
65209860098,65209860099,1,1115,1770,0
65212994488,65212994488,0,2118,2266,0
65214717099,65214717102,3,1758,1872,0
65216325223,65216325225,2,1432,2028,0
65218277554,65218277554,0,1591,1583,0
65218587593,65218587593,0,1293,1425,0
65218636546,65218636546,0,1488,1520,0
65220684382,65220684381,-1,1536,1459,0
65221953554,65221953566,12,1116,1677,0
65226450653,65226450656,3,1506,1045,0
65228202887,65228202888,1,1721,1535,0
65229264050,65229264049,-1,1046,1574,0
65230866986,65230866986,0,1665,2324,0
65233286031,65233286032,1,1439,1701,0
65233982417,65233982417,0,1284,1713,0
65234975302,65234975305,3,2162,2008,0
65242448674,65242448674,0,1262,1859,0
65244575727,65244575726,-1,1103,1649,0
65251052089,65251052089,0,1650,2460,0
65252790574,65252790573,-1,1736,1885,0
65252968431,65252968430,-1,957,1080,0
65256936514,65256936513,-1,1582,1945,0
65258242773,65258242775,2,1374,1513,0
65261250347,65261250343,-4,1219,2754,0
65263926986,65263926988,2,1492,1719,0
65267068365,65267068369,4,1737,1622,0
65268998595,65268998596,1,1268,1496,0
65270380485,65270380486,1,1436,2033,0
65273251939,65273251938,-1,1345,1341,0
65273316242,65273316240,-2,1144,2308,0
65276983098,65276983098,0,1525,2232,0
65277535380,65277535378,-2,1762,1938,0
65278416201,65278416202,1,1149,915,0
65278587930,65278587931,1,1370,2031,0
65278668725,65278668725,0,1350,2170,0
65278712278,65278712278,0,1643,1597,0
65278911173,65278911173,0,1374,1948,0
65282616371,65282616374,3,2574,1610,0
65284898469,65284898470,1,1648,1982,0
65284937669,65284937677,8,1329,1080,0
65286446875,65286446887,12,14107,20631,0
65288753542,65288753542,0,1277,1533,0
65291062930,65291062930,0,890,1150,0
65293419131,65293419133,2,1216,1836,0
65293740475,65293740473,-2,984,1415,0
65295932531,65295932530,-1,1107,1173,0
65297373962,65297373961,-1,1084,2114,0
65299091749,65299091748,-1,1346,1523,0
65301092984,65301092985,1,1420,1775,0
65301454363,65301454360,-3,1249,1852,0
65302986489,65302986490,1,980,1378,0
65304427114,65304427114,0,1212,1558,0
65306573826,65306573829,3,1750,1649,0
65307993253,65307993234,-19,1286,1255,0
65310546158,65310546157,-1,1062,2065,0
65311121642,65311121641,-1,1407,1794,0
65311230916,65311230914,-2,1625,2157,0
65312456021,65312456021,0,1008,1569,0
65315527401,65315527399,-2,1560,1708,0
65316728013,65316728000,-13,993,1062,0
65320112953,65320112953,0,1545,2002,0
65324403231,65324403230,-1,1045,1775,0
65327328367,65327328367,0,1699,1737,0
65328722295,65328722297,2,1460,1622,0
65330246321,65330246323,2,1075,1620,0
65333771774,65333771774,0,1215,1797,0
65334290983,65334290984,1,1074,1180,0
65335364483,65335364485,2,809,1548,0
65335830298,65335830304,6,10815,22580,0
65338169495,65338169497,2,1118,2150,0
65340888525,65340888525,0,1488,1652,0
65341140302,65341140318,16,1298,1321,0
65343616042,65343616042,0,1127,1511,0
65347572755,65347572755,0,1391,1940,0
65349623299,65349623297,-2,1487,1639,0
65354139029,65354139030,1,1556,1568,0
65354319209,65354319210,1,1105,1813,0
65356219842,65356219846,4,1761,1605,0
65359523958,65359523959,1,1720,2410,0
65359949176,65359949178,2,1379,1413,0
65360915517,65360915518,1,1552,1403,0
65361240034,65361240028,-6,915,3894,0
65361325546,65361325545,-1,1187,1448,0
65361418110,65361418110,0,479,906,0
65363058909,65363058915,6,7700,27696,0
65364540905,65364540906,1,1172,1445,0
65366065656,65366065657,1,1431,2003,0
65370389571,65370389568,-3,1081,1868,0
65373296438,65373296438,0,1227,2243,0
65373438174,65373438168,-6,624,2513,0
65375978966,65375978967,1,830,1271,0
65376612322,65376612322,0,1319,1718,0
65377483922,65377483922,0,1521,1918,0
65378779660,65378779661,1,1514,1231,0
65381782942,65381782945,3,1085,1216,0
65382373733,65382373731,-2,816,2103,0
65385314202,65385314202,0,1098,1345,0
65392089689,65392089688,-1,1109,983,0
65393174648,65393174649,1,1562,2008,0
65396290733,65396290733,0,1903,2065,0
65397150947,65397150949,2,1302,1494,0
65397895296,65397895293,-3,30838,9267,0
65398259994,65398259992,-2,1744,1858,0
65400707439,65400707441,2,1346,1590,0
65401366321,65401366319,-2,1390,1903,0
65402501262,65402501260,-2,1634,2074,0
65403236495,65403236495,0,1464,1668,0
65404518196,65404518197,1,1672,1891,0
65410927290,65410927291,1,1201,1707,0
65411142972,65411142961,-11,1352,1794,0
65411595769,65411595770,1,1318,2451,0
65419746423,65419746426,3,1383,1524,0
65420716535,65420716534,-1,2440,4000,0
65425621637,65425621639,2,2311,2518,0
65425892850,65425892851,1,1504,1703,0
65426408439,65426408441,2,1729,2205,0
65427075129,65427075129,0,1309,2111,0
65430225063,65430225063,0,1793,1306,0
65431860202,65431860203,1,1212,1505,0
65434743114,65434743114,0,1697,1386,0
65435814299,65435814297,-2,837,2046,0
65435992649,65435992649,0,1538,1900,0
65439487368,65439487369,1,1598,1079,0
65443538792,65443538793,1,1682,1100,0
65444256594,65444256593,-1,1118,1820,0
65444402868,65444402863,-5,1637,1686,0
65444844454,65444844455,1,1381,1789,0
65446501905,65446501906,1,1717,1717,0
65450707559,65450707561,2,1400,1497,0
65452996245,65452996244,-1,1548,2439,0
65454069923,65454069925,2,1649,2156,0
65454608814,65454608816,2,1202,1916,0
65455962539,65455962537,-2,47076,16818,0
65456807199,65456807197,-2,1159,1736,0
65459747791,65459747792,1,986,1264,0
65461153827,65461153829,2,1282,1322,0
65462645149,65462645150,1,1501,1865,0
65462983426,65462983426,0,1571,1958,0
65478461139,65478461139,0,1220,1073,0
65479875799,65479875800,1,1159,2532,0
65480082124,65480082105,-19,1576,1274,0
65480176815,65480176817,2,1449,1924,0
65482473953,65482473955,2,804,1103,0
65486230711,65486230713,2,1190,1704,0
65486612526,65486612527,1,1415,1146,0
65487616331,65487616332,1,1330,1651,0
65489361394,65489361391,-3,1408,1360,0
65494599611,65494599614,3,989,1848,0
65497052325,65497052326,1,2136,1738,0
65500587937,65500587940,3,1268,1830,0
65501247467,65501247468,1,1150,1425,0
65501897143,65501897145,2,1407,1831,0
65504638564,65504638562,-2,1145,2205,0
65505689911,65505689910,-1,1011,2108,0
65506422831,65506422832,1,968,1422,0
65509331865,65509331865,0,1286,1780,0
65512925895,65512925898,3,1047,1180,0
65514319233,65514319234,1,1342,1690,0
65517190558,65517190554,-4,1331,1371,0
65518981303,65518981305,2,904,1338,0
65519036057,65519036057,0,1720,1735,0
65519499361,65519499361,0,1555,1217,0
65519548682,65519548682,0,970,1039,0
65521619334,65521619334,0,1493,2119,0
65522033311,65522033302,-9,872,1450,0
65523983377,65523983377,0,1072,2130,0
65527180168,65527180175,7,49,525,0
65529160113,65529160111,-2,1465,2181,0
65529901735,65529901715,-20,635,1959,0
65533542294,65533542298,4,1652,1100,0
65533959597,65533959598,1,1314,1300,0
65534345746,65534345745,-1,804,1411,0
65534786225,65534786227,2,1113,1944,0
65535270274,65535270275,1,1409,1211,0
65536579561,65536579555,-6,711,2529,0
65543419921,65543419921,0,1146,1158,0
65546530717,65546530718,1,912,1795,0
65547392945,65547392945,0,2008,2033,0
65547668050,65547668050,0,1394,2256,0
65552473365,65552473367,2,1239,1528,0
65555459762,65555459765,3,1193,1948,0
65559138843,65559138843,0,1365,1238,0
65560432402,65560432407,5,2387,1418,0
65564153233,65564153233,0,1305,1853,0
65573238025,65573238026,1,1691,1510,0
65574563606,65574563602,-4,1219,1557,0
65575894083,65575894082,-1,1531,1412,0
65577229638,65577229640,2,1538,1853,0
65578691558,65578691558,0,1188,1332,0
65582226750,65582226750,0,1014,1387,0
65582863974,65582863977,3,816,1170,0
65583403785,65583403786,1,1504,1433,0
65584009025,65584009028,3,2813,2208,0
65586333269,65586333266,-3,1328,1553,0
65587648034,65587648033,-1,1632,2088,0
65588515484,65588515486,2,1658,1473,0
65596292462,65596292463,1,1451,2143,0
65598346114,65598346115,1,1395,2183,0
65599940650,65599940651,1,1328,2083,0
65600166498,65600166498,0,1631,1802,0
65600764886,65600764887,1,1620,1939,0
65600828131,65600828131,0,705,1474,0
65600878118,65600878103,-15,1858,1307,0
65601265342,65601265341,-1,1666,1918,0
65607850158,65607850159,1,1355,1016,0
65608710905,65608710898,-7,1024,1737,0
65609547819,65609547821,2,1203,1624,0
65616390417,65616390418,1,1702,1863,0
65619981139,65619981139,0,1776,1994,0
65620065992,65620065988,-4,823,1689,0
65621092598,65621092598,0,2131,2096,0
65621978161,65621978162,1,1556,1315,0
65626201709,65626201708,-1,1431,1838,0
65627701950,65627701953,3,1129,1229,0
65630359318,65630359321,3,1744,1590,0
65632708146,65632708145,-1,1167,1644,0
65633081425,65633081446,21,987,1205,0
65639259060,65639259062,2,1806,1612,0
65639844118,65639844117,-1,1163,1214,0
65640408251,65640408251,0,1259,2010,0
65641080734,65641080736,2,1779,1412,0
65647136254,65647136254,0,992,2026,0
65649381494,65649381494,0,1173,1279,0
65649533750,65649533731,-19,1513,1402,0
65650124310,65650124310,0,1515,1582,0
65650559789,65650559789,0,1492,1578,0
65652806344,65652806344,0,1333,1796,0
65654870257,65654870258,1,1789,2027,0
65657081270,65657081271,1,887,1328,0
65664068945,65664068946,1,1090,1115,0
65665393698,65665393697,-1,1626,2019,0
65667001341,65667001342,1,1913,2122,0
65670874964,65670874965,1,1306,1531,0
65671609282,65671609282,0,1529,1349,0
65673978918,65673978918,0,1527,1514,0
65675681487,65675681487,0,1202,2380,0
65679999362,65679999362,0,1385,1058,0
65682081876,65682081874,-2,1195,1785,0
65687808413,65687808407,-6,2921,9843,0
65693055422,65693055422,0,1645,2573,0
65693866284,65693866285,1,1418,1874,0
65695038037,65695038030,-7,1226,4916,0
65695903406,65695903386,-20,962,1582,0
65696190523,65696190523,0,1443,2231,0
65698564253,65698564253,0,32102,53496,0
65699508419,65699508421,2,1298,2095,0
65702430561,65702430554,-7,1144,3659,0
65702720898,65702720893,-5,1151,2018,0
65703601543,65703601545,2,1381,2143,0
65705899182,65705899184,2,1580,1533,0
65707887385,65707887386,1,1464,1527,0
65710918829,65710918825,-4,1490,3721,0
65714428791,65714428792,1,1269,1324,0
65715359993,65715359993,0,1379,1710,0
65718547049,65718547050,1,1252,1579,0
65723040594,65723040585,-9,757,1035,0
65724355404,65724355403,-1,938,1704,0
65726052438,65726052450,12,13303,19490,0
65726506771,65726506776,5,1871,1457,0
65727696898,65727696901,3,2222,1511,0
65727791078,65727791081,3,1148,1603,0
65730510338,65730510337,-1,1090,1195,0
65731797991,65731797993,2,1675,2090,0
65733652322,65733652324,2,1689,1487,0
65734648407,65734648410,3,1467,1112,0
65734775170,65734775162,-8,1703,8182,0
65737130086,65737130088,2,1450,1675,0
65739719470,65739719470,0,1714,1874,0
65741496610,65741496622,12,1683,2043,0
65746036157,65746036157,0,1199,2026,0
65754680597,65754680595,-2,1546,2394,0
65757996674,65757996675,1,2148,1689,0
65758260562,65758260562,0,1701,1917,0
65760133325,65760133326,1,1539,2112,0
65760988878,65760988896,18,2372,38444,0
65761612090,65761612089,-1,1488,3524,0
65762968110,65762968110,0,1424,1667,0
65765129742,65765129742,0,1498,2260,0
65768288725,65768288723,-2,1224,1941,0
65772287673,65772287673,0,1458,1506,0
65773766155,65773766157,2,1384,1653,0
65774090634,65774090637,3,1908,1735,0
65774757086,65774757087,1,1780,2251,0
65775582994,65775582993,-1,1300,1761,0
65779826071,65779826070,-1,1458,2430,0
65780544025,65780544026,1,1406,1567,0
65780792189,65780792189,0,939,1663,0
65787306942,65787306944,2,1512,1397,0
65789431558,65789431558,0,1214,1923,0
65789965367,65789965367,0,1499,1742,0
65794250025,65794250025,0,1005,1118,0
65795531354,65795531354,0,1094,1738,0
65797946877,65797946878,1,1160,1482,0
65800039046,65800039046,0,1026,1362,0
65800803558,65800803557,-1,1311,1444,0
65800872008,65800872008,0,1644,1988,0
65806555210,65806555210,0,1394,1404,0
65809818108,65809818107,-1,2222,2191,0
65813511881,65813511881,0,1665,1317,0
65814059206,65814059206,0,1723,2891,0
65816122438,65816122438,0,1563,1477,0
65819255106,65819255106,0,1151,1646,0
65822458426,65822458427,1,1250,1524,0
65831381829,65831381827,-2,597,2188,0
65833414322,65833414324,2,1662,1833,0
65834190566,65834190568,2,1542,1669,0
65838829180,65838829180,0,1178,1578,0
65843571334,65843571336,2,1452,1486,0
65846135500,65846135502,2,1092,1381,0
65846665249,65846665249,0,1304,1865,0
65848506942,65848506941,-1,1569,1887,0
65849887571,65849887574,3,1868,1898,0
65850036218,65850036218,0,1048,1261,0
65857158001,65857157999,-2,1564,1782,0
65860601719,65860601719,0,1695,2359,0
65864428918,65864428913,-5,1246,2249,0
65865384462,65865384462,0,1622,1777,0
65866366795,65866366794,-1,1164,1422,0
65867960649,65867960649,0,1444,1615,0
65871789679,65871789679,0,1617,1215,0
65872954123,65872954123,0,993,1091,0
65874306343,65874306344,1,1387,1545,0
65874341217,65874341219,2,1949,2278,0
65877324133,65877324135,2,1326,1750,0
65877791158,65877791161,3,2575,1365,0
65880552698,65880552698,0,851,1121,0
65881180154,65881180154,0,1463,2163,0
65881320152,65881320152,0,1469,1901,0
65882896139,65882896138,-1,1302,1762,0
65883794894,65883794896,2,1608,2430,0
65884230285,65884230286,1,1559,1837,0
65884700567,65884700545,-22,995,1529,0
65885107066,65885107066,0,1170,1743,0
65887245866,65887245866,0,1112,1432,0
65890606243,65890606241,-2,1117,1955,0
65893215879,65893215880,1,1858,1937,0
65896273755,65896273755,0,1636,1781,0
65897081590,65897081588,-2,1266,1757,0
65899492038,65899492039,1,1128,1612,0
65900654130,65900654129,-1,1621,1708,0
65902189555,65902189555,0,1338,1758,0
65903604981,65903604982,1,1417,1483,0
65905570046,65905570045,-1,1184,1396,0
65913665870,65913665871,1,868,923,0
65915309900,65915309901,1,1377,1726,0
65916346697,65916346696,-1,1209,1241,0
65917610730,65917610732,2,2028,2100,0
65918207244,65918207267,23,836,1761,0
65918295391,65918295392,1,996,1454,0
65919781688,65919781669,-19,1006,1725,0
65922335937,65922335938,1,1443,1594,0
65928025142,65928025142,0,1057,1704,0
65930406299,65930406299,0,1390,1983,0
65931137466,65931137469,3,1466,2058,0
65932980010,65932980010,0,1904,2707,0
65934690446,65934690448,2,1678,1629,0
65936604134,65936604135,1,1069,1975,0
65937589056,65937589045,-11,910,1432,0
65938516386,65938516384,-2,1204,2132,0
65943908284,65943908286,2,1416,2335,0
65945732284,65945732284,0,2112,2644,0
65947088215,65947088214,-1,1096,1215,0
65951988683,65951988684,1,1322,1795,0
65952331407,65952331407,0,1302,1668,0
65954494898,65954494898,0,1447,1957,0
65958714544,65958714544,0,1151,1521,0
65961566929,65961566928,-1,1791,1923,0
65962869331,65962869331,0,1339,1860,0
65964866658,65964866661,3,1502,1701,0
65965984848,65965984845,-3,24251,13123,0
65966743932,65966743934,2,1405,1755,0
65967378709,65967378712,3,1610,1555,0
65968357332,65968357334,2,1240,1478,0
65970129679,65970129676,-3,1387,3577,0
65973110998,65973110999,1,1277,1985,0
65977458355,65977458342,-13,239,404,0
65981528591,65981528584,-7,25334,12461,0
65982258913,65982258914,1,2063,1300,0
65983883840,65983883842,2,1344,1698,0
65984168615,65984168614,-1,1328,1452,0
65988583401,65988583401,0,2350,2528,0
65991511953,65991511955,2,798,1450,0
65993489655,65993489657,2,1584,1676,0
65995662469,65995662474,5,2224,1811,0
65998371968,65998371970,2,1305,1090,0
66001840250,66001840245,-5,888,3253,0
66003646546,66003646547,1,2292,1706,0
66003995264,66003995263,-1,1616,2223,0
66006793948,66006793949,1,1418,2100,0
66009018983,66009018984,1,1487,1715,0
66016101551,66016101558,7,855,50,0
66018087538,66018087539,1,956,1133,0
66018150478,66018150478,0,1160,1737,0
66019033608,66019033610,2,3143,3008,0
66019385786,66019385787,1,1316,1382,0
66020283699,66020283699,0,1465,2332,0
66021193395,66021193398,3,1667,1980,0
66026427466,66026427463,-3,1504,4544,0
66031743965,66031743966,1,1751,1846,0
66033188789,66033188790,1,1654,1576,0
66037027727,66037027730,3,1345,1748,0
66037650245,66037650246,1,1052,1624,0
66039765651,66039765651,0,1300,1419,0
66042828261,66042828262,1,1282,1600,0
66043020527,66043020526,-1,1327,1420,0
66044895754,66044895754,0,1918,1665,0
66047997037,66047997037,0,1947,2347,0
66049221009,66049221010,1,1291,1550,0
66050209662,66050209662,0,1575,2089,0
66051255821,66051255819,-2,1374,1497,0
66058079821,66058079822,1,1226,2111,0
66059214065,66059214065,0,1450,1817,0
66060355590,66060355594,4,1485,927,0
66061537840,66061537842,2,1437,1464,0
66062519649,66062519647,-2,1643,2091,0
66062722800,66062722798,-2,1058,1566,0
66064276305,66064276305,0,1873,2150,0
66064345473,66064345475,2,1683,1320,0
66068734987,66068734987,0,1326,1616,0
66071226134,66071226134,0,807,1320,0
66071798171,66071798174,3,1054,1887,0
66071948245,66071948240,-5,817,3940,0
66072482981,66072482981,0,1713,1633,0
66072644769,66072644771,2,1334,1236,0
66075752484,66075752485,1,1228,1257,0
66077114798,66077114799,1,1461,1490,0
66081270537,66081270538,1,1610,1514,0
66084593097,66084593098,1,1836,1745,0
66092286891,66092286891,0,2018,2328,0
66093905362,66093905365,3,1388,1835,0
66094459228,66094459228,0,1277,1802,0
66094659555,66094659559,4,1499,1597,0
66103019781,66103019782,1,1738,1587,0
66103293276,66103293277,1,1257,2039,0
66105290986,66105290983,-3,1007,1459,0
66106071646,66106071646,0,921,1071,0
66109630635,66109630638,3,1322,1546,0
66110153733,66110153734,1,1710,1812,0
66110758499,66110758499,0,1789,2164,0
66111822112,66111822113,1,1060,1700,0
66114772571,66114772571,0,1230,1355,0
66116626720,66116626719,-1,1244,2314,0
66119277852,66119277850,-2,1657,2063,0
66121628876,66121628877,1,1858,2054,0
66122400131,66122400133,2,1481,1894,0
66125058998,66125059000,2,1421,1744,0
66125681795,66125681796,1,1702,1765,0
66126022125,66126022135,10,11728,27189,0
66129809513,66129809516,3,1430,1625,0
66130676317,66130676318,1,1434,1890,0
66131609739,66131609738,-1,887,1375,0
66135137122,66135137123,1,1795,1656,0
66135727690,66135727691,1,1862,2232,0
66137762486,66137762487,1,2021,2373,0
66139325716,66139325712,-4,1686,5664,0
66140711686,66140711686,0,1568,1650,0
66143496130,66143496129,-1,1511,1668,0
66143597566,66143597567,1,1894,1543,0
66144493754,66144493755,1,1235,1329,0
66145861182,66145861162,-20,1029,1597,0
66146974532,66146974531,-1,1398,1376,0
66148538561,66148538562,1,1234,1193,0
66150076452,66150076452,0,1518,1993,0
66152074026,66152074037,11,16036,42723,0
66152596842,66152596843,1,1172,1621,0
66157441414,66157441415,1,3070,2223,0
66158296220,66158296221,1,925,1016,0
66159669066,66159669068,2,1343,1622,0
66159875477,66159875482,5,3999,2508,0
66161737130,66161737131,1,1262,1560,0
66163974501,66163974497,-4,847,2937,0
66164451311,66164451322,11,821,4159,0
66164979739,66164979738,-1,1588,1715,0
66165785558,66165785559,1,974,909,0
66167980986,66167980988,2,1183,1666,0
66170821702,66170821702,0,1652,2219,0
66171965523,66171965522,-1,1050,892,0
66172559901,66172559900,-1,1351,1611,0
66172873606,66172873607,1,1910,2096,0
66174242255,66174242257,2,1361,2394,0
66174622540,66174622540,0,1538,2049,0
66176068265,66176068265,0,1431,2029,0
66176574262,66176574260,-2,1208,1347,0
66177700452,66177700454,2,2895,2590,0
66178261148,66178261147,-1,1700,2284,0
66181430974,66181430976,2,1493,1623,0
66187090053,66187090066,13,1546,1773,0
66190192113,66190192114,1,1237,1037,0
66191664305,66191664309,4,16880,48171,0
66191765947,66191765946,-1,1819,1796,0
66192692410,66192692414,4,1666,2284,0
66195019890,66195019883,-7,1278,5099,0
66201041893,66201041893,0,1780,1522,0
66202694529,66202694529,0,1324,1599,0
66205587797,66205587799,2,1085,1761,0
66209128935,66209128937,2,1321,1694,0
66210691843,66210691846,3,1318,1900,0
66217399818,66217399818,0,2039,2821,0
66220746791,66220746793,2,1867,1131,0
66221524512,66221524513,1,1522,1607,0
66221923846,66221923866,20,265,1022,0
66222046050,66222046051,1,1312,1723,0
66222566522,66222566521,-1,1320,2240,0
66222958552,66222958551,-1,1756,1894,0
66225371782,66225371781,-1,1074,1555,0
66233384257,66233384262,5,1948,1547,0
66242618614,66242618613,-1,1291,1667,0
66243670368,66243670362,-6,1102,1977,0
66243930900,66243930903,3,1545,1035,0
66249206126,66249206123,-3,1290,2479,0
66251536546,66251536554,8,2124,864,0
66255803630,66255803623,-7,1421,7707,0
66260888926,66260888926,0,1231,1490,0
66260944597,66260944596,-1,880,2154,0
66262682000,66262682001,1,1727,1617,0
66264650446,66264650448,2,1414,1473,0
66265329240,66265329241,1,2449,1988,0
66265650934,66265650945,11,9737,36661,0
66266044046,66266044045,-1,1191,2065,0
66268357931,66268357930,-1,830,1846,0
66272859245,66272859245,0,1266,1978,0
66272951380,66272951371,-9,1131,1284,0
66276558628,66276558627,-1,1037,1664,0
66277264802,66277264804,2,1147,1754,0
66278603422,66278603442,20,1113,1262,0
66279677908,66279677911,3,1197,1452,0
66282042862,66282042863,1,865,1242,0
66282470117,66282470118,1,1314,1331,0
66284044066,66284044066,0,1315,1104,0
66284470530,66284470526,-4,816,1813,0
66287650182,66287650179,-3,1049,1438,0
66288800419,66288800418,-1,932,1232,0
66290201997,66290201994,-3,1020,1520,0
66291368007,66291368006,-1,1632,1839,0
66291516367,66291516367,0,1337,1454,0
66293637894,66293637895,1,1736,1813,0
66297507694,66297507697,3,1131,1604,0
66298509806,66298509806,0,1263,1658,0
66300726006,66300726007,1,2437,1933,0
66302933942,66302933945,3,1230,1261,0
66305159228,66305159228,0,1194,1561,0
66307095733,66307095734,1,1442,1354,0
66311211310,66311211311,1,1578,2136,0
66312283506,66312283507,1,988,1187,0
66313170845,66313170847,2,532,896,0
66314247875,66314247879,4,1340,911,0
66315760431,66315760450,19,1692,1183,0
66318312801,66318312802,1,1535,1586,0
66320283784,66320283786,2,1468,2341,0
66321055139,66321055138,-1,1408,1774,0
66321670048,66321670049,1,1452,1743,0
66321973638,66321973638,0,1515,1835,0
66323529402,66323529403,1,1424,1484,0
66323694350,66323694352,2,1800,2428,0
66324555189,66324555190,1,1808,1799,0
66327327775,66327327776,1,1366,1741,0
66329326003,66329326003,0,1551,1569,0
66333158515,66333158522,7,3677,1997,0
66334006206,66334006205,-1,1865,2197,0
66334226512,66334226513,1,1275,1729,0
66335100882,66335100882,0,1241,1791,0
66338253194,66338253194,0,2095,2130,0
66343327463,66343327465,2,1315,1017,0
66345272553,66345272544,-9,41251,11371,0
66348520550,66348520549,-1,2118,1726,0
66351276550,66351276549,-1,1618,2062,0
66352613514,66352613517,3,2018,1809,0
66353741829,66353741846,17,1294,1509,0
66354967877,66354967877,0,997,1034,0
66360307327,66360307326,-1,1393,1352,0
66368977301,66368977298,-3,1219,1819,0
66374774667,66374774668,1,1482,1919,0
66376219795,66376219795,0,1457,2297,0
66378164440,66378164446,6,3808,1265,0
66378634404,66378634403,-1,1150,1658,0
66381160130,66381160133,3,1222,1726,0
66382242191,66382242191,0,1281,1764,0
66383952207,66383952206,-1,1743,1657,0
66384846180,66384846181,1,1317,1943,0
66388477852,66388477851,-1,1845,14736,0
66389150547,66389150548,1,1818,1913,0
66389292716,66389292717,1,1386,1928,0
66389359502,66389359503,1,1526,1841,0
66390543334,66390543336,2,2690,2382,0
66391908106,66391908105,-1,18652,21210,0
66394923365,66394923366,1,1349,2003,0
66395878329,66395878332,3,3137,1950,0
66401535134,66401535133,-1,1030,1961,0
66403324293,66403324285,-8,35008,17294,0
66403766047,66403766046,-1,1057,1437,0
66404301378,66404301377,-1,1372,1714,0
66414318210,66414318210,0,953,1666,0
66415013893,66415013892,-1,1155,1670,0
66418300127,66418300126,-1,1416,1798,0
66419271124,66419271126,2,1551,1991,0
66421357388,66421357391,3,1862,1641,0
66424081985,66424081989,4,1414,1586,0
66425983619,66425983619,0,1288,1724,0
66430398795,66430398796,1,1367,1578,0
66432092734,66432092735,1,1287,2140,0
66435552591,66435552594,3,1342,1238,0
66438425905,66438425907,2,1211,1568,0
66444353906,66444353906,0,1446,1949,0
66445371945,66445371946,1,1466,1151,0
66446631926,66446631925,-1,1572,1746,0
66447844248,66447844246,-2,1317,1831,0
66452952921,66452952923,2,1529,1212,0
66455537078,66455537077,-1,1215,2220,0
66457367397,66457367378,-19,886,1341,0
66457466544,66457466563,19,62,547,0
66458074499,66458074499,0,1225,1557,0
66459940590,66459940595,5,3714,2495,0
66460401350,66460401350,0,798,1004,0
66463580791,66463580791,0,1204,1793,0
66463879714,66463879714,0,1591,1460,0
66466479972,66466479974,2,1603,1437,0
66468449794,66468449792,-2,1263,1714,0
66469198391,66469198392,1,1821,1345,0
66472618237,66472618238,1,916,1768,0
66473533013,66473533012,-1,1624,2615,0
66474425238,66474425238,0,743,990,0
66474818127,66474818127,0,1264,2015,0
66475725690,66475725690,0,1075,1664,0
66478051944,66478051944,0,1528,2289,0
66479348490,66479348493,3,1920,1860,0
66481564086,66481564086,0,1121,1987,0
66482332974,66482332975,1,1226,1806,0
66482837698,66482837701,3,1335,2466,0
66482944786,66482944787,1,1587,1486,0
66483540237,66483540236,-1,1936,1859,0
66484259641,66484259641,0,1281,1768,0
66487293593,66487293593,0,1493,2094,0
66490508176,66490508179,3,650,929,0
66492397770,66492397770,0,1155,787,0
66492725845,66492725845,0,1438,1886,0
66494709590,66494709588,-2,1399,1455,0
66496135499,66496135501,2,1586,1741,0
66506934250,66506934250,0,1359,1585,0
66507750278,66507750278,0,1987,2286,0
66508600405,66508600405,0,1604,1150,0
66509981510,66509981511,1,1259,1871,0
66512185563,66512185563,0,680,1039,0
66513694319,66513694319,0,1482,1790,0
66513983337,66513983337,0,1272,1487,0
66516493098,66516493099,1,1436,2433,0
66517053960,66517053964,4,1695,1308,0
66517276714,66517276715,1,1094,1938,0
66522123227,66522123227,0,1519,2123,0
66522643047,66522643047,0,1204,1772,0
66523269195,66523269194,-1,1056,1597,0
66524289294,66524289292,-2,1478,1671,0
66525096127,66525096127,0,1705,2104,0
66525591063,66525591065,2,1256,1324,0
66527633706,66527633706,0,1360,1268,0
66528232326,66528232325,-1,1471,1811,0
66528589663,66528589662,-1,1711,1954,0
66532393913,66532393913,0,1394,1145,0
66536628635,66536628637,2,842,1165,0
66539293792,66539293793,1,1152,1346,0
66542855777,66542855780,3,1253,1498,0
66543691342,66543691341,-1,1361,2114,0
66545276994,66545276995,1,1689,1926,0
66547415194,66547415198,4,2338,1817,0
66549839157,66549839154,-3,1695,2489,0
66551826413,66551826415,2,1457,1457,0
66561514363,66561514361,-2,1096,1336,0
66562651834,66562651835,1,886,1089,0
66566579570,66566579573,3,1406,1641,0
66568856036,66568856042,6,2535,1338,0
66572694931,66572694934,3,1383,1946,0
66574515043,66574515038,-5,1429,2922,0
66574836299,66574836299,0,1529,1773,0
66579578860,66579578862,2,1569,1717,0
66582568935,66582568933,-2,1415,2092,0
66585497065,66585497065,0,1250,1173,0
66586156239,66586156239,0,1503,2181,0
66587527224,66587527224,0,1906,1790,0
66587555136,66587555136,0,1666,1938,0
66587840517,66587840510,-7,1074,2219,0
66591636646,66591636646,0,1181,1781,0
66591960004,66591960006,2,1396,1529,0
66593026841,66593026841,0,1849,1954,0
66593897594,66593897594,0,1442,1264,0
66594943190,66594943191,1,1918,1989,0
66596268462,66596268461,-1,1365,2205,0
66598841469,66598841470,1,1566,2024,0
66599934424,66599934428,4,1805,1672,0
66600679342,66600679347,5,4129,1805,0
66604576369,66604576368,-1,1819,1745,0
66610546639,66610546638,-1,1677,2698,0
66616805462,66616805462,0,1243,1973,0
66620523817,66620523818,1,1542,2278,0
66620662533,66620662534,1,909,1021,0
66621103451,66621103450,-1,1563,2249,0
66621207646,66621207647,1,1006,1179,0
66621280183,66621280186,3,1681,1611,0
66622687691,66622687691,0,1142,1316,0
66625672555,66625672554,-1,813,1279,0
66625997686,66625997687,1,1368,1784,0
66626477206,66626477207,1,1545,1638,0
66631819178,66631819178,0,1309,1539,0
66631915245,66631915245,0,1623,1334,0
66634207392,66634207391,-1,1742,1481,0
66640816894,66640816890,-4,1329,3155,0
66642297695,66642297694,-1,1020,1264,0
66643974566,66643974564,-2,1070,1615,0
66644642510,66644642510,0,1242,2304,0
66645646263,66645646279,16,656,1847,0
66653299714,66653299714,0,1316,1599,0
66656445552,66656445552,0,1711,1391,0
66658583818,66658583817,-1,1574,1933,0
66658788690,66658788690,0,1517,1955,0
66664639736,66664639737,1,1125,1448,0
66664769692,66664769685,-7,1416,1497,0
66666225396,66666225395,-1,2453,1693,0
66666611274,66666611269,-5,970,4809,0
66667925975,66667925974,-1,1672,2101,0
66671215710,66671215711,1,1428,1636,0
66672753810,66672753811,1,1461,1779,0
66674535687,66674535687,0,1064,1448,0
66674917302,66674917301,-1,1339,2041,0
66676306286,66676306287,1,1774,2375,0
66676457226,66676457226,0,1450,1620,0
66677457363,66677457364,1,825,1587,0
66677629189,66677629192,3,1012,1612,0
66678581683,66678581681,-2,1301,2034,0
66680267504,66680267506,2,1331,1413,0
66681163399,66681163402,3,1228,1513,0
66685668038,66685668035,-3,1353,1612,0
66686218906,66686218906,0,1402,1335,0
66686907471,66686907473,2,1594,2006,0
66687848446,66687848446,0,1513,1583,0
66695789860,66695789862,2,1863,1839,0
66696479511,66696479519,8,10893,23488,0
66701295024,66701295021,-3,1431,2169,0
66703710234,66703710240,6,5387,1937,0
66704427862,66704427864,2,830,894,0
66704492839,66704492839,0,1147,1089,0
66714534846,66714534845,-1,943,1561,0
66719905305,66719905285,-20,1355,1752,0
66720455546,66720455550,4,1516,1509,0
66722823495,66722823495,0,1425,1258,0
66723075838,66723075854,16,1290,1883,0
66724838747,66724838748,1,1525,1331,0
66725258410,66725258417,7,2163,1372,0
66727161419,66727161420,1,1234,1097,0
66727233957,66727233972,15,1771,1487,0
66727525560,66727525566,6,3483,1559,0
66728864013,66728864010,-3,1095,2079,0
66729188198,66729188202,4,1377,1271,0
66731522315,66731522317,2,1387,1432,0
66732598925,66732598923,-2,1239,1536,0
66733988942,66733988942,0,1348,1787,0
66734408799,66734408781,-18,1147,1477,0
66736964477,66736964474,-3,1023,2076,0
66737016967,66737016987,20,1363,1790,0
66741548781,66741548782,1,934,1657,0
66741641030,66741641031,1,2312,3103,0
66743139206,66743139206,0,1167,1551,0
66744118604,66744118606,2,1286,1967,0
66745323127,66745323129,2,1241,1477,0
66746536142,66746536142,0,1271,2007,0
66750124234,66750124235,1,1354,1839,0
66751638857,66751638857,0,1318,2096,0
66755793330,66755793330,0,954,1177,0
66757379784,66757379785,1,1817,1950,0
66767080029,66767080029,0,1338,1858,0
66770126607,66770126608,1,1876,2796,0
66773876626,66773876626,0,1148,2619,0
66774455389,66774455386,-3,966,864,0
66780788452,66780788452,0,1476,2454,0
66781021277,66781021298,21,857,1404,0
66781603494,66781603487,-7,1774,5887,0
66786154895,66786154896,1,1681,1969,0
66787913618,66787913619,1,1161,1170,0
66789733200,66789733202,2,2046,2160,0
66794131198,66794131197,-1,1803,2123,0
66794474174,66794474178,4,1340,1284,0
66798364487,66798364466,-21,1528,1462,0
66800563562,66800563562,0,1656,2099,0
66803126794,66803126793,-1,1065,2033,0
66803208569,66803208568,-1,1903,2703,0
66805269540,66805269534,-6,2595,8249,0
66810762086,66810762089,3,1751,1135,0
66812814735,66812814735,0,1073,2041,0
66814884250,66814884251,1,1105,1423,0
66816023057,66816023058,1,1427,1662,0
66819090294,66819090298,4,1325,1127,0
66821063489,66821063489,0,1492,1428,0
66821303519,66821303518,-1,1241,1859,0
66824141883,66824141883,0,1603,1562,0
66827806066,66827806067,1,1429,1462,0
66829093203,66829093203,0,1736,1495,0
66829284166,66829284164,-2,2008,5215,0
66830947741,66830947741,0,1253,1695,0
66831139935,66831139936,1,1229,1431,0
66834553837,66834553838,1,1290,1715,0
66837353093,66837353093,0,1482,2059,0
66838347243,66838347241,-2,1142,1820,0
66839238082,66839238078,-4,1342,1578,0
66840605245,66840605246,1,2453,1863,0
66841065896,66841065888,-8,36300,16011,0
66842059710,66842059710,0,989,1730,0
66846013328,66846013328,0,1173,2491,0
66853742098,66853742098,0,1594,2146,0
66854930162,66854930161,-1,982,1597,0
66857028948,66857028948,0,1095,1323,0
66857468822,66857468823,1,1121,1274,0
66858312053,66858312052,-1,1223,2079,0
66858871128,66858871128,0,1048,1695,0
66859009010,66859008988,-22,1292,672,0
66859904328,66859904330,2,1357,1259,0
66861093573,66861093574,1,1037,2118,0
66862419776,66862419776,0,1398,2112,0
66863323447,66863323446,-1,1218,1545,0
66864974924,66864974923,-1,1875,1543,0
66865002679,66865002679,0,929,880,0
66865838129,66865838130,1,1522,1423,0
66867361512,66867361515,3,1025,1051,0
66871861807,66871861808,1,1248,1911,0
66872984790,66872984795,5,22541,55989,0
66874026227,66874026228,1,1369,1998,0
66877677465,66877677465,0,1274,1667,0
66878679002,66878679004,2,1465,2018,0
66882287882,66882287885,3,832,1003,0
66882447506,66882447503,-3,1188,4814,0
66882908370,66882908373,3,966,1451,0
66886597050,66886597049,-1,1473,1569,0
66889075016,66889075017,1,1340,1157,0
66890802207,66890802208,1,1571,1569,0
66891074722,66891074727,5,1809,1695,0
66891546723,66891546718,-5,1233,4406,0
66893979142,66893979142,0,1433,1782,0
66894282857,66894282857,0,1703,2408,0
66894311115,66894311115,0,1585,1612,0
66896975940,66896975939,-1,1612,1691,0
66897219682,66897219682,0,1416,2084,0
66899846713,66899846715,2,1444,1430,0
66902845421,66902845426,5,1923,1182,0
66905644816,66905644818,2,1634,1256,0
66906133499,66906133498,-1,948,1851,0
66907222345,66907222346,1,1034,1510,0
66908899986,66908899987,1,1151,1482,0
66909779858,66909779858,0,1142,1423,0
66912251038,66912251030,-8,938,6062,0
66915515163,66915515163,0,1404,1361,0
66918554787,66918554780,-7,1023,3109,0
66918738546,66918738546,0,1399,1818,0
66919438458,66919438462,4,1527,1338,0
66920951413,66920951411,-2,2134,3207,0
66921081501,66921081502,1,2037,1412,0
66921519326,66921519327,1,999,1681,0
66921798454,66921798453,-1,1319,2898,0
66923939014,66923939017,3,2058,1841,0
66929413670,66929413674,4,952,1268,0
66929832490,66929832489,-1,1676,1820,0
66931522412,66931522412,0,1699,1762,0
66934016756,66934016757,1,1458,1723,0
66941343814,66941343815,1,2121,2008,0
66944353463,66944353464,1,886,1373,0
66947278559,66947278571,12,10138,37757,0
66949932052,66949932054,2,1087,1069,0
66951463137,66951463135,-2,830,1801,0
66951528601,66951528602,1,2233,1803,0
66952726842,66952726842,0,1215,1749,0
66960662310,66960662310,0,1495,1670,0
66963033074,66963033075,1,1549,1660,0
66965837666,66965837665,-1,1167,1661,0
66967165619,66967165617,-2,1227,1799,0
66973416741,66973416742,1,1590,1546,0
66974416112,66974416110,-2,1718,4063,0
66982748022,66982748025,3,2482,1585,0
66984627486,66984627486,0,1371,1051,0
66985833567,66985833566,-1,1202,1145,0
66989837871,66989837865,-6,1079,3002,0
66990136060,66990136059,-1,1346,1483,0
66992423171,66992423171,0,1255,1557,0
66992655451,66992655452,1,1254,1694,0
66995055225,66995055226,1,1885,2034,0
66995710156,66995710146,-10,1192,2043,0
66995859508,66995859526,18,6,1110,0
66999416765,66999416766,1,885,1249,0
67002241157,67002241159,2,1787,1671,0
67004208767,67004208767,0,1154,1803,0
67004289335,67004289351,16,488,1361,0
67006023902,67006023901,-1,1083,2310,0
67006157892,67006157893,1,1402,2299,0
67006316947,67006316946,-1,730,970,0
67006505466,67006505467,1,1663,1364,0
67012635087,67012635086,-1,609,1135,0
67015959474,67015959474,0,1534,1309,0
67017323409,67017323410,1,1758,1324,0
67019259700,67019259705,5,3194,1540,0
67019632002,67019632002,0,1071,1420,0
67024073198,67024073199,1,1121,1764,0
67026598557,67026598558,1,1388,1712,0
67026905729,67026905735,6,1528,1234,0
67029964521,67029964521,0,1705,2096,0
67030001747,67030001747,0,878,1372,0
67030625253,67030625250,-3,1531,1964,0
67032926334,67032926335,1,1318,900,0
67033531302,67033531303,1,1969,2261,0
67035731899,67035731898,-1,1260,1785,0
67036475457,67036475458,1,1826,1842,0
67038150670,67038150671,1,1153,2072,0
67038677604,67038677603,-1,893,1744,0
67040127673,67040127670,-3,1056,1867,0
67047704690,67047704689,-1,750,979,0
67048573035,67048573031,-4,1025,1295,0
67049235451,67049235453,2,1511,1632,0
67052710032,67052710035,3,1305,1321,0
67053182070,67053182070,0,848,1089,0
67054112008,67054112008,0,1477,1334,0
67064388730,67064388733,3,1769,1136,0
67066934211,67066934210,-1,1468,1776,0
67068465890,67068465891,1,1229,1266,0
67068656514,67068656511,-3,1918,2211,0
67070350070,67070350070,0,1490,1806,0
67070597058,67070597058,0,1383,1577,0
67070650459,67070650461,2,1623,1267,0
67077271251,67077271254,3,1319,1799,0
67082538498,67082538498,0,1643,1854,0
67083882170,67083882170,0,1347,1677,0
67084068013,67084068014,1,1841,1501,0
67085261534,67085261534,0,821,1601,0
67086601168,67086601170,2,1412,1566,0
67088199178,67088199178,0,1354,1484,0
67089844457,67089844455,-2,1384,1784,0
67092890602,67092890602,0,947,1490,0
67095534444,67095534442,-2,1123,1998,0
67096784754,67096784750,-4,1946,6273,0
67097090186,67097090185,-1,1918,2169,0
67097652152,67097652152,0,1528,2397,0
67098289934,67098289936,2,1385,1600,0
67098664810,67098664804,-6,1845,7673,0
67101001379,67101001360,-19,1856,1239,0
67104661474,67104661472,-2,1578,1625,0
67105250447,67105250446,-1,1200,1567,0
67106039082,67106039083,1,1693,1188,0
67106586450,67106586450,0,1565,1293,0
67108040246,67108040245,-1,1315,2099,0
67110578915,67110578914,-1,1024,1837,0
67112537148,67112537153,5,2503,1263,0
67115983291,67115983290,-1,1210,1581,0
67118054906,67118054909,3,1243,1543,0
67118769950,67118769950,0,1149,1726,0
67122418515,67122418514,-1,1534,1663,0
67122817626,67122817625,-1,1170,1526,0
67123857743,67123857743,0,1720,1590,0
67125921177,67125921178,1,1635,2188,0
67133079641,67133079641,0,1638,1615,0
67133138307,67133138306,-1,959,1218,0
67134491834,67134491835,1,1120,1274,0
67135520225,67135520225,0,1276,1917,0
67136827522,67136827522,0,837,1282,0
67139057124,67139057126,2,1023,1363,0
67143939721,67143939724,3,1757,1373,0
67150838192,67150838195,3,1253,1984,0
67154195219,67154195220,1,1990,2260,0
67159139355,67159139358,3,2111,2132,0
67166289439,67166289439,0,1607,2186,0
67166405535,67166405534,-1,28116,14866,0
67169676166,67169676167,1,1040,1030,0
67171715280,67171715281,1,1517,1958,0
67172897032,67172897035,3,1246,1331,0
67173018594,67173018594,0,2113,1679,0
67174248547,67174248545,-2,1030,1077,0
67174391781,67174391788,7,21030,66304,0
67174653152,67174653152,0,969,1397,0
67176213106,67176213111,5,719,1092,0
67181441993,67181441993,0,1078,1337,0
67182647938,67182647939,1,2002,2127,0
67186961001,67186961002,1,1239,1353,0
67188065882,67188065885,3,1634,1240,0
67188625798,67188625799,1,1695,2135,0
67189080612,67189080612,0,1308,1805,0
67190025305,67190025303,-2,1222,2220,0
67190979461,67190979461,0,1310,1636,0
67191425002,67191424998,-4,1192,2214,0
67195551356,67195551358,2,2062,1384,0
67195675762,67195675762,0,1550,1746,0
67197927325,67197927327,2,1156,1413,0
67199287251,67199287247,-4,843,1269,0
67201438349,67201438349,0,1146,1844,0
67205817861,67205817863,2,1010,2244,0
67206572951,67206572952,1,1559,1594,0
67206755101,67206755103,2,1260,1510,0
67208395179,67208395185,6,2097,1753,0
67212275412,67212275411,-1,1393,1971,0
67214015770,67214015774,4,2420,2657,0
67218027953,67218027952,-1,1968,2422,0
67220296317,67220296317,0,1131,1589,0
67223720657,67223720657,0,1107,1595,0
67231075273,67231075273,0,1131,1839,0
67231868633,67231868647,14,1345,1281,0
67235405522,67235405522,0,975,1635,0
67238243441,67238243443,2,1043,1082,0
67243174154,67243174157,3,1523,1308,0
67245144469,67245144470,1,1495,920,0
67245549974,67245549975,1,1783,1018,0
67246631062,67246631065,3,1732,2032,0
67247173311,67247173309,-2,1414,2052,0
67249298682,67249298682,0,1145,1364,0
67252451428,67252451431,3,1770,1704,0
67255737070,67255737070,0,1634,1989,0
67255808109,67255808110,1,1360,2290,0
67256006530,67256006530,0,1805,1938,0
67258133268,67258133269,1,1305,1692,0
67261206794,67261206786,-8,1724,241,0
67262872455,67262872453,-2,1124,1979,0
67269907498,67269907499,1,1335,1872,0
67272611142,67272611143,1,1250,1810,0
67276491198,67276491199,1,1053,1453,0
67279877561,67279877563,2,1934,1917,0
67282783634,67282783634,0,1176,1875,0
67289688671,67289688668,-3,994,1962,0
67291226622,67291226621,-1,1747,2208,0
67292952318,67292952318,0,1090,1242,0
67294051698,67294051698,0,809,1541,0
67297590708,67297590710,2,1799,1842,0
67299706141,67299706141,0,1248,1627,0
67307624737,67307624738,1,2499,1676,0
67311202436,67311202437,1,1138,1946,0
67311473871,67311473872,1,1449,1706,0
67312333698,67312333698,0,1982,2549,0
67317151022,67317151022,0,1521,1586,0
67320497789,67320497790,1,1521,1225,0
67320685187,67320685188,1,1495,2080,0
67323630827,67323630830,3,1202,1350,0
67331782283,67331782284,1,1529,1740,0
67335874855,67335874855,0,1583,1625,0
67336090911,67336090913,2,1198,1508,0
67336522793,67336522793,0,1464,2016,0
67336686266,67336686269,3,2017,1550,0
67340003560,67340003561,1,1456,1952,0
67346744179,67346744180,1,1294,1770,0
67346823816,67346823815,-1,1561,2162,0
67350352138,67350352142,4,1308,2075,0
67353131003,67353131004,1,1553,2056,0
67353320542,67353320543,1,1515,2087,0
67354589997,67354589996,-1,1424,1822,0
67355150378,67355150379,1,1052,1825,0
67355747381,67355747382,1,1084,1578,0
67357709695,67357709694,-1,1345,1519,0
67360493842,67360493843,1,1542,1694,0
67360720241,67360720243,2,944,1102,0
67362189716,67362189716,0,1692,2484,0
67364544514,67364544514,0,1347,2027,0
67364752398,67364752395,-3,1621,2242,0
67369065093,67369065092,-1,2037,2371,0
67371924982,67371924982,0,1308,1412,0
67374646177,67374646175,-2,1373,2397,0
67378106290,67378106290,0,1563,2280,0
67378296145,67378296150,5,1901,1426,0
67384346193,67384346194,1,1536,1466,0
67384880353,67384880353,0,1399,1806,0
67386580482,67386580481,-1,1239,1562,0
67389922735,67389922734,-1,747,1363,0
67396350190,67396350191,1,903,1192,0
67398485475,67398485477,2,1735,1509,0
67398752998,67398753005,7,1552,1128,0
67403568753,67403568757,4,31530,31559,0
67404341042,67404341043,1,1945,1255,0
67405347213,67405347213,0,1754,2194,0
67405990507,67405990509,2,1809,1584,0
67408713774,67408713775,1,927,1565,0
67411033810,67411033807,-3,813,1240,0
67411713647,67411713649,2,1398,1605,0
67411753602,67411753606,4,3507,2415,0
67412182301,67412182302,1,2104,1948,0
67416938617,67416938615,-2,1433,2444,0
67417845534,67417845535,1,686,994,0
67418236546,67418236541,-5,1211,1795,0
67418842090,67418842093,3,1382,2043,0
67419970014,67419970014,0,1476,1270,0
67422954747,67422954746,-1,1222,1279,0
67424064386,67424064387,1,1116,2217,0
67425134430,67425134430,0,9294,12059,0
67425800501,67425800502,1,1284,1647,0
67427092438,67427092435,-3,1228,2196,0
67427138324,67427138328,4,1692,1232,0
67430254229,67430254216,-13,1619,812,0
67434023365,67434023366,1,1500,1194,0
67434833389,67434833389,0,990,1439,0
67436439374,67436439377,3,1168,1471,0
67440695215,67440695217,2,1634,2043,0
67441423954,67441423958,4,1183,1234,0
67441702507,67441702507,0,1373,1352,0
67446489143,67446489143,0,1034,1522,0
67447091455,67447091454,-1,1400,1905,0
67451756601,67451756601,0,1398,2589,0
67451877546,67451877545,-1,1503,2459,0
67452760574,67452760575,1,1656,1691,0
67453886686,67453886687,1,1171,1342,0
67454931956,67454931975,19,574,723,0
67463986599,67463986601,2,1514,1539,0
67464583032,67464583031,-1,1764,1719,0
67465611338,67465611337,-1,1702,1607,0
67467909810,67467909810,0,1871,2445,0
67469691960,67469691959,-1,1289,1567,0
67470743324,67470743333,9,2790,1201,0
67473413893,67473413893,0,1133,1163,0
67475942434,67475942438,4,1630,1720,0
67475977805,67475977807,2,1144,1601,0
67478078019,67478078025,6,3390,853,0
67478143629,67478143629,0,1173,2004,0
67482014833,67482014834,1,1523,1807,0
67482425810,67482425810,0,1577,1649,0
67483061098,67483061098,0,2434,2213,0
67485087214,67485087214,0,1048,865,0
67492886541,67492886542,1,1149,988,0
67494034046,67494034046,0,1583,2099,0
67502240593,67502240593,0,1519,2200,0
67503452262,67503452262,0,1168,1583,0
67503581217,67503581215,-2,2114,2311,0
67505248753,67505248752,-1,1768,1325,0
67506278345,67506278327,-18,2116,1405,0
67512555379,67512555382,3,1749,1885,0
67516070690,67516070691,1,1310,1504,0
67516606050,67516606051,1,1094,1572,0
67517243154,67517243153,-1,1435,1601,0
67517935943,67517935945,2,1470,1875,0
67518728175,67518728178,3,1641,1536,0
67520152393,67520152392,-1,1751,1783,0
67524233813,67524233813,0,1527,1598,0
67524702817,67524702819,2,912,1209,0
67525077959,67525077959,0,1342,1796,0
67526089635,67526089635,0,1585,1738,0
67527529155,67527529150,-5,2310,7649,0
67528265414,67528265416,2,1211,1427,0
67529062195,67529062199,4,2514,1347,0
67531440735,67531440738,3,2084,1664,0
67535032078,67535032075,-3,1025,1046,0
67540430125,67540430126,1,1236,1510,0
67543205870,67543205871,1,1764,1836,0
67545434223,67545434230,7,3074,1757,0
67549876412,67549876411,-1,1547,2032,0
67551422569,67551422569,0,1683,1759,0
67554030521,67554030522,1,1969,2183,0
67554070413,67554070412,-1,1285,1638,0
67560225086,67560225087,1,1432,815,0
67560326985,67560326964,-21,1856,2164,0
67561558580,67561558582,2,1903,1597,0
67564306635,67564306635,0,810,1709,0
67568209670,67568209670,0,1479,2020,0
67568557134,67568557133,-1,1640,2119,0
67568586750,67568586752,2,1454,1871,0
67569520706,67569520707,1,1187,1360,0
67574687301,67574687301,0,865,1058,0
67576569979,67576569978,-1,751,878,0
67579434874,67579434873,-1,1606,1749,0
67580110437,67580110437,0,1436,1747,0
67581383586,67581383586,0,1631,1499,0
67582644082,67582644082,0,1104,1666,0
67584356278,67584356278,0,917,1318,0
67584495066,67584495065,-1,1447,2004,0
67584532608,67584532611,3,1668,1177,0
67584694946,67584694967,21,858,1029,0
67585404742,67585404743,1,1571,1860,0
67586747618,67586747612,-6,1004,3790,0
67592840844,67592840845,1,2259,1578,0
67593933929,67593933923,-6,1525,1374,0
67594004413,67594004407,-6,1182,1550,0
67597285617,67597285617,0,1702,1769,0
67597992212,67597992217,5,3895,1412,0
67603553819,67603553817,-2,1483,1530,0
67604963025,67604963026,1,1157,1744,0
67607311426,67607311425,-1,1326,1768,0
67607567536,67607567536,0,1845,1959,0
67609366622,67609366625,3,1336,1735,0
67610452338,67610452340,2,1138,1067,0
67612257497,67612257497,0,1667,1421,0
67613509696,67613509698,2,1084,1391,0
67613902044,67613902046,2,1498,1767,0
67614765133,67614765134,1,1131,1416,0
67614980187,67614980188,1,1192,1689,0
67615464201,67615464201,0,1292,1307,0
67618307612,67618307615,3,1240,1248,0
67621968970,67621968968,-2,1412,2148,0
67625658608,67625658607,-1,1298,1751,0
67627588865,67627588863,-2,1449,1339,0
67630179449,67630179450,1,1205,2573,0
67632537295,67632537297,2,1612,1046,0
67642972458,67642972458,0,989,1591,0
67647364915,67647364917,2,1175,1536,0
67650578985,67650578985,0,1783,2598,0
67652635534,67652635538,4,2986,1796,0
67653875298,67653875298,0,1499,1838,0
67654790914,67654790914,0,1401,1402,0
67656907090,67656907089,-1,1298,1817,0
67657341274,67657341273,-1,1136,1265,0
67660701486,67660701493,7,2002,1041,0
67661856004,67661856009,5,130,2762,0
67662093192,67662093193,1,1621,1893,0
67664201897,67664201898,1,1063,1414,0
67665526759,67665526759,0,1558,2418,0
67668604246,67668604246,0,1327,1889,0
67669546652,67669546653,1,1520,1806,0
67670519794,67670519786,-8,696,2802,0
67671668329,67671668329,0,1354,1636,0
67671722230,67671722230,0,893,1063,0
67673350169,67673350170,1,2012,1960,0
67673785110,67673785114,4,2686,1030,0
67673994788,67673994791,3,1787,1856,0
67676510742,67676510742,0,1144,1078,0
67680265710,67680265710,0,1576,1442,0
67680570019,67680570018,-1,1194,1973,0
67681280820,67681280819,-1,1517,1593,0
67681313539,67681313541,2,868,1683,0
67682135958,67682135957,-1,1674,2358,0
67682538478,67682538480,2,2374,1654,0
67683714375,67683714378,3,1370,1739,0
67684724794,67684724793,-1,1330,2831,0
67684989642,67684989643,1,1240,1899,0
67685026045,67685026066,21,1086,1821,0
67685700006,67685700008,2,1247,1629,0
67687027551,67687027551,0,1427,1451,0
67687895435,67687895433,-2,1889,2243,0
67692276745,67692276745,0,1148,1684,0
67693623774,67693623772,-2,1214,1761,0
67696092863,67696092863,0,1814,2086,0
67701995958,67701995956,-2,1205,1401,0
67705694062,67705694062,0,1713,2470,0
67712336532,67712336533,1,1536,1774,0
67714240882,67714240883,1,1536,1523,0
67716794223,67716794222,-1,1499,1486,0
67722695449,67722695454,5,3124,1204,0
67723213130,67723213133,3,816,1257,0
67723781810,67723781810,0,1435,1648,0
67727043678,67727043678,0,1477,1542,0
67731898142,67731898144,2,1483,1210,0
67733870178,67733870178,0,42921,5026,0
67734049512,67734049510,-2,1177,1262,0
67734851566,67734851567,1,1419,1968,0
67736405724,67736405727,3,1674,1121,0
67736750823,67736750823,0,1107,1195,0
67737206367,67737206347,-20,141,1464,0
67740886196,67740886196,0,1571,2132,0
67741688831,67741688818,-13,1681,1840,0
67743934991,67743934990,-1,1195,1119,0
67743980777,67743980760,-17,1317,1038,0
67753748163,67753748165,2,1203,1542,0
67756593331,67756593326,-5,1335,2566,0
67756664491,67756664490,-1,684,792,0
67758352710,67758352709,-1,1932,2051,0
67758740549,67758740548,-1,1332,1443,0
67761584718,67761584717,-1,1376,1624,0
67763033593,67763033594,1,2002,2091,0
67764650208,67764650207,-1,1995,2703,0
67767580333,67767580334,1,1512,1687,0
67769188329,67769188329,0,1566,1622,0
67769779130,67769779130,0,1367,1565,0
67769837542,67769837549,7,2324,1288,0
67771477182,67771477182,0,1038,1761,0
67773028691,67773028694,3,1147,1147,0
67773689173,67773689173,0,1770,2526,0
67774391315,67774391317,2,1297,1586,0
67775734434,67775734430,-4,683,1870,0
67775929575,67775929572,-3,1497,1838,0
67776723030,67776723030,0,1001,1234,0
67781979077,67781979077,0,1099,1252,0
67789313686,67789313687,1,1662,1228,0
67790464441,67790464445,4,1722,1898,0
67790973949,67790973951,2,1328,1897,0
67794187230,67794187230,0,1498,1621,0
67794832842,67794832841,-1,1315,1319,0
67798219784,67798219783,-1,1288,1839,0
67799273138,67799273141,3,1060,1694,0
67800322207,67800322209,2,1179,1663,0
67802917102,67802917102,0,1070,1782,0
67805169887,67805169887,0,1450,1870,0
67805247122,67805247125,3,1740,1684,0
67806480129,67806480127,-2,1188,1864,0
67809628758,67809628757,-1,2676,4116,0
67810646585,67810646587,2,1411,1704,0
67812103690,67812103688,-2,948,1199,0
67818367158,67818367157,-1,1485,2189,0
67818965166,67818965165,-1,1200,1973,0
67820615890,67820615890,0,1220,1206,0
67821327490,67821327490,0,1417,2138,0
67824088791,67824088791,0,1402,1463,0
67829645774,67829645778,4,1724,1266,0
67830052804,67830052803,-1,1239,1254,0
67831557022,67831557024,2,846,1183,0
67839815675,67839815677,2,2502,1845,0
67840057040,67840057039,-1,2218,2506,0
67840611840,67840611839,-1,1335,1622,0
67842050864,67842050863,-1,1300,1494,0
67843487478,67843487477,-1,1689,2610,0
67846349639,67846349639,0,1460,1605,0
67847338755,67847338756,1,1376,2285,0
67847980550,67847980551,1,1944,1887,0
67849357066,67849357066,0,1393,1396,0
67851615003,67851615004,1,1526,2211,0
67853449903,67853449903,0,1433,1554,0
67857752379,67857752377,-2,1319,1767,0
67857886623,67857886621,-2,901,1335,0
67859585579,67859585581,2,1128,1723,0
67862354001,67862354007,6,5550,2719,0
67865157914,67865157909,-5,1035,3318,0
67865608646,67865608642,-4,754,2454,0
67866005372,67866005373,1,1351,2271,0
67873407159,67873407157,-2,1481,1903,0
67875441711,67875441711,0,1826,1600,0
67876216938,67876216937,-1,991,1236,0
67877753206,67877753205,-1,1976,2337,0
67878244886,67878244890,4,1712,753,0
67881116245,67881116246,1,1098,1984,0
67881639744,67881639743,-1,1203,1378,0
67884476872,67884476871,-1,1030,1671,0
67884710035,67884710035,0,865,1174,0
67885925882,67885925882,0,734,1657,0
67887047351,67887047353,2,1321,1734,0
67887891411,67887891413,2,1904,2558,0
67887922006,67887922007,1,1528,1537,0
67889263171,67889263170,-1,1349,1472,0
67891226022,67891226023,1,1076,1551,0
67892189312,67892189330,18,668,885,0
67897783661,67897783664,3,1500,1667,0
67900119135,67900119135,0,1189,2036,0
67900501174,67900501177,3,11091,26760,0
67901050708,67901050710,2,1163,1004,0
67904022330,67904022338,8,4884,36007,0
67904527659,67904527661,2,1198,1476,0
67905779994,67905779994,0,1385,2944,0
67906960698,67906960699,1,1451,1498,0
67921497709,67921497710,1,1307,1893,0
67923216637,67923216637,0,1517,1320,0
67923440345,67923440346,1,1188,1713,0
67926324021,67926324022,1,1113,1535,0
67929013716,67929013715,-1,1133,1857,0
67929200367,67929200354,-13,1489,1223,0
67933275180,67933275178,-2,1244,1714,0
67934586628,67934586627,-1,1114,1191,0
67935420351,67935420350,-1,801,834,0
67937046375,67937046374,-1,1593,1702,0
67943154097,67943154102,5,5182,22797,0
67949195174,67949195175,1,1821,2567,0
67950988973,67950988973,0,1449,1604,0
67952325753,67952325754,1,1723,1846,0
67952907913,67952907914,1,1318,1503,0
67956743266,67956743266,0,948,989,0
67956915462,67956915442,-20,1586,1466,0
67958059543,67958059543,0,832,1472,0
67959638173,67959638173,0,1451,1854,0
67960972909,67960972910,1,1672,1378,0
67963967082,67963967082,0,1503,2488,0
67965443012,67965443012,0,1158,2050,0
67968576722,67968576722,0,1688,1527,0
67969323685,67969323684,-1,1362,1874,0
67973044114,67973044114,0,506,1009,0
67973945310,67973945309,-1,1338,2259,0
67975095503,67975095500,-3,1109,1617,0
67976674259,67976674261,2,1585,1705,0
67982073085,67982073084,-1,1325,1394,0
67983358010,67983358009,-1,937,1988,0
67985405830,67985405830,0,1704,1824,0
67987307050,67987307050,0,1452,1957,0
67987623456,67987623456,0,1442,2000,0
67988569038,67988569038,0,1076,1133,0
67995934774,67995934774,0,1679,1977,0
67996480349,67996480349,0,1721,2208,0
68002388065,68002388065,0,1476,2072,0
68003227141,68003227141,0,957,1453,0
68004033903,68004033904,1,1740,2021,0
68006121298,68006121298,0,1773,2013,0
68007837078,68007837078,0,859,1173,0
68008405951,68008405950,-1,1153,1745,0
68009039663,68009039663,0,1335,1335,0
68010341841,68010341838,-3,1158,2231,0
68011695566,68011695569,3,1234,1873,0
68012967658,68012967657,-1,762,1463,0
68014972315,68014972313,-2,1847,2317,0
68017668122,68017668127,5,886,1205,0
68018670195,68018670195,0,1600,1658,0
68020428690,68020428688,-2,1952,2280,0
68022399369,68022399370,1,1995,2232,0
68022663215,68022663215,0,1329,1189,0
68023355226,68023355229,3,4667,2084,0
68023612654,68023612654,0,1609,1948,0
68023887768,68023887783,15,393,554,0
68033040830,68033040834,4,2257,1362,0
68034325661,68034325663,2,896,1627,0
68036144402,68036144407,5,2015,1154,0
68036872630,68036872632,2,1604,1841,0
68037255391,68037255390,-1,1541,2032,0
68039174138,68039174139,1,1394,1603,0
68043715279,68043715279,0,1307,1951,0
68044697114,68044697114,0,1466,1294,0
68045733073,68045733073,0,1571,1347,0
68049340986,68049340986,0,1779,1618,0
68049637270,68049637263,-7,714,3900,0
68050725275,68050725275,0,1244,1823,0
68051319445,68051319447,2,1225,1813,0
68055392446,68055392446,0,1609,1682,0
68057164361,68057164362,1,965,1374,0
68058556828,68058556829,1,1504,1477,0
68062935911,68062935911,0,1350,1179,0
68063897121,68063897121,0,1586,1369,0
68064192214,68064192213,-1,1045,1847,0
68065017388,68065017391,3,1415,1628,0
68065460537,68065460537,0,1081,1885,0
68066828058,68066828059,1,1773,1482,0
68068855158,68068855159,1,1049,1607,0
68072852274,68072852274,0,583,1887,0
68073126847,68073126848,1,1515,1732,0
68074249343,68074249342,-1,1056,2054,0
68077150486,68077150486,0,2892,3398,0
68084585383,68084585384,1,1535,2084,0
68086510102,68086510104,2,1164,1625,0
68089916390,68089916390,0,2182,1922,0
68090616474,68090616476,2,1186,1715,0
68090645829,68090645818,-11,1365,1251,0
68093351443,68093351443,0,1458,2066,0
68093436984,68093436986,2,1635,1980,0
68095455025,68095455030,5,4803,2314,0
68098542557,68098542560,3,1127,1712,0
68098619122,68098619122,0,1298,2380,0
68100515959,68100515958,-1,1087,1309,0
68100883043,68100883045,2,1899,1787,0
68101566567,68101566569,2,1560,1725,0
68102095199,68102095198,-1,985,1698,0
68104301811,68104301812,1,1215,1833,0
68107875470,68107875470,0,1089,1705,0
68110821042,68110821042,0,1112,1933,0
68112166075,68112166074,-1,1138,1313,0
68121233588,68121233588,0,1997,2374,0
68121896271,68121896273,2,1107,1916,0
68127176653,68127176654,1,1224,1976,0
68127444243,68127444241,-2,1268,1889,0
68128413552,68128413552,0,1630,1616,0
68132522485,68132522486,1,1868,2037,0
68134465198,68134465197,-1,1882,1913,0
68134681766,68134681765,-1,1474,1806,0
68135151695,68135151695,0,1844,2337,0
68135350123,68135350122,-1,986,1376,0
68136220326,68136220329,3,1289,1955,0
68138127747,68138127766,19,1345,1370,0
68139674162,68139674161,-1,1543,2400,0
68141115490,68141115491,1,1282,1436,0
68141470623,68141470621,-2,907,1305,0
68143591493,68143591494,1,1653,1758,0
68149131154,68149131154,0,1460,1416,0
68150148424,68150148423,-1,1101,1871,0
68153212213,68153212214,1,1485,1802,0
68154251737,68154251737,0,1008,1912,0
68157690085,68157690086,1,1587,2215,0
68159234579,68159234582,3,1570,1940,0
68159645261,68159645262,1,1569,2168,0
68159685750,68159685748,-2,1708,2366,0
68160248736,68160248737,1,1373,1702,0
68160492857,68160492840,-17,2490,1136,0
68161110929,68161110934,5,56646,30693,0
68164697743,68164697743,0,1171,1776,0
68165805158,68165805161,3,2020,1705,0
68166614462,68166614464,2,1497,1785,0
68168378699,68168378701,2,1643,1927,0
68168629137,68168629135,-2,1281,1570,0
68173294962,68173294961,-1,1313,2316,0
68177447758,68177447754,-4,1214,2699,0
68182300697,68182300697,0,1256,1599,0
68187306542,68187306545,3,1954,1646,0
68187938563,68187938565,2,1160,1686,0
68189292235,68189292236,1,1367,1904,0
68189508109,68189508117,8,2300,1341,0
68194951874,68194951876,2,1964,2217,0
68195004608,68195004607,-1,1152,2110,0
68195281396,68195281419,23,943,2821,0
68195837999,68195837998,-1,1982,1760,0
68195902977,68195902977,0,1468,1386,0
68196552530,68196552528,-2,1079,1453,0
68198793715,68198793713,-2,1520,2463,0
68201732058,68201732057,-1,993,2266,0
68202621942,68202621942,0,969,1501,0
68206658031,68206658030,-1,1581,2147,0
68206994655,68206994654,-1,1545,1565,0
68209963539,68209963540,1,1222,2042,0
68210635806,68210635808,2,1388,1573,0
68211154440,68211154443,3,1879,2023,0
68211913055,68211913055,0,1018,1620,0
68212596334,68212596335,1,1093,1196,0
68213482385,68213482387,2,1630,1605,0
68222223928,68222223928,0,1767,1467,0
68222748226,68222748205,-21,1284,1231,0
68222788243,68222788248,5,1694,1310,0
68225660342,68225660343,1,1281,1814,0
68226378549,68226378549,0,1649,1379,0
68229881521,68229881523,2,2003,2502,0
68231054658,68231054658,0,1477,1939,0
68231441485,68231441485,0,1389,1539,0
68235442052,68235442046,-6,1749,6849,0
68235832329,68235832330,1,1593,2283,0
68236459954,68236459955,1,1386,1289,0
68236490884,68236490882,-2,1133,1366,0
68237955326,68237955332,6,3375,1481,0
68238515127,68238515129,2,1844,1951,0
68239942733,68239942735,2,1274,1682,0
68240181782,68240181780,-2,1337,1849,0
68241976281,68241976281,0,1350,2147,0
68243400241,68243400242,1,1284,1515,0
68247939916,68247939916,0,2453,2528,0
68247999408,68247999406,-2,1297,1651,0
68250199738,68250199743,5,3109,1851,0
68251884242,68251884242,0,1460,2067,0
68253788221,68253788221,0,919,1578,0
68255142206,68255142207,1,1746,1620,0
68255290351,68255290349,-2,1032,1891,0
68257164599,68257164599,0,1423,1894,0
68257386947,68257386946,-1,1280,1695,0
68260265565,68260265565,0,1238,1360,0
68261137521,68261137517,-4,1380,2981,0
68261553325,68261553326,1,1132,1476,0
68264126826,68264126821,-5,1883,8774,0
68267259208,68267259210,2,1174,1631,0
68268225290,68268225291,1,1779,1544,0
68269305123,68269305103,-20,1347,2659,0
68276857542,68276857543,1,1074,1347,0
68278031262,68278031263,1,1179,1183,0
68278646703,68278646704,1,1432,1355,0
68280019780,68280019779,-1,1326,2080,0
68284587195,68284587194,-1,1131,2102,0
68284713745,68284713746,1,1346,1872,0
68287222578,68287222575,-3,1171,1244,0
68287710498,68287710498,0,1396,1925,0
68289438259,68289438260,1,1291,1410,0
68289563423,68289563406,-17,1384,1981,0
68290633671,68290633673,2,1797,1692,0
68295049646,68295049647,1,1124,1314,0
68295683610,68295683610,0,978,1974,0
68297803645,68297803644,-1,1324,1643,0
68299464002,68299464002,0,1330,1624,0
68300394702,68300394705,3,1419,1213,0
68302340092,68302340094,2,1535,1347,0
68304080924,68304080926,2,910,1956,0
68305426238,68305426238,0,1468,1878,0
68305527425,68305527426,1,1758,1718,0
68305600409,68305600413,4,1843,1357,0
68307172682,68307172682,0,1334,1645,0
68307601246,68307601247,1,1728,1691,0
68309128766,68309128765,-1,1228,1539,0
68311232942,68311232944,2,2327,1454,0
68312389784,68312389785,1,1657,1623,0
68313909951,68313909953,2,1368,1796,0
68316533551,68316533552,1,1640,1659,0
68316908522,68316908521,-1,1507,2142,0
68320678254,68320678254,0,1427,1492,0
68320844602,68320844603,1,1331,1727,0
68321969267,68321969267,0,1106,1719,0
68322874998,68322874998,0,1496,2065,0
68325740633,68325740631,-2,1057,1205,0
68332722333,68332722333,0,1333,1472,0
68341966006,68341966006,0,1122,1669,0
68348204442,68348204442,0,1361,1701,0
68349259429,68349259431,2,1608,1534,0
68354642037,68354642037,0,1359,1498,0
68358766067,68358766067,0,1731,1341,0
68359025803,68359025803,0,1240,2407,0
68360816979,68360816979,0,1752,1993,0
68362308282,68362308284,2,18824,23402,0
68364679462,68364679460,-2,1454,1733,0
68366565181,68366565182,1,1507,1962,0
68368332917,68368332920,3,1590,1640,0
68370276232,68370276233,1,1152,1246,0
68370860774,68370860774,0,1478,1651,0
68371439342,68371439343,1,1709,1859,0
68372835057,68372835059,2,2071,2171,0
68376298782,68376298782,0,1701,1982,0
68377255342,68377255345,3,1852,1851,0
68379339834,68379339813,-21,1014,1355,0
68380219961,68380219961,0,1672,1746,0
68381619831,68381619831,0,1071,1822,0
68384638606,68384638609,3,1330,1587,0
68386363918,68386363920,2,1437,1459,0
68390549720,68390549723,3,1797,2057,0
68390638578,68390638579,1,1426,1409,0
68391888806,68391888806,0,1124,1616,0
68392463774,68392463757,-17,1655,2315,0
68393106570,68393106569,-1,1407,1680,0
68393933842,68393933842,0,1568,1982,0
68394314243,68394314245,2,1872,1414,0
68394514242,68394514242,0,856,1261,0
68397407289,68397407289,0,1500,2195,0
68397676951,68397676951,0,1638,1627,0
68398198634,68398198634,0,1164,2614,0
68398423586,68398423588,2,1577,1244,0
68400629483,68400629484,1,1406,2257,0
68403434857,68403434857,0,1152,881,0
68404471585,68404471586,1,1256,1376,0
68406399267,68406399268,1,1628,1318,0
68406909455,68406909455,0,1399,1540,0
68407422401,68407422402,1,927,1353,0
68407672532,68407672531,-1,1512,1308,0
68413377830,68413377832,2,1663,1377,0
68416029619,68416029617,-2,1145,1617,0
68416638571,68416638573,2,863,1148,0
68416953751,68416953751,0,1553,1815,0
68420991719,68420991719,0,1461,2124,0
68421208390,68421208386,-4,951,1958,0
68425305316,68425305310,-6,1416,3529,0
68427627133,68427627131,-2,1358,1439,0
68427814073,68427814073,0,1501,1528,0
68428893643,68428893642,-1,1979,3289,0
68432172280,68432172281,1,1796,1933,0
68440115263,68440115269,6,2298,1569,0
68441089151,68441089129,-22,1415,3916,0
68443241710,68443241713,3,1100,1235,0
68445786778,68445786782,4,2071,1771,0
68448727833,68448727834,1,1187,1515,0
68450933774,68450933774,0,1866,2020,0
68451382108,68451382111,3,1407,1202,0
68452832570,68452832570,0,1656,2064,0
68458193126,68458193128,2,1429,2116,0
68458402095,68458402115,20,1334,1518,0
68460552248,68460552247,-1,1456,1886,0
68463220051,68463220046,-5,1962,5745,0
68464596494,68464596493,-1,1226,1864,0
68464867557,68464867557,0,1103,1694,0
68468381764,68468381766,2,1332,1572,0
68472418207,68472418209,2,1314,1712,0
68473312491,68473312492,1,1201,1890,0
68473855481,68473855479,-2,955,1936,0
68474359357,68474359359,2,1982,1988,0
68475444571,68475444569,-2,1876,2157,0
68478492845,68478492841,-4,1020,2153,0
68480695355,68480695359,4,1275,940,0
68481835574,68481835573,-1,1351,2601,0
68482207950,68482207952,2,1673,1674,0
68483491206,68483491205,-1,1127,1448,0
68484586161,68484586167,6,5467,2550,0
68484866097,68484866098,1,1266,2337,0
68485046027,68485046028,1,2033,2082,0
68489766242,68489766240,-2,1319,1620,0
68490728749,68490728749,0,1588,2195,0
68491231630,68491231630,0,1552,1894,0
68491675976,68491675975,-1,1463,2637,0
68492073106,68492073106,0,917,1545,0
68493192678,68493192675,-3,907,1712,0
68499337661,68499337661,0,1348,1381,0
68500111230,68500111234,4,1922,1324,0
68500946881,68500946884,3,1984,1108,0
68502656819,68502656819,0,1595,1916,0
68503778670,68503778672,2,1799,2017,0
68509323394,68509323392,-2,677,1186,0
68511747405,68511747405,0,1273,1756,0
68515486552,68515486552,0,1993,2212,0
68518993190,68518993190,0,1140,1506,0
68520384763,68520384757,-6,817,3228,0
68527185965,68527185965,0,1303,1381,0
68528325402,68528325398,-4,1775,5626,0
68528990593,68528990592,-1,1131,1333,0
68535204632,68535204633,1,1701,1508,0
68537195818,68537195818,0,1145,1606,0
68538417904,68538417903,-1,1321,1243,0
68540218631,68540218610,-21,1540,827,0
68542894131,68542894126,-5,1425,2827,0
68547095804,68547095803,-1,1448,2594,0
68548310790,68548310790,0,1199,2054,0
68551180631,68551180616,-15,1556,190,0
68551585602,68551585598,-4,17037,16769,0
68553875453,68553875453,0,1770,2521,0
68555733261,68555733261,0,1422,1889,0
68558177406,68558177408,2,23458,39165,0
68558629362,68558629363,1,2102,2196,0
68560646411,68560646411,0,1172,1098,0
68563363429,68563363431,2,1447,1492,0
68564869655,68564869656,1,1705,2255,0
68565139016,68565139015,-1,1173,1952,0
68567921922,68567921928,6,2621,1113,0
68568512733,68568512733,0,1016,1165,0
68577728143,68577728143,0,1086,1917,0
68578150582,68578150583,1,1182,1725,0
68580254312,68580254312,0,1569,1561,0
68584948953,68584948955,2,2041,1231,0
68587455018,68587455018,0,1034,1635,0
68588283947,68588283946,-1,1541,2194,0
68589844349,68589844348,-1,1081,1724,0
68592511290,68592511289,-1,1286,1463,0
68596814902,68596814901,-1,1298,1424,0
68598018030,68598018048,18,2471,1022,0
68603983929,68603983935,6,4596,2150,0
68610163035,68610163036,1,1211,1360,0
68612152693,68612152693,0,1767,1459,0
68613133893,68613133894,1,1607,1374,0
68614816000,68614816000,0,1509,2081,0
68618272330,68618272330,0,1319,1845,0
68618457956,68618457959,3,1773,1681,0
68621647066,68621647068,2,835,1531,0
68623164528,68623164526,-2,1781,1669,0
68623801330,68623801330,0,1086,1281,0
68626261157,68626261158,1,1821,1850,0
68626419842,68626419843,1,1857,1388,0
68628086062,68628086062,0,1086,1413,0
68634515145,68634515149,4,1244,747,0
68634791089,68634791089,0,1920,1938,0
68637565390,68637565394,4,2019,1490,0
68637696301,68637696301,0,1616,1718,0
68639110084,68639110090,6,3227,1284,0
68642925558,68642925557,-1,1279,1750,0
68646332608,68646332609,1,1806,2368,0
68646440369,68646440370,1,1570,1713,0
68648310110,68648310106,-4,20178,16253,0
68652090102,68652090102,0,1435,1950,0
68653028742,68653028741,-1,1224,1965,0
68653772725,68653772727,2,1570,1682,0
68658399458,68658399459,1,1412,1759,0
68658498805,68658498807,2,1112,1126,0
68659491088,68659491088,0,1084,1214,0
68664434367,68664434367,0,1613,2403,0
68664942037,68664942040,3,674,1100,0
68665341295,68665341294,-1,1345,1597,0
68667232273,68667232269,-4,1219,1755,0
68669953092,68669953092,0,1235,1640,0
68671482030,68671482032,2,2081,1548,0
68676512717,68676512710,-7,2061,9163,0
68677531297,68677531298,1,1014,1564,0
68683461738,68683461738,0,1427,1915,0
68684407333,68684407317,-16,81,1134,0
68685125062,68685125063,1,763,1360,0
68689321086,68689321085,-1,1308,1795,0
68692447154,68692447154,0,1571,1836,0
68692795579,68692795579,0,1505,1533,0
68695890569,68695890570,1,1513,1872,0
68697641370,68697641372,2,1592,1478,0
68698474922,68698474922,0,1212,1569,0
68699734984,68699734985,1,1349,2330,0
68701437923,68701437924,1,1249,1476,0
68704493491,68704493491,0,1287,2123,0
68707757134,68707757137,3,1010,1817,0
68708434133,68708434131,-2,1499,1479,0
68709677879,68709677879,0,1687,1585,0
68711975861,68711975862,1,1833,2040,0
68712071747,68712071748,1,1188,1628,0
68714510734,68714510735,1,1527,1908,0
68721750390,68721750390,0,1177,1093,0
68721994395,68721994397,2,1961,1686,0
68723351387,68723351387,0,1581,1578,0
68725422951,68725422953,2,1625,1371,0
68729567721,68729567724,3,875,1206,0
68731397374,68731397373,-1,1498,1441,0
68733973257,68733973259,2,1371,1213,0
68737760635,68737760638,3,2027,1695,0
68739528975,68739528975,0,1133,1429,0
68740680768,68740680768,0,1368,1880,0
68740798522,68740798525,3,12152,11794,0
68741242643,68741242645,2,986,1705,0
68742210483,68742210481,-2,940,1593,0
68743796858,68743796859,1,1223,1913,0
68745326253,68745326253,0,1294,1424,0
68749288159,68749288159,0,1600,2255,0
68753952234,68753952230,-4,1240,1421,0
68754027488,68754027492,4,1216,2067,0
68755223217,68755223217,0,1818,1825,0
68756607779,68756607778,-1,1536,1992,0
68757408477,68757408478,1,1409,1848,0
68757939434,68757939437,3,2163,1575,0
68758740189,68758740190,1,1539,1641,0
68759175194,68759175194,0,1302,1860,0
68759989154,68759989155,1,1253,1948,0
68760939005,68760939005,0,1512,1603,0
68766212889,68766212890,1,1637,1646,0
68772151821,68772151821,0,2526,2131,0
68777751836,68777751838,2,1514,1616,0
68779344572,68779344578,6,14851,43240,0
68780140591,68780140590,-1,1064,1949,0
68782536243,68782536242,-1,1174,1715,0
68782917083,68782917083,0,1497,1890,0
68785658416,68785658417,1,1822,2491,0
68785946114,68785946115,1,1858,1818,0
68788571290,68788571289,-1,1914,1280,0
68789115161,68789115162,1,1104,1453,0
68790158909,68790158909,0,1429,2293,0
68790891966,68790891967,1,846,813,0
68792421633,68792421640,7,17555,25819,0
68792644508,68792644504,-4,1683,2639,0
68792724570,68792724569,-1,1538,2394,0
68793461666,68793461664,-2,1374,1450,0
68794923469,68794923470,1,1598,1434,0
68795952889,68795952887,-2,1620,1908,0
68796548819,68796548822,3,1142,2070,0
68797189610,68797189610,0,1441,2050,0
68798428958,68798428959,1,1407,1618,0
68801377909,68801377915,6,5264,2516,0
68801597778,68801597779,1,2000,1677,0
68804246746,68804246747,1,1240,1048,0
68805619210,68805619213,3,1795,1650,0
68810284077,68810284082,5,13620,8465,0
68811012579,68811012582,3,1242,1628,0
68811175042,68811175041,-1,1289,1802,0
68820946919,68820946918,-1,1415,1881,0
68829144938,68829144938,0,1287,1759,0
68830473563,68830473565,2,979,1494,0
68831658178,68831658179,1,1450,1998,0
68832217975,68832217975,0,1354,1745,0
68832604394,68832604395,1,645,735,0
68835661738,68835661740,2,1248,1301,0
68838157058,68838157056,-2,1641,2226,0
68839333271,68839333271,0,1336,1694,0
68841965754,68841965753,-1,1228,2102,0
68850284754,68850284755,1,3685,3386,0
68853133766,68853133773,7,1503,1179,0
68854609667,68854609668,1,1176,1309,0
68858261363,68858261362,-1,1478,2315,0
68860464061,68860464060,-1,1596,2383,0
68860992779,68860992781,2,1058,1784,0
68861199681,68861199682,1,1377,1864,0
68861814819,68861814836,17,1506,1637,0
68863182662,68863182663,1,1666,1922,0
68863907919,68863907919,0,1084,1384,0
68864907682,68864907682,0,1317,2118,0
68866787754,68866787754,0,1288,1867,0
68867868322,68867868322,0,1642,1912,0
68868263208,68868263206,-2,970,1338,0
68869600175,68869600156,-19,2744,1258,0
68874818212,68874818214,2,1284,1471,0
68876955410,68876955410,0,1579,2312,0
68877463785,68877463785,0,848,1429,0
68879193596,68879193597,1,1459,2246,0
68883959454,68883959453,-1,1325,1708,0
68884357890,68884357890,0,1525,1567,0
68885056699,68885056701,2,1531,1588,0
68887136186,68887136179,-7,1371,1408,0
68887993182,68887993182,0,1055,1323,0
68889044567,68889044567,0,735,738,0
68889733603,68889733602,-1,1725,1627,0
68890325732,68890325731,-1,1578,1818,0
68890412205,68890412206,1,1665,1369,0
68893395060,68893395060,0,990,1258,0
68894459853,68894459853,0,1048,1465,0
68897412046,68897412046,0,1153,1176,0
68899371071,68899371072,1,1160,2195,0
68900573343,68900573345,2,1292,1594,0
68903165891,68903165893,2,1189,1602,0
68904161143,68904161143,0,1417,2136,0
68906513094,68906513092,-2,780,1680,0
68906977923,68906977925,2,1794,1662,0
68915285855,68915285856,1,1248,2556,0
68915875462,68915875462,0,1239,1450,0
68916669939,68916669939,0,1310,1996,0
68917425649,68917425655,6,3054,1182,0
68918148841,68918148843,2,1775,1405,0
68918189688,68918189689,1,1380,1776,0
68923458008,68923458010,2,1200,1381,0
68927259562,68927259561,-1,1075,1707,0
68928848749,68928848751,2,923,1520,0
68933803340,68933803341,1,975,1020,0
68934293675,68934293678,3,1745,1359,0
68934774415,68934774415,0,1009,1516,0
68935295932,68935295932,0,1407,1742,0
68935371719,68935371717,-2,1277,2013,0
68939390766,68939390766,0,1198,1166,0
68945398065,68945398066,1,1093,1177,0
68951966702,68951966702,0,1038,1682,0
68952452886,68952452888,2,1031,1404,0
68954725347,68954725342,-5,1236,4386,0
68955763619,68955763621,2,1070,1783,0
68958193066,68958193066,0,947,1356,0
68958980718,68958980735,17,542,2121,0
68962791461,68962791461,0,1429,1453,0
68965489526,68965489524,-2,1463,2261,0
68966156688,68966156690,2,1704,1619,0
68966302557,68966302561,4,1422,1298,0
68970826259,68970826259,0,933,1057,0
68971504624,68971504622,-2,1937,2181,0
68972370194,68972370195,1,1243,1948,0
68972942266,68972942266,0,1195,2453,0
68975245029,68975245028,-1,937,1346,0
68976457667,68976457667,0,852,1599,0
68978471706,68978471705,-1,1468,1922,0
68980668630,68980668634,4,3488,2322,0
68983036750,68983036751,1,1406,2189,0
68985511791,68985511793,2,1675,1556,0
68987215450,68987215452,2,1534,1667,0
68987833258,68987833259,1,1427,1428,0
68987902983,68987902986,3,2420,1742,0
68989448659,68989448659,0,1275,1406,0
68990010771,68990010770,-1,1076,1206,0
68991398686,68991398688,2,1769,1662,0
68993180744,68993180745,1,1333,1399,0
68993564483,68993564481,-2,1738,1502,0
68994105362,68994105362,0,1959,2075,0
68997923582,68997923575,-7,2249,8656,0
68998204230,68998204227,-3,1147,2138,0
68999499914,68999499915,1,1502,1305,0
69001899488,69001899489,1,1337,1782,0
69002035953,69002035972,19,1204,1391,0
69003648528,69003648528,0,1437,2649,0
69004603775,69004603774,-1,1232,1802,0
69007896267,69007896267,0,1796,1878,0
69011635496,69011635496,0,1487,1585,0
69012039379,69012039380,1,1920,2859,0
69012196985,69012196985,0,1200,1414,0
69012603169,69012603169,0,1943,2090,0
69013644192,69013644192,0,1314,1768,0
69023358141,69023358141,0,1649,2019,0
69023874129,69023874129,0,1592,1689,0
69024961477,69024961477,0,2697,3647,0
69026863778,69026863778,0,1484,2121,0
69032332632,69032332646,14,12704,47193,0
69033518081,69033518080,-1,1579,1471,0
69036329810,69036329811,1,1121,1871,0
69038257538,69038257534,-4,1460,4351,0
69038686631,69038686631,0,1325,1735,0
69040149789,69040149790,1,1571,1931,0
69041794213,69041794213,0,1442,1176,0
69045618373,69045618373,0,1337,1658,0
69047264282,69047264283,1,1000,1703,0
69049270722,69049270722,0,1623,1389,0
69050599250,69050599251,1,1698,1688,0
69051215686,69051215685,-1,1123,2216,0
69056123841,69056123841,0,1398,1399,0
69057632255,69057632257,2,2017,2284,0
69058339356,69058339355,-1,1665,1694,0
69062449392,69062449394,2,1461,1194,0
69065326239,69065326235,-4,1018,1726,0
69066656346,69066656346,0,1007,1179,0
69066841443,69066841443,0,1500,1471,0
69067518311,69067518311,0,770,1415,0
69071531777,69071531766,-11,1638,1441,0
69071845591,69071845590,-1,867,1903,0
69076501525,69076501526,1,1793,2353,0
69078985525,69078985510,-15,1076,1500,0
69079554677,69079554674,-3,886,1325,0
69080947516,69080947504,-12,1072,1223,0
69081763340,69081763341,1,1694,2815,0
69082332829,69082332829,0,1425,1653,0
69083404193,69083404195,2,1695,2012,0
69087013558,69087013558,0,1042,1587,0
69089411706,69089411705,-1,1025,1136,0
69093406114,69093406115,1,1607,2322,0
69094169583,69094169582,-1,1537,1755,0
69098378242,69098378244,2,2184,1390,0
69100677143,69100677145,2,1061,1402,0
69101398525,69101398525,0,922,1407,0
69102304530,69102304538,8,1392,1340,0
69103890816,69103890816,0,1234,2179,0
69104011713,69104011716,3,1958,1277,0
69104397846,69104397843,-3,1245,2159,0
69107828861,69107828862,1,1209,1233,0
69111214746,69111214745,-1,1765,1334,0
69112535555,69112535554,-1,1561,1952,0
69112874314,69112874313,-1,1557,1965,0
69113759297,69113759278,-19,912,1132,0
69114341603,69114341603,0,1789,1613,0
69115601650,69115601649,-1,1728,1458,0
69116128651,69116128651,0,983,1436,0
69119647394,69119647397,3,2704,1633,0
69120256709,69120256706,-3,1171,1625,0
69121732663,69121732663,0,1245,1518,0
69122523118,69122523118,0,1443,2246,0
69124162366,69124162370,4,1897,996,0
69125978470,69125978469,-1,1319,1630,0
69127342767,69127342767,0,1547,1551,0
69127526739,69127526738,-1,1261,1746,0
69130172941,69130172941,0,1098,1779,0
69130641989,69130641989,0,1228,1269,0
69136746767,69136746766,-1,895,1203,0
69139218047,69139218047,0,1151,1624,0
69141877070,69141877071,1,1315,1473,0
69142000830,69142000832,2,1358,1296,0
69143113305,69143113306,1,1999,2488,0
69145877149,69145877150,1,1102,1647,0
69148102211,69148102214,3,1912,1266,0
69150473833,69150473832,-1,1146,1432,0
69153165570,69153165570,0,1427,2481,0
69154189790,69154189790,0,1606,1353,0
69154364364,69154364365,1,1096,1283,0
69155071553,69155071551,-2,1288,1182,0
69160622630,69160622631,1,862,1552,0
69163610627,69163610630,3,2323,1578,0
69163780662,69163780660,-2,1467,2512,0
69165509835,69165509836,1,1717,2007,0
69166281762,69166281761,-1,1172,2290,0
69169729735,69169729728,-7,2276,8531,0
69171759537,69171759538,1,1365,1487,0
69172873699,69172873699,0,1060,1314,0
69173485901,69173485902,1,1357,1537,0
69176694410,69176694430,20,1393,1795,0
69182088526,69182088526,0,1359,1942,0
69182348622,69182348622,0,885,1401,0
69183154091,69183154091,0,805,1646,0
69183660862,69183660863,1,1714,1775,0
69183713208,69183713218,10,1372,1472,0
69188526645,69188526649,4,40255,30235,0
69192980793,69192980794,1,1627,1414,0
69195037797,69195037797,0,1378,1866,0
69196587473,69196587473,0,2601,3755,0
69197117651,69197117654,3,1132,1384,0
69199288723,69199288722,-1,1465,1723,0
69202475634,69202475635,1,1437,1825,0
69206090386,69206090387,1,929,1536,0
69206485175,69206485177,2,1485,1201,0
69207180405,69207180408,3,1430,1921,0
69209274338,69209274338,0,1723,2273,0
69209349142,69209349142,0,889,1333,0
69210438007,69210438006,-1,1418,2573,0
69215912818,69215912822,4,1794,1231,0
69219701201,69219701203,2,2347,2541,0
69219788221,69219788222,1,969,1151,0
69221152128,69221152128,0,1992,2973,0
69221815736,69221815735,-1,1684,2198,0
69222158134,69222158134,0,915,1247,0
69225298930,69225298930,0,1469,1623,0
69226105131,69226105131,0,1512,1394,0
69226954507,69226954509,2,1702,1933,0
69231882616,69231882614,-2,1879,2262,0
69234140491,69234140490,-1,1119,1773,0
69239953239,69239953239,0,1001,1447,0
69241159373,69241159374,1,1659,1767,0
69241813398,69241813398,0,1952,2608,0
69243408562,69243408555,-7,697,2815,0
69244101944,69244101962,18,926,878,0
69245619754,69245619755,1,1768,1863,0
69248550907,69248550907,0,1511,1949,0
69252690504,69252690508,4,1495,1091,0
69254991450,69254991446,-4,1499,1984,0
69257824937,69257824937,0,1063,1646,0
69258453951,69258453953,2,1033,1559,0
69258649409,69258649410,1,1483,1323,0
69262517707,69262517711,4,1563,1703,0
69263385854,69263385857,3,2675,1726,0
69265401325,69265401306,-19,1232,1324,0
69266673412,69266673414,2,2256,2056,0
69267966226,69267966227,1,1743,2380,0
69271356109,69271356107,-2,1507,1547,0
69275131820,69275131819,-1,995,1849,0
69277178441,69277178440,-1,1415,2088,0
69278271169,69278271169,0,766,1353,0
69279934903,69279934904,1,1521,2060,0
69280545795,69280545794,-1,1309,1383,0
69282426838,69282426838,0,1615,2103,0
69286287220,69286287221,1,1618,2355,0
69293541380,69293541380,0,1561,1829,0
69296613353,69296613354,1,1897,2069,0
69299702925,69299702925,0,1297,2225,0
69301607650,69301607650,0,2767,3563,0
69302759638,69302759642,4,1650,1415,0
69306431675,69306431675,0,1610,1487,0
69307201651,69307201651,0,1595,2036,0
69308092681,69308092682,1,1837,2256,0
69309131279,69309131280,1,1076,1819,0
69310021458,69310021459,1,1531,1447,0
69312602710,69312602710,0,838,1150,0
69313942802,69313942804,2,1334,1919,0
69315953043,69315953045,2,1509,2233,0
69316577390,69316577388,-2,1406,2213,0
69318158761,69318158762,1,1376,1669,0
69318796565,69318796566,1,1198,1660,0
69319550377,69319550358,-19,663,1007,0
69320818891,69320818891,0,1165,1322,0
69321077694,69321077694,0,1400,1380,0
69324416829,69324416836,7,7171,2122,0
69325339627,69325339627,0,1106,1651,0
69328979070,69328979071,1,1468,1624,0
69330938826,69330938827,1,1705,922,0
69331049539,69331049542,3,1345,1078,0
69331401558,69331401558,0,1793,2141,0
69331750683,69331750682,-1,1219,1437,0
69332025358,69332025358,0,1862,1824,0
69334303693,69334303691,-2,1438,2334,0
69334388916,69334388917,1,1349,1714,0
69339265702,69339265701,-1,959,1201,0
69341707373,69341707375,2,1977,1337,0
69342506296,69342506298,2,1834,1955,0
69343024300,69343024295,-5,1405,3290,0
69345744642,69345744642,0,1427,1017,0
69350182077,69350182077,0,1787,2352,0
69356887344,69356887346,2,1767,2441,0
69360392194,69360392194,0,2026,2067,0
69361380383,69361380389,6,2674,2218,0
69369472734,69369472735,1,1128,1471,0
69372415495,69372415495,0,664,722,0
69373098240,69373098240,0,1427,1838,0
69373472763,69373472765,2,1318,1861,0
69373705144,69373705145,1,878,1354,0
69376553478,69376553478,0,946,1395,0
69378815261,69378815260,-1,1594,2179,0
69389191453,69389191453,0,1066,1174,0
69391980162,69391980163,1,1956,1928,0
69395928010,69395928011,1,1459,2043,0
69396785258,69396785259,1,1459,1492,0
69398997169,69398997170,1,1427,1369,0
69400757288,69400757288,0,1488,1369,0
69400783519,69400783521,2,35225,38205,0
69402162275,69402162281,6,2513,1347,0
69406862804,69406862806,2,1458,1067,0
69413665333,69413665335,2,1661,1312,0
69413742530,69413742530,0,1115,1287,0
69416975851,69416975852,1,1238,1279,0
69417318834,69417318841,7,1079,978,0
69422806783,69422806783,0,1137,1372,0
69425148386,69425148386,0,1254,1449,0
69426233327,69426233328,1,1087,1853,0
69427658801,69427658800,-1,1357,1712,0
69429060901,69429060903,2,1405,2144,0
69436597447,69436597446,-1,1729,2451,0
69437754747,69437754746,-1,956,1505,0
69439755957,69439755953,-4,739,3061,0
69440422375,69440422373,-2,1299,2276,0
69441957679,69441957679,0,1886,2057,0
69442935131,69442935131,0,1208,937,0
69443115858,69443115859,1,1277,1510,0
69444828426,69444828428,2,1098,1420,0
69445336229,69445336230,1,1432,2917,0
69451843826,69451843826,0,1560,1007,0
69452576654,69452576662,8,2900,1321,0
69452827313,69452827310,-3,1909,2676,0
69453245701,69453245693,-8,190,628,0
69456283871,69456283872,1,1264,1561,0
69457247337,69457247344,7,5877,1293,0
69459452526,69459452525,-1,1308,1546,0
69466158694,69466158690,-4,1211,1548,0
69467896713,69467896713,0,1500,1680,0
69468213811,69468213811,0,1582,1425,0
69468306395,69468306398,3,1756,1639,0
69468458031,69468458027,-4,2413,5953,0
69470251852,69470251856,4,1377,1344,0
69477347182,69477347183,1,985,1433,0
69478301871,69478301873,2,1114,1275,0
69480017037,69480017039,2,1091,886,0
69482147012,69482147013,1,1185,1165,0
69488458542,69488458543,1,1103,1401,0
69492470571,69492470573,2,1145,2015,0
69495461818,69495461817,-1,1349,1906,0
69498492159,69498492137,-22,602,1063,0
69499103652,69499103669,17,584,1233,0
69501258843,69501258842,-1,1236,1214,0
69512163926,69512163941,15,1816,1734,0
69512225004,69512225021,17,1378,1811,0
69514029322,69514029322,0,1874,1753,0
69514125592,69514125594,2,1235,1511,0
69517615875,69517615876,1,1676,1666,0
69521737787,69521737788,1,844,1711,0
69525793813,69525793814,1,1153,1582,0
69527044809,69527044803,-6,1224,4024,0
69529233234,69529233234,0,760,1120,0
69530460441,69530460443,2,1110,958,0
69532302379,69532302379,0,1439,1466,0
69532663126,69532663128,2,1767,1978,0
69534096953,69534096953,0,1142,1857,0
69535269178,69535269180,2,1392,1309,0
69540190588,69540190595,7,1386,1537,0
69541112793,69541112795,2,2184,1564,0
69541467398,69541467397,-1,1319,2086,0
69544849337,69544849341,4,2055,1536,0
69546761481,69546761479,-2,1020,1762,0
69549974021,69549974022,1,1478,1551,0
69553633085,69553633086,1,1445,1292,0
69555123346,69555123347,1,836,1638,0
69557269560,69557269557,-3,1035,2347,0
69558965178,69558965180,2,1292,1668,0
69563106634,69563106637,3,922,1539,0
69566336429,69566336429,0,1545,1994,0
69567452826,69567452827,1,1298,1065,0
69568377287,69568377289,2,817,1300,0
69568981694,69568981695,1,1673,1679,0
69570895159,69570895154,-5,549,1766,0
69572775574,69572775578,4,1195,1393,0
69574533107,69574533110,3,2593,3369,0
69575705471,69575705465,-6,1059,3044,0
69580783073,69580783075,2,1741,1735,0
69581112773,69581112772,-1,1222,2229,0
69581833178,69581833178,0,1314,1453,0
69583329121,69583329121,0,1252,1460,0
69586489784,69586489790,6,2293,765,0
69589578233,69589578230,-3,1488,2367,0
69590875366,69590875367,1,1326,1628,0
69593793865,69593793866,1,1724,2588,0
69596247189,69596247190,1,1147,1763,0
69597948671,69597948672,1,1200,2401,0
69600943734,69600943734,0,1613,2296,0
69602269799,69602269801,2,1663,2469,0
69603643507,69603643507,0,1546,1409,0
69605966791,69605966793,2,955,1614,0
69607762385,69607762386,1,1777,1883,0
69608536166,69608536164,-2,1072,2322,0
69610488798,69610488799,1,1512,1347,0
69612442786,69612442786,0,1247,1334,0
69613632555,69613632556,1,1374,1881,0
69614221921,69614221919,-2,1112,1960,0
69617763413,69617763414,1,1383,1695,0
69620709229,69620709228,-1,1616,1918,0
69636987271,69636987270,-1,1685,1828,0
69641307316,69641307317,1,1365,1736,0
69644546306,69644546307,1,1628,2266,0
69645557138,69645557137,-1,968,1625,0
69646809124,69646809123,-1,1247,1491,0
69648733628,69648733626,-2,1904,1878,0
69649312845,69649312842,-3,1296,2700,0
69650361083,69650361083,0,2162,2082,0
69650840899,69650840901,2,1270,1992,0
69651841197,69651841198,1,759,1701,0
69653300630,69653300629,-1,1268,1545,0
69653785550,69653785544,-6,1188,1919,0
69653957557,69653957548,-9,1425,1689,0
69655791353,69655791353,0,1172,1742,0
69656317609,69656317610,1,1244,1471,0
69658050877,69658050877,0,1748,1472,0
69658099521,69658099522,1,2196,1855,0
69660023428,69660023430,2,2068,1542,0
69662396483,69662396483,0,1607,1366,0
69663165383,69663165382,-1,974,1484,0
69664591099,69664591097,-2,1190,1758,0
69666979265,69666979267,2,880,1769,0
69668123246,69668123246,0,1432,1871,0
69669447825,69669447826,1,1005,1695,0
69669574773,69669574774,1,1185,1113,0
69669902246,69669902246,0,1752,1778,0
69674851178,69674851178,0,1403,1427,0
69675348560,69675348559,-1,1293,1584,0
69676150139,69676150138,-1,983,1209,0
69677837065,69677837063,-2,2006,2916,0
69680655502,69680655503,1,1785,1763,0
69682947379,69682947381,2,1131,1285,0
69684920170,69684920170,0,1479,1396,0
69687595614,69687595614,0,1810,1978,0
69687718526,69687718525,-1,1059,1450,0
69688363701,69688363702,1,1070,1754,0
69689431821,69689431823,2,1181,1185,0
69695628937,69695628938,1,1086,2256,0
69699063174,69699063174,0,1167,2014,0
69704247963,69704247962,-1,1199,2038,0
69708399802,69708399801,-1,1211,2097,0
69708595374,69708595374,0,1168,1778,0
69710882811,69710882810,-1,1371,1815,0
69713395293,69713395297,4,1853,1636,0
69713971089,69713971089,0,759,1440,0
69716172142,69716172143,1,1283,1415,0
69716232159,69716232159,0,1919,2509,0
69716850539,69716850546,7,4051,1770,0
69720493834,69720493835,1,2061,2024,0
69724139517,69724139515,-2,1215,1361,0
69724381269,69724381270,1,1701,2067,0
69725408245,69725408249,4,1533,1447,0
69726115528,69726115528,0,1463,1623,0
69732062331,69732062333,2,1214,1746,0
69732629150,69732629150,0,1800,2334,0
69732975623,69732975622,-1,1204,2032,0
69733908798,69733908799,1,1387,1307,0
69734212673,69734212680,7,2658,1447,0
69734915489,69734915490,1,1447,2008,0
69735367487,69735367492,5,1472,1276,0
69739509383,69739509380,-3,1479,2113,0
69739722773,69739722774,1,1200,1252,0
69742818880,69742818883,3,1837,1780,0
69743668925,69743668923,-2,1200,1426,0
69743947722,69743947722,0,1459,1704,0
69744217696,69744217695,-1,1064,1949,0
69745041063,69745041047,-16,998,986,0
69746020726,69746020726,0,1297,1666,0
69747942133,69747942140,7,1162,1304,0
69748300455,69748300455,0,1373,2113,0
69748366847,69748366847,0,565,1129,0
69750068035,69750068038,3,1158,1429,0
69750845107,69750845111,4,1034,1284,0
69751781098,69751781098,0,1726,1627,0
69755912707,69755912706,-1,1121,2194,0
69756325186,69756325187,1,946,1436,0
69760035547,69760035547,0,1473,1216,0
69773161976,69773161976,0,1540,1832,0
69777886409,69777886410,1,1764,1723,0
69778094057,69778094059,2,1447,1860,0
69780438798,69780438799,1,1256,1263,0
69782656482,69782656485,3,1703,1700,0
69785621134,69785621134,0,1178,2203,0
69785765540,69785765527,-13,836,1420,0
69787221229,69787221229,0,1506,2164,0
69790008636,69790008636,0,1889,18873,0
69791700194,69791700191,-3,1413,2052,0
69791835383,69791835361,-22,1303,1699,0
69792435981,69792436001,20,929,1551,0
69793848391,69793848390,-1,2094,2351,0
69799101718,69799101718,0,1825,1546,0
69799996554,69799996554,0,1498,1897,0
69803768890,69803768888,-2,1619,3036,0
69804065380,69804065378,-2,1406,2811,0
69804772854,69804772854,0,1560,1624,0
69807699069,69807699075,6,3543,2105,0
69807937746,69807937746,0,1206,1805,0
69812326166,69812326166,0,1877,1891,0
69813956246,69813956246,0,1358,1700,0
69816973818,69816973822,4,2280,2032,0
69817458181,69817458182,1,1225,1402,0
69818361352,69818361353,1,1638,1351,0
69819030433,69819030434,1,1580,1775,0
69819100303,69819100305,2,600,966,0
69820603572,69820603571,-1,1470,1438,0
69822093329,69822093336,7,9789,35533,0
69823168696,69823168698,2,14699,12569,0
69826110560,69826110559,-1,1435,1688,0
69831856440,69831856441,1,1472,1367,0
69832609358,69832609359,1,1123,1480,0
69833391591,69833391590,-1,1823,1699,0
69834053818,69834053820,2,1076,1175,0
69836779534,69836779535,1,1660,1963,0
69836931987,69836931987,0,1495,1942,0
69837034542,69837034541,-1,1347,1797,0
69837438185,69837438187,2,1127,1733,0
69839481038,69839481038,0,1284,1347,0
69841788339,69841788339,0,1325,1619,0
69847037558,69847037559,1,1454,1788,0
69847630420,69847630427,7,3276,1082,0
69848169374,69848169373,-1,901,1300,0
69855203425,69855203425,0,1484,1425,0
69855989109,69855989110,1,1597,2316,0
69856442584,69856442583,-1,1266,1858,0
69856941976,69856941978,2,874,1787,0
69857333958,69857333958,0,1516,1753,0
69860735050,69860735052,2,1339,1670,0
69861395772,69861395773,1,1757,2157,0
69863402050,69863402050,0,1300,1606,0
69866118266,69866118270,4,1609,1339,0
69867080055,69867080056,1,1387,1328,0
69868114534,69868114534,0,1910,1521,0
69872205246,69872205245,-1,1710,2225,0
69874109845,69874109845,0,1166,1684,0
69874556825,69874556824,-1,1968,1554,0
69876855235,69876855236,1,902,1686,0
69880689300,69880689301,1,1495,1770,0
69882743022,69882743022,0,1221,1608,0
69886240242,69886240238,-4,1164,1965,0
69890266460,69890266461,1,1071,2064,0
69891038824,69891038821,-3,2106,2326,0
69894639709,69894639706,-3,1625,2167,0
69896565097,69896565094,-3,1446,2142,0
69897632533,69897632532,-1,1211,1528,0
69899732933,69899732933,0,1057,1330,0
69905073538,69905073537,-1,823,1440,0
69906327602,69906327602,0,1756,1756,0
69906895157,69906895156,-1,1251,1901,0
69911489322,69911489322,0,1834,1649,0
69912694935,69912694935,0,1967,2011,0
69918906534,69918906534,0,1019,1425,0
69924898413,69924898415,2,1799,1451,0
69927199586,69927199586,0,1320,1706,0
69939079317,69939079318,1,1050,1928,0
69939343982,69939343982,0,1649,1688,0
69940776771,69940776773,2,1320,1786,0
69945617942,69945617937,-5,1092,3732,0
69951110490,69951110491,1,1892,2231,0
69951810130,69951810130,0,1561,2150,0
69955404886,69955404886,0,1319,1892,0
69959258530,69959258534,4,2017,1388,0
69960270998,69960270999,1,1691,2427,0
69962040305,69962040306,1,1551,1311,0
69962495793,69962495795,2,1657,1488,0
69963121984,69963121984,0,1861,1698,0
69964368882,69964368881,-1,1673,2772,0
69966850599,69966850599,0,1094,1290,0
69967541527,69967541526,-1,1395,2596,0
69975329118,69975329119,1,1223,1552,0
69976309798,69976309799,1,1101,1412,0
69978423879,69978423880,1,1448,1658,0
69979609994,69979609973,-21,1215,1962,0
69980534657,69980534663,6,2853,905,0
69983218593,69983218598,5,1754,902,0
69984411622,69984411624,2,1849,1457,0
69988236093,69988236090,-3,1905,2599,0
69988545990,69988546004,14,15126,55993,0
69988843234,69988843236,2,2304,2221,0
69989947550,69989947547,-3,510,1737,0
69991957821,69991957816,-5,2222,6428,0
69992495693,69992495691,-2,935,1709,0
69995168790,69995168791,1,1436,1856,0
69997438134,69997438133,-1,1309,1930,0
70000089909,70000089910,1,1025,1275,0
70000589942,70000589942,0,1504,1924,0
70001080840,70001080846,6,6572,3016,0
70002106807,70002106806,-1,1554,1797,0
70005164228,70005164229,1,959,1813,0
70006100579,70006100582,3,1292,2299,0
70009765210,70009765210,0,1316,2015,0
70010704507,70010704507,0,957,1591,0
70012788350,70012788350,0,1536,1608,0
70013460423,70013460423,0,768,1264,0
70018096545,70018096546,1,1345,2099,0
70018460136,70018460136,0,1294,1518,0
70027965802,70027965805,3,1441,1327,0
70028902427,70028902447,20,885,1075,0
70029937990,70029937995,5,2511,808,0
70030365312,70030365312,0,1357,1377,0
70033065178,70033065179,1,1295,1603,0
70034625592,70034625593,1,1460,1671,0
70034786174,70034786194,20,1090,1492,0
70038425135,70038425137,2,1412,1457,0
70039409722,70039409725,3,3564,2844,0
70043751994,70043751994,0,1444,1474,0
70046191681,70046191682,1,2021,2348,0
70047644479,70047644481,2,1730,1878,0
70048355768,70048355766,-2,1240,1649,0
70051224941,70051224942,1,1228,1696,0
70051371826,70051371825,-1,1418,2021,0
70052121897,70052121898,1,1653,1854,0
70054514432,70054514433,1,1570,1725,0
70056947366,70056947367,1,1216,1418,0
70060072815,70060072820,5,1178,1521,0
70060904587,70060904588,1,1398,1318,0
70063169233,70063169234,1,1289,1071,0
70066285864,70066285867,3,1600,1542,0
70067895844,70067895841,-3,1341,2790,0
70068351430,70068351429,-1,1502,1756,0
70070294913,70070294914,1,1485,2081,0
70074137646,70074137648,2,2888,3952,0
70074835625,70074835623,-2,1632,1281,0
70075215374,70075215375,1,1321,1873,0
70076050593,70076050595,2,1325,1768,0
70079762439,70079762440,1,1715,1499,0
70085362107,70085362106,-1,1886,2016,0
70085780010,70085780010,0,1785,1208,0
70087936084,70087936083,-1,1382,1902,0
70091048464,70091048466,2,1566,2013,0
70091691383,70091691384,1,975,1712,0
70092218054,70092218058,4,1390,1467,0
70094247373,70094247370,-3,1011,1658,0
70094392600,70094392598,-2,1311,2421,0
70094642985,70094642986,1,1513,1870,0
70096938655,70096938655,0,1248,1728,0
70098288415,70098288417,2,1137,1438,0
70099746552,70099746566,14,4875,16729,0
70102362327,70102362329,2,1025,1215,0
70112027782,70112027782,0,1481,2246,0
70112946750,70112946751,1,1157,1344,0
70115180612,70115180611,-1,1435,1091,0
70115765315,70115765326,11,1323,1757,0
70116139836,70116139835,-1,1450,1828,0
70118043598,70118043600,2,1338,1434,0
70119956787,70119956786,-1,1845,2418,0
70120957349,70120957343,-6,1614,4334,0
70121073766,70121073767,1,1781,2004,0
70124317098,70124317098,0,2206,2329,0
70127261351,70127261350,-1,1913,1922,0
70130865410,70130865411,1,1284,1712,0
70132244774,70132244775,1,1501,1489,0
70134914780,70134914783,3,1628,1120,0
70136415812,70136415833,21,1260,1637,0
70136510934,70136510934,0,1298,1480,0
70139580386,70139580386,0,1202,1775,0
70144904523,70144904524,1,1744,1662,0
70148045099,70148045094,-5,844,2491,0
70148583422,70148583422,0,1216,1156,0
70149890382,70149890383,1,1572,1296,0
70150740535,70150740537,2,1034,1405,0
70152226516,70152226517,1,1866,1960,0
70153477495,70153477496,1,1271,1629,0
70154720445,70154720445,0,1357,2003,0
70157149327,70157149326,-1,1234,1821,0
70157274004,70157273993,-11,1048,1205,0
70158225043,70158225042,-1,737,832,0
70160697479,70160697480,1,1416,1517,0
70161733509,70161733511,2,2071,2321,0
70161998269,70161998269,0,1478,1648,0
70163515860,70163515861,1,1784,1350,0
70169449118,70169449118,0,1340,1658,0
70170145357,70170145353,-4,25012,6905,0
70178253521,70178253523,2,1413,1529,0
70178350226,70178350227,1,1673,2730,0
70182747270,70182747272,2,1412,1981,0
70183469090,70183469090,0,1213,1936,0
70188361202,70188361205,3,1685,2261,0
70191610486,70191610487,1,1507,1761,0
70196854358,70196854359,1,1494,1455,0
70197565027,70197565027,0,1558,1853,0
70199617450,70199617451,1,653,942,0
70200670820,70200670806,-14,1281,2131,0
70205813306,70205813308,2,1975,2003,0
70211824555,70211824554,-1,1556,1830,0
70212727914,70212727915,1,1293,1330,0
70213952498,70213952498,0,885,1120,0
70214485559,70214485578,19,940,1891,0
70214719423,70214719426,3,1094,1214,0
70215555171,70215555170,-1,1025,1617,0
70217093958,70217093958,0,1005,1257,0
70219437763,70219437763,0,1079,1608,0
70221308270,70221308269,-1,1400,1996,0
70221751287,70221751287,0,1499,1869,0
70230107247,70230107243,-4,834,1841,0
70231053193,70231053186,-7,1047,4689,0
70231927374,70231927375,1,1068,1196,0
70232123918,70232123919,1,899,1611,0
70237021542,70237021541,-1,1439,1863,0
70239255562,70239255564,2,1290,1622,0
70239788202,70239788200,-2,1195,1846,0
70243549412,70243549414,2,2376,1983,0
70244850532,70244850529,-3,21563,13203,0
70245868785,70245868786,1,1015,1320,0
70246754500,70246754489,-11,1390,4875,0
70253721082,70253721082,0,1435,1574,0
70256496031,70256496031,0,1178,1568,0
70259113858,70259113858,0,1348,1040,0
70259654050,70259654068,18,1348,1195,0
70260404407,70260404386,-21,1692,1756,0
70261695940,70261695938,-2,1087,2362,0
70262325789,70262325789,0,1825,1492,0
70264483418,70264483418,0,1310,1960,0
70266051121,70266051119,-2,873,1665,0
70270862321,70270862322,1,2077,1907,0
70271314100,70271314102,2,1608,1564,0
70271970069,70271970061,-8,602,2881,0
70274177258,70274177261,3,961,1454,0
70274711430,70274711447,17,1247,2060,0
70278928324,70278928326,2,1568,1332,0
70279423915,70279423915,0,1778,1710,0
70280641975,70280641976,1,1540,1758,0
70283852760,70283852760,0,1268,1737,0
70284840821,70284840820,-1,845,1434,0
70285833454,70285833454,0,1678,1963,0
70286576410,70286576412,2,1431,1393,0
70287250240,70287250261,21,1338,2020,0
70289805831,70289805840,9,13845,29471,0
70290726550,70290726550,0,1539,1701,0
70290796752,70290796770,18,239,983,0
70293356875,70293356873,-2,1305,1189,0
70294588622,70294588622,0,1149,1994,0
70296380276,70296380274,-2,1222,1426,0
70296738794,70296738794,0,719,1254,0
70298851913,70298851913,0,1567,1619,0
70301455415,70301455414,-1,1644,2333,0
70302122868,70302122870,2,1360,1319,0
70304190072,70304190076,4,1895,1633,0
70309893590,70309893591,1,1725,1775,0
70310083964,70310083963,-1,1193,1259,0
70310360614,70310360606,-8,1577,2263,0
70311134561,70311134559,-2,881,868,0
70318601335,70318601336,1,1247,2074,0
70321675203,70321675203,0,1036,1465,0
70322083106,70322083110,4,853,1241,0
70323836526,70323836526,0,1175,2181,0
70324470427,70324470425,-2,697,2473,0
70328642481,70328642502,21,1201,1287,0
70331088097,70331088097,0,1122,1700,0
70333101764,70333101774,10,8678,44743,0
70333918166,70333918173,7,12392,29271,0
70338344876,70338344880,4,2427,1295,0
70339395776,70339395770,-6,1470,5219,0
70339474701,70339474699,-2,1787,1849,0
70340877123,70340877123,0,1674,2043,0
70340934427,70340934428,1,826,1332,0
70342003366,70342003366,0,1489,1888,0
70347269861,70347269862,1,1484,1934,0
70351677070,70351677073,3,1763,1607,0
70352858244,70352858243,-1,1456,1785,0
70353775370,70353775370,0,1635,1634,0
70356980715,70356980714,-1,1813,1883,0
70357402852,70357402854,2,1883,2271,0
70357656475,70357656473,-2,1511,1562,0
70362505938,70362505942,4,1731,1219,0
70363103910,70363103910,0,730,1360,0
70365695298,70365695300,2,1489,1295,0
70365849931,70365849935,4,12320,9209,0
70366046473,70366046472,-1,1868,2379,0
70370540797,70370540795,-2,1419,1505,0
70372513269,70372513266,-3,468,883,0
70373541656,70373541657,1,1628,2132,0
70374968906,70374968906,0,1592,2654,0
70375785614,70375785607,-7,1526,7735,0
70376180594,70376180594,0,1709,1695,0
70380464187,70380464190,3,1428,1355,0
70380545813,70380545792,-21,973,1058,0
70381914008,70381914009,1,1150,1146,0
70386113641,70386113641,0,1687,1749,0
70387503435,70387503434,-1,1759,1782,0
70391825118,70391825117,-1,1565,2090,0
70393965062,70393965063,1,1385,1652,0
70396400990,70396400992,2,1238,1479,0
70397142922,70397142900,-22,989,1003,0
70397331597,70397331595,-2,1596,1886,0
70398448648,70398448650,2,1663,1640,0
70400052032,70400052033,1,1891,1960,0
70400923383,70400923382,-1,1078,1781,0
70402507886,70402507886,0,1705,2084,0
70402801482,70402801481,-1,1492,1871,0
70404059466,70404059469,3,4041,3097,0
70407114569,70407114569,0,1659,1758,0
70407828754,70407828754,0,1918,2038,0
70408278076,70408278077,1,1986,1961,0
70409101763,70409101766,3,984,1576,0
70411057708,70411057709,1,1522,1372,0
70414766219,70414766221,2,36835,32328,0
70419935701,70419935702,1,1185,857,0
70421275983,70421275987,4,3092,2214,0
70423182584,70423182585,1,1248,1617,0
70427182787,70427182788,1,1420,1704,0
70428399113,70428399113,0,1525,1625,0
70430002735,70430002734,-1,1629,1970,0
70431245318,70431245318,0,1087,2010,0
70432909151,70432909151,0,1215,1282,0
70434884518,70434884510,-8,956,1214,0
70436667629,70436667636,7,1985,1466,0
70438010065,70438010066,1,1300,1846,0
70442385357,70442385356,-1,1429,1987,0
70448678463,70448678477,14,192,1438,0
70448725265,70448725264,-1,862,1014,0
70450206091,70450206089,-2,1156,1715,0
70451360317,70451360317,0,1357,1401,0
70451897925,70451897927,2,1519,1467,0
70452139517,70452139519,2,1184,1434,0
70454395474,70454395474,0,981,1170,0
70454954573,70454954566,-7,696,834,0
70456688681,70456688686,5,2773,1510,0
70457327459,70457327458,-1,829,1092,0
70458414986,70458414986,0,1141,1216,0
70467007131,70467007137,6,2889,1590,0
70468528515,70468528516,1,933,1602,0
70469466999,70469467000,1,1126,2190,0
70470276747,70470276750,3,1561,1751,0
70470790410,70470790409,-1,1822,2080,0
70474299557,70474299559,2,1531,1475,0
70476439277,70476439277,0,1592,1730,0
70477904382,70477904383,1,1239,1325,0
70480554636,70480554635,-1,1230,1423,0
70481571358,70481571357,-1,1129,1961,0
70487633215,70487633215,0,2066,2438,0
70488807506,70488807506,0,1624,1732,0
70489513227,70489513226,-1,1067,1796,0
70492911558,70492911558,0,1721,2050,0
70493965758,70493965755,-3,1624,2693,0
70496419094,70496419098,4,1896,1005,0
70499219502,70499219502,0,1660,1853,0
70499786276,70499786277,1,1825,1772,0
70501320526,70501320530,4,1847,1403,0
70503961698,70503961699,1,1088,1714,0
70504215279,70504215280,1,1528,1862,0
70507828031,70507828034,3,1678,1606,0
70508984786,70508984774,-12,777,383,0
70510269866,70510269866,0,1760,1628,0
70512913518,70512913520,2,1678,1679,0
70513987672,70513987671,-1,1706,1777,0
70515027054,70515027055,1,1794,2831,0
70516297106,70516297088,-18,1126,1577,0
70519066438,70519066437,-1,1364,1973,0
70521057666,70521057666,0,1809,2107,0
70521337018,70521337018,0,1061,1909,0
70521650502,70521650513,11,1108,1520,0
70524315351,70524315354,3,1503,1738,0
70525231137,70525231137,0,1786,2616,0
70526685841,70526685842,1,976,1518,0
70527763454,70527763453,-1,1729,1667,0
70527867903,70527867903,0,848,916,0
70530820715,70530820714,-1,1275,1457,0
70530903070,70530903073,3,1754,1456,0
70533328181,70533328178,-3,1087,1376,0
70534417238,70534417237,-1,1155,1493,0
70535153709,70535153710,1,1295,1607,0
70536647753,70536647737,-16,62142,51244,0
70538456090,70538456091,1,1279,1510,0
70539757911,70539757912,1,1263,1773,0
70543153946,70543153946,0,990,1350,0
70543432031,70543432023,-8,1250,1552,0
70544320261,70544320261,0,1667,2039,0
70547069209,70547069210,1,1412,1671,0
70549004926,70549004923,-3,1290,1491,0
70551484990,70551484990,0,1088,1191,0
70553982746,70553982747,1,1262,1593,0
70556230934,70556230934,0,1344,1337,0
70557068029,70557068030,1,1477,1456,0
70558737665,70558737668,3,2316,1675,0
70558904245,70558904245,0,1200,1840,0
70559910718,70559910724,6,4648,3266,0
70560556251,70560556253,2,1883,1571,0
70560594006,70560594005,-1,1601,1599,0
70560924931,70560924930,-1,1610,1259,0
70567693118,70567693118,0,1909,2453,0
70569346042,70569346042,0,1710,1384,0
70570164739,70570164741,2,691,892,0
70570743425,70570743425,0,1833,1778,0
70571150650,70571150650,0,1339,2123,0
70571765510,70571765510,0,1016,1762,0
70577282525,70577282527,2,992,1008,0
70582717554,70582717553,-1,1258,1256,0
70583353433,70583353434,1,1723,2380,0
70583762203,70583762201,-2,1147,1144,0
70584271490,70584271489,-1,1322,1539,0
70586640790,70586640790,0,1700,1451,0
70589152437,70589152436,-1,1173,1959,0
70589783249,70589783250,1,1531,2588,0
70590154558,70590154558,0,1318,1286,0
70591166204,70591166205,1,1651,1923,0
70592410727,70592410730,3,1135,1476,0
70593032787,70593032787,0,2765,3446,0
70597434775,70597434777,2,1295,1993,0
70601416738,70601416738,0,1007,2224,0
70605272910,70605272914,4,1185,1692,0
70606247903,70606247906,3,2000,1523,0
70607406478,70607406481,3,1032,2008,0
70609101261,70609101262,1,1433,1666,0
70609535094,70609535095,1,943,1187,0
70610804406,70610804405,-1,1022,1173,0
70612480002,70612480001,-1,2090,1583,0
70613082769,70613082770,1,2088,1285,0
70616517622,70616517623,1,862,1225,0
70618422025,70618422028,3,1226,1782,0
70626319962,70626319959,-3,980,1254,0
70629952441,70629952445,4,1473,1268,0
70632833122,70632833122,0,1157,1693,0
70635976556,70635976575,19,1050,1496,0
70636254708,70636254707,-1,1137,2195,0
70638466306,70638466307,1,1926,2374,0
70639452833,70639452833,0,1842,2036,0
70641743892,70641743891,-1,1342,1952,0
70647028598,70647028599,1,1315,1697,0
70647645926,70647645925,-1,1834,2037,0
70648015296,70648015295,-1,1013,1756,0
70652795690,70652795692,2,1289,1687,0
70653751716,70653751718,2,1663,1513,0
70654749374,70654749373,-1,1064,1596,0
70654785103,70654785104,1,1631,2250,0
70654890683,70654890685,2,1510,1658,0
70657597595,70657597579,-16,412,431,0
70658724637,70658724637,0,861,1822,0
70660368613,70660368614,1,1197,1101,0
70660645910,70660645912,2,645,1526,0
70667304110,70667304114,4,1278,1358,0
70667665714,70667665716,2,1276,2160,0
70669622503,70669622501,-2,848,1314,0
70669882805,70669882801,-4,2615,5742,0
70673692570,70673692573,3,1522,1396,0
70676046985,70676046985,0,1255,1444,0
70678400489,70678400490,1,1866,1371,0
70683245102,70683245103,1,1293,1427,0
70685688316,70685688317,1,1368,1770,0
70693786798,70693786799,1,1185,1760,0
70695611017,70695611017,0,1406,1926,0
70697926817,70697926818,1,1223,1440,0
70700107632,70700107633,1,1839,2055,0
70700360082,70700360085,3,1875,2139,0
70701258462,70701258460,-2,1612,2132,0
70701908294,70701908292,-2,1214,3072,0
70702750733,70702750734,1,1389,2055,0
70704531719,70704531722,3,1197,992,0
70705438540,70705438540,0,1392,2069,0
70706810229,70706810231,2,1482,1536,0
70709675633,70709675633,0,1638,2535,0
70710939177,70710939177,0,1219,1513,0
70716963914,70716963915,1,2257,1502,0
70717493957,70717493957,0,1555,2047,0
70723615569,70723615570,1,1062,2031,0
70725724083,70725724086,3,1512,1430,0
70728689129,70728689135,6,5073,1674,0
70730971291,70730971296,5,1329,519,0
70735082780,70735082781,1,1449,1560,0
70736014602,70736014605,3,2969,2946,0
70749291423,70749291425,2,1268,894,0
70750403098,70750403098,0,1270,1796,0
70754901604,70754901604,0,1119,1788,0
70760961639,70760961638,-1,1335,1980,0
70762180326,70762180326,0,1631,1612,0
70762227589,70762227589,0,1120,1855,0
70763253535,70763253534,-1,1776,1314,0
70763369869,70763369872,3,1701,1465,0
70764897475,70764897477,2,1435,1700,0
70765759383,70765759382,-1,1987,2645,0
70767586218,70767586217,-1,1279,1548,0
70771558014,70771558014,0,1138,1326,0
70777843390,70777843397,7,2539,1287,0
70783250163,70783250162,-1,1222,1235,0
70784624897,70784624906,9,4644,1069,0
70787241603,70787241596,-7,1335,6161,0
70788004686,70788004684,-2,1368,1583,0
70789999140,70789999140,0,1467,1977,0
70793903243,70793903243,0,1402,2047,0
70795937468,70795937468,0,1437,2066,0
70796456040,70796456042,2,1795,1557,0
70798138855,70798138856,1,1155,1231,0
70799446218,70799446219,1,1952,1524,0
70805758045,70805758047,2,1431,1217,0
70808491303,70808491306,3,2118,1881,0
70810440451,70810440450,-1,1056,1346,0
70813240353,70813240355,2,1638,2276,0
70815311062,70815311064,2,1482,2151,0
70816792990,70816792986,-4,54,820,0
70818336359,70818336359,0,580,1078,0
70820028602,70820028603,1,1099,1281,0
70820218525,70820218525,0,1540,1661,0
70820582677,70820582677,0,1066,1354,0
70822160434,70822160437,3,1829,2082,0
70822938753,70822938754,1,1655,1563,0
70823421169,70823421169,0,1239,1512,0
70824835636,70824835636,0,1292,2394,0
70825122085,70825122085,0,1255,1339,0
70827789046,70827789045,-1,1305,1410,0
70828061094,70828061091,-3,962,2203,0
70829010026,70829010027,1,1571,1866,0
70829499234,70829499234,0,1548,1923,0
70829531646,70829531647,1,1281,1772,0
70830295638,70830295638,0,1034,1277,0
70831340477,70831340478,1,894,1674,0
70831481680,70831481682,2,1728,1842,0
70831991685,70831991684,-1,1110,2034,0
70833676359,70833676357,-2,1188,1939,0
70835720208,70835720209,1,1310,1438,0
70840549037,70840549037,0,1505,1891,0
70842925952,70842925953,1,1131,1653,0
70846084738,70846084738,0,1481,2190,0
70847679838,70847679839,1,1155,1135,0
70848867578,70848867577,-1,1343,1207,0
70849460451,70849460456,5,1426,1099,0
70851614913,70851614913,0,2091,1722,0
70851983587,70851983589,2,1200,1977,0
70852815554,70852815555,1,418,487,0
70853162366,70853162366,0,1468,2763,0
70853874149,70853874150,1,1042,1620,0
70856786218,70856786217,-1,1346,2125,0
70856826275,70856826275,0,1052,859,0
70858071197,70858071198,1,1332,1739,0
70858253958,70858253966,8,195,826,0
70860093993,70860093995,2,1511,1805,0
70860125850,70860125849,-1,1162,1849,0
70862341919,70862341914,-5,1015,1547,0
70863665609,70863665610,1,1413,1726,0
70865660270,70865660271,1,1190,1468,0
70866363139,70866363142,3,968,1331,0
70869794531,70869794530,-1,1297,2131,0
70870544810,70870544810,0,1488,2125,0
70871369894,70871369914,20,1595,1640,0
70872346173,70872346174,1,977,1629,0
70873579161,70873579162,1,1882,1591,0
70875523122,70875523124,2,1395,1976,0
70877979998,70877979994,-4,1140,2471,0
70879186017,70879186015,-2,1342,1293,0
70882602611,70882602612,1,1317,1557,0
70884556636,70884556637,1,830,1432,0
70889504068,70889504067,-1,1522,2409,0
70889569725,70889569726,1,1653,1345,0
70892738716,70892738716,0,1441,2048,0
70893142326,70893142326,0,1117,2023,0
70895782995,70895782994,-1,2040,2007,0
70896864419,70896864420,1,1307,1914,0
70898740418,70898740425,7,1075,963,0
70901637514,70901637517,3,963,1505,0
70902132677,70902132679,2,2222,2280,0
70902552471,70902552470,-1,1406,2123,0
70904368342,70904368343,1,941,2075,0
70904571318,70904571319,1,1576,1501,0
70904599391,70904599390,-1,872,1032,0
70905552118,70905552119,1,1393,2044,0
70908081061,70908081063,2,697,919,0
70909012278,70909012278,0,2126,2099,0
70910572456,70910572457,1,1566,1695,0
70915901183,70915901185,2,1374,1961,0
70916898029,70916898030,1,1333,2254,0
70917370529,70917370531,2,1826,1660,0
70917431991,70917431990,-1,942,1296,0
70917904655,70917904654,-1,1066,1258,0
70918105657,70918105658,1,1246,1415,0
70921383049,70921383053,4,2593,1362,0
70922766270,70922766269,-1,1003,1642,0
70925321601,70925321601,0,1227,1866,0
70925480107,70925480107,0,1340,1421,0
70926244182,70926244183,1,1601,1370,0
70929407972,70929407974,2,1249,1269,0
70930488859,70930488859,0,1655,2008,0
70934311682,70934311664,-18,765,665,0
70940261973,70940261974,1,1407,1377,0
70942430708,70942430711,3,741,886,0
70942470240,70942470246,6,7813,2827,0
70943927214,70943927214,0,1331,1425,0
70945257445,70945257442,-3,1177,2255,0
70947627551,70947627553,2,1631,1537,0
70948512090,70948512092,2,1433,2017,0
70948921751,70948921751,0,1202,1351,0
70951324371,70951324374,3,1480,1684,0
70952899240,70952899241,1,1433,1492,0
70953326018,70953326039,21,255,2586,0
70954160482,70954160485,3,1043,950,0
70955334255,70955334256,1,1485,1372,0
70956160249,70956160254,5,2421,1284,0
70956799443,70956799442,-1,907,1342,0
70957987647,70957987647,0,1240,1150,0
70959913311,70959913312,1,1556,2103,0
70962078795,70962078796,1,1323,1468,0
70962911044,70962911044,0,1333,1608,0
70968004587,70968004587,0,1606,1810,0
70968031010,70968031013,3,1931,2169,0
70970510595,70970510589,-6,737,1508,0
70973314953,70973314955,2,1873,1992,0
70974553814,70974553816,2,1124,2102,0
70975675798,70975675797,-1,1067,1597,0
70976699586,70976699589,3,934,1214,0
70977620293,70977620294,1,2158,2140,0
70978005443,70978005441,-2,1464,1839,0
70978747138,70978747138,0,1301,1757,0
70980204205,70980204203,-2,1722,2885,0
70980257359,70980257357,-2,1400,1645,0
70980360275,70980360292,17,1543,1740,0
70985965995,70985965994,-1,1023,1874,0
70992112698,70992112696,-2,1737,1941,0
70992631550,70992631556,6,4375,2936,0
70998721447,70998721446,-1,1906,1688,0
70999438234,70999438232,-2,783,868,0
70999990239,70999990240,1,595,1054,0
71003791410,71003791411,1,1238,1203,0
71005006561,71005006558,-3,883,1420,0
71009181017,71009181019,2,2458,2536,0
71011476094,71011476094,0,1421,1849,0
71012209046,71012209047,1,917,1342,0
71012487809,71012487809,0,1078,1606,0
71017731058,71017731059,1,1420,1893,0
71018700002,71018700002,0,1402,1899,0
71019055111,71019055113,2,12603,9493,0
71022709834,71022709834,0,1736,1475,0
71026932214,71026932217,3,1426,1086,0
71028866533,71028866532,-1,1205,1716,0
71031474342,71031474343,1,2433,2590,0
71032193317,71032193315,-2,967,1922,0
71033211753,71033211754,1,1237,1878,0
71034142133,71034142133,0,1493,1622,0
71037278202,71037278202,0,1226,2637,0
71037899439,71037899434,-5,860,1852,0
71041236240,71041236238,-2,904,1603,0
71041542767,71041542766,-1,1340,1893,0
71042769095,71042769098,3,1909,1927,0
71043392986,71043392985,-1,1318,1926,0
71043921290,71043921290,0,1475,1564,0
71046001931,71046001918,-13,1458,2150,0
71048909964,71048909963,-1,794,1175,0
71051420887,71051420887,0,1259,1547,0
71052589625,71052589630,5,2393,1242,0
71055557354,71055557354,0,1740,1979,0
71056009019,71056009018,-1,1279,2076,0
71062110582,71062110581,-1,1188,1887,0
71062234168,71062234166,-2,1228,1249,0
71064345441,71064345440,-1,956,2069,0
71064870919,71064870922,3,1538,1308,0
71066258538,71066258537,-1,1078,1459,0
71067180724,71067180721,-3,988,2426,0
71069634832,71069634834,2,1534,1172,0
71073244068,71073244070,2,965,1050,0
71075769466,71075769466,0,1538,1761,0
71077892410,71077892411,1,1825,2568,0
71081029185,71081029184,-1,1751,1479,0
71081954858,71081954857,-1,1011,1722,0
71084202059,71084202055,-4,833,3705,0
71084266497,71084266497,0,1078,1268,0
71086455766,71086455765,-1,1325,1966,0
71086881334,71086881334,0,860,1806,0
71088250474,71088250473,-1,905,1121,0
71089607220,71089607220,0,1515,1815,0
71090570802,71090570803,1,1002,1552,0
71091476070,71091476072,2,1140,1629,0
71093074953,71093074953,0,1235,1987,0
71093372074,71093372074,0,1202,1308,0
71094234054,71094234074,20,1624,1515,0
71096160626,71096160627,1,914,2126,0
71099138834,71099138834,0,1391,1314,0
71103033675,71103033674,-1,736,1650,0
71107881509,71107881512,3,1323,1339,0
71110400476,71110400475,-1,1218,1306,0
71111617679,71111617678,-1,1617,1682,0
71112295586,71112295585,-1,1816,2223,0
71114062874,71114062876,2,996,1415,0
71114441582,71114441582,0,1131,1441,0
71120645183,71120645182,-1,1495,1933,0
71122294184,71122294183,-1,1024,1413,0
71123227714,71123227714,0,1735,2654,0
71123608892,71123608891,-1,1324,1341,0
71126421447,71126421450,3,1471,1170,0
71126690740,71126690739,-1,1698,3026,0
71126882573,71126882561,-12,1024,1493,0
71132082914,71132082916,2,1595,1476,0
71133283418,71133283425,7,13746,25505,0
71134022591,71134022591,0,1166,862,0
71135519034,71135519039,5,3157,1472,0
71135638466,71135638484,18,1425,1448,0
71139182346,71139182344,-2,1624,2607,0
71141002551,71141002551,0,1460,1914,0
71142362675,71142362676,1,2289,2684,0
71142436584,71142436587,3,39392,16146,0
71144792974,71144792974,0,1514,1939,0
71145260221,71145260222,1,1341,1725,0
71145828203,71145828204,1,1971,2104,0
71148541922,71148541923,1,1312,1945,0
71148942198,71148942200,2,1267,1709,0
71149709357,71149709358,1,1705,2084,0
71151197720,71151197721,1,1529,1653,0
71153083379,71153083385,6,2331,1344,0
71155105948,71155105950,2,1597,1585,0
71155363807,71155363809,2,1158,1268,0
71158851819,71158851820,1,1160,1733,0
71159026328,71159026347,19,1331,2697,0
71160011501,71160011502,1,1158,1467,0
71160988335,71160988335,0,1112,2028,0
71162249361,71162249363,2,976,1310,0
71165071138,71165071139,1,1416,1447,0
71165686286,71165686287,1,1414,1939,0
71167426545,71167426545,0,1268,1119,0
71171760377,71171760377,0,1429,1688,0
71172098588,71172098588,0,1251,1385,0
71173721399,71173721376,-23,1061,1793,0
71174395786,71174395786,0,1335,1604,0
71174748753,71174748754,1,932,1442,0
71179369914,71179369913,-1,1565,1599,0
71179854022,71179854024,2,1390,1436,0
71182065235,71182065235,0,1122,1477,0
71182561285,71182561285,0,1228,1884,0
71187141602,71187141602,0,1280,1786,0
71187232494,71187232494,0,955,1207,0
71190433077,71190433078,1,1943,2058,0
71191298503,71191298502,-1,1138,1490,0
71191340057,71191340057,0,1764,1808,0
71192221359,71192221347,-12,1234,1443,0
71197532298,71197532278,-20,879,781,0
71215433099,71215433099,0,1063,1983,0
71217203939,71217203940,1,1642,1620,0
71219890136,71219890133,-3,24933,14370,0
71220534207,71220534206,-1,1156,1810,0
71221313529,71221313527,-2,1335,1575,0
71225131023,71225131026,3,1341,1587,0
71227256317,71227256318,1,1218,851,0
71229178899,71229178898,-1,1224,1646,0
71229440147,71229440141,-6,2281,7262,0
71233286745,71233286745,0,1578,1759,0
71237490734,71237490734,0,1639,2487,0
71239057659,71239057658,-1,1613,1710,0
71240627228,71240627230,2,23051,28603,0
71240657902,71240657902,0,1209,1324,0
71241922979,71241922979,0,1948,1670,0
71242794270,71242794269,-1,1125,1354,0
71243929973,71243929971,-2,1367,1368,0
71244415898,71244415899,1,1876,1822,0
71248580077,71248580079,2,1389,1138,0
71249423722,71249423722,0,1618,1103,0
71250789398,71250789399,1,781,1066,0
71254678833,71254678833,0,1419,1531,0
71260695753,71260695754,1,1553,1837,0
71260953797,71260953798,1,1388,1475,0
71263738306,71263738310,4,1619,1787,0
71267460798,71267460799,1,875,1466,0
71277565818,71277565814,-4,1221,2381,0
71280087706,71280087713,7,8889,43307,0
71280837198,71280837199,1,1479,1391,0
71281661683,71281661682,-1,1353,1716,0
71283673603,71283673602,-1,1838,2050,0
71283938527,71283938525,-2,799,924,0
71289567530,71289567527,-3,1424,3080,0
71293146400,71293146400,0,1628,1516,0
71296001829,71296001829,0,1717,2121,0
71298730226,71298730229,3,1301,1318,0
71299642338,71299642330,-8,33014,13277,0
71303296639,71303296639,0,978,1375,0
71303722990,71303722991,1,1787,1654,0
71305299611,71305299613,2,1146,1611,0
71307371589,71307371591,2,1251,1564,0
71311241824,71311241823,-1,1362,2103,0
71311766667,71311766663,-4,1359,1678,0
71314095603,71314095603,0,1240,1562,0
71314361911,71314361914,3,4092,3767,0
71316137901,71316137900,-1,2346,2818,0
71316174025,71316174026,1,2176,1518,0
71317213361,71317213358,-3,1133,2340,0
71318862708,71318862708,0,1232,1415,0
71321254161,71321254162,1,1548,1575,0
71322111658,71322111661,3,1080,1249,0
71322875812,71322875813,1,1166,1818,0
71324872207,71324872203,-4,1343,3017,0
71327380426,71327380429,3,1439,1707,0
71328972615,71328972616,1,848,1386,0
71333383783,71333383782,-1,1668,1797,0
71334521117,71334521121,4,1497,1439,0
71340921775,71340921775,0,994,1290,0
71341662287,71341662288,1,1786,2643,0
71343408274,71343408274,0,1729,2027,0
71344112628,71344112626,-2,981,1082,0
71344353824,71344353824,0,1561,1940,0
71346649589,71346649588,-1,1433,2268,0
71347034143,71347034142,-1,1549,1378,0
71349716300,71349716299,-1,1957,2235,0
71350771119,71350771123,4,2043,1440,0
71351031077,71351031078,1,1199,1354,0
71352142510,71352142511,1,1590,1656,0
71352440654,71352440653,-1,1396,2174,0
71352964830,71352964827,-3,1097,1482,0
71361002107,71361002109,2,1324,1494,0
71361188545,71361188543,-2,1129,2306,0
71362879466,71362879467,1,1446,1538,0
71367998737,71367998737,0,1627,1715,0
71374400090,71374400090,0,1621,1415,0
71375909530,71375909529,-1,1468,1733,0
71377493456,71377493456,0,1819,2117,0
71379064162,71379064157,-5,692,2907,0
71382431457,71382431459,2,1523,1289,0
71384202442,71384202439,-3,1400,1269,0
71389604326,71389604328,2,1538,1689,0
71391714326,71391714327,1,962,1967,0
71392183547,71392183549,2,1627,1872,0
71393849334,71393849342,8,4759,1581,0
71397065091,71397065086,-5,1957,7198,0
71399817943,71399817943,0,1283,2224,0
71400008394,71400008394,0,1105,1948,0
71400069037,71400069059,22,870,814,0
71404798178,71404798174,-4,2314,4727,0
71406859540,71406859541,1,1287,1535,0
71407247930,71407247930,0,1307,2114,0
71407972339,71407972339,0,1429,1642,0
71410924265,71410924265,0,1071,2135,0
71412850571,71412850567,-4,1555,1928,0
71414453661,71414453666,5,3743,2074,0
71414923922,71414923915,-7,1670,12281,0
71415766629,71415766630,1,1023,1045,0
71417509880,71417509879,-1,1268,1427,0
71419475295,71419475294,-1,1343,1707,0
71420462043,71420462045,2,1450,1360,0
71421573576,71421573576,0,1232,1688,0
71426988551,71426988552,1,1453,1437,0
71427999997,71427999997,0,1113,1694,0
71428308299,71428308300,1,1138,1697,0
71428700358,71428700359,1,1807,2427,0
71432168924,71432168930,6,3497,1609,0
71432293175,71432293171,-4,1980,3004,0
71434023992,71434023993,1,1119,1749,0
71434332426,71434332429,3,1614,1420,0
71434665217,71434665217,0,1134,1195,0
71436348218,71436348218,0,1515,2034,0
71437461721,71437461724,3,1155,1604,0
71438782611,71438782610,-1,1305,2030,0
71443286442,71443286442,0,1639,2254,0
71443448527,71443448526,-1,765,1447,0
71443940772,71443940774,2,1196,1331,0
71445658735,71445658729,-6,856,4078,0
71445853452,71445853453,1,1496,1114,0
71446398491,71446398470,-21,1615,1782,0
71452030057,71452030057,0,1420,2063,0
71453817526,71453817522,-4,1008,1770,0
71456183529,71456183529,0,1365,2006,0
71457286928,71457286930,2,1710,1739,0
71457945250,71457945231,-19,566,523,0
71458612599,71458612598,-1,1370,2383,0
71465542335,71465542335,0,1822,1434,0
71467283911,71467283913,2,1322,2161,0
71471860970,71471860971,1,2030,2203,0
71472656838,71472656842,4,1394,1556,0
71475592945,71475592950,5,1522,1427,0
71478921361,71478921359,-2,1074,1312,0
71483458654,71483458657,3,2120,1778,0
71483771454,71483771450,-4,1266,2460,0
71486379886,71486379887,1,1475,1681,0
71489393538,71489393539,1,1055,1975,0
71490054967,71490054966,-1,1627,1606,0
71490454423,71490454424,1,1899,2262,0
71490721877,71490721875,-2,2693,4703,0
71494535479,71494535482,3,1118,1395,0
71495705947,71495705946,-1,1449,1865,0
71502090426,71502090429,3,1477,1441,0
71502175615,71502175615,0,1523,1608,0
71504054009,71504054012,3,1637,1968,0
71504266066,71504266064,-2,1059,1674,0
71504454543,71504454545,2,1235,1389,0
71507332613,71507332617,4,4560,2350,0
71515531894,71515531895,1,709,1352,0
71518287037,71518287039,2,1847,1790,0
71520263003,71520263005,2,1428,2082,0
71521190093,71521190094,1,1326,1857,0
71529226105,71529226107,2,911,1091,0
71532217546,71532217548,2,1099,1207,0
71533343496,71533343497,1,1482,1256,0
71534610160,71534610157,-3,1397,1887,0
71535685512,71535685513,1,1173,1084,0
71537586074,71537586074,0,1114,1049,0
71541982366,71541982365,-1,1677,1865,0
71544183476,71544183477,1,1172,1591,0
71547813940,71547813943,3,2531,2349,0
71548523230,71548523230,0,1665,1842,0
71550839538,71550839539,1,1381,1753,0
71550982677,71550982675,-2,1262,1553,0
71551974135,71551974136,1,1243,1676,0
71555295628,71555295629,1,1384,1710,0
71559100956,71559100955,-1,1448,1763,0
71562957727,71562957726,-1,1355,1636,0
71563828570,71563828570,0,1435,2655,0
71568458141,71568458142,1,1348,1866,0
71568592650,71568592653,3,726,885,0
71571254501,71571254502,1,1210,1841,0
71574583537,71574583535,-2,1360,2330,0
71574751461,71574751460,-1,1858,2698,0
71579312382,71579312382,0,1766,2266,0
71583124150,71583124149,-1,1134,2198,0
71584819189,71584819192,3,1478,1678,0
71586962219,71586962219,0,1899,2135,0
71588505771,71588505771,0,1332,1228,0
71590037246,71590037246,0,1751,1731,0
71591307533,71591307533,0,1133,1808,0
71592144589,71592144587,-2,969,1234,0
71593137018,71593137016,-2,630,597,0
71593268380,71593268381,1,1349,2741,0
71596871232,71596871232,0,1375,1454,0
71597715464,71597715466,2,1755,1136,0
71599114883,71599114882,-1,2077,3097,0
71602287127,71602287128,1,1322,1597,0
71602518281,71602518282,1,2052,1824,0
71604353057,71604353058,1,1493,1313,0
71609086761,71609086762,1,1742,2597,0
71610727168,71610727167,-1,1223,1736,0
71611822123,71611822125,2,1706,1755,0
71615570338,71615570334,-4,742,1468,0
71618510050,71618510050,0,1758,1518,0
71623169472,71623169471,-1,1678,1402,0
71623357465,71623357467,2,1832,1253,0
71625104394,71625104395,1,1059,1441,0
71626371732,71626371733,1,1537,1756,0
71630390573,71630390575,2,1478,1470,0
71637259310,71637259309,-1,1334,2166,0
71638552890,71638552890,0,1658,1937,0
71639365120,71639365122,2,1256,1804,0
71641175934,71641175936,2,1515,1293,0
71642497134,71642497135,1,1586,1471,0
71642788726,71642788729,3,1256,1307,0
71644727831,71644727832,1,1121,1737,0
71647804131,71647804133,2,1219,1437,0
71651761635,71651761634,-1,1271,2077,0
71654646871,71654646870,-1,1806,1440,0
71655309105,71655309103,-2,714,61,0
71655421226,71655421225,-1,1014,1467,0
71656085537,71656085539,2,1626,1162,0
71658823025,71658823025,0,1535,1465,0
71666546453,71666546450,-3,1052,1472,0
71667401665,71667401662,-3,1465,2050,0
71676276107,71676276095,-12,1456,1689,0
71677444856,71677444856,0,1882,2289,0
71677855935,71677855933,-2,526,1007,0
71680538202,71680538217,15,1168,1488,0
71681472026,71681472028,2,1110,1585,0
71682402983,71682402984,1,1431,1885,0
71682668737,71682668735,-2,1526,1551,0
71684870934,71684870932,-2,1341,2137,0
71685336108,71685336116,8,1375,1884,0
71685801422,71685801424,2,2001,2432,0
71687966048,71687966049,1,928,1180,0
71688688818,71688688823,5,2799,1120,0
71688995066,71688995087,21,2026,2189,0
71693991532,71693991534,2,1797,1673,0
71694482574,71694482592,18,898,2235,0
71694619934,71694619936,2,1624,1525,0
71696457881,71696457886,5,1207,1725,0
71702888383,71702888385,2,2157,2500,0
71705026180,71705026185,5,2214,1755,0
71710966576,71710966593,17,313,974,0
71717222201,71717222201,0,1188,945,0
71723450070,71723450057,-13,1151,1955,0
71729080594,71729080594,0,966,1630,0
71729739617,71729739615,-2,1068,1323,0
71731039999,71731039998,-1,1272,1937,0
71734008959,71734008961,2,1106,1497,0
71736519983,71736519982,-1,1402,1379,0
71737413757,71737413753,-4,1339,2949,0
71743371911,71743371911,0,1351,1475,0
71743399115,71743399117,2,1301,1714,0
71743553389,71743553389,0,1459,1948,0
71747363150,71747363150,0,1743,1226,0
71748423231,71748423230,-1,1203,2169,0
71751072254,71751072255,1,2485,2972,0
71752301694,71752301696,2,1713,2049,0
71753424953,71753424966,13,1184,1285,0
71758992310,71758992312,2,1117,1686,0
71759359537,71759359535,-2,1248,972,0
71760210253,71760210254,1,1733,1606,0
71762810419,71762810419,0,1167,959,0
71763823047,71763823050,3,1840,1854,0
71764862310,71764862310,0,1788,2256,0
71765101948,71765101948,0,1803,2047,0
71773281906,71773281906,0,1611,2083,0
71775295460,71775295461,1,1193,1728,0
71776502796,71776502797,1,1920,1759,0
71777634339,71777634339,0,1485,2406,0
71778990346,71778990346,0,1657,1824,0
71781149754,71781149753,-1,1316,1528,0
71782686591,71782686589,-2,1438,2193,0
71786711754,71786711754,0,1433,1457,0
71787107416,71787107410,-6,819,3993,0
71792770703,71792770702,-1,1455,1643,0
71792813770,71792813769,-1,1186,1758,0
71792975359,71792975354,-5,1217,1522,0
71794522314,71794522314,0,817,966,0
71795074719,71795074717,-2,1720,1737,0
71798361881,71798361888,7,5695,1487,0
71800555018,71800555019,1,1183,1140,0
71802768843,71802768847,4,1469,1435,0
71804815618,71804815619,1,1300,1722,0
71810067539,71810067539,0,1596,2229,0
71811668657,71811668656,-1,1278,1999,0
71812598760,71812598763,3,1574,1726,0
71819156439,71819156438,-1,660,1046,0
71820148238,71820148239,1,1937,1327,0
71821711029,71821711029,0,1187,1676,0
71822788318,71822788319,1,1184,1256,0
71822851619,71822851618,-1,807,966,0
71823365462,71823365463,1,31987,37167,0
71823921700,71823921716,16,1428,2150,0
71824335797,71824335796,-1,1635,1401,0
71824723376,71824723380,4,2534,1907,0
71825245213,71825245211,-2,887,1224,0
71827275654,71827275654,0,1303,1732,0
71828481693,71828481697,4,1399,1253,0
71830498609,71830498614,5,4043,1131,0
71831120232,71831120234,2,1303,1668,0
71837041743,71837041742,-1,1441,1695,0
71837804548,71837804549,1,1280,1403,0
71839175462,71839175463,1,1162,1553,0
71839295244,71839295226,-18,1132,1684,0
71842034170,71842034169,-1,1287,1852,0
71843870170,71843870171,1,726,1060,0
71844736137,71844736137,0,1737,2272,0
71846036326,71846036327,1,1236,1629,0
71849626571,71849626570,-1,955,1230,0
71852139134,71852139132,-2,1604,2174,0
71853534497,71853534497,0,1257,1813,0
71854235883,71854235882,-1,1162,1305,0
71854910067,71854910069,2,1065,2109,0
71857092206,71857092205,-1,1438,1643,0
71858497093,71858497095,2,1148,1449,0
71861273518,71861273510,-8,70,975,0
71863157820,71863157818,-2,1568,1707,0
71863529362,71863529361,-1,1478,1819,0
71863679527,71863679526,-1,982,1545,0
71865571593,71865571593,0,1302,2082,0
71865721209,71865721209,0,1738,2025,0
71872270391,71872270392,1,1861,2015,0
71876350381,71876350383,2,1380,1692,0
71880606587,71880606587,0,900,1549,0
71881284766,71881284772,6,1377,829,0
71885035601,71885035602,1,1342,1622,0
71886585334,71886585334,0,1060,1487,0
71887867781,71887867781,0,1405,1945,0
71890520240,71890520227,-13,1468,1801,0
71891603286,71891603287,1,1607,2352,0
71894064286,71894064283,-3,1140,2398,0
71899306517,71899306515,-2,1475,1930,0
71899624517,71899624516,-1,1706,2128,0
71902031154,71902031152,-2,2449,4057,0
71902515747,71902515746,-1,2488,2662,0
71903241112,71903241112,0,1948,2207,0
71909064775,71909064777,2,793,1937,0
71911772957,71911772959,2,1462,1754,0
71912016343,71912016331,-12,1348,1860,0
71912046141,71912046141,0,1199,2182,0
71912495479,71912495478,-1,1214,1188,0
71915506131,71915506132,1,1192,1996,0
71918942233,71918942230,-3,1562,2075,0
71920471310,71920471309,-1,2251,2521,0
71922296997,71922296994,-3,1297,2284,0
71923940501,71923940500,-1,1149,1398,0
71925159583,71925159584,1,1648,1656,0
71930251058,71930251058,0,1385,1087,0
71935881985,71935881986,1,1366,1768,0
71936151825,71936151823,-2,1236,1799,0
71936537174,71936537177,3,1664,1544,0
71938565206,71938565206,0,1155,1355,0
71938781141,71938781138,-3,1654,2800,0
71943675309,71943675310,1,1019,1479,0
71946210794,71946210794,0,1853,2060,0
71947306793,71947306778,-15,1050,400,0
71952030450,71952030450,0,1072,1531,0
71956772785,71956772786,1,1765,1520,0
71957436135,71957436138,3,1558,1587,0
71959531669,71959531669,0,1196,1940,0
71960637667,71960637666,-1,1884,2172,0
71960812189,71960812192,3,1326,1358,0
71960992551,71960992553,2,1689,1553,0
71961899613,71961899614,1,1103,1855,0
71964323213,71964323213,0,1531,1553,0
71964620851,71964620853,2,1501,2253,0
71966330202,71966330207,5,2634,1159,0
71968294573,71968294574,1,1684,1928,0
71979871661,71979871669,8,1461,1242,0
71982747422,71982747409,-13,1199,1575,0
71982940117,71982940118,1,1343,2176,0
71991548765,71991548769,4,1121,1569,0
71992614623,71992614621,-2,1257,2481,0
71996072039,71996072040,1,1457,1634,0
71996297580,71996297578,-2,1216,1911,0
71996725603,71996725604,1,1325,1854,0
71999747953,71999747955,2,1372,1894,0
72000644151,72000644132,-19,1060,1629,0
72001489018,72001489019,1,2713,3466,0
72002772762,72002772762,0,1820,1337,0
72003555886,72003555887,1,1184,1058,0
72003938449,72003938448,-1,1399,1710,0
72004894535,72004894534,-1,1257,1408,0
72005043625,72005043626,1,952,1268,0
72007311897,72007311880,-17,1123,1828,0
72011776374,72011776377,3,2016,2333,0
72014483255,72014483234,-21,1104,1190,0
72018246174,72018246178,4,763,1218,0
72019060503,72019060504,1,1462,1670,0
72020774485,72020774485,0,1953,2343,0
72024708955,72024708954,-1,1108,1660,0
72026033173,72026033174,1,2298,2145,0
72026256510,72026256511,1,1172,2264,0
72031861634,72031861634,0,1213,1479,0
72038591271,72038591274,3,1051,1571,0
72041331294,72041331292,-2,1182,1848,0
72042056864,72042056863,-1,1584,1953,0
72044564434,72044564436,2,2468,2497,0
72045497644,72045497644,0,1345,1937,0
72046421522,72046421526,4,1728,1166,0
72047097451,72047097445,-6,1194,1478,0
72047753358,72047753358,0,987,1589,0
72050438506,72050438506,0,1293,1233,0
72061132085,72061132086,1,1516,1482,0
72061801682,72061801683,1,1221,1940,0
72061840246,72061840228,-18,1610,1771,0
72063048173,72063048172,-1,908,1879,0
72063811640,72063811639,-1,1168,3150,0
72064109173,72064109175,2,1627,2096,0
72067989971,72067989983,12,2226,1750,0
72071377307,72071377309,2,1386,1459,0
72074059699,72074059698,-1,1510,2394,0
72077443820,72077443825,5,4323,2077,0
72077741907,72077741903,-4,863,1843,0
72080873232,72080873236,4,2349,1659,0
72083571447,72083571447,0,1290,1500,0
72084915389,72084915389,0,1017,2133,0
72086759194,72086759185,-9,579,2018,0
72087094458,72087094458,0,1098,1155,0
72091610502,72091610501,-1,1064,1704,0
72093608726,72093608726,0,1410,1893,0
72095975229,72095975237,8,2078,762,0
72097716434,72097716433,-1,1118,1702,0
72101351538,72101351539,1,2272,2021,0
72103025238,72103025239,1,1462,1833,0
72103979398,72103979401,3,1105,1478,0
72107640242,72107640243,1,1248,1117,0
72110085307,72110085305,-2,901,1891,0
72114033203,72114033205,2,1173,892,0
72116573360,72116573363,3,1173,1322,0
72116908810,72116908825,15,851,1551,0
72120930014,72120930016,2,1347,1950,0
72125024174,72125024174,0,878,760,0
72125853828,72125853851,23,1041,1076,0
72126844373,72126844375,2,1240,2321,0
72130917354,72130917354,0,627,1119,0
72135458326,72135458325,-1,1269,1682,0
72142305115,72142305115,0,1611,2336,0
72142559245,72142559246,1,1521,1229,0
72143018606,72143018607,1,1641,1487,0
72144680602,72144680612,10,14440,42738,0
72145086446,72145086424,-22,1551,1630,0
72146072974,72146072974,0,946,1154,0
72148297633,72148297635,2,1656,983,0
72148386045,72148386042,-3,1406,1296,0
72148594441,72148594443,2,1458,1739,0
72154190435,72154190435,0,999,1170,0
72157509494,72157509497,3,1600,1899,0
72160096085,72160096083,-2,1173,1647,0
72170492087,72170492088,1,964,1225,0
72181491922,72181491925,3,1511,1388,0
72181780591,72181780591,0,1352,1956,0
72184520351,72184520353,2,1421,1385,0
72185773042,72185773046,4,1465,1392,0
72187408522,72187408524,2,937,1800,0
72189492195,72189492177,-18,1531,2304,0
72190448230,72190448232,2,947,1332,0
72193224354,72193224354,0,692,772,0
72204201941,72204201942,1,1389,2340,0
72204472861,72204472863,2,1181,1464,0
72207211021,72207211022,1,1502,2068,0
72207818759,72207818756,-3,1418,1996,0
72208407200,72208407203,3,4548,3004,0
72212609084,72212609085,1,1110,1439,0
72222550785,72222550786,1,1856,1785,0
72224494351,72224494351,0,1953,2869,0
72225610506,72225610506,0,1212,1271,0
72227983738,72227983739,1,1372,2628,0
72228106311,72228106310,-1,1074,1760,0
72228514581,72228514584,3,1476,1629,0
72228701483,72228701482,-1,1275,2130,0
72230293803,72230293804,1,1338,1544,0
72234968699,72234968701,2,1373,1315,0
72236632954,72236632957,3,1626,1296,0
72245103234,72245103234,0,1856,2449,0
72250529053,72250529053,0,1981,1942,0
72253732697,72253732698,1,1302,1439,0
72256894062,72256894059,-3,1136,1383,0
72257130574,72257130575,1,1535,1538,0
72258079851,72258079852,1,1692,2310,0
72260563122,72260563117,-5,496,1442,0
72264752770,72264752771,1,1319,1287,0
72265786909,72265786910,1,1666,1557,0
72266356366,72266356365,-1,1076,1583,0
72267408022,72267408041,19,707,886,0
72268444226,72268444226,0,1652,1942,0
72272619825,72272619826,1,1576,1692,0
72273143731,72273143732,1,1996,1463,0
72273500838,72273500838,0,1083,1803,0
72273558764,72273558763,-1,1325,1523,0
72274975478,72274975482,4,1174,1407,0
72276878506,72276878506,0,1572,1268,0
72277227959,72277227959,0,1549,1569,0
72280645395,72280645398,3,2050,2311,0
72281846044,72281846043,-1,1702,1881,0
72282312797,72282312797,0,1681,1509,0
72284172141,72284172141,0,1562,2174,0
72284485652,72284485651,-1,1595,1738,0
72287984537,72287984537,0,1596,1851,0
72289315767,72289315768,1,1455,1980,0
72290982525,72290982523,-2,1081,1414,0
72291999418,72291999418,0,1800,2118,0
72292257923,72292257924,1,1613,2059,0
72292634553,72292634554,1,1529,1800,0
72294388567,72294388562,-5,1411,3748,0
72298528712,72298528714,2,1817,1574,0
72299730482,72299730485,3,1456,1520,0
72302238960,72302238982,22,331,523,0
72303796223,72303796220,-3,872,1674,0
72305967423,72305967424,1,1538,2021,0
72309163283,72309163282,-1,1261,1620,0
72323314020,72323314017,-3,1325,3725,0
72323937302,72323937306,4,21051,19804,0
72323994453,72323994454,1,1291,1294,0
72325002186,72325002185,-1,1151,1477,0
72325792829,72325792833,4,1867,1746,0
72326701581,72326701574,-7,2521,7688,0
72327262559,72327262558,-1,2038,2158,0
72327843987,72327843988,1,1493,1627,0
72327980246,72327980248,2,1400,1458,0
72328634711,72328634713,2,1916,2130,0
72333251815,72333251815,0,1370,1809,0
72333306593,72333306598,5,2625,1743,0
72333353029,72333353034,5,2331,1286,0
72335444354,72335444354,0,1070,1805,0
72336102482,72336102481,-1,1609,2065,0
72337656576,72337656575,-1,1297,1844,0
72338324339,72338324340,1,1278,1390,0
72340187321,72340187321,0,1491,1823,0
72340583838,72340583841,3,2997,2066,0
72343085153,72343085153,0,1735,1805,0
72343273812,72343273811,-1,1183,1298,0
72344755626,72344755623,-3,1678,3551,0
72345870151,72345870151,0,1352,1369,0
72350202262,72350202262,0,1713,1839,0
72353728779,72353728783,4,1370,1105,0
72355421606,72355421607,1,1558,1230,0
72356663131,72356663133,2,933,790,0
72366172954,72366172954,0,1819,1786,0
72366440618,72366440620,2,1290,1713,0
72367727684,72367727685,1,1147,1849,0
72368687176,72368687177,1,1413,1837,0
72369278410,72369278414,4,819,1156,0
72370638911,72370638911,0,1364,1731,0
72370788018,72370788018,0,1248,930,0
72371015369,72371015367,-2,8208,14654,0
72371869392,72371869396,4,2621,2259,0
72372088314,72372088314,0,2113,2310,0
72372316102,72372316108,6,2699,1789,0
72374886627,72374886627,0,1099,2051,0
72377059352,72377059354,2,1114,1490,0
72381769523,72381769525,2,1814,2617,0
72382605894,72382605898,4,1486,1719,0
72384272253,72384272237,-16,2112,1001,0
72390147653,72390147657,4,1497,1307,0
72390961605,72390961606,1,1431,1874,0
72391325761,72391325761,0,1233,1727,0
72395357917,72395357917,0,1711,1956,0
72395904678,72395904678,0,1804,1395,0
72396325611,72396325610,-1,1226,1398,0
72396841578,72396841579,1,915,1230,0
72398344727,72398344726,-1,1270,1799,0
72400503722,72400503720,-2,554,1011,0
72400878148,72400878142,-6,1776,6974,0
72402071834,72402071834,0,1407,2159,0
72403487478,72403487478,0,815,967,0
72406984889,72406984890,1,1529,1776,0
72408751278,72408751278,0,1654,1586,0
72415164430,72415164437,7,7660,2850,0
72417789801,72417789799,-2,1691,2414,0
72419528628,72419528626,-2,1002,965,0
72424514468,72424514468,0,1504,2177,0
72429694579,72429694580,1,1009,2113,0
72432040967,72432040968,1,1716,2540,0
72433244663,72433244661,-2,1122,1643,0
72440168039,72440168037,-2,1210,2147,0
72441432596,72441432597,1,1540,2005,0
72442104669,72442104657,-12,931,1938,0
72442711917,72442711918,1,1508,1351,0
72444531602,72444531603,1,1578,2047,0
72448173270,72448173270,0,1600,2086,0
72449763166,72449763167,1,1054,1049,0
72451935035,72451935035,0,1173,1402,0
72457821439,72457821440,1,1430,2074,0
72460595714,72460595713,-1,839,1246,0
72461160210,72461160217,7,2621,1299,0
72462938133,72462938134,1,1558,1790,0
72463079866,72463079866,0,1144,1928,0
72463288313,72463288317,4,1980,1235,0
72463864647,72463864630,-17,6440,2389,0
72464934531,72464934528,-3,2135,4945,0
72467109955,72467109958,3,1514,1206,0
72468265526,72468265528,2,1381,1916,0
72469827915,72469827925,10,1281,1667,0
72469957102,72469957101,-1,810,556,0
72470297791,72470297791,0,933,1499,0
72471986047,72471986049,2,1891,1596,0
72475856381,72475856377,-4,1262,1382,0
72477981817,72477981821,4,2059,1902,0
72478880926,72478880925,-1,1741,1586,0
72482244635,72482244639,4,1472,1435,0
72483768106,72483768109,3,2195,1780,0
72485486191,72485486191,0,1253,1951,0
72487600757,72487600759,2,1057,1014,0
72489937011,72489937012,1,2141,2174,0
72490299488,72490299489,1,1401,1521,0
72491642100,72491642099,-1,910,1957,0
72497584482,72497584481,-1,1770,1780,0
72498469171,72498469169,-2,1115,1944,0
72500824387,72500824390,3,1303,1559,0
72502430052,72502430053,1,1990,2960,0
72503075547,72503075549,2,1497,1519,0
72505410632,72505410631,-1,1293,1317,0
72506584916,72506584915,-1,724,1240,0
72507509553,72507509555,2,1225,1719,0
72508788638,72508788637,-1,1560,2168,0
72509394422,72509394421,-1,34723,46640,0
72509598583,72509598584,1,1507,2020,0
72512166735,72512166737,2,1311,1535,0
72513425137,72513425138,1,1462,2390,0
72514834705,72514834705,0,1381,1881,0
72515371184,72515371185,1,1171,2103,0
72515653978,72515653998,20,1151,1256,0
72516395312,72516395314,2,1332,1647,0
72519140886,72519140885,-1,983,1876,0
72519218624,72519218626,2,315,1757,0
72521765209,72521765209,0,2041,2212,0
72522344770,72522344772,2,1352,1589,0
72525037253,72525037252,-1,1335,1800,0
72530002261,72530002262,1,1299,1389,0
72532075151,72532075130,-21,1953,1155,0
72532843951,72532843947,-4,1233,2201,0
72533549649,72533549649,0,1333,1830,0
72534176242,72534176243,1,1440,1966,0
72535047822,72535047822,0,802,1104,0
72537058535,72537058543,8,1178,1269,0
72538458384,72538458388,4,1463,1703,0
72539633402,72539633403,1,1396,1625,0
72541948662,72541948673,11,1789,922,0
72543760841,72543760842,1,1688,1738,0
72547296993,72547296995,2,1809,2046,0
72550890899,72550890900,1,1951,2439,0
72551977777,72551977778,1,1295,2466,0
72556168031,72556168024,-7,1259,3982,0
72564158637,72564158640,3,2209,2206,0
72566321067,72566321066,-1,1436,1288,0
72567314678,72567314680,2,1609,1874,0
72571703127,72571703127,0,1142,1640,0
72573691307,72573691307,0,1530,1363,0
72574383734,72574383734,0,416,544,0
72575254857,72575254859,2,1846,1665,0
72577791370,72577791369,-1,1220,1576,0
72580238670,72580238668,-2,1004,2003,0
72580688110,72580688119,9,3290,1171,0
72580721629,72580721629,0,1250,1751,0
72583455457,72583455457,0,1541,1486,0
72583821646,72583821646,0,1261,1943,0
72586798826,72586798819,-7,1618,7380,0
72587771257,72587771258,1,2333,1671,0
72588763473,72588763480,7,19385,44624,0
72591186233,72591186235,2,1185,2105,0
72593826778,72593826781,3,1926,1914,0
72599180238,72599180238,0,1217,1601,0
72601268660,72601268661,1,1549,2162,0
72602202843,72602202848,5,3560,1608,0
72602723990,72602723991,1,1498,2434,0
72603849537,72603849539,2,703,1076,0
72606958155,72606958154,-1,1392,1639,0
72608040492,72608040494,2,1437,1868,0
72609724398,72609724410,12,392,1060,0
72611594571,72611594570,-1,2386,4437,0
72611714250,72611714250,0,1710,1836,0
72613072966,72613072969,3,1250,1535,0
72613608702,72613608704,2,1605,2029,0
72613775099,72613775099,0,1241,1645,0
72617904241,72617904246,5,2106,1005,0
72625644343,72625644345,2,1281,1616,0
72626840536,72626840538,2,1332,1579,0
72632416521,72632416521,0,2002,2145,0
72633143746,72633143743,-3,1424,1662,0
72633435572,72633435573,1,1815,2038,0
72635506567,72635506569,2,879,1022,0
72640460496,72640460496,0,1689,1751,0
72640877002,72640877003,1,1202,1468,0
72640961798,72640961799,1,1620,1641,0
72641020863,72641020864,1,758,1225,0
72641720002,72641720002,0,1230,1839,0
72644752859,72644752862,3,784,1248,0
72648274858,72648274858,0,1848,2029,0
72655395274,72655395274,0,1176,1096,0
72656901678,72656901677,-1,1104,1251,0
72658152588,72658152590,2,753,1301,0
72660820755,72660820748,-7,1994,10711,0
72664986242,72664986242,0,1481,1544,0
72667804190,72667804190,0,1673,2076,0
72667869394,72667869394,0,1188,1258,0
72669249307,72669249307,0,1298,2185,0
72671068827,72671068825,-2,1137,1603,0
72671805774,72671805775,1,1025,1930,0
72674277604,72674277601,-3,35015,13693,0
72675761677,72675761675,-2,1670,1412,0
72677884465,72677884465,0,1275,1074,0
72678998090,72678998109,19,1319,1864,0
72680994026,72680994028,2,1858,2003,0
72687079065,72687079066,1,1260,1452,0
72688972153,72688972156,3,1949,1419,0
72689402458,72689402464,6,2590,1497,0
72689523100,72689523112,12,481,422,0
72689882824,72689882803,-21,1004,1609,0
72693513624,72693513638,14,11927,43344,0
72693812903,72693812902,-1,1449,1969,0
72693895130,72693895129,-1,1012,1591,0
72697142179,72697142182,3,1088,1405,0
72697407263,72697407263,0,839,1082,0
72702867307,72702867307,0,1468,1821,0
72705131018,72705131016,-2,1224,1610,0
72705917242,72705917242,0,1214,1552,0
72706640306,72706640305,-1,1481,1709,0
72708650742,72708650740,-2,1104,1704,0
72711418025,72711418026,1,1726,2072,0
72714895997,72714895999,2,1615,1594,0
72716965389,72716965409,20,969,1337,0
72717198907,72717198909,2,1866,2071,0
72721591661,72721591661,0,1419,1377,0
72729996260,72729996260,0,852,2430,0
72730961286,72730961289,3,719,1366,0
72731627669,72731627660,-9,1524,1682,0
72733119860,72733119861,1,1574,1940,0
72733701027,72733701029,2,973,1279,0
72734766832,72734766831,-1,1185,1611,0
72736415958,72736415958,0,1545,1530,0
72737668261,72737668259,-2,960,1521,0
72742604070,72742604070,0,1378,1712,0
72744782613,72744782614,1,1777,2013,0
72745850078,72745850079,1,1829,1822,0
72749756807,72749756808,1,1278,1244,0
72750376383,72750376382,-1,1746,2285,0
72752658241,72752658241,0,1117,1973,0
72758060265,72758060269,4,1399,1400,0
72759258478,72759258478,0,1348,2016,0
72759625273,72759625275,2,1442,2069,0
72760463233,72760463233,0,1203,1461,0
72762534933,72762534941,8,16456,24991,0
72763753597,72763753595,-2,6993,12874,0
72763985719,72763985719,0,1535,1650,0
72772008210,72772008211,1,1195,1590,0
72775078838,72775078838,0,1243,1619,0
72777559474,72777559475,1,1278,1643,0
72778951361,72778951363,2,1217,2028,0
72780593614,72780593615,1,1174,1178,0
72780824618,72780824619,1,1373,1270,0
72781374429,72781374428,-1,1240,2098,0
72785560110,72785560110,0,1501,1509,0
72788464577,72788464575,-2,1274,1206,0
72793045898,72793045903,5,1591,1747,0
72793280802,72793280801,-1,778,1598,0
72796325483,72796325485,2,1501,1619,0
72799453051,72799453058,7,260,1125,0
72801275846,72801275847,1,1097,1947,0
72808445875,72808445876,1,1340,1217,0
72809756405,72809756405,0,1350,2478,0
72811410909,72811410910,1,1293,1407,0
72815526353,72815526357,4,1013,1383,0
72818560162,72818560163,1,1316,1687,0
72820894875,72820894879,4,1141,1286,0
72823981200,72823981201,1,1541,1717,0
72824763054,72824763055,1,862,968,0
72825643515,72825643517,2,1524,1985,0
72826065494,72826065494,0,1262,1714,0
72828766510,72828766510,0,1676,1661,0
72829504706,72829504707,1,1527,1523,0
72830640865,72830640867,2,1732,1628,0
72833520630,72833520629,-1,1822,2167,0
72834095307,72834095307,0,964,1337,0
72834518494,72834518482,-12,1018,1586,0
72836501753,72836501754,1,725,1269,0
72837280818,72837280818,0,1213,1631,0
72838241587,72838241588,1,1615,1341,0
72845484112,72845484112,0,1350,1374,0
72846957103,72846957101,-2,1029,1325,0
72848293205,72848293205,0,1849,1539,0
72849651758,72849651742,-16,678,2745,0
72851245202,72851245203,1,1617,2448,0
72851688691,72851688692,1,1311,2085,0
72852837382,72852837385,3,3822,3135,0
72853405263,72853405264,1,1678,1785,0
72854460566,72854460566,0,1615,2282,0
72856422292,72856422292,0,1475,1735,0
72858217843,72858217843,0,1213,1922,0
72858372962,72858372961,-1,354,1230,0
72860831637,72860831638,1,1344,1917,0
72861175993,72861175992,-1,919,1157,0
72861443778,72861443777,-1,1240,1437,0
72862123311,72862123311,0,2198,3248,0
72864684435,72864684435,0,952,1317,0
72865646142,72865646145,3,30793,23611,0
72866706639,72866706638,-1,1898,1750,0
72867762737,72867762738,1,1559,2535,0
72868090721,72868090723,2,1690,1487,0
72868640709,72868640707,-2,1406,1676,0
72869547040,72869547041,1,959,1638,0
72871878545,72871878546,1,1537,1793,0
72874442056,72874442054,-2,1986,1951,0
72878928627,72878928628,1,1888,2390,0
72879020261,72879020261,0,1204,1802,0
72883810851,72883810851,0,2030,1995,0
72884146706,72884146707,1,1303,1826,0
72893130983,72893130982,-1,1123,1276,0
72896846839,72896846837,-2,1123,1467,0
72897280649,72897280647,-2,1054,1915,0
72899509502,72899509506,4,2089,1426,0
72901367086,72901367090,4,2065,925,0
72901403498,72901403501,3,937,1215,0
72902431014,72902431015,1,1064,1278,0
72904304318,72904304319,1,1325,910,0
72905956340,72905956339,-1,1125,1554,0
72906246438,72906246439,1,941,1497,0
72907275696,72907275692,-4,1801,4623,0
72909507526,72909507528,2,1510,2285,0
72910360402,72910360401,-1,1390,2110,0
72911365370,72911365371,1,1847,1876,0
72911395790,72911395792,2,1441,2378,0
72912748855,72912748854,-1,1580,1859,0
72912913052,72912913053,1,2109,1911,0
72917478504,72917478505,1,1528,1509,0
72919331206,72919331202,-4,1005,3091,0
72923136202,72923136202,0,1247,1286,0
72925776150,72925776149,-1,933,1570,0
72938982258,72938982263,5,5129,3201,0
72941161842,72941161843,1,1050,1149,0
72942833023,72942833022,-1,1505,1654,0
72942972108,72942972107,-1,631,776,0
72944096989,72944096990,1,1324,1564,0
72950011019,72950011018,-1,1093,1454,0
72950389778,72950389776,-2,1626,2405,0
72952494345,72952494345,0,1378,1604,0
72955562422,72955562423,1,1427,1597,0
72961097163,72961097162,-1,1271,1320,0
72961146451,72961146428,-23,2718,1161,0
72965461827,72965461827,0,1378,1931,0
72966771415,72966771431,16,1297,1302,0
72969770129,72969770131,2,884,1188,0
72971499171,72971499170,-1,1060,1760,0
72973439316,72973439318,2,1435,1773,0
72973914517,72973914518,1,1687,2829,0
72973951600,72973951619,19,1889,1571,0
72974719596,72974719595,-1,1306,1721,0
72979123318,72979123320,2,1726,1336,0
72984240131,72984240130,-1,2113,2370,0
72987058221,72987058222,1,1086,1651,0
72987517826,72987517825,-1,1473,2145,0
72987852647,72987852663,16,1341,1088,0
72989568923,72989568923,0,1062,1621,0
72995887313,72995887313,0,1373,1805,0
72997518306,72997518308,2,1258,1783,0
72998728089,72998728089,0,1115,1733,0
73002876347,73002876346,-1,1198,1848,0
73004977391,73004977390,-1,1347,1639,0
73006715149,73006715149,0,1487,2161,0
73009947463,73009947464,1,1168,1927,0
73011124534,73011124534,0,1222,1573,0
73011855655,73011855663,8,4417,1974,0
73013278813,73013278818,5,3223,1286,0
73019385407,73019385406,-1,1262,1441,0
73020866669,73020866670,1,1265,1431,0
73021839557,73021839558,1,1401,1428,0
73023359861,73023359860,-1,1431,2076,0
73025588869,73025588870,1,1479,1891,0
73029359098,73029359099,1,1618,2204,0
73031569114,73031569112,-2,2171,3663,0
73032504098,73032504098,0,952,1676,0
73037207690,73037207690,0,1788,2599,0
73038059102,73038059103,1,1459,1575,0
73039802472,73039802473,1,1288,1320,0
73042408357,73042408357,0,1083,1942,0
73044629611,73044629611,0,2103,2382,0
73050708270,73050708271,1,1112,1933,0
73051721468,73051721470,2,2844,1713,0
73054351442,73054351446,4,1278,1394,0
73057129986,73057129986,0,1381,1858,0
73058287349,73058287346,-3,979,2397,0
73059277986,73059277986,0,1466,1714,0
73061728452,73061728455,3,1625,1359,0
73066112409,73066112413,4,1102,1629,0
73068801578,73068801579,1,1404,1344,0
73070186890,73070186891,1,1155,1309,0
73070445741,73070445741,0,1877,1778,0
73072097890,73072097893,3,1648,1493,0
73072472387,73072472366,-21,1947,1983,0
73073952078,73073952079,1,979,1764,0
73075311958,73075311958,0,1089,1681,0
73076042435,73076042444,9,1468,1681,0
73078707538,73078707539,1,1907,2574,0
73079472990,73079472990,0,1412,2311,0
73084017073,73084017073,0,2132,3612,0
73085781347,73085781346,-1,1392,1949,0
73087025502,73087025501,-1,1036,2337,0
73088843915,73088843917,2,951,1062,0
73089405875,73089405877,2,1770,1356,0
73091031506,73091031506,0,1342,1753,0
73096938700,73096938699,-1,1377,1758,0
73097684582,73097684582,0,1194,1544,0
73098503630,73098503650,20,1821,2383,0
73107510447,73107510447,0,1325,1397,0
73107611730,73107611730,0,1454,1901,0
73109101190,73109101190,0,1350,1438,0
73110989810,73110989811,1,1261,1709,0
73111605626,73111605627,1,1001,1584,0
73112948884,73112948883,-1,1346,1908,0
73115861500,73115861517,17,656,1178,0
73116860568,73116860568,0,1771,2067,0
73117561416,73117561417,1,2046,2161,0
73118115321,73118115322,1,1615,1734,0
73119241877,73119241878,1,1380,1734,0
73120379029,73120379030,1,1549,1587,0
73121975222,73121975224,2,1421,1859,0
73123152450,73123152449,-1,1132,1364,0
73123583863,73123583866,3,1662,1947,0
73123887558,73123887558,0,1561,1544,0
73126209005,73126209006,1,1764,2509,0
73126484449,73126484450,1,951,1430,0
73127486785,73127486787,2,1525,1905,0
73129654062,73129654062,0,1577,1782,0
73133691150,73133691151,1,1826,2188,0
73134213851,73134213853,2,1527,2244,0
73137023042,73137023041,-1,954,1239,0
73137148007,73137148007,0,1908,2129,0
73144709062,73144709061,-1,1568,1564,0
73147401333,73147401333,0,1623,1493,0
73151588535,73151588533,-2,819,2478,0
73153064881,73153064883,2,1017,1580,0
73154179643,73154179643,0,1472,1380,0
73155248919,73155248918,-1,1097,1371,0
73155465910,73155465910,0,1634,1758,0
73155850425,73155850425,0,1407,1921,0
73159609954,73159609954,0,1347,1951,0
73160458126,73160458125,-1,1476,1628,0
73164026529,73164026530,1,1217,1417,0
73164085748,73164085749,1,1612,2055,0
73165387344,73165387342,-2,1179,1214,0
73165431125,73165431142,17,1704,1535,0
73166584993,73166584994,1,1016,1068,0
73166746165,73166746166,1,1322,1538,0
73169459497,73169459494,-3,1655,2500,0
73172154012,73172154002,-10,1016,641,0
73172710489,73172710490,1,1123,1970,0
73172887672,73172887672,0,1319,1872,0
73174383406,73174383413,7,3615,1206,0
73179490446,73179490445,-1,1548,1767,0
73183273189,73183273182,-7,1221,1432,0
73187200425,73187200429,4,2902,2078,0
73187478863,73187478867,4,1596,1532,0
73190047230,73190047230,0,1483,2010,0
73191284974,73191284975,1,1225,1904,0
73191682174,73191682176,2,1734,1787,0
73192130643,73192130621,-22,789,825,0
73200227969,73200227970,1,905,1675,0
73201846122,73201846121,-1,1417,2149,0
73203261968,73203261968,0,1865,2175,0
73204740141,73204740141,0,1439,2217,0
73208680571,73208680573,2,2385,1421,0
73213357047,73213357046,-1,1021,1540,0
73214743682,73214743682,0,1601,1932,0
73215044060,73215044058,-2,1581,2098,0
73215078802,73215078801,-1,1342,1909,0
73217429986,73217429987,1,1297,1372,0
73217714311,73217714312,1,1196,1564,0
73221624445,73221624442,-3,1116,1576,0
73223681230,73223681230,0,1586,1541,0
73224329203,73224329202,-1,1111,1616,0
73224971145,73224971146,1,1386,1160,0
73227897822,73227897823,1,1717,1584,0
73229827302,73229827304,2,987,1160,0
73230455692,73230455695,3,1188,961,0
73232853710,73232853712,2,1318,1714,0
73235742878,73235742878,0,1685,2506,0
73237234471,73237234473,2,1157,1319,0
73238727613,73238727611,-2,937,1406,0
73248340186,73248340184,-2,1706,3061,0
73248829724,73248829726,2,1126,1200,0
73249285205,73249285206,1,1293,1307,0
73258750766,73258750773,7,1981,1280,0
73259398643,73259398644,1,1444,2388,0
73259994573,73259994574,1,870,1397,0
73262403466,73262403466,0,1362,1335,0
73267443144,73267443143,-1,1445,1812,0
73267585674,73267585674,0,1353,1544,0
73267730618,73267730624,6,3490,2080,0
73268140086,73268140087,1,1354,1768,0
73268265986,73268265990,4,1804,1274,0
73268476751,73268476751,0,1007,1240,0
73269478402,73269478402,0,1116,1445,0
73269531319,73269531302,-17,1244,1611,0
73269980261,73269980259,-2,1413,2094,0
73270510402,73270510402,0,1975,1895,0
73271734526,73271734525,-1,973,1354,0
73273706446,73273706446,0,1321,1269,0
73276590670,73276590672,2,948,2081,0
73282133483,73282133481,-2,1284,1666,0
73282608116,73282608118,2,2177,2217,0
73283388443,73283388443,0,1131,1280,0
73284235574,73284235575,1,867,1448,0
73285799852,73285799864,12,10269,47466,0
73286362702,73286362701,-1,1716,2095,0
73287379814,73287379817,3,1834,1692,0
73293527459,73293527460,1,885,938,0
73295396513,73295396512,-1,1285,1305,0
73295559122,73295559121,-1,1662,1727,0
73296173502,73296173505,3,1530,1796,0
73296501233,73296501232,-1,1353,1934,0
73298024515,73298024515,0,1416,1509,0
73299092032,73299092042,10,8263,40893,0
73300392946,73300392947,1,1335,1345,0
73301431324,73301431323,-1,1240,1411,0
73301547078,73301547098,20,1063,1595,0
73305331878,73305331881,3,1718,1383,0
73307431555,73307431556,1,1182,1855,0
73308155134,73308155135,1,1134,1579,0
73309608909,73309608908,-1,1492,2178,0
73312197595,73312197598,3,1500,1345,0
73312250966,73312250966,0,1229,1530,0
73317042916,73317042917,1,1559,1845,0
73317741497,73317741496,-1,1426,2337,0
73319573351,73319573357,6,1187,853,0
73321030261,73321030283,22,1256,2012,0
73322950251,73322950251,0,1431,1700,0
73323187194,73323187195,1,1526,1322,0
73324938234,73324938238,4,1422,1396,0
73327629082,73327629083,1,962,1113,0
73327893866,73327893865,-1,690,1441,0
73330737848,73330737849,1,1452,1188,0
73331583346,73331583345,-1,1873,2313,0
73335124421,73335124421,0,1870,2841,0
73337117234,73337117234,0,1390,1963,0
73341646675,73341646676,1,1202,1573,0
73342020279,73342020281,2,1695,1943,0
73343282526,73343282528,2,1989,2519,0
73344232788,73344232790,2,1556,1454,0
73345024669,73345024677,8,2787,1162,0
73345226689,73345226686,-3,2309,3671,0
73352125680,73352125679,-1,1518,2123,0
73353643614,73353643610,-4,858,3103,0
73355769071,73355769072,1,1333,1571,0
73357310441,73357310443,2,1743,1924,0
73358352321,73358352322,1,1122,1500,0
73361545586,73361545585,-1,2005,1650,0
73364676010,73364676008,-2,5454,10720,0
73368803217,73368803218,1,1154,1655,0
73370707378,73370707378,0,1467,2296,0
73371997134,73371997133,-1,1712,2107,0
73372164481,73372164483,2,1529,1463,0
73375665326,73375665328,2,1655,1722,0
73377503358,73377503359,1,1397,1030,0
73378748295,73378748294,-1,1415,2225,0
73380627655,73380627656,1,1525,1811,0
73381181499,73381181499,0,1410,1491,0
73381980624,73381980638,14,16630,38773,0
73382342222,73382342222,0,1379,1920,0
73384177819,73384177820,1,1403,1889,0
73384453119,73384453122,3,1154,1187,0
73384487507,73384487510,3,1885,1648,0
73386314576,73386314595,19,236,1013,0
73389822023,73389822023,0,992,1166,0
73390347346,73390347346,0,1243,1953,0
73391339411,73391339410,-1,984,1495,0
73393182035,73393182036,1,1370,2121,0
73395154486,73395154487,1,1919,1611,0
73399749830,73399749830,0,1550,1558,0
73401023720,73401023726,6,1775,777,0
73401260802,73401260800,-2,823,1632,0
73406867857,73406867858,1,1673,1863,0
73407803566,73407803566,0,1397,1924,0
73408326258,73408326263,5,2049,1915,0
73413978594,73413978596,2,1348,1500,0
73415752167,73415752169,2,1207,2103,0
73415889281,73415889281,0,2140,2569,0
73416084796,73416084797,1,1422,1452,0
73418251747,73418251748,1,844,1019,0
73418763614,73418763614,0,1249,1704,0
73419789330,73419789331,1,2124,2046,0
73424488560,73424488562,2,1430,1406,0
73425666381,73425666376,-5,2724,7878,0
73428056470,73428056470,0,932,935,0
73428572255,73428572250,-5,901,1024,0
73430684167,73430684167,0,1118,1386,0
73430789126,73430789125,-1,1378,2106,0
73435226534,73435226534,0,1577,1805,0
73435794011,73435794011,0,1133,963,0
73437947269,73437947267,-2,1126,1684,0
73438174835,73438174835,0,1204,1312,0
73438219031,73438219023,-8,1295,4671,0
73438877614,73438877614,0,1511,1513,0
73439524027,73439524025,-2,1067,1890,0
73442239371,73442239371,0,1582,1709,0
73443331548,73443331549,1,1201,1835,0
73447110190,73447110194,4,1630,1593,0
73448525005,73448525008,3,1303,1745,0
73448949041,73448949042,1,883,1053,0
73449648931,73449648930,-1,1067,1941,0
73449931958,73449931958,0,1328,1260,0
73450752978,73450752979,1,1387,1755,0
73452965166,73452965168,2,1587,1783,0
73456217740,73456217740,0,1476,1280,0
73457029665,73457029666,1,1578,1931,0
73458012950,73458012951,1,872,1238,0
73461205070,73461205070,0,1314,1206,0
73465938726,73465938726,0,1080,1813,0
73470440242,73470440243,1,1607,1571,0
73472564442,73472564446,4,1860,1857,0
73473763489,73473763499,10,553,99,0
73475124797,73475124798,1,1256,1652,0
73479251086,73479251090,4,1784,2246,0
73482785757,73482785752,-5,984,4102,0
73485800546,73485800546,0,1553,1381,0
73486436450,73486436453,3,1270,1943,0
73486992857,73486992857,0,1235,1984,0
73488979774,73488979778,4,3923,2205,0
73489131953,73489131954,1,1114,1890,0
73491606053,73491606055,2,1144,1313,0
73493537743,73493537743,0,1253,1706,0
73493658947,73493658955,8,2330,1438,0
73494231390,73494231390,0,1794,1960,0
73498664930,73498664930,0,515,1518,0
73499446751,73499446750,-1,1320,1271,0
73500504715,73500504717,2,958,1815,0
73501303929,73501303929,0,1205,1140,0
73501473905,73501473917,12,1956,1631,0
73504350692,73504350694,2,1717,2084,0
73504558382,73504558384,2,1227,1676,0
73504900890,73504900892,2,1381,2000,0
73505131910,73505131910,0,1464,1867,0
73510436492,73510436490,-2,1075,1876,0
73511220160,73511220159,-1,1504,1432,0
73512268791,73512268790,-1,1506,2323,0
73513306365,73513306366,1,1488,1762,0
73513419491,73513419493,2,1133,1237,0
73517626605,73517626603,-2,1499,1684,0
73519635638,73519635638,0,1558,1503,0
73519879790,73519879791,1,1350,940,0
73520283299,73520283299,0,1662,2177,0
73520452176,73520452174,-2,1140,1674,0
73520886562,73520886564,2,915,1208,0
73522013473,73522013475,2,1794,1593,0
73522214568,73522214566,-2,1380,1979,0
73524473464,73524473466,2,2666,2949,0
73526056161,73526056163,2,1319,1896,0
73528227376,73528227376,0,1585,2223,0
73530491284,73530491278,-6,1152,2047,0
73532300390,73532300390,0,1274,1612,0
73538737251,73538737251,0,1526,1392,0
73542281028,73542281029,1,1202,2044,0
73544489485,73544489484,-1,1075,1469,0
73549429036,73549429037,1,1159,1143,0
73552886578,73552886572,-6,1600,4135,0
73553222742,73553222763,21,1433,1354,0
73554235455,73554235454,-1,1327,1434,0
73557594758,73557594761,3,1489,2356,0
73561719099,73561719099,0,1247,1942,0
73567256617,73567256622,5,2036,1088,0
73567487168,73567487169,1,1716,1764,0
73569552387,73569552388,1,1187,1429,0
73571895912,73571895914,2,1408,2139,0
73572233626,73572233624,-2,980,939,0
73572643658,73572643661,3,1285,1512,0
73574319555,73574319553,-2,971,1710,0
73574495070,73574495070,0,1470,1514,0
73575651346,73575651343,-3,1299,2095,0
73577545927,73577545929,2,1526,1932,0
73577954529,73577954526,-3,1246,2625,0
73578155069,73578155069,0,1376,2489,0
73582036912,73582036912,0,821,1878,0
73585172019,73585172022,3,1091,1394,0
73586197863,73586197862,-1,2906,4134,0
73586552549,73586552552,3,1937,1783,0
73591147020,73591147022,2,1661,1490,0
73594338978,73594338978,0,1320,1432,0
73595504044,73595504047,3,1975,2229,0
73597905626,73597905626,0,1376,1518,0
73598009754,73598009753,-1,1032,1300,0
73598423395,73598423396,1,1755,1507,0
73598912399,73598912394,-5,995,2132,0
73606901246,73606901246,0,1585,1757,0
73609291176,73609291177,1,1611,2058,0
73611629675,73611629677,2,1026,1065,0
73622093114,73622093116,2,1667,1989,0
73623690288,73623690289,1,1345,1970,0
73625966861,73625966862,1,811,1105,0
73628335703,73628335703,0,1344,1660,0
73629934134,73629934134,0,1791,2044,0
73630676766,73630676766,0,1372,1789,0
73630865383,73630865375,-8,1479,1007,0
73632457122,73632457120,-2,1472,2245,0
73632598993,73632598992,-1,1519,1637,0
73636957532,73636957523,-9,1724,10647,0
73638739817,73638739802,-15,1024,1730,0
73642461762,73642461762,0,938,1579,0
73642804466,73642804467,1,2097,1905,0
73650364494,73650364498,4,1715,1498,0
73650963625,73650963623,-2,1293,2098,0
73652475850,73652475845,-5,1356,4053,0
73652969021,73652969021,0,1110,1257,0
73654574170,73654574174,4,4400,3594,0
73654972431,73654972433,2,1176,1807,0
73655173430,73655173409,-21,1270,2016,0
73655674594,73655674591,-3,1431,1835,0
73658454173,73658454174,1,1666,1606,0
73658866603,73658866605,2,1609,1737,0
73659229591,73659229591,0,1164,1488,0
73662590011,73662590013,2,1415,1996,0
73663578263,73663578263,0,1253,1592,0
73663977682,73663977674,-8,33367,14067,0
73666892861,73666892863,2,1555,1544,0
73671696143,73671696145,2,1163,1343,0
73672972295,73672972296,1,1305,1714,0
73674310364,73674310365,1,851,1387,0
73675225206,73675225186,-20,3554,1467,0
73676430404,73676430404,0,1488,1411,0
73678737487,73678737486,-1,2042,4011,0
73681844348,73681844350,2,1061,1295,0
73683500449,73683500448,-1,1535,1708,0
73684980586,73684980588,2,865,1213,0
73686702663,73686702662,-1,1565,1708,0
73688866414,73688866414,0,935,1425,0
73690908245,73690908246,1,899,1535,0
73691956829,73691956830,1,1090,1698,0
73693784910,73693784911,1,1225,1236,0
73694191351,73694191351,0,872,1642,0
73696286065,73696286066,1,1472,2085,0
73697478962,73697478964,2,864,1988,0
73702967955,73702967949,-6,1719,4879,0
73708344625,73708344624,-1,1015,1347,0
73711276282,73711276282,0,1913,1466,0
73711910137,73711910137,0,1568,1592,0
73712526451,73712526454,3,1213,1538,0
73713707402,73713707404,2,1234,1733,0
73718887911,73718887912,1,1200,2230,0
73719207553,73719207554,1,2192,1610,0
73719919848,73719919851,3,2155,1679,0
73721336414,73721336414,0,1358,1257,0
73723042598,73723042593,-5,1082,2665,0
73725570197,73725570197,0,1466,1997,0
73725833341,73725833342,1,1471,1197,0
73726027666,73726027665,-1,872,1314,0
73726421461,73726421476,15,1663,1774,0
73728858401,73728858401,0,1436,1079,0
73729790238,73729790239,1,1358,899,0
73731389589,73731389589,0,1307,1225,0
73736470997,73736470994,-3,1715,2896,0
73736695891,73736695890,-1,960,1613,0
73743257707,73743257707,0,1010,1497,0
73745007066,73745007070,4,1684,1222,0
73750310125,73750310126,1,1705,2017,0
73751180994,73751181006,12,10894,49378,0
73757239123,73757239124,1,1355,2178,0
73761723298,73761723296,-2,1011,1225,0
73762462302,73762462301,-1,1754,1818,0
73764064906,73764064906,0,1480,1957,0
73764832909,73764832909,0,887,1346,0
73765733054,73765733049,-5,22,2169,0
73766724030,73766724031,1,1730,1458,0
73768486690,73768486690,0,1826,2329,0
73769008440,73769008440,0,1562,1731,0
73769365639,73769365641,2,1550,2207,0
73769951674,73769951674,0,627,1274,0
73770564829,73770564829,0,1925,1908,0
73770852633,73770852638,5,2598,1701,0
73774189470,73774189472,2,1122,870,0
73785537007,73785537008,1,1040,1210,0
73786961107,73786961106,-1,1232,1697,0
73796423679,73796423681,2,1444,1871,0
73797867249,73797867247,-2,1472,1833,0
73799198326,73799198326,0,1174,1496,0
73800087743,73800087743,0,843,954,0
73804135118,73804135118,0,1024,1112,0
73804536957,73804536958,1,1991,1826,0
73804976166,73804976165,-1,1481,1874,0
73805540694,73805540694,0,1811,2283,0
73806660599,73806660598,-1,1426,1822,0
73808107087,73808107087,0,2396,2853,0
73808404643,73808404639,-4,1410,1944,0
73812803546,73812803545,-1,949,1755,0
73812887566,73812887568,2,1463,1641,0
73819925873,73819925874,1,1385,1660,0
73821056358,73821056354,-4,24428,14246,0
73822145541,73822145548,7,3301,1950,0
73824656354,73824656354,0,1319,1995,0
73829206125,73829206125,0,1141,1941,0
73833176554,73833176553,-1,1343,1570,0
73835095142,73835095141,-1,1551,2473,0
73835390245,73835390246,1,1708,1728,0
73836616962,73836616961,-1,1833,2746,0
73838441619,73838441619,0,1270,1386,0
73843788272,73843788271,-1,1362,1780,0
73845691395,73845691394,-1,1110,1503,0
73848833213,73848833214,1,1608,1207,0
73849640580,73849640582,2,1372,1642,0
73850966238,73850966237,-1,1344,1435,0
73851857429,73851857429,0,1281,1164,0
73853150001,73853150002,1,1305,1105,0
73857885006,73857885006,0,1996,2331,0
73858711998,73858711998,0,3127,3550,0
73859621744,73859621746,2,1807,1560,0
73860592110,73860592111,1,1380,1445,0
73863306359,73863306364,5,1274,1776,0
73866233250,73866233250,0,1639,1235,0
73868026098,73868026099,1,1435,1723,0
73869092481,73869092481,0,1453,1632,0
73870013197,73870013197,0,1006,1237,0
73871074206,73871074207,1,1299,1622,0
73872327862,73872327863,1,1654,2525,0
73873251042,73873251054,12,271,916,0
73873781840,73873781841,1,1233,1580,0
73875591897,73875591898,1,1846,1657,0
73875678826,73875678846,20,806,421,0
73886901011,73886901013,2,946,1310,0
73890678209,73890678206,-3,1391,1902,0
73895988501,73895988501,0,1691,2072,0
73897953277,73897953275,-2,1199,2205,0
73901079734,73901079734,0,1152,1580,0
73901987038,73901987039,1,1996,2414,0
73904320704,73904320706,2,1183,1474,0
73908385489,73908385491,2,1281,1820,0
73910739915,73910739914,-1,1410,1915,0
73911709864,73911709864,0,1596,2066,0
73914124851,73914124849,-2,1084,2210,0
73922278818,73922278818,0,625,1243,0
73922443682,73922443681,-1,1372,1712,0
73923905651,73923905652,1,1223,1253,0
73927200910,73927200916,6,2054,1773,0
73927583679,73927583679,0,1263,1743,0
73930894163,73930894162,-1,602,1406,0
73932097695,73932097695,0,885,1047,0
73935305062,73935305061,-1,1376,1212,0
73936474644,73936474643,-1,1774,1824,0
73939146669,73939146670,1,1199,1798,0
73939196327,73939196325,-2,1096,1696,0
73942264286,73942264288,2,1813,2260,0
73942880138,73942880139,1,1331,1576,0
73945214344,73945214358,14,11453,46482,0
73950964000,73950964006,6,6729,2770,0
73952484740,73952484739,-1,1902,1515,0
73953034744,73953034742,-2,1783,2498,0
73957520825,73957520832,7,666,933,0
73958707143,73958707142,-1,1232,1554,0
73960177046,73960177046,0,1492,1504,0
73961174085,73961174086,1,1366,2258,0
73964396897,73964396897,0,1133,2084,0
73965071213,73965071223,10,950,1336,0
73966230072,73966230074,2,1430,1323,0
73968232227,73968232228,1,959,1560,0
73971627470,73971627472,2,960,1499,0
73972739266,73972739263,-3,1534,2417,0
73973109111,73973109112,1,1713,1708,0
73978733540,73978733541,1,1628,1336,0
73978860162,73978860143,-19,1240,2042,0
73982761978,73982761979,1,934,1364,0
73983916210,73983916211,1,1368,1762,0
73986106858,73986106858,0,1460,1339,0
73986738159,73986738179,20,439,915,0
73990126844,73990126858,14,13272,50519,0
73991538698,73991538700,2,1802,2107,0
73993346491,73993346491,0,1039,1950,0
73998046409,73998046409,0,1631,2090,0
74002338869,74002338869,0,1172,1543,0
74003712377,74003712377,0,1286,2112,0
74008015849,74008015851,2,1398,1638,0
74010971759,74010971761,2,1329,1538,0
74013191359,74013191361,2,1249,1685,0
74014783985,74014783986,1,1582,1466,0
74017140972,74017140973,1,2062,2517,0
74018300638,74018300635,-3,1222,2502,0
74019283006,74019283005,-1,911,1610,0
74020931886,74020931887,1,1864,2231,0
74023932598,74023932600,2,1229,1349,0
74028030424,74028030425,1,676,1206,0
74029889375,74029889378,3,1864,1550,0
74032707697,74032707699,2,1327,1720,0
74033341614,74033341615,1,1261,1098,0
74036574218,74036574218,0,1064,1626,0
74037887836,74037887838,2,1823,1794,0
74040301913,74040301902,-11,29172,17781,0
74049307467,74049307462,-5,5063,14494,0
74049424018,74049424019,1,1536,1767,0
74050088562,74050088562,0,1514,2547,0
74051048535,74051048537,2,1320,1587,0
74052361257,74052361257,0,1768,1802,0
74054340750,74054340749,-1,1269,1753,0
74056849545,74056849545,0,1003,1536,0
74059972623,74059972623,0,1296,2000,0
74063085150,74063085150,0,1408,1868,0
74065702094,74065702095,1,1240,1485,0
74065784554,74065784557,3,1502,2043,0
74066261079,74066261078,-1,776,1290,0
74068067910,74068067912,2,1713,1895,0
74068640182,74068640182,0,723,1198,0
74070217147,74070217149,2,1122,2086,0
74077055839,74077055839,0,1951,2240,0
74077142850,74077142850,0,1713,1969,0
74078843632,74078843633,1,1491,1880,0
74078982358,74078982359,1,1611,1712,0
74080654938,74080654942,4,2124,1631,0
74083314638,74083314637,-1,954,2516,0
74085543577,74085543575,-2,1681,1227,0
74087737889,74087737891,2,890,1224,0
74088374488,74088374486,-2,1804,1548,0
74090358730,74090358730,0,1973,2042,0
74091930727,74091930726,-1,1503,2118,0
74092714697,74092714699,2,1352,1237,0
74093011571,74093011574,3,1355,1618,0
74093114386,74093114367,-19,1263,1403,0
74094716626,74094716625,-1,1333,1481,0
74096984418,74096984414,-4,1748,3716,0
74098221834,74098221837,3,1451,1507,0
74099605291,74099605296,5,4354,2539,0
74100295185,74100295185,0,1952,2441,0
74110516713,74110516716,3,2029,1930,0
74110960810,74110960812,2,1643,1628,0
74114454043,74114454043,0,1892,2006,0
74114729406,74114729406,0,1768,1528,0
74116422234,74116422234,0,1781,1707,0
74121496499,74121496498,-1,1467,2149,0
74124670120,74124670120,0,1321,1785,0
74125450318,74125450317,-1,1202,1128,0
74125819893,74125819883,-10,1494,1802,0
74127534406,74127534407,1,1885,2035,0
74130314826,74130314811,-15,1041,3304,0
74132768131,74132768131,0,1371,1449,0
74133855500,74133855501,1,1796,1830,0
74134016027,74134016025,-2,1305,1944,0
74140940591,74140940590,-1,946,2219,0
74142366404,74142366403,-1,1198,1679,0
74144975525,74144975525,0,1445,2122,0
74147285012,74147285012,0,1515,1537,0
74149208767,74149208769,2,1432,1250,0
74156867611,74156867610,-1,1108,2022,0
74157884773,74157884771,-2,1757,1688,0
74158073151,74158073153,2,2044,1770,0
74160605033,74160605034,1,1587,2017,0
74163875850,74163875849,-1,1527,2119,0
74171889886,74171889885,-1,1156,1333,0
74177754767,74177754767,0,826,1313,0
74180945066,74180945067,1,1170,1656,0
74188599396,74188599396,0,1707,1881,0
74191998232,74191998233,1,1464,1748,0
74193430577,74193430578,1,2028,1479,0
74194299674,74194299673,-1,1225,1969,0
74197741412,74197741412,0,1048,1348,0
74198311282,74198311283,1,1098,1472,0
74200963922,74200963925,3,1451,1741,0
74208874902,74208874917,15,1963,1208,0
74209030417,74209030418,1,1414,2014,0
74209932768,74209932769,1,1695,1388,0
74210346174,74210346173,-1,1086,1797,0
74211886285,74211886287,2,1360,1509,0
74212490233,74212490233,0,1012,1560,0
74215294545,74215294545,0,1742,1892,0
74215597022,74215597022,0,1126,1738,0
74217360081,74217360083,2,1899,1650,0
74217811437,74217811438,1,1132,1754,0
74219963206,74219963205,-1,1151,1370,0
74222648301,74222648296,-5,1173,2822,0
74223597703,74223597702,-1,1669,1872,0
74225131429,74225131430,1,2180,2462,0
74228902746,74228902748,2,764,1447,0
74230822238,74230822238,0,1393,1867,0
74231832357,74231832354,-3,1471,1323,0
74232564506,74232564506,0,1190,1872,0
74232904162,74232904175,13,809,1188,0
74234536175,74234536169,-6,1092,3341,0
74235397297,74235397298,1,1498,1262,0
74238993934,74238993938,4,2639,1705,0
74239295386,74239295386,0,927,1805,0
74245424955,74245424955,0,1170,965,0
74247618026,74247618025,-1,2020,2683,0
74252879998,74252880000,2,982,1720,0
74253959532,74253959532,0,1816,1665,0
74257623541,74257623542,1,1116,1805,0
74264087813,74264087814,1,1553,1297,0
74270905016,74270905010,-6,786,897,0
74273173823,74273173822,-1,1820,2313,0
74273603831,74273603830,-1,1520,1379,0
74275145405,74275145405,0,1732,1454,0
74276607823,74276607823,0,1468,1701,0
74276865131,74276865130,-1,1283,1632,0
74279030488,74279030487,-1,1815,1797,0
74281939715,74281939734,19,1475,1917,0
74284255086,74284255086,0,1995,1950,0
74285979148,74285979146,-2,556,869,0
74286732591,74286732591,0,1442,1839,0
74293012561,74293012561,0,1028,1439,0
74294220981,74294220979,-2,1286,1678,0
74295403597,74295403598,1,1000,1202,0
74295437586,74295437584,-2,1133,1098,0
74299441727,74299441727,0,1550,2078,0
74303273786,74303273786,0,1332,1016,0
74304763508,74304763507,-1,1803,2396,0
74306127803,74306127805,2,1170,1453,0
74309918644,74309918648,4,1389,1376,0
74314912837,74314912838,1,868,892,0
74315125161,74315125161,0,1097,1381,0
74316779739,74316779716,-23,1640,1546,0
74318586350,74318586350,0,1131,1961,0
74320968266,74320968266,0,1088,1235,0
74321332491,74321332490,-1,22264,30018,0
74321954524,74321954524,0,1433,2649,0
74323080940,74323080942,2,1426,1451,0
74323538465,74323538467,2,1130,1352,0
74329867781,74329867781,0,1824,1788,0
74332161897,74332161896,-1,1422,1428,0
74332469886,74332469878,-8,1054,1460,0
74335368379,74335368380,1,1506,1828,0
74335853689,74335853689,0,1572,1375,0
74337583967,74337583966,-1,857,1739,0
74342106347,74342106349,2,1567,1503,0
74343826159,74343826159,0,1451,1922,0
74345719050,74345719051,1,1173,1833,0
74346000341,74346000341,0,1112,1410,0
74346721733,74346721730,-3,1083,1474,0
74347612986,74347612986,0,1131,1688,0
74347741543,74347741545,2,1266,1633,0
74352175245,74352175245,0,1663,2120,0
74353606219,74353606220,1,1448,1240,0
74353916409,74353916410,1,1314,1659,0
74355159250,74355159238,-12,1077,1990,0
74356216790,74356216791,1,1108,1657,0
74356744145,74356744145,0,1403,1683,0
74357336355,74357336355,0,916,1352,0
74359115882,74359115884,2,1293,1500,0
74361147170,74361147173,3,1182,1927,0
74361814169,74361814167,-2,1303,1887,0
74363394832,74363394833,1,1188,1376,0
74364978375,74364978374,-1,1038,1713,0
74366243229,74366243232,3,1708,1645,0
74368422478,74368422477,-1,1386,1857,0
74370786463,74370786464,1,2204,2242,0
74370812003,74370812003,0,976,1494,0
74373125833,74373125837,4,1452,1817,0
74382034938,74382034938,0,1732,2287,0
74382789121,74382789121,0,1537,1534,0
74385063674,74385063675,1,801,1189,0
74389488757,74389488758,1,1424,1674,0
74392250971,74392250973,2,1325,1830,0
74393232548,74393232549,1,934,1161,0
74394511910,74394511911,1,1276,1245,0
74396539878,74396539878,0,1925,1503,0
74397716443,74397716444,1,1960,2034,0
74398452278,74398452280,2,1837,2169,0
74402687423,74402687422,-1,1488,1716,0
74403525637,74403525638,1,1784,2294,0
74404418766,74404418767,1,2269,2194,0
74405343426,74405343425,-1,1079,1600,0
74407960919,74407960918,-1,816,1635,0
74408834829,74408834831,2,2557,1889,0
74409806763,74409806763,0,1393,1688,0
74410604526,74410604526,0,1974,1795,0
74418668134,74418668135,1,1251,1990,0
74419997710,74419997708,-2,1794,2930,0
74420995694,74420995693,-1,1620,1826,0
74423107346,74423107345,-1,1049,1361,0
74423317634,74423317633,-1,952,1710,0
74425161492,74425161494,2,1918,1606,0
74426798981,74426798981,0,1283,1625,0
74431714651,74431714650,-1,1551,1744,0
74435210805,74435210805,0,1123,1077,0
74435751556,74435751556,0,1704,2184,0
74438188027,74438188026,-1,8223,14644,0
74438540574,74438540574,0,1048,1107,0
74442001805,74442001804,-1,1355,1516,0
74442760882,74442760882,0,1522,1911,0
74443826049,74443826051,2,1085,1370,0
74448266264,74448266268,4,1864,1712,0
74453807403,74453807404,1,1089,1689,0
74454428482,74454428482,0,1114,1683,0
74456635949,74456635950,1,939,1495,0
74457180647,74457180646,-1,1715,2783,0
74462770766,74462770766,0,1422,1901,0
74467289018,74467289017,-1,1839,2441,0
74471339883,74471339882,-1,934,1526,0
74476303077,74476303075,-2,1610,2005,0
74478689139,74478689141,2,1486,1292,0
74479092635,74479092633,-2,1172,884,0
74480336175,74480336176,1,1315,1872,0
74480711314,74480711311,-3,1101,2489,0
74481250903,74481250905,2,4670,18454,0
74483343330,74483343329,-1,1710,2450,0
74493218156,74493218165,9,3241,1579,0
74493388489,74493388492,3,1069,1272,0
74496784786,74496784785,-1,1347,1899,0
74498353771,74498353771,0,1473,1626,0
74500155627,74500155627,0,1489,1545,0
74500864351,74500864351,0,1263,2191,0
74501636701,74501636702,1,1596,1894,0
74506241089,74506241089,0,1094,1777,0
74506538502,74506538502,0,1203,1137,0
74507613635,74507613637,2,1447,1681,0
74508332454,74508332452,-2,870,1728,0
74515939835,74515939835,0,1435,2157,0
74517550718,74517550719,1,1114,1742,0
74517994170,74517994170,0,950,1151,0
74520118399,74520118399,0,1267,1378,0
74520407235,74520407236,1,1797,1649,0
74520830450,74520830451,1,1477,2087,0
74524385423,74524385422,-1,1514,1597,0
74525508591,74525508591,0,1500,1532,0
74527445193,74527445194,1,1761,1307,0
74528333378,74528333379,1,1360,1779,0
74532499950,74532499951,1,1516,1154,0
74532977803,74532977804,1,2218,2863,0
74537746462,74537746464,2,1566,1274,0
74540820597,74540820600,3,1272,961,0
74544986737,74544986738,1,2052,2169,0
74545324976,74545324975,-1,1510,2206,0
74547606898,74547606897,-1,834,1154,0
74549165966,74549165966,0,865,1966,0
74552082807,74552082806,-1,1414,1221,0
74553681965,74553681962,-3,1261,1306,0
74558216723,74558216723,0,981,1965,0
74561541935,74561541933,-2,511,1205,0
74561994158,74561994155,-3,1509,2148,0
74563758006,74563758007,1,2334,2039,0
74563827602,74563827598,-4,1334,3272,0
74565903420,74565903422,2,1383,1200,0
74566572967,74566572966,-1,1393,2206,0
74568240690,74568240688,-2,1323,1658,0
74569806426,74569806428,2,1522,2036,0
74571459541,74571459543,2,1487,1466,0
74572998001,74572998002,1,1945,1381,0
74573416220,74573416220,0,1395,1898,0
74574901648,74574901647,-1,1263,1660,0
74577000654,74577000656,2,1021,1208,0
74577693726,74577693725,-1,1195,2124,0
74578937490,74578937492,2,1259,2371,0
74579852999,74579852999,0,1325,1605,0
74580196023,74580196029,6,1227,933,0
74580429155,74580429155,0,1589,1577,0
74582104170,74582104177,7,6561,2283,0
74586693668,74586693670,2,1450,1793,0
74586793409,74586793409,0,1496,1421,0
74588873355,74588873352,-3,25756,9801,0
74589120117,74589120119,2,1633,1156,0
74591178308,74591178306,-2,1877,2076,0
74591286698,74591286698,0,2042,1885,0
74592519794,74592519794,0,2473,4920,0
74593614154,74593614157,3,1123,1337,0
74596182655,74596182656,1,1370,1804,0
74597181569,74597181570,1,1457,1622,0
74598837334,74598837335,1,1085,1268,0
74599336938,74599336938,0,2146,1480,0
74600436309,74600436311,2,1554,1697,0
74601168269,74601168269,0,1924,2127,0
74601212683,74601212685,2,1080,2268,0
74605575409,74605575409,0,1477,1508,0
74608286836,74608286837,1,1563,2391,0
74608497831,74608497831,0,1286,1400,0
74613715714,74613715715,1,1219,1065,0
74616331869,74616331869,0,2398,1379,0
74623811894,74623811893,-1,1114,1776,0
74631805018,74631805018,0,1552,2251,0
74633383717,74633383732,15,583,532,0
74637353634,74637353635,1,1462,1204,0
74642851893,74642851895,2,1291,1361,0
74643639006,74643639010,4,2638,1591,0
74645058078,74645058079,1,1311,1762,0
74646896574,74646896575,1,959,956,0
74647131328,74647131325,-3,21576,15653,0
74650550958,74650550959,1,1504,1447,0
74655381793,74655381794,1,1101,1441,0
74659598790,74659598793,3,1077,1350,0
74661299763,74661299763,0,929,1431,0
74665773611,74665773612,1,2121,2212,0
74669966004,74669966005,1,1722,2069,0
74671989959,74671989959,0,1115,1082,0
74674747885,74674747886,1,1106,1374,0
74677512255,74677512257,2,1221,1215,0
74678114926,74678114926,0,892,1237,0
74679004511,74679004495,-16,1141,1411,0
74680913063,74680913060,-3,1409,4065,0
74683842308,74683842310,2,1022,2001,0
74685964433,74685964425,-8,1554,2173,0
74690074667,74690074668,1,1904,2088,0
74691024958,74691024959,1,1404,1021,0
74692238784,74692238798,14,809,1535,0
74694348155,74694348154,-1,1286,1689,0
74697153346,74697153346,0,1395,1777,0
74699875384,74699875383,-1,1359,1711,0
74699944227,74699944226,-1,1291,1764,0
74700102356,74700102355,-1,1099,2251,0
74703019274,74703019272,-2,36219,30995,0
74705371389,74705371388,-1,1263,1711,0
74705817050,74705817050,0,1789,1912,0
74707081117,74707081119,2,1719,2003,0
74707946192,74707946194,2,1720,1265,0
74709016615,74709016615,0,1169,1720,0
74711537099,74711537100,1,1673,2014,0
74715260266,74715260266,0,2069,2629,0
74715870061,74715870062,1,1627,1732,0
74719948833,74719948830,-3,1732,1399,0
74721337478,74721337479,1,1784,1516,0
74722049642,74722049649,7,13809,6684,0
74730063407,74730063409,2,1112,1534,0
74731914338,74731914335,-3,1014,1342,0
74735317730,74735317730,0,1117,1916,0
74735535459,74735535461,2,6303,7148,0
74736906718,74736906721,3,641,665,0
74738767063,74738767064,1,1543,1475,0
74741792981,74741792982,1,1213,1171,0
74744052679,74744052673,-6,2618,4680,0
74748831689,74748831687,-2,947,1575,0
74750539138,74750539138,0,1401,1975,0
74753834438,74753834437,-1,942,1184,0
74756750939,74756750942,3,1373,1356,0
74756957800,74756957799,-1,1704,1337,0
74757160150,74757160151,1,1791,1847,0
74759938931,74759938929,-2,493,740,0
74764489641,74764489642,1,1475,1364,0
74766152999,74766152997,-2,1127,3081,0
74767983157,74767983158,1,1751,1491,0
74769757034,74769757035,1,1037,1625,0
74771898451,74771898452,1,922,1054,0
74772722995,74772722999,4,1518,1454,0
74777238050,74777238051,1,1429,1849,0
74778407989,74778407990,1,1124,1158,0
74783419721,74783419719,-2,20284,19330,0
74788785274,74788785276,2,2331,2359,0
74794303188,74794303189,1,1592,1796,0
74796296254,74796296255,1,1307,1128,0
74797625722,74797625722,0,923,1514,0
74798915898,74798915898,0,1615,1936,0
74800526216,74800526217,1,1410,1414,0
74801028242,74801028243,1,935,1256,0
74803884529,74803884532,3,1461,1610,0
74804066593,74804066594,1,1109,1690,0
74810787064,74810787063,-1,1584,2562,0
74812143231,74812143232,1,1541,1817,0
74813646762,74813646759,-3,1169,1830,0
74815386938,74815386939,1,1298,1657,0
74815597982,74815597985,3,994,1464,0
74817358754,74817358754,0,1798,1709,0
74820272225,74820272228,3,1207,1136,0
74822542751,74822542750,-1,846,1217,0
74824038426,74824038426,0,1096,1260,0
74826154290,74826154290,0,1247,1798,0
74827360669,74827360670,1,19685,11531,0
74831892039,74831892037,-2,1237,2273,0
74835999571,74835999571,0,854,1544,0
74836810434,74836810433,-1,1173,1191,0
74841998046,74841998047,1,895,1148,0
74851178200,74851178201,1,1055,1327,0
74851624021,74851624021,0,1692,2077,0
74853548507,74853548507,0,843,1332,0
74857831962,74857831962,0,1109,1547,0
74858338047,74858338029,-18,1311,1379,0
74861433923,74861433931,8,1081,2058,0
74863359157,74863359162,5,1471,962,0
74866808914,74866808915,1,1040,1079,0
74870832861,74870832860,-1,959,1937,0
74876341038,74876341036,-2,960,1676,0
74881256752,74881256751,-1,1454,1725,0
74882529392,74882529393,1,1160,1541,0
74888968690,74888968690,0,887,1382,0
74892775094,74892775095,1,3059,3677,0
74893610191,74893610191,0,1096,1643,0
74894182579,74894182582,3,1154,2063,0
74895457622,74895457623,1,1094,1264,0
74899768673,74899768671,-2,1464,1511,0
74903240788,74903240802,14,13599,1902,0
74905603673,74905603675,2,1424,1715,0
74905833866,74905833865,-1,1592,1756,0
74905948658,74905948657,-1,1835,2358,0
74909089023,74909089026,3,1622,1819,0
74915784642,74915784642,0,1864,1708,0
74916509152,74916509153,1,28853,34758,0
74919354467,74919354469,2,1554,1974,0
74920333316,74920333317,1,1328,1901,0
74920474052,74920474054,2,1813,1807,0
74921055938,74921055945,7,4086,1343,0
74926601178,74926601179,1,1662,1378,0
74934338730,74934338730,0,1703,1278,0
74934978646,74934978647,1,1360,1634,0
74935153932,74935153932,0,1175,1545,0
74939619079,74939619080,1,970,1185,0
74941212335,74941212337,2,1960,2073,0
74941911322,74941911323,1,870,1539,0
74943152737,74943152738,1,1990,1506,0
74947715477,74947715481,4,1810,1688,0
74949242515,74949242493,-22,1291,2142,0
74949709543,74949709536,-7,1556,7592,0
74950405693,74950405694,1,1750,1486,0
74952380755,74952380736,-19,1530,1614,0
74953444361,74953444362,1,1547,1280,0
74953618203,74953618203,0,816,1640,0
74958531461,74958531461,0,1318,1354,0
74965004005,74965004006,1,1504,1302,0
74966322425,74966322425,0,1107,1044,0
74970133336,74970133337,1,1374,1717,0
74970365333,74970365331,-2,38312,62070,0
74971282889,74971282890,1,1877,2194,0
74971858415,74971858422,7,87437,84930,0
74974062643,74974062642,-1,1218,1981,0
74975221602,74975221602,0,1454,1702,0
74975350049,74975350050,1,1755,1292,0
74975541408,74975541407,-1,1215,1740,0
74976955901,74976955901,0,1522,1330,0
74979171256,74979171257,1,1147,1971,0
74979456637,74979456635,-2,1193,1821,0
74981639562,74981639563,1,1361,1454,0
74981908125,74981908125,0,2023,2040,0
74988441738,74988441737,-1,1270,995,0
74990551161,74990551162,1,1318,1505,0
74991600579,74991600578,-1,1773,1523,0
74991815009,74991815010,1,1608,2116,0
74992267062,74992267063,1,1427,1227,0
74993699994,74993699998,4,1690,1334,0
74994757310,74994757318,8,1424,674,0
74998531306,74998531307,1,1234,1399,0
74999741775,74999741776,1,1723,1619,0
74999826138,74999826138,0,1130,1581,0
75002250354,75002250353,-1,1155,1853,0
75003075745,75003075747,2,1432,1858,0
75006794874,75006794874,0,1038,2017,0
75006883406,75006883406,0,781,1336,0
75007115115,75007115115,0,1017,1374,0
75007622844,75007622844,0,981,2086,0
75007931906,75007931906,0,1100,2053,0
75009491585,75009491581,-4,1711,2477,0
75010692191,75010692192,1,1390,2299,0
75014874171,75014874171,0,1195,1261,0
75018468451,75018468453,2,1232,1385,0
75022637247,75022637244,-3,1318,3167,0
75026332943,75026332949,6,2631,1434,0
75027690422,75027690422,0,1632,1684,0
75029119374,75029119375,1,940,1442,0
75029764778,75029764782,4,1459,1355,0
75031194302,75031194302,0,1543,1620,0
75033146526,75033146529,3,1541,1541,0
75035880980,75035880980,0,1257,1433,0
75036892609,75036892610,1,1303,1285,0
75039714326,75039714327,1,1497,1899,0
75042582594,75042582594,0,1084,1530,0
75044209609,75044209609,0,1201,1476,0
75045795414,75045795416,2,1031,1586,0
75046135243,75046135242,-1,1096,2082,0
75047956267,75047956269,2,1654,1892,0
75049040501,75049040502,1,1250,1968,0
75049526572,75049526575,3,816,1225,0
75055540019,75055540019,0,2256,2286,0
75056055474,75056055475,1,1131,1952,0
75056289348,75056289346,-2,1424,1212,0
75056429200,75056429219,19,450,846,0
75059886359,75059886358,-1,1068,1978,0
75062205421,75062205421,0,1562,2457,0
75064531521,75064531522,1,1330,2083,0
75065478025,75065478026,1,1805,1823,0
75075432602,75075432601,-1,1534,1861,0
75075853771,75075853774,3,1538,1587,0
75078637739,75078637738,-1,909,1624,0
75079528710,75079528710,0,1212,1706,0
75079680310,75079680310,0,1908,1846,0
75082685950,75082685953,3,926,971,0
75087827359,75087827339,-20,1731,1708,0
75092486814,75092486815,1,2088,2462,0
75094402140,75094402144,4,6994,23540,0
75095286415,75095286410,-5,1477,3469,0
75096958709,75096958710,1,2012,2001,0
75098488378,75098488378,0,1390,1720,0
75100524553,75100524552,-1,1459,1843,0
75111346942,75111346942,0,1500,1920,0
75113981825,75113981823,-2,1365,2355,0
75119972302,75119972306,4,3339,2646,0
75120035993,75120035993,0,1606,2345,0
75123350345,75123350345,0,1231,1945,0
75125752025,75125752026,1,1814,1938,0
75126983039,75126983038,-1,1613,2308,0
75131303427,75131303429,2,1428,1731,0
75131754129,75131754129,0,1217,1636,0
75140468750,75140468749,-1,1260,2526,0
75141217224,75141217225,1,1706,1834,0
75141553773,75141553766,-7,1369,8695,0
75152135552,75152135548,-4,1603,4999,0
75158932218,75158932217,-1,1212,1282,0
75161290968,75161290972,4,1671,1243,0
75165729438,75165729438,0,1053,1929,0
75169642003,75169642002,-1,954,2029,0
75173354457,75173354459,2,1985,1827,0
75173477383,75173477382,-1,1287,1192,0
75176409658,75176409660,2,1013,1269,0
75183815835,75183815835,0,1115,1435,0
75185898160,75185898159,-1,1131,1520,0
75187453771,75187453778,7,3002,1327,0
75193389698,75193389703,5,6940,52727,0
75193663948,75193663934,-14,1185,2043,0
75194863047,75194863046,-1,1112,1287,0
75195213474,75195213475,1,1751,1807,0
75197165673,75197165673,0,1483,2695,0
75201182895,75201182895,0,967,1766,0
75201904999,75201904998,-1,928,1792,0
75204076048,75204076053,5,1518,1031,0
75204793547,75204793533,-14,6945,3020,0
75206756929,75206756926,-3,1398,1399,0
75207021572,75207021581,9,300,3455,0
75207554822,75207554818,-4,1099,2020,0
75208014086,75208014089,3,2050,1456,0
75209804271,75209804271,0,1545,1988,0
75210746733,75210746733,0,1374,1795,0
75213759959,75213759957,-2,1442,1575,0
75214091246,75214091247,1,939,1284,0
75214243149,75214243150,1,1079,1266,0
75215858679,75215858679,0,1390,1230,0
75219632001,75219632002,1,1119,1862,0
75221072927,75221072926,-1,1402,1524,0
75221332386,75221332387,1,1517,1636,0
75221979358,75221979372,14,1134,1556,0
75223131973,75223131974,1,1154,1493,0
75224887949,75224887947,-2,1300,1953,0
75226954829,75226954829,0,1172,2153,0
75227688775,75227688766,-9,1371,1096,0
75229278965,75229278965,0,1378,1629,0
75230747159,75230747161,2,1594,1466,0
75232519311,75232519311,0,1583,1312,0
75241724175,75241724177,2,1524,2039,0
75250067980,75250067979,-1,1316,1670,0
75250148643,75250148643,0,1163,1228,0
75250614649,75250614649,0,1098,1152,0
75252386111,75252386111,0,1361,2083,0
75252768529,75252768530,1,2184,1603,0
75256587599,75256587599,0,1193,1683,0
75256715111,75256715110,-1,1142,1874,0
75260015089,75260015089,0,1133,1849,0
75263491415,75263491417,2,1748,1560,0
75264279879,75264279881,2,2029,1907,0
75264383419,75264383421,2,875,1503,0
75265303955,75265303958,3,1638,1246,0
75266023261,75266023262,1,1342,1664,0
75268951027,75268951027,0,924,1656,0
75269458361,75269458363,2,2103,2085,0
75274374465,75274374466,1,1634,1725,0
75274543253,75274543253,0,1870,1404,0
75275790313,75275790312,-1,1308,1964,0
75275856840,75275856838,-2,874,856,0
75276832208,75276832211,3,1516,1292,0
75280853750,75280853751,1,998,1823,0
75283016449,75283016452,3,1701,1907,0
75283107679,75283107681,2,1916,1375,0
75284040065,75284040066,1,1487,1279,0
75286682444,75286682441,-3,1287,1948,0
75296012003,75296012003,0,1070,1437,0
75297190949,75297190950,1,1257,1310,0
75299598143,75299598143,0,1737,1458,0
75302036606,75302036608,2,1911,2439,0
75302477834,75302477835,1,1884,1799,0
75305979086,75305979082,-4,1389,3989,0
75307151441,75307151442,1,1318,1202,0
75309630539,75309630537,-2,1462,2200,0
75309778567,75309778565,-2,1087,2044,0
75311163075,75311163073,-2,1320,1611,0
75311831708,75311831709,1,1617,1407,0
75318079529,75318079529,0,1905,2007,0
75318511824,75318511825,1,1398,1924,0
75319164775,75319164777,2,1535,1721,0
75320438423,75320438424,1,1383,1307,0
75321273346,75321273346,0,1040,1496,0
75322345314,75322345315,1,1596,1414,0
75322391350,75322391351,1,1182,1367,0
75322955391,75322955391,0,1474,1407,0
75328160837,75328160853,16,17920,20095,0
75328425381,75328425381,0,1444,1751,0
75333195473,75333195473,0,1113,1316,0
75334018483,75334018483,0,1680,2176,0
75334160892,75334160895,3,2011,2107,0
75334577221,75334577221,0,1377,1941,0
75334674372,75334674372,0,1240,1626,0
75337133438,75337133438,0,1121,1626,0
75340805927,75340805930,3,1807,1780,0
75342198242,75342198243,1,1387,1600,0
75342682086,75342682088,2,1353,2245,0
75342769495,75342769496,1,2159,2139,0
75344785735,75344785734,-1,1785,2607,0
75347762655,75347762657,2,1080,1696,0
75349609555,75349609553,-2,1194,1456,0
75350321856,75350321855,-1,1408,1740,0
75354409229,75354409227,-2,1263,1501,0
75356045321,75356045322,1,934,1076,0
75358665278,75358665276,-2,1534,1718,0
75358748067,75358748067,0,1164,1503,0
75359194678,75359194674,-4,1071,2824,0
75361077056,75361077061,5,1875,1684,0
75362623025,75362623035,10,10175,34708,0
75364594247,75364594245,-2,1475,1249,0
75365920427,75365920419,-8,220,496,0
75369274786,75369274787,1,1425,1364,0
75372220350,75372220349,-1,1429,1916,0
75374612070,75374612071,1,1122,1370,0
75374680639,75374680634,-5,1144,1048,0
75376626461,75376626459,-2,1455,1715,0
75379311198,75379311202,4,1781,1734,0
75379532469,75379532469,0,1495,2133,0
75379749810,75379749811,1,1570,1715,0
75380253314,75380253313,-1,1173,1112,0
75383936597,75383936597,0,1283,1306,0
75385350170,75385350169,-1,1233,1893,0
75386088545,75386088546,1,1413,2127,0
75388630038,75388630034,-4,1780,3509,0
75389015178,75389015177,-1,1184,2255,0
75389552239,75389552238,-1,1465,1464,0
75389919178,75389919177,-1,1068,2080,0
75390696826,75390696827,1,1056,1235,0
75391293088,75391293090,2,1752,1921,0
75392557526,75392557525,-1,1165,1633,0
75393232861,75393232854,-7,1177,1697,0
75393678459,75393678454,-5,1162,1904,0
75397355291,75397355294,3,1938,1698,0
75398142734,75398142735,1,1641,1938,0
75399170229,75399170230,1,1747,1982,0
75400261023,75400261021,-2,1134,1269,0
75401435185,75401435182,-3,474,2700,0
75405053315,75405053314,-1,1084,1990,0
75405930885,75405930885,0,1393,1463,0
75408760435,75408760431,-4,1977,5030,0
75409526227,75409526227,0,1543,1792,0
75412538794,75412538794,0,1597,1312,0
75413389199,75413389198,-1,1313,2073,0
75413951770,75413951772,2,1250,1301,0
75414683073,75414683074,1,1639,1765,0
75417131914,75417131914,0,1216,1344,0
75419142582,75419142578,-4,1545,2318,0
75420844003,75420843999,-4,1793,2455,0
75421089018,75421089019,1,1431,1413,0
75421140729,75421140731,2,1333,1256,0
75424928611,75424928614,3,2233,2261,0
75425822266,75425822266,0,1759,1804,0
75426348629,75426348629,0,1825,1810,0
75429041481,75429041481,0,1832,1906,0
75429957186,75429957192,6,2393,1339,0
75431955012,75431955012,0,1477,1953,0
75437401001,75437401002,1,888,1482,0
75440412639,75440412643,4,1507,1748,0
75449319181,75449319179,-2,1325,2109,0
75449541301,75449541311,10,239,1046,0
75450822405,75450822389,-16,858,3337,0
75451219742,75451219743,1,1005,2123,0
75453411951,75453411953,2,1296,1840,0
75453848275,75453848274,-1,1246,1971,0
75455390706,75455390707,1,1159,1272,0
75459736197,75459736198,1,1003,1420,0
75460515090,75460515090,0,901,1199,0
75465213971,75465213973,2,1457,1353,0
75467555782,75467555780,-2,1296,1740,0
75468035190,75468035189,-1,1135,1656,0
75469240267,75469240266,-1,1052,1980,0
75472324234,75472324234,0,948,1250,0
75475698112,75475698111,-1,1514,1843,0
75476445589,75476445589,0,4601,14649,0
75478175061,75478175062,1,1288,1295,0
75481603130,75481603131,1,1151,1863,0
75485005575,75485005576,1,1107,1587,0
75488129497,75488129512,15,1215,1522,0
75489730289,75489730294,5,1180,1486,0
75491042694,75491042690,-4,1735,5861,0
75494345278,75494345279,1,1716,1525,0
75495014122,75495014123,1,835,1022,0
75495151468,75495151459,-9,1402,1658,0
75495807654,75495807641,-13,1187,1321,0
75496966284,75496966282,-2,1741,1884,0
75500096815,75500096816,1,901,1447,0
75500700859,75500700861,2,1360,1803,0
75504763651,75504763650,-1,1440,2082,0
75508721760,75508721763,3,1639,1114,0
75510093006,75510093022,16,2033,6070,0
75510333314,75510333315,1,1277,1480,0
75511041210,75511041210,0,1912,1894,0
75512008806,75512008806,0,1619,1591,0
75512156001,75512156005,4,2478,1461,0
75513066466,75513066466,0,1654,2117,0
75515697479,75515697478,-1,1377,1453,0
75517077289,75517077290,1,1258,1357,0
75520529250,75520529251,1,906,1011,0
75523710055,75523710058,3,2288,2232,0
75524491113,75524491114,1,1483,1286,0
75531393110,75531393110,0,1675,1654,0
75535462877,75535462876,-1,1595,1931,0
75536175176,75536175175,-1,1457,1927,0
75540284170,75540284171,1,1804,2179,0
75542286832,75542286830,-2,1329,1451,0
75542613938,75542613938,0,1640,1971,0
75543533678,75543533679,1,1972,2055,0
75544887991,75544887991,0,1556,1810,0
75545732948,75545732948,0,1324,1624,0
75546216884,75546216885,1,1375,1606,0
75546245852,75546245836,-16,878,1627,0
75548302098,75548302098,0,1000,1815,0
75549961517,75549961518,1,1239,1716,0
75551866739,75551866741,2,1285,1838,0
75554991886,75554991886,0,1886,2262,0
75558675085,75558675085,0,1938,2074,0
75563325441,75563325444,3,1113,1598,0
75563646642,75563646641,-1,1659,1402,0
75564908437,75564908437,0,1158,1337,0
75565688914,75565688917,3,1292,1634,0
75570353918,75570353919,1,1101,1939,0
75571065620,75571065622,2,1855,1680,0
75571442314,75571442308,-6,1103,2414,0
75571937791,75571937784,-7,862,303,0
75577239176,75577239178,2,2177,2006,0
75577846637,75577846634,-3,1373,2711,0
75579383515,75579383515,0,2181,1764,0
75579926918,75579926918,0,1685,2220,0
75580272798,75580272800,2,1451,2034,0
75582725997,75582725990,-7,2239,8018,0
75585972470,75585972478,8,1248,1694,0
75589004643,75589004642,-1,1478,2056,0
75595960070,75595960070,0,1292,1384,0
75596126377,75596126379,2,1595,1377,0
75596932589,75596932590,1,1299,1460,0
75597912301,75597912302,1,1359,1819,0
75598258852,75598258858,6,3437,1624,0
75600412138,75600412137,-1,1149,1872,0
75601657757,75601657758,1,1437,1304,0
75604478235,75604478233,-2,1340,2126,0
75610718235,75610718238,3,1099,1826,0
75612104456,75612104454,-2,1489,1678,0
75612360346,75612360347,1,1605,1516,0
75613176351,75613176348,-3,673,1532,0
75613917033,75613917033,0,1605,1865,0
75614622642,75614622643,1,1608,1690,0
75614994390,75614994390,0,1104,1540,0
75616877721,75616877721,0,1483,1320,0
75617139703,75617139703,0,963,1717,0
75617208128,75617208131,3,948,1451,0
75619548310,75619548310,0,804,1419,0
75621717183,75621717198,15,1522,1395,0
75621813215,75621813223,8,789,1292,0
75622963366,75622963368,2,1330,1700,0
75624116216,75624116216,0,2197,2792,0
75625164770,75625164771,1,1682,1579,0
75625449587,75625449586,-1,1258,2103,0
75626549008,75626549002,-6,1962,6358,0
75629367918,75629367917,-1,1329,2088,0
75630221634,75630221635,1,1373,1854,0
75632624734,75632624732,-2,1189,1933,0
75637572250,75637572251,1,1686,1476,0
75638982325,75638982324,-1,1666,1551,0
75640751482,75640751502,20,1109,1031,0
75641394965,75641394965,0,1271,1320,0
75646571663,75646571663,0,1303,1654,0
75646829925,75646829923,-2,1197,2145,0
75654188893,75654188893,0,2207,1954,0
75654420675,75654420676,1,1131,1467,0
75654663897,75654663917,20,1537,1755,0
75654901351,75654901351,0,1146,1316,0
75660487926,75660487926,0,1181,1333,0
75660915866,75660915870,4,1299,1460,0
75667869715,75667869716,1,1934,2605,0
75670473121,75670473121,0,2098,2251,0
75672519525,75672519525,0,2133,1415,0
75673921021,75673921019,-2,1400,1443,0
75674035851,75674035854,3,1784,1719,0
75674772273,75674772273,0,1729,1671,0
75675938033,75675938033,0,1507,1605,0
75676976593,75676976594,1,1508,1473,0
75677950060,75677950060,0,1819,1368,0
75678528690,75678528691,1,1344,1218,0
75681123621,75681123621,0,1170,1411,0
75682873664,75682873666,2,1275,1300,0
75692549482,75692549484,2,1072,1555,0
75694228109,75694228105,-4,1857,5664,0
75695709527,75695709525,-2,1443,1472,0
75700950032,75700950033,1,1363,1362,0
75703622360,75703622360,0,1454,2498,0
75703647526,75703647535,9,1295,1606,0
75703661093,75703661094,1,33,111,0
75704822638,75704822640,2,1127,1709,0
75710217488,75710217486,-2,814,1232,0
75710553623,75710553622,-1,1274,1791,0
75711065730,75711065711,-19,1582,1933,0
75714071117,75714071119,2,1810,1276,0
75718270821,75718270820,-1,1357,1981,0
75723189578,75723189578,0,1207,1585,0
75728832247,75728832250,3,1378,1977,0
75734702289,75734702288,-1,1099,1637,0
75736765557,75736765557,0,1873,3350,0
75738404343,75738404342,-1,957,1019,0
75739896054,75739896055,1,1626,1833,0
75740887543,75740887543,0,1391,1861,0
75741494249,75741494250,1,1126,1707,0
75744436489,75744436489,0,1379,1487,0
75745785758,75745785759,1,1272,1244,0
75752467140,75752467143,3,2729,1258,0
75753502003,75753502002,-1,1867,2016,0
75754482275,75754482275,0,915,1629,0
75755795635,75755795637,2,1172,1842,0
75756821893,75756821898,5,2402,1217,0
75759679398,75759679398,0,1251,1564,0
75763125006,75763125005,-1,891,1889,0
75763862509,75763862510,1,1168,1986,0
75765394859,75765394859,0,1061,1065,0
75767639949,75767639949,0,1100,1894,0
75771462355,75771462356,1,1104,1800,0
75773468748,75773468751,3,1350,1177,0
75776093482,75776093460,-22,1563,1644,0
75776677046,75776677047,1,1547,1578,0
75781552437,75781552437,0,1424,1949,0
75782891783,75782891782,-1,1570,1997,0
75786795029,75786795029,0,1435,2887,0
75786870370,75786870373,3,1562,1137,0
75788486174,75788486173,-1,1498,1819,0
75788583747,75788583747,0,1448,2043,0
75789122223,75789122224,1,1463,1448,0
75790141560,75790141561,1,1189,1859,0
75790963337,75790963337,0,1342,1530,0
75792489138,75792489138,0,1178,2229,0
75794192478,75794192477,-1,1479,1665,0
75795389918,75795389923,5,3165,1335,0
75796308612,75796308629,17,13,61,0
75797012998,75797012997,-1,5555,7086,0
75798060174,75798060174,0,1088,2024,0
75799493209,75799493210,1,1807,2106,0
75803015880,75803015880,0,1268,1795,0
75805350131,75805350131,0,1234,1334,0
75806710896,75806710896,0,1679,1931,0
75810566870,75810566870,0,1336,1443,0
75811265201,75811265203,2,2120,2309,0
75812900765,75812900765,0,1639,1859,0
75817114946,75817114950,4,1593,1385,0
75817622011,75817622014,3,1346,2041,0
75818787053,75818787053,0,1220,1710,0
75822732028,75822732029,1,1177,938,0
75824358255,75824358257,2,1389,1495,0
75826393614,75826393615,1,980,1616,0
75826918856,75826918855,-1,1273,2840,0
75829141978,75829141957,-21,1781,1764,0
75829507090,75829507090,0,1217,1633,0
75831037685,75831037685,0,2177,2169,0
75831849530,75831849529,-1,1966,2517,0
75835999232,75835999234,2,2155,998,0
75838908164,75838908162,-2,1549,1721,0
75839390326,75839390327,1,702,916,0
75839804565,75839804566,1,2015,2029,0
75840345343,75840345342,-1,1664,1764,0
75840462250,75840462251,1,1887,1765,0
75841133846,75841133847,1,1074,2076,0
75842381218,75842381219,1,1383,2326,0
75842640732,75842640733,1,882,1165,0
75842721846,75842721828,-18,945,675,0
75843199307,75843199307,0,1743,1835,0
75844044384,75844044384,0,1419,1435,0
75844479029,75844479024,-5,930,2081,0
75846819384,75846819384,0,1280,1772,0
75849877992,75849877990,-2,1565,1506,0
75850643174,75850643173,-1,1662,2268,0
75855948295,75855948295,0,855,1341,0
75856610687,75856610688,1,1222,1642,0
75862410541,75862410541,0,971,1990,0
75863719750,75863719748,-2,1141,2464,0
75867268723,75867268723,0,1456,1608,0
75870002579,75870002578,-1,1833,1622,0
75871104818,75871104818,0,1774,2125,0
75874391319,75874391318,-1,754,1854,0
75876203247,75876203246,-1,1138,1619,0
75876931321,75876931318,-3,1563,1491,0
75877144385,75877144387,2,1584,1805,0
75880538610,75880538612,2,1043,1645,0
75881835544,75881835545,1,1635,1613,0
75886699393,75886699395,2,1197,1961,0
75892948108,75892948105,-3,1070,2531,0
75895032517,75895032522,5,2870,1221,0
75896970331,75896970331,0,31520,21759,0
75900563835,75900563833,-2,1132,1243,0
75901367613,75901367612,-1,1953,1764,0
75902037222,75902037223,1,1612,1845,0
75902317298,75902317300,2,1245,1692,0
75902766507,75902766505,-2,1349,1839,0
75903127873,75903127874,1,901,1098,0
75906470542,75906470543,1,1171,1505,0
75908318290,75908318289,-1,1317,2436,0
75909043312,75909043314,2,1413,2024,0
75919241914,75919241915,1,1635,1380,0
75919954787,75919954788,1,1335,1682,0
75920593398,75920593397,-1,967,1380,0
75921487249,75921487254,5,3060,1558,0
75922412142,75922412142,0,1230,1179,0
75922524677,75922524674,-3,1245,1693,0
75925095974,75925095975,1,1373,1676,0
75925662566,75925662566,0,1399,1790,0
75926902038,75926902039,1,863,1189,0
75928062406,75928062406,0,1562,1691,0
75929029137,75929029137,0,1572,2474,0
75932092539,75932092538,-1,1401,1565,0
75935389799,75935389799,0,1722,2015,0
75935420631,75935420637,6,6273,3559,0
75937203784,75937203783,-1,1551,1603,0
75937427256,75937427253,-3,1247,2359,0
75938651055,75938651054,-1,1218,2084,0
75940667534,75940667542,8,5103,1840,0
75941541903,75941541903,0,964,1653,0
75943101221,75943101222,1,1310,1320,0
75943281439,75943281439,0,1104,2126,0
75944094236,75944094236,0,1717,2128,0
75945177974,75945177975,1,1919,2250,0
75946022776,75946022777,1,1343,1925,0
75948018623,75948018623,0,1058,1440,0
75950032590,75950032592,2,1171,1139,0
75951752638,75951752637,-1,1225,1535,0
75953302085,75953302086,1,1145,2008,0
75955420713,75955420711,-2,1737,1486,0
75959960694,75959960695,1,1137,1378,0
75960851659,75960851660,1,1694,1599,0
75967946006,75967946008,2,1681,1665,0
75968776822,75968776824,2,1410,1950,0
75969536809,75969536821,12,1882,1609,0
75970313025,75970313004,-21,1459,1609,0
75974048809,75974048810,1,1474,1331,0
75974619834,75974619833,-1,1452,1263,0
75975317643,75975317646,3,1358,1915,0
75980796565,75980796570,5,2637,1235,0
75981575187,75981575196,9,1425,1331,0
75982142757,75982142757,0,851,1412,0
75985883675,75985883674,-1,1163,1378,0
75987276183,75987276187,4,3398,2377,0
75987303201,75987303198,-3,1163,1423,0
75989707909,75989707889,-20,1151,1353,0
75990904398,75990904403,5,1366,1642,0
75994787029,75994787030,1,961,1229,0
75997582725,75997582724,-1,1504,2050,0
76002417463,76002417463,0,1447,1734,0
76005730453,76005730454,1,1495,1680,0
76010497326,76010497321,-5,975,1941,0
76011724221,76011724219,-2,1418,2233,0
76014533950,76014533951,1,1480,1635,0
76014994021,76014994024,3,1267,1759,0
76015407678,76015407678,0,1447,1740,0
76016200873,76016200873,0,1334,1736,0
76016906034,76016906034,0,1925,1348,0
76017197130,76017197130,0,780,1259,0
76018073508,76018073507,-1,1722,1642,0
76021458607,76021458602,-5,1066,3204,0
76025082783,76025082782,-1,1025,1448,0
76025368090,76025368089,-1,1647,1715,0
76027522734,76027522736,2,1697,2029,0
76029593127,76029593125,-2,1245,2646,0
76029729881,76029729878,-3,972,1437,0
76032463095,76032463097,2,1255,2057,0
76032753166,76032753170,4,1447,1209,0
76035047881,76035047881,0,1355,1700,0
76037466598,76037466602,4,2364,1527,0
76038120479,76038120477,-2,1234,1480,0
76039403751,76039403751,0,1248,1210,0
76042441466,76042441462,-4,1476,5620,0
76047412434,76047412435,1,928,712,0
76049495959,76049495961,2,1565,1595,0
76052170309,76052170306,-3,1567,1886,0
76054556831,76054556831,0,1797,1683,0
76054683459,76054683457,-2,22617,21160,0
76055224848,76055224847,-1,1401,1248,0
76057525936,76057525949,13,15965,20951,0
76057764553,76057764554,1,1516,1924,0
76058020492,76058020510,18,1392,1312,0
76058420825,76058420827,2,1024,1391,0
76059068922,76059068922,0,1290,1991,0
76060276652,76060276657,5,2854,1187,0
76065099327,76065099331,4,1371,1142,0
76065376455,76065376455,0,1094,1130,0
76065982150,76065982150,0,863,1315,0
76066454281,76066454284,3,1374,1117,0
76068761991,76068761993,2,1809,1848,0
76069484733,76069484733,0,2107,2128,0
76083230021,76083230020,-1,1487,2342,0
76083529303,76083529303,0,1700,2241,0
76088476018,76088476018,0,1066,1557,0
76090474560,76090474579,19,1850,2570,0
76091551134,76091551132,-2,925,1452,0
76093546421,76093546403,-18,1101,1872,0
76095173517,76095173518,1,1331,1366,0
76097654895,76097654889,-6,952,5508,0
76098582195,76098582203,8,13230,23105,0
76098688026,76098688027,1,1042,1543,0
76100419757,76100419757,0,1694,1613,0
76100574545,76100574546,1,1358,1686,0
76101177181,76101177181,0,722,1314,0
76101773006,76101773006,0,1001,1285,0
76102865151,76102865153,2,1162,1738,0
76103284465,76103284462,-3,27826,14179,0
76104190592,76104190590,-2,1420,1646,0
76104494151,76104494152,1,1673,1479,0
76104661711,76104661710,-1,1572,1939,0
76106331274,76106331276,2,1320,1996,0
76110370926,76110370941,15,593,1324,0
76111515183,76111515186,3,1527,1292,0
76111614894,76111614900,6,1231,1354,0
76112804946,76112804946,0,883,1308,0
76115906448,76115906447,-1,1444,1886,0
76120521034,76120521036,2,1268,1695,0
76122021748,76122021748,0,1405,1876,0
76123684682,76123684682,0,971,2132,0
76126517865,76126517865,0,1217,1569,0
76126727013,76126727014,1,2033,1535,0
76126856042,76126856043,1,976,1162,0
76127356678,76127356678,0,1300,1400,0
76133833075,76133833077,2,1060,1545,0
76134490500,76134490501,1,1495,1419,0
76135809585,76135809586,1,1252,1998,0
76137248511,76137248515,4,1228,1433,0
76137584617,76137584617,0,1118,2346,0
76141972250,76141972251,1,1792,1765,0
76151144826,76151144827,1,1581,1552,0
76157275529,76157275539,10,16385,22588,0
76157746354,76157746353,-1,1157,1575,0
76162161113,76162161113,0,1000,1764,0
76163708338,76163708339,1,1363,1658,0
76164381118,76164381117,-1,1217,1667,0
76168711527,76168711528,1,1355,1334,0
76169880843,76169880843,0,1120,1618,0
76171685451,76171685452,1,1413,1630,0
76179521093,76179521093,0,2243,2184,0
76179836009,76179836022,13,1446,1739,0
76184927805,76184927804,-1,1338,1566,0
76189428757,76189428758,1,1001,1217,0
76190713637,76190713637,0,1461,1719,0
76192706115,76192706115,0,1358,1435,0
76201496075,76201496075,0,1428,1422,0
76202860741,76202860742,1,1601,1179,0
76204584470,76204584471,1,1817,1744,0
76207737659,76207737658,-1,1884,2192,0
76207957534,76207957537,3,1401,1627,0
76210529846,76210529847,1,1405,1375,0
76213527975,76213527974,-1,1764,1749,0
76213809322,76213809323,1,1237,1767,0
76217090922,76217090921,-1,1379,1821,0
76217697716,76217697715,-1,1189,1699,0
76218843002,76218843003,1,1606,1907,0
76220286555,76220286554,-1,1627,2820,0
76221128430,76221128430,0,1059,1575,0
76221578343,76221578341,-2,1592,1361,0
76224171365,76224171366,1,3141,4266,0
76228245346,76228245345,-1,1072,1879,0
76229437042,76229437041,-1,1695,1257,0
76229889577,76229889575,-2,1404,1921,0
76231719173,76231719175,2,991,1641,0
76233600611,76233600613,2,1123,1429,0
76234255690,76234255692,2,1315,1022,0
76236911607,76236911611,4,1209,904,0
76241684942,76241684942,0,1882,2281,0
76242000723,76242000721,-2,1055,2003,0
76242646476,76242646485,9,890,731,0
76243387233,76243387234,1,3045,1696,0
76243523446,76243523449,3,1230,1702,0
76245972531,76245972531,0,880,1421,0
76247981700,76247981701,1,1388,1644,0
76250576413,76250576412,-1,1630,1932,0
76256422487,76256422468,-19,1586,1721,0
76257092978,76257092978,0,1044,1231,0
76262158348,76262158346,-2,1709,1843,0
76265832061,76265832063,2,1361,1141,0
76265996574,76265996573,-1,1265,2048,0
76267916291,76267916293,2,1287,2130,0
76279563414,76279563413,-1,1757,1630,0
76284638608,76284638608,0,1165,1624,0
76289978139,76289978140,1,1372,1676,0
76297640882,76297640879,-3,1162,1951,0
76298098474,76298098476,2,1958,2251,0
76299537621,76299537622,1,1469,1902,0
76303004299,76303004298,-1,1012,1697,0
76303986843,76303986845,2,952,1677,0
76308596696,76308596695,-1,1621,1865,0
76311764997,76311765001,4,1775,1358,0
76312589727,76312589727,0,1429,1415,0
76313329875,76313329876,1,1396,2110,0
76313426878,76313426879,1,1350,1823,0
76314277319,76314277321,2,956,1539,0
76315089101,76315089105,4,2208,1828,0
76319992690,76319992690,0,1171,1843,0
76321096291,76321096286,-5,758,3933,0
76322654461,76322654462,1,1308,2026,0
76324261498,76324261501,3,1364,1323,0
76324446701,76324446702,1,1368,1545,0
76327811411,76327811413,2,1296,1218,0
76329637053,76329637052,-1,1263,1558,0
76331573690,76331573690,0,983,1255,0
76331909891,76331909893,2,1369,2750,0
76335105557,76335105556,-1,1607,1782,0
76336083570,76336083571,1,1646,1779,0
76337192015,76337192018,3,2114,1632,0
76337287586,76337287587,1,976,1255,0
76337737613,76337737613,0,1500,1369,0
76338663148,76338663146,-2,1059,1210,0
76339082668,76339082668,0,1623,2293,0
76342137810,76342137806,-4,1066,2170,0
76343945493,76343945492,-1,1519,1916,0
76346463990,76346463993,3,1457,1639,0
76347066881,76347066881,0,1701,2354,0
76359337483,76359337484,1,1533,2231,0
76361368453,76361368454,1,1552,1513,0
76365770334,76365770333,-1,1165,1733,0
76366464291,76366464293,2,876,1424,0
76369718205,76369718195,-10,1538,1997,0
76370635593,76370635594,1,1089,1042,0
76373770882,76373770882,0,1179,1549,0
76375520770,76375520772,2,2058,1697,0
76375630820,76375630822,2,1535,1871,0
76375789653,76375789650,-3,1450,2786,0
76376649745,76376649750,5,2517,1577,0
76377404024,76377404025,1,1134,1639,0
76379942838,76379942838,0,911,1484,0
76381438924,76381438925,1,1250,1551,0
76382542011,76382542007,-4,1060,3031,0
76385870145,76385870146,1,1377,1846,0
76387644759,76387644759,0,1384,1365,0
76391976856,76391976857,1,1570,2401,0
76397235680,76397235680,0,1953,2592,0
76400420683,76400420687,4,1321,2014,0
76402013062,76402013062,0,1388,1435,0
76407093832,76407093830,-2,1362,2234,0
76408829361,76408829360,-1,1231,1512,0
76410123813,76410123814,1,991,1399,0
76411358195,76411358196,1,1416,1644,0
76411759839,76411759841,2,1444,1690,0
76413033710,76413033709,-1,1356,1721,0
76416064814,76416064815,1,1670,2196,0
76416456590,76416456591,1,2138,2843,0
76417225523,76417225523,0,1371,2192,0
76418545860,76418545859,-1,1236,2025,0
76419173773,76419173773,0,1306,1281,0
76426200488,76426200489,1,1055,1095,0
76428017741,76428017742,1,1291,1299,0
76429239250,76429239251,1,1028,1245,0
76430308154,76430308157,3,1510,1532,0
76432370328,76432370323,-5,1437,4281,0
76434221880,76434221883,3,1464,1153,0
76435043382,76435043383,1,1135,1429,0
76436574922,76436574923,1,1065,1155,0
76439523901,76439523901,0,1702,2216,0
76440135303,76440135303,0,1593,1544,0
76440548869,76440548870,1,1103,1874,0
76444920850,76444920850,0,1465,1578,0
76450058250,76450058251,1,1492,1707,0
76450423373,76450423373,0,2257,2245,0
76453628366,76453628365,-1,1646,1582,0
76456489931,76456489932,1,1363,1433,0
76457388217,76457388217,0,978,1652,0
76458711165,76458711165,0,1355,1674,0
76465941314,76465941314,0,1305,1486,0
76467953520,76467953520,0,1912,1892,0
76473526566,76473526567,1,1487,1591,0
76474410823,76474410823,0,1180,1526,0
76475413354,76475413358,4,2324,1869,0
76476169671,76476169672,1,1473,1532,0
76483408606,76483408606,0,1450,1546,0
76485862634,76485862634,0,1740,2217,0
76487517535,76487517535,0,1570,1685,0
76488369740,76488369742,2,1543,1631,0
76490203290,76490203291,1,1195,1147,0
76490649993,76490649994,1,1181,1529,0
76491264058,76491264058,0,1425,1931,0
76492258790,76492258792,2,2711,3800,0
76492311930,76492311931,1,1461,1871,0
76492789779,76492789778,-1,1279,1611,0
76495214345,76495214350,5,7538,3610,0
76496487021,76496487023,2,1813,1623,0
76498418974,76498418977,3,1889,2284,0
76499351421,76499351422,1,1532,1613,0
76500635484,76500635484,0,1277,1588,0
76502355910,76502355913,3,1495,1707,0
76503385779,76503385779,0,1424,1641,0
76503553298,76503553299,1,2190,1597,0
76504746409,76504746410,1,1453,1729,0
76505759182,76505759182,0,1535,1524,0
76506315028,76506315030,2,1951,1485,0
76508440220,76508440221,1,1617,1523,0
76510617489,76510617488,-1,1340,1914,0
76511153484,76511153483,-1,1376,1729,0
76515262972,76515262973,1,1864,1838,0
76517809771,76517809770,-1,1364,1983,0
76518027470,76518027470,0,906,951,0
76521979173,76521979177,4,1763,1318,0
76522605143,76522605143,0,1522,1617,0
76523086499,76523086506,7,6799,2342,0
76524110723,76524110729,6,1462,1334,0
76530542794,76530542795,1,1272,1410,0
76530903400,76530903401,1,1451,1844,0
76532197562,76532197562,0,1254,1693,0
76533562718,76533562723,5,2983,1491,0
76535806953,76535806954,1,1581,1631,0
76536510874,76536510875,1,1466,2061,0
76536730983,76536730983,0,1788,1357,0
76536797628,76536797628,0,1415,2075,0
76539370206,76539370206,0,1132,1828,0
76541108809,76541108810,1,2073,2352,0
76543415022,76543415021,-1,986,1211,0
76546407973,76546407974,1,1535,1284,0
76546456843,76546456860,17,1007,1503,0
76548232505,76548232505,0,1431,1644,0
76548449105,76548449106,1,1005,1422,0
76549960030,76549960033,3,874,1256,0
76551871407,76551871408,1,1966,2005,0
76552801705,76552801705,0,1469,1650,0
76557465799,76557465799,0,952,1376,0
76559150521,76559150522,1,1389,1828,0
76560762536,76560762529,-7,1177,5863,0
76562012234,76562012232,-2,788,1645,0
76563109471,76563109471,0,1076,1245,0
76567405702,76567405702,0,1513,1738,0
76570307673,76570307675,2,1196,1076,0
76572249561,76572249564,3,2577,1463,0
76572395981,76572395983,2,1300,1160,0
76575196351,76575196351,0,1342,1338,0
76575720366,76575720367,1,1249,1708,0
76576383791,76576383791,0,1888,2293,0
76576443941,76576443942,1,1533,1848,0
76577165085,76577165086,1,1637,2065,0
76580279953,76580279953,0,1199,1194,0
76581409706,76581409707,1,1182,1311,0
76582689872,76582689872,0,1209,1261,0
76584086382,76584086383,1,1189,1558,0
76584349393,76584349396,3,2572,1426,0
76585871270,76585871275,5,1104,1533,0
76586136199,76586136211,12,10987,38765,0
76588075369,76588075369,0,2005,2002,0
76588410688,76588410691,3,1522,1254,0
76589618487,76589618489,2,1372,1004,0
76591896969,76591896973,4,1392,1424,0
76592258255,76592258255,0,1397,2194,0
76595002214,76595002213,-1,1483,2029,0
76598977269,76598977270,1,1523,1643,0
76599115577,76599115578,1,1584,1849,0
76599253760,76599253761,1,1129,1621,0
76600093786,76600093791,5,1050,939,0
76600509496,76600509496,0,1229,1530,0
76605332312,76605332314,2,2036,2502,0
76606160058,76606160055,-3,1529,1670,0
76606396623,76606396624,1,1251,1614,0
76607821776,76607821777,1,1440,1198,0
76608448075,76608448074,-1,1221,1265,0
76608536043,76608536042,-1,846,1750,0
76613588438,76613588439,1,1021,1323,0
76618150743,76618150745,2,1870,1872,0
76618330869,76618330870,1,1094,1576,0
76621922494,76621922489,-5,1510,1940,0
76623523694,76623523696,2,1184,1895,0
76623870650,76623870650,0,2460,4577,0
76624965475,76624965478,3,1956,2459,0
76626463442,76626463442,0,1583,1846,0
76626880973,76626880972,-1,1183,1391,0
76628259371,76628259373,2,1342,1379,0
76632743256,76632743256,0,1351,1729,0
76636156838,76636156838,0,1441,1513,0
76645076103,76645076109,6,1825,976,0
76650214090,76650214091,1,1406,1515,0
76650848964,76650848965,1,1333,1507,0
76651841521,76651841522,1,1166,1616,0
76652474154,76652474153,-1,987,1250,0
76653771814,76653771815,1,999,1500,0
76656117621,76656117615,-6,2725,7478,0
76659609513,76659609515,2,1413,1432,0
76662961901,76662961902,1,1172,1828,0
76671048831,76671048833,2,1550,1301,0
76671267413,76671267415,2,601,1156,0
76672561466,76672561466,0,1447,1413,0
76675699460,76675699460,0,1286,1800,0
76679738419,76679738419,0,977,1394,0
76681375198,76681375194,-4,1129,3744,0
76683876448,76683876450,2,1072,1559,0
76685448436,76685448443,7,2165,1171,0
76685720174,76685720173,-1,1073,1463,0
76687061646,76687061646,0,2019,2342,0
76690337845,76690337844,-1,1092,1998,0
76691365007,76691365006,-1,1045,1932,0
76695879703,76695879702,-1,2225,2333,0
76698286176,76698286172,-4,1285,1539,0
76704146062,76704146063,1,1112,1409,0
76705904433,76705904435,2,1611,1461,0
76708890926,76708890926,0,1422,1619,0
76709758783,76709758786,3,1440,1863,0
76709812570,76709812570,0,1887,1853,0
76712754016,76712754014,-2,893,1001,0
76713879124,76713879113,-11,1292,1452,0
76714902950,76714902952,2,1797,1927,0
76714967215,76714967219,4,1549,1383,0
76717772808,76717772809,1,1375,1668,0
76720127310,76720127310,0,690,824,0
76722654661,76722654659,-2,1589,1645,0
76728430193,76728430194,1,1604,2475,0
76729620484,76729620486,2,1887,1441,0
76730629974,76730629975,1,1415,1306,0
76730832050,76730832030,-20,1025,1157,0
76738561907,76738561906,-1,1616,2340,0
76740745841,76740745838,-3,1222,2172,0
76741097559,76741097578,19,1393,1801,0
76742531751,76742531750,-1,1375,1414,0
76745067665,76745067665,0,1074,1583,0
76746581939,76746581939,0,893,2252,0
76747140127,76747140127,0,1083,1260,0
76747564255,76747564255,0,1129,1351,0
76748662134,76748662136,2,2916,3332,0
76751414170,76751414191,21,950,1530,0
76752631112,76752631113,1,1113,1695,0
76754641978,76754641979,1,1693,1849,0
76759424693,76759424692,-1,1700,1873,0
76760323562,76760323564,2,1166,926,0
76760420755,76760420754,-1,800,1115,0
76764547709,76764547708,-1,1054,1398,0
76765444230,76765444228,-2,1124,1558,0
76767301754,76767301753,-1,1027,1230,0
76767676203,76767676195,-8,1187,4278,0
76767820927,76767820930,3,1360,1075,0
76775323859,76775323862,3,1849,1552,0
76775613662,76775613663,1,1307,1604,0
76775770311,76775770308,-3,1104,3479,0
76776406653,76776406655,2,907,2275,0
76776966001,76776966003,2,1246,1789,0
76779749983,76779749986,3,1465,1680,0
76780798186,76780798194,8,2819,1640,0
76782842387,76782842384,-3,719,1593,0
76786172359,76786172358,-1,1240,1848,0
76787478223,76787478224,1,1627,3140,0
76790431045,76790431058,13,15103,37156,0
76790985257,76790985258,1,2046,2162,0
76794514090,76794514090,0,1441,1970,0
76794663669,76794663669,0,1486,2105,0
76799623338,76799623318,-20,1534,1735,0
76802536751,76802536749,-2,1265,1580,0
76804719582,76804719583,1,1012,1739,0
76805871794,76805871806,12,952,1070,0
76808533230,76808533228,-2,1371,2637,0
76815070321,76815070322,1,971,1861,0
76816003543,76816003543,0,1278,2240,0
76816164532,76816164522,-10,851,1636,0
76825328110,76825328109,-1,989,1646,0
76829776823,76829776826,3,1667,1703,0
76832295874,76832295875,1,1519,1759,0
76833329293,76833329290,-3,1053,1650,0
76835901786,76835901787,1,1185,1253,0
76839493609,76839493612,3,1846,2238,0
76839793774,76839793775,1,1317,1798,0
76843169196,76843169197,1,1321,1190,0
76844181554,76844181553,-1,1310,2109,0
76847711176,76847711170,-6,1272,6664,0
76852561066,76852561067,1,1297,1279,0
76856471533,76856471534,1,692,1796,0
76858084535,76858084535,0,1303,1653,0
76859634151,76859634149,-2,1119,2001,0
76861415787,76861415794,7,4356,1726,0
76862730107,76862730106,-1,895,1909,0
76865615211,76865615212,1,1428,1763,0
76866899771,76866899773,2,1965,2182,0
76869695965,76869695965,0,1609,1995,0
76872969319,76872969319,0,991,829,0
76874245922,76874245922,0,1463,1490,0
76874707821,76874707821,0,1499,1433,0
76876030648,76876030650,2,2164,1411,0
76881798946,76881798948,2,2001,1725,0
76882552320,76882552343,23,1393,1647,0
76883009212,76883009211,-1,1178,2056,0
76883295898,76883295902,4,2026,1059,0
76893441756,76893441756,0,1113,1526,0
76896813590,76896813589,-1,1626,3228,0
76898594049,76898594041,-8,985,5778,0
76899331471,76899331471,0,1539,1797,0
76900497200,76900497198,-2,1458,2054,0
76902371871,76902371873,2,1301,1688,0
76904397833,76904397834,1,1257,1715,0
76906629691,76906629692,1,1198,1621,0
76907339537,76907339537,0,1313,2044,0
76911051370,76911051352,-18,854,1517,0
76911086855,76911086856,1,1517,1365,0
76913467914,76913467913,-1,1277,1671,0
76917055745,76917055746,1,1611,2498,0
76917298374,76917298374,0,987,1661,0
76918141406,76918141406,0,1040,1942,0
76919612785,76919612783,-2,1753,1783,0
76921407852,76921407852,0,1434,1659,0
76921760494,76921760493,-1,1367,1472,0
76922153638,76922153639,1,1483,1154,0
76923261882,76923261881,-1,827,1392,0
76925926941,76925926940,-1,1602,2240,0
76927609557,76927609556,-1,1459,1805,0
76929428278,76929428278,0,2433,2279,0
76931610418,76931610432,14,1482,1070,0
76935023794,76935023791,-3,1061,1593,0
76936873886,76936873886,0,1775,2434,0
76937106829,76937106830,1,1118,1438,0
76937237370,76937237369,-1,1021,2180,0
76941205243,76941205245,2,1695,1625,0
76942648566,76942648567,1,1503,1668,0
76948034611,76948034611,0,1039,1855,0
76948807706,76948807705,-1,1976,1962,0
76950216488,76950216489,1,1282,1829,0
76952487673,76952487674,1,1093,1505,0
76952938655,76952938653,-2,1007,1378,0
76953633569,76953633570,1,942,1396,0
76953908109,76953908111,2,802,1466,0
76959946869,76959946869,0,1200,2244,0
76961479293,76961479292,-1,1764,2501,0
76964057797,76964057795,-2,1674,1262,0
76964223968,76964223970,2,1914,1958,0
76964410467,76964410469,2,1402,1578,0
76971088796,76971088797,1,1606,1514,0
76972841457,76972841441,-16,62,1107,0
76974302071,76974302073,2,1355,1455,0
76977105371,76977105374,3,846,961,0
76977390725,76977390722,-3,747,1787,0
76981043127,76981043126,-1,1112,2328,0
76982499736,76982499735,-1,883,1250,0
76983753712,76983753714,2,1411,1798,0
76993600478,76993600479,1,1288,1139,0
76999534762,76999534761,-1,1850,1818,0
77000439427,77000439426,-1,1214,1585,0
77004364622,77004364622,0,1664,1586,0
77004980622,77004980622,0,1767,2033,0
77009647330,77009647333,3,1233,1312,0
77015253994,77015253994,0,1314,1441,0
77015657846,77015657847,1,1246,1793,0
77015962645,77015962646,1,1466,1755,0
77018399747,77018399749,2,904,1283,0
77019846209,77019846209,0,1385,1606,0
77020108541,77020108543,2,1646,1763,0
77020338637,77020338638,1,1745,1759,0
77024640539,77024640541,2,1719,1336,0
77028436847,77028436849,2,1590,1348,0
77028597412,77028597429,17,1718,1620,0
77029691887,77029691889,2,1882,2760,0
77031516299,77031516298,-1,1729,1710,0
77032643387,77032643386,-1,1019,1565,0
77035543009,77035543010,1,2010,1832,0
77037021513,77037021514,1,1248,1826,0
77037069883,77037069882,-1,1236,2666,0
77040542782,77040542785,3,1615,1383,0
77055187430,77055187434,4,5000,3197,0
77062542101,77062542101,0,1042,855,0
77063149934,77063149934,0,1520,2009,0
77066827479,77066827478,-1,1659,2389,0
77067190765,77067190765,0,2077,2367,0
77067217534,77067217535,1,1626,2663,0
77070124138,77070124138,0,1555,2115,0
77070251238,77070251239,1,1174,1849,0
77070755380,77070755380,0,2146,2428,0
77071645901,77071645900,-1,1405,1585,0
77072392771,77072392773,2,1497,1343,0
77076446902,77076446904,2,1639,1699,0
77081437581,77081437582,1,1575,2189,0
77082379874,77082379874,0,1108,1271,0
77083974617,77083974619,2,1428,1602,0
77086779282,77086779286,4,1983,1970,0
77087608489,77087608482,-7,1008,7923,0
77088362080,77088362070,-10,1275,1565,0
77095440281,77095440281,0,1102,1706,0
77102781303,77102781301,-2,1019,1207,0
77104757402,77104757402,0,1272,1293,0
77105299342,77105299345,3,744,1166,0
77107400138,77107400140,2,1047,1685,0
77108938331,77108938332,1,895,1376,0
77111068647,77111068647,0,1190,1785,0
77111187052,77111187053,1,1356,1782,0
77111827543,77111827537,-6,1150,4913,0
77115158857,77115158857,0,1918,1792,0
77115627234,77115627233,-1,1496,1698,0
77117142769,77117142771,2,1955,1171,0
77117641849,77117641850,1,1111,1650,0
77118912756,77118912758,2,2658,1930,0
77120738118,77120738118,0,1315,1326,0
77121601403,77121601407,4,1580,1231,0
77122057547,77122057546,-1,1164,1542,0
77123386170,77123386170,0,1729,2225,0
77124601283,77124601285,2,1747,2643,0
77125515632,77125515630,-2,1454,1327,0
77126268494,77126268493,-1,1778,2639,0
77127242967,77127242968,1,1897,2271,0
77132438271,77132438259,-12,1106,1498,0
77134986170,77134986170,0,1006,1960,0
77136214662,77136214665,3,2006,1654,0
77137215750,77137215752,2,1220,1701,0
77138624589,77138624586,-3,1046,1857,0
77146927253,77146927253,0,1313,1601,0
77152267505,77152267506,1,1599,1052,0
77153491675,77153491674,-1,1947,1881,0
77154305981,77154305981,0,2641,1926,0
77155573743,77155573762,19,1057,1714,0
77156051887,77156051885,-2,1650,1863,0
77158798130,77158798139,9,2470,1210,0
77159711862,77159711862,0,1408,1386,0
77161311762,77161311762,0,1197,1873,0
77162869741,77162869743,2,1417,1222,0
77170595238,77170595239,1,1756,1709,0
77172005710,77172005711,1,1207,1383,0
77172219466,77172219466,0,1522,1452,0
77183120248,77183120249,1,1722,1495,0
77188559761,77188559762,1,1156,1813,0
77189651980,77189651985,5,1981,1264,0
77192457787,77192457787,0,1386,1482,0
77194858379,77194858379,0,1784,1866,0
77199027607,77199027611,4,1947,1388,0
77200155526,77200155527,1,1611,1616,0
77201516861,77201516860,-1,935,1512,0
77207192038,77207192038,0,1306,1990,0
77209966054,77209966056,2,6029,29830,0
77213279991,77213279991,0,1443,1576,0
77213769021,77213769022,1,1034,1282,0
77214775886,77214775886,0,1628,2012,0
77215813883,77215813891,8,1442,769,0
77221555722,77221555723,1,1377,1215,0
77223068402,77223068402,0,1176,1383,0
77223205045,77223205047,2,1421,1423,0
77224100593,77224100594,1,1421,1845,0
77225334553,77225334555,2,1237,1147,0
77226291539,77226291537,-2,1336,2862,0
77229613274,77229613273,-1,1696,2437,0
77232082950,77232082950,0,988,1076,0
77235917819,77235917817,-2,1482,1665,0
77236831362,77236831363,1,1524,1686,0
77237543351,77237543352,1,1300,1865,0
77239753535,77239753532,-3,1157,1393,0
77240194870,77240194868,-2,1147,1773,0
77241491481,77241491481,0,1531,1705,0
77249438646,77249438649,3,1919,1615,0
77253577842,77253577843,1,1255,1571,0
77256074978,77256074972,-6,1022,6526,0
77257830361,77257830362,1,2353,2428,0
77260664471,77260664472,1,1400,1784,0
77263687030,77263687031,1,1287,1537,0
77268712201,77268712202,1,1526,1336,0
77271328758,77271328757,-1,1499,1543,0
77276846394,77276846402,8,967,1555,0
77277433695,77277433695,0,1366,1572,0
77277745797,77277745797,0,1074,1827,0
77279076771,77279076770,-1,1178,1792,0
77280320076,77280320077,1,1766,1893,0
77281716357,77281716358,1,1260,1041,0
77282973596,77282973595,-1,1190,1459,0
77291997657,77291997654,-3,1317,2001,0
77292956590,77292956591,1,920,1248,0
77293311141,77293311140,-1,2452,2785,0
77293476224,77293476225,1,1222,1770,0
77295451530,77295451530,0,1023,1589,0
77300965495,77300965494,-1,1162,1648,0
77311840674,77311840670,-4,1069,3597,0
77312339041,77312339040,-1,2263,2511,0
77313185827,77313185828,1,1838,1330,0
77318444915,77318444915,0,744,996,0
77319785915,77319785915,0,1000,1696,0
77322150318,77322150320,2,1455,1868,0
77322360113,77322360115,2,1187,1773,0
77324237114,77324237112,-2,1048,1197,0
77326451664,77326451667,3,2762,1856,0
77327405534,77327405537,3,1501,1458,0
77329376261,77329376261,0,1393,2199,0
77329402157,77329402141,-16,1269,1932,0
77330046974,77330046978,4,1161,1052,0
77334520385,77334520394,9,95,1389,0
77336754570,77336754570,0,1076,1477,0
77340112919,77340112919,0,1057,1549,0
77345305025,77345305025,0,1673,2279,0
77347796237,77347796238,1,1349,1776,0
77348638233,77348638234,1,1423,2093,0
77349447758,77349447758,0,1514,2006,0
77352482075,77352482070,-5,995,2091,0
77354578745,77354578746,1,1818,2022,0
77356037035,77356037034,-1,1448,2402,0
77356571206,77356571207,1,1467,1476,0
77357260671,77357260671,0,1710,1542,0
77358306634,77358306634,0,864,1404,0
77362983831,77362983830,-1,1448,1455,0
77368038177,77368038176,-1,1269,1663,0
77369430257,77369430278,21,1475,2201,0
77369717859,77369717860,1,1631,1417,0
77370594993,77370594994,1,1619,1474,0
77371471245,77371471243,-2,1857,2343,0
77377643288,77377643289,1,1650,2069,0
77378512058,77378512060,2,1035,1328,0
77379526818,77379526818,0,1074,1151,0
77383637386,77383637386,0,1496,1770,0
77388568510,77388568510,0,988,1347,0
77389057699,77389057705,6,2279,1265,0
77389580405,77389580406,1,1219,1108,0
77396846817,77396846817,0,794,1370,0
77398654984,77398654981,-3,1854,2148,0
77399274723,77399274719,-4,1323,2892,0
77399796961,77399796961,0,578,916,0
77401875760,77401875760,0,1823,1479,0
77403131335,77403131330,-5,2104,5574,0
77403853698,77403853699,1,1968,1806,0
77404520898,77404520897,-1,1427,1782,0
77404939627,77404939629,2,1737,1996,0
77406174489,77406174489,0,1245,1575,0
77408086346,77408086345,-1,1699,2426,0
77410791450,77410791451,1,1392,1231,0
77413012947,77413012933,-14,1857,1906,0
77415007313,77415007313,0,230,560,0
77416703358,77416703358,0,1625,1891,0
77417763959,77417763976,17,16041,46222,0
77419000262,77419000266,4,1102,1564,0
77420507470,77420507470,0,1777,1866,0
77421109123,77421109122,-1,1539,1581,0
77426122970,77426122972,2,1460,1187,0
77427206566,77427206567,1,1381,1586,0
77428121161,77428121157,-4,1168,1609,0
77428972061,77428972061,0,1836,1759,0
77433106819,77433106818,-1,1593,1738,0
77434605533,77434605533,0,1755,1681,0
77435544537,77435544538,1,1596,2000,0
77444860277,77444860278,1,1139,1346,0
77444940586,77444940587,1,811,1235,0
77445954502,77445954502,0,1196,1577,0
77448456289,77448456289,0,1499,2105,0
77449483129,77449483123,-6,900,4805,0
77450343094,77450343094,0,1211,2095,0
77452248377,77452248376,-1,1562,1739,0
77454430834,77454430837,3,1283,1080,0
77458609567,77458609568,1,1401,1766,0
77460609701,77460609702,1,864,1947,0
77460743261,77460743255,-6,1337,1602,0
77461032299,77461032299,0,1312,1166,0
77465707515,77465707515,0,1328,1558,0
77466217390,77466217390,0,908,1503,0
77467416028,77467416029,1,1356,1503,0
77467862206,77467862214,8,860,1323,0
77468401617,77468401623,6,8872,2114,0
77470960158,77470960158,0,1707,1882,0
77472085357,77472085361,4,2547,1280,0
77472125539,77472125559,20,1346,1241,0
77474517465,77474517467,2,1361,1423,0
77475705917,77475705914,-3,1066,1600,0
77482369485,77482369486,1,1980,1315,0
77482404050,77482404049,-1,1158,1687,0
77482849427,77482849429,2,1789,1963,0
77483252054,77483252055,1,599,873,0
77484927257,77484927258,1,1508,1792,0
77485120545,77485120524,-21,1794,1458,0
77486570299,77486570301,2,1147,1369,0
77488134288,77488134288,0,1544,1649,0
77488200030,77488200029,-1,1551,1898,0
77490784635,77490784637,2,1976,1880,0
77491492517,77491492519,2,1759,2196,0
77492468333,77492468333,0,1861,1540,0
77492819665,77492819666,1,1043,1992,0
77493067628,77493067629,1,1640,1820,0
77495005731,77495005730,-1,1241,1860,0
77495411226,77495411226,0,1168,1544,0
77497732161,77497732153,-8,841,4854,0
77497943683,77497943688,5,1541,1309,0
77498796238,77498796234,-4,1365,1969,0
77498871488,77498871490,2,1236,1544,0
77500404767,77500404769,2,1933,1610,0
77501190488,77501190489,1,1755,1747,0
77501428226,77501428225,-1,1364,1790,0
77503236514,77503236507,-7,1055,5714,0
77504789049,77504789051,2,1277,1399,0
77505862890,77505862889,-1,1894,2044,0
77508634961,77508634962,1,1329,1406,0
77509176974,77509176977,3,1682,1505,0
77509578827,77509578826,-1,863,1517,0
77510754461,77510754462,1,1474,1645,0
77511527130,77511527131,1,991,1181,0
77516469683,77516469683,0,1267,1825,0
77517804151,77517804147,-4,1445,2938,0
77519391190,77519391192,2,1086,1314,0
77521568025,77521568028,3,1204,1411,0
77523532341,77523532342,1,1039,1852,0
77523949808,77523949809,1,1592,1687,0
77524171069,77524171065,-4,1351,2685,0
77528862299,77528862297,-2,7245,14070,0
77528916740,77528916739,-1,1439,1616,0
77532334394,77532334395,1,1287,1263,0
77534052103,77534052102,-1,1597,1720,0
77534750453,77534750454,1,1447,2765,0
77535858580,77535858587,7,1430,1561,0
77540518989,77540518990,1,2465,1889,0
77546394490,77546394489,-1,1317,1376,0
77546647839,77546647853,14,947,907,0
77548533872,77548533874,2,1296,1274,0
77551473331,77551473334,3,761,1148,0
77551739158,77551739160,2,955,1549,0
77560080657,77560080649,-8,1031,5307,0
77562362177,77562362178,1,1411,1273,0
77562747388,77562747389,1,1134,1839,0
77564647614,77564647615,1,1435,1211,0
77565296548,77565296534,-14,399,665,0
77566532686,77566532687,1,1117,1408,0
77568312240,77568312240,0,1563,1490,0
77573899782,77573899780,-2,1600,1730,0
77574536338,77574536338,0,1193,1811,0
77577128830,77577128830,0,1662,1003,0
77578313548,77578313553,5,2287,1600,0
77582097182,77582097185,3,1551,1772,0
77582715555,77582715557,2,1791,2160,0
77583547486,77583547495,9,3933,830,0
77583760303,77583760298,-5,1417,3214,0
77593310349,77593310348,-1,1593,1222,0
77595199948,77595199945,-3,1454,1695,0
77598052505,77598052506,1,1740,1235,0
77600058281,77600058283,2,1428,1376,0
77606362486,77606362485,-1,1209,1716,0
77606967148,77606967150,2,1334,1706,0
77613079066,77613079067,1,749,2019,0
77614987951,77614987949,-2,849,1910,0
77619278469,77619278470,1,1636,1913,0
77620690525,77620690526,1,1544,1563,0
77621732813,77621732815,2,2417,1547,0
77622245924,77622245925,1,2001,1663,0
77622681858,77622681860,2,1338,2060,0
77624169427,77624169426,-1,1338,1636,0
77624964631,77624964630,-1,1245,1594,0
77628821875,77628821873,-2,1873,2832,0
77628999584,77628999586,2,1785,1925,0
77630306644,77630306650,6,4209,1575,0
77632095309,77632095309,0,1803,2583,0
77633215165,77633215168,3,1787,1758,0
77633748142,77633748144,2,1525,1816,0
77638402418,77638402423,5,1028,1688,0
77639345941,77639345941,0,1357,1763,0
77641198522,77641198528,6,9725,35829,0
77645809759,77645809761,2,1079,1705,0
77649362601,77649362601,0,1204,2325,0
77653201338,77653201338,0,1330,1701,0
77654470586,77654470586,0,1276,900,0
77654719787,77654719788,1,1326,1778,0
77658071068,77658071067,-1,1527,1510,0
77660660779,77660660778,-1,1193,1776,0
77661483757,77661483738,-19,889,1760,0
77664465614,77664465616,2,1376,2395,0
77664801766,77664801769,3,1221,1362,0
77667648518,77667648520,2,1119,1566,0
77669354853,77669354853,0,1441,1799,0
77670496941,77670496942,1,1839,1828,0
77674351906,77674351905,-1,949,1052,0
77674399473,77674399494,21,1442,1618,0
77676001539,77676001538,-1,1115,2192,0
77677017003,77677017004,1,1647,1812,0
77677287231,77677287225,-6,1752,6421,0
77681502118,77681502118,0,1615,1763,0
77686579530,77686579530,0,1557,2742,0
77688311423,77688311422,-1,1868,1596,0
77689861263,77689861265,2,1480,1230,0
77691637249,77691637250,1,1404,1737,0
77693469305,77693469303,-2,1252,1669,0
77693800834,77693800833,-1,1207,1124,0
77698160482,77698160482,0,1383,1325,0
77698621849,77698621850,1,3975,4150,0
77700799342,77700799345,3,1247,1193,0
77705017002,77705017003,1,1442,1442,0
77705560677,77705560677,0,1615,2396,0
77707794177,77707794177,0,1308,2407,0
77709470598,77709470600,2,1087,1645,0
77710143562,77710143564,2,1517,1268,0
77713486102,77713486102,0,1311,1554,0
77713979603,77713979603,0,1154,1306,0
77719678931,77719678930,-1,1157,2116,0
77726964479,77726964478,-1,1220,1068,0
77727027955,77727027957,2,1575,2584,0
77727109257,77727109257,0,995,866,0
77729707739,77729707740,1,1569,2176,0
77731503571,77731503573,2,1516,1387,0
77733382091,77733382094,3,933,1443,0
77735565064,77735565064,0,1331,1510,0
77736151645,77736151643,-2,1523,2493,0
77737859249,77737859253,4,1305,1250,0
77740329706,77740329708,2,1683,2061,0
77742234401,77742234414,13,13302,42490,0
77742293865,77742293866,1,1327,1967,0
77745740938,77745740939,1,1319,1425,0
77747186128,77747186127,-1,1225,1966,0
77747508666,77747508666,0,1340,1409,0
77747569578,77747569574,-4,962,3334,0
77747642804,77747642807,3,1056,1357,0
77748701586,77748701580,-6,1504,7121,0
77750754591,77750754591,0,1616,1690,0
77754376062,77754376070,8,6048,1769,0
77755226426,77755226429,3,1129,968,0
77756640294,77756640294,0,1245,1173,0
77757835555,77757835555,0,1204,1475,0
77759140510,77759140509,-1,1255,1595,0
77764773550,77764773552,2,1619,1679,0
77766535577,77766535578,1,1486,2207,0
77768975734,77768975737,3,1405,1612,0
77774705442,77774705438,-4,2382,5087,0
77775320043,77775320042,-1,1770,1925,0
77777486583,77777486578,-5,1009,2407,0
77779469265,77779469265,0,1492,1858,0
77781996454,77781996461,7,2005,897,0
77782170069,77782170053,-16,2286,875,0
77784717175,77784717175,0,1270,1889,0
77787398703,77787398703,0,1078,1919,0
77793716715,77793716714,-1,1194,1761,0
77797059840,77797059839,-1,1274,1498,0
77800954565,77800954566,1,1228,1756,0
77808017660,77808017661,1,1090,973,0
77808647543,77808647527,-16,1426,1560,0
77810662533,77810662535,2,1481,1442,0
77811072660,77811072666,6,1090,2792,0
77812467155,77812467155,0,1079,1835,0
77822871374,77822871374,0,1658,1613,0
77823208049,77823208052,3,951,1456,0
77823701999,77823701999,0,1047,1673,0
77823756316,77823756315,-1,1356,1371,0
77825675855,77825675854,-1,1195,1447,0
77827576232,77827576232,0,1684,2096,0
77832268486,77832268487,1,1664,2025,0
77833565462,77833565462,0,1986,2137,0
77833596541,77833596542,1,1760,2152,0
77836269082,77836269081,-1,906,1320,0
77840984290,77840984292,2,1363,2003,0
77841211267,77841211267,0,1099,1457,0
77843725099,77843725093,-6,948,3689,0
77846693713,77846693714,1,1702,2046,0
77848355268,77848355269,1,1101,1583,0
77848429319,77848429320,1,898,1423,0
77849386691,77849386691,0,1536,1432,0
77850182598,77850182598,0,859,1437,0
77853078654,77853078654,0,1975,2201,0
77853290176,77853290175,-1,1462,1478,0
77854891938,77854891943,5,819,823,0
77858382321,77858382326,5,5731,2486,0
77859715976,77859715977,1,1320,2318,0
77860104670,77860104669,-1,1482,1971,0
77861207999,77861207998,-1,1585,1593,0
77863026734,77863026732,-2,2069,2458,0
77865248409,77865248410,1,1381,1554,0
77865734606,77865734605,-1,1611,1525,0
77870525027,77870525026,-1,1838,1832,0
77870772762,77870772760,-2,1125,1811,0
77871998774,77871998774,0,1487,1672,0
77873717590,77873717593,3,2571,1408,0
77874071559,77874071565,6,1629,1282,0
77875674609,77875674609,0,1041,1398,0
77884963150,77884963154,4,2046,2513,0
77885094426,77885094427,1,1497,1979,0
77886778165,77886778166,1,1165,1734,0
77889293225,77889293225,0,1500,1352,0
77891776438,77891776438,0,1574,1710,0
77892755583,77892755582,-1,1530,1969,0
77897764463,77897764460,-3,1686,4415,0
77899454674,77899454674,0,1690,2483,0
77902665509,77902665512,3,1931,2388,0
77903786166,77903786162,-4,1255,2869,0
77905288758,77905288758,0,931,1308,0
77907302733,77907302734,1,2053,2088,0
77911738106,77911738104,-2,1018,1156,0
77913405899,77913405904,5,2261,1578,0
77915102992,77915102991,-1,939,1445,0
77920110603,77920110606,3,1418,1239,0
77924030031,77924030026,-5,916,1095,0
77928022121,77928022124,3,1878,1950,0
77932211606,77932211609,3,1900,1632,0
77932265671,77932265676,5,894,1150,0
77932919202,77932919205,3,1452,2043,0
77933991739,77933991742,3,1761,1960,0
77937473477,77937473477,0,1681,1854,0
77939113338,77939113338,0,1019,1412,0
77941298594,77941298594,0,1075,1120,0
77943093547,77943093548,1,1447,2097,0
77949207549,77949207555,6,3976,22273,0
77952451155,77952451158,3,1572,1139,0
77952700814,77952700819,5,1967,1369,0
77953322650,77953322649,-1,1362,2388,0
77954295173,77954295174,1,2198,1831,0
77954364761,77954364757,-4,872,1444,0
77957529132,77957529130,-2,1658,2586,0
77959483833,77959483833,0,1512,2368,0
77970907975,77970907976,1,1755,1815,0
77976271614,77976271614,0,1263,2478,0
77977117795,77977117796,1,1177,1849,0
77978786946,77978786947,1,1241,1808,0
77981324901,77981324902,1,1231,1868,0
77982667814,77982667814,0,1084,1265,0
77985642544,77985642545,1,1727,1875,0
77985716152,77985716162,10,363,2378,0
77989446866,77989446862,-4,726,1540,0
77989683813,77989683813,0,1549,3027,0
77995655342,77995655341,-1,1288,1958,0
77998390062,77998390058,-4,26575,10963,0
78001364435,78001364433,-2,1096,2456,0
78001867678,78001867680,2,1768,2022,0
78002940397,78002940397,0,1673,1840,0
78004371729,78004371729,0,1571,1818,0
78006322097,78006322095,-2,1397,2896,0
78009852109,78009852108,-1,1393,1927,0
78009921201,78009921202,1,1086,1271,0
78018160004,78018160003,-1,1278,1296,0
78021413157,78021413161,4,2257,1353,0
78021761518,78021761518,0,1380,1462,0
78023975741,78023975742,1,1613,1589,0
78025534182,78025534182,0,1578,1580,0
78027854658,78027854658,0,1044,1426,0
78028823954,78028823956,2,1449,1358,0
78029248225,78029248226,1,1368,1518,0
78032918938,78032918938,0,1020,1425,0
78034806538,78034806539,1,1137,1738,0
78038455350,78038455358,8,12090,4562,0
78040135614,78040135614,0,1137,1393,0
78045522278,78045522279,1,1444,1440,0
78048879313,78048879313,0,1299,1941,0
78050286495,78050286490,-5,942,4507,0
78051105523,78051105522,-1,1175,1707,0
78051263701,78051263694,-7,67,863,0
78054065254,78054065254,0,1326,1696,0
78055365419,78055365421,2,1553,1297,0
78056613747,78056613749,2,1275,1525,0
78057120706,78057120707,1,1566,1336,0
78059373907,78059373907,0,1450,1565,0
78060519577,78060519579,2,1499,1594,0
78062027503,78062027502,-1,1403,1650,0
78068442175,78068442174,-1,1060,2205,0
78069799088,78069799090,2,1967,1358,0
78070367969,78070367970,1,1406,1775,0
78073013346,78073013347,1,1360,1656,0
78075264664,78075264666,2,958,1829,0
78078082302,78078082302,0,1593,1552,0
78079144889,78079144881,-8,796,4202,0
78080051391,78080051379,-12,1482,1264,0
78082442260,78082442261,1,1556,1740,0
78086832242,78086832244,2,1535,1716,0
78087611949,78087611950,1,1167,1597,0
78087988285,78087988285,0,1366,1351,0
78089213753,78089213755,2,1406,1738,0
78089730156,78089730175,19,59,945,0
78089955083,78089955084,1,1714,1984,0
78095464583,78095464585,2,1269,2009,0
78096408908,78096408909,1,2037,1575,0
78099248691,78099248693,2,1346,1682,0
78101055974,78101055976,2,1596,1836,0
78110299227,78110299228,1,1404,1896,0
78112564359,78112564359,0,1503,1673,0
78114637306,78114637307,1,1341,2186,0
78119938937,78119938938,1,1588,1935,0
78122290722,78122290720,-2,406,558,0
78124958243,78124958243,0,1578,1271,0
78125889876,78125889875,-1,1231,1675,0
78130783148,78130783147,-1,1318,2197,0
78131628133,78131628134,1,1938,1806,0
78132652748,78132652747,-1,1842,2154,0
78132696931,78132696930,-1,1484,1493,0
78134177014,78134177016,2,1750,1563,0
78138433697,78138433695,-2,1081,1583,0
78143466567,78143466566,-1,1649,2359,0
78146925164,78146925165,1,2343,2210,0
78156248494,78156248493,-1,1585,2315,0
78159811406,78159811409,3,1501,1603,0
78160253644,78160253643,-1,1371,1669,0
78160877093,78160877093,0,1551,1645,0
78164593028,78164593028,0,1046,1940,0
78167387095,78167387096,1,1535,1583,0
78173268085,78173268087,2,1261,1459,0
78173544527,78173544528,1,1763,1434,0
78173863430,78173863431,1,1639,1842,0
78176174152,78176174151,-1,1392,2343,0
78176998942,78176998941,-1,1649,1650,0
78181461546,78181461547,1,1374,2185,0
78182220326,78182220332,6,2190,1346,0
78183288338,78183288341,3,1323,1713,0
78185696882,78185696881,-1,1622,2154,0
78188524617,78188524618,1,1009,1696,0
78193131190,78193131189,-1,1012,2512,0
78194468417,78194468416,-1,1261,2227,0
78194977431,78194977425,-6,1149,4299,0
78196589200,78196589190,-10,894,1222,0
78199005051,78199005050,-1,1119,1608,0
78202563113,78202563113,0,1182,2122,0
78205064671,78205064672,1,1278,1759,0
78205701202,78205701202,0,1414,1668,0
78209716452,78209716455,3,1305,1050,0
78211799361,78211799362,1,1293,2061,0
78214096710,78214096710,0,1353,1571,0
78218790789,78218790782,-7,1457,6897,0
78221289245,78221289246,1,1183,1197,0
78224688054,78224688053,-1,1783,2670,0
78224917633,78224917634,1,1527,1774,0
78225576598,78225576599,1,2940,2660,0
78225972134,78225972134,0,1305,1414,0
78228586005,78228586006,1,1437,1673,0
78231560450,78231560450,0,1368,1960,0
78231982572,78231982573,1,1333,1890,0
78233080917,78233080916,-1,2022,2765,0
78235111642,78235111643,1,1206,1244,0
78236299571,78236299577,6,1711,829,0
78238306070,78238306070,0,1498,1797,0
78240280631,78240280632,1,1380,1359,0
78240377228,78240377227,-1,983,1330,0
78246088809,78246088811,2,1183,1395,0
78247018073,78247018069,-4,1044,2218,0
78249415801,78249415802,1,1886,1824,0
78252767521,78252767522,1,1389,1436,0
78253385372,78253385371,-1,904,1729,0
78253831817,78253831817,0,1518,2066,0
78254249685,78254249679,-6,1364,5733,0
78255266794,78255266798,4,1899,2366,0
78257874426,78257874429,3,892,1172,0
78258535214,78258535214,0,1099,1695,0
78263192182,78263192181,-1,826,982,0
78264926976,78264926975,-1,1143,1519,0
78265212366,78265212366,0,1225,1751,0
78271036430,78271036430,0,1467,1634,0
78272338479,78272338478,-1,1510,1347,0
78276703279,78276703279,0,1095,1921,0
78279119762,78279119767,5,51037,31991,0
78280490566,78280490567,1,1123,1489,0
78285587453,78285587455,2,998,1270,0
78286772834,78286772839,5,1207,1274,0
78287684666,78287684665,-1,1269,1885,0
78288235922,78288235922,0,939,1699,0
78288391195,78288391175,-20,1002,553,0
78289619294,78289619295,1,1881,2002,0
78290735914,78290735918,4,1708,1684,0
78290769706,78290769707,1,1260,1343,0
78291911230,78291911230,0,1297,1351,0
78295064362,78295064362,0,1622,1966,0
78295153138,78295153138,0,1352,2344,0
78295533929,78295533929,0,1886,2324,0
78300244927,78300244926,-1,1250,1742,0
78305701525,78305701525,0,1034,1393,0
78306818159,78306818159,0,1131,1425,0
78307060946,78307060950,4,1138,1492,0
78312907789,78312907789,0,879,1551,0
78313831785,78313831783,-2,1262,1106,0
78317128857,78317128858,1,1651,1829,0
78322069695,78322069693,-2,965,1508,0
78325563226,78325563226,0,1381,1811,0
78326072771,78326072748,-23,1500,1750,0
78326683598,78326683598,0,1764,2472,0
78329280306,78329280307,1,1864,1592,0
78330783044,78330783045,1,1423,1353,0
78334669363,78334669365,2,1259,1452,0
78338323510,78338323510,0,1587,1388,0
78339892527,78339892526,-1,1391,1460,0
78343065322,78343065325,3,2203,3143,0
78345095844,78345095845,1,2266,2108,0
78346904390,78346904396,6,2326,841,0
78348147214,78348147213,-1,1171,1687,0
78349666519,78349666519,0,1841,1366,0
78351339374,78351339375,1,1232,1921,0
78351707001,78351707002,1,1343,2203,0
78353002857,78353002858,1,1270,1124,0
78353612548,78353612550,2,1600,2079,0
78354790950,78354790951,1,1451,1840,0
78355789510,78355789507,-3,1194,1347,0
78357562398,78357562398,0,1144,1224,0
78364175883,78364175885,2,1143,1555,0
78364745790,78364745790,0,1468,1738,0
78369636910,78369636911,1,2126,2589,0
78370604710,78370604713,3,1920,1276,0
78373844055,78373844055,0,1552,2351,0
78374845681,78374845682,1,1229,1288,0
78375406488,78375406496,8,1226,1871,0
78378559683,78378559683,0,1717,2821,0
78379752509,78379752510,1,1157,2223,0
78381310544,78381310546,2,1174,1420,0
78382884539,78382884533,-6,782,1472,0
78386032572,78386032573,1,654,1364,0
78388315051,78388315047,-4,1343,1471,0
78390693759,78390693759,0,1285,1060,0
78391439733,78391439733,0,1337,2103,0
78392186450,78392186458,8,1711,871,0
78394474903,78394474922,19,1117,1218,0
78397957114,78397957115,1,1630,1770,0
78402397706,78402397700,-6,1770,6276,0
78403257024,78403257025,1,1085,1401,0
78406717476,78406717477,1,1646,1550,0
78408249698,78408249701,3,1385,1680,0
78412684662,78412684664,2,993,1488,0
78419035446,78419035447,1,1170,1303,0
78423831373,78423831374,1,1229,2001,0
78426303877,78426303877,0,1045,1503,0
78433510894,78433510894,0,1342,1848,0
78437096679,78437096678,-1,2074,2058,0
78439270190,78439270192,2,1620,1711,0
78440178018,78440178017,-1,1325,1760,0
78440488376,78440488377,1,1082,1450,0
78447376717,78447376713,-4,21137,11536,0
78458475893,78458475894,1,1845,1936,0
78460267311,78460267310,-1,1817,2194,0
78465166066,78465166070,4,1738,1681,0
78470114479,78470114493,14,14626,5659,0
78471365982,78471365984,2,1506,1372,0
78472211004,78472211004,0,1803,2262,0
78475991211,78475991202,-9,20583,47419,0
78480101211,78480101214,3,2427,1685,0
78480148865,78480148866,1,1397,1023,0
78481119619,78481119617,-2,1038,1389,0
78481855445,78481855442,-3,1326,2417,0
78483674990,78483674991,1,1249,1273,0
78483813686,78483813686,0,1773,1747,0
78487592767,78487592765,-2,1521,1358,0
78489212301,78489212298,-3,1407,1311,0
78490608634,78490608634,0,2062,1780,0
78490712086,78490712095,9,935,1162,0
78493506134,78493506133,-1,1125,1927,0
78495937818,78495937818,0,1350,1319,0
78499543129,78499543130,1,1165,1318,0
78500438199,78500438214,15,1648,1259,0
78502718921,78502718922,1,1233,1303,0
78504661864,78504661866,2,1425,1401,0
78505827348,78505827345,-3,1363,1841,0
78511844855,78511844854,-1,1620,2281,0
78512071826,78512071826,0,1031,2040,0
78514000429,78514000427,-2,1865,1874,0
78514513497,78514513497,0,1558,2341,0
78516463598,78516463593,-5,49600,21240,0
78517617639,78517617639,0,1516,1934,0
78524166379,78524166381,2,1310,2747,0
78524626959,78524626959,0,942,1373,0
78524696878,78524696879,1,1156,1365,0
78525043074,78525043056,-18,1496,417,0
78525340173,78525340172,-1,1445,1686,0
78526149857,78526149863,6,4326,1546,0
78532564659,78532564661,2,919,986,0
78534827941,78534827941,0,1411,1632,0
78535540296,78535540297,1,1016,1045,0
78535952755,78535952753,-2,1401,1872,0
78537770043,78537770042,-1,1292,2085,0
78538547483,78538547484,1,1061,1383,0
78542829034,78542829037,3,1284,2311,0
78546284481,78546284481,0,1874,2082,0
78547952176,78547952178,2,1413,2142,0
78548523453,78548523452,-1,1269,1721,0
78551013791,78551013792,1,1374,2119,0
78551707798,78551707800,2,1426,1611,0
78552632506,78552632509,3,1517,1170,0
78555198549,78555198546,-3,937,2316,0
78559593406,78559593404,-2,1555,2526,0
78561963518,78561963519,1,1285,1305,0
78565133286,78565133287,1,1890,2048,0
78565642225,78565642227,2,1676,1346,0
78566077287,78566077270,-17,1567,1449,0
78566362454,78566362453,-1,1350,2234,0
78566420150,78566420149,-1,1412,1689,0
78573343647,78573343647,0,1060,1683,0
78574200222,78574200222,0,1118,1036,0
78578468119,78578468119,0,1035,1711,0
78580373498,78580373498,0,1355,1661,0
78584551117,78584551118,1,1812,1757,0
78588185601,78588185603,2,1387,1587,0
78595845787,78595845786,-1,1055,1796,0
78596357548,78596357548,0,1425,2152,0
78597961750,78597961751,1,1672,1867,0
78598937710,78598937713,3,1037,1448,0
78599328738,78599328738,0,1382,1788,0
78599493243,78599493246,3,2006,1545,0
78600317731,78600317731,0,1130,1550,0
78600648279,78600648279,0,1303,2014,0
78601593931,78601593928,-3,946,2288,0
78607043954,78607043956,2,1263,1668,0
78610780125,78610780126,1,1284,2045,0
78612314123,78612314125,2,1567,1354,0
78613846895,78613846899,4,1300,1721,0
78615799295,78615799293,-2,925,1540,0
78616780218,78616780227,9,20540,56217,0
78617986832,78617986834,2,1666,1621,0
78618066246,78618066245,-1,1368,1656,0
78619828829,78619828830,1,2094,2844,0
78620383176,78620383175,-1,1691,2314,0
78621191878,78621191877,-1,1533,1578,0
78625070026,78625070027,1,1378,2141,0
78626688452,78626688454,2,1663,1485,0
78627512007,78627512007,0,1331,1235,0
78628335718,78628335718,0,1290,1896,0
78629191826,78629191829,3,18742,14806,0
78632977366,78632977365,-1,703,835,0
78634530993,78634530994,1,1378,1483,0
78637225424,78637225423,-1,1272,1484,0
78638769290,78638769290,0,1579,1709,0
78639856647,78639856647,0,1089,1602,0
78642098391,78642098390,-1,1256,1897,0
78644635057,78644635062,5,1820,1059,0
78647103984,78647103985,1,1125,1837,0
78647691257,78647691262,5,1434,1177,0
78648679507,78648679510,3,1477,2128,0
78650300228,78650300227,-1,1269,1944,0
78650567054,78650567055,1,1447,1483,0
78651440196,78651440197,1,939,2003,0
78651607127,78651607127,0,796,1719,0
78651961357,78651961357,0,930,1331,0
78653069703,78653069704,1,1113,1776,0
78654317118,78654317115,-3,1159,2491,0
78657187205,78657187203,-2,1088,2545,0
78658853027,78658853028,1,1476,1779,0
78661484700,78661484697,-3,1737,5068,0
78663372107,78663372110,3,2199,1585,0
78663727085,78663727077,-8,2167,6147,0
78672430607,78672430609,2,1582,1716,0
78673506645,78673506643,-2,1134,1742,0
78674217001,78674216999,-2,1661,2617,0
78676445696,78676445695,-1,1312,1805,0
78683235043,78683235043,0,1402,1530,0
78688144688,78688144687,-1,1320,1731,0
78689014871,78689014870,-1,1452,1490,0
78689698272,78689698271,-1,1939,3155,0
78690086986,78690086986,0,1638,1802,0
78691694965,78691694965,0,1271,1702,0
78702270662,78702270661,-1,1712,2665,0
78702445819,78702445818,-1,1376,1829,0
78703747572,78703747574,2,1071,1629,0
78705822396,78705822395,-1,981,2029,0
78710452526,78710452526,0,1207,1834,0
78714741278,78714741278,0,958,860,0
78718838841,78718838834,-7,5591,10808,0
78719758603,78719758602,-1,1840,1772,0
78719901614,78719901616,2,1054,1262,0
78722016807,78722016808,1,1042,1297,0
78723666690,78723666689,-1,1666,1591,0
78726956985,78726956990,5,1648,1246,0
78732039338,78732039338,0,1436,2798,0
78734325855,78734325855,0,1561,2073,0
78742635249,78742635247,-2,1295,1860,0
78742807276,78742807276,0,1011,2377,0
78743478478,78743478481,3,1557,1770,0
78743913972,78743913973,1,1221,1511,0
78747955930,78747955931,1,1392,1454,0
78751069073,78751069071,-2,1689,1680,0
78753535435,78753535435,0,1471,2039,0
78756467934,78756467935,1,1206,1777,0
78758645406,78758645407,1,1607,1674,0
78758996402,78758996402,0,1126,1588,0
78759568753,78759568756,3,1552,1325,0
78760600903,78760600902,-1,1528,1898,0
78762196253,78762196250,-3,1774,3164,0
78763893346,78763893346,0,1426,2114,0
78764089193,78764089193,0,1353,1896,0
78766528329,78766528329,0,1453,2037,0
78770959437,78770959435,-2,1164,1651,0
78774136559,78774136554,-5,1568,4927,0
78775904022,78775904025,3,1454,1893,0
78779609718,78779609721,3,1125,1520,0
78783836834,78783836833,-1,1213,2027,0
78785558970,78785558969,-1,1628,2508,0
78787302659,78787302660,1,1189,1381,0
78788372146,78788372146,0,1165,1264,0
78788866085,78788866085,0,1232,1666,0
78792146063,78792146063,0,657,1563,0
78794988605,78794988605,0,1221,1827,0
78798948282,78798948283,1,1623,2242,0
78799470591,78799470592,1,1977,2599,0
78804431073,78804431074,1,1353,1219,0
78805949877,78805949875,-2,1409,1534,0
78808114763,78808114763,0,1720,1871,0
78808510171,78808510165,-6,946,2655,0
78809163708,78809163729,21,1484,1729,0
78810949790,78810949790,0,1211,1569,0
78811356831,78811356825,-6,764,3056,0
78812581486,78812581486,0,1146,1556,0
78814664815,78814664816,1,830,860,0
78816567911,78816567913,2,1141,1559,0
78818590604,78818590612,8,245,1256,0
78821189155,78821189155,0,2135,1925,0
78822677841,78822677842,1,1396,2279,0
78823470676,78823470678,2,1090,1762,0
78827048609,78827048609,0,1783,1934,0
78828290022,78828290023,1,1280,1733,0
78828900802,78828900803,1,1329,1628,0
78832820326,78832820323,-3,1325,2675,0
78834215282,78834215282,0,1817,1880,0
78836240994,78836241006,12,2955,1501,0
78836620285,78836620286,1,1422,1282,0
78836736945,78836736952,7,11619,30205,0
78840717934,78840717934,0,1667,1907,0
78843612164,78843612166,2,2180,2325,0
78845135626,78845135629,3,1968,2475,0
78846294262,78846294262,0,1514,1599,0
78847222744,78847222743,-1,1875,1927,0
78847746340,78847746338,-2,1464,2245,0
78849408961,78849408964,3,981,1501,0
78850686694,78850686693,-1,1443,2159,0
78856286175,78856286175,0,788,712,0
78857245001,78857245003,2,1383,1866,0
78858299310,78858299311,1,1667,1498,0
78858798167,78858798162,-5,859,2692,0
78859282655,78859282658,3,1060,1517,0
78859980741,78859980742,1,1283,1462,0
78861201371,78861201370,-1,1171,1308,0
78862653997,78862653998,1,1718,1765,0
78865109147,78865109147,0,1708,1761,0
78865144307,78865144309,2,1118,1524,0
78866053825,78866053826,1,2278,1997,0
78870968647,78870968649,2,1844,2405,0
78878987279,78878987282,3,1786,1760,0
78879530940,78879530937,-3,1575,1689,0
78887229284,78887229280,-4,25118,16100,0
78887431639,78887431638,-1,1404,1982,0
78890612334,78890612333,-1,1271,1625,0
78892014311,78892014311,0,1496,1479,0
78893555042,78893555044,2,1423,2039,0
78894109286,78894109288,2,1251,1531,0
78895044301,78895044301,0,1738,2025,0
78895575245,78895575250,5,3318,1968,0
78898559158,78898559160,2,1525,2237,0
78910706991,78910706991,0,1610,1529,0
78910797069,78910797071,2,867,1016,0
78912091645,78912091647,2,1578,2072,0
78912834096,78912834096,0,1242,1309,0
78916489758,78916489758,0,1691,2247,0
78917639891,78917639891,0,1010,1889,0
78924396972,78924396966,-6,642,1730,0
78926349084,78926349085,1,1254,1659,0
78929675179,78929675179,0,1363,1818,0
78930194083,78930194082,-1,1701,2382,0
78931570338,78931570339,1,1847,2586,0
78932902942,78932902943,1,1199,1211,0
78935252510,78935252512,2,1645,2489,0
78935903511,78935903511,0,1441,1164,0
78936251389,78936251388,-1,1507,1550,0
78938285735,78938285734,-1,1448,2058,0
78938856772,78938856779,7,5049,1501,0
78943473037,78943473038,1,1611,2332,0
78948076157,78948076159,2,1566,2271,0
78951927508,78951927507,-1,2205,2629,0
78952014963,78952014965,2,1086,1447,0
78953593527,78953593529,2,1733,1501,0
78953679055,78953679054,-1,1610,1466,0
78959283897,78959283897,0,2762,3716,0
78972943926,78972943930,4,1556,2372,0
78974573924,78974573924,0,2032,2229,0
78979922130,78979922130,0,1798,2127,0
78980774177,78980774178,1,805,1319,0
78982215501,78982215502,1,1204,1252,0
78984016230,78984016230,0,1275,1454,0
78987559705,78987559706,1,1310,1818,0
78993799917,78993799918,1,2192,2369,0
78994335454,78994335454,0,1326,1103,0
78995542745,78995542745,0,1695,1657,0
79001360282,79001360282,0,1402,1707,0
79001821791,79001821791,0,1183,1944,0
79003617841,79003617842,1,1460,1589,0
79004886042,79004886043,1,1312,1479,0
79005731958,79005731960,2,710,1177,0
79006227565,79006227566,1,1226,2012,0
79006439600,79006439603,3,1029,867,0
79008024334,79008024334,0,1808,1783,0
79011208565,79011208566,1,1691,1790,0
79012344158,79012344161,3,1034,1529,0
79012373456,79012373455,-1,1233,1542,0
79013337467,79013337467,0,1325,1459,0
79017982666,79017982668,2,1435,2097,0
79019074186,79019074189,3,1372,1362,0
79019284714,79019284694,-20,1763,1739,0
79020958198,79020958198,0,1832,1589,0
79028299447,79028299446,-1,1033,1323,0
79028396623,79028396626,3,1196,1943,0
79030758238,79030758239,1,1452,1146,0
79035362618,79035362618,0,1730,1217,0
79039021962,79039021962,0,1522,1586,0
79039282061,79039282058,-3,1425,1940,0
79042396729,79042396730,1,1296,2123,0
79042824702,79042824704,2,1572,2128,0
79044019277,79044019278,1,1934,2025,0
79045775987,79045775987,0,924,1563,0
79046602102,79046602100,-2,2397,4499,0
79051671027,79051671027,0,1059,1527,0
79052370684,79052370685,1,1745,1997,0
79056577031,79056577030,-1,1017,2197,0
79059224734,79059224736,2,1175,1706,0
79059976313,79059976317,4,1456,1457,0
79060121158,79060121157,-1,780,907,0
79062278284,79062278285,1,1334,1066,0
79064540824,79064540825,1,1682,1409,0
79064880162,79064880158,-4,1218,4539,0
79066411497,79066411499,2,1805,2106,0
79067578963,79067578962,-1,1002,1301,0
79074268262,79074268265,3,1408,1455,0
79076475369,79076475373,4,2129,1595,0
79080803487,79080803485,-2,1688,2132,0
79082832519,79082832519,0,1234,1524,0
79087876211,79087876213,2,1436,1573,0
79088285010,79088285030,20,1400,1640,0
79089831025,79089831023,-2,2353,4349,0
79090142554,79090142560,6,1493,898,0
79090975014,79090975014,0,1656,1525,0
79092542358,79092542360,2,1301,2039,0
79096468745,79096468745,0,1370,1484,0
79100407387,79100407385,-2,1321,2280,0
79105474454,79105474458,4,1741,1596,0
79109877901,79109877897,-4,32285,14239,0
79110022165,79110022164,-1,1658,1876,0
79110563328,79110563328,0,1222,1298,0
79111264390,79111264407,17,2251,6609,0
79112972722,79112972721,-1,1918,1928,0
79113959343,79113959344,1,1542,1520,0
79115408478,79115408481,3,1156,1078,0
79116572849,79116572850,1,1666,1851,0
79118339422,79118339425,3,1194,1103,0
79119683605,79119683606,1,764,1184,0
79121054292,79121054293,1,1630,1521,0
79121330134,79121330133,-1,969,1446,0
79126035658,79126035659,1,1112,1528,0
79126775759,79126775761,2,1546,1050,0
79130439079,79130439080,1,1055,1403,0
79132669847,79132669848,1,817,1373,0
79133403611,79133403610,-1,1180,1469,0
79135751637,79135751637,0,1648,1510,0
79137185790,79137185791,1,1151,1597,0
79138250395,79138250401,6,2408,1177,0
79138504379,79138504381,2,1164,2173,0
79140672522,79140672525,3,1670,1217,0
79142057297,79142057299,2,1594,1509,0
79144451127,79144451133,6,1229,1282,0
79147042839,79147042840,1,1100,1599,0
79149316202,79149316203,1,1143,2452,0
79150009813,79150009805,-8,859,2575,0
79150641842,79150641842,0,1584,1928,0
79152655482,79152655482,0,2154,2849,0
79154498497,79154498496,-1,1708,1622,0
79161410216,79161410217,1,1951,1571,0
79162286838,79162286839,1,1691,1617,0
79162363333,79162363330,-3,1204,1990,0
79162901586,79162901587,1,1181,1561,0
79163379497,79163379499,2,3792,8428,0
79164073424,79164073405,-19,1252,1686,0
79164249080,79164249099,19,1700,2059,0
79166397442,79166397445,3,1085,1460,0
79168178010,79168178013,3,2096,1675,0
79170292474,79170292476,2,1302,1045,0
79171541762,79171541763,1,1150,1287,0
79174499762,79174499762,0,2168,2609,0
79176262985,79176263007,22,1754,964,0
79177466577,79177466577,0,1656,1792,0
79178620938,79178620937,-1,1355,1552,0
79182039995,79182039997,2,2009,2238,0
79187621766,79187621766,0,1104,1365,0
79192469913,79192469910,-3,927,2178,0
79193864218,79193864217,-1,1077,1643,0
79193956396,79193956390,-6,271,529,0
79195383275,79195383295,20,1622,1445,0
79201228795,79201228794,-1,828,1679,0
79202009026,79202009021,-5,1216,2770,0
79202846177,79202846178,1,1462,1518,0
79205891387,79205891386,-1,952,1514,0
79206990016,79206990015,-1,1289,1469,0
79207158743,79207158743,0,1198,1380,0
79207467839,79207467816,-23,1202,1810,0
79208449209,79208449211,2,1714,1981,0
79216490545,79216490542,-3,848,1281,0
79217532994,79217532993,-1,1055,1654,0
79218263371,79218263380,9,1304,1773,0
79218967301,79218967301,0,1205,1844,0
79220486465,79220486463,-2,1207,2071,0
79224953714,79224953711,-3,1962,1771,0
79225065593,79225065593,0,1686,1600,0
79225585381,79225585386,5,1488,1458,0
79226711895,79226711895,0,1241,1828,0
79230427526,79230427526,0,1792,1678,0
79232549028,79232549021,-7,1043,6018,0
79232998139,79232998140,1,1109,1323,0
79235617379,79235617380,1,1418,1630,0
79237011239,79237011238,-1,1265,1375,0
79238804005,79238804007,2,1988,1749,0
79238918632,79238918638,6,4460,1847,0
79239685057,79239685055,-2,710,1114,0
79241160994,79241160993,-1,1794,1361,0
79244514621,79244514621,0,1206,1077,0
79244991440,79244991443,3,1185,1365,0
79245677884,79245677882,-2,1254,1539,0
79248069056,79248069058,2,1423,1943,0
79248143859,79248143858,-1,1820,2143,0
79248506791,79248506795,4,1442,1677,0
79254193109,79254193108,-1,1152,2385,0
79256450491,79256450491,0,1121,2234,0
79257088499,79257088501,2,1049,1386,0
79257710517,79257710496,-21,595,839,0
79261685581,79261685582,1,1457,1621,0
79263354974,79263354977,3,1423,1616,0
79266786940,79266786941,1,2049,2207,0
79269920045,79269920046,1,1619,1602,0
79270767487,79270767486,-1,1568,1720,0
79271967613,79271967615,2,1061,1614,0
79275454583,79275454585,2,788,1278,0
79276902642,79276902641,-1,774,931,0
79278302205,79278302203,-2,1392,2105,0
79282190052,79282190050,-2,1101,1845,0
79282765651,79282765649,-2,1894,2494,0
79283298595,79283298597,2,1062,1406,0
79283710779,79283710781,2,1283,2001,0
79293120321,79293120325,4,1548,1693,0
79293469463,79293469463,0,1236,2106,0
79295632685,79295632687,2,1189,1255,0
79296346513,79296346512,-1,1059,1582,0
79296915660,79296915663,3,1690,1367,0
79298277111,79298277112,1,1133,1980,0
79302311438,79302311440,2,1784,1758,0
79306883829,79306883829,0,1260,1970,0
79307337670,79307337669,-1,1039,1144,0
79315098033,79315098034,1,1808,988,0
79316788412,79316788411,-1,933,1262,0
79317108147,79317108146,-1,1239,1354,0
79317150266,79317150266,0,1459,1987,0
79318510059,79318510054,-5,762,2269,0
79318709575,79318709575,0,1050,1584,0
79321428037,79321428038,1,1185,1791,0
79323321994,79323321995,1,1123,2261,0
79329775207,79329775206,-1,1407,1959,0
79333193863,79333193866,3,1690,1860,0
79334561570,79334561550,-20,1003,367,0
79336148629,79336148629,0,1225,1772,0
79336667802,79336667802,0,1057,1580,0
79338084856,79338084854,-2,1534,1520,0
79346819190,79346819191,1,1530,1519,0
79347226714,79347226715,1,1396,1074,0
79347579503,79347579484,-19,1064,1176,0
79348450713,79348450713,0,3699,3981,0
79353948949,79353948951,2,1075,1209,0
79354138582,79354138583,1,1128,2033,0
79354929902,79354929901,-1,1599,1927,0
79355677867,79355677866,-1,1356,2224,0
79357847446,79357847446,0,1503,2039,0
79358304190,79358304188,-2,1258,1619,0
79359353103,79359353103,0,1014,1444,0
79359863347,79359863346,-1,1430,1770,0
79360374299,79360374302,3,1579,1846,0
79360672918,79360672925,7,10917,33065,0
79362482320,79362482318,-2,1770,1497,0
79363593738,79363593740,2,2199,1598,0
79368204267,79368204269,2,1851,2268,0
79369625778,79369625775,-3,1173,2463,0
79370053153,79370053154,1,1304,1794,0
79374727539,79374727538,-1,1075,1608,0
79374850772,79374850770,-2,1155,1483,0
79381306273,79381306273,0,1487,1741,0
79382348051,79382348051,0,1481,2200,0
79384551704,79384551699,-5,1486,6631,0
79384636063,79384636062,-1,1449,2464,0
79387189941,79387189940,-1,1547,1383,0
79387326816,79387326818,2,1774,1596,0
79390128547,79390128546,-1,924,2239,0
79390508498,79390508500,2,2031,2238,0
79391802039,79391802037,-2,932,1753,0
79392257581,79392257571,-10,1071,1281,0
79393398882,79393398882,0,1564,1921,0
79397350114,79397350113,-1,1208,1576,0
79399194327,79399194327,0,963,1767,0
79402380693,79402380693,0,1479,1646,0
79403258297,79403258297,0,1306,1369,0
79407462180,79407462179,-1,1259,1387,0
79408310338,79408310343,5,1729,944,0
79408618453,79408618454,1,1082,1272,0
79410548417,79410548419,2,1570,1771,0
79412837662,79412837664,2,1278,1398,0
79417845406,79417845408,2,1653,1190,0
79424644250,79424644254,4,3632,3453,0
79429723575,79429723575,0,1066,1799,0
79429887962,79429887963,1,1713,1662,0
79434384024,79434384025,1,1175,1877,0
79434677957,79434677961,4,1473,1433,0
79436624997,79436624998,1,903,1152,0
79436743750,79436743750,0,1113,1193,0
79443394409,79443394407,-2,957,1712,0
79444631444,79444631445,1,1301,1868,0
79448540703,79448540703,0,1184,1464,0
79450360685,79450360690,5,5247,2672,0
79451549075,79451549077,2,1791,1838,0
79451939242,79451939240,-2,1365,2569,0
79454127332,79454127339,7,12542,3931,0
79460370712,79460370723,11,3036,1302,0
79463462677,79463462678,1,1247,1853,0
79465578537,79465578536,-1,1628,1756,0
79467828387,79467828387,0,1339,1107,0
79469514167,79469514165,-2,1313,1212,0
79473104414,79473104416,2,1365,1452,0
79481217930,79481217930,0,1650,1595,0
79482801182,79482801185,3,1039,2293,0
79482984921,79482984922,1,1477,1609,0
79483173629,79483173626,-3,1512,1731,0
79489652006,79489652006,0,1251,2169,0
79490075475,79490075475,0,1265,1632,0
79493628197,79493628201,4,2018,1614,0
79495279274,79495279274,0,1195,1261,0
79503872438,79503872440,2,1391,1745,0
79504222248,79504222249,1,1528,2018,0
79506335381,79506335382,1,1077,1265,0
79508276235,79508276237,2,1888,1711,0
79509565674,79509565674,0,1574,1274,0
79510987673,79510987674,1,1899,1235,0
79512097822,79512097822,0,1258,1160,0
79513311427,79513311427,0,1049,1074,0
79514986275,79514986277,2,1112,1430,0
79516271459,79516271469,10,663,232,0
79523225181,79523225182,1,2775,1866,0
79523252310,79523252309,-1,1162,2037,0
79524258541,79524258542,1,1380,1571,0
79529425114,79529425113,-1,1516,1987,0
79530504072,79530504071,-1,1117,1476,0
79535065585,79535065587,2,1627,1409,0
79535258456,79535258457,1,1609,1628,0
79537386675,79537386670,-5,1068,1856,0
79538005343,79538005343,0,1250,1267,0
79542482215,79542482218,3,1675,1780,0
79543025561,79543025562,1,1212,1043,0
79545430745,79545430745,0,1781,1530,0
79546465837,79546465830,-7,31584,15840,0
79551019702,79551019701,-1,1184,1740,0
79554599139,79554599145,6,1441,1124,0
79560143894,79560143900,6,11823,39485,0
79560609719,79560609719,0,1307,2265,0
79564640094,79564640093,-1,843,1300,0
79567011077,79567011088,11,9586,42678,0
79567648929,79567648927,-2,906,1789,0
79570286409,79570286410,1,1911,1687,0
79572819867,79572819862,-5,2126,2596,0
79576836817,79576836815,-2,1446,1670,0
79580097354,79580097355,1,1434,1489,0
79580890907,79580890911,4,3148,2057,0
79584310451,79584310450,-1,1216,2120,0
79584749409,79584749408,-1,1734,2121,0
79585786380,79585786380,0,1206,1262,0
79586271908,79586271907,-1,1526,2224,0
79588883355,79588883356,1,1647,2000,0
79591864275,79591864274,-1,1458,1752,0
79592160062,79592160063,1,1093,1487,0
79594082966,79594082966,0,1794,2472,0
79595331218,79595331218,0,1099,1774,0
79596558699,79596558699,0,1333,1981,0
79596621253,79596621253,0,1303,2547,0
79597745470,79597745470,0,1165,1607,0
79597806504,79597806505,1,1427,1459,0
79602401217,79602401217,0,1124,1422,0
79605045306,79605045313,7,1357,1597,0
79607785062,79607785074,12,1585,1004,0
79610506802,79610506802,0,1217,1412,0
79617558756,79617558762,6,6588,2520,0
79618567314,79618567317,3,1107,1694,0
79619860596,79619860597,1,1485,1768,0
79620176276,79620176276,0,1209,1551,0
79621538347,79621538350,3,1335,1090,0
79623240047,79623240046,-1,1455,1594,0
79623390579,79623390580,1,1967,2027,0
79626640030,79626640029,-1,1833,3709,0
79629200290,79629200291,1,1302,1136,0
79629603854,79629603855,1,1380,1954,0
79630272440,79630272438,-2,1268,2344,0
79631186888,79631186890,2,1389,1471,0
79632528500,79632528502,2,1286,1725,0
79634862953,79634862952,-1,2260,2520,0
79635326549,79635326550,1,1325,1475,0
79637917818,79637917819,1,1352,1815,0
79639540761,79639540763,2,1103,1422,0
79647306305,79647306301,-4,1532,2369,0
79647567209,79647567210,1,3659,3160,0
79648864372,79648864367,-5,1006,1692,0
79649236013,79649235994,-19,1141,1806,0
79649956872,79649956871,-1,1998,1666,0
79650958131,79650958130,-1,1482,2236,0
79655198174,79655198174,0,1176,1473,0
79656347811,79656347812,1,1379,1629,0
79656964469,79656964470,1,1481,1862,0
79657476697,79657476698,1,1510,1863,0
79659848019,79659848020,1,1845,2224,0
79665056650,79665056649,-1,1784,1991,0
79665857535,79665857533,-2,1773,2437,0
79667068193,79667068176,-17,1623,1566,0
79667676501,79667676502,1,1312,1937,0
79669516045,79669516045,0,1263,1750,0
79670611686,79670611687,1,11389,10031,0
79671205126,79671205127,1,1924,1652,0
79674389027,79674389033,6,4348,2395,0
79676358658,79676358657,-1,1343,1300,0
79678339458,79678339466,8,1173,1876,0
79679844087,79679844082,-5,1688,7296,0
79681483253,79681483253,0,1793,1666,0
79682158770,79682158766,-4,1144,1274,0
79682255651,79682255654,3,2161,1129,0
79686252007,79686252007,0,1238,1927,0
79686979628,79686979630,2,1334,2028,0
79688015430,79688015432,2,1280,1812,0
79690874285,79690874286,1,2012,1979,0
79691430006,79691430009,3,1494,1551,0
79694107070,79694107065,-5,1025,1428,0
79695227706,79695227706,0,1996,1160,0
79696776190,79696776190,0,1042,1382,0
79697015478,79697015493,15,1298,1758,0
79703534614,79703534614,0,1502,1593,0
79707356283,79707356282,-1,1885,2524,0
79707921663,79707921664,1,974,992,0
79708111965,79708111962,-3,1022,1965,0
79709864466,79709864469,3,4985,18215,0
79716691440,79716691447,7,4403,1272,0
79719128305,79719128306,1,1456,1500,0
79724528871,79724528871,0,1854,2103,0
79724575221,79724575222,1,2224,2433,0
79726195466,79726195470,4,3961,3358,0
79729277362,79729277362,0,1469,1540,0
79731134341,79731134344,3,1035,1362,0
79734056050,79734056051,1,1404,1459,0
79735500791,79735500792,1,1247,1390,0
79739844171,79739844173,2,1810,1329,0
79743238811,79743238815,4,1221,1269,0
79744690990,79744690990,0,1115,1456,0
79746213898,79746213897,-1,1122,1468,0
79748008125,79748008125,0,1058,1897,0
79749323640,79749323637,-3,1903,4763,0
79749654328,79749654328,0,1417,1872,0
79750809500,79750809502,2,941,1487,0
79752275919,79752275919,0,1031,1569,0
79753284162,79753284161,-1,1114,1024,0
79757636308,79757636307,-1,1165,1184,0
79759261491,79759261492,1,1334,1624,0
79760364321,79760364316,-5,1144,4003,0
79766923436,79766923437,1,876,1792,0
79768945373,79768945374,1,1274,1437,0
79772540989,79772540987,-2,918,1553,0
79772816070,79772816070,0,1273,1334,0
79773076760,79773076761,1,1825,1424,0
79776910144,79776910141,-3,839,1208,0
79782077766,79782077767,1,1236,1518,0
79783625187,79783625187,0,1773,2130,0
79784151515,79784151517,2,1234,1424,0
79786183251,79786183250,-1,1598,1545,0
79786880392,79786880390,-2,1180,1672,0
79790300979,79790300981,2,1000,1259,0
79794676020,79794676019,-1,1406,2072,0
79798611041,79798611042,1,1413,1417,0
79799924221,79799924221,0,1325,1630,0
79801892176,79801892177,1,1718,2360,0
79803050714,79803050713,-1,1261,1186,0
79805729442,79805729443,1,1214,1966,0
79806621209,79806621210,1,1218,1830,0
79808204749,79808204750,1,1564,1707,0
79808908020,79808908022,2,1382,1405,0
79809518367,79809518366,-1,1184,1302,0
79811001040,79811001041,1,1071,1200,0
79812568062,79812568063,1,1333,1643,0
79815516991,79815516990,-1,1421,2222,0
79815892106,79815892106,0,1707,1807,0
79816038546,79816038546,0,879,1654,0
79816922670,79816922670,0,1334,2187,0
79817828638,79817828640,2,1357,1146,0
79818494806,79818494808,2,1100,1851,0
79822178786,79822178769,-17,2609,1477,0
79822459551,79822459551,0,1310,1476,0
79827809042,79827809043,1,1515,2003,0
79829070747,79829070749,2,1437,1969,0
79832378806,79832378787,-19,2224,1503,0
79832623619,79832623621,2,1665,1473,0
79833728086,79833728085,-1,702,1181,0
79835532578,79835532578,0,1677,2205,0
79836963778,79836963779,1,1854,1949,0
79840949998,79840950000,2,1255,2599,0
79842356002,79842356001,-1,1704,1688,0
79844014067,79844014070,3,1587,2106,0
79844498221,79844498235,14,12081,31755,0
79849841415,79849841417,2,782,1601,0
79851640229,79851640222,-7,1560,4824,0
79860492673,79860492673,0,1498,1764,0
79860664248,79860664234,-14,1095,1708,0
79861344829,79861344829,0,2344,2279,0
79862576422,79862576422,0,974,1483,0
79864440698,79864440697,-1,1805,1336,0
79868880430,79868880432,2,1553,1689,0
79869901450,79869901451,1,1209,1967,0
79870098808,79870098809,1,1769,1948,0
79870605098,79870605099,1,1109,1187,0
79870632306,79870632312,6,10648,22617,0
79871743347,79871743354,7,2922,1252,0
79872543877,79872543877,0,1529,2799,0
79877009545,79877009546,1,958,1706,0
79877392927,79877392929,2,6256,6908,0
79880603805,79880603804,-1,1216,1085,0
79882445129,79882445130,1,896,1570,0
79883329522,79883329522,0,1830,2204,0
79884572695,79884572695,0,872,1541,0
79887095712,79887095715,3,943,1400,0
79887975366,79887975366,0,1065,1393,0
79889381523,79889381540,17,937,898,0
79894481964,79894481965,1,1769,1350,0
79894631671,79894631674,3,1742,2197,0
79896639681,79896639681,0,1310,1643,0
79897304097,79897304097,0,951,1621,0
79898541047,79898541046,-1,943,1538,0
79898818533,79898818533,0,1068,1469,0
79900574632,79900574650,18,719,2905,0
79900953775,79900953775,0,1179,1566,0
79902408153,79902408154,1,1839,1111,0
79904755156,79904755154,-2,884,1472,0
79913988770,79913988771,1,1075,1386,0
79917625587,79917625589,2,1197,1534,0
79926037794,79926037794,0,1406,1833,0
79927202102,79927202102,0,1178,1453,0
79928125064,79928125064,0,1260,1487,0
79932503629,79932503626,-3,1911,2538,0
79934717274,79934717276,2,2193,2040,0
79937085518,79937085519,1,1707,1111,0
79941235758,79941235759,1,1414,1438,0
79942321198,79942321200,2,1082,1671,0
79942921857,79942921856,-1,632,1852,0
79947318357,79947318358,1,1469,1418,0
79947466408,79947466407,-1,1481,2044,0
79950952503,79950952503,0,1684,2037,0
79953032922,79953032922,0,1446,1348,0
79957153959,79957153961,2,1359,1821,0
79958480623,79958480624,1,1172,1410,0
79963480539,79963480541,2,1410,1780,0
79964319334,79964319333,-1,1368,1212,0
79966630114,79966630114,0,1541,2414,0
79970934437,79970934438,1,1598,1294,0
79972539291,79972539290,-1,794,1294,0
79977302785,79977302782,-3,1241,1609,0
79988401297,79988401305,8,8495,2166,0
79988614741,79988614742,1,2058,1744,0
79989492294,79989492294,0,891,954,0
79993546267,79993546266,-1,1150,1164,0
79994261227,79994261227,0,802,1500,0
79994413834,79994413834,0,1076,1864,0
79994650793,79994650793,0,1606,2122,0
79997664129,79997664130,1,1741,1303,0
79998859284,79998859283,-1,1184,2121,0
80001454485,80001454498,13,13043,38453,0
80001983811,80001983815,4,2045,2009,0
80004884874,80004884873,-1,1790,2712,0
80012590851,80012590850,-1,1214,1196,0
80015785189,80015785191,2,1946,1712,0
80018889023,80018889025,2,1253,1908,0
80019445151,80019445159,8,1428,1223,0
80020783953,80020783956,3,696,1106,0
80022054241,80022054245,4,2540,1733,0
80023424222,80023424217,-5,1936,6241,0
80023763878,80023763893,15,1494,1510,0
80023874915,80023874895,-20,1087,1635,0
80023921858,80023921857,-1,1754,1895,0
80024109561,80024109564,3,1836,1763,0
80026585033,80026585034,1,1415,1696,0
80027769741,80027769741,0,2235,2339,0
80028932922,80028932917,-5,902,1257,0
80029553808,80029553806,-2,1362,1719,0
80031564763,80031564763,0,1820,2103,0
80036307831,80036307835,4,1143,1193,0
80036825052,80036825045,-7,230,316,0
80037392669,80037392687,18,1582,1719,0
80042639834,80042639833,-1,1258,1978,0
80043590794,80043590793,-1,1352,1775,0
80045242993,80045242988,-5,1816,8575,0
80046048602,80046048602,0,1570,1803,0
80046917711,80046917710,-1,962,2031,0
80047625441,80047625440,-1,1097,1350,0
80047859469,80047859469,0,1171,1326,0
80048996697,80048996698,1,1425,1464,0
80059973115,80059973114,-1,1169,2212,0
80060343506,80060343506,0,1111,1298,0
80060894966,80060894966,0,956,1223,0
80062306039,80062306039,0,1227,1724,0
80063540995,80063540997,2,1024,1125,0
80070976372,80070976373,1,1430,1415,0
80077539290,80077539293,3,1470,1563,0
80077903726,80077903730,4,1527,1335,0
80078373688,80078373690,2,1853,1887,0
80082511567,80082511570,3,1829,2158,0
80087726756,80087726756,0,1417,1670,0
80089013642,80089013640,-2,1211,2340,0
80093698558,80093698579,21,1063,1229,0
80096307382,80096307382,0,1765,2471,0
80100213230,80100213231,1,1373,1632,0
80101775772,80101775772,0,1186,1623,0
80106074036,80106074037,1,1336,1676,0
80106153610,80106153610,0,1143,1894,0
80106695269,80106695269,0,1497,2106,0
80108385071,80108385071,0,1067,1275,0
80109062995,80109062975,-20,1574,1385,0
80110850025,80110850027,2,1674,1723,0
80113096448,80113096443,-5,1651,1565,0
80118685066,80118685064,-2,2003,3024,0
80121003902,80121003895,-7,1019,4527,0
80121397911,80121397914,3,1561,2050,0
80122054017,80122054017,0,970,1296,0
80123089911,80123089914,3,1152,1763,0
80123768254,80123768259,5,2009,1656,0
80130492274,80130492278,4,2091,1143,0
80130539522,80130539524,2,1538,1401,0
80131111581,80131111577,-4,4044,7209,0
80131683029,80131683031,2,1248,1555,0
80137034091,80137034089,-2,854,1977,0
80140861494,80140861501,7,3662,1600,0
80143643053,80143643052,-1,1201,1448,0
80146621791,80146621791,0,2046,2124,0
80148449991,80148449994,3,1432,1167,0
80148823646,80148823646,0,11373,12011,0
80149044358,80149044358,0,1503,1608,0
80151493371,80151493370,-1,830,1844,0
80152424563,80152424562,-1,1542,2306,0
80153385211,80153385211,0,1054,1386,0
80153702035,80153702023,-12,1070,486,0
80154606423,80154606419,-4,1066,3701,0
80155081545,80155081545,0,1358,1381,0
80155838126,80155838113,-13,1109,2286,0
80156720924,80156720925,1,1597,1966,0
80158219376,80158219375,-1,1953,2272,0
80158835773,80158835774,1,1378,1803,0
80158989627,80158989626,-1,1230,1727,0
80159860433,80159860434,1,1167,1525,0
80162733750,80162733751,1,1658,1791,0
80164014478,80164014478,0,987,1500,0
80164551663,80164551664,1,1713,1665,0
80165481802,80165481807,5,48221,26683,0
80166291770,80166291771,1,1714,1723,0
80171669135,80171669136,1,1377,1680,0
80172152186,80172152187,1,1225,2013,0
80175394818,80175394818,0,1925,2414,0
80176653342,80176653342,0,1223,1772,0
80180055078,80180055090,12,16042,21946,0
80182313069,80182313058,-11,1081,1767,0
80182501983,80182501985,2,1704,1960,0
80182731703,80182731702,-1,1520,1305,0
80186605342,80186605339,-3,1036,1818,0
80187634158,80187634159,1,1588,1701,0
80189150019,80189150019,0,1438,1577,0
80189906573,80189906574,1,1182,1515,0
80202052084,80202052083,-1,1225,1114,0
80204576622,80204576631,9,1033,774,0
80209041977,80209041978,1,1300,1871,0
80210169913,80210169914,1,1534,1498,0
80210444783,80210444784,1,905,1540,0
80213077357,80213077358,1,1866,1867,0
80213671855,80213671854,-1,1601,1965,0
80215727532,80215727531,-1,1265,1653,0
80216481125,80216481126,1,1169,1623,0
80216707493,80216707492,-1,1413,1801,0
80221252902,80221252902,0,1825,2327,0
80221425746,80221425748,2,1564,1539,0
80222636276,80222636276,0,1583,1956,0
80223861082,80223861084,2,1961,2070,0
80232216521,80232216520,-1,1650,1443,0
80233480297,80233480297,0,1267,1476,0
80236948562,80236948562,0,1531,1465,0
80240686790,80240686790,0,1075,1338,0
80242574826,80242574825,-1,1634,1989,0
80244961461,80244961462,1,1103,1134,0
80247542106,80247542107,1,1210,1454,0
80248889461,80248889466,5,1516,933,0
80250295332,80250295332,0,1687,1892,0
80250435443,80250435446,3,1830,1848,0
80252945397,80252945396,-1,1431,1702,0
80253120489,80253120491,2,1651,1709,0
80255425722,80255425723,1,1277,1931,0
80256194598,80256194602,4,1103,1096,0
80258180805,80258180806,1,1283,1545,0
80259906874,80259906875,1,1076,1439,0
80260044124,80260044107,-17,1182,1605,0
80262242360,80262242362,2,1516,1340,0
80266100798,80266100779,-19,928,1428,0
80267458127,80267458132,5,4331,2392,0
80267823485,80267823487,2,1367,2208,0
80272158261,80272158261,0,1477,1986,0
80272475218,80272475214,-4,1002,2373,0
80275180448,80275180449,1,1831,1657,0
80275314601,80275314599,-2,1036,1167,0
80275771945,80275771941,-4,1289,4039,0
80276304351,80276304351,0,977,1385,0
80276706129,80276706125,-4,919,1331,0
80277246769,80277246769,0,1452,1762,0
80281014217,80281014213,-4,1474,6809,0
80283679756,80283679757,1,2420,2473,0
80286678515,80286678517,2,1388,1722,0
80289679153,80289679159,6,2807,1239,0
80294483685,80294483685,0,1246,1642,0
80295417347,80295417346,-1,941,1482,0
80297213262,80297213263,1,1343,1458,0
80297258811,80297258811,0,1084,1807,0
80301045726,80301045726,0,1273,1591,0
80301229919,80301229918,-1,1548,1651,0
80303520785,80303520786,1,1239,1327,0
80305586931,80305586934,3,1000,1163,0
80306655992,80306655991,-1,1696,1802,0
80310092687,80310092691,4,2042,1374,0
80310898891,80310898892,1,1398,1916,0
80313187054,80313187054,0,1163,1124,0
80315514106,80315514107,1,1643,2091,0
80315667250,80315667250,0,1503,1647,0
80316450202,80316450203,1,1198,1743,0
80317007213,80317007219,6,11489,5841,0
80319663161,80319663161,0,1262,1704,0
80319983993,80319983993,0,1507,1944,0
80321293178,80321293174,-4,523,2306,0
80331547796,80331547803,7,2883,1653,0
80331806796,80331806795,-1,1488,1828,0
80332173878,80332173863,-15,305,1098,0
80338237099,80338237100,1,1141,1751,0
80344644770,80344644773,3,1557,1841,0
80345058319,80345058319,0,1428,1716,0
80347619519,80347619523,4,2850,2155,0
80347753640,80347753639,-1,995,1527,0
80349486034,80349486035,1,1167,1458,0
80352464646,80352464645,-1,1279,1856,0
80353046262,80353046261,-1,763,1526,0
80354223548,80354223549,1,1095,1495,0
80358691327,80358691327,0,1679,1741,0
80359331389,80359331395,6,2847,1722,0
80360850452,80360850454,2,3502,3275,0
80361051194,80361051194,0,1170,1077,0
80362068586,80362068581,-5,984,3801,0
80363322868,80363322869,1,1541,1753,0
80365739381,80365739382,1,1469,1833,0
80369831796,80369831794,-2,2276,1835,0
80370138528,80370138530,2,1645,1906,0
80372904817,80372904818,1,1276,1763,0
80378504574,80378504574,0,1095,1749,0
80383376547,80383376548,1,1331,1811,0
80385487475,80385487475,0,1108,1644,0
80386631649,80386631649,0,1963,2035,0
80387425855,80387425854,-1,1059,1332,0
80389037886,80389037885,-1,1374,1421,0
80389626701,80389626701,0,1465,1700,0
80392737941,80392737943,2,1699,1804,0
80394394219,80394394218,-1,704,1055,0
80396186913,80396186909,-4,1206,3678,0
80396549528,80396549528,0,1648,2032,0
80396855008,80396855009,1,1219,1489,0
80399757137,80399757137,0,1603,1873,0
80401218239,80401218239,0,2061,2127,0
80403082708,80403082707,-1,1158,1439,0
80404463326,80404463326,0,1424,1739,0
80406248870,80406248871,1,1310,1412,0
80407183490,80407183491,1,1941,2447,0
80409024370,80409024369,-1,1459,2424,0
80410136009,80410136010,1,1353,1550,0
80412712856,80412712855,-1,1437,1319,0
80413966983,80413966983,0,828,1605,0
80414309355,80414309357,2,1383,1552,0
80414549429,80414549431,2,1451,1873,0
80414825423,80414825424,1,1719,1829,0
80416982778,80416982785,7,4628,1793,0
80419158380,80419158378,-2,966,1199,0
80420083085,80420083084,-1,9428,15533,0
80424483896,80424483897,1,2193,1429,0
80429584483,80429584482,-1,1128,1022,0
80431976081,80431976083,2,1455,1849,0
80432953793,80432953794,1,1425,1735,0
80436559589,80436559589,0,1188,1375,0
80440200876,80440200877,1,1391,1829,0
80441472402,80441472401,-1,1771,2154,0
80441565972,80441565953,-19,1348,1927,0
80442853141,80442853143,2,1799,1969,0
80444989242,80444989241,-1,1099,2024,0
80445302127,80445302125,-2,1140,2612,0
80446867826,80446867827,1,1714,1784,0
80450737631,80450737630,-1,1458,1612,0
80451808963,80451808970,7,12534,25767,0
80453692682,80453692682,0,1327,1391,0
80456444058,80456444058,0,1213,1807,0
80458138080,80458138077,-3,1422,2107,0
80458216550,80458216549,-1,1115,1268,0
80458471046,80458471047,1,15443,6950,0
80466228491,80466228492,1,1523,1358,0
80467751178,80467751177,-1,719,1585,0
80469680251,80469680251,0,1559,1555,0
80472260487,80472260484,-3,3614,6859,0
80472306698,80472306698,0,1409,2197,0
80472875997,80472876006,9,272,673,0
80477639810,80477639807,-3,2651,6164,0
80479223418,80479223422,4,1430,1430,0
80479271148,80479271149,1,1726,1942,0
80482328441,80482328442,1,1241,1897,0
80482580271,80482580275,4,1102,1312,0
80484687155,80484687157,2,1143,1998,0
80485124366,80485124363,-3,1971,2432,0
80485961651,80485961653,2,1052,1235,0
80486890030,80486890032,2,1325,1576,0
80492463574,80492463577,3,1248,1372,0
80494284511,80494284514,3,941,1164,0
80498261393,80498261377,-16,1368,1568,0
80498696302,80498696304,2,1061,1560,0
80498885766,80498885766,0,1281,1684,0
80501136872,80501136872,0,1746,1803,0
80507940638,80507940637,-1,1491,1597,0
80510651097,80510651098,1,1402,1463,0
80512915041,80512915042,1,1505,2343,0
80515387183,80515387181,-2,1414,1472,0
80516375946,80516375943,-3,1080,1775,0
80516411916,80516411925,9,213,867,0
80518654974,80518654976,2,1148,1719,0
80526288779,80526288781,2,726,1510,0
80526652454,80526652456,2,1093,1721,0
80527104055,80527104055,0,1379,2092,0
80531455713,80531455714,1,3259,3636,0
80532481131,80532481132,1,1651,1361,0
80533004438,80533004437,-1,1511,1635,0
80535240070,80535240070,0,939,1620,0
80535689969,80535689970,1,1392,1948,0
80536111781,80536111787,6,16993,5933,0
80536431439,80536431440,1,1461,1033,0
80539632978,80539632981,3,2095,2147,0
80539908309,80539908310,1,2009,1824,0
80540499921,80540499918,-3,1086,1546,0
80541480918,80541480918,0,1134,1722,0
80542722882,80542722861,-21,2509,1136,0
80548395447,80548395440,-7,979,4080,0
80549305415,80549305417,2,2127,1705,0
80550863022,80550863023,1,1301,1675,0
80554747838,80554747838,0,1129,1937,0
80559658743,80559658743,0,1750,1284,0
80561485666,80561485665,-1,1288,1334,0
80564287845,80564287857,12,759,1226,0
80568045844,80568045845,1,1120,1188,0
80570370145,80570370146,1,1262,1698,0
80575888297,80575888280,-17,2112,1760,0
80576629586,80576629585,-1,1583,1858,0
80580136741,80580136740,-1,1257,1262,0
80581849870,80581849869,-1,1964,2276,0
80586623155,80586623155,0,1143,1119,0
80586964269,80586964269,0,982,1923,0
80588592846,80588592847,1,1439,1762,0
80593279766,80593279766,0,1505,1626,0
80596368947,80596368943,-4,715,1545,0
80596463839,80596463818,-21,7,1437,0
80603067444,80603067445,1,1348,1464,0
80603800837,80603800838,1,1574,1126,0
80606640242,80606640243,1,1279,1060,0
80608752587,80608752587,0,1628,1589,0
80613901802,80613901801,-1,1158,1837,0
80614047172,80614047172,0,1203,1808,0
80615626721,80615626717,-4,1862,6561,0
80620878576,80620878580,4,2309,2056,0
80620939685,80620939687,2,1677,2392,0
80621662526,80621662526,0,1884,2239,0
80623186923,80623186922,-1,1199,1500,0
80625287192,80625287197,5,2017,1525,0
80625532605,80625532606,1,1350,1371,0
80625612000,80625612009,9,20438,34974,0
80627813807,80627813806,-1,1107,2000,0
80630967667,80630967667,0,1619,1791,0
80633685926,80633685927,1,1153,1918,0
80636612438,80636612440,2,1699,1944,0
80638499953,80638499955,2,1636,1223,0
80647188802,80647188801,-1,1277,2094,0
80647380539,80647380537,-2,1213,1361,0
80650586206,80650586206,0,910,1549,0
80655043734,80655043733,-1,832,1620,0
80657391379,80657391378,-1,1277,1503,0
80658057413,80658057414,1,2107,2561,0
80658162081,80658162083,2,1387,2212,0
80662460615,80662460615,0,1479,1439,0
80663761807,80663761806,-1,1297,1740,0
80664786803,80664786804,1,1540,1650,0
80665527901,80665527902,1,1068,1846,0
80666545590,80666545591,1,1434,1576,0
80667260883,80667260882,-1,1859,1815,0
80668518162,80668518157,-5,1443,4217,0
80674167283,80674167281,-2,955,1643,0
80674439413,80674439411,-2,1494,1885,0
80679369714,80679369729,15,778,1245,0
80682291325,80682291326,1,1538,1882,0
80684114838,80684114842,4,2024,1160,0
80694166183,80694166181,-2,1071,1224,0
80697610327,80697610327,0,1336,1053,0
80699099889,80699099890,1,1266,1851,0
80699650890,80699650889,-1,1401,2530,0
80701125046,80701125046,0,1537,1713,0
80703093009,80703093010,1,1443,1998,0
80703986249,80703986251,2,2097,1882,0
80705222243,80705222246,3,2179,1917,0
80707054098,80707054098,0,1390,1690,0
80709623314,80709623315,1,1121,1292,0
80710233762,80710233762,0,1786,2031,0
80715461658,80715461658,0,1394,2142,0
80716412269,80716412271,2,1425,1566,0
80716700055,80716700043,-12,76,1037,0
80719025642,80719025642,0,1312,1172,0
80719464329,80719464329,0,1219,1157,0
80721034094,80721034094,0,1549,2145,0
80721341337,80721341338,1,1336,1563,0
80723075097,80723075099,2,1102,1527,0
80728457559,80728457561,2,1596,2548,0
80728743241,80728743242,1,839,953,0
80729904663,80729904658,-5,581,1986,0
80734504732,80734504734,2,1041,1447,0
80735951766,80735951766,0,1092,1502,0
80737493853,80737493850,-3,971,1484,0
80737556423,80737556443,20,819,1899,0
80737935526,80737935526,0,994,1401,0
80738970538,80738970542,4,2270,1339,0
80742052192,80742052190,-2,1068,1890,0
80744288991,80744288991,0,1708,2387,0
80744686031,80744686031,0,1178,1806,0
80745063750,80745063750,0,1372,1913,0
80745207081,80745207081,0,1947,1407,0
80748561548,80748561547,-1,1510,1673,0
80748882222,80748882224,2,1412,1488,0
80749201035,80749201013,-22,1384,2276,0
80749556937,80749556938,1,1323,1294,0
80750131175,80750131174,-1,1144,1637,0
80754561493,80754561494,1,7429,9062,0
80755029917,80755029916,-1,1759,2320,0
80757015852,80757015858,6,3718,1505,0
80758973279,80758973279,0,1586,1560,0
80761970442,80761970439,-3,1419,2165,0
80762788494,80762788502,8,5680,2327,0
80765348633,80765348634,1,1776,1928,0
80767468101,80767468103,2,1149,1204,0
80768791282,80768791282,0,1527,1717,0
80769931262,80769931263,1,1203,2093,0
80772127934,80772127934,0,1669,1916,0
80776788523,80776788543,20,1112,1423,0
80777854655,80777854654,-1,1509,1500,0
80780698354,80780698354,0,1358,1773,0
80784600797,80784600796,-1,1188,1885,0
80792598182,80792598185,3,1281,2158,0
80795810597,80795810597,0,1131,1304,0
80797713593,80797713592,-1,1878,987,0
80801097490,80801097486,-4,924,2639,0
80809244119,80809244138,19,917,1697,0
80810081497,80810081500,3,1334,1463,0
80817187522,80817187523,1,1709,1576,0
80817447297,80817447298,1,1641,1637,0
80818043659,80818043660,1,1092,1958,0
80818595373,80818595376,3,1845,2045,0
80819671159,80819671158,-1,997,1703,0
80819908664,80819908663,-1,1343,2552,0
80820024471,80820024470,-1,1100,1109,0
80820373334,80820373335,1,1057,1597,0
80823089709,80823089710,1,760,960,0
80831531327,80831531325,-2,1366,1711,0
80831870355,80831870358,3,1222,1368,0
80837760025,80837760026,1,2173,2560,0
80839124714,80839124714,0,766,1127,0
80840543516,80840543513,-3,1059,1816,0
80842015178,80842015177,-1,1125,1880,0
80844214237,80844214237,0,1956,1955,0
80844407450,80844407452,2,1298,986,0
80844921401,80844921413,12,1092,999,0
80849428839,80849428838,-1,1199,1424,0
80851372036,80851372037,1,1410,1749,0
80852410226,80852410225,-1,1904,2164,0
80856022572,80856022571,-1,1350,1741,0
80857708982,80857708984,2,1683,1506,0
80861776446,80861776447,1,1044,1838,0
80869860158,80869860159,1,1964,2216,0
80871315568,80871315568,0,1960,2134,0
80871701909,80871701910,1,1150,1639,0
80874870396,80874870398,2,1330,1164,0
80875082649,80875082651,2,1228,1494,0
80875627907,80875627919,12,12429,40915,0
80876306047,80876306047,0,1341,2078,0
80877160273,80877160275,2,1343,1912,0
80880756222,80880756223,1,1116,1479,0
80882663442,80882663445,3,1146,1070,0
80884178350,80884178354,4,2414,1415,0
80885641599,80885641600,1,1408,1685,0
80888064625,80888064625,0,1711,1999,0
80889702909,80889702906,-3,2346,4557,0
80891328930,80891328933,3,2037,1326,0
80893551034,80893551036,2,1528,1670,0
80896865612,80896865613,1,1494,1564,0
80899624147,80899624147,0,1718,1754,0
80903778474,80903778472,-2,1395,1816,0
80904399668,80904399671,3,524,940,0
80906030453,80906030455,2,2728,1596,0
80911534934,80911534934,0,1162,1488,0
80913284223,80913284225,2,1603,1352,0
80913715923,80913715920,-3,1288,4128,0
80914000051,80914000054,3,1482,1981,0
80915679546,80915679546,0,1105,1574,0
80920353778,80920353778,0,1459,1760,0
80922623161,80922623158,-3,1033,1482,0
80929493341,80929493348,7,5225,1973,0
80931287868,80931287868,0,1463,2001,0
80931813109,80931813127,18,592,1848,0
80933191425,80933191425,0,1573,1529,0
80933223636,80933223652,16,1018,1115,0
80935070847,80935070848,1,1261,1733,0
80938309193,80938309190,-3,6401,11644,0
80939530170,80939530174,4,1810,1411,0
80943956473,80943956473,0,893,1478,0
80946713957,80946713958,1,1460,1346,0
80948706171,80948706172,1,1325,1526,0
80949754627,80949754622,-5,1266,2956,0
80950395475,80950395474,-1,1417,1825,0
80952892780,80952892781,1,1314,1214,0
80956970906,80956970906,0,1435,2006,0
80963442870,80963442871,1,1524,1713,0
80963473185,80963473182,-3,2084,6249,0
80966983317,80966983318,1,1284,1528,0
80967031210,80967031205,-5,2916,13163,0
80967376775,80967376774,-1,971,1389,0
80968224824,80968224824,0,1628,1939,0
80969490319,80969490318,-1,1161,1589,0
80971366921,80971366923,2,1135,1772,0
80974407877,80974407882,5,3111,1722,0
80980562370,80980562370,0,1266,1425,0
80981957277,80981957278,1,996,1608,0
80985723323,80985723323,0,1366,1928,0
80986322014,80986322015,1,1188,1770,0
80987381985,80987381985,0,1879,2307,0
80989506483,80989506482,-1,1066,1410,0
80990286970,80990286971,1,699,835,0
80995606346,80995606345,-1,964,1691,0
80996576946,80996576938,-8,1378,4615,0
80999902317,80999902298,-19,1250,2273,0
81002247194,81002247192,-2,1205,1180,0
81003079639,81003079641,2,1161,1488,0
81003168680,81003168679,-1,1254,1597,0
81004443021,81004443022,1,1458,1738,0
81005651567,81005651565,-2,885,2540,0
81012833442,81012833448,6,1952,910,0
81014815891,81014815892,1,1519,1639,0
81014907040,81014907063,23,1592,1614,0
81018272962,81018272962,0,1105,1060,0
81021455137,81021455125,-12,36713,13330,0
81021896166,81021896168,2,1176,1367,0
81022584939,81022584918,-21,1504,911,0
81027409039,81027409040,1,1745,1949,0
81029330278,81029330274,-4,1534,3805,0
81031514749,81031514749,0,1407,2064,0
81034573195,81034573197,2,941,1476,0
81037418200,81037418200,0,1112,2181,0
81038957198,81038957198,0,1141,2200,0
81039279399,81039279417,18,1173,1662,0
81039544281,81039544286,5,2166,1483,0
81041596719,81041596720,1,1447,2127,0
81046848663,81046848663,0,1523,1461,0
81048188787,81048188790,3,1388,1350,0
81048446269,81048446269,0,1397,1897,0
81051422205,81051422204,-1,1215,1474,0
81052023766,81052023771,5,3626,1919,0
81054024446,81054024447,1,1120,1912,0
81054623042,81054623047,5,1059,511,0
81055019737,81055019736,-1,744,1825,0
81055320402,81055320403,1,822,978,0
81059267117,81059267117,0,1238,2328,0
81059342599,81059342595,-4,1137,1437,0
81059525203,81059525203,0,1401,1773,0
81061155706,81061155716,10,1763,1726,0
81070713713,81070713714,1,1288,1347,0
81070810758,81070810761,3,1551,1461,0
81071455113,81071455113,0,1778,1909,0
81071930816,81071930796,-20,44,894,0
81073486646,81073486646,0,1713,1124,0
81073888338,81073888338,0,1276,1423,0
81074684446,81074684447,1,1712,1669,0
81079476175,81079476174,-1,1132,2330,0
81082415562,81082415566,4,1092,1318,0
81084512397,81084512394,-3,1028,1538,0
81085026438,81085026439,1,1337,1406,0
81085213480,81085213480,0,1491,1249,0
81089465969,81089465967,-2,2532,2613,0
81093920181,81093920182,1,1354,1813,0
81102048856,81102048858,2,1741,2215,0
81103872626,81103872621,-5,1094,4882,0
81108685627,81108685642,15,940,1481,0
81109411711,81109411710,-1,811,1135,0
81110524989,81110524989,0,1918,1081,0
81111563717,81111563719,2,1610,1073,0
81113929773,81113929774,1,1515,1557,0
81115553041,81115553040,-1,1218,2032,0
81116100053,81116100053,0,5584,20342,0
81117088752,81117088752,0,1301,1721,0
81121366151,81121366151,0,1285,1313,0
81121809984,81121809986,2,1536,2125,0
81122019716,81122019717,1,1325,1278,0
81122613542,81122613540,-2,1207,2292,0
81122766629,81122766612,-17,39665,15458,0
81124387670,81124387670,0,1126,1616,0
81126919333,81126919338,5,3022,2209,0
81127972463,81127972462,-1,1735,1481,0
81128017807,81128017807,0,1487,2159,0
81129337738,81129337741,3,1636,1814,0
81130328518,81130328518,0,1271,1607,0
81131116797,81131116782,-15,1334,2325,0
81131273982,81131273983,1,1500,2525,0
81133094730,81133094732,2,1759,2071,0
81133259854,81133259855,1,1173,1406,0
81134523686,81134523687,1,1144,1827,0
81136618901,81136618898,-3,1083,2470,0
81136656501,81136656501,0,1524,1464,0
81138835213,81138835211,-2,1785,2308,0
81139606008,81139606010,2,16227,16037,0
81142683133,81142683133,0,1138,1693,0
81144283751,81144283751,0,1242,1349,0
81145321133,81145321133,0,1464,2437,0
81148162782,81148162782,0,1716,2477,0
81148223954,81148223951,-3,1193,1766,0
81150873602,81150873601,-1,1062,1694,0
81156291892,81156291898,6,4025,1500,0
81158206943,81158206942,-1,1441,1794,0
81158977261,81158977263,2,1271,2514,0
81159459366,81159459367,1,1067,1907,0
81160630501,81160630502,1,1383,1895,0
81163075971,81163075974,3,1270,1688,0
81170504018,81170504017,-1,1010,1763,0
81170967601,81170967601,0,1541,1793,0
81184211627,81184211627,0,1003,1554,0
81185695195,81185695190,-5,975,3283,0
81186671061,81186671061,0,1665,1833,0
81191595597,81191595598,1,1099,1614,0
81192529581,81192529581,0,1561,1862,0
81194800753,81194800754,1,1233,1652,0
81197865692,81197865690,-2,1248,1266,0
81206945867,81206945865,-2,2148,1860,0
81210130580,81210130579,-1,863,1954,0
81211645238,81211645238,0,1042,1061,0
81212066563,81212066564,1,1775,2307,0
81212630442,81212630440,-2,858,1134,0
81213230207,81213230206,-1,1114,1771,0
81216588901,81216588902,1,1123,1985,0
81218417813,81218417820,7,5450,2105,0
81219843834,81219843834,0,1043,1397,0
81220764064,81220764066,2,1236,1765,0
81223765660,81223765658,-2,858,2292,0
81224253414,81224253414,0,1508,2189,0
81226969385,81226969384,-1,1725,2145,0
81227739214,81227739207,-7,1428,5144,0
81232886694,81232886698,4,1832,1618,0
81233016186,81233016189,3,1271,1458,0
81233690735,81233690738,3,1116,1426,0
81235095287,81235095290,3,1677,2285,0
81235395475,81235395474,-1,694,1112,0
81235656615,81235656633,18,907,2003,0
81238329997,81238329998,1,1274,2047,0
81241873785,81241873787,2,2118,2327,0
81242074783,81242074760,-23,330,2845,0
81247545846,81247545846,0,1282,2106,0
81253198543,81253198544,1,2348,2035,0
81253536481,81253536481,0,1523,1904,0
81254775860,81254775860,0,1506,1411,0
81255870527,81255870527,0,1684,2093,0
81256122218,81256122218,0,1641,1794,0
81260076010,81260076013,3,2051,2028,0
81261212595,81261212594,-1,1633,1645,0
81263369130,81263369131,1,1569,2255,0
81264980210,81264980214,4,1501,1460,0
81266243626,81266243627,1,1191,1305,0
81272625562,81272625566,4,1841,1002,0
81273631362,81273631362,0,1650,2016,0
81274652494,81274652494,0,983,1717,0
81278859722,81278859726,4,1165,1593,0
81280961138,81280961140,2,1242,1704,0
81281079590,81281079591,1,1546,1607,0
81285036279,81285036279,0,1131,1172,0
81286178547,81286178546,-1,1356,1527,0
81289473503,81289473503,0,998,1207,0
81290822114,81290822123,9,2536,1651,0
81291375393,81291375393,0,1238,1330,0
81294555337,81294555336,-1,1319,1336,0
81296821968,81296821965,-3,1252,2533,0
81298294041,81298294043,2,1734,1861,0
81301902203,81301902199,-4,2196,7706,0
81304431582,81304431583,1,1123,1629,0
81306990329,81306990333,4,1033,1617,0
81310956347,81310956346,-1,902,1582,0
81312230906,81312230909,3,1361,1379,0
81313944302,81313944303,1,1038,1134,0
81315183701,81315183698,-3,957,1688,0
81316362374,81316362374,0,1495,1826,0
81317334718,81317334714,-4,1442,2522,0
81321511994,81321511994,0,1044,1565,0
81323234516,81323234514,-2,1307,1421,0
81326954634,81326954635,1,1581,1725,0
81327579606,81327579608,2,1498,2421,0
81333610410,81333610412,2,1920,1624,0
81334349754,81334349757,3,1429,1766,0
81334494125,81334494126,1,1515,1246,0
81335439390,81335439390,0,1410,1971,0
81336210934,81336210934,0,1204,1731,0
81342514994,81342514994,0,1614,1921,0
81343962850,81343962849,-1,1186,1884,0
81345948055,81345948050,-5,1386,3424,0
81346590726,81346590725,-1,1550,1917,0
81347748763,81347748766,3,1249,1877,0
81348811312,81348811314,2,1525,1863,0
81351350790,81351350788,-2,1526,1970,0
81353964111,81353964111,0,1377,1464,0
81354289465,81354289466,1,2032,1492,0
81354557297,81354557297,0,1185,1098,0
81355614479,81355614479,0,1354,1368,0
81359270853,81359270852,-1,1434,1834,0
81363411450,81363411453,3,1614,2383,0
81365850415,81365850415,0,1760,2098,0
81366548778,81366548778,0,943,2124,0
81367566258,81367566258,0,954,1550,0
81369464610,81369464609,-1,941,2339,0
81371808162,81371808165,3,1734,1735,0
81372212129,81372212129,0,1078,1391,0
81375499022,81375499023,1,2139,1279,0
81377821270,81377821270,0,1525,1269,0
81377963293,81377963293,0,1545,1633,0
81382754819,81382754797,-22,644,323,0
81388592548,81388592547,-1,1260,1895,0
81389313937,81389313938,1,973,1329,0
81392490564,81392490565,1,2099,2173,0
81393760882,81393760888,6,3115,1449,0
81395237583,81395237583,0,953,1433,0
81397523025,81397523019,-6,1510,4011,0
81397664221,81397664221,0,1191,1689,0
81400155802,81400155803,1,1228,1376,0
81400661114,81400661116,2,1614,1729,0
81402495041,81402495043,2,1395,1588,0
81405918237,81405918239,2,1482,2204,0
81408339615,81408339615,0,1705,1335,0
81409376718,81409376719,1,2034,2262,0
81409620742,81409620743,1,858,1281,0
81412258322,81412258322,0,1336,2165,0
81412411758,81412411758,0,39905,19090,0
81414574558,81414574560,2,1628,1486,0
81417079852,81417079853,1,5092,6074,0
81419276499,81419276501,2,1171,1598,0
81420275333,81420275334,1,1434,2217,0
81422331889,81422331889,0,1529,2122,0
81424774898,81424774899,1,963,1402,0
81426214858,81426214860,2,2210,2486,0
81427088672,81427088671,-1,1185,1670,0
81428753605,81428753605,0,1720,1958,0
81429962826,81429962827,1,1516,2515,0
81431450062,81431450059,-3,1245,1998,0
81431897786,81431897787,1,2108,1756,0
81434449536,81434449515,-21,138,702,0
81437105008,81437105009,1,1415,1577,0
81437253130,81437253131,1,1415,2077,0
81438089102,81438089104,2,892,1410,0
81443899785,81443899786,1,1548,1456,0
81445523226,81445523227,1,1639,2124,0
81447366727,81447366728,1,1579,1423,0
81448734157,81448734159,2,239,697,0
81450714646,81450714647,1,1231,1241,0
81453929430,81453929427,-3,1085,1147,0
81457311680,81457311679,-1,1053,1293,0
81462020897,81462020898,1,1397,1607,0
81463709880,81463709880,0,1479,2094,0
81468208852,81468208855,3,2298,1937,0
81472457335,81472457335,0,1198,1561,0
81474205937,81474205937,0,1053,1584,0
81476840001,81476839997,-4,2258,5663,0
81494395062,81494395065,3,2078,1633,0
81501841363,81501841365,2,1333,1636,0
81502331018,81502331018,0,1753,1814,0
81504157777,81504157779,2,1314,1567,0
81505390464,81505390465,1,1932,2024,0
81505583611,81505583612,1,1116,1616,0
81505643133,81505643132,-1,1263,1617,0
81506163871,81506163868,-3,1325,1768,0
81506879472,81506879479,7,8272,2149,0
81506926045,81506926046,1,1527,1499,0
81510403876,81510403877,1,1606,1785,0
81510668230,81510668230,0,1211,890,0
81512745291,81512745294,3,1631,1567,0
81513577414,81513577415,1,1585,1718,0
81519361701,81519361702,1,1121,1867,0
81519879227,81519879226,-1,1229,2046,0
81522575299,81522575300,1,1118,1817,0
81524437669,81524437669,0,1304,1685,0
81526358872,81526358871,-1,1265,1622,0
81527852190,81527852189,-1,1361,2004,0
81529457885,81529457884,-1,1595,2177,0
81544483593,81544483593,0,1099,1522,0
81548738902,81548738909,7,2113,1094,0
81550987354,81550987354,0,1433,1869,0
81551556285,81551556287,2,1573,1411,0
81555019599,81555019601,2,1008,1052,0
81555881170,81555881170,0,1548,1619,0
81559177610,81559177611,1,1863,1842,0
81567234897,81567234897,0,1368,1977,0
81568635283,81568635282,-1,1428,1876,0
81568992962,81568992965,3,1851,1909,0
81574120570,81574120571,1,1481,1585,0
81578702352,81578702353,1,1098,1412,0
81579661580,81579661565,-15,1386,10341,0
81582774483,81582774482,-1,1365,2136,0
81583029438,81583029438,0,1547,1872,0
81583154791,81583154785,-6,1321,1425,0
81583453785,81583453787,2,1458,1463,0
81585336768,81585336766,-2,1360,1337,0
81585904209,81585904210,1,1601,1688,0
81585940278,81585940295,17,482,1756,0
81587434331,81587434330,-1,1158,2292,0
81594121358,81594121359,1,1346,1751,0
81598640638,81598640637,-1,1006,2458,0
81599050274,81599050275,1,877,1003,0
81602164731,81602164735,4,3261,2002,0
81602441118,81602441118,0,1392,1779,0
81602692663,81602692661,-2,1176,1747,0
81604689151,81604689150,-1,1278,1069,0
81605221746,81605221746,0,246,137,0
81610157431,81610157432,1,1717,1664,0
81613928157,81613928156,-1,1535,1825,0
81615087694,81615087694,0,683,1103,0
81615379268,81615379284,16,45695,13444,0
81621877979,81621877980,1,1599,1596,0
81622983438,81622983440,2,1940,2072,0
81625937194,81625937194,0,1330,2442,0
81627985974,81627985974,0,1164,1728,0
81628019908,81628019911,3,1849,1906,0
81628221283,81628221283,0,1295,1438,0
81630183719,81630183719,0,1222,2091,0
81634814466,81634814469,3,2035,2146,0
81636355272,81636355274,2,1772,1783,0
81636566063,81636566063,0,1383,1726,0
81638342346,81638342346,0,1764,2724,0
81638471196,81638471198,2,1627,2336,0
81639241188,81639241210,22,903,1150,0
81640993253,81640993253,0,727,1662,0
81643215890,81643215890,0,1139,1325,0
81646804936,81646804935,-1,749,926,0
81653599196,81653599193,-3,1220,2125,0
81658019974,81658019975,1,1463,1187,0
81658952509,81658952509,0,1846,2527,0
81659473654,81659473656,2,1313,2076,0
81665326490,81665326491,1,1610,1761,0
81666116421,81666116425,4,1720,1771,0
81668596617,81668596618,1,693,814,0
81670692902,81670692901,-1,1824,1575,0
81671860418,81671860415,-3,1305,1480,0
81674055114,81674055116,2,2850,3802,0
81676810058,81676810058,0,1022,1953,0
81677386402,81677386401,-1,819,1414,0
81677533485,81677533486,1,971,1602,0
81678920945,81678920950,5,24224,17413,0
81679181312,81679181311,-1,1205,1508,0
81682674093,81682674093,0,1193,2050,0
81685345778,81685345780,2,1413,1518,0
81687003234,81687003235,1,1054,1600,0
81687384099,81687384098,-1,1254,1994,0
81691858179,81691858182,3,2361,1988,0
81692370964,81692370965,1,1123,1751,0
81694955994,81694955994,0,1758,2442,0
81699142197,81699142199,2,1236,1316,0
81702682590,81702682589,-1,1077,1543,0
81703295194,81703295198,4,1651,1426,0
81707057926,81707057929,3,973,1262,0
81708715108,81708715110,2,816,798,0
81710185054,81710185054,0,1295,2127,0
81727675994,81727675993,-1,1443,1567,0
81727978941,81727978948,7,12451,25898,0
81729270782,81729270782,0,908,1216,0
81732541288,81732541293,5,3835,1815,0
81735612107,81735612107,0,1040,2089,0
81736703765,81736703764,-1,1303,1050,0
81742243678,81742243677,-1,1208,2188,0
81745788513,81745788513,0,1375,1473,0
81746500405,81746500407,2,1283,1804,0
81747596995,81747596997,2,1754,1843,0
81749282530,81749282529,-1,943,1474,0
81749772133,81749772133,0,1260,1652,0
81753529566,81753529565,-1,985,1836,0
81754873941,81754873938,-3,630,935,0
81755213206,81755213192,-14,635,607,0
81759964963,81759964965,2,796,1889,0
81762660595,81762660595,0,1137,1396,0
81763893437,81763893433,-4,116711,58715,0
81764364750,81764364729,-21,790,1339,0
81765945930,81765945930,0,1776,1774,0
81768384390,81768384391,1,1375,1655,0
81771625231,81771625232,1,1723,2035,0
81774375686,81774375682,-4,1547,5063,0
81776528830,81776528830,0,910,837,0
81778793795,81778793795,0,1957,1934,0
81780760774,81780760774,0,1780,1450,0
81783872878,81783872874,-4,1073,2876,0
81789188357,81789188358,1,1938,2286,0
81790246518,81790246520,2,1071,1856,0
81791365945,81791365945,0,1575,1617,0
81793715149,81793715150,1,1616,1136,0
81793899404,81793899404,0,1664,1445,0
81795947313,81795947314,1,1683,1888,0
81796541295,81796541296,1,1651,1536,0
81800427787,81800427788,1,1390,851,0
81802361691,81802361689,-2,736,1359,0
81804556426,81804556427,1,1485,1572,0
81805122729,81805122730,1,1283,1184,0
81810653394,81810653394,0,1301,1307,0
81817588221,81817588221,0,1247,1962,0
81821106283,81821106284,1,1903,3307,0
81821780887,81821780888,1,956,1287,0
81823880934,81823880942,8,3958,1277,0
81827123198,81827123198,0,825,1154,0
81834454612,81834454610,-2,1165,2140,0
81840048462,81840048463,1,1984,2123,0
81849028026,81849028027,1,1231,1638,0
81849340498,81849340498,0,2312,2114,0
81850493794,81850493789,-5,2624,8262,0
81850919883,81850919881,-2,3109,5019,0
81853042649,81853042651,2,1486,1278,0
81857336054,81857336054,0,1590,1365,0
81857866354,81857866355,1,1341,1380,0
81858529770,81858529770,0,1305,1707,0
81862128066,81862128065,-1,1110,2223,0
81862758213,81862758213,0,1297,1672,0
81865394643,81865394642,-1,1359,1865,0
81865929647,81865929648,1,1454,2047,0
81872416625,81872416625,0,1286,1768,0
81875660343,81875660345,2,1733,2142,0
81876711078,81876711078,0,1162,1769,0
81877168202,81877168204,2,1195,1516,0
81877675054,81877675054,0,1757,2172,0
81878984272,81878984272,0,1750,1880,0
81879265040,81879265042,2,1328,1868,0
81882601351,81882601351,0,1144,1438,0
81883523001,81883523002,1,1231,1159,0
81883607731,81883607725,-6,1315,2694,0
81889000106,81889000107,1,1419,1257,0
81891328403,81891328402,-1,1204,1211,0
81892461312,81892461312,0,1112,1527,0
81896569103,81896569107,4,624,953,0
81897942418,81897942423,5,1811,2034,0
81899135513,81899135518,5,7470,2196,0
81900833249,81900833249,0,1767,2356,0
81901941215,81901941215,0,1094,1391,0
81904198211,81904198209,-2,1378,2408,0
81904889179,81904889181,2,1312,1347,0
81905639091,81905639092,1,1624,2487,0
81910944206,81910944205,-1,1690,1360,0
81911563461,81911563463,2,1217,2001,0
81914593781,81914593782,1,1912,2415,0
81915001147,81915001147,0,1176,1924,0
81915630336,81915630334,-2,1601,1970,0
81915898285,81915898285,0,1517,1808,0
81917832195,81917832174,-21,582,449,0
81917985719,81917985722,3,1911,1703,0
81919764789,81919764792,3,1087,1472,0
81921940035,81921940034,-1,1244,2043,0
81922624143,81922624143,0,1535,1573,0
81922865001,81922864999,-2,1584,2163,0
81933249775,81933249774,-1,1172,1977,0
81936455697,81936455698,1,1875,1543,0
81936975536,81936975531,-5,1202,4556,0
81937451862,81937451859,-3,1097,2049,0
81938007515,81938007516,1,1463,1957,0
81938140854,81938140857,3,1415,1907,0
81938804334,81938804354,20,563,910,0
81942761526,81942761527,1,895,1570,0
81947563564,81947563570,6,2590,1607,0
81950590622,81950590621,-1,1285,1170,0
81951684628,81951684627,-1,1620,1630,0
81952569310,81952569310,0,1228,1053,0
81960759545,81960759545,0,1337,1011,0
81961766537,81961766544,7,1985,999,0
81968485400,81968485398,-2,1610,2593,0
81968668321,81968668321,0,1775,1955,0
81972310839,81972310840,1,2059,1624,0
81972708130,81972708130,0,832,1595,0
81973751335,81973751336,1,1301,1551,0
81976795499,81976795499,0,1047,1101,0
81977114788,81977114789,1,1588,1958,0
81977976863,81977976863,0,1264,1811,0
81978497209,81978497209,0,1339,2061,0
81981490321,81981490322,1,1355,1403,0
81982618469,81982618470,1,1736,2192,0
81986576125,81986576124,-1,1386,1243,0
81991609970,81991609969,-1,1039,1521,0
81992243229,81992243250,21,129,770,0
81998653957,81998653957,0,1430,1679,0
81999399926,81999399915,-11,1164,1906,0
82002149778,82002149777,-1,1491,1809,0
82003033835,82003033831,-4,1276,1899,0
82003133130,82003133132,2,1632,1805,0
82009247352,82009247353,1,1864,1445,0
82012873821,82012873827,6,5732,2405,0
82017763675,82017763675,0,1508,2262,0
82019353050,82019353057,7,9142,40563,0
82019412943,82019412943,0,1359,1516,0
82019852787,82019852786,-1,1260,2093,0
82022421074,82022421073,-1,1660,1637,0
82022722982,82022722976,-6,27982,13264,0
82023537150,82023537150,0,1339,1085,0
82024282258,82024282259,1,1031,1221,0
82026017947,82026017947,0,1731,1988,0
82027115226,82027115227,1,1724,1568,0
82028477935,82028477929,-6,2513,6284,0
82028620706,82028620707,1,1389,1433,0
82030608049,82030608054,5,2259,1823,0
82031675985,82031675985,0,1643,2028,0
82032943826,82032943827,1,1086,1982,0
82037147430,82037147429,-1,1623,2189,0
82041759575,82041759575,0,1104,984,0
82042797836,82042797822,-14,1123,3600,0
82046048976,82046048976,0,1800,1954,0
82047242516,82047242514,-2,1307,1495,0
82050557363,82050557365,2,1641,1629,0
82052159389,82052159386,-3,989,1949,0
82054695535,82054695536,1,1501,1974,0
82055176821,82055176822,1,1506,1980,0
82055740844,82055740834,-10,1171,1789,0
82056500132,82056500114,-18,904,1501,0
82058244934,82058244936,2,1050,1480,0
82058325309,82058325330,21,1408,2403,0
82058441190,82058441193,3,2115,2307,0
82058559729,82058559730,1,2090,2029,0
82060511324,82060511326,2,1705,1689,0
82062096061,82062096060,-1,1601,2061,0
82063038805,82063038800,-5,1420,2140,0
82063426191,82063426191,0,1305,1195,0
82065409174,82065409174,0,1202,1615,0
82068144204,82068144204,0,1232,1857,0
82069723678,82069723677,-1,1744,1921,0
82071402077,82071402081,4,1363,1465,0
82075794414,82075794415,1,2113,1902,0
82080075243,82080075243,0,1006,1805,0
82084796475,82084796476,1,960,1904,0
82091892214,82091892214,0,1443,1307,0
82092449581,82092449587,6,3109,1803,0
82093484534,82093484535,1,2455,2332,0
82093855402,82093855402,0,1187,1210,0
82097791949,82097791952,3,1779,1551,0
82098259537,82098259538,1,1900,1961,0
82099143009,82099143006,-3,1451,2344,0
82100953773,82100953773,0,2623,3448,0
82104174420,82104174421,1,1833,2035,0
82104309051,82104309050,-1,1318,1443,0
82106345980,82106345984,4,1445,1706,0
82106591758,82106591759,1,861,1529,0
82108643545,82108643546,1,1848,2296,0
82109835005,82109835005,0,1766,2261,0
82113389086,82113389086,0,1073,1109,0
82116380577,82116380578,1,1429,1676,0
82118642167,82118642167,0,1296,1235,0
82120513442,82120513441,-1,1616,1567,0
82122536286,82122536287,1,634,1554,0
82125060310,82125060311,1,1499,1741,0
82126699739,82126699742,3,1228,1717,0
82131840908,82131840909,1,1593,2071,0
82132201347,82132201350,3,1075,1242,0
82137443222,82137443223,1,930,1013,0
82139539469,82139539468,-1,1312,1735,0
82144040905,82144040904,-1,1116,1773,0
82149384245,82149384245,0,1345,1705,0
82150172490,82150172490,0,1505,1613,0
82152655790,82152655791,1,1163,1550,0
82155322154,82155322155,1,1541,2131,0
82156637442,82156637442,0,1716,1329,0
82158287607,82158287604,-3,1596,2359,0
82159989996,82159989995,-1,1460,1717,0
82161943426,82161943423,-3,1172,2106,0
82166879450,82166879449,-1,1394,1658,0
82168055221,82168055221,0,1799,1680,0
82168380054,82168380054,0,1344,1419,0
82169491158,82169491160,2,1410,2110,0
82170305179,82170305182,3,841,1622,0
82173132990,82173132992,2,2544,2211,0
82173690385,82173690386,1,1612,1620,0
82175305964,82175305963,-1,1378,1271,0
82175350255,82175350257,2,1807,1371,0
82177072633,82177072630,-3,19034,13826,0
82180947114,82180947115,1,907,1449,0
82187706330,82187706331,1,2102,2368,0
82189406678,82189406678,0,974,1381,0
82191911032,82191911031,-1,1917,2359,0
82202158489,82202158491,2,1302,2834,0
82202721453,82202721453,0,1188,1741,0
82208442878,82208442878,0,1429,1676,0
82208687702,82208687705,3,1362,2261,0
82210227605,82210227602,-3,1166,3078,0
82211249006,82211249006,0,1320,1582,0
82212081469,82212081478,9,1768,1437,0
82213379001,82213379003,2,1475,1445,0
82215757826,82215757827,1,1504,1534,0
82217159845,82217159845,0,1381,1830,0
82217422652,82217422654,2,2490,2942,0
82222727611,82222727611,0,1341,1667,0
82223388935,82223388935,0,1300,1012,0
82226747547,82226747551,4,1611,1484,0
82227752881,82227752883,2,1418,1746,0
82228231035,82228231033,-2,1617,2732,0
82231339031,82231339033,2,1151,1677,0
82238024468,82238024470,2,2773,2387,0
82238151014,82238151015,1,1470,1555,0
82239503466,82239503467,1,1380,1928,0
82242963344,82242963346,2,1045,1120,0
82248278434,82248278434,0,1250,1844,0
82250351503,82250351505,2,1357,1994,0
82252006896,82252006897,1,1207,1334,0
82253166914,82253166914,0,1114,1657,0
82256314314,82256314319,5,1734,1244,0
82258917959,82258917959,0,1359,1319,0
82262370917,82262370919,2,1149,1123,0
82265761266,82265761267,1,1207,1227,0
82267305608,82267305607,-1,1791,1589,0
82271823227,82271823229,2,1609,1518,0
82279834950,82279834951,1,991,1331,0
82283317553,82283317552,-1,794,1619,0
82287769058,82287769060,2,1989,1901,0
82289298185,82289298184,-1,1739,2006,0
82295940219,82295940217,-2,1400,2475,0
82296073007,82296073021,14,987,6176,0
82301409491,82301409490,-1,1783,2180,0
82305141794,82305141795,1,1780,1906,0
82305427891,82305427890,-1,1129,1239,0
82305608134,82305608136,2,1434,1488,0
82306630474,82306630474,0,1396,1748,0
82307450554,82307450556,2,954,1319,0
82309439639,82309439639,0,842,803,0
82314106159,82314106159,0,1603,2276,0
82315001029,82315001030,1,1385,1637,0
82316626839,82316626842,3,1737,1225,0
82319318194,82319318193,-1,1326,2165,0
82319822494,82319822497,3,1545,1788,0
82321142025,82321142025,0,1361,1684,0
82325781474,82325781475,1,1412,1540,0
82329149870,82329149870,0,1876,1891,0
82330266849,82330266843,-6,2109,5871,0
82331106175,82331106176,1,1377,1994,0
82338876350,82338876350,0,1255,1380,0
82339914727,82339914728,1,1377,1251,0
82341557903,82341557903,0,740,940,0
82347893780,82347893782,2,1355,1648,0
82348384427,82348384429,2,1400,1468,0
82357543571,82357543555,-16,907,1192,0
82359085527,82359085529,2,1352,1644,0
82360539953,82360539955,2,979,1205,0
82363830216,82363830215,-1,1356,2521,0
82366810441,82366810439,-2,797,1737,0
82371872570,82371872572,2,1921,2338,0
82372930311,82372930311,0,1388,1340,0
82373110686,82373110694,8,9623,1736,0
82374421269,82374421269,0,1559,1584,0
82375252559,82375252560,1,1890,1926,0
82381300906,82381300907,1,1610,1476,0
82383184491,82383184491,0,1296,2219,0
82384642106,82384642102,-4,1987,4867,0
82387038491,82387038490,-1,1443,1521,0
82388405787,82388405787,0,1183,1287,0
82390174154,82390174173,19,1937,1610,0
82391696899,82391696901,2,1445,1623,0
82396012795,82396012799,4,1399,1886,0
82396592368,82396592370,2,2003,2074,0
82396649198,82396649198,0,1453,1987,0
82397089104,82397089105,1,1279,999,0
82404154567,82404154567,0,1148,2024,0
82405022866,82405022866,0,1126,1450,0
82408086727,82408086726,-1,1359,1996,0
82412058369,82412058348,-21,1310,1401,0
82412541702,82412541684,-18,1143,1666,0
82416319198,82416319199,1,1263,1516,0
82417156505,82417156505,0,1282,1748,0
82424736300,82424736302,2,1332,1478,0
82425759300,82425759303,3,1108,1356,0
82426372543,82426372536,-7,1065,3733,0
82427012262,82427012263,1,1804,1477,0
82428207712,82428207714,2,1383,1372,0
82431332081,82431332063,-18,1628,1044,0
82437019173,82437019174,1,1232,1559,0
82439459818,82439459797,-21,681,803,0
82446963679,82446963682,3,1426,2017,0
82447233489,82447233489,0,1104,1703,0
82450359923,82450359920,-3,1135,2957,0
82450876703,82450876705,2,1526,1855,0
82454066223,82454066201,-22,1203,1810,0
82455332991,82455332994,3,1928,1449,0
82457231440,82457231438,-2,1427,1305,0
82459673190,82459673206,16,15737,29684,0
82462965433,82462965432,-1,1603,2021,0
82464344090,82464344091,1,835,1338,0
82464797525,82464797527,2,1385,1339,0
82465883493,82465883494,1,1727,1528,0
82467709256,82467709257,1,1327,1788,0
82468842019,82468842018,-1,1417,1580,0
82469952938,82469952938,0,1285,1208,0
82470967532,82470967531,-1,1308,1856,0
82472425469,82472425468,-1,1049,1692,0
82474270119,82474270121,2,833,1239,0
82474801893,82474801894,1,1174,1779,0
82476328400,82476328398,-2,1169,1745,0
82478848260,82478848261,1,860,1604,0
82483019557,82483019556,-1,1322,1433,0
82492794357,82492794357,0,1516,2418,0
82494232649,82494232647,-2,1104,1379,0
82494268011,82494268010,-1,1576,2065,0
82494494870,82494494870,0,1333,2193,0
82495136087,82495136089,2,971,1353,0
82497527394,82497527394,0,1182,1547,0
82500684664,82500684665,1,1964,1406,0
82503565716,82503565717,1,1465,2192,0
82503798066,82503798067,1,1876,1700,0
82505159986,82505159986,0,995,1483,0
82507458214,82507458217,3,1066,1587,0
82509844787,82509844787,0,1103,1177,0
82513753670,82513753670,0,1226,1691,0
82514441919,82514441921,2,1777,1377,0
82515036245,82515036246,1,1648,1731,0
82516692920,82516692924,4,20350,19030,0
82522904547,82522904546,-1,903,1730,0
82523244016,82523244015,-1,2411,3588,0
82523703617,82523703618,1,1703,1834,0
82526368546,82526368546,0,1512,1753,0
82527297706,82527297707,1,1918,2020,0
82535357910,82535357902,-8,1342,5911,0
82536372517,82536372522,5,2456,1569,0
82538463755,82538463755,0,1308,1669,0
82538933105,82538933103,-2,1047,1605,0
82539764446,82539764450,4,1936,1571,0
82539900657,82539900659,2,4011,3140,0
82543399026,82543399029,3,1208,1283,0
82544867362,82544867361,-1,1648,1488,0
82545110135,82545110136,1,2094,2323,0
82547479238,82547479234,-4,1143,1520,0
82549327862,82549327861,-1,1953,2206,0
82552003139,82552003141,2,1125,1449,0
82556544182,82556544182,0,1701,1687,0
82557587918,82557587918,0,1105,1284,0
82564847263,82564847270,7,2850,1617,0
82564921085,82564921086,1,1089,1225,0
82566245310,82566245310,0,1054,1245,0
82567225619,82567225621,2,1426,1617,0
82569317106,82569317105,-1,1214,1387,0
82570422345,82570422347,2,1338,1715,0
82572740742,82572740741,-1,1307,2397,0
82574051546,82574051547,1,1279,1726,0
82577071135,82577071138,3,1571,1668,0
82577922639,82577922641,2,1134,1542,0
82580348879,82580348878,-1,1542,1946,0
82580897344,82580897345,1,1985,2687,0
82582801896,82582801894,-2,1476,1696,0
82584712518,82584712519,1,1053,2053,0
82585294221,82585294221,0,1321,1511,0
82588182102,82588182102,0,1214,1794,0
82593602010,82593602023,13,16400,5055,0
82596192236,82596192234,-2,1379,2265,0
82596781030,82596781029,-1,1356,1877,0
82598195663,82598195665,2,1703,2004,0
82600001345,82600001345,0,1837,2165,0
82601742505,82601742506,1,1342,1959,0
82605572516,82605572517,1,1334,2208,0
82605817149,82605817153,4,1945,1571,0
82607432742,82607432743,1,785,971,0
82609173037,82609173057,20,1178,1315,0
82611145474,82611145474,0,1015,1320,0
82611208554,82611208554,0,1638,1879,0
82611572766,82611572766,0,1032,1584,0
82614951006,82614951006,0,1281,1259,0
82620152423,82620152424,1,1256,1202,0
82620917473,82620917473,0,909,956,0
82622130041,82622130040,-1,1558,1514,0
82622649758,82622649758,0,1328,1467,0
82624521884,82624521885,1,1199,1141,0
82627646691,82627646691,0,1445,1580,0
82627886085,82627886086,1,1599,1625,0
82628994048,82628994050,2,1477,1153,0
82629938755,82629938757,2,1365,1478,0
82631733974,82631733975,1,1523,1892,0
82632662715,82632662695,-20,1450,1785,0
82633222185,82633222184,-1,1213,1877,0
82639199351,82639199353,2,1450,1658,0
82640283210,82640283211,1,1373,2421,0
82642423146,82642423148,2,1736,1969,0
82648443252,82648443253,1,1364,1690,0
82648730875,82648730892,17,773,408,0
82649177875,82649177877,2,1539,1752,0
82649415402,82649415405,3,1602,1713,0
82650737910,82650737911,1,1369,2042,0
82650929561,82650929563,2,1829,2520,0
82651701340,82651701337,-3,1425,1999,0
82655452112,82655452120,8,11685,41795,0
82664737734,82664737735,1,1030,1720,0
82665687656,82665687657,1,1956,2179,0
82669160102,82669160102,0,2200,1651,0
82670732174,82670732173,-1,1485,1330,0
82673358069,82673358070,1,1451,1525,0
82674001583,82674001582,-1,1214,1699,0
82678834777,82678834779,2,1380,1619,0
82681963029,82681963031,2,1356,1624,0
82682761809,82682761810,1,1738,1465,0
82684477743,82684477761,18,1365,1249,0
82686350644,82686350639,-5,1058,3642,0
82688095430,82688095426,-4,897,2178,0
82688869467,82688869467,0,1126,1630,0
82689837897,82689837898,1,1548,1552,0
82690114302,82690114302,0,1038,1749,0
82692039320,82692039313,-7,35291,18758,0
82695066010,82695066010,0,953,1437,0
82696417736,82696417730,-6,1261,4685,0
82697368929,82697368933,4,2056,1283,0
82698198358,82698198352,-6,662,2617,0
82699035178,82699035179,1,624,822,0
82699577863,82699577882,19,1112,2323,0
82700281732,82700281733,1,1227,1103,0
82701567026,82701567026,0,1331,1920,0
82707224450,82707224451,1,993,1600,0
82710773419,82710773417,-2,1657,2125,0
82711237702,82711237702,0,848,1449,0
82712409646,82712409638,-8,549,1384,0
82714407652,82714407653,1,1448,1974,0
82714586524,82714586521,-3,1334,2266,0
82715553220,82715553214,-6,1608,1519,0
82717326820,82717326820,0,1870,2118,0
82718052342,82718052342,0,1777,2041,0
82718919018,82718919015,-3,4967,8650,0
82723323512,82723323514,2,2092,2159,0
82725443504,82725443502,-2,1238,2083,0
82726260278,82726260278,0,1537,1503,0
82728729813,82728729813,0,1784,2296,0
82728940411,82728940412,1,996,1409,0
82732412362,82732412364,2,1192,1436,0
82735016194,82735016194,0,1921,2380,0
82735991533,82735991533,0,1809,2172,0
82736064153,82736064153,0,2091,2147,0
82740999642,82740999642,0,1071,1842,0
82743502857,82743502857,0,987,1580,0
82745365423,82745365423,0,833,900,0
82745557023,82745557023,0,919,1229,0
82749013941,82749013942,1,1325,2018,0
82755515565,82755515565,0,1445,1916,0
82755689762,82755689763,1,1647,1185,0
82757958370,82757958369,-1,1207,2118,0
82759935413,82759935413,0,1391,1274,0
82761248098,82761248096,-2,970,2141,0
82761821913,82761821913,0,1447,1434,0
82764311781,82764311781,0,1644,1541,0
82766220489,82766220495,6,5729,2656,0
82766260814,82766260814,0,1042,1502,0
82766642676,82766642699,23,610,592,0
82766775610,82766775611,1,1122,1259,0
82767875115,82767875118,3,1019,1119,0
82773875934,82773875950,16,261,1099,0
82777924686,82777924685,-1,1327,2379,0
82778921355,82778921359,4,1647,1216,0
82785683874,82785683874,0,1507,1319,0
82786946413,82786946412,-1,1462,1532,0
82788245737,82788245736,-1,1466,1881,0
82789617726,82789617728,2,1220,1267,0
82792460507,82792460505,-2,1238,1623,0
82794554925,82794554926,1,1166,2052,0
82796056269,82796056270,1,1450,2293,0
82801182194,82801182211,17,11252,50037,0
82802494095,82802494093,-2,1299,1998,0
82804589617,82804589619,2,1195,1784,0
82809317779,82809317785,6,3440,2239,0
82815942790,82815942791,1,1100,1384,0
82818455534,82818455533,-1,954,1896,0
82818817834,82818817813,-21,549,567,0
82818928698,82818928698,0,1188,1189,0
82820583666,82820583670,4,2062,1978,0
82821572021,82821572022,1,1285,1667,0
82822282294,82822282295,1,1097,1168,0
82823601867,82823601867,0,1057,1727,0
82825292634,82825292634,0,1696,1801,0
82826473231,82826473228,-3,1365,4806,0
82832643789,82832643789,0,1415,1743,0
82832806462,82832806462,0,1114,1248,0
82833206803,82833206805,2,1309,1543,0
82836576452,82836576445,-7,2066,6508,0
82840125349,82840125351,2,1842,1091,0
82844567045,82844567049,4,1112,1269,0
82846805681,82846805679,-2,1602,2405,0
82850369071,82850369072,1,1851,2335,0
82852598451,82852598451,0,963,1281,0
82852644932,82852644938,6,2835,1564,0
82852849105,82852849106,1,1381,1370,0
82853609424,82853609443,19,857,1099,0
82855109102,82855109103,1,1604,2179,0
82857865987,82857865988,1,1119,1693,0
82858831902,82858831902,0,1266,995,0
82861846097,82861846096,-1,1838,2100,0
82863318493,82863318492,-1,1205,1739,0
82865618807,82865618809,2,1045,1174,0
82867083254,82867083254,0,1726,1646,0
82867249185,82867249182,-3,1512,3993,0
82867907941,82867907942,1,1286,1625,0
82868662008,82868662007,-1,1023,1122,0
82872230395,82872230393,-2,1659,3467,0
82872481778,82872481779,1,1395,1357,0
82873468609,82873468610,1,1171,1409,0
82877864514,82877864517,3,1355,1780,0
82879209718,82879209717,-1,1061,1659,0
82880712900,82880712888,-12,892,1783,0
82887513235,82887513229,-6,943,1586,0
82892429609,82892429611,2,1876,2254,0
82893185645,82893185647,2,1745,1529,0
82893431244,82893431242,-2,1335,1675,0
82903232630,82903232630,0,1259,1526,0
82917177495,82917177497,2,812,1710,0
82917999694,82917999695,1,1453,2008,0
82919844271,82919844270,-1,1833,2000,0
82923455311,82923455309,-2,1448,1732,0
82936519342,82936519343,1,1059,898,0
82937892263,82937892263,0,1127,2034,0
82940235496,82940235495,-1,2327,3716,0
82940465026,82940465029,3,1140,1223,0
82941746471,82941746471,0,1080,1960,0
82943151761,82943151761,0,1207,1594,0
82943645431,82943645432,1,2081,2656,0
82950327240,82950327241,1,1766,2066,0
82950584025,82950584027,2,1393,2081,0
82953535666,82953535670,4,1940,2119,0
82955124314,82955124315,1,1332,1147,0
82961908255,82961908254,-1,1326,1564,0
82967865667,82967865668,1,1460,1427,0
82969867420,82969867421,1,1118,2200,0
82974892513,82974892511,-2,2764,3569,0
82976780856,82976780858,2,1466,1236,0
82980832696,82980832693,-3,1612,1600,0
82982850587,82982850586,-1,1746,2281,0
82983337103,82983337111,8,1175,1545,0
82986112482,82986112484,2,1949,2303,0
82987188278,82987188278,0,1539,1556,0
82987465858,82987465861,3,1324,1770,0
82989639950,82989639952,2,838,1134,0
82990905927,82990905910,-17,1285,1617,0
82991697751,82991697753,2,1565,1169,0
82992342090,82992342095,5,2815,2063,0
82992676808,82992676809,1,1754,1474,0
82992832254,82992832234,-20,46,318,0
82993643549,82993643550,1,1103,1860,0
82993894098,82993894099,1,1512,1885,0
82994097902,82994097901,-1,1071,1584,0
82996189481,82996189482,1,1316,1931,0
82996435902,82996435902,0,1279,1633,0
82996657930,82996657928,-2,1314,2567,0
83006130637,83006130636,-1,1330,1055,0
83007231975,83007231977,2,1186,1192,0
83010521799,83010521800,1,1165,2147,0
83012669799,83012669800,1,1563,2251,0
83024445534,83024445534,0,1425,1490,0
83027570215,83027570215,0,721,908,0
83030225142,83030225143,1,1010,978,0
83032060914,83032060918,4,1890,1545,0
83032697419,83032697418,-1,1124,1594,0
83033961238,83033961238,0,1929,2544,0
83035727411,83035727410,-1,1076,1594,0
83036481826,83036481828,2,1641,2387,0
83038104735,83038104737,2,1816,1890,0
83041123115,83041123117,2,1754,1286,0
83041903834,83041903835,1,1035,1725,0
83046717863,83046717865,2,32844,35409,0
83052872030,83052872030,0,1240,1809,0
83054476901,83054476906,5,4185,1651,0
83054888766,83054888761,-5,934,2167,0
83056800893,83056800895,2,1073,1307,0
83058266200,83058266214,14,11696,45436,0
83058472055,83058472060,5,2654,2119,0
83062979704,83062979703,-1,1592,1596,0
83063634085,83063634087,2,1565,1979,0
83073114820,83073114822,2,1811,2547,0
83074942921,83074942924,3,814,1565,0
83078385505,83078385500,-5,1411,18757,0
83078514398,83078514397,-1,1458,1788,0
83078597170,83078597151,-19,1493,1871,0
83078903935,83078903936,1,1526,1326,0
83079043456,83079043455,-1,1118,1600,0
83081610938,83081610938,0,1643,1726,0
83081700970,83081700970,0,1565,1711,0
83086726107,83086726108,1,1724,2078,0
83087079494,83087079491,-3,1393,2767,0
83088199256,83088199256,0,1160,1707,0
83089810173,83089810175,2,1568,2013,0
83089936861,83089936863,2,1490,1473,0
83094794647,83094794649,2,1211,1597,0
83098308879,83098308879,0,1603,1526,0
83100504071,83100504070,-1,1177,2057,0
83102687009,83102687013,4,1161,1193,0
83105665513,83105665515,2,1812,1777,0
83106651648,83106651651,3,1904,1334,0
83106755106,83106755105,-1,1580,1652,0
83108747494,83108747494,0,1395,1504,0
83114458154,83114458155,1,1290,1901,0
83117611351,83117611351,0,843,1296,0
83117702119,83117702116,-3,1020,1582,0
83120971337,83120971337,0,1178,1908,0
83123090983,83123090983,0,1379,2383,0
83123116851,83123116853,2,1227,1789,0
83125489018,83125489018,0,1343,1671,0
83126672042,83126672041,-1,1526,2606,0
83127737806,83127737797,-9,1356,2572,0
83131060303,83131060302,-1,1081,1917,0
83132839867,83132839869,2,1630,2279,0
83136875983,83136875983,0,874,1289,0
83137289454,83137289455,1,1140,1576,0
83138599585,83138599584,-1,1710,2220,0
83138737583,83138737584,1,1216,2108,0
83139004307,83139004306,-1,1289,1424,0
83139722566,83139722567,1,828,1391,0
83143609375,83143609377,2,1420,1668,0
83145554222,83145554223,1,2170,1992,0
83146835838,83146835842,4,1180,1025,0
83151068202,83151068202,0,1328,1697,0
83152513825,83152513829,4,10869,8131,0
83154077437,83154077434,-3,925,1732,0
83155560170,83155560165,-5,1292,2882,0
83157294766,83157294759,-7,1104,1685,0
83157804935,83157804926,-9,1164,1791,0
83159373406,83159373406,0,966,1270,0
83163511014,83163511015,1,1010,1642,0
83163980524,83163980526,2,1508,1696,0
83165394234,83165394234,0,2306,2006,0
83167100506,83167100504,-2,1531,1565,0
83175071711,83175071711,0,950,768,0
83175190072,83175190074,2,1121,1205,0
83177688179,83177688177,-2,1499,1665,0
83178116826,83178116826,0,1602,2329,0
83178903990,83178903990,0,1013,1302,0
83179468122,83179468122,0,1647,1899,0
83182112558,83182112559,1,1009,1307,0
83182571651,83182571653,2,1757,1494,0
83184404489,83184404490,1,1473,1927,0
83186219291,83186219292,1,1499,1151,0
83191733707,83191733706,-1,1267,1419,0
83192290316,83192290318,2,1189,1112,0
83193828089,83193828090,1,802,1258,0
83195982411,83195982410,-1,1079,2001,0
83196150306,83196150305,-1,1853,1664,0
83197034109,83197034109,0,1715,2081,0
83199008916,83199008916,0,1225,1502,0
83200081815,83200081835,20,808,1270,0
83201887294,83201887302,8,1760,545,0
83202367527,83202367527,0,1628,1943,0
83202589279,83202589278,-1,707,2209,0
83203526837,83203526837,0,1631,1396,0
83204083953,83204083954,1,1398,1836,0
83204582082,83204582090,8,3240,1019,0
83207490708,83207490710,2,1826,1722,0
83212672222,83212672222,0,982,1333,0
83215526503,83215526501,-2,1217,1898,0
83221564534,83221564534,0,1513,1691,0
83222158791,83222158790,-1,1380,1449,0
83223392078,83223392078,0,1532,1799,0
83225543907,83225543909,2,1346,1564,0
83227718327,83227718328,1,1360,2059,0
83231063590,83231063591,1,1470,1318,0
83231533866,83231533866,0,1714,1939,0
83232004181,83232004182,1,1549,1790,0
83236718658,83236718659,1,1203,1566,0
83240371347,83240371348,1,1543,1822,0
83240876731,83240876730,-1,1502,2197,0
83240945674,83240945672,-2,1080,1769,0
83243240214,83243240213,-1,856,1322,0
83245741413,83245741413,0,1145,1686,0
83247065030,83247065029,-1,1051,2264,0
83248567718,83248567717,-1,1818,1633,0
83248639503,83248639504,1,1691,1922,0
83255453271,83255453271,0,879,1198,0
83257311894,83257311900,6,1664,1304,0
83258328958,83258328957,-1,1134,1790,0
83261705625,83261705626,1,1160,1751,0
83262877091,83262877090,-1,2401,2564,0
83266746058,83266746059,1,1091,1422,0
83266871357,83266871343,-14,1309,1259,0
83269613455,83269613457,2,606,941,0
83270360644,83270360643,-1,2006,2996,0
83273001546,83273001546,0,1154,1609,0
83275247001,83275247001,0,1129,1896,0
83276693833,83276693834,1,1911,1716,0
83277285355,83277285355,0,1033,1570,0
83278915125,83278915127,2,1269,1592,0
83282907114,83282907113,-1,1532,2143,0
83284746109,83284746110,1,1248,1574,0
83284878681,83284878681,0,1796,2311,0
83285287538,83285287538,0,1404,1963,0
83285586231,83285586231,0,1122,1448,0
83290100795,83290100799,4,1631,1216,0
83290585369,83290585380,11,1588,1723,0
83290875569,83290875565,-4,957,1751,0
83294091883,83294091883,0,1138,948,0
83295821035,83295821037,2,1090,1138,0
83297972241,83297972241,0,2025,2151,0
83304280438,83304280439,1,1567,1572,0
83305380430,83305380448,18,1514,2270,0
83306448734,83306448738,4,1282,1348,0
83306817346,83306817346,0,1599,1465,0
83315933057,83315933050,-7,1472,1239,0
83317512143,83317512143,0,1228,1608,0
83318414419,83318414418,-1,990,1028,0
83319502266,83319502270,4,1817,1114,0
83325154351,83325154351,0,1262,1416,0
83329496062,83329496062,0,1619,1653,0
83331452774,83331452781,7,1901,883,0
83332746065,83332746065,0,1275,2005,0
83333156778,83333156778,0,1710,1715,0
83334301339,83334301341,2,1571,1988,0
83335789075,83335789074,-1,1543,3081,0
83337208117,83337208118,1,1571,1499,0
83337347573,83337347577,4,1256,1170,0
83340739802,83340739802,0,1357,1725,0
83341877304,83341877302,-2,1896,3301,0
83342846965,83342846969,4,1786,1729,0
83350994803,83350994803,0,1884,1669,0
83356880102,83356880103,1,1320,1371,0
83358427219,83358427218,-1,1331,2162,0
83358486150,83358486151,1,1800,2702,0
83359506838,83359506838,0,1321,1441,0
83359822158,83359822158,0,1066,1326,0
83360681313,83360681311,-2,692,944,0
83364139701,83364139701,0,1057,2431,0
83365677403,83365677403,0,1781,1739,0
83367757794,83367757795,1,2398,1449,0
83372186255,83372186257,2,1419,1782,0
83380478396,83380478398,2,2015,2580,0
83382365491,83382365493,2,1195,1522,0
83383959139,83383959138,-1,2287,2665,0
83398177231,83398177234,3,1050,1186,0
83398227550,83398227557,7,1089,1701,0
83398616043,83398616046,3,1315,1041,0
83400020158,83400020159,1,1326,1553,0
83400306073,83400306059,-14,1078,1519,0
83404349271,83404349258,-13,1481,1751,0
83404857814,83404857818,4,1797,1567,0
83405294599,83405294599,0,1390,2191,0
83405824364,83405824368,4,1648,1685,0
83408224071,83408224073,2,850,1343,0
83409079344,83409079345,1,1229,1472,0
83410442221,83410442225,4,1674,1387,0
83414719310,83414719313,3,2399,2649,0
83415446944,83415446945,1,1456,1979,0
83417385734,83417385732,-2,1248,1352,0
83420716167,83420716169,2,1331,1881,0
83422908989,83422908988,-1,1324,1751,0
83426983316,83426983317,1,1723,1683,0
83432548198,83432548198,0,1363,1629,0
83438669822,83438669823,1,932,1555,0
83439177967,83439177966,-1,1624,1541,0
83440511351,83440511353,2,1552,2871,0
83442730922,83442730922,0,919,1071,0
83443830574,83443830575,1,1513,2222,0
83447761394,83447761391,-3,1072,1740,0
83454002371,83454002372,1,1381,1460,0
83454360298,83454360301,3,1397,1337,0
83458867297,83458867298,1,1387,1629,0
83462505075,83462505076,1,1420,1735,0
83465248963,83465248967,4,2484,2216,0
83467100248,83467100248,0,1739,2115,0
83467467317,83467467320,3,1006,1280,0
83469806519,83469806522,3,2649,1691,0
83470038596,83470038597,1,1368,2126,0
83473122887,83473122889,2,1607,1573,0
83477182153,83477182151,-2,1187,1921,0
83477947464,83477947462,-2,1506,2272,0
83480333167,83480333168,1,2051,2344,0
83480517154,83480517153,-1,1106,1493,0
83480837959,83480837974,15,867,3350,0
83480891431,83480891432,1,1548,1612,0
83481063287,83481063287,0,1179,1752,0
83482557230,83482557234,4,2104,1503,0
83485604763,83485604778,15,1222,1281,0
83486355642,83486355659,17,303,872,0
83490139202,83490139206,4,1516,1246,0
83490814755,83490814735,-20,832,789,0
83491204380,83491204386,6,1734,1306,0
83491607619,83491607621,2,1846,2341,0
83491763938,83491763935,-3,1339,1881,0
83493056120,83493056121,1,1523,1267,0
83496348834,83496348834,0,1353,1722,0
83498166068,83498166070,2,1201,1042,0
83508052569,83508052570,1,1034,1310,0
83512889921,83512889921,0,21505,1826,0
83517158100,83517158097,-3,1064,1660,0
83522437932,83522437930,-2,1371,1958,0
83525344809,83525344810,1,1221,1540,0
83528309256,83528309255,-1,1402,1602,0
83530020548,83530020542,-6,24878,14810,0
83531149040,83531149042,2,1478,1174,0
83533114035,83533114035,0,1132,1677,0
83536458201,83536458199,-2,938,2050,0
83536907118,83536907106,-12,975,1530,0
83538470523,83538470524,1,1029,1877,0
83540483617,83540483619,2,1374,1313,0
83542099162,83542099167,5,3686,3643,0
83543645673,83543645670,-3,1424,3143,0
83545543762,83545543764,2,1727,1793,0
83546027595,83546027596,1,993,1185,0
83546291637,83546291634,-3,31152,14125,0
83546417909,83546417909,0,1047,1530,0
83547215886,83547215885,-1,1836,2275,0
83549281354,83549281356,2,1142,1118,0
83551322702,83551322702,0,1408,2021,0
83552211805,83552211805,0,1574,1479,0
83554594535,83554594542,7,3504,1722,0
83554888730,83554888729,-1,935,1712,0
83556761235,83556761235,0,1913,2405,0
83557388586,83557388586,0,1063,1692,0
83557463196,83557463219,23,692,1157,0
83563764285,83563764285,0,1182,1353,0
83567014690,83567014672,-18,3197,2542,0
83569073851,83569073850,-1,1260,1547,0
83569149689,83569149689,0,1459,1996,0
83570344131,83570344133,2,1489,1627,0
83571165443,83571165442,-1,1004,1089,0
83572607039,83572607041,2,1115,1574,0
83576107110,83576107106,-4,1242,1526,0
83577204704,83577204681,-23,1375,1328,0
83578995219,83578995223,4,1300,1271,0
83580669830,83580669831,1,652,1287,0
83580731122,83580731103,-19,1758,1244,0
83581628905,83581628906,1,1253,1347,0
83583649566,83583649567,1,1675,2048,0
83584859751,83584859753,2,567,1849,0
83586088738,83586088737,-1,1334,1654,0
83587404904,83587404905,1,1587,2574,0
83589980400,83589980401,1,1187,1341,0
83590631942,83590631941,-1,1282,1335,0
83592013414,83592013415,1,1506,1227,0
83593444582,83593444583,1,1505,1394,0
83593988020,83593988022,2,1472,2066,0
83595152517,83595152517,0,1042,1142,0
83597622909,83597622910,1,1588,1361,0
83599249043,83599249043,0,1253,1538,0
83599860191,83599860188,-3,1399,1285,0
83601961342,83601961342,0,1601,2118,0
83603260800,83603260802,2,1065,2053,0
83604174092,83604174090,-2,1612,3868,0
83604717722,83604717721,-1,1662,1982,0
83605557218,83605557218,0,1101,1691,0
83609605553,83609605554,1,1456,1441,0
83611908138,83611908138,0,1693,1404,0
83614405614,83614405613,-1,1300,1729,0
83615604413,83615604413,0,1241,1097,0
83619235839,83619235839,0,1776,2544,0
83621276795,83621276794,-1,1046,1248,0
83621482601,83621482601,0,1631,2102,0
83624769391,83624769393,2,1059,1083,0
83625198011,83625198013,2,1936,1484,0
83626052161,83626052159,-2,915,1851,0
83628466999,83628466999,0,1689,1597,0
83628832115,83628832134,19,772,1048,0
83630838635,83630838634,-1,1324,1383,0
83631777973,83631777974,1,1478,1180,0
83634026493,83634026498,5,5893,3213,0
83634269223,83634269224,1,1400,1471,0
83635128785,83635128786,1,1109,1538,0
83635345965,83635345962,-3,2038,2378,0
83636120218,83636120219,1,1374,2255,0
83636692490,83636692490,0,1709,2126,0
83636875997,83636875999,2,1398,1909,0
83639844941,83639844940,-1,975,1152,0
83640742283,83640742285,2,1423,1841,0
83642355022,83642355023,1,1653,2633,0
83644068675,83644068677,2,1388,929,0
83644260324,83644260325,1,1350,1624,0
83653271768,83653271767,-1,1105,1763,0
83657391176,83657391175,-1,1846,1652,0
83659683805,83659683805,0,1258,1983,0
83660015322,83660015322,0,1052,1683,0
83660775225,83660775225,0,1534,1996,0
83661467236,83661467242,6,3655,1694,0
83662310553,83662310553,0,832,1658,0
83663425680,83663425681,1,1414,2076,0
83663699279,83663699279,0,1086,1913,0
83666121461,83666121461,0,1525,2380,0
83668020559,83668020559,0,1253,1075,0
83669532898,83669532899,1,1285,1575,0
83671508060,83671508060,0,1645,2884,0
83674701086,83674701086,0,1223,1673,0
83675978119,83675978119,0,1652,1647,0
83676125767,83676125767,0,1575,2010,0
83679409999,83679410002,3,651,1189,0
83684873351,83684873353,2,1212,1799,0
83685128822,83685128822,0,1584,1644,0
83685752971,83685752948,-23,494,324,0
83686769908,83686769907,-1,1367,2554,0
83688143067,83688143064,-3,1448,3121,0
83691892785,83691892786,1,1067,1181,0
83692968514,83692968508,-6,1398,7043,0
83694025535,83694025534,-1,1110,1613,0
83694242924,83694242947,23,417,748,0
83695660049,83695660051,2,1222,1453,0
83695843590,83695843589,-1,1771,1532,0
83699377538,83699377537,-1,2121,1865,0
83700034617,83700034617,0,1861,1847,0
83700804186,83700804183,-3,1055,1582,0
83705551419,83705551428,9,1489,1945,0
83706217279,83706217279,0,1736,2259,0
83707948862,83707948862,0,1167,1711,0
83708481658,83708481660,2,982,1357,0
83709306767,83709306764,-3,1053,2313,0
83712334886,83712334886,0,1584,2522,0
83713046371,83713046370,-1,1175,1795,0
83715386646,83715386647,1,1393,1504,0
83722256637,83722256639,2,1298,1386,0
83723350815,83723350815,0,803,1548,0
83723917007,83723917005,-2,886,1965,0
83726001802,83726001803,1,1755,1541,0
83727231898,83727231898,0,1379,1850,0
83727559204,83727559205,1,895,1164,0
83731155785,83731155786,1,2050,2240,0
83733760350,83733760351,1,1486,1461,0
83735096870,83735096870,0,1241,1373,0
83738739678,83738739677,-1,1059,2300,0
83739070664,83739070666,2,1453,1129,0
83740212186,83740212186,0,1685,2530,0
83741646289,83741646291,2,1201,1055,0
83743424195,83743424198,3,51299,52563,0
83747489643,83747489643,0,914,1361,0
83748657881,83748657881,0,1227,1439,0
83753215950,83753215952,2,1001,1535,0
83753737812,83753737811,-1,1496,1986,0
83757753109,83757753110,1,1350,1174,0
83758048646,83758048648,2,1828,1941,0
83759097386,83759097385,-1,1313,1313,0
83760182253,83760182255,2,928,834,0
83761887951,83761887954,3,1621,1081,0
83762835431,83762835424,-7,2900,10596,0
83764636241,83764636243,2,1489,1378,0
83766895201,83766895220,19,1157,1418,0
83768082631,83768082631,0,1395,1314,0
83769544377,83769544377,0,1952,2203,0
83769908198,83769908197,-1,969,1341,0
83772197569,83772197570,1,1018,1265,0
83777516462,83777516461,-1,1365,1855,0
83778396608,83778396608,0,1057,1783,0
83779610877,83779610878,1,2649,2683,0
83781382562,83781382564,2,1447,2177,0
83783721262,83783721261,-1,1475,1796,0
83787218084,83787218084,0,1530,1697,0
83788859700,83788859698,-2,1549,2423,0
83789241482,83789241484,2,1409,1688,0
83789664216,83789664226,10,14687,33722,0
83791550834,83791550834,0,1423,1292,0
83794620385,83794620386,1,1811,1667,0
83800706117,83800706118,1,1246,1519,0
83801593161,83801593161,0,1521,1596,0
83802678537,83802678537,0,770,1166,0
83803211262,83803211263,1,1172,1178,0
83806802814,83806802813,-1,1844,2242,0
83807783678,83807783679,1,1476,1878,0
83809960812,83809960813,1,1440,1820,0
83811153293,83811153286,-7,1060,3055,0
83811537699,83811537698,-1,1297,1921,0
83811768941,83811768941,0,1994,1938,0
83812328384,83812328387,3,925,1371,0
83815166750,83815166750,0,1434,1839,0
83816719654,83816719654,0,1444,2121,0
83819301950,83819301951,1,1250,2120,0
83820697189,83820697194,5,3781,1656,0
83820959600,83820959600,0,1653,1917,0
83825095974,83825095974,0,1333,1270,0
83827727972,83827727971,-1,1522,1477,0
83830075077,83830075080,3,1169,1715,0
83830650679,83830650678,-1,1723,2227,0
83831265858,83831265858,0,1010,1268,0
83831439592,83831439611,19,930,1287,0
83836344229,83836344231,2,1179,1288,0
83836405033,83836405033,0,1102,1475,0
83837658157,83837658159,2,1541,1429,0
83839910694,83839910695,1,1729,1991,0
83842488714,83842488715,1,1097,1432,0
83842986843,83842986853,10,2051,1918,0
83844779089,83844779082,-7,2041,8657,0
83849988023,83849988022,-1,1151,1604,0
83851677537,83851677538,1,1272,2105,0
83852634998,83852634998,0,1289,1057,0
83853938784,83853938786,2,2388,1844,0
83854870154,83854870154,0,1284,1253,0
83855087423,83855087424,1,2100,1820,0
83858906550,83858906549,-1,1294,1948,0
83861238949,83861238950,1,1580,1504,0
83861318746,83861318744,-2,1087,1367,0
83863992895,83863992897,2,1473,1693,0
83864055337,83864055320,-17,1054,1355,0
83868130057,83868130057,0,888,1285,0
83870176503,83870176502,-1,1039,1375,0
83874212075,83874212077,2,1345,2285,0
83875068278,83875068280,2,1659,2559,0
83880561046,83880561049,3,1118,1577,0
83881514869,83881514871,2,1363,1419,0
83884271388,83884271387,-1,1598,1776,0
83884466869,83884466869,0,1392,2046,0
83886421273,83886421274,1,1468,2113,0
83887259715,83887259718,3,2024,1862,0
83889641546,83889641548,2,1677,2058,0
83889938102,83889938104,2,996,1131,0
83890001497,83890001498,1,1450,1898,0
83891661586,83891661588,2,1390,1506,0
83892017927,83892017927,0,1526,2079,0
83894805271,83894805264,-7,30038,15097,0
83895895908,83895895902,-6,2176,8105,0
83897275999,83897275999,0,1350,1707,0
83897837101,83897837101,0,1282,1294,0
83898966750,83898966750,0,1686,1886,0
83899518347,83899518348,1,1067,1203,0
83901828985,83901828986,1,2039,1174,0
83905190035,83905190035,0,1028,1681,0
83905717382,83905717382,0,1474,1346,0
83906441120,83906441121,1,1637,1955,0
83911878393,83911878390,-3,927,2746,0
83921638683,83921638692,9,1156,1115,0
83923654715,83923654708,-7,812,2231,0
83926439697,83926439694,-3,1513,2860,0
83926520792,83926520809,17,1459,1687,0
83926989254,83926989258,4,1988,1423,0
83928959755,83928959757,2,1874,1627,0
83929009898,83929009899,1,2010,1977,0
83932628947,83932628948,1,963,1016,0
83933193346,83933193347,1,1976,2579,0
83933991193,83933991210,17,775,1479,0
83934557939,83934557940,1,1354,1929,0
83935389286,83935389287,1,1003,1223,0
83938331969,83938331969,0,1947,2159,0
83944492173,83944492180,7,11246,44096,0
83944805399,83944805399,0,1167,1640,0
83946349602,83946349616,14,14399,53288,0
83948834162,83948834165,3,1643,1554,0
83959942255,83959942252,-3,1334,1735,0
83960396953,83960396934,-19,1180,1087,0
83960441695,83960441696,1,1556,1494,0
83966639890,83966639891,1,1146,1449,0
83967997403,83967997403,0,1587,1391,0
83970340939,83970340947,8,2830,1319,0
83974464181,83974464179,-2,1588,1775,0
83975713306,83975713304,-2,1428,1442,0
83976303281,83976303282,1,2185,1343,0
83978522689,83978522694,5,1534,1629,0
83979693428,83979693427,-1,1011,705,0
83982086183,83982086186,3,1049,1256,0
83983139648,83983139644,-4,1304,2034,0
83983918614,83983918615,1,1263,1976,0
83985831271,83985831272,1,1202,1479,0
83988925059,83988925058,-1,1696,1439,0
83990990355,83990990354,-1,1424,1925,0
83991600924,83991600924,0,1679,2406,0
83992351762,83992351758,-4,650,1340,0
83992995269,83992995270,1,1493,1703,0
83995047566,83995047565,-1,1234,2663,0
83996878741,83996878744,3,1646,1454,0
84002384902,84002384904,2,1360,1396,0
84005271275,84005271274,-1,751,1101,0
84007531573,84007531572,-1,1316,1388,0
84010024831,84010024830,-1,1231,1550,0
84010360647,84010360646,-1,1428,1516,0
84015892914,84015892915,1,1402,999,0
84017470894,84017470894,0,1233,1706,0
84017632294,84017632294,0,1347,1341,0
84019816371,84019816371,0,189,737,0
84023716403,84023716401,-2,1598,2259,0
84033272142,84033272143,1,1513,2035,0
84034416662,84034416662,0,1373,1606,0
84035486382,84035486383,1,1371,1552,0
84037088070,84037088073,3,2408,1312,0
84037763803,84037763804,1,1212,1980,0
84042072367,84042072367,0,1121,1384,0
84042834370,84042834373,3,1538,1829,0
84044700669,84044700673,4,45671,3580,0
84046208762,84046208762,0,841,1235,0
84047483066,84047483066,0,1195,2054,0
84048433313,84048433314,1,1366,1854,0
84048458678,84048458679,1,1057,1195,0
84048472238,84048472240,2,52,58,0
84049341008,84049341009,1,1418,1999,0
84050273666,84050273667,1,1384,1576,0
84052309986,84052309987,1,1067,1250,0
84053228639,84053228633,-6,1227,1436,0
84053556730,84053556730,0,1471,1687,0
84060723486,84060723485,-1,1826,2036,0
84061762274,84061762274,0,850,1157,0
84062623391,84062623391,0,1691,1652,0
84063581718,84063581720,2,1047,1174,0
84063933306,84063933306,0,1503,2102,0
84064700964,84064700966,2,804,532,0
84066153302,84066153322,20,534,646,0
84068860649,84068860650,1,1641,1764,0
84069257454,84069257449,-5,1336,4437,0
84070580498,84070580497,-1,1186,1540,0
84070721178,84070721178,0,1905,1903,0
84076275949,84076275951,2,1558,2158,0
84077755144,84077755144,0,1360,1575,0
84080271800,84080271801,1,1000,1426,0
84081436986,84081436984,-2,1351,1163,0
84083917110,84083917113,3,1403,1613,0
84084475292,84084475284,-8,2662,13187,0
84089409360,84089409361,1,1279,2120,0
84090939248,84090939249,1,1498,1887,0
84091413067,84091413067,0,865,1092,0
84094333778,84094333778,0,1329,2410,0
84099547883,84099547885,2,1284,1478,0
84099850933,84099850933,0,1547,1694,0
84101352137,84101352137,0,1611,1821,0
84105053536,84105053537,1,2159,2109,0
84106086179,84106086179,0,1143,1781,0
84106716992,84106716989,-3,1623,2043,0
84108212735,84108212736,1,1245,1789,0
84108364063,84108364061,-2,1255,1619,0
84109889083,84109889086,3,1447,1486,0
84110083666,84110083665,-1,986,1772,0
84113950268,84113950267,-1,1795,1703,0
84123309371,84123309370,-1,1151,1733,0
84125028029,84125028032,3,1168,1240,0
84125159816,84125159836,20,969,1534,0
84128075437,84128075437,0,1183,1399,0
84130255296,84130255300,4,20621,41744,0
84130722746,84130722747,1,1123,1569,0
84131376850,84131376850,0,1473,1297,0
84133832018,84133832018,0,1960,1841,0
84134503188,84134503190,2,1726,1701,0
84134940273,84134940274,1,1035,1226,0
84136296866,84136296867,1,1604,1603,0
84136845364,84136845363,-1,1202,2097,0
84137569157,84137569157,0,1771,2614,0
84137834654,84137834654,0,1112,1330,0
84142290774,84142290785,11,1849,1153,0
84145536522,84145536522,0,1374,2306,0
84147551959,84147551957,-2,1461,1806,0
84148431474,84148431474,0,1020,1338,0
84149960771,84149960770,-1,1457,1920,0
84150535151,84150535153,2,1254,2430,0
84152687991,84152687992,1,1155,1394,0
84154936786,84154936786,0,1563,2016,0
84155923373,84155923371,-2,1554,2077,0
84157761566,84157761569,3,1370,1967,0
84159370358,84159370359,1,1219,1375,0
84161592446,84161592446,0,2031,2012,0
84162720635,84162720634,-1,1649,1783,0
84164280824,84164280825,1,1428,1565,0
84165025662,84165025662,0,1325,1410,0
84165440276,84165440275,-1,1891,1293,0
84173186295,84173186295,0,1429,2474,0
84173542870,84173542870,0,1251,1693,0
84175199759,84175199761,2,828,1018,0
84184823886,84184823885,-1,1481,2009,0
84186099926,84186099924,-2,1417,1516,0
84188428436,84188428436,0,1558,2173,0
84188905504,84188905503,-1,2088,2461,0
84189618459,84189618457,-2,896,1722,0
84192977169,84192977175,6,1157,884,0
84194018809,84194018809,0,1120,1791,0
84197104462,84197104469,7,1158,564,0
84197932579,84197932579,0,1393,1705,0
84198249267,84198249269,2,1131,1978,0
84198987326,84198987327,1,2098,2205,0
84207034660,84207034661,1,1521,1662,0
84207284415,84207284418,3,1586,1629,0
84209930834,84209930834,0,1643,1449,0
84210144788,84210144770,-18,1798,1532,0
84215290142,84215290142,0,1476,1487,0
84217051635,84217051640,5,4133,3066,0
84219984180,84219984181,1,1465,2382,0
84220529388,84220529411,23,1577,1319,0
84221331657,84221331658,1,1241,1403,0
84223372418,84223372414,-4,1745,4231,0
84226425392,84226425387,-5,2091,8286,0
84228961578,84228961578,0,1552,1480,0
84231081706,84231081706,0,1078,1460,0
84234767200,84234767201,1,1481,1626,0
84235216602,84235216602,0,1506,1475,0
84238270416,84238270418,2,1260,978,0
84239117693,84239117698,5,5208,3045,0
84240187225,84240187225,0,1039,1844,0
84241667722,84241667723,1,1346,2105,0
84253457562,84253457565,3,1952,1513,0
84257381038,84257381038,0,1469,2085,0
84258251050,84258251050,0,1863,2318,0
84258650933,84258650932,-1,1044,1649,0
84261987379,84261987377,-2,1389,1953,0
84263893188,84263893187,-1,1867,1632,0
84269241783,84269241782,-1,1347,1968,0
84270147414,84270147413,-1,1415,2067,0
84270790710,84270790710,0,1476,1798,0
84288734150,84288734151,1,2228,1707,0
84289390274,84289390272,-2,999,1569,0
84290407167,84290407167,0,908,1413,0
84295050512,84295050511,-1,1163,1309,0
84295955435,84295955435,0,1482,2206,0
84296909207,84296909208,1,1497,2385,0
84299100662,84299100662,0,1127,1387,0
84300161629,84300161630,1,1331,1775,0
84305041043,84305041023,-20,1045,1332,0
84307447165,84307447166,1,1515,2106,0
84310318586,84310318586,0,700,1030,0
84313872366,84313872366,0,1100,1419,0
84314923092,84314923093,1,2309,2317,0
84315510527,84315510527,0,1678,1538,0
84318380939,84318380942,3,1684,1582,0
84320654185,84320654185,0,1269,1251,0
84324504051,84324504050,-1,1224,1600,0
84327460412,84327460411,-1,1288,1643,0
84328519018,84328519017,-1,1708,2133,0
84331079169,84331079171,2,1597,1511,0
84334302048,84334302049,1,1762,1916,0
84335149600,84335149601,1,1474,2351,0
84338006042,84338006042,0,1385,1327,0
84342239927,84342239925,-2,1598,3167,0
84343418046,84343418041,-5,1793,2880,0
84345325414,84345325413,-1,1287,1665,0
84353025914,84353025907,-7,1575,7502,0
84355501795,84355501795,0,822,1529,0
84355812962,84355812958,-4,997,2364,0
84355919588,84355919578,-10,808,1678,0
84357834874,84357834873,-1,1354,2226,0
84358256837,84358256838,1,1680,2233,0
84358290924,84358290923,-1,1348,1870,0
84359743693,84359743695,2,1427,2007,0
84360903155,84360903156,1,890,1044,0
84364616303,84364616303,0,1428,1792,0
84369866163,84369866162,-1,666,995,0
84370955286,84370955286,0,1336,2221,0
84374994402,84374994401,-1,1133,1160,0
84377082517,84377082518,1,976,1732,0
84382887287,84382887300,13,1250,1804,0
84383798667,84383798669,2,1531,1828,0
84384038191,84384038193,2,1340,1906,0
84384160166,84384160166,0,1735,1788,0
84390205396,84390205395,-1,1547,1758,0
84390424042,84390424045,3,1293,1882,0
84392229932,84392229913,-19,1306,2285,0
84397576595,84397576595,0,2020,2279,0
84398206090,84398206090,0,585,774,0
84400365717,84400365714,-3,1392,1949,0
84401528611,84401528613,2,2040,1951,0
84402558393,84402558393,0,1147,1713,0
84406498262,84406498261,-1,1392,1377,0
84408898897,84408898899,2,1375,1457,0
84410858760,84410858761,1,1046,1306,0
84416442094,84416442096,2,1614,1358,0
84419634322,84419634324,2,1276,2099,0
84420533643,84420533642,-1,820,969,0
84425998432,84425998431,-1,1148,1844,0
84427388858,84427388858,0,1083,1723,0
84427765587,84427765588,1,1680,2185,0
84430025677,84430025678,1,1870,2349,0
84432829449,84432829450,1,1084,1887,0
84434586989,84434586989,0,1337,1781,0
84434683442,84434683442,0,1595,1525,0
84435153778,84435153785,7,2919,1325,0
84437407451,84437407458,7,3929,1752,0
84437736976,84437736974,-2,1490,2135,0
84439064022,84439064022,0,1090,2047,0
84439924840,84439924841,1,1849,2565,0
84443908736,84443908736,0,1210,1466,0
84446457776,84446457776,0,1801,1877,0
84447857849,84447857850,1,1056,1379,0
84448190146,84448190145,-1,1682,1168,0
84448241974,84448241977,3,1906,2050,0
84449733929,84449733935,6,2039,1304,0
84450005154,84450005155,1,1177,1122,0
84453095243,84453095244,1,1352,1499,0
84462950478,84462950479,1,1203,1403,0
84463659251,84463659250,-1,1005,1631,0
84464648601,84464648601,0,1270,1253,0
84464980117,84464980117,0,1296,1147,0
84466959732,84466959733,1,1485,1773,0
84477278902,84477278902,0,1309,1905,0
84479599110,84479599110,0,840,1051,0
84480774459,84480774456,-3,1084,2943,0
84481017335,84481017337,2,1432,1440,0
84483111199,84483111201,2,1763,2581,0
84485670038,84485670038,0,1512,1746,0
84485764870,84485764871,1,1062,1762,0
84487365872,84487365873,1,1335,1670,0
84489482439,84489482441,2,2029,2210,0
84494351133,84494351133,0,1412,2211,0
84494716442,84494716442,0,1395,1871,0
84496404706,84496404708,2,1746,1559,0
84497238194,84497238197,3,1468,1409,0
84500123011,84500123009,-2,1366,1951,0
84502005515,84502005516,1,1200,1049,0
84502680538,84502680546,8,10543,23939,0
84504571231,84504571238,7,3929,1468,0
84504938957,84504938959,2,2115,1894,0
84506095133,84506095134,1,1673,2484,0
84507784735,84507784734,-1,1111,1282,0
84509377408,84509377409,1,1339,1548,0
84511427688,84511427690,2,1423,1892,0
84516920989,84516920989,0,1103,1673,0
84520066926,84520066929,3,928,1376,0
84523739761,84523739760,-1,1614,2541,0
84524113562,84524113561,-1,1051,743,0
84525859835,84525859837,2,907,1780,0
84528836881,84528836882,1,1372,1624,0
84530281551,84530281554,3,1322,1673,0
84531824510,84531824510,0,1416,1317,0
84532656153,84532656153,0,1889,1819,0
84533383862,84533383865,3,1192,1842,0
84536192242,84536192246,4,1834,1549,0
84536717662,84536717662,0,1449,1224,0
84538774495,84538774494,-1,1347,1491,0
84539419690,84539419691,1,1419,1693,0
84539821086,84539821082,-4,1252,1483,0
84540926874,84540926875,1,2251,2031,0
84541757020,84541757023,3,1489,1535,0
84542822223,84542822223,0,949,1346,0
84545989965,84545989965,0,1476,1635,0
84546632954,84546632955,1,864,1887,0
84547431535,84547431533,-2,647,1407,0
84548958045,84548958043,-2,1244,1421,0
84552335585,84552335584,-1,1443,1557,0
84554203841,84554203844,3,1338,1738,0
84554305870,84554305866,-4,1860,1763,0
84555916170,84555916170,0,1522,2064,0
84558390519,84558390522,3,4650,3112,0
84561743542,84561743542,0,1758,1522,0
84562199770,84562199778,8,1757,982,0
84564078058,84564078059,1,841,1175,0
84564835610,84564835609,-1,1527,1390,0
84565718717,84565718718,1,1031,1105,0
84567021786,84567021785,-1,1065,1495,0
84567237859,84567237861,2,1408,2565,0
84569246866,84569246865,-1,1662,3178,0
84569795917,84569795918,1,1654,1637,0
84573349445,84573349444,-1,1800,1957,0
84574601456,84574601450,-6,1344,4225,0
84575917745,84575917746,1,1394,1742,0
84577195514,84577195516,2,1650,1912,0
84579420855,84579420858,3,1878,2240,0
84580156337,84580156338,1,1332,1910,0
84581037140,84581037142,2,1180,1345,0
84582611370,84582611371,1,1693,2631,0
84583548844,84583548842,-2,1362,1866,0
84584692262,84584692261,-1,1415,1861,0
84585434936,84585434933,-3,1196,3078,0
84586942607,84586942608,1,1503,2038,0
84590606661,84590606665,4,1156,1097,0
84591649790,84591649795,5,1819,1753,0
84591960807,84591960804,-3,979,1507,0
84593637199,84593637199,0,971,1536,0
84595607165,84595607164,-1,1447,1979,0
84595676839,84595676838,-1,1874,2254,0
84598862877,84598862878,1,1069,1437,0
84600220267,84600220268,1,2025,2118,0
84600966838,84600966834,-4,863,1071,0
84605771150,84605771151,1,1075,1604,0
84606971757,84606971758,1,1303,1497,0
84607302671,84607302671,0,1763,2032,0
84609335117,84609335118,1,2146,2390,0
84611693450,84611693448,-2,1433,2917,0
84613621883,84613621881,-2,898,1758,0
84616036821,84616036822,1,1166,1484,0
84617092921,84617092918,-3,1135,1575,0
84617840321,84617840317,-4,18892,18478,0
84618029613,84618029611,-2,1211,1701,0
84619110481,84619110480,-1,1491,1942,0
84620020341,84620020341,0,1147,1429,0
84621783822,84621783822,0,1293,1852,0
84622304863,84622304881,18,738,2800,0
84624801355,84624801354,-1,956,1144,0
84625340194,84625340199,5,2172,1379,0
84628032601,84628032601,0,1628,2716,0
84628386225,84628386226,1,2394,2595,0
84628555450,84628555451,1,1199,1439,0
84632100452,84632100450,-2,1601,1890,0
84632574542,84632574543,1,1484,2238,0
84633078598,84633078598,0,1213,1815,0
84634933143,84634933144,1,1073,2029,0
84635512563,84635512562,-1,1102,1539,0
84637071339,84637071338,-1,1630,2050,0
84638657900,84638657903,3,2574,2190,0
84639327988,84639327987,-1,1749,1232,0
84642709201,84642709210,9,12941,32269,0
84645150058,84645150058,0,1643,2063,0
84646585914,84646585914,0,1329,1536,0
84649698243,84649698244,1,1035,1251,0
84650602120,84650602120,0,824,1467,0
84655037978,84655037978,0,1415,1570,0
84656605440,84656605461,21,1550,1740,0
84657372005,84657372007,2,1551,1714,0
84658459025,84658459026,1,1273,1685,0
84659225607,84659225623,16,701,1901,0
84660501597,84660501598,1,2352,2128,0
84660580915,84660580917,2,804,1861,0
84660865205,84660865207,2,1742,2059,0
84660905810,84660905810,0,1158,1901,0
84662295619,84662295626,7,2636,1517,0
84666352278,84666352279,1,1504,1741,0
84670730178,84670730179,1,1276,2170,0
84674715968,84674715966,-2,1252,1763,0
84674919925,84674919926,1,1304,1539,0
84681140266,84681140267,1,1592,1547,0
84684305437,84684305439,2,1332,1359,0
84685436234,84685436246,12,1466,1524,0
84686098623,84686098643,20,907,2049,0
84686535822,84686535821,-1,1276,2035,0
84687698041,84687698042,1,1291,1390,0
84687864290,84687864288,-2,1219,2066,0
84690267404,84690267404,0,1312,2262,0
84690398753,84690398755,2,1631,1406,0
84692461781,84692461780,-1,1527,1490,0
84692602883,84692602882,-1,1217,1791,0
84694173359,84694173361,2,1482,1474,0
84695970269,84695970271,2,1314,1742,0
84704707833,84704707834,1,1361,1298,0
84705731688,84705731671,-17,1370,596,0
84709101371,84709101372,1,2488,2789,0
84712016478,84712016475,-3,1239,1771,0
84717918158,84717918153,-5,1115,1410,0
84718979041,84718979040,-1,1741,2530,0
84722800345,84722800342,-3,1397,2603,0
84728333960,84728333960,0,1579,2336,0
84729851059,84729851060,1,1421,1574,0
84730471478,84730471478,0,1338,1971,0
84731523573,84731523575,2,2089,2182,0
84733419483,84733419483,0,1208,2010,0
84734711637,84734711641,4,1876,1441,0
84736031910,84736031893,-17,341,2052,0
84738845459,84738845460,1,1543,1384,0
84740676911,84740676911,0,1174,1273,0
84741728974,84741728975,1,1680,1382,0
84743870926,84743870927,1,1101,1410,0
84745821305,84745821307,2,1470,1422,0
84746236302,84746236302,0,978,1576,0
84748212029,84748212030,1,1576,2039,0
84752009399,84752009398,-1,1671,889,0
84755728123,84755728123,0,1331,2061,0
84758086212,84758086210,-2,1245,1686,0
84760777822,84760777822,0,1259,1983,0
84763183572,84763183570,-2,1144,1286,0
84764558737,84764558739,2,1492,994,0
84767978151,84767978156,5,4736,1425,0
84770174168,84770174169,1,1409,1559,0
84770583929,84770583928,-1,1387,1535,0
84773973678,84773973678,0,1073,2054,0
84774871193,84774871194,1,1686,1534,0
84775703594,84775703595,1,1143,1716,0
84777042578,84777042576,-2,1074,1941,0
84778099619,84778099618,-1,1144,1816,0
84779017739,84779017741,2,1088,1545,0
84784302910,84784302909,-1,1153,1240,0
84786463631,84786463631,0,957,1339,0
84788446354,84788446354,0,1451,2180,0
84790335913,84790335914,1,1562,149,0
84790634621,84790634617,-4,1423,2913,0
84791007345,84791007345,0,1454,1496,0
84792470209,84792470206,-3,1469,2121,0
84792695614,84792695614,0,1747,1752,0
84793218882,84793218882,0,1214,1757,0
84794379861,84794379866,5,5733,29451,0
84795629320,84795629322,2,1473,2115,0
84799546371,84799546362,-9,1053,8577,0
84800176323,84800176325,2,1535,1564,0
84801430308,84801430301,-7,2673,8124,0
84805066596,84805066596,0,1095,1602,0
84809708310,84809708311,1,1322,1410,0
84810211950,84810211947,-3,1174,2310,0
84810437175,84810437173,-2,772,1435,0
84811550225,84811550231,6,5054,1848,0
84813689078,84813689078,0,1691,1539,0
84813864065,84813864068,3,1417,1700,0
84817940513,84817940514,1,1072,1756,0
84821466442,84821466444,2,1136,2314,0
84822998112,84822998114,2,1296,1503,0
84823962792,84823962793,1,2333,2645,0
84824591442,84824591443,1,1190,2082,0
84825465549,84825465549,0,1718,1927,0
84828035696,84828035697,1,2171,2337,0
84832789494,84832789496,2,1208,1841,0
84833015610,84833015609,-1,1476,1971,0
84834587565,84834587566,1,1357,1622,0
84838620753,84838620753,0,1266,1773,0
84842128962,84842128965,3,1283,1762,0
84842977130,84842977130,0,921,1485,0
84848100707,84848100708,1,1343,1724,0
84849937891,84849937893,2,1591,1445,0
84853983246,84853983245,-1,1280,1504,0
84855127146,84855127148,2,1510,1991,0
84858059605,84858059607,2,1726,2006,0
84860777522,84860777520,-2,1043,1378,0
84861316392,84861316378,-14,1142,1919,0
84862622923,84862622917,-6,53671,23208,0
84867332998,84867332996,-2,1614,1667,0
84867856485,84867856487,2,1352,1106,0
84872206736,84872206737,1,1465,1431,0
84874573811,84874573813,2,1190,1609,0
84875604407,84875604409,2,1264,1337,0
84879215929,84879215929,0,1246,1337,0
84883955997,84883955999,2,1595,1835,0
84892564401,84892564401,0,1018,1511,0
84893519733,84893519722,-11,1194,1542,0
84897096125,84897096125,0,1472,1219,0
84906026302,84906026303,1,900,1066,0
84912643743,84912643745,2,6600,20297,0
84917416018,84917416023,5,2410,1061,0
84919310566,84919310566,0,1828,2198,0
84919455999,84919456000,1,1149,1890,0
84920600982,84920600987,5,1439,1216,0
84923356775,84923356775,0,1256,1384,0
84924953280,84924953281,1,1329,1734,0
84926451782,84926451784,2,1442,1933,0
84930670767,84930670768,1,1210,1848,0
84930706741,84930706763,22,1661,1352,0
84936414084,84936414083,-1,1423,2162,0
84936531131,84936531131,0,1620,1858,0
84938642067,84938642065,-2,1661,2487,0
84940393793,84940393793,0,1541,2335,0
84942360737,84942360738,1,1536,1623,0
84944937088,84944937088,0,1446,1918,0
84953683169,84953683171,2,720,1552,0
84957639419,84957639419,0,706,912,0
84958235638,84958235639,1,1465,1611,0
84960172193,84960172193,0,32083,39149,0
84960759846,84960759846,0,1192,1447,0
84961082482,84961082483,1,1370,1753,0
84963390502,84963390502,0,1465,1620,0
84964369676,84964369693,17,503,713,0
84972471602,84972471603,1,6045,9070,0
84973373322,84973373315,-7,2335,9991,0
84978708513,84978708513,0,1631,2565,0
84978839150,84978839150,0,1110,1337,0
84979691234,84979691234,0,1558,1764,0
84982267718,84982267714,-4,3813,10069,0
84982472708,84982472709,1,1315,2182,0
84983348051,84983348049,-2,1375,1438,0
84985455689,84985455690,1,1887,1984,0
84987929455,84987929454,-1,1197,1685,0
84991120415,84991120416,1,1188,1172,0
84992874953,84992874935,-18,1244,1802,0
84994178661,84994178663,2,1517,1936,0
84996857575,84996857580,5,7077,35493,0
85000140322,85000140322,0,1231,1291,0
85001936542,85001936542,0,1549,1487,0
85005795099,85005795101,2,1049,1402,0
85006223182,85006223183,1,1247,1361,0
85008144051,85008144051,0,1254,2066,0
85009159811,85009159813,2,1295,1736,0
85010096511,85010096510,-1,1277,1297,0
85014204159,85014204157,-2,1169,1630,0
85015288205,85015288206,1,1783,1921,0
85016926746,85016926747,1,1620,1807,0
85021310974,85021310975,1,1479,2733,0
85021795639,85021795641,2,2292,2043,0
85024201321,85024201320,-1,1224,1821,0
85028747570,85028747570,0,1707,1747,0
85034295629,85034295630,1,1470,1648,0
85036434483,85036434481,-2,1400,1596,0
85037559367,85037559367,0,888,1211,0
85040955005,85040954995,-10,874,4664,0
85045633741,85045633741,0,2202,1636,0
85049970662,85049970663,1,1233,1249,0
85052616837,85052616835,-2,782,2302,0
85052810358,85052810357,-1,1428,1627,0
85054195682,85054195684,2,1178,2114,0
85058223386,85058223388,2,1287,1631,0
85059189294,85059189295,1,935,1332,0
85071013363,85071013361,-2,1562,1957,0
85071971663,85071971665,2,1127,1431,0
85077221175,85077221175,0,1046,1066,0
85077631823,85077631824,1,993,1725,0
85078106698,85078106698,0,1452,1403,0
85080241910,85080241914,4,1253,560,0
85083246163,85083246167,4,2083,1245,0
85087081073,85087081074,1,1730,1482,0
85091874246,85091874246,0,1449,1631,0
85092501009,85092501008,-1,1162,1970,0
85097845231,85097845230,-1,1253,1087,0
85098942628,85098942628,0,1769,2268,0
85099489362,85099489358,-4,1468,2327,0
85099889590,85099889590,0,1482,1631,0
85100524169,85100524173,4,3839,2756,0
85101876135,85101876134,-1,2253,2384,0
85102247170,85102247174,4,1026,1205,0
85102311279,85102311276,-3,791,1301,0
85106364642,85106364643,1,1614,2068,0
85107657246,85107657246,0,2688,2517,0
85111295743,85111295733,-10,1623,1856,0
85116144982,85116144983,1,1898,1610,0
85117600066,85117600071,5,2072,1595,0
85117846343,85117846345,2,1101,1738,0
85123676302,85123676303,1,1669,1407,0
85126809286,85126809290,4,2418,1228,0
85127174549,85127174549,0,1461,1833,0
85130356986,85130356987,1,2117,2993,0
85130624806,85130624805,-1,1462,1536,0
85131619289,85131619288,-1,1710,1521,0
85132716522,85132716522,0,1439,1755,0
85133552623,85133552625,2,965,1608,0
85133943806,85133943806,0,1509,1679,0
85134490457,85134490459,2,851,1228,0
85135639275,85135639275,0,1086,1405,0
85138000018,85138000021,3,738,1168,0
85144668818,85144668818,0,1027,1657,0
85145859315,85145859319,4,2147,1002,0
85150207906,85150207904,-2,1300,1736,0
85152369586,85152369588,2,1020,1674,0
85153415450,85153415456,6,14739,31991,0
85154801438,85154801438,0,441,713,0
85157820051,85157820053,2,1165,1424,0
85158263802,85158263803,1,1345,1320,0
85161254973,85161254972,-1,1187,1316,0
85161434528,85161434525,-3,1680,2454,0
85161879960,85161879961,1,1660,1988,0
85166495061,85166495062,1,1398,1908,0
85170876874,85170876864,-10,6943,518,0
85171579970,85171579971,1,1001,1480,0
85179296198,85179296199,1,1542,1923,0
85184906255,85184906253,-2,1066,1279,0
85186433404,85186433402,-2,1927,2474,0
85187062247,85187062249,2,1430,1563,0
85188989063,85188989065,2,1624,1381,0
85189349247,85189349246,-1,1326,1824,0
85192500330,85192500329,-1,1552,1911,0
85193052745,85193052743,-2,1023,1211,0
85195494534,85195494535,1,1219,1910,0
85195960632,85195960635,3,1616,1714,0
85199240709,85199240710,1,1390,1497,0
85199274415,85199274430,15,1780,1258,0
85203094211,85203094209,-2,1217,2093,0
85203390941,85203390941,0,1321,1768,0
85211246413,85211246415,2,1429,1250,0
85214528474,85214528478,4,1256,1643,0
85218035415,85218035414,-1,810,1779,0
85218916079,85218916077,-2,1780,2220,0
85220279029,85220279030,1,1326,1777,0
85221490401,85221490402,1,1720,2071,0
85221911594,85221911595,1,1708,2276,0
85225083095,85225083096,1,1401,1403,0
85227151906,85227151906,0,1815,2284,0
85230173150,85230173149,-1,1630,1342,0
85231475470,85231475470,0,1733,1834,0
85235574313,85235574318,5,3208,1278,0
85236904525,85236904525,0,2016,1796,0
85239123147,85239123125,-22,802,364,0
85241315574,85241315574,0,1304,1270,0
85242311683,85242311682,-1,1399,2251,0
85245312534,85245312533,-1,1472,2120,0
85245808785,85245808786,1,1382,1444,0
85252054571,85252054572,1,1562,2232,0
85254945099,85254945101,2,965,1372,0
85258396517,85258396517,0,1055,2009,0
85261984494,85261984491,-3,978,1713,0
85262606146,85262606147,1,890,1380,0
85263066965,85263066965,0,1209,1615,0
85268294592,85268294610,18,817,1146,0
85270937550,85270937551,1,1313,1506,0
85271026590,85271026587,-3,1013,1821,0
85275472955,85275472955,0,2405,1947,0
85276143221,85276143232,11,1676,2004,0
85276364910,85276364914,4,1873,1165,0
85279302983,85279302982,-1,1559,1387,0
85280678650,85280678651,1,966,1307,0
85291727089,85291727090,1,1796,2464,0
85291761501,85291761507,6,3422,1682,0
85293031288,85293031289,1,1499,1767,0
85299397594,85299397594,0,1396,1512,0
85302353344,85302353345,1,1610,2158,0
85303094645,85303094646,1,758,1145,0
85305688658,85305688659,1,1503,1465,0
85306712846,85306712850,4,1744,2027,0
85309236482,85309236468,-14,1069,1348,0
85312825489,85312825489,0,1125,1309,0
85313951753,85313951753,0,1217,1926,0
85315965324,85315965324,0,1176,1668,0
85317349755,85317349755,0,834,1516,0
85323289426,85323289425,-1,805,1610,0
85325302005,85325301999,-6,2038,6292,0
85328344360,85328344358,-2,1067,2294,0
85332408261,85332408263,2,1161,1646,0
85335319445,85335319442,-3,1586,2460,0
85339284822,85339284823,1,1533,1891,0
85340520114,85340520094,-20,1542,1811,0
85341078746,85341078747,1,2082,2407,0
85341308765,85341308766,1,1307,1770,0
85342167954,85342167954,0,859,1377,0
85344839970,85344839971,1,1210,1796,0
85345621639,85345621640,1,1340,1644,0
85349358078,85349358079,1,1753,1711,0
85354299303,85354299300,-3,1168,2291,0
85354940154,85354940153,-1,1141,2169,0
85358236457,85358236456,-1,1540,2115,0
85359412694,85359412694,0,1337,1522,0
85360834974,85360834974,0,1009,1825,0
85361149568,85361149567,-1,1371,2542,0
85361928150,85361928150,0,1072,1323,0
85362435367,85362435361,-6,1532,1811,0
85364944143,85364944143,0,914,1162,0
85368858611,85368858611,0,1199,1379,0
85371459871,85371459866,-5,905,2008,0
85371963717,85371963717,0,1313,1583,0
85373949231,85373949233,2,2078,1661,0
85375273866,85375273867,1,1418,2224,0
85382755643,85382755638,-5,1366,3026,0
85386484038,85386484039,1,1331,2527,0
85389069209,85389069207,-2,1212,1615,0
85390455309,85390455311,2,1203,1958,0
85395428825,85395428826,1,1437,1409,0
85396187050,85396187050,0,1534,1892,0
85398566609,85398566610,1,1286,1731,0
85398613528,85398613546,18,1515,1790,0
85401868825,85401868824,-1,1118,1962,0
85403004335,85403004337,2,1401,1499,0
85404796530,85404796530,0,1356,1769,0
85405252423,85405252425,2,996,1521,0
85406908599,85406908599,0,1279,1685,0
85409640106,85409640106,0,2156,2398,0
85411391506,85411391506,0,1266,2331,0
85415104503,85415104502,-1,1025,1343,0
85415170725,85415170726,1,1803,2019,0
85416120198,85416120198,0,1215,1649,0
85416889375,85416889374,-1,1545,1079,0
85417382857,85417382856,-1,1773,1997,0
85418216713,85418216714,1,1715,2424,0
85434291557,85434291552,-5,570,1879,0
85434579835,85434579836,1,2427,2514,0
85435444478,85435444478,0,1800,1665,0
85436156030,85436156030,0,1058,1971,0
85443145353,85443145353,0,1099,1469,0
85451827983,85451827964,-19,1414,1505,0
85454731298,85454731299,1,1456,1600,0
85454823777,85454823775,-2,1516,1766,0
85454952778,85454952780,2,1340,1416,0
85457522441,85457522441,0,1843,2412,0
85459241314,85459241314,0,1090,1115,0
85461109539,85461109538,-1,1571,1666,0
85464740102,85464740106,4,1685,1424,0
85466895463,85466895463,0,1219,1931,0
85467492603,85467492602,-1,961,1207,0
85470127098,85470127099,1,1324,1937,0
85472364858,85472364859,1,1947,2334,0
85478836922,85478836924,2,1131,1757,0
85482627057,85482627057,0,2010,3155,0
85483495110,85483495110,0,1482,1461,0
85484188909,85484188910,1,1695,1740,0
85484521982,85484521982,0,1445,2503,0
85485386925,85485386926,1,876,1353,0
85489472575,85489472577,2,2177,1934,0
85492829323,85492829322,-1,1948,2668,0
85494249162,85494249162,0,1794,2650,0
85496475840,85496475838,-2,1144,2161,0
85499891948,85499891948,0,1907,2192,0
85501678499,85501678499,0,1554,2365,0
85503819378,85503819379,1,2107,2012,0
85504309446,85504309448,2,1579,1893,0
85504950146,85504950148,2,1456,1839,0
85506918665,85506918667,2,1306,1291,0
85511512137,85511512141,4,2095,1151,0
85512384995,85512384995,0,1130,1035,0
85512988902,85512988881,-21,1859,2415,0
85513712237,85513712234,-3,1065,1512,0
85522637931,85522637934,3,908,980,0
85524742880,85524742881,1,1585,1825,0
85525732983,85525732983,0,1707,1839,0
85529314645,85529314647,2,1110,1689,0
85530427026,85530427027,1,1065,1081,0
85534320919,85534320913,-6,1950,6620,0
85534596421,85534596419,-2,1182,1525,0
85535406997,85535406995,-2,1715,1946,0
85535746973,85535746971,-2,1216,1948,0
85538126239,85538126238,-1,872,1248,0
85545559389,85545559395,6,36077,30829,0
85546817411,85546817410,-1,1260,1717,0
85552096954,85552096954,0,1175,2618,0
85552731786,85552731785,-1,1219,1739,0
85553235431,85553235430,-1,1751,2216,0
85557312235,85557312235,0,2085,2261,0
85557650730,85557650729,-1,1568,2878,0
85559923834,85559923833,-1,1184,1323,0
85561082993,85561082993,0,1612,1911,0
85561280558,85561280559,1,1511,1757,0
85566266091,85566266091,0,1470,1268,0
85566913596,85566913596,0,1022,1144,0
85568201706,85568201706,0,1193,2173,0
85569835171,85569835173,2,1335,1917,0
85573064810,85573064809,-1,999,860,0
85575176690,85575176691,1,703,691,0
85576708022,85576708022,0,1414,1539,0
85576801902,85576801903,1,993,1209,0
85578064435,85578064435,0,1435,1531,0
85581357417,85581357417,0,1611,1824,0
85583110343,85583110346,3,895,1643,0
85589240235,85589240235,0,1361,2009,0
85592260090,85592260091,1,1326,1714,0
85593526391,85593526391,0,956,1117,0
85597056742,85597056743,1,1423,2030,0
85598056915,85598056917,2,1014,1179,0
85599174085,85599174086,1,1070,1482,0
85600726404,85600726406,2,1391,2834,0
85601010527,85601010527,0,937,760,0
85602595666,85602595669,3,1462,1339,0
85607124275,85607124273,-2,817,1777,0
85608339930,85608339931,1,1266,1847,0
85614593406,85614593406,0,1182,1664,0
85614827931,85614827933,2,1368,1118,0
85615611426,85615611427,1,1624,1723,0
85619184579,85619184581,2,1891,1970,0
85619436610,85619436609,-1,1654,1273,0
85619476959,85619476957,-2,1183,1888,0
85620926326,85620926326,0,1514,1638,0
85626431916,85626431924,8,5983,1123,0
85631485086,85631485087,1,1843,1671,0
85633893765,85633893763,-2,1124,1821,0
85634813030,85634813030,0,1154,1816,0
85635676913,85635676914,1,1194,1470,0
85638405621,85638405622,1,1070,1493,0
85643316515,85643316515,0,1047,1849,0
85654762268,85654762269,1,1204,1297,0
85655839400,85655839403,3,5256,2689,0
85656017462,85656017462,0,1191,1264,0
85657286749,85657286756,7,10443,42065,0
85657817469,85657817470,1,1601,1937,0
85660545482,85660545483,1,1542,1727,0
85661651920,85661651920,0,1085,1303,0
85668333593,85668333591,-2,1176,1365,0
85669112266,85669112266,0,1115,1023,0
85673828909,85673828910,1,1356,1193,0
85674531734,85674531735,1,1545,2093,0
85677833526,85677833524,-2,854,2110,0
85679980238,85679980234,-4,1015,1400,0
85680283710,85680283709,-1,1335,1710,0
85682805070,85682805066,-4,1353,2259,0
85684456692,85684456692,0,1672,2548,0
85685017706,85685017703,-3,914,1835,0
85688667643,85688667640,-3,1039,1482,0
85688952260,85688952262,2,1261,1867,0
85694568283,85694568285,2,1396,1294,0
85695725582,85695725591,9,1658,1635,0
85696415311,85696415317,6,2237,1430,0
85698591348,85698591350,2,769,1206,0
85699268633,85699268634,1,1564,2005,0
85701253891,85701253890,-1,937,965,0
85703726450,85703726453,3,1956,1996,0
85704095353,85704095350,-3,931,1136,0
85708874890,85708874891,1,1735,1369,0
85710025963,85710025969,6,2873,1989,0
85712399990,85712399991,1,1457,1685,0
85714728358,85714728358,0,1286,1356,0
85717319202,85717319202,0,1022,1514,0
85718377284,85718377305,21,793,773,0
85719763769,85719763767,-2,1317,1884,0
85723204906,85723204906,0,1468,1801,0
85728243959,85728243962,3,1740,1466,0
85730038950,85730038949,-1,976,1728,0
85731512787,85731512789,2,1550,1802,0
85732093760,85732093779,19,367,834,0
85733397164,85733397166,2,1209,1645,0
85738432226,85738432225,-1,1467,1918,0
85743276756,85743276758,2,1271,1361,0
85743372653,85743372654,1,1278,1293,0
85743438456,85743438457,1,1955,2330,0
85748921821,85748921814,-7,2286,6165,0
85750173902,85750173901,-1,1702,1996,0
85751850581,85751850585,4,1590,871,0
85755158617,85755158616,-1,1288,1987,0
85759474259,85759474259,0,1226,2197,0
85765082950,85765082950,0,1542,2046,0
85771510402,85771510401,-1,1573,1368,0
85772997914,85772997911,-3,2184,3326,0
85776933624,85776933626,2,1400,1618,0
85778029273,85778029275,2,1127,1357,0
85778997935,85778997937,2,2196,2127,0
85779467220,85779467221,1,1171,1648,0
85780492622,85780492622,0,1141,1095,0
85783188341,85783188341,0,1860,2692,0
85786159890,85786159885,-5,1413,2860,0
85788110057,85788110057,0,1402,1909,0
85789749998,85789749999,1,1404,1545,0
85794504753,85794504753,0,3130,3557,0
85799584890,85799584890,0,941,1379,0
85802695178,85802695178,0,1617,1795,0
85804903922,85804903918,-4,1092,1688,0
85805793222,85805793223,1,1188,2581,0
85806612220,85806612219,-1,1211,1710,0
85807687553,85807687554,1,1293,1624,0
85807721321,85807721321,0,1715,2010,0
85808469222,85808469222,0,1412,1486,0
85809173993,85809173993,0,2074,2042,0
85809606941,85809606941,0,973,741,0
85810165070,85810165070,0,1637,1178,0
85813314278,85813314277,-1,1166,1836,0
85813683057,85813683057,0,1905,1778,0
85818222089,85818222088,-1,1424,2029,0
85827605129,85827605114,-15,764,1391,0
85829511526,85829511527,1,1439,1797,0
85832054999,85832054999,0,1167,1706,0
85832749458,85832749460,2,1589,1542,0
85838159787,85838159779,-8,17534,14840,0
85841827747,85841827746,-1,1441,2277,0
85842164337,85842164339,2,1762,1721,0
85844009333,85844009336,3,970,357,0
85844264261,85844264251,-10,1141,2627,0
85845710586,85845710587,1,1270,1970,0
85848938589,85848938584,-5,978,2986,0
85850442687,85850442687,0,925,1861,0
85852490009,85852490010,1,1095,1962,0
85853049376,85853049382,6,8,1903,0
85856069389,85856069390,1,2111,1771,0
85860089041,85860089045,4,2197,1209,0
85864475598,85864475619,21,1157,1363,0
85869618226,85869618225,-1,1211,2218,0
85875597781,85875597782,1,1449,1985,0
85881665855,85881665858,3,1770,1482,0
85881724415,85881724413,-2,1364,1678,0
85883390569,85883390567,-2,1504,1747,0
85883672306,85883672307,1,1061,1363,0
85885688617,85885688616,-1,1817,1643,0
85886316097,85886316098,1,1006,1873,0
85886818646,85886818650,4,1269,1543,0
85891510133,85891510133,0,1135,1321,0
85895512994,85895512994,0,1899,1502,0
85898753597,85898753597,0,1774,1918,0
85899324509,85899324510,1,1838,1930,0
85903101469,85903101469,0,1398,1724,0
85903822570,85903822569,-1,1422,1045,0
85905532949,85905532949,0,913,702,0
85908059897,85908059898,1,949,1126,0
85912646608,85912646609,1,2283,1338,0
85913363262,85913363269,7,1060,1387,0
85914383982,85914383984,2,1557,1725,0
85914968661,85914968663,2,1443,2150,0
85916578381,85916578382,1,1374,1494,0
85919395863,85919395858,-5,20110,13640,0
85923055711,85923055713,2,2537,2029,0
85924164711,85924164713,2,988,1150,0
85931260169,85931260169,0,1158,1939,0
85931908826,85931908821,-5,4695,12312,0
85932617593,85932617594,1,1265,1605,0
85933002681,85933002680,-1,1701,1972,0
85934574261,85934574262,1,922,1683,0
85936088609,85936088611,2,1191,1411,0
85939201187,85939201189,2,1656,1599,0
85939325350,85939325353,3,1730,1552,0
85939782399,85939782402,3,974,1494,0
85941244322,85941244325,3,1314,1476,0
85943937126,85943937126,0,1086,1048,0
85945033730,85945033730,0,2115,2670,0
85945296176,85945296174,-2,1717,1595,0
85949400648,85949400638,-10,52,1826,0
85949629177,85949629176,-1,1070,1225,0
85950500027,85950500013,-14,931,1505,0
85951098434,85951098434,0,1509,1575,0
85952585058,85952585056,-2,1479,2570,0
85953308646,85953308646,0,1371,2524,0
85956569075,85956569076,1,1092,1553,0
85957500586,85957500586,0,1344,1715,0
85961754018,85961754019,1,1661,1731,0
85962360251,85962360254,3,1374,1761,0
85969841564,85969841566,2,1429,1556,0
85971463310,85971463316,6,1483,1661,0
85973491995,85973491992,-3,1012,1655,0
85974305678,85974305681,3,1670,1739,0
85975422619,85975422618,-1,1199,1170,0
85976359232,85976359231,-1,1430,1552,0
85982970102,85982970104,2,860,1226,0
85987356266,85987356266,0,1469,1809,0
85989535990,85989535991,1,1029,1294,0
85993181388,85993181393,5,2410,1570,0
85998333906,85998333906,0,1272,1939,0
86000999722,86000999725,3,1339,1162,0
86005463281,86005463283,2,1531,1925,0
86007100418,86007100414,-4,1527,6935,0
86008048379,86008048380,1,1379,2168,0
86008431461,86008431459,-2,1095,1841,0
86009071405,86009071407,2,1554,740,0
86009990465,86009990470,5,1147,1769,0
86011175735,86011175731,-4,894,3282,0
86014610816,86014610816,0,1538,2191,0
86016854733,86016854733,0,1597,2303,0
86023227746,86023227748,2,1340,2503,0
86028874444,86028874443,-1,995,1492,0
86029040296,86029040296,0,1699,1308,0
86029944371,86029944371,0,985,1071,0
86031202360,86031202359,-1,837,1289,0
86033051416,86033051417,1,1166,1182,0
86034888517,86034888518,1,1762,2266,0
86038221030,86038221030,0,1301,2219,0
86039463701,86039463702,1,1506,1591,0
86039869630,86039869629,-1,1280,1901,0
86042079241,86042079238,-3,1058,1494,0
86044755961,86044755959,-2,868,1134,0
86050771403,86050771404,1,1960,1441,0
86051504834,86051504836,2,1556,1160,0
86053255655,86053255654,-1,1282,2176,0
86067780845,86067780844,-1,1270,1547,0
86068353998,86068353998,0,1310,1549,0
86072279141,86072279142,1,1479,2092,0
86072370797,86072370798,1,974,1580,0
86072852244,86072852266,22,1676,2678,0
86074459991,86074459991,0,1450,1715,0
86076230716,86076230712,-4,1402,2768,0
86077997664,86077997665,1,1377,1765,0
86080886525,86080886527,2,1461,1903,0
86081782674,86081782674,0,1440,1589,0
86082010411,86082010411,0,1574,2265,0
86086333447,86086333447,0,1421,1695,0
86088172198,86088172198,0,1169,1815,0
86089946583,86089946585,2,1174,1446,0
86094273291,86094273290,-1,981,1514,0
86098622805,86098622802,-3,1368,1515,0
86100588822,86100588824,2,20548,28406,0
86101365463,86101365465,2,1672,1452,0
86103709223,86103709225,2,642,1361,0
86104763761,86104763762,1,1501,1881,0
86106715395,86106715395,0,1154,1796,0
86107847305,86107847304,-1,951,1622,0
86108398379,86108398381,2,944,1730,0
86112557426,86112557428,2,1165,1139,0
86113295116,86113295115,-1,1525,1843,0
86113374806,86113374807,1,1123,1553,0
86121815082,86121815084,2,972,1419,0
86121981373,86121981373,0,1271,2621,0
86122734802,86122734802,0,1428,1734,0
86123752586,86123752582,-4,1535,3941,0
86124394232,86124394231,-1,1444,1777,0
86125131495,86125131497,2,1357,1183,0
86125682287,86125682286,-1,1632,1981,0
86126128575,86126128582,7,5857,2438,0
86126711954,86126711955,1,1868,1536,0
86136264938,86136264938,0,846,1289,0
86137466626,86137466627,1,1274,2197,0
86137863530,86137863530,0,1701,1323,0
86138229842,86138229843,1,1289,1588,0
86141442962,86141442964,2,850,2123,0
86142768801,86142768781,-20,1349,1515,0
86143108451,86143108451,0,1698,2015,0
86143566371,86143566371,0,1499,2224,0
86144938405,86144938403,-2,1370,1196,0
86146562530,86146562530,0,14411,17213,0
86146852623,86146852622,-1,987,1926,0
86148384322,86148384323,1,1128,1689,0
86150395487,86150395486,-1,942,1202,0
86152792030,86152792032,2,1146,1404,0
86153700916,86153700918,2,1388,1431,0
86157123031,86157123030,-1,713,1020,0
86158006066,86158006066,0,1159,1031,0
86159055455,86159055456,1,1277,1127,0
86161801463,86161801462,-1,1168,1968,0
86163791367,86163791365,-2,1239,2021,0
86166901826,86166901829,3,1313,2045,0
86167874942,86167874942,0,1291,1542,0
86169306642,86169306643,1,902,1361,0
86169435973,86169435963,-10,1665,1496,0
86171089938,86171089938,0,1969,1778,0
86171194241,86171194242,1,1726,2722,0
86175055290,86175055293,3,907,1379,0
86180241830,86180241830,0,1531,1976,0
86180678654,86180678655,1,1507,1652,0
86181474077,86181474081,4,3850,2062,0
86183274007,86183274006,-1,1327,1450,0
86185053327,86185053321,-6,1910,3404,0
86185133554,86185133555,1,1739,1777,0
86190068130,86190068130,0,1936,3431,0
86192377257,86192377258,1,1371,1407,0
86193504395,86193504402,7,7632,2419,0
86196595794,86196595791,-3,1607,1518,0
86197974485,86197974487,2,1045,1682,0
86199301681,86199301678,-3,925,2372,0
86201547908,86201547909,1,1769,2189,0
86207746497,86207746498,1,1370,1773,0
86215156057,86215156056,-1,1279,1586,0
86215899445,86215899441,-4,21031,16715,0
86216422426,86216422425,-1,1230,2053,0
86218911777,86218911777,0,1331,1458,0
86220130874,86220130873,-1,1418,1376,0
86221606112,86221606118,6,8417,2703,0
86221784764,86221784765,1,1393,1830,0
86222797676,86222797676,0,1598,1796,0
86223605995,86223605997,2,1524,1924,0
86224822475,86224822475,0,1258,1801,0
86229323505,86229323505,0,1162,1643,0
86231699233,86231699234,1,1154,1508,0
86232368156,86232368155,-1,1572,2467,0
86232981994,86232981995,1,1232,1689,0
86234310461,86234310466,5,1851,1337,0
86234664392,86234664394,2,1474,1693,0
86236184217,86236184214,-3,550,1891,0
86237174066,86237174067,1,2437,1856,0
86252428389,86252428391,2,1039,1148,0
86254330994,86254330998,4,1740,1614,0
86254601414,86254601413,-1,878,1604,0
86256527357,86256527358,1,1124,1240,0
86257665878,86257665886,8,8192,2701,0
86259060974,86259060976,2,1220,1202,0
86261057479,86261057479,0,825,1101,0
86262413887,86262413882,-5,1805,5124,0
86264378429,86264378430,1,1582,1871,0
86264467846,86264467846,0,1200,1436,0
86265598808,86265598831,23,276,984,0
86268764758,86268764761,3,1803,1758,0
86272267317,86272267317,0,1262,2220,0
86273552502,86273552504,2,1491,1926,0
86276859067,86276859066,-1,1087,2108,0
86277690442,86277690443,1,1462,1814,0
86278674911,86278674915,4,1617,1568,0
86279592050,86279592050,0,1353,1964,0
86281757122,86281757124,2,1060,1722,0
86282327998,86282328002,4,1318,1238,0
86283605541,86283605527,-14,1097,1163,0
86289780154,86289780155,1,1558,1665,0
86291500581,86291500585,4,1209,1431,0
86297652801,86297652801,0,1807,2198,0
86301617454,86301617453,-1,1377,2225,0
86302269757,86302269757,0,1654,2153,0
86304177215,86304177217,2,1799,1518,0
86307193235,86307193237,2,1233,1307,0
86312618774,86312618775,1,1116,1476,0
86313308903,86313308902,-1,1167,1438,0
86314850110,86314850099,-11,1150,1143,0
86319406539,86319406539,0,1377,1627,0
86320421385,86320421379,-6,1285,1447,0
86320698126,86320698131,5,2688,1642,0
86322450511,86322450511,0,1503,2337,0
86323302827,86323302827,0,1682,1889,0
86323976398,86323976399,1,1625,1723,0
86325097327,86325097329,2,1926,2086,0
86328731570,86328731571,1,1672,2015,0
86330636501,86330636521,20,462,2208,0
86331776866,86331776865,-1,1334,1121,0
86331971190,86331971190,0,1344,1662,0
86334205951,86334205953,2,1503,2167,0
86337146978,86337146978,0,1324,1529,0
86342341192,86342341194,2,1279,1885,0
86343793143,86343793142,-1,1429,1500,0
86354623215,86354623215,0,1412,1426,0
86357639458,86357639458,0,2753,4902,0
86357900871,86357900870,-1,928,1296,0
86359448901,86359448902,1,2064,1841,0
86366012551,86366012553,2,1487,1567,0
86368234095,86368234097,2,1602,1691,0
86370457669,86370457670,1,1498,1506,0
86378150258,86378150255,-3,1224,2875,0
86378924676,86378924676,0,1289,1408,0
86384170143,86384170146,3,1581,1719,0
86384274753,86384274752,-1,1093,1354,0
86384669670,86384669670,0,1244,1287,0
86388042525,86388042525,0,1573,1709,0
86392512940,86392512941,1,1274,1896,0
86398210193,86398210192,-1,1495,1776,0
86399121802,86399121804,2,1246,1301,0
86401236067,86401236069,2,1320,1326,0
86406025902,86406025902,0,1425,1417,0
86407100946,86407100948,2,1440,1407,0
86407566251,86407566250,-1,1335,1634,0
86408017326,86408017330,4,3788,2587,0
86409856218,86409856220,2,1026,1668,0
86410230164,86410230182,18,17526,28737,0
86422215185,86422215182,-3,1666,2289,0
86422419397,86422419396,-1,1376,1618,0
86425016692,86425016693,1,1181,1315,0
86426847070,86426847070,0,1234,1818,0
86427074529,86427074528,-1,1670,2214,0
86428945690,86428945693,3,4877,3285,0
86429211877,86429211877,0,1166,1967,0
86432342978,86432342979,1,1312,2171,0
86434198129,86434198129,0,1808,1503,0
86435653741,86435653744,3,1338,1585,0
86435808102,86435808103,1,1926,2001,0
86439275869,86439275869,0,1702,2139,0
86445168909,86445168910,1,1281,1820,0
86445834813,86445834813,0,1579,1035,0
86446539199,86446539198,-1,1488,1767,0
86450506694,86450506694,0,1385,2395,0
86457814955,86457814958,3,1593,1054,0
86458336957,86458336950,-7,89,754,0
86459272612,86459272613,1,1235,1337,0
86462548582,86462548582,0,1689,1573,0
86466129098,86466129093,-5,769,3291,0
86468070255,86468070255,0,1753,2057,0
86468785726,86468785724,-2,1659,1784,0
86472786287,86472786286,-1,1066,1475,0
86473799854,86473799875,21,1243,1721,0
86475760181,86475760181,0,1332,1838,0
86478236237,86478236238,1,2006,2139,0
86478885094,86478885095,1,1327,1749,0
86479543347,86479543346,-1,1901,1940,0
86482530418,86482530414,-4,951,2423,0
86484931774,86484931774,0,1063,1830,0
86486698608,86486698605,-3,1341,3488,0
86487523126,86487523126,0,1192,1435,0
86488369830,86488369830,0,1368,1984,0
86488494226,86488494223,-3,1018,2252,0
86493009722,86493009722,0,1909,1770,0
86494481682,86494481682,0,970,1846,0
86497686413,86497686414,1,1648,1704,0
86498208212,86498208215,3,1290,1249,0
86499654034,86499654034,0,1655,1755,0
86500818758,86500818765,7,1813,1372,0
86505966967,86505966970,3,1765,1639,0
86506481383,86506481385,2,1561,2250,0
86506617262,86506617261,-1,1671,1801,0
86507113230,86507113230,0,867,1422,0
86510802554,86510802554,0,1041,1314,0
86512867342,86512867345,3,1097,1182,0
86514531891,86514531886,-5,1313,4705,0
86518922397,86518922398,1,1276,1636,0
86519182346,86519182345,-1,977,1692,0
86520041919,86520041919,0,1048,1383,0
86521931906,86521931906,0,1568,1845,0
86524724419,86524724421,2,1328,1706,0
86530667194,86530667196,2,1859,1749,0
86533723257,86533723256,-1,1089,1591,0
86533880027,86533880026,-1,1105,2687,0
86535163439,86535163439,0,1250,1559,0
86536758772,86536758771,-1,1687,1759,0
86539892921,86539892921,0,1339,1869,0
86541613327,86541613327,0,1329,2008,0
86542193330,86542193351,21,1700,1324,0
86542740140,86542740140,0,1564,1456,0
86542988775,86542988776,1,1911,2685,0
86545116443,86545116443,0,1570,1305,0
86546881855,86546881855,0,625,1325,0
86547447510,86547447499,-11,1301,1474,0
86547880103,86547880106,3,1425,1460,0
86549615498,86549615501,3,1435,1469,0
86552330155,86552330153,-2,1501,1782,0
86554183678,86554183678,0,1668,1746,0
86555172815,86555172818,3,1295,1326,0
86556374248,86556374248,0,1862,1765,0
86558146328,86558146330,2,1987,2086,0
86559162861,86559162858,-3,1287,3234,0
86559923724,86559923725,1,1930,1909,0
86570289374,86570289374,0,1463,2064,0
86570389471,86570389473,2,1604,1290,0
86572055316,86572055315,-1,950,1257,0
86574851406,86574851409,3,2129,1793,0
86576004211,86576004211,0,2175,2851,0
86576625656,86576625654,-2,884,1897,0
86582450383,86582450386,3,1635,1720,0
86583950677,86583950678,1,1126,1508,0
86588126930,86588126931,1,1457,1320,0
86590287566,86590287566,0,1250,1547,0
86591210614,86591210617,3,1337,1380,0
86594445085,86594445084,-1,1555,1728,0
86595099716,86595099717,1,1734,2365,0
86595186144,86595186139,-5,427,3062,0
86599161291,86599161292,1,1812,2097,0
86599806027,86599806027,0,1649,1901,0
86603489992,86603489991,-1,2012,2579,0
86603644104,86603644104,0,1560,1932,0
86607264915,86607264917,2,1982,1771,0
86608693950,86608693951,1,1531,1442,0
86608737494,86608737510,16,1362,1468,0
86609722369,86609722370,1,1144,1555,0
86611209688,86611209689,1,1216,1503,0
86613064469,86613064469,0,1789,2069,0
86614066667,86614066668,1,1049,974,0
86616656673,86616656673,0,1546,1277,0
86617359854,86617359855,1,1220,1773,0
86617818385,86617818378,-7,1904,5909,0
86618545591,86618545568,-23,1597,1305,0
86618932943,86618932946,3,1159,1423,0
86620202935,86620202938,3,1836,1888,0
86623940758,86623940757,-1,1352,1816,0
86624317299,86624317302,3,1379,1680,0
86629053551,86629053549,-2,1662,1914,0
86629756645,86629756646,1,879,945,0
86630616188,86630616189,1,1219,1527,0
86633570081,86633570082,1,1140,1334,0
86634169839,86634169841,2,1351,1299,0
86636402794,86636402796,2,2146,2314,0
86637752971,86637752968,-3,1083,2124,0
86638968496,86638968509,13,262,474,0
86645959802,86645959801,-1,1665,1643,0
86651493628,86651493626,-2,1403,1337,0
86652467789,86652467789,0,1529,2040,0
86654420968,86654420969,1,1174,1239,0
86665222667,86665222669,2,1390,1986,0
86668802314,86668802314,0,2111,2784,0
86673580214,86673580213,-1,1368,1761,0
86678940406,86678940405,-1,1464,1689,0
86681231590,86681231592,2,1330,1674,0
86681830278,86681830277,-1,2012,2136,0
86684310262,86684310263,1,1770,1358,0
86687872207,86687872206,-1,1201,1158,0
86688328520,86688328521,1,1468,2162,0
86689190510,86689190509,-1,1298,1246,0
86689657323,86689657324,1,1381,1577,0
86690307658,86690307658,0,1071,1856,0
86691291220,86691291217,-3,1421,2105,0
86691438907,86691438907,0,1292,1909,0
86692439316,86692439315,-1,1377,1858,0
86692848722,86692848722,0,1917,2897,0
86693315541,86693315547,6,3130,1479,0
86695124517,86695124517,0,1426,1191,0
86700441900,86700441900,0,977,1352,0
86700510862,86700510862,0,1363,2063,0
86701817911,86701817913,2,1309,1250,0
86705618098,86705618097,-1,1666,2709,0
86706199643,86706199643,0,1217,1369,0
86708746830,86708746830,0,1304,1955,0
86714820214,86714820215,1,1176,1006,0
86715176341,86715176341,0,1058,1664,0
86716119545,86716119543,-2,1699,4418,0
86717105445,86717105449,4,1611,1860,0
86720074123,86720074123,0,1256,1494,0
86721391461,86721391467,6,2439,1019,0
86726509267,86726509268,1,1334,1814,0
86727647967,86727647967,0,898,1056,0
86727864711,86727864715,4,2235,1651,0
86728987505,86728987507,2,1744,1649,0
86729887481,86729887474,-7,2356,7314,0
86731014399,86731014399,0,1254,1699,0
86733816512,86733816513,1,1539,1724,0
86737073582,86737073582,0,1276,1370,0
86738379366,86738379364,-2,1447,1474,0
86740343559,86740343562,3,1651,1828,0
86746605012,86746605014,2,1410,2412,0
86749084933,86749084933,0,1917,1947,0
86752365722,86752365723,1,1664,1658,0
86761033026,86761033030,4,1440,1543,0
86761879091,86761879090,-1,1296,1944,0
86765218224,86765218226,2,1632,1679,0
86766171386,86766171384,-2,1000,2835,0
86766243839,86766243822,-17,1091,1501,0
86776276383,86776276364,-19,1193,1958,0
86779098202,86779098203,1,1293,1906,0
86783343649,86783343651,2,1215,1405,0
86784317373,86784317373,0,1625,2472,0
86788345971,86788345974,3,1111,1341,0
86788409077,86788409076,-1,1486,2084,0
86796695014,86796695017,3,1302,2159,0
86803037021,86803037021,0,1275,1530,0
86808142037,86808142038,1,1030,1596,0
86814247467,86814247467,0,1182,3299,0
86816996718,86816996722,4,1099,1460,0
86819119622,86819119623,1,1563,2221,0
86819666910,86819666912,2,1551,2695,0
86823118193,86823118193,0,1379,1409,0
86823396768,86823396770,2,941,1289,0
86827138969,86827138971,2,1795,1489,0
86833266518,86833266518,0,1196,1266,0
86839864646,86839864649,3,1427,1855,0
86840797393,86840797393,0,1369,1593,0
86841283983,86841283986,3,1744,1410,0
86843288166,86843288167,1,1275,1500,0
86843503250,86843503251,1,933,2009,0
86844746478,86844746494,16,1070,1380,0
86851823913,86851823914,1,1531,1828,0
86851966306,86851966306,0,1326,1785,0
86854158258,86854158258,0,1763,1510,0
86857627396,86857627396,0,1315,1238,0
86858253412,86858253411,-1,1711,1813,0
86861478518,86861478518,0,1558,2614,0
86862157257,86862157259,2,1592,1388,0
86875013133,86875013153,20,1102,1095,0
86875465147,86875465146,-1,1134,1492,0
86876035917,86876035918,1,1007,1262,0
86879927794,86879927794,0,1531,1738,0
86882882046,86882882047,1,1492,1455,0
86883757385,86883757379,-6,1100,5196,0
86885172730,86885172732,2,2066,2548,0
86886237205,86886237204,-1,17679,1971,0
86886308598,86886308598,0,1232,2011,0
86886427723,86886427722,-1,1121,1252,0
86887249802,86887249801,-1,909,1295,0
86888795662,86888795663,1,1787,1460,0
86891055544,86891055542,-2,1841,1732,0
86891414830,86891414830,0,980,687,0
86893927370,86893927371,1,1625,1823,0
86897253579,86897253578,-1,868,2058,0
86897889355,86897889354,-1,1544,3263,0
86898818174,86898818174,0,1251,1013,0
86900567303,86900567303,0,1567,2136,0
86900795999,86900795999,0,954,1532,0
86901181423,86901181423,0,999,1817,0
86904955532,86904955518,-14,1185,1862,0
86907134778,86907134779,1,1141,2030,0
86908352867,86908352866,-1,1099,1210,0
86908952089,86908952091,2,1082,1486,0
86910695845,86910695847,2,1474,1676,0
86912352441,86912352441,0,1321,1530,0
86915832785,86915832786,1,1062,1797,0
86923032679,86923032683,4,2021,1204,0
86927796950,86927796950,0,1966,2012,0
86928350914,86928350893,-21,1553,1450,0
86928803996,86928803998,2,1687,2010,0
86930014429,86930014430,1,1323,1201,0
86931252294,86931252297,3,1333,1241,0
86931595346,86931595347,1,1172,1775,0
86933449374,86933449375,1,1979,1421,0
86938971006,86938971006,0,1354,1575,0
86939115125,86939115126,1,558,716,0
86939818859,86939818858,-1,1079,1644,0
86941110011,86941110010,-1,1258,1511,0
86943480974,86943480972,-2,1194,1188,0
86944177049,86944177049,0,1519,1802,0
86944539652,86944539669,17,720,1240,0
86944971769,86944971789,20,1777,198,0
86945656025,86945656022,-3,897,2084,0
86946417179,86946417179,0,1131,1532,0
86946721098,86946721098,0,1072,1385,0
86947395090,86947395092,2,1400,1653,0
86949523974,86949523974,0,1381,1781,0
86955268498,86955268501,3,1261,1469,0
86961984931,86961984932,1,1223,1533,0
86964926963,86964926966,3,1133,1288,0
86967558102,86967558102,0,904,925,0
86969672899,86969672898,-1,1247,1447,0
86970057466,86970057466,0,833,1733,0
86970123236,86970123229,-7,1886,10104,0
86971121610,86971121610,0,1369,1904,0
86972712723,86972712722,-1,1211,1626,0
86974126937,86974126938,1,1603,1339,0
86975867398,86975867401,3,1980,2154,0
86976291589,86976291590,1,1352,1416,0
86980860665,86980860665,0,1325,1189,0
86984330964,86984330964,0,1044,1390,0
86988001386,86988001386,0,1596,2878,0
86992173546,86992173545,-1,1380,2075,0
86992541205,86992541207,2,1616,1915,0
86995336610,86995336611,1,1254,2275,0
86996590366,86996590366,0,1453,1664,0
86997131725,86997131727,2,2735,2175,0
86997841600,86997841601,1,1516,2109,0
86998885885,86998885885,0,746,1586,0
87002781146,87002781146,0,1198,1946,0
87005525340,87005525341,1,1305,1739,0
87007918203,87007918202,-1,949,1870,0
87009429390,87009429391,1,794,1481,0
87010172186,87010172179,-7,665,2629,0
87011371617,87011371619,2,1503,1740,0
87013423239,87013423238,-1,1723,2383,0
87014756323,87014756321,-2,1492,1729,0
87018216685,87018216674,-11,730,1576,0
87018789931,87018789932,1,1465,1855,0
87023614894,87023614899,5,4119,2020,0
87023843525,87023843531,6,4446,2231,0
87028056418,87028056418,0,1524,1867,0
87028537404,87028537405,1,1166,1305,0
87030305983,87030305983,0,1664,2205,0
87032757274,87032757272,-2,1317,1737,0
87032849021,87032849022,1,1601,1613,0
87032915670,87032915673,3,1328,1402,0
87032988967,87032988967,0,1535,2055,0
87033147818,87033147819,1,1755,2207,0
87037872054,87037872057,3,1153,1470,0
87044435975,87044435975,0,1013,2099,0
87046989474,87046989474,0,1519,1883,0
87047239347,87047239347,0,946,1384,0
87051443536,87051443537,1,1647,1586,0
87053791236,87053791236,0,1418,1213,0
87054671286,87054671286,0,1741,1822,0
87054791176,87054791178,2,1360,1610,0
87059351908,87059351906,-2,1556,1560,0
87059864791,87059864791,0,1004,1782,0
87060612467,87060612468,1,1056,1689,0
87064449673,87064449675,2,1354,1814,0
87068285630,87068285630,0,835,1212,0
87069096814,87069096812,-2,2125,2611,0
87069241762,87069241762,0,809,1416,0
87070427927,87070427923,-4,1153,2612,0
87070745914,87070745913,-1,1339,2312,0
87073634451,87073634453,2,2113,2751,0
87077241657,87077241658,1,1407,1675,0
87078159256,87078159259,3,1216,2499,0
87078764023,87078764022,-1,985,1305,0
87081652900,87081652900,0,1691,1579,0
87082473380,87082473379,-1,950,1698,0
87082592337,87082592337,0,1144,1107,0
87083717842,87083717839,-3,1626,1580,0
87084160054,87084160056,2,1671,1964,0
87085153438,87085153438,0,1192,1808,0
87088619813,87088619812,-1,1192,1720,0
87090330368,87090330369,1,1514,1861,0
87094139218,87094139222,4,1800,1830,0
87097806542,87097806542,0,1453,1938,0
87099247464,87099247464,0,1342,1267,0
87099956795,87099956797,2,1146,1493,0
87101606915,87101606915,0,1102,1630,0
87102588914,87102588916,2,1739,2302,0
87105596585,87105596586,1,1156,948,0
87108430002,87108430002,0,1189,1960,0
87110415143,87110415145,2,1275,1936,0
87113634069,87113634067,-2,1491,2559,0
87121640510,87121640509,-1,1589,1748,0
87121769165,87121769164,-1,1364,2499,0
87123378888,87123378890,2,948,1684,0
87124112007,87124112009,2,1524,1803,0
87126580247,87126580246,-1,1480,1279,0
87128974552,87128974553,1,1386,1836,0
87129190837,87129190840,3,1883,1482,0
87129576347,87129576349,2,1867,1778,0
87132996457,87132996458,1,977,1664,0
87133309053,87133309058,5,1535,1190,0
87141663106,87141663106,0,1787,2608,0
87144102449,87144102449,0,1192,1830,0
87145307906,87145307907,1,1590,2091,0
87150200874,87150200877,3,1430,2057,0
87151978198,87151978197,-1,980,1238,0
87153064895,87153064898,3,1074,1631,0
87154106235,87154106228,-7,1266,6418,0
87154753269,87154753269,0,2295,2580,0
87157689911,87157689913,2,1299,1675,0
87161599859,87161599860,1,1042,1762,0
87162355451,87162355453,2,1186,1216,0
87162666420,87162666423,3,1294,1806,0
87163254406,87163254425,19,1503,1002,0
87166083875,87166083879,4,3291,3419,0
87168053350,87168053349,-1,1677,1834,0
87169393950,87169393952,2,1350,1776,0
87171168692,87171168702,10,17887,20604,0
87174988386,87174988387,1,1865,1773,0
87175440461,87175440462,1,1471,1320,0
87175842764,87175842765,1,1934,1718,0
87180125915,87180125918,3,1197,1190,0
87180913818,87180913818,0,1231,1887,0
87181717216,87181717202,-14,37,993,0
87182786798,87182786799,1,1883,1915,0
87188359718,87188359721,3,2080,1308,0
87191858404,87191858403,-1,1746,1759,0
87196945395,87196945395,0,1156,1731,0
87201260622,87201260622,0,1170,1965,0
87203908531,87203908531,0,1841,1356,0
87205124567,87205124574,7,7070,2680,0
87208134698,87208134701,3,1674,1678,0
87212406220,87212406221,1,1516,1800,0
87218484794,87218484794,0,1234,2126,0
87219347795,87219347796,1,1505,1562,0
87220580147,87220580143,-4,779,1895,0
87220768871,87220768871,0,1197,1542,0
87222339705,87222339706,1,1908,1638,0
87223041398,87223041402,4,1352,1709,0
87223502473,87223502475,2,1723,2272,0
87224080033,87224080033,0,1121,1559,0
87225036671,87225036670,-1,1063,1402,0
87225817540,87225817542,2,2163,1714,0
87227005994,87227005993,-1,2181,1535,0
87229676731,87229676730,-1,1568,1927,0
87229868792,87229868791,-1,1528,2452,0
87230202415,87230202401,-14,403,691,0
87230879550,87230879552,2,1389,1531,0
87231081990,87231081991,1,1721,2287,0
87232352307,87232352308,1,1140,1433,0
87233490995,87233490994,-1,1222,1277,0
87233804777,87233804779,2,1458,1937,0
87235944423,87235944422,-1,2076,2860,0
87236679710,87236679701,-9,2115,4763,0
87236815906,87236815906,0,802,1000,0
87240090730,87240090730,0,1294,1664,0
87241253975,87241253974,-1,1441,1796,0
87244533087,87244533089,2,1329,1320,0
87246965326,87246965328,2,1843,1951,0
87247760041,87247760044,3,1083,1600,0
87250267894,87250267897,3,2529,2856,0
87254741410,87254741410,0,1346,2245,0
87255130997,87255131003,6,5312,2708,0
87256288605,87256288605,0,1288,1252,0
87257513957,87257513957,0,762,1848,0
87263478715,87263478714,-1,1018,1894,0
87271648070,87271648071,1,1512,1842,0
87273214979,87273214978,-1,1352,1626,0
87273782953,87273782955,2,998,1381,0
87274796793,87274796799,6,4419,1338,0
87276072514,87276072513,-1,1278,1892,0
87276179642,87276179646,4,1885,1532,0
87277108356,87277108357,1,1498,1739,0
87278721207,87278721209,2,1576,1827,0
87279139019,87279139023,4,3053,1718,0
87281129962,87281129965,3,1078,1669,0
87282506245,87282506247,2,1579,1903,0
87286956247,87286956250,3,1945,2522,0
87287987443,87287987442,-1,1003,1616,0
87288471130,87288471121,-9,1634,9758,0
87291325491,87291325468,-23,918,923,0
87292489497,87292489498,1,1378,1451,0
87295181502,87295181503,1,1186,1672,0
87296373350,87296373351,1,1602,2411,0
87296437861,87296437862,1,1387,1455,0
87298906418,87298906420,2,1295,1219,0
87303320303,87303320305,2,1367,795,0
87306522495,87306522499,4,1750,933,0
87307807405,87307807404,-1,1430,1890,0
87310052158,87310052144,-14,1581,1900,0
87311938717,87311938719,2,1195,1742,0
87318070999,87318070999,0,1187,1499,0
87318891298,87318891298,0,1338,1999,0
87319544052,87319544053,1,1725,2237,0
87320234283,87320234281,-2,730,1938,0
87325152357,87325152358,1,1512,1550,0
87326280568,87326280571,3,1964,1657,0
87326330570,87326330566,-4,1376,2377,0
87331160869,87331160869,0,1522,1543,0
87331352967,87331352967,0,1005,1464,0
87339658601,87339658601,0,1619,1757,0
87339808570,87339808572,2,720,984,0
87340689221,87340689221,0,1368,1667,0
87342928858,87342928858,0,1002,1540,0
87344726449,87344726448,-1,1499,1849,0
87346208076,87346208075,-1,1958,1694,0
87346374040,87346374043,3,5810,21130,0
87347302560,87347302565,5,4218,3200,0
87348330562,87348330567,5,1662,1419,0
87349607308,87349607307,-1,1096,1229,0
87350510501,87350510501,0,940,1255,0
87356753354,87356753357,3,1855,1906,0
87360573118,87360573118,0,1309,1799,0
87361227995,87361227988,-7,946,3640,0
87363047842,87363047845,3,1618,2008,0
87367620554,87367620552,-2,1483,1556,0
87368142901,87368142904,3,1485,1467,0
87371294242,87371294243,1,1387,1581,0
87376104722,87376104723,1,1041,1521,0
87377030354,87377030357,3,1064,1230,0
87379288601,87379288602,1,1239,1955,0
87380015727,87380015743,16,93,593,0
87384008362,87384008364,2,979,1012,0
87385297627,87385297627,0,1577,1954,0
87385332642,87385332641,-1,926,1674,0
87386453873,87386453869,-4,1893,3550,0
87388076077,87388076078,1,1533,2193,0
87390063621,87390063621,0,1651,1914,0
87391471142,87391471142,0,1901,2064,0
87392665167,87392665169,2,1525,1662,0
87395802095,87395802097,2,1147,1919,0
87401974818,87401974818,0,1118,1305,0
87402799346,87402799349,3,1121,1140,0
87404079369,87404079368,-1,1244,1873,0
87404592413,87404592414,1,1485,1706,0
87406822867,87406822866,-1,1333,2157,0
87407636247,87407636246,-1,936,867,0
87409702367,87409702361,-6,1144,4526,0
87410306672,87410306673,1,1236,1337,0
87411578950,87411578951,1,1319,1017,0
87413852321,87413852322,1,1434,2245,0
87414630302,87414630302,0,1376,1749,0
87419042261,87419042261,0,2215,1845,0
87422214679,87422214677,-2,1042,1736,0
87423855089,87423855090,1,1693,2038,0
87428896294,87428896295,1,1169,1655,0
87430488069,87430488089,20,540,1788,0
87430897919,87430897918,-1,963,1493,0
87439509370,87439509371,1,2389,1924,0
87440542516,87440542514,-2,1593,1761,0
87441239493,87441239493,0,1608,2624,0
87443431296,87443431299,3,1144,1289,0
87446700710,87446700713,3,1201,1639,0
87447816110,87447816110,0,1584,1852,0
87451781237,87451781238,1,1485,1878,0
87452858834,87452858832,-2,733,1649,0
87452894906,87452894907,1,1177,1792,0
87454734686,87454734689,3,1462,1311,0
87455589673,87455589674,1,1382,1644,0
87458016039,87458016039,0,1390,1796,0
87459853167,87459853166,-1,1041,2531,0
87460206519,87460206519,0,929,926,0
87461216914,87461216914,0,902,1343,0
87462634426,87462634432,6,2518,1093,0
87463788262,87463788277,15,1008,1104,0
87464693474,87464693477,3,1443,1608,0
87466187806,87466187807,1,1334,1865,0
87466616597,87466616595,-2,1717,1248,0
87467288931,87467288908,-23,1203,1709,0
87468314917,87468314919,2,1755,2002,0
87469248338,87469248336,-2,1478,1611,0
87470516999,87470517000,1,1363,2019,0
87471404703,87471404704,1,885,1781,0
87473717845,87473717841,-4,1459,3334,0
87481387146,87481387147,1,1471,1829,0
87482090021,87482090022,1,871,1181,0
87484747057,87484747057,0,1128,2096,0
87485369062,87485369040,-22,1671,1219,0
87486567062,87486567062,0,919,1752,0
87487078293,87487078293,0,1521,1820,0
87488995173,87488995171,-2,1539,1959,0
87489293734,87489293733,-1,1528,3371,0
87489665295,87489665295,0,1328,1322,0
87489823312,87489823313,1,1870,1897,0
87491290659,87491290658,-1,1536,1526,0
87492936472,87492936471,-1,2597,3465,0
87493427507,87493427506,-1,1361,1717,0
87495062873,87495062875,2,1907,1914,0
87496538115,87496538113,-2,1551,3139,0
87498738747,87498738745,-2,1131,1295,0
87502883698,87502883699,1,1410,1529,0
87504660358,87504660361,3,1877,1528,0
87505799770,87505799770,0,1260,1225,0
87507148123,87507148122,-1,880,1785,0
87508123942,87508123942,0,758,1115,0
87508362622,87508362622,0,1512,1499,0
87511047146,87511047146,0,2111,1892,0
87513612943,87513612946,3,1421,1661,0
87520045185,87520045186,1,1228,1025,0
87521976103,87521976106,3,976,1493,0
87522906586,87522906586,0,1177,1725,0
87523219874,87523219870,-4,917,1225,0
87526237974,87526237975,1,764,1595,0
87526332949,87526332946,-3,919,1107,0
87526658368,87526658368,0,1714,2215,0
87530118442,87530118442,0,1589,1709,0
87530196242,87530196242,0,1017,1297,0
87530619333,87530619326,-7,1212,5528,0
87533806183,87533806185,2,1463,1671,0
87534984285,87534984286,1,1161,1667,0
87538222846,87538222847,1,920,1459,0
87538587837,87538587838,1,1011,1575,0
87544157863,87544157870,7,3068,1544,0
87550500889,87550500889,0,1268,1547,0
87551987927,87551987926,-1,1083,2166,0
87556677566,87556677570,4,2204,1231,0
87557073933,87557073934,1,1615,1896,0
87557280307,87557280307,0,1527,2179,0
87559517176,87559517178,2,1370,1366,0
87560590505,87560590506,1,1522,2143,0
87563382762,87563382763,1,1222,1646,0
87566464766,87566464767,1,1753,1853,0
87571975070,87571975073,3,2127,1498,0
87579477628,87579477629,1,1545,2207,0
87581403762,87581403765,3,1394,1995,0
87582929590,87582929590,0,1192,1624,0
87583277912,87583277909,-3,1193,1446,0
87584524518,87584524518,0,1030,2223,0
87586461917,87586461918,1,1565,1852,0
87586787718,87586787718,0,930,1313,0
87588911004,87588911006,2,1953,2506,0
87589645779,87589645779,0,1514,1374,0
87599061171,87599061170,-1,1366,1808,0
87600915126,87600915126,0,1101,1623,0
87604206606,87604206608,2,1685,1269,0
87605728427,87605728426,-1,1786,2068,0
87606794479,87606794499,20,1608,2103,0
87608446784,87608446780,-4,1470,2092,0
87609271878,87609271879,1,1317,1356,0
87609876903,87609876904,1,484,1274,0
87611537858,87611537863,5,2158,1165,0
87612101575,87612101578,3,1573,1438,0
87612141547,87612141550,3,1747,1656,0
87616525315,87616525317,2,1626,2749,0
87616801440,87616801439,-1,1077,1557,0
87617827085,87617827087,2,2597,1779,0
87618677663,87618677659,-4,20905,8936,0
87622044578,87622044583,5,2434,1695,0
87623211884,87623211884,0,1377,1920,0
87625544386,87625544389,3,2938,2304,0
87626367932,87626367933,1,1430,1436,0
87628372160,87628372162,2,1934,1861,0
87628827392,87628827394,2,1259,1546,0
87631133219,87631133220,1,1073,1692,0
87634788654,87634788655,1,1021,1759,0
87635196710,87635196711,1,1635,1551,0
87636799057,87636799058,1,1240,1581,0
87637710241,87637710245,4,2026,2155,0
87638228280,87638228279,-1,1114,1418,0
87639246461,87639246462,1,1349,1725,0
87642228662,87642228663,1,1429,2478,0
87642873021,87642873020,-1,1430,1815,0
87643508849,87643508847,-2,1999,3815,0
87643899494,87643899493,-1,1405,1647,0
87644989829,87644989829,0,1463,1251,0
87651989882,87651989884,2,1444,2005,0
87653976089,87653976087,-2,1112,1073,0
87655706341,87655706342,1,1196,1520,0
87656222662,87656222661,-1,1494,1735,0
87658974918,87658974917,-1,1026,1861,0
87661946691,87661946691,0,1348,2000,0
87662979466,87662979467,1,1115,1427,0
87663051733,87663051734,1,1423,1667,0
87679412225,87679412224,-1,959,1842,0
87680552963,87680552942,-21,1474,1873,0
87680683167,87680683168,1,1187,1857,0
87680777435,87680777440,5,5046,2705,0
87681679954,87681679954,0,1396,1936,0
87687642066,87687642065,-1,1585,1756,0
87687800310,87687800309,-1,1391,1802,0
87688240734,87688240734,0,1448,1790,0
87689954290,87689954291,1,1400,1518,0
87690590646,87690590646,0,4752,13814,0
87694177485,87694177485,0,1326,1512,0
87696350533,87696350533,0,1402,1662,0
87696673171,87696673172,1,1731,1686,0
87697960170,87697960170,0,2309,1909,0
87698040746,87698040749,3,1666,1634,0
87699629272,87699629291,19,485,987,0
87699861038,87699861040,2,1530,1362,0
87704714126,87704714126,0,1220,1632,0
87709989424,87709989424,0,1330,1625,0
87710595372,87710595375,3,940,888,0
87715359725,87715359746,21,179,445,0
87716463567,87716463561,-6,842,1994,0
87717173462,87717173465,3,1464,1666,0
87722185738,87722185737,-1,1136,1788,0
87723000166,87723000172,6,2830,1345,0
87723268113,87723268112,-1,2056,2084,0
87724588754,87724588755,1,1567,1568,0
87726216030,87726216032,2,1062,1611,0
87728847801,87728847801,0,1052,1587,0
87729559337,87729559337,0,1483,1384,0
87731097017,87731097017,0,1360,1387,0
87731579299,87731579299,0,1661,1120,0
87731849667,87731849667,0,1302,1163,0
87733465463,87733465466,3,1471,1796,0
87735205793,87735205795,2,1873,1760,0
87736752972,87736752972,0,1270,1769,0
87737108742,87737108744,2,1830,1667,0
87743069914,87743069913,-1,1419,1792,0
87744875667,87744875666,-1,1325,1862,0
87745861515,87745861514,-1,1241,1647,0
87748407945,87748407946,1,1032,1659,0
87748552399,87748552376,-23,827,1341,0
87750815906,87750815907,1,1835,1641,0
87750959685,87750959684,-1,1798,2344,0
87753372330,87753372330,0,1372,1488,0
87755706509,87755706514,5,1834,1469,0
87756680637,87756680636,-1,1318,1932,0
87757017476,87757017480,4,12,2205,0
87761813980,87761813979,-1,1149,2126,0
87762576882,87762576883,1,1527,1486,0
87763868785,87763868787,2,951,1557,0
87765604379,87765604379,0,818,1742,0
87765680518,87765680518,0,1531,1634,0
87767919094,87767919097,3,1394,1798,0
87768088391,87768088390,-1,1453,998,0
87769415903,87769415903,0,1685,1815,0
87776093757,87776093756,-1,1318,1946,0
87785213133,87785213134,1,1358,1904,0
87787126893,87787126893,0,1243,1420,0
87787264634,87787264634,0,1750,2611,0
87791197674,87791197677,3,1180,1513,0
87792559683,87792559682,-1,1081,1648,0
87792599226,87792599227,1,1528,1858,0
87792662103,87792662102,-1,1027,1949,0
87795199641,87795199642,1,879,1569,0
87795892904,87795892906,2,1181,1605,0
87796611342,87796611341,-1,111,1163,0
87796749709,87796749710,1,1248,1900,0
87797238199,87797238201,2,945,1013,0
87800574919,87800574921,2,1568,2296,0
87803730574,87803730577,3,2079,2279,0
87804318568,87804318565,-3,1386,3074,0
87805185759,87805185758,-1,1154,2390,0
87807120047,87807120026,-21,1674,1753,0
87807992360,87807992361,1,1527,1888,0
87812712306,87812712305,-1,1110,1955,0
87815613800,87815613802,2,1712,1659,0
87819580698,87819580699,1,1554,1780,0
87822698723,87822698730,7,3615,1195,0
87825172444,87825172447,3,10555,8853,0
87832014938,87832014920,-18,1927,1784,0
87833956925,87833956926,1,1615,1633,0
87835520358,87835520337,-21,1298,1644,0
87840792405,87840792406,1,1383,2121,0
87844793134,87844793134,0,1169,1843,0
87848199122,87848199125,3,1759,1404,0
87849098463,87849098462,-1,1535,1527,0
87849318365,87849318371,6,4985,2475,0
87849753510,87849753512,2,1615,2323,0
87855964557,87855964558,1,1829,1603,0
87857236923,87857236925,2,1423,1621,0
87859791163,87859791163,0,993,1214,0
87863803299,87863803299,0,999,1599,0
87864463206,87864463207,1,1522,1940,0
87866696468,87866696468,0,1206,1910,0
87868706547,87868706545,-2,1254,1909,0
87870396689,87870396689,0,1219,1767,0
87872207907,87872207907,0,1094,1320,0
87875138502,87875138505,3,1716,1988,0
87875995874,87875995879,5,2523,1106,0
87876817379,87876817381,2,1378,1529,0
87884461803,87884461806,3,1295,1936,0
87885161027,87885161029,2,2245,2458,0
87887304965,87887304966,1,1499,2117,0
87888275055,87888275055,0,1061,1543,0
87889538581,87889538583,2,686,762,0
87890860837,87890860835,-2,1307,1673,0
87891105285,87891105285,0,1427,1770,0
87891882829,87891882830,1,1341,2004,0
87895287857,87895287859,2,2020,2048,0
87896212450,87896212450,0,1888,2302,0
87897543798,87897543802,4,1052,1550,0
87898793938,87898793939,1,874,1100,0
87899956241,87899956241,0,1033,1585,0
87899992849,87899992850,1,1421,2163,0
87900875725,87900875723,-2,1620,1803,0
87904089895,87904089895,0,1310,2180,0
87904244197,87904244198,1,1340,1280,0
87905915626,87905915627,1,1462,1671,0
87907294215,87907294216,1,1471,1879,0
87917946302,87917946304,2,1848,2034,0
87918829241,87918829240,-1,1252,1902,0
87928724086,87928724086,0,1036,1441,0
87929737517,87929737513,-4,21177,15640,0
87929831756,87929831753,-3,1791,2007,0
87929863668,87929863668,0,1447,1314,0
87931920309,87931920309,0,1398,1286,0
87934623590,87934623594,4,1421,1517,0
87934757724,87934757726,2,1283,1407,0
87938413229,87938413228,-1,1257,1446,0
87940639889,87940639889,0,1164,1758,0
87942733070,87942733070,0,2712,3743,0
87943775358,87943775357,-1,1451,1557,0
87943922202,87943922203,1,1377,1692,0
87944063567,87944063569,2,1341,2539,0
87946197287,87946197286,-1,1146,1883,0
87947379887,87947379892,5,3033,42604,0
87947717695,87947717696,1,1411,1520,0
87948200128,87948200126,-2,1112,1555,0
87949513696,87949513698,2,2061,2319,0
87949711011,87949711010,-1,1673,1528,0
87955162432,87955162432,0,1532,1747,0
87958296209,87958296210,1,1137,1749,0
87959136798,87959136799,1,1158,2145,0
87962279010,87962279010,0,1424,1542,0
87963122786,87963122788,2,1608,1614,0
87965675470,87965675471,1,1239,1780,0
87970936543,87970936543,0,1617,1523,0
87973369511,87973369511,0,305,518,0
87974340636,87974340639,3,1258,953,0
87976019782,87976019784,2,1528,2093,0
87981946426,87981946426,0,897,1850,0
87984669806,87984669814,8,8657,42750,0
87987403144,87987403143,-1,1612,1878,0
87987561001,87987561001,0,856,2396,0
87987782731,87987782731,0,1234,1552,0
87991925845,87991925844,-1,1832,1995,0
87992582042,87992582040,-2,1350,1916,0
87994294534,87994294534,0,1169,1762,0
87994888056,87994888055,-1,1114,1209,0
87995047717,87995047715,-2,1658,1674,0
87995960701,87995960701,0,1720,1466,0
87996113852,87996113854,2,1099,1749,0
87996429774,87996429775,1,1784,1560,0
87998924505,87998924502,-3,941,1175,0
88002049431,88002049430,-1,2158,2504,0
88002256633,88002256636,3,1468,2104,0
88003048723,88003048724,1,981,1272,0
88005926598,88005926597,-1,1675,1459,0
88006276146,88006276146,0,1261,1520,0
88007687551,88007687550,-1,1541,1498,0
88009091939,88009091939,0,1666,1856,0
88010127354,88010127354,0,1240,688,0
88012247446,88012247447,1,1011,1187,0
88013442118,88013442119,1,1062,1439,0
88016113055,88016113055,0,1418,1503,0
88022893724,88022893726,2,1870,1663,0
88023135195,88023135199,4,1861,2505,0
88024239058,88024239059,1,1188,1723,0
88025725562,88025725560,-2,1085,1539,0
88026230154,88026230150,-4,1295,1816,0
88026764861,88026764862,1,1601,2140,0
88028254596,88028254598,2,1338,1580,0
88031463406,88031463405,-1,1054,1811,0
88031834965,88031834966,1,1355,2251,0
88035832298,88035832299,1,1453,1177,0
88038311963,88038311964,1,896,934,0
88042104079,88042104081,2,1215,1903,0
88050166003,88050166003,0,1278,1389,0
88052497965,88052497969,4,1155,1771,0
88053323762,88053323759,-3,1210,2300,0
88053554885,88053554882,-3,2600,4117,0
88053637700,88053637701,1,1517,1801,0
88053701579,88053701582,3,1559,981,0
88057873802,88057873803,1,1408,1897,0
88058241869,88058241869,0,1351,1441,0
88063868882,88063868890,8,3887,1313,0
88068188833,88068188834,1,1541,1235,0
88068690285,88068690288,3,1765,1000,0
88071333851,88071333850,-1,977,1358,0
88071893822,88071893822,0,1443,1670,0
88072973782,88072973781,-1,1379,1450,0
88075109440,88075109439,-1,1294,1653,0
88075260193,88075260186,-7,1513,9165,0
88075465764,88075465773,9,1323,1123,0
88077018550,88077018550,0,1269,1830,0
88077792506,88077792506,0,1851,2297,0
88079351865,88079351860,-5,1000,3871,0
88079671278,88079671299,21,1396,1383,0
88085239946,88085239942,-4,1088,2732,0
88087422707,88087422708,1,1151,1252,0
88087803189,88087803189,0,1859,2153,0
88087910485,88087910486,1,1754,2611,0
88092089745,88092089745,0,2222,2226,0
88097985010,88097985012,2,1392,1670,0
88102759963,88102759963,0,1039,1388,0
88105849031,88105849031,0,1039,1516,0
88107377428,88107377429,1,1823,2166,0
88108831631,88108831633,2,1410,1424,0
88116419513,88116419517,4,1762,1683,0
88118198170,88118198170,0,878,888,0
88124614747,88124614746,-1,1330,2189,0
88128506233,88128506241,8,11903,42061,0
88129109910,88129109909,-1,1124,1446,0
88129460186,88129460187,1,869,1401,0
88129966867,88129966867,0,1107,1563,0
88133286931,88133286929,-2,1511,1755,0
88133956378,88133956378,0,1380,1842,0
88138915395,88138915394,-1,1844,2106,0
88140993991,88140993991,0,1102,1068,0
88145843690,88145843693,3,1836,2537,0
88146350751,88146350751,0,1578,1969,0
88151982597,88151982597,0,33596,25192,0
88152346863,88152346862,-1,6603,10798,0
88154096103,88154096104,1,1338,1849,0
88160919940,88160919941,1,1587,1742,0
88163155895,88163155895,0,1135,1902,0
88163547867,88163547869,2,1368,2448,0
88164993413,88164993413,0,1328,1707,0
88170961601,88170961601,0,1219,2038,0
88175692478,88175692479,1,1206,1073,0
88177627745,88177627745,0,1329,1562,0
88178423085,88178423085,0,1522,2140,0
88186341973,88186341974,1,1338,1277,0
88188731537,88188731538,1,1117,1442,0
88191929198,88191929199,1,1488,1988,0
88192118617,88192118617,0,837,1840,0
88192426936,88192426934,-2,716,1032,0
88192688230,88192688228,-2,1734,2929,0
88194893598,88194893599,1,1392,1434,0
88196103022,88196103023,1,1084,1272,0
88196231122,88196231122,0,1182,2112,0
88200056909,88200056910,1,1298,1689,0
88200498710,88200498709,-1,1417,1107,0
88201707749,88201707751,2,1841,1505,0
88202015269,88202015272,3,926,1738,0
88204875279,88204875280,1,1125,1603,0
88206151509,88206151510,1,1361,1252,0
88206825398,88206825401,3,2119,1403,0
88210221626,88210221627,1,1142,1299,0
88211723491,88211723488,-3,934,1841,0
88212308499,88212308498,-1,815,1664,0
88213123462,88213123461,-1,630,220,0
88214752716,88214752717,1,1871,1385,0
88221313319,88221313318,-1,1000,1807,0
88226991542,88226991542,0,1374,1228,0
88230018923,88230018926,3,1320,1533,0
88231276497,88231276495,-2,1761,2240,0
88232735338,88232735343,5,1298,1275,0
88234537094,88234537095,1,1187,1607,0
88240117546,88240117548,2,1617,1402,0
88241731805,88241731809,4,2077,1133,0
88242805151,88242805152,1,1236,1212,0
88243715257,88243715255,-2,1315,1859,0
88249003425,88249003426,1,1482,2177,0
88249712063,88249712065,2,1283,1434,0
88251673893,88251673894,1,1751,1824,0
88252907639,88252907641,2,1078,1794,0
88257804399,88257804403,4,944,921,0
88259143403,88259143404,1,880,1140,0
88261172999,88261173001,2,1541,1853,0
88263088514,88263088514,0,4254,4385,0
88265194567,88265194566,-1,1405,1666,0
88269057545,88269057546,1,1044,1927,0
88273041578,88273041574,-4,1314,2024,0
88277326879,88277326883,4,23183,26489,0
88277959475,88277959473,-2,5214,8080,0
88282707135,88282707135,0,1188,1505,0
88284547739,88284547741,2,1610,1818,0
88284886410,88284886410,0,1447,2102,0
88285760944,88285760945,1,1523,1482,0
88286947777,88286947775,-2,1344,2030,0
88287523091,88287523098,7,2693,2066,0
88290449635,88290449638,3,1228,903,0
88290663156,88290663156,0,237,1590,0
88292374957,88292374970,13,570,2501,0
88293493883,88293493883,0,1313,1876,0
88298649445,88298649449,4,2540,1725,0
88299306163,88299306162,-1,1038,1096,0
88302638386,88302638389,3,1288,1797,0
88303374921,88303374922,1,1721,1573,0
88303603419,88303603421,2,1236,1561,0
88304274242,88304274241,-1,2204,4053,0
88304514902,88304514899,-3,2064,4666,0
88304869575,88304869578,3,1185,1047,0
88308781041,88308781036,-5,1824,5047,0
88310655116,88310655117,1,1561,1357,0
88316330667,88316330669,2,1815,1547,0
88319970631,88319970631,0,1402,1771,0
88322455058,88322455058,0,1691,2388,0
88324290726,88324290733,7,2685,1250,0
88328951010,88328951011,1,1565,1979,0
88329574645,88329574632,-13,738,1461,0
88332117197,88332117199,2,2286,2086,0
88332358473,88332358471,-2,1386,1725,0
88333432654,88333432657,3,1360,1831,0
88336199098,88336199099,1,1990,2112,0
88338212686,88338212687,1,2121,1987,0
88339824237,88339824238,1,1189,924,0
88346909292,88346909293,1,1309,1809,0
88347664693,88347664693,0,1390,1623,0
88347800691,88347800690,-1,1347,2259,0
88350251597,88350251587,-10,3918,17442,0
88350851250,88350851250,0,927,1685,0
88352709987,88352709988,1,1417,2293,0
88353086032,88353086029,-3,937,1922,0
88354847554,88354847554,0,631,1200,0
88359811015,88359811016,1,990,1027,0
88362323911,88362323911,0,831,1083,0
88368694637,88368694639,2,1623,1886,0
88369464358,88369464357,-1,1518,2232,0
88378757978,88378757978,0,1313,1866,0
88382199435,88382199434,-1,1169,1324,0
88382697086,88382697087,1,860,1444,0
88384143212,88384143206,-6,2270,6510,0
88386252674,88386252673,-1,1111,1449,0
88387704366,88387704386,20,1036,1334,0
88388523182,88388523181,-1,1432,1236,0
88395653238,88395653238,0,916,1499,0
88397536116,88397536109,-7,1270,5091,0
88400744523,88400744526,3,1377,1333,0
88401181979,88401181979,0,824,1493,0
88401831950,88401831950,0,1268,1719,0
88404457198,88404457199,1,1547,1592,0
88406864630,88406864630,0,1807,1797,0
88409872841,88409872839,-2,1319,1823,0
88410540093,88410540097,4,2732,1430,0
88411788073,88411788075,2,1345,1209,0
88412296569,88412296568,-1,957,1155,0
88420288606,88420288606,0,1411,1421,0
88421207267,88421207266,-1,1514,1644,0
88421879668,88421879666,-2,1001,1563,0
88424275195,88424275195,0,1730,1883,0
88424593355,88424593354,-1,858,1264,0
88427519299,88427519298,-1,1378,2010,0
88427901847,88427901841,-6,889,2626,0
88429455249,88429455249,0,1606,1632,0
88432179411,88432179412,1,1325,1749,0
88432510278,88432510277,-1,1335,1702,0
88435449667,88435449669,2,1261,1360,0
88435991406,88435991404,-2,1986,2986,0
88440582278,88440582278,0,954,1063,0
88442823751,88442823749,-2,1322,1654,0
88447969357,88447969359,2,1347,1665,0
88450256979,88450256980,1,1456,1535,0
88451660378,88451660379,1,1405,2243,0
88453536955,88453536958,3,1016,1750,0
88455187246,88455187246,0,1398,1363,0
88460808445,88460808446,1,1081,1610,0
88461122515,88461122515,0,1558,1635,0
88465539533,88465539532,-1,1249,2131,0
88468671639,88468671641,2,1731,1989,0
88471329006,88471329007,1,1376,1327,0
88477082299,88477082301,2,1419,1609,0
88477183678,88477183678,0,1323,1332,0
88478442004,88478442005,1,1339,1497,0
88485725049,88485725047,-2,816,1027,0
88487112780,88487112781,1,1610,1897,0
88487592538,88487592538,0,1319,1548,0
88491685287,88491685287,0,1128,1063,0
88492728078,88492728081,3,1714,1626,0
88493822581,88493822581,0,1167,1255,0
88496314802,88496314804,2,1317,1633,0
88497960883,88497960876,-7,1075,3199,0
88498046734,88498046734,0,1527,1602,0
88499755021,88499755022,1,1183,1353,0
88502075831,88502075830,-1,572,1229,0
88503263869,88503263870,1,1573,1696,0
88504015746,88504015751,5,996,1157,0
88504980595,88504980598,3,1577,1958,0
88506798860,88506798859,-1,1490,1874,0
88517154135,88517154135,0,976,1817,0
88517808909,88517808910,1,2590,3207,0
88519381709,88519381707,-2,1220,1475,0
88523656358,88523656358,0,1028,893,0
88524365933,88524365933,0,1299,1472,0
88530666285,88530666284,-1,1245,1367,0
88532930772,88532930772,0,1186,2427,0
88535392258,88535392257,-1,1440,2325,0
88535782183,88535782185,2,1225,1834,0
88536431531,88536431533,2,1421,1384,0
88538254650,88538254646,-4,1618,2861,0
88540271628,88540271628,0,1907,2281,0
88540864201,88540864199,-2,1011,1440,0
88541174285,88541174286,1,1466,2064,0
88544944422,88544944422,0,1464,1415,0
88545830540,88545830542,2,1082,1780,0
88547467782,88547467781,-1,1774,1671,0
88547540502,88547540503,1,1757,2518,0
88547779087,88547779089,2,925,1645,0
88548305506,88548305508,2,1581,1856,0
88549799351,88549799351,0,1300,1255,0
88553415790,88553415790,0,2278,2229,0
88556033052,88556033052,0,1354,1788,0
88561980938,88561980938,0,1537,1759,0
88564708595,88564708595,0,1142,1229,0
88565646930,88565646926,-4,1996,5130,0
88569318382,88569318385,3,1349,1912,0
88572353710,88572353710,0,1725,2448,0
88572790127,88572790128,1,1588,2178,0
88573358837,88573358837,0,1300,1866,0
88574144837,88574144839,2,2410,1555,0
88581516854,88581516855,1,1547,1720,0
88582192550,88582192552,2,1431,2016,0
88591077959,88591077958,-1,1713,1831,0
88592565463,88592565464,1,1464,1494,0
88598420477,88598420477,0,1507,1945,0
88598474098,88598474098,0,1056,1909,0
88601449250,88601449250,0,1287,1420,0
88602498284,88602498277,-7,1228,4708,0
88602756378,88602756377,-1,1020,1426,0
88606587919,88606587918,-1,1200,1725,0
88607822445,88607822445,0,1397,1904,0
88612905298,88612905298,0,1182,1376,0
88614305215,88614305199,-16,1027,1227,0
88619238280,88619238281,1,1741,2105,0
88620247855,88620247856,1,1115,1286,0
88627991827,88627991827,0,761,1650,0
88630814842,88630814821,-21,1204,1712,0
88633768187,88633768190,3,1502,1908,0
88638011059,88638011057,-2,1132,1426,0
88638046932,88638046955,23,1653,2361,0
88642134697,88642134696,-1,1569,1524,0
88642289774,88642289774,0,1427,1978,0
88643890693,88643890693,0,1807,1910,0
88646108746,88646108747,1,1302,1181,0
88649196138,88649196138,0,1102,1550,0
88649945677,88649945697,20,1636,1894,0
88655555258,88655555258,0,1062,1141,0
88657687345,88657687345,0,1354,1230,0
88658433805,88658433806,1,1297,1308,0
88661705411,88661705412,1,1935,2293,0
88663600021,88663600020,-1,1115,1891,0
88666323858,88666323857,-1,3792,7304,0
88666610847,88666610848,1,1134,1600,0
88667694338,88667694342,4,3841,2359,0
88668164958,88668164958,0,1185,3230,0
88669681717,88669681717,0,1767,2365,0
88671627834,88671627835,1,1408,1295,0
88671689113,88671689116,3,4421,22479,0
88678268427,88678268429,2,1020,2061,0
88683167928,88683167927,-1,1658,1983,0
88683231970,88683231972,2,13793,21243,0
88684096778,88684096779,1,1248,1085,0
88685092796,88685092797,1,1293,1196,0
88687078030,88687078031,1,2592,3093,0
88687981333,88687981334,1,1546,1614,0
88688693165,88688693166,1,1676,1428,0
88688956565,88688956565,0,1477,2039,0
88692706370,88692706370,0,1087,1290,0
88693147769,88693147770,1,1167,2263,0
88694270166,88694270165,-1,1421,1879,0
88694763459,88694763437,-22,472,631,0
88697586916,88697586918,2,1217,1786,0
88699782047,88699782046,-1,1119,1894,0
88700755389,88700755391,2,1110,1250,0
88702003006,88702003006,0,970,1804,0
88703509369,88703509367,-2,2226,2529,0
88707980259,88707980257,-2,1289,1693,0
88708166017,88708166019,2,2131,1487,0
88710399479,88710399479,0,1152,1706,0
88715641304,88715641305,1,1216,1754,0
88715770706,88715770707,1,1442,2134,0
88716465626,88716465625,-1,738,1826,0
88717221571,88717221572,1,1201,1468,0
88719564052,88719564041,-11,947,787,0
88720607863,88720607842,-21,1119,1231,0
88724468542,88724468547,5,3198,1491,0
88728604118,88728604119,1,1372,1678,0
88729038384,88729038385,1,2085,2200,0
88729428450,88729428451,1,1103,2468,0
88731010654,88731010652,-2,1122,1778,0
88731108599,88731108597,-2,1134,1716,0
88732574172,88732574173,1,963,1587,0
88734259934,88734259934,0,1530,2170,0
88736645279,88736645279,0,1642,1798,0
88739059345,88739059345,0,1664,1309,0
88740088915,88740088917,2,1473,1861,0
88741853411,88741853410,-1,1851,2101,0
88747669303,88747669307,4,1258,1144,0
88748478973,88748478975,2,623,959,0
88750060179,88750060181,2,1173,1608,0
88752406523,88752406529,6,2840,1180,0
88754961487,88754961486,-1,948,1706,0
88755686074,88755686075,1,1730,1693,0
88756983363,88756983362,-1,1175,1650,0
88758187492,88758187494,2,1863,2544,0
88759411805,88759411802,-3,1032,1272,0
88760355751,88760355735,-16,1657,5331,0
88760549311,88760549309,-2,1756,3104,0
88763808941,88763808942,1,1477,2816,0
88764478254,88764478254,0,835,999,0
88765762459,88765762461,2,1373,1610,0
88766967249,88766967248,-1,1540,1921,0
88772871794,88772871794,0,1450,2430,0
88774678802,88774678802,0,1282,1425,0
88776753582,88776753583,1,1820,2175,0
88777077907,88777077907,0,1301,2364,0
88777129581,88777129580,-1,2206,3775,0
88781824863,88781824864,1,1479,1241,0
88782344138,88782344139,1,1436,1462,0
88786855530,88786855529,-1,1285,1804,0
88791660543,88791660542,-1,1065,2306,0
88791941675,88791941674,-1,1498,1595,0
88795388118,88795388119,1,2045,1892,0
88795421438,88795421437,-1,1414,2345,0
88797031178,88797031178,0,1346,1946,0
88798662325,88798662324,-1,1985,2513,0
88804246251,88804246251,0,1262,1836,0
88807131440,88807131443,3,1260,1719,0
88809381379,88809381383,4,9665,53040,0
88810166256,88810166251,-5,1086,2448,0
88810795338,88810795337,-1,1031,1384,0
88811266573,88811266574,1,1667,1624,0
88811888679,88811888679,0,356,608,0
88817224757,88817224754,-3,1395,2012,0
88817987732,88817987733,1,1471,1493,0
88819413665,88819413666,1,481,1490,0
88822173214,88822173214,0,1851,2186,0
88822780707,88822780710,3,1633,807,0
88823653524,88823653522,-2,1307,1704,0
88827055816,88827055815,-1,881,1057,0
88830368915,88830368915,0,1702,2558,0
88833120397,88833120403,6,2261,1133,0
88834082063,88834082067,4,1592,1765,0
88835456648,88835456650,2,1361,2175,0
88836830580,88836830581,1,1227,1363,0
88838686142,88838686142,0,1625,1686,0
88840555030,88840555026,-4,1362,768,0
88844699254,88844699255,1,1658,2001,0
88847496615,88847496615,0,1657,1609,0
88849364759,88849364763,4,1569,1372,0
88849941817,88849941818,1,1473,1738,0
88853155650,88853155651,1,1057,1269,0
88853436139,88853436142,3,2412,1899,0
88853515003,88853515004,1,1457,1675,0
88856496819,88856496823,4,1185,1462,0
88857786544,88857786545,1,1209,1381,0
88858262422,88858262422,0,1388,1394,0
88859091818,88859091819,1,1614,1777,0
88859824631,88859824637,6,2883,1092,0
88860892075,88860892076,1,1184,1756,0
88861542501,88861542501,0,1241,1757,0
88864922322,88864922321,-1,1981,1619,0
88866864871,88866864874,3,1244,1471,0
88866996103,88866996102,-1,1503,2120,0
88867329499,88867329501,2,1453,1472,0
88867674375,88867674375,0,1133,1386,0
88869754125,88869754131,6,3254,1240,0
88871879991,88871879992,1,1193,1023,0
88873351962,88873351962,0,1460,1717,0
88873655246,88873655247,1,1290,1967,0
88873901818,88873901820,2,2050,1417,0
88876036006,88876036008,2,1224,1399,0
88877789812,88877789814,2,1560,1131,0
88877906545,88877906538,-7,690,3749,0
88878578901,88878578923,22,840,1648,0
88878691735,88878691736,1,1459,2652,0
88881170822,88881170821,-1,2405,3126,0
88883338010,88883338007,-3,1326,1184,0
88884794217,88884794217,0,1193,1680,0
88885909206,88885909207,1,1766,2167,0
88886951879,88886951879,0,1825,2038,0
88887417331,88887417334,3,1746,1532,0
88888954002,88888954002,0,784,779,0
88890831190,88890831191,1,1268,1408,0
88891933292,88891933292,0,936,1610,0
88894992031,88894992030,-1,1186,1500,0
88896816974,88896816975,1,1216,2012,0
88898555785,88898555789,4,1324,1272,0
88899649340,88899649342,2,1394,1756,0
88900168747,88900168745,-2,1549,1398,0
88909141831,88909141832,1,1425,1845,0
88910234721,88910234718,-3,1114,1125,0
88910954610,88910954604,-6,1552,5587,0
88911136773,88911136774,1,1511,1966,0
88911610566,88911610567,1,1579,1874,0
88914601430,88914601431,1,1135,1205,0
88915972902,88915972905,3,1371,1799,0
88915999526,88915999526,0,1380,1325,0
88916247953,88916247953,0,1070,1903,0
88916328095,88916328096,1,1989,2224,0
88917116718,88917116716,-2,1570,1666,0
88919683827,88919683828,1,1789,1959,0
88920652603,88920652606,3,1001,1238,0
88926841900,88926841903,3,1453,1139,0
88926980268,88926980266,-2,1656,2079,0
88928610761,88928610763,2,1454,1976,0
88930421999,88930421998,-1,1935,1951,0
88932653186,88932653185,-1,1504,2049,0
88937810016,88937810016,0,1058,1535,0
88940003802,88940003801,-1,1981,1889,0
88940707715,88940707719,4,2046,957,0
88942158238,88942158238,0,1233,2183,0
88943048441,88943048445,4,1521,1239,0
88944785394,88944785393,-1,1749,1756,0
88948571310,88948571310,0,1538,1341,0
88949656830,88949656829,-1,1072,2108,0
88950419995,88950419995,0,1348,1714,0
88951337039,88951337040,1,1779,2228,0
88951640768,88951640767,-1,1944,2141,0
88951684453,88951684453,0,1089,1699,0
88952578185,88952578185,0,1936,2781,0
88958642777,88958642780,3,1851,1224,0
88968547780,88968547773,-7,2083,12799,0
88970973204,88970973205,1,1914,2225,0
88971249362,88971249365,3,1871,1729,0
88973718331,88973718331,0,1099,1085,0
88975187401,88975187402,1,1212,1571,0
88975883559,88975883561,2,1942,1531,0
88976634336,88976634337,1,1493,1988,0
88977656997,88977657018,21,908,1037,0
88978615602,88978615603,1,955,1501,0
88979357538,88979357538,0,1849,1915,0
88979572862,88979572862,0,1498,1669,0
88980452705,88980452706,1,1366,1573,0
88983048714,88983048715,1,1619,1812,0
88984574651,88984574656,5,2548,1925,0
88984694738,88984694741,3,2302,1838,0
88988239322,88988239322,0,1692,2080,0
88991537732,88991537734,2,987,958,0
88992886633,88992886634,1,3650,3476,0
88993608105,88993608106,1,1703,1661,0
88995245986,88995245988,2,1134,1398,0
88995367161,88995367163,2,1538,1390,0
88999183903,88999183904,1,1679,1836,0
89001105766,89001105764,-2,1071,1848,0
89010882770,89010882770,0,1647,2052,0
89011612545,89011612545,0,1376,1711,0
89016957806,89016957807,1,1215,1584,0
89019607057,89019607042,-15,1492,1725,0
89021643079,89021643078,-1,1427,1869,0
89023308382,89023308383,1,1789,1906,0
89025623060,89025623059,-1,1859,2119,0
89025936471,89025936474,3,2087,1711,0
89029228369,89029228370,1,1537,1758,0
89035351789,89035351791,2,827,1125,0
89035590343,89035590344,1,2023,2406,0
89043342896,89043342897,1,1253,2029,0
89045509897,89045509898,1,850,957,0
89046365190,89046365193,3,1330,1820,0
89046700540,89046700535,-5,892,1588,0
89047074995,89047074995,0,1049,1290,0
89052050460,89052050460,0,1260,1690,0
89053386782,89053386782,0,1295,1821,0
89055781359,89055781359,0,1360,1539,0
89061935771,89061935774,3,1878,2128,0
89062722570,89062722570,0,1240,1462,0
89068145190,89068145189,-1,1476,2253,0
89068253217,89068253219,2,1482,1667,0
89068555583,89068555586,3,1384,1175,0
89075604154,89075604154,0,1240,1573,0
89077340865,89077340867,2,1287,1644,0
89078852983,89078852983,0,1454,2247,0
89078883141,89078883143,2,1527,1540,0
89080036627,89080036628,1,781,1397,0
89081596621,89081596622,1,1398,2265,0
89083239595,89083239596,1,1566,1923,0
89083531050,89083531050,0,1406,1602,0
89085952087,89085952089,2,754,1297,0
89087938018,89087938019,1,1109,1839,0
89088280935,89088280937,2,1023,1179,0
89090769338,89090769338,0,1461,1497,0
89091789102,89091789103,1,1744,1495,0
89091923515,89091923515,0,1483,1626,0
89094071898,89094071899,1,1594,1362,0
89096648724,89096648725,1,1436,1210,0
89096849452,89096849450,-2,1751,1569,0
89102718398,89102718398,0,1296,1596,0
89106249311,89106249314,3,1896,1517,0
89108564749,89108564747,-2,1363,1122,0
89109165565,89109165564,-1,1308,1276,0
89109444649,89109444650,1,1186,1499,0
89112110459,89112110454,-5,1253,4134,0
89112496075,89112496076,1,1431,1641,0
89116719083,89116719085,2,1442,1360,0
89118999649,89118999649,0,1454,1741,0
89121280277,89121280278,1,1389,1297,0
89123063965,89123063965,0,1115,1946,0
89123825441,89123825442,1,1612,1505,0
89128479799,89128479798,-1,826,2090,0
89128746646,89128746647,1,1580,2342,0
89129175226,89129175228,2,1528,2069,0
89131219758,89131219750,-8,1137,5338,0
89132358986,89132358988,2,1609,1847,0
89139279782,89139279782,0,1444,1811,0
89140050507,89140050509,2,2003,2046,0
89140337377,89140337378,1,1263,1887,0
89144094437,89144094436,-1,1497,2087,0
89144493163,89144493162,-1,1199,2132,0
89144578149,89144578146,-3,1636,1794,0
89144871266,89144871264,-2,1496,1956,0
89146579900,89146579900,0,1901,1826,0
89146605341,89146605340,-1,1000,1362,0
89150229020,89150229022,2,1247,2008,0
89150981840,89150981840,0,1480,1530,0
89153560800,89153560801,1,1252,1511,0
89156240853,89156240853,0,1564,1752,0
89156833464,89156833465,1,1854,2145,0
89157660418,89157660418,0,1142,1673,0
89157711606,89157711607,1,1867,2605,0
89157876266,89157876265,-1,1450,1848,0
89158081351,89158081351,0,1181,1679,0
89158310726,89158310725,-1,973,1136,0
89159889866,89159889864,-2,1125,2405,0
89160304706,89160304707,1,1624,2021,0
89161324114,89161324114,0,1523,1588,0
89161615323,89161615323,0,1178,1573,0
89162364882,89162364883,1,2128,2038,0
89164694062,89164694061,-1,1273,1704,0
89166250055,89166250057,2,981,1111,0
89167061118,89167061118,0,1215,1541,0
89168421170,89168421170,0,1426,1528,0
89170199293,89170199293,0,1158,1536,0
89173145816,89173145816,0,2348,1692,0
89176451925,89176451923,-2,2274,2511,0
89177394097,89177394095,-2,1061,1700,0
89186619685,89186619684,-1,1464,1849,0
89187639514,89187639513,-1,1349,2030,0
89189761379,89189761381,2,1096,1768,0
89190213708,89190213706,-2,1173,2004,0
89192012764,89192012765,1,2030,1682,0
89193746616,89193746611,-5,1221,2484,0
89193975424,89193975424,0,1430,2005,0
89195938761,89195938761,0,1285,1672,0
89198251859,89198251859,0,1401,1332,0
89200967111,89200967110,-1,1642,1902,0
89205673555,89205673570,15,13502,48973,0
89207441911,89207441912,1,1548,1850,0
89208734041,89208734041,0,1854,1766,0
89210524422,89210524421,-1,1297,1982,0
89210612767,89210612767,0,1013,1096,0
89211063901,89211063902,1,1645,1614,0
89212155293,89212155294,1,2716,1947,0
89212304773,89212304773,0,1056,1283,0
89216018031,89216018031,0,1360,1384,0
89220191551,89220191552,1,839,1240,0
89223795156,89223795155,-1,1044,1715,0
89224468003,89224468003,0,1306,1422,0
89228903278,89228903277,-1,1595,2227,0
89229322346,89229322347,1,1740,1742,0
89229795806,89229795806,0,1249,1995,0
89230152318,89230152319,1,1362,1037,0
89235726505,89235726506,1,1408,2016,0
89237461583,89237461583,0,1372,1880,0
89238758634,89238758635,1,1733,1923,0
89241725531,89241725534,3,2172,1506,0
89241758394,89241758395,1,1499,1432,0
89244249434,89244249436,2,1400,1664,0
89244843121,89244843121,0,1185,1681,0
89246261686,89246261689,3,1767,1763,0
89246758190,89246758191,1,910,1435,0
89247957093,89247957095,2,1086,1195,0
89249766861,89249766854,-7,1482,11334,0
89257572627,89257572626,-1,1577,2342,0
89258580134,89258580132,-2,1362,1223,0
89259464302,89259464300,-2,1333,2014,0
89259568837,89259568837,0,1254,1450,0
89262379352,89262379351,-1,1110,1465,0
89265321162,89265321161,-1,1399,1603,0
89267128627,89267128628,1,2099,2222,0
89269391319,89269391318,-1,853,1434,0
89269684477,89269684478,1,1161,1656,0
89273976474,89273976474,0,1357,1493,0
89274318511,89274318510,-1,1185,1401,0
89275409773,89275409774,1,1525,1777,0
89276871981,89276871986,5,1717,1609,0
89279666406,89279666407,1,1210,1276,0
89281922409,89281922404,-5,1004,5182,0
89282768318,89282768320,2,1198,1597,0
89283919902,89283919905,3,1404,1427,0
89284641095,89284641093,-2,1443,2013,0
89286776781,89286776782,1,1179,1947,0
89288442336,89288442338,2,1398,1750,0
89288613815,89288613801,-14,1330,1637,0
89290884595,89290884594,-1,1880,2052,0
89291264728,89291264730,2,1725,1713,0
89291335211,89291335213,2,1015,1845,0
89291805126,89291805127,1,1468,1719,0
89294656918,89294656918,0,1529,1818,0
89296708701,89296708702,1,1042,1539,0
89297753238,89297753239,1,1416,1390,0
89299766679,89299766681,2,813,816,0
89300380421,89300380422,1,1022,1336,0
89301637660,89301637661,1,1547,2120,0
89301874401,89301874401,0,1188,2282,0
89302223003,89302223004,1,1315,1984,0
89302682631,89302682631,0,1586,1666,0
89302991497,89302991497,0,1472,1052,0
89303287771,89303287775,4,1761,1447,0
89310545855,89310545855,0,1062,1511,0
89318381853,89318381853,0,1086,1430,0
89319234352,89319234351,-1,1283,1740,0
89320424151,89320424153,2,1467,2111,0
89321359140,89321359137,-3,1177,2410,0
89329141602,89329141606,4,2032,1431,0
89330529651,89330529652,1,1247,1756,0
89332815071,89332815072,1,1669,2874,0
89333458450,89333458452,2,1421,2129,0
89335363064,89335363066,2,1933,1603,0
89340300768,89340300768,0,1191,1454,0
89340944505,89340944507,2,1282,1547,0
89342503145,89342503146,1,1261,1852,0
89344539385,89344539386,1,1289,1463,0
89345726551,89345726551,0,1147,1831,0
89346357452,89346357453,1,1199,2605,0
89348198157,89348198150,-7,1220,4219,0
89350876140,89350876139,-1,1171,1942,0
89352475714,89352475715,1,944,1256,0
89353751779,89353751780,1,1541,1347,0
89357878714,89357878714,0,1126,1512,0
89360325582,89360325582,0,1259,1397,0
89365158573,89365158595,22,1189,1592,0
89367599937,89367599938,1,1477,1900,0
89368090874,89368090874,0,1086,1492,0
89370211595,89370211596,1,1837,1743,0
89371187376,89371187372,-4,1180,2281,0
89378119026,89378119023,-3,1056,1573,0
89381699913,89381699917,4,1875,1384,0
89384374582,89384374585,3,1589,1998,0
89386173234,89386173236,2,1288,1086,0
89391297687,89391297684,-3,1921,3420,0
89394885079,89394885073,-6,1057,3965,0
89397930193,89397930195,2,1985,2072,0
89400168718,89400168718,0,1293,1392,0
89402576866,89402576866,0,1098,1472,0
89403510029,89403510029,0,1526,1395,0
89407565050,89407565050,0,828,1184,0
89408395613,89408395614,1,1539,2261,0
89410397297,89410397295,-2,1264,2276,0
89412466558,89412466562,4,1103,1372,0
89421324754,89421324754,0,2054,1422,0
89423636867,89423636869,2,1127,1382,0
89424145635,89424145634,-1,1452,2190,0
89425101525,89425101525,0,1680,1417,0
89426722122,89426722142,20,1141,1607,0
89427860557,89427860558,1,1086,1696,0
89430579530,89430579534,4,7656,5120,0
89431742174,89431742188,14,37758,12376,0
89432805519,89432805521,2,1287,1542,0
89433516851,89433516854,3,1794,1447,0
89434165528,89434165529,1,1452,2003,0
89436304406,89436304409,3,1636,1552,0
89440208646,89440208653,7,3745,1517,0
89440924134,89440924134,0,811,1208,0
89441946065,89441946066,1,1599,2121,0
89442176882,89442176886,4,2020,1113,0
89447232369,89447232369,0,1342,1714,0
89448275243,89448275246,3,1555,1636,0
89451950055,89451950055,0,1108,1425,0
89453579055,89453579055,0,985,1546,0
89455814622,89455814622,0,1615,1850,0
89459797221,89459797224,3,14562,10616,0
89459998714,89459998715,1,1405,2254,0
89461028205,89461028207,2,1237,1218,0
89461658163,89461658162,-1,1192,2422,0
89463052890,89463052890,0,1448,1632,0
89464063607,89464063608,1,1277,1156,0
89464648973,89464648990,17,1244,1980,0
89465809218,89465809221,3,1477,1376,0
89467260630,89467260630,0,1024,1447,0
89468543146,89468543149,3,2887,1412,0
89470694964,89470694962,-2,1362,1456,0
89470946412,89470946412,0,1522,1469,0
89471620987,89471620986,-1,1233,1525,0
89473471657,89473471654,-3,2054,3884,0
89476034366,89476034365,-1,1255,1526,0
89479501802,89479501801,-1,1392,1308,0
89481385612,89481385611,-1,1447,1651,0
89482241860,89482241848,-12,1099,1395,0
89483485223,89483485223,0,1456,1781,0
89485635901,89485635901,0,1235,1424,0
89486029534,89486029538,4,1450,2063,0
89492396019,89492396018,-1,711,1686,0
89494436779,89494436781,2,1052,1557,0
89495037418,89495037420,2,860,1326,0
89500370338,89500370340,2,1973,2395,0
89500636263,89500636262,-1,1925,3089,0
89503522019,89503522018,-1,914,1594,0
89506889250,89506889249,-1,985,1675,0
89507341955,89507341957,2,1467,2216,0
89507963765,89507963767,2,1976,2050,0
89510275724,89510275724,0,1580,1419,0
89510482282,89510482282,0,2044,2829,0
89511204823,89511204825,2,1667,1858,0
89515348231,89515348230,-1,1376,995,0
89516743903,89516743919,16,108,849,0
89525735065,89525735066,1,1448,1780,0
89528145759,89528145759,0,1683,1776,0
89529023338,89529023342,4,1552,1148,0
89531138489,89531138511,22,951,1338,0
89533971122,89533971120,-2,1272,1982,0
89538001537,89538001538,1,1012,1336,0
89538324551,89538324543,-8,975,1273,0
89539316788,89539316782,-6,1560,6926,0
89541319834,89541319835,1,1205,1778,0
89541707359,89541707354,-5,1149,3181,0
89545970578,89545970580,2,1650,2048,0
89548156503,89548156503,0,1239,1418,0
89549211451,89549211449,-2,1032,1424,0
89549509617,89549509615,-2,1114,1409,0
89550825023,89550825022,-1,1297,1456,0
89554757857,89554757858,1,1408,1474,0
89554978004,89554977991,-13,377,955,0
89559875014,89559875014,0,1114,1524,0
89563980458,89563980458,0,1436,1873,0
89567969669,89567969670,1,1366,1489,0
89569369778,89569369778,0,1701,1905,0
89569986630,89569986632,2,1767,1616,0
89570911515,89570911514,-1,1767,2463,0
89571872083,89571872084,1,2015,2144,0
89573102629,89573102629,0,1604,1686,0
89576802325,89576802326,1,1102,1945,0
89576951758,89576951758,0,1773,2032,0
89579356006,89579356006,0,1345,2417,0
89580013126,89580013130,4,1826,1673,0
89580972094,89580972095,1,987,1403,0
89586046249,89586046251,2,2020,2004,0
89591015677,89591015680,3,1089,1696,0
89591603474,89591603475,1,1588,1682,0
89592089598,89592089599,1,1102,1869,0
89594617494,89594617494,0,1252,1051,0
89596496221,89596496206,-15,1585,1146,0
89598238384,89598238381,-3,1560,2610,0
89599289471,89599289470,-1,1423,1577,0
89600010632,89600010632,0,976,1914,0
89600939969,89600939962,-7,1187,4775,0
89601271178,89601271178,0,1182,1514,0
89602185535,89602185533,-2,1635,2099,0
89603209750,89603209750,0,1501,2164,0
89603724586,89603724586,0,1201,1394,0
89608055534,89608055536,2,1227,1665,0
89608497842,89608497843,1,1142,1166,0
89609869234,89609869233,-1,1500,1740,0
89613681471,89613681471,0,1689,2252,0
89615360731,89615360730,-1,1885,2267,0
89619899947,89619899949,2,1081,1257,0
89621851858,89621851857,-1,1594,1447,0
89623950283,89623950285,2,1426,1653,0
89626492562,89626492557,-5,2278,5277,0
89627975481,89627975481,0,1096,1666,0
89628307953,89628307955,2,1717,1328,0
89628365194,89628365194,0,1156,1857,0
89629196046,89629196049,3,1287,2077,0
89630417121,89630417123,2,1974,2612,0
89633422142,89633422144,2,1060,1763,0
89633989647,89633989650,3,1620,1646,0
89634308407,89634308405,-2,1098,1264,0
89634946114,89634946115,1,1274,1624,0
89636833950,89636833951,1,1411,1414,0
89637813222,89637813212,-10,1159,2182,0
89637873213,89637873215,2,888,1400,0
89638245192,89638245192,0,1420,1724,0
89638430295,89638430294,-1,1442,1774,0
89639105208,89639105207,-1,1317,2756,0
89641791519,89641791522,3,1085,1714,0
89642736854,89642736871,17,590,984,0
89643691747,89643691747,0,906,1472,0
89644204550,89644204534,-16,1403,2259,0
89648516279,89648516280,1,890,1426,0
89649495109,89649495119,10,786,878,0
89650205934,89650205938,4,3372,936,0
89650325254,89650325254,0,1248,1633,0
89652827587,89652827587,0,1203,1600,0
89654704094,89654704097,3,1469,1220,0
89661642483,89661642482,-1,1078,1924,0
89663863923,89663863923,0,1085,1293,0
89666049560,89666049560,0,1029,1796,0
89671415789,89671415791,2,1878,2095,0
89671832739,89671832741,2,1262,1499,0
89671928796,89671928796,0,1483,1900,0
89672778439,89672778438,-1,1190,1797,0
89676157486,89676157487,1,1204,1327,0
89677029821,89677029822,1,1712,2441,0
89677310938,89677310940,2,1685,1594,0
89682354961,89682354963,2,1599,1628,0
89682463371,89682463373,2,1935,1855,0
89685104701,89685104701,0,1196,1887,0
89685731485,89685731473,-12,27238,14918,0
89687384046,89687384045,-1,1434,1524,0
89690653987,89690653986,-1,915,1772,0
89691935947,89691935948,1,1075,1978,0
89692230194,89692230194,0,1135,1551,0
89694188994,89694188994,0,1573,2312,0
89697857817,89697857819,2,1236,1299,0
89698043857,89698043838,-19,1321,641,0
89706722798,89706722798,0,986,1577,0
89711063030,89711063031,1,1750,1531,0
89711267583,89711267586,3,1339,1463,0
89711589527,89711589523,-4,1431,1574,0
89713625801,89713625802,1,2076,1548,0
89713655322,89713655321,-1,1319,1602,0
89714736311,89714736311,0,1285,1704,0
89717796127,89717796128,1,1533,2337,0
89719124454,89719124453,-1,1373,2155,0
89720017485,89720017486,1,1770,1651,0
89720700655,89720700658,3,948,1078,0
89722412316,89722412318,2,1646,1815,0
89722602602,89722602603,1,1529,2200,0
89724227119,89724227114,-5,1614,3666,0
89725158125,89725158127,2,1461,1066,0
89725271587,89725271588,1,1298,1443,0
89729830733,89729830734,1,1309,1909,0
89733774943,89733774944,1,1214,1505,0
89736199135,89736199135,0,1196,1351,0
89736423591,89736423592,1,1784,1767,0
89739956674,89739956671,-3,1275,2418,0
89740133058,89740133058,0,1539,1831,0
89741675903,89741675905,2,880,1404,0
89745853058,89745853059,1,1722,1961,0
89749883189,89749883190,1,1075,1054,0
89763461045,89763461045,0,1470,1174,0
89766541153,89766541155,2,1329,1589,0
89768677394,89768677393,-1,1403,1606,0
89769947588,89769947587,-1,1507,1451,0
89771322450,89771322457,7,4931,2091,0
89775646390,89775646388,-2,1038,1835,0
89775832124,89775832111,-13,1294,396,0
89777870670,89777870670,0,1235,1574,0
89778588486,89778588507,21,1431,1803,0
89778735382,89778735381,-1,1141,1544,0
89780512021,89780512020,-1,1073,1750,0
89782515782,89782515783,1,1082,1539,0
89783712130,89783712133,3,3008,2235,0
89785720974,89785720974,0,1552,1715,0
89788186060,89788186061,1,1564,2325,0
89790405350,89790405349,-1,1119,1868,0
89793121354,89793121356,2,1615,1727,0
89795837198,89795837198,0,1150,1704,0
89799254894,89799254896,2,1591,1639,0
89801175396,89801175398,2,1590,1491,0
89802147784,89802147783,-1,1080,1942,0
89804009520,89804009522,2,1722,1886,0
89807474162,89807474162,0,2181,2139,0
89807561015,89807561016,1,1670,2077,0
89809578185,89809578186,1,1663,2450,0
89817222392,89817222389,-3,1730,1683,0
89819350379,89819350379,0,1315,1562,0
89819552484,89819552485,1,1327,1537,0
89825413698,89825413699,1,1438,1680,0
89827766574,89827766573,-1,886,1084,0
89829211542,89829211542,0,1818,2146,0
89831046382,89831046389,7,2747,1077,0
89832784950,89832784946,-4,889,1654,0
89835270830,89835270829,-1,1349,1788,0
89839491899,89839491899,0,1568,2505,0
89841025190,89841025191,1,1496,1829,0
89843199949,89843199947,-2,1411,1936,0
89844793527,89844793526,-1,1899,2281,0
89848019033,89848019031,-2,1443,1829,0
89848122686,89848122681,-5,1309,1382,0
89850464547,89850464546,-1,1037,1538,0
89851317254,89851317260,6,1097,1485,0
89853169762,89853169763,1,1599,1760,0
89853950135,89853950133,-2,1168,1630,0
89857064891,89857064890,-1,1421,3260,0
89858206749,89858206750,1,1298,1551,0
89859022436,89859022435,-1,1023,1517,0
89861241245,89861241244,-1,1684,2187,0
89861457215,89861457218,3,1700,1042,0
89867784499,89867784501,2,1801,1832,0
89868460853,89868460854,1,1406,1865,0
89868664591,89868664590,-1,1555,2082,0
89870154518,89870154521,3,1107,1774,0
89873439594,89873439598,4,2408,1925,0
89889784721,89889784721,0,1170,1821,0
89891451832,89891451833,1,1319,1510,0
89893239923,89893239925,2,1091,1140,0
89894626954,89894626954,0,791,1064,0
89894713819,89894713820,1,444,528,0
89896102160,89896102168,8,260,1226,0
89897290853,89897290855,2,2306,1594,0
89900483845,89900483847,2,1941,1542,0
89902858259,89902858257,-2,1065,1781,0
89903336027,89903336029,2,1362,1796,0
89904114655,89904114657,2,1119,1353,0
89904606919,89904606920,1,2003,2490,0
89907283559,89907283559,0,1277,2123,0
89909229824,89909229826,2,1365,1650,0
89911682561,89911682562,1,1420,1292,0
89912628589,89912628589,0,1357,1621,0
89913266974,89913266972,-2,1460,1944,0
89914135321,89914135322,1,1428,2148,0
89915740430,89915740429,-1,1713,2163,0
89920188113,89920188115,2,1818,1850,0
89922034760,89922034759,-1,1330,1720,0
89922144607,89922144598,-9,983,1443,0
89922242308,89922242300,-8,1445,1523,0
89924753806,89924753804,-2,1484,2750,0
89926916768,89926916770,2,1446,2061,0
89927967573,89927967573,0,1121,1505,0
89929850101,89929850107,6,3588,1685,0
89934355522,89934355523,1,1528,2289,0
89940229287,89940229292,5,2275,1189,0
89940448154,89940448154,0,1039,1207,0
89942774708,89942774709,1,1555,1949,0
89943679120,89943679121,1,1412,1561,0
89949144663,89949144663,0,1652,2809,0
89949760051,89949760053,2,1459,1664,0
89950658982,89950658982,0,1394,2461,0
89953667870,89953667869,-1,1425,2059,0
89956627530,89956627530,0,1392,1281,0
89959863722,89959863723,1,889,1222,0
89962149662,89962149664,2,1541,1397,0
89964484769,89964484773,4,1449,1201,0
89965359374,89965359373,-1,1204,1245,0
89966486479,89966486479,0,795,1223,0
89967178315,89967178316,1,1378,1957,0
89967246419,89967246419,0,1138,1418,0
89967363889,89967363889,0,999,2082,0
89967598600,89967598600,0,1211,1655,0
89969180609,89969180610,1,1460,1434,0
89971046670,89971046670,0,1070,1950,0
89973540726,89973540725,-1,1164,1530,0
89981161521,89981161520,-1,856,1310,0
89982759431,89982759426,-5,1338,4463,0
89984419359,89984419361,2,1767,1996,0
89987339060,89987339061,1,1816,1535,0
89988677415,89988677415,0,1871,1925,0
89995394170,89995394170,0,1514,1854,0
89995686519,89995686517,-2,1191,1775,0
89996029777,89996029778,1,978,1705,0
89996064072,89996064074,2,1600,1232,0
89997210521,89997210522,1,12414,13463,0
90000227318,90000227318,0,1039,1612,0
90001523421,90001523423,2,1546,1203,0
90003393034,90003393034,0,1355,1377,0
90004555918,90004555913,-5,49699,23644,0
90007211340,90007211339,-1,1894,2481,0
90007807686,90007807686,0,1142,1361,0
90009168123,90009168125,2,1589,2187,0
90009221089,90009221089,0,1300,1511,0
90010643718,90010643720,2,1903,1654,0
90012114281,90012114281,0,1265,1616,0
90014617066,90014617061,-5,1008,2713,0
90019490145,90019490139,-6,1709,5603,0
90027399758,90027399755,-3,1346,1195,0
90028397250,90028397250,0,1711,2322,0
90029039499,90029039496,-3,2134,5981,0
90031518522,90031518519,-3,701,1140,0
90037501451,90037501450,-1,1316,1300,0
90037614274,90037614273,-1,1392,1752,0
90048151838,90048151840,2,1000,1045,0
90049095838,90049095838,0,1042,1749,0
90051740246,90051740247,1,1066,1282,0
90052333780,90052333783,3,1369,1543,0
90054926545,90054926544,-1,1169,1766,0
90055074589,90055074589,0,1624,2063,0
90056348826,90056348827,1,1294,2059,0
90058862108,90058862107,-1,1361,1772,0
90063735171,90063735171,0,1082,2203,0
90063808351,90063808351,0,1325,1402,0
90064845719,90064845717,-2,1475,1497,0
90065668479,90065668479,0,1251,1797,0
90066702145,90066702146,1,1107,1053,0
90069118318,90069118314,-4,1948,3712,0
90069337209,90069337209,0,1164,1920,0
90072036573,90072036579,6,3517,1898,0
90072608400,90072608399,-1,1295,2391,0
90073885509,90073885508,-1,1055,1463,0
90073922842,90073922843,1,655,861,0
90077256768,90077256769,1,1404,1399,0
90079409727,90079409727,0,923,2082,0
90081551290,90081551289,-1,2216,3149,0
90081834242,90081834237,-5,1342,1458,0
90084658047,90084658046,-1,806,1145,0
90086943301,90086943303,2,1311,1711,0
90089447826,90089447825,-1,1108,1353,0
90090312529,90090312531,2,1635,1632,0
90095916346,90095916346,0,1488,1600,0
90097695066,90097695064,-2,867,1541,0
90098265635,90098265636,1,1718,2366,0
90103126152,90103126151,-1,1566,1960,0
90104580113,90104580113,0,1063,1834,0
90107967422,90107967421,-1,1766,2616,0
90109021849,90109021850,1,1249,1318,0
90110524014,90110524012,-2,1211,1566,0
90110900890,90110900894,4,2858,1958,0
90111009169,90111009173,4,1656,1653,0
90114672813,90114672815,2,1292,1811,0
90115434009,90115434009,0,1047,1266,0
90116389193,90116389193,0,1249,1695,0
90117499927,90117499929,2,1978,1370,0
90121020135,90121020134,-1,1221,1850,0
90121482786,90121482788,2,1455,1286,0
90121567646,90121567646,0,1191,2004,0
90123099042,90123099042,0,1192,1215,0
90124309637,90124309638,1,1133,935,0
90125481245,90125481246,1,1147,1185,0
90125716192,90125716191,-1,1387,2072,0
90126974047,90126974047,0,1854,2239,0
90128459234,90128459235,1,1226,1759,0
90129427762,90129427762,0,1128,1573,0
90130159962,90130159961,-1,1629,1494,0
90133578093,90133578093,0,1483,1373,0
90136719870,90136719871,1,1664,2492,0
90138612752,90138612753,1,1156,845,0
90140039793,90140039797,4,1534,1713,0
90142109066,90142109062,-4,1796,3061,0
90152348812,90152348813,1,1585,2254,0
90153642594,90153642595,1,1535,1969,0
90155452447,90155452447,0,949,1163,0
90156254207,90156254210,3,2121,1781,0
90156453582,90156453583,1,1080,1704,0
90158505225,90158505226,1,748,1243,0
90159001698,90159001700,2,1175,1503,0
90159760129,90159760126,-3,1320,1547,0
90160582179,90160582180,1,1041,2449,0
90162364918,90162364918,0,1771,1630,0
90163366082,90163366083,1,1522,1147,0
90167996711,90167996713,2,1612,1835,0
90168631482,90168631482,0,1106,1303,0
90168884598,90168884597,-1,1529,2151,0
90169220350,90169220350,0,1296,1695,0
90169606207,90169606207,0,1111,1690,0
90171786082,90171786081,-1,1629,1597,0
90174500977,90174500978,1,1080,1838,0
90176853705,90176853705,0,1890,1865,0
90178428068,90178428070,2,1404,1438,0
90181229451,90181229451,0,1533,1568,0
90181440230,90181440232,2,30709,22576,0
90183119677,90183119678,1,1081,1113,0
90184396947,90184396951,4,1384,1715,0
90186090718,90186090718,0,1327,1667,0
90188408209,90188408210,1,2106,1779,0
90188716054,90188716055,1,1025,1247,0
90190104992,90190104993,1,898,1995,0
90190651707,90190651707,0,1261,1909,0
90194082034,90194082035,1,1306,1645,0
90198689104,90198689103,-1,1228,1571,0
90201542919,90201542919,0,1024,2009,0
90211132564,90211132565,1,1534,1992,0
90212514997,90212514999,2,1378,1457,0
90212609416,90212609418,2,1853,1922,0
90212706926,90212706917,-9,1841,758,0
90214487793,90214487795,2,1114,973,0
90215955934,90215955933,-1,1209,1718,0
90220845297,90220845299,2,1705,1546,0
90226010979,90226010979,0,913,1673,0
90227296077,90227296070,-7,1108,2127,0
90227407560,90227407579,19,1169,1420,0
90229101266,90229101263,-3,1396,1786,0
90229831030,90229831030,0,1839,1499,0
90230812026,90230812020,-6,1236,6037,0
90231703066,90231703063,-3,817,2120,0
90232220741,90232220742,1,1671,1798,0
90232794948,90232794950,2,1747,1771,0
90234389738,90234389737,-1,1778,2491,0
90234529862,90234529867,5,3445,1700,0
90235561172,90235561171,-1,1935,1502,0
90235599457,90235599458,1,2552,2886,0
90240569282,90240569282,0,1575,1983,0
90242665509,90242665509,0,1707,2067,0
90244890538,90244890539,1,1275,1071,0
90248093442,90248093442,0,1495,1821,0
90248983055,90248983050,-5,31807,11044,0
90252060805,90252060806,1,1594,1837,0
90255038434,90255038425,-9,46677,13527,0
90258005303,90258005302,-1,1340,1823,0
90258523304,90258523305,1,1597,1514,0
90259933500,90259933502,2,1348,1630,0
90262608220,90262608220,0,1051,1668,0
90262944118,90262944120,2,1034,1538,0
90263782742,90263782742,0,1350,1520,0
90267005096,90267005095,-1,959,1460,0
90269699501,90269699500,-1,1259,2354,0
90270439571,90270439578,7,11139,32350,0
90277568863,90277568865,2,1477,1393,0
90281972567,90281972549,-18,1548,1227,0
90284138685,90284138692,7,6850,2529,0
90288421145,90288421142,-3,1194,1667,0
90289228432,90289228433,1,1753,1770,0
90289323058,90289323058,0,1711,2294,0
90291577699,90291577704,5,5718,3132,0
90292546767,90292546767,0,1506,2204,0
90292706961,90292706962,1,1422,1372,0
90297499692,90297499695,3,1494,966,0
90301159671,90301159671,0,1080,1509,0
90301848870,90301848848,-22,1387,636,0
90304106788,90304106787,-1,1450,1912,0
90304917194,90304917195,1,2176,2252,0
90305607769,90305607767,-2,1493,2047,0
90305878037,90305878033,-4,5985,14793,0
90309345099,90309345098,-1,1055,1320,0
90310926522,90310926510,-12,1548,1602,0
90312274720,90312274725,5,2981,1349,0
90315966977,90315966977,0,1517,1414,0
90320052273,90320052275,2,1709,2261,0
90320372537,90320372538,1,1481,1368,0
90323476412,90323476415,3,1105,1496,0
90325932133,90325932134,1,1521,2420,0
90329647046,90329647046,0,1449,2050,0
90332288343,90332288342,-1,1349,1165,0
90334158702,90334158704,2,1459,1859,0
90336919779,90336919781,2,1810,1573,0
90339662595,90339662595,0,1110,1587,0
90343248989,90343248993,4,938,736,0
90343577452,90343577454,2,1373,1418,0
90344981210,90344981211,1,957,1601,0
90346547681,90346547681,0,1632,2175,0
90347442037,90347442038,1,1288,1540,0
90348117940,90348117930,-10,1282,1782,0
90349755975,90349755975,0,1624,1724,0
90352251447,90352251443,-4,1496,2105,0
90353060424,90353060426,2,1578,1603,0
90354806327,90354806327,0,998,1322,0
90355522414,90355522401,-13,239,638,0
90356863909,90356863910,1,1479,1939,0
90358434735,90358434733,-2,1547,1750,0
90361353814,90361353814,0,1517,2324,0
90362319845,90362319844,-1,1942,2094,0
90365567469,90365567470,1,1435,1773,0
90366802581,90366802582,1,1117,1360,0
90367568366,90367568365,-1,1618,1946,0
90369360307,90369360306,-1,1264,2072,0
90370769229,90370769230,1,1199,1521,0
90374268419,90374268421,2,740,1233,0
90376094902,90376094900,-2,1504,2145,0
90378858827,90378858826,-1,801,1222,0
90381082500,90381082506,6,3016,1619,0
90382169474,90382169472,-2,873,1200,0
90383390222,90383390221,-1,1641,1926,0
90384051290,90384051294,4,1637,1014,0
90386633760,90386633760,0,1413,1355,0
90388055124,90388055126,2,1625,1848,0
90388321613,90388321614,1,1229,1094,0
90388412434,90388412433,-1,1369,2698,0
90392220800,90392220799,-1,25243,13174,0
90392284451,90392284450,-1,1539,1813,0
90393551727,90393551727,0,935,1336,0
90393621325,90393621325,0,1634,1376,0
90394843647,90394843650,3,1667,1344,0
90401628113,90401628113,0,1413,2278,0
90404206198,90404206200,2,994,950,0
90406036057,90406036058,1,1350,2277,0
90406816180,90406816178,-2,992,2004,0
90407743031,90407743030,-1,967,1437,0
90409752419,90409752420,1,1453,1277,0
90410859019,90410859019,0,1193,1585,0
90417035122,90417035117,-5,1301,3386,0
90417575030,90417575030,0,1722,1547,0
90418378963,90418378964,1,1127,1132,0
90419829631,90419829630,-1,1065,1664,0
90420894325,90420894326,1,1445,1465,0
90423222666,90423222667,1,954,1384,0
90424297553,90424297553,0,1629,1873,0
90425690267,90425690265,-2,1145,1238,0
90426834509,90426834511,2,2085,1896,0
90430802500,90430802499,-1,1565,1894,0
90432376098,90432376097,-1,863,1614,0
90433638625,90433638626,1,1516,1698,0
90436510515,90436510515,0,1431,2010,0
90440493845,90440493845,0,1562,1934,0
90441439737,90441439737,0,2025,2229,0
90441610233,90441610234,1,880,1489,0
90442740246,90442740246,0,1268,1571,0
90451976482,90451976482,0,1733,1744,0
90454155417,90454155418,1,1291,1809,0
90455660157,90455660158,1,1708,2186,0
90456763830,90456763831,1,1591,1586,0
90459813295,90459813297,2,1292,2086,0
90460804358,90460804361,3,1373,1311,0
90462934345,90462934349,4,1889,1094,0
90466442482,90466442481,-1,1229,2331,0
90466544922,90466544924,2,1169,1649,0
90471891476,90471891477,1,1215,1320,0
90473903003,90473903001,-2,1691,1443,0
90474718475,90474718479,4,1456,1062,0
90474909717,90474909716,-1,1217,1233,0
90476428422,90476428423,1,1100,1620,0
90476507357,90476507336,-21,536,935,0
90479544466,90479544465,-1,1184,2178,0
90480386625,90480386626,1,1010,1370,0
90482914042,90482914044,2,905,863,0
90484795506,90484795504,-2,1076,1794,0
90489722733,90489722746,13,914,1106,0
90492594443,90492594444,1,1076,988,0
90493220896,90493220902,6,3680,1462,0
90493686087,90493686086,-1,1873,2493,0
90499466630,90499466630,0,1812,2023,0
90503748143,90503748145,2,1403,2027,0
90503922909,90503922909,0,1229,1669,0
90506874203,90506874205,2,1585,1907,0
90507379842,90507379846,4,1665,1871,0
90518086422,90518086423,1,1994,2230,0
90522082622,90522082620,-2,1296,1219,0
90523075933,90523075918,-15,970,3060,0
90526310035,90526310035,0,716,1379,0
90528532422,90528532423,1,1449,1662,0
90535845189,90535845192,3,1453,1444,0
90535968966,90535968971,5,1336,1351,0
90538694869,90538694870,1,1516,2021,0
90540642072,90540642069,-3,890,1440,0
90544548802,90544548803,1,1580,2000,0
90546229714,90546229709,-5,2108,4924,0
90548239613,90548239614,1,1372,1195,0
90549522682,90549522682,0,928,1866,0
90549922596,90549922593,-3,1230,1742,0
90550680159,90550680159,0,1687,1773,0
90554003244,90554003235,-9,135,2621,0
90555657670,90555657669,-1,971,2118,0
90555856694,90555856692,-2,1519,1445,0
90556206110,90556206110,0,1958,1879,0
90561844109,90561844110,1,1003,1576,0
90564269903,90564269907,4,1608,1295,0
90571210287,90571210285,-2,704,1789,0
90573270165,90573270166,1,1113,1530,0
90573905077,90573905076,-1,847,1459,0
90574189799,90574189797,-2,1277,1949,0
90574534174,90574534174,0,1321,1502,0
90578964509,90578964508,-1,1057,1107,0
90585071649,90585071649,0,1019,803,0
90594253976,90594253977,1,1378,1801,0
90599024166,90599024166,0,1050,1865,0
90601467458,90601467458,0,4286,6445,0
90601763914,90601763913,-1,1617,2659,0
90602393270,90602393270,0,1124,1301,0
90607515698,90607515698,0,1088,994,0
90609157919,90609157917,-2,1043,1516,0
90609309442,90609309443,1,1766,1607,0
90611609284,90611609281,-3,2422,4461,0
90611998961,90611998959,-2,602,1211,0
90613683973,90613683952,-21,1884,839,0
90614394118,90614394118,0,1434,2090,0
90617339210,90617339211,1,1649,1048,0
90624213994,90624213995,1,926,1193,0
90627661278,90627661279,1,978,1094,0
90631423620,90631423620,0,1511,1269,0
90631970792,90631970790,-2,1127,1570,0
90632131800,90632131802,2,922,2013,0
90637784558,90637784558,0,1004,1695,0
90638350231,90638350230,-1,1950,3235,0
90641402268,90641402269,1,1472,1056,0
90641712275,90641712276,1,1386,1261,0
90642374498,90642374500,2,1171,1620,0
90643796489,90643796490,1,1819,1901,0
90644168653,90644168654,1,1729,1686,0
90651185140,90651185116,-24,1206,1553,0
90651890134,90651890135,1,1040,1787,0
90652533454,90652533446,-8,1696,1379,0
90653841338,90653841337,-1,1488,1746,0
90655928694,90655928694,0,1803,1615,0
90658274763,90658274759,-4,1158,1366,0
90659328342,90659328343,1,1332,1958,0
90659902317,90659902319,2,2038,2860,0
90661904273,90661904274,1,989,1107,0
90664867026,90664867026,0,1325,1766,0
90665919084,90665919085,1,1598,2081,0
90667184180,90667184199,19,1655,1530,0
90668918450,90668918450,0,1813,1750,0
90669670191,90669670190,-1,1277,1828,0
90670849334,90670849319,-15,1263,1481,0
90676208221,90676208223,2,1709,1548,0
90677787210,90677787210,0,1580,1750,0
90680073172,90680073173,1,1565,1719,0
90682837352,90682837347,-5,1906,5725,0
90683004220,90683004218,-2,1414,1778,0
90683115903,90683115903,0,1211,1091,0
90683667033,90683667015,-18,1354,1819,0
90683973535,90683973535,0,1468,1783,0
90684036951,90684036950,-1,1450,2335,0
90687248263,90687248263,0,1574,1143,0
90690891766,90690891770,4,1438,1701,0
90695988215,90695988216,1,1465,2163,0
90700297863,90700297862,-1,190,2521,0
90701516440,90701516442,2,1266,1432,0
90703511295,90703511294,-1,1036,1902,0
90704259658,90704259659,1,1312,1643,0
90704408153,90704408153,0,1239,1638,0
90705214598,90705214598,0,1428,2511,0
90711120810,90711120812,2,5585,20016,0
90711313641,90711313645,4,1661,1295,0
90712262223,90712262223,0,1753,2027,0
90713074976,90713074973,-3,1358,1520,0
90717402798,90717402798,0,1260,1836,0
90717765991,90717765993,2,1033,1690,0
90725325550,90725325551,1,1354,1855,0
90736274042,90736274039,-3,1004,1182,0
90739184634,90739184634,0,1533,1450,0
90739765822,90739765822,0,1009,1466,0
90743377798,90743377799,1,1723,1841,0
90744893291,90744893292,1,1295,1720,0
90749282402,90749282403,1,1561,1655,0
90750048362,90750048362,0,1609,1540,0
90750731147,90750731145,-2,1173,1364,0
90752084128,90752084126,-2,1312,1503,0
90759685208,90759685208,0,1470,2382,0
90761496265,90761496266,1,1478,1752,0
90762378089,90762378089,0,1274,1903,0
90762894157,90762894155,-2,2040,2019,0
90766563935,90766563934,-1,1050,2467,0
90771877451,90771877450,-1,1739,1781,0
90772514740,90772514723,-17,1431,1775,0
90773483141,90773483142,1,1454,1672,0
90778469534,90778469532,-2,1137,2476,0
90785762910,90785762910,0,1113,1588,0
90786177318,90786177319,1,1822,1298,0
90789035366,90789035365,-1,1580,1267,0
90790050656,90790050659,3,2741,2380,0
90791361281,90791361278,-3,1787,2379,0
90793449646,90793449648,2,1929,1336,0
90794594335,90794594338,3,1234,1453,0
90795820553,90795820554,1,6136,7009,0
90795937330,90795937331,1,1817,2147,0
90796745668,90796745667,-1,1291,2368,0
90799462314,90799462314,0,992,2083,0
90803680931,90803680932,1,1353,1297,0
90805869713,90805869714,1,1083,1930,0
90806217206,90806217208,2,2278,1603,0
90810243955,90810243957,2,1335,1520,0
90812131782,90812131781,-1,1136,1566,0
90817161267,90817161266,-1,1056,1894,0
90819520614,90819520615,1,829,1079,0
90821971505,90821971503,-2,1451,1768,0
90825593805,90825593805,0,1171,1500,0
90830257603,90830257605,2,1343,1622,0
90832334572,90832334573,1,1840,1424,0
90834432279,90834432278,-1,960,2495,0
90836149463,90836149465,2,2759,2429,0
90837233579,90837233578,-1,1357,1749,0
90842810190,90842810190,0,1550,2121,0
90843515198,90843515200,2,1705,1960,0
90844088977,90844088978,1,1312,1057,0
90851227827,90851227826,-1,1401,1974,0
90853329648,90853329646,-2,1688,1289,0
90853669350,90853669350,0,1832,2565,0
90854716767,90854716782,15,839,1432,0
90856089854,90856089854,0,1098,1602,0
90860434525,90860434531,6,1717,2238,0
90860774159,90860774159,0,1461,1437,0
90863180221,90863180226,5,1965,1021,0
90867860489,90867860490,1,1081,2131,0
90869376574,90869376574,0,1371,2040,0
90876999384,90876999381,-3,1149,1437,0
90881679868,90881679868,0,1034,1845,0
90888156779,90888156762,-17,1347,1117,0
90888876762,90888876763,1,1347,1859,0
90889838213,90889838214,1,607,1545,0
90893325422,90893325424,2,1685,1994,0
90893439056,90893439057,1,1257,1979,0
90895042342,90895042342,0,1193,1234,0
90900456718,90900456712,-6,1024,5203,0
90902116769,90902116769,0,1197,1583,0
90903554825,90903554817,-8,1799,8490,0
90904169585,90904169587,2,1063,1369,0
90907583220,90907583219,-1,1638,2159,0
90908612223,90908612222,-1,1486,1734,0
90909439650,90909439654,4,1780,1223,0
90913946600,90913946598,-2,1631,2998,0
90916838619,90916838635,16,1170,1182,0
90917893937,90917893938,1,1695,2384,0
90920953416,90920953415,-1,1355,2297,0
90923609770,90923609770,0,1821,1518,0
90927636794,90927636797,3,1310,1419,0
90935465410,90935465411,1,1433,1821,0
90938189826,90938189827,1,1440,1525,0
90938239351,90938239353,2,1683,1709,0
90939112860,90939112861,1,1733,1639,0
90943334974,90943334975,1,1472,1800,0
90943467198,90943467194,-4,1204,2074,0
90946376619,90946376618,-1,1616,1278,0
90947242938,90947242940,2,1608,1644,0
90952655502,90952655502,0,1429,1853,0
90952826193,90952826195,2,1505,1391,0
90957631003,90957631003,0,1308,1331,0
90958214266,90958214270,4,1528,1148,0
90958729763,90958729764,1,1579,1872,0
90962882690,90962882691,1,1150,1308,0
90963767731,90963767728,-3,1106,2604,0
90966407542,90966407542,0,1357,1695,0
90968449395,90968449395,0,1635,2539,0
90970092369,90970092367,-2,1410,2179,0
90970258194,90970258194,0,1046,1762,0
90975156633,90975156634,1,1086,1560,0
90979115037,90979115033,-4,1621,3810,0
90979173351,90979173354,3,1038,1630,0
90984216782,90984216782,0,779,1162,0
90988622782,90988622784,2,1909,2386,0
90988761711,90988761712,1,1300,1500,0
90988810744,90988810745,1,1496,1466,0
90992382813,90992382814,1,1872,1100,0
90995402197,90995402196,-1,21984,18271,0
90996804009,90996804004,-5,1273,3475,0
90998422533,90998422534,1,1293,1462,0
91001072723,91001072725,2,1127,1821,0
91003643361,91003643362,1,2318,1989,0
91004740530,91004740530,0,2240,2205,0
91010708755,91010708753,-2,1494,1600,0
91011305595,91011305596,1,957,1534,0
91012901218,91012901218,0,1437,1500,0
91013632069,91013632069,0,1912,1695,0
91018888882,91018888882,0,1292,1933,0
91023120199,91023120199,0,1544,1448,0
91030720141,91030720141,0,935,1589,0
91031208397,91031208398,1,1458,2218,0
91034089630,91034089629,-1,1293,1959,0
91034898537,91034898538,1,1277,1701,0
91036180447,91036180451,4,1494,1431,0
91037953076,91037953076,0,1272,1708,0
91041831399,91041831401,2,1177,2036,0
91042689186,91042689187,1,825,1259,0
91043851677,91043851677,0,1274,1813,0
91047701641,91047701641,0,1145,1598,0
91051207159,91051207159,0,1560,1483,0
91051985926,91051985925,-1,1212,1767,0
91056076455,91056076455,0,1699,2295,0
91057886799,91057886799,0,940,949,0
91058814084,91058814086,2,606,1312,0
91064560796,91064560796,0,1623,1992,0
91064904174,91064904174,0,1239,2361,0
91065064475,91065064476,1,1300,1968,0
91069470769,91069470769,0,1876,2014,0
91070381018,91070381020,2,1451,1587,0
91075816874,91075816874,0,1832,2123,0
91079397749,91079397734,-15,1024,1499,0
91080571640,91080571646,6,2290,1646,0
91082179406,91082179407,1,1305,1340,0
91082954798,91082954797,-1,1577,1720,0
91082987090,91082987078,-12,1602,701,0
91085761116,91085761118,2,1564,1983,0
91085958982,91085958984,2,1310,1682,0
91088276359,91088276359,0,1484,1945,0
91088891261,91088891262,1,1265,1038,0
91089222591,91089222590,-1,1229,1464,0
91092250626,91092250626,0,1372,1283,0
91098834593,91098834594,1,1489,1589,0
91100537830,91100537831,1,1384,1381,0
91105185812,91105185813,1,1675,1406,0
91106259178,91106259179,1,902,1648,0
91110519525,91110519547,22,1274,1304,0
91113361089,91113361090,1,1581,2160,0
91116966622,91116966622,0,1828,1776,0
91118532210,91118532209,-1,1433,1734,0
91119593141,91119593141,0,1378,1781,0
91120393282,91120393283,1,761,1776,0
91126073695,91126073694,-1,1692,1726,0
91131838404,91131838403,-1,991,1912,0
91140550255,91140550256,1,1609,1319,0
91140885010,91140885011,1,1678,2551,0
91144516323,91144516325,2,860,1754,0
91145485255,91145485258,3,1638,2149,0
91147365985,91147365985,0,1537,1756,0
91150205622,91150205622,0,1231,1373,0
91150394038,91150394039,1,1391,1579,0
91150793230,91150793228,-2,1540,1681,0
91155823106,91155823107,1,1405,1451,0
91157778026,91157778026,0,1225,1566,0
91158899368,91158899369,1,1197,1987,0
91161175071,91161175066,-5,963,1992,0
91162552380,91162552380,0,1343,1505,0
91163492218,91163492215,-3,920,1137,0
91165574670,91165574673,3,1176,1522,0
91171060127,91171060127,0,1537,2086,0
91171735856,91171735857,1,1668,2208,0
91173930641,91173930642,1,951,1726,0
91176979827,91176979829,2,1864,1504,0
91178255690,91178255695,5,827,717,0
91179139310,91179139311,1,1283,1695,0
91180329494,91180329495,1,981,1567,0
91181439243,91181439245,2,1249,1435,0
91183141530,91183141530,0,1521,1543,0
91184913958,91184913958,0,1813,1480,0
91185709039,91185709038,-1,1134,2238,0
91188925663,91188925667,4,1542,799,0
91192201068,91192201070,2,1260,1721,0
91194135301,91194135302,1,1216,1487,0
91196348271,91196348271,0,2000,1816,0
91199025366,91199025364,-2,1827,1596,0
91201075862,91201075861,-1,1095,1127,0
91201174690,91201174670,-20,975,921,0
91202405964,91202405961,-3,2085,4021,0
91202762465,91202762465,0,2114,2471,0
91205063474,91205063474,0,1777,2067,0
91207564585,91207564584,-1,1732,1773,0
91208187686,91208187686,0,816,1101,0
91209199743,91209199742,-1,758,724,0
91211550610,91211550610,0,667,1061,0
91212354469,91212354469,0,1658,1565,0
91212826404,91212826404,0,912,1402,0
91213082973,91213082973,0,1467,1939,0
91213573405,91213573406,1,1974,2114,0
91215779086,91215779090,4,1680,1867,0
91218252182,91218252183,1,1915,1480,0
91220534016,91220534015,-1,1304,1182,0
91220904916,91220904918,2,1176,1554,0
91221570473,91221570472,-1,1267,1671,0
91222743551,91222743548,-3,779,1363,0
91223697977,91223697977,0,1310,1484,0
91224372741,91224372743,2,1219,1595,0
91225103574,91225103574,0,1549,1881,0
91225202901,91225202903,2,969,1046,0
91225336287,91225336287,0,1368,2047,0
91229134933,91229134933,0,1558,2441,0
91230112276,91230112275,-1,1609,1395,0
91232883286,91232883287,1,1272,1586,0
91232963193,91232963193,0,1344,2062,0
91240798941,91240798942,1,1164,1137,0
91243383357,91243383363,6,5805,21741,0
91244090658,91244090659,1,1414,2267,0
91244391118,91244391118,0,575,1108,0
91244921925,91244921922,-3,1093,1101,0
91247220357,91247220343,-14,860,1409,0
91249667658,91249667658,0,1600,1423,0
91250995130,91250995130,0,1233,1531,0
91251743183,91251743181,-2,878,1171,0
91255379987,91255379983,-4,1172,1721,0
91259337105,91259337106,1,1504,2032,0
91260916733,91260916733,0,1888,1704,0
91261865223,91261865222,-1,1721,1734,0
91262483732,91262483732,0,1324,2123,0
91263725991,91263725991,0,1728,1542,0
91265296209,91265296205,-4,770,2755,0
91266009075,91266009074,-1,1119,1980,0
91270471813,91270471813,0,1703,1230,0
91270854131,91270854109,-22,943,1414,0
91271528878,91271528879,1,1046,1884,0
91273555031,91273555030,-1,1553,1314,0
91274438677,91274438677,0,1408,1563,0
91274905521,91274905523,2,1693,1460,0
91275476193,91275476193,0,1627,1664,0
91276386603,91276386603,0,1342,2023,0
91278145350,91278145348,-2,815,1632,0
91280719040,91280719041,1,1433,1640,0
91283700364,91283700366,2,2299,2117,0
91288023595,91288023594,-1,782,1387,0
91289200937,91289200938,1,1276,1790,0
91292927586,91292927577,-9,39985,12567,0
91294555145,91294555146,1,989,1458,0
91296486471,91296486472,1,1514,1524,0
91298322050,91298322051,1,1722,2255,0
91300920275,91300920276,1,1294,1978,0
91305048890,91305048890,0,1594,2595,0
91312658495,91312658495,0,1255,1860,0
91313144776,91313144775,-1,1874,2539,0
91316295945,91316295947,2,753,1135,0
91319507876,91319507859,-17,1384,1626,0
91319880142,91319880143,1,1858,2548,0
91323958998,91323958998,0,1373,1756,0
91327787144,91327787145,1,1119,1245,0
91327938478,91327938461,-17,4388,2541,0
91331637720,91331637719,-1,1502,1748,0
91335424073,91335424074,1,1551,1609,0
91335630106,91335630106,0,1430,1660,0
91338610342,91338610342,0,1170,1676,0
91342452280,91342452280,0,1486,1450,0
91344758398,91344758397,-1,872,1192,0
91345425282,91345425264,-18,1281,1493,0
91347385497,91347385494,-3,1721,1960,0
91347651190,91347651191,1,1433,1329,0
91350722254,91350722256,2,1278,2003,0
91353336303,91353336305,2,1485,1946,0
91354414016,91354414018,2,1535,1435,0
91355176253,91355176254,1,1625,1397,0
91359723185,91359723186,1,1180,1249,0
91360262462,91360262461,-1,1332,1432,0
91360573524,91360573522,-2,22138,43265,0
91360630141,91360630163,22,1098,882,0
91363488237,91363488238,1,1354,1417,0
91365594263,91365594263,0,1526,1244,0
91367870686,91367870686,0,1569,1403,0
91369402346,91369402346,0,1577,1863,0
91374450110,91374450110,0,971,1145,0
91374564858,91374564860,2,1008,1689,0
91378404541,91378404542,1,1618,1494,0
91380624005,91380624005,0,1806,1910,0
91383062875,91383062874,-1,1610,1624,0
91385779458,91385779459,1,914,1002,0
91389960804,91389960805,1,1226,1589,0
91393219901,91393219904,3,1203,1613,0
91395180268,91395180266,-2,1734,2043,0
91397120013,91397120014,1,1283,1321,0
91399057285,91399057286,1,1169,1240,0
91402615239,91402615248,9,1542,1298,0
91404975025,91404975031,6,7427,2683,0
91405154338,91405154339,1,1206,1875,0
91407824975,91407824975,0,879,1133,0
91409098426,91409098431,5,2055,1208,0
91411083639,91411083639,0,1228,1813,0
91412282542,91412282543,1,1554,1482,0
91413990549,91413990546,-3,1313,2043,0
91414660559,91414660551,-8,1396,1211,0
91415379704,91415379705,1,2162,3202,0
91415517010,91415517010,0,1534,1916,0
91416446360,91416446379,19,1100,2102,0
91416927084,91416927086,2,1154,1515,0
91418383290,91418383289,-1,1123,1198,0
91418684718,91418684719,1,1009,1428,0
91421486210,91421486210,0,1012,1142,0
91425611160,91425611170,10,18781,50060,0
91426182275,91426182273,-2,2544,5685,0
91428333311,91428333310,-1,552,1273,0
91430580097,91430580099,2,1660,1767,0
91431649279,91431649282,3,1343,1954,0
91433604187,91433604187,0,1460,1863,0
91435690685,91435690687,2,1571,1491,0
91435845081,91435845080,-1,1401,2517,0
91437617321,91437617317,-4,2155,5999,0
91437776690,91437776690,0,1288,2046,0
91439126794,91439126796,2,1531,1266,0
91441989030,91441989030,0,1365,1989,0
91447519393,91447519397,4,1299,993,0
91448003210,91448003210,0,1623,1998,0
91455604559,91455604560,1,1834,1850,0
91456687360,91456687361,1,1364,1932,0
91457712260,91457712259,-1,1466,1795,0
91458998311,91458998311,0,1609,2809,0
91464586915,91464586915,0,1701,1531,0
91468103746,91468103748,2,1685,2059,0
91468531607,91468531610,3,1663,1833,0
91469353468,91469353467,-1,1456,1744,0
91469591911,91469591902,-9,1028,1600,0
91470233978,91470233978,0,1006,1736,0
91471351742,91471351742,0,1762,2796,0
91474843154,91474843154,0,1847,1618,0
91477470292,91477470290,-2,1709,2214,0
91478010907,91478010908,1,1416,1449,0
91478715230,91478715231,1,2100,1551,0
91480699176,91480699178,2,1511,1784,0
91482405528,91482405527,-1,1180,1049,0
91490376970,91490376971,1,1327,2019,0
91492244948,91492244949,1,2140,2469,0
91498186248,91498186258,10,14422,31170,0
91500579633,91500579634,1,1367,1422,0
91502826653,91502826653,0,1265,1181,0
91505543802,91505543806,4,1594,1440,0
91508173746,91508173728,-18,1838,3038,0
91509841059,91509841060,1,1664,1466,0
91511248642,91511248646,4,2806,1833,0
91513003126,91513003128,2,1545,1587,0
91514030778,91514030775,-3,800,1574,0
91517424341,91517424345,4,1332,1035,0
91518063969,91518063974,5,2370,1443,0
91518525383,91518525385,2,915,1600,0
91519838780,91519838780,0,941,2235,0
91520420038,91520420038,0,1015,1370,0
91521948559,91521948559,0,1591,1722,0
91523749265,91523749263,-2,1073,1221,0
91524662854,91524662854,0,1445,1399,0
91524824083,91524824084,1,2328,1761,0
91526356070,91526356071,1,1305,1334,0
91531157766,91531157765,-1,1526,1635,0
91531429083,91531429082,-1,1195,1523,0
91533311462,91533311462,0,1215,1438,0
91533944084,91533944081,-3,1589,1680,0
91535299447,91535299449,2,1298,1768,0
91535509325,91535509329,4,1673,1431,0
91537237965,91537237967,2,1201,1500,0
91543465705,91543465707,2,1524,1690,0
91546433420,91546433423,3,2331,2298,0
91549008553,91549008553,0,1722,2498,0
91549070653,91549070654,1,1250,1494,0
91549407358,91549407355,-3,882,1592,0
91550957065,91550957066,1,2207,2226,0
91553296105,91553296105,0,1779,1912,0
91554481063,91554481063,0,1096,1731,0
91556743406,91556743406,0,1756,2104,0
91557317276,91557317276,0,1097,1360,0
91559166624,91559166623,-1,2019,2232,0
91560180602,91560180594,-8,3103,9747,0
91568279093,91568279094,1,1360,1395,0
91571088565,91571088566,1,1323,1837,0
91579394166,91579394168,2,2303,1814,0
91580460966,91580460965,-1,1436,2745,0
91580878771,91580878770,-1,1219,1362,0
91582000587,91582000587,0,1053,1486,0
91586565766,91586565771,5,1690,1003,0
91586879901,91586879900,-1,1681,1821,0
91587528962,91587528962,0,1360,1863,0
91590364653,91590364655,2,1301,1332,0
91593801638,91593801638,0,1558,1953,0
91594289233,91594289233,0,1602,2274,0
91598265031,91598265030,-1,31141,40479,0
91600893538,91600893538,0,1102,1113,0
91604709636,91604709636,0,1786,2732,0
91605815155,91605815154,-1,1051,1315,0
91606604900,91606604902,2,1040,1434,0
91611629125,91611629125,0,770,1277,0
91611982591,91611982574,-17,2173,848,0
91614256071,91614256071,0,1959,2193,0
91615676652,91615676647,-5,1682,6246,0
91615776522,91615776518,-4,798,1480,0
91616950030,91616950033,3,1173,1436,0
91618011507,91618011508,1,1424,1558,0
91618492160,91618492159,-1,481,495,0
91621869042,91621869043,1,1446,1720,0
91622743307,91622743305,-2,1582,2518,0
91624099518,91624099519,1,1664,1785,0
91627720364,91627720363,-1,1161,1189,0
91634443966,91634443968,2,1141,1963,0
91636086003,91636086002,-1,1610,1808,0
91638298923,91638298922,-1,1618,1713,0
91639185089,91639185085,-4,1000,1279,0
91639942417,91639942416,-1,1309,1438,0
91644873584,91644873583,-1,1146,1505,0
91646084574,91646084573,-1,978,1421,0
91648328670,91648328669,-1,1382,1573,0
91648486470,91648486454,-16,833,1513,0
91651024166,91651024171,5,5594,24272,0
91654269329,91654269329,0,1204,1721,0
91654354838,91654354832,-6,163,2005,0
91656442514,91656442514,0,1318,2146,0
91657199908,91657199907,-1,1273,1245,0
91661443265,91661443266,1,1474,2214,0
91661478565,91661478579,14,492,1487,0
91666483470,91666483472,2,1236,1706,0
91666585498,91666585498,0,1785,1908,0
91666762580,91666762581,1,1205,1716,0
91667741215,91667741217,2,1659,1756,0
91668762611,91668762610,-1,1190,1464,0
91676478657,91676478666,9,14456,36843,0
91679550193,91679550194,1,1468,1786,0
91680541357,91680541353,-4,1666,1716,0
91680718374,91680718374,0,988,1162,0
91681435503,91681435506,3,1189,966,0
91682731642,91682731643,1,1442,1760,0
91682873311,91682873298,-13,1373,1919,0
91683515218,91683515217,-1,1437,1987,0
91686759819,91686759798,-21,1040,1274,0
91693697569,91693697570,1,1452,1756,0
91694934974,91694934994,20,1516,1202,0
91695621805,91695621822,17,1243,1277,0
91695785205,91695785205,0,1016,1418,0
91697937346,91697937350,4,1829,1182,0
91701301267,91701301267,0,1342,1502,0
91702128595,91702128595,0,1202,1650,0
91702337317,91702337319,2,1444,1464,0
91703493591,91703493592,1,1611,1866,0
91706540090,91706540090,0,1844,1723,0
91711372958,91711372958,0,1459,1524,0
91713298310,91713298309,-1,1642,2208,0
91715487202,91715487205,3,1171,1832,0
91716591657,91716591658,1,1463,1752,0
91719582406,91719582406,0,1069,2022,0
91720040298,91720040294,-4,1913,4961,0
91721818063,91721818065,2,1412,2147,0
91722994859,91722994857,-2,1113,1700,0
91727145454,91727145453,-1,1303,1966,0
91735270204,91735270202,-2,1318,1867,0
91736886478,91736886478,0,2041,1867,0
91736954626,91736954626,0,1047,1737,0
91737844707,91737844706,-1,1977,2626,0
91740349154,91740349155,1,1319,1963,0
91740980160,91740980159,-1,1258,2031,0
91743834131,91743834131,0,842,1440,0
91753927270,91753927272,2,1332,1917,0
91755854899,91755854899,0,1513,1949,0
91756162552,91756162569,17,890,926,0
91757268287,91757268286,-1,1525,1914,0
91762208895,91762208894,-1,1749,2060,0
91763732525,91763732528,3,1449,1982,0
91768736028,91768736027,-1,1297,2064,0
91775600378,91775600378,0,1251,1008,0
91778555777,91778555778,1,2152,2264,0
91779418155,91779418155,0,989,1135,0
91780219058,91780219061,3,1331,2084,0
91783936313,91783936314,1,802,1228,0
91786616534,91786616535,1,2485,2295,0
91788793794,91788793809,15,1115,1403,0
91792291706,91792291706,0,1018,1105,0
91793661954,91793661964,10,1098,1315,0
91798828240,91798828237,-3,892,1693,0
91805332070,91805332071,1,1396,1495,0
91805602767,91805602755,-12,1576,1751,0
91807644241,91807644240,-1,1442,1708,0
91812139514,91812139514,0,1049,1076,0
91812652670,91812652671,1,1213,1217,0
91813953857,91813953858,1,1768,1086,0
91814861564,91814861562,-2,1247,1216,0
91817274149,91817274150,1,1311,1732,0
91820868265,91820868266,1,2123,1851,0
91826021775,91826021770,-5,1796,7351,0
91829372362,91829372363,1,949,1384,0
91829759358,91829759377,19,1365,2685,0
91832313130,91832313130,0,1005,1045,0
91832550490,91832550485,-5,1331,5900,0
91834789011,91834789010,-1,798,1478,0
91838515777,91838515779,2,2265,1757,0
91840370015,91840370017,2,1196,1519,0
91844626730,91844626730,0,1569,1352,0
91844771670,91844771670,0,1429,1369,0
91845508966,91845508966,0,1604,1524,0
91846163992,91846163993,1,1483,2256,0
91846504211,91846504213,2,1346,1764,0
91849551110,91849551111,1,1371,1062,0
91849905779,91849905756,-23,5723,446,0
91852305245,91852305246,1,1475,1696,0
91852522446,91852522447,1,1077,1798,0
91853186407,91853186407,0,1760,2004,0
91853346491,91853346491,0,924,1228,0
91855012263,91855012263,0,1628,2211,0
91855827011,91855827011,0,1977,2118,0
91858030494,91858030494,0,1262,1644,0
91859221552,91859221552,0,1999,2268,0
91862835445,91862835450,5,2700,1938,0
91863379718,91863379714,-4,1256,2771,0
91864300357,91864300357,0,1753,1727,0
91864805114,91864805114,0,1754,2445,0
91865185361,91865185363,2,1414,1043,0
91866545069,91866545069,0,1888,2064,0
91866773005,91866773007,2,934,1259,0
91868482941,91868482940,-1,1043,1231,0
91871390382,91871390383,1,1430,1351,0
91872215927,91872215926,-1,1336,1596,0
91873153054,91873153053,-1,1319,2497,0
91873681109,91873681110,1,858,1568,0
91873790096,91873790098,2,35986,37382,0
91875571143,91875571137,-6,1222,4450,0
91875637058,91875637059,1,2413,2575,0
91878350323,91878350324,1,976,1765,0
91880691849,91880691848,-1,1782,2715,0
91884887931,91884887933,2,1466,2377,0
91885287272,91885287274,2,1312,2280,0
91885625510,91885625510,0,967,1487,0
91887918619,91887918639,20,1482,2533,0
91889082162,91889082163,1,1168,1758,0
91894429331,91894429330,-1,1473,1372,0
91897007611,91897007606,-5,1875,3070,0
91899493582,91899493581,-1,1280,1798,0
91899740914,91899740914,0,1007,1864,0
91900013462,91900013463,1,1475,1232,0
91903063202,91903063203,1,1216,1252,0
91904482430,91904482432,2,1748,1549,0
91908597788,91908597786,-2,1414,1772,0
91909754437,91909754438,1,1477,1492,0
91911567717,91911567718,1,1507,2426,0
91914024197,91914024199,2,1270,1696,0
91914622334,91914622350,16,1838,1424,0
91915748859,91915748860,1,1258,1583,0
91919523319,91919523319,0,1559,1667,0
91921425587,91921425587,0,1340,1715,0
91922673787,91922673785,-2,769,1012,0
91923420291,91923420293,2,1055,1346,0
91925435629,91925435628,-1,1777,2203,0
91927360043,91927360042,-1,1343,2111,0
91930267482,91930267482,0,1095,2010,0
91931174685,91931174685,0,1808,2678,0
91935370107,91935370105,-2,946,1609,0
91936472794,91936472776,-18,1343,1166,0
91938166819,91938166823,4,1414,1413,0
91943298525,91943298526,1,1321,1937,0
91943636528,91943636529,1,1341,1874,0
91948120930,91948120930,0,1362,1272,0
91950766652,91950766647,-5,918,3465,0
91951142523,91951142524,1,1855,1496,0
91951295145,91951295147,2,1147,1724,0
91955956319,91955956325,6,1418,1370,0
91956521909,91956521913,4,1382,1599,0
91956809181,91956809201,20,1354,1643,0
91958659223,91958659225,2,1480,1948,0
91965601503,91965601502,-1,1693,2774,0
91966185799,91966185799,0,1290,2051,0
91967793886,91967793886,0,1025,1991,0
91967900589,91967900590,1,747,1235,0
91969639476,91969639478,2,1551,1745,0
91971904923,91971904922,-1,2024,2176,0
91972021224,91972021222,-2,1202,1310,0
91972413933,91972413934,1,1378,1467,0
91972814630,91972814630,0,1833,1864,0
91973562230,91973562233,3,1959,1677,0
91975706837,91975706837,0,1230,1475,0
91980685637,91980685637,0,1401,1844,0
91981116822,91981116826,4,1336,1757,0
91981935836,91981935833,-3,1172,2469,0
91984022374,91984022376,2,2091,2106,0
91988318114,91988318122,8,1563,1181,0
91989079993,91989079993,0,1592,1506,0
91989252901,91989252902,1,880,955,0
91993695784,91993695786,2,1224,1087,0
92003016926,92003016926,0,1668,1748,0
92003430014,92003430016,2,1701,1568,0
92005363905,92005363906,1,980,1136,0
92005843330,92005843337,7,6377,1280,0
92006696875,92006696877,2,880,1389,0
92006810181,92006810177,-4,1694,1819,0
92008345413,92008345415,2,1893,1965,0
92009708282,92009708283,1,969,1447,0
92010320995,92010320973,-22,1261,1830,0
92019977766,92019977766,0,1382,1883,0
92020212631,92020212630,-1,1415,2008,0
92022426610,92022426611,1,1528,1606,0
92024990778,92024990779,1,1044,1192,0
92026622317,92026622318,1,1479,1459,0
92027799461,92027799464,3,1240,1348,0
92029259747,92029259748,1,854,1584,0
92030226683,92030226682,-1,846,1404,0
92030280361,92030280361,0,1594,1804,0
92030614131,92030614133,2,1952,1982,0
92034486565,92034486566,1,1202,1330,0
92035898883,92035898882,-1,1206,1833,0
92036193828,92036193829,1,1175,1470,0
92040662447,92040662448,1,1403,1530,0
92041860605,92041860606,1,1183,1213,0
92044986191,92044986193,2,1047,1552,0
92052085771,92052085772,1,1378,2067,0
92054521820,92054521819,-1,999,1492,0
92055404618,92055404618,0,1382,1217,0
92056100814,92056100814,0,677,1860,0
92059265806,92059265806,0,1152,1278,0
92060927578,92060927579,1,924,1343,0
92061689765,92061689744,-21,615,1273,0
92061885536,92061885515,-21,1136,1322,0
92062712026,92062712026,0,1047,1767,0
92064922316,92064922317,1,2139,1901,0
92070621070,92070621069,-1,1537,2697,0
92071946094,92071946093,-1,1233,2092,0
92076933344,92076933342,-2,1449,1370,0
92078490705,92078490708,3,1516,1529,0
92078555438,92078555438,0,1731,2023,0
92080549612,92080549598,-14,2112,658,0
92080769410,92080769410,0,1200,1191,0
92083497022,92083497034,12,1378,1419,0
92085317230,92085317230,0,1335,1655,0
92086618453,92086618454,1,1054,1746,0
92094416587,92094416587,0,1490,1662,0
92094846221,92094846222,1,8284,8412,0
92097451501,92097451499,-2,905,1270,0
92099568419,92099568426,7,1769,1675,0
92100795017,92100795018,1,679,1151,0
92102069018,92102069018,0,1562,1226,0
92104767166,92104767164,-2,944,1462,0
92107281671,92107281672,1,1239,1330,0
92109948983,92109948982,-1,1605,2255,0
92109991199,92109991192,-7,1537,9334,0
92112661544,92112661545,1,1557,1683,0
92114917490,92114917491,1,1459,1653,0
92119761539,92119761528,-11,1138,19465,0
92120123044,92120123038,-6,1559,1740,0
92121669728,92121669731,3,1746,1353,0
92129544097,92129544097,0,1336,2339,0
92131778730,92131778733,3,1715,1248,0
92133431825,92133431823,-2,1028,1331,0
92133792037,92133792018,-19,664,1129,0
92135365686,92135365686,0,2240,2527,0
92137952872,92137952873,1,1083,1288,0
92138412386,92138412386,0,1037,2052,0
92144016389,92144016390,1,1685,1496,0
92144473754,92144473765,11,14072,33007,0
92145551979,92145551978,-1,996,1549,0
92150456021,92150456022,1,1302,2016,0
92151494657,92151494658,1,1812,2284,0
92154777103,92154777101,-2,1888,3769,0
92156283348,92156283347,-1,1070,2169,0
92159740334,92159740335,1,2108,1772,0
92162568210,92162568210,0,1423,1556,0
92166858278,92166858280,2,1205,1530,0
92167360266,92167360285,19,1662,1862,0
92168687278,92168687278,0,1139,1564,0
92168989462,92168989463,1,1226,1638,0
92169807113,92169807120,7,4402,2044,0
92171349114,92171349116,2,1303,1795,0
92172860998,92172861000,2,1188,1052,0
92175923558,92175923558,0,1252,1463,0
92177551075,92177551075,0,1597,1967,0
92178562754,92178562755,1,2276,1616,0
92179137491,92179137489,-2,1587,1621,0
92179690406,92179690406,0,737,1671,0
92180276123,92180276130,7,3520,1542,0
92180567493,92180567508,15,1007,1044,0
92181287231,92181287233,2,1459,1595,0
92183505447,92183505449,2,1519,1543,0
92185661770,92185661771,1,1265,1982,0
92185969225,92185969224,-1,1663,1941,0
92189368777,92189368779,2,1394,2258,0
92190055665,92190055663,-2,915,1966,0
92191401354,92191401355,1,1570,1275,0
92192225211,92192225209,-2,1313,1319,0
92194199331,92194199334,3,1894,1472,0
92194717297,92194717299,2,1252,2195,0
92195194519,92195194517,-2,1294,1793,0
92196057138,92196057137,-1,1115,1398,0
92197869062,92197869064,2,1531,1323,0
92200514295,92200514294,-1,1230,1049,0
92200672313,92200672313,0,845,1701,0
92202956127,92202956127,0,1392,1676,0
92203148062,92203148067,5,2751,1765,0
92204000813,92204000814,1,1301,1507,0
92206815597,92206815597,0,1712,1702,0
92209652077,92209652076,-1,1372,1819,0
92214517433,92214517432,-1,1655,2334,0
92215527287,92215527303,16,1443,1115,0
92216631243,92216631243,0,1164,2125,0
92218685662,92218685661,-1,1000,1708,0
92221865707,92221865707,0,1161,1681,0
92222748512,92222748506,-6,1580,4587,0
92229148253,92229148255,2,1526,1596,0
92229999003,92229998984,-19,1060,792,0
92234174473,92234174477,4,3346,1520,0
92236735422,92236735425,3,1561,1377,0
92236804170,92236804170,0,1488,2362,0
92237076571,92237076571,0,1443,1652,0
92237607118,92237607119,1,1377,1204,0
92239470375,92239470370,-5,642,1428,0
92239709483,92239709462,-21,1264,2056,0
92240659878,92240659877,-1,1817,1711,0
92242647806,92242647807,1,1465,1189,0
92244801484,92244801487,3,1480,1352,0
92248008802,92248008806,4,2453,1299,0
92249943657,92249943657,0,1016,1588,0
92254936947,92254936947,0,1407,2102,0
92256092987,92256092987,0,1136,1181,0
92257549085,92257549090,5,1538,885,0
92258729510,92258729510,0,1325,1063,0
92259450042,92259450042,0,1338,1840,0
92261374757,92261374758,1,1481,1748,0
92262580156,92262580178,22,929,1945,0
92262896365,92262896369,4,2141,1507,0
92270594949,92270594949,0,1475,1853,0
92276662054,92276662049,-5,578,1615,0
92277670923,92277670923,0,1221,2219,0
92281987010,92281987009,-1,2271,1951,0
92284319973,92284319974,1,1314,1723,0
92290657933,92290657930,-3,715,1623,0
92293050011,92293050010,-1,1102,1582,0
92294798467,92294798466,-1,1552,1804,0
92295293654,92295293653,-1,1277,1580,0
92296416111,92296416112,1,1553,1762,0
92299716131,92299716145,14,28125,11592,0
92300721874,92300721874,0,1282,1398,0
92309029482,92309029477,-5,1184,1268,0
92309960073,92309960078,5,1216,1476,0
92311964458,92311964436,-22,1763,1415,0
92316773472,92316773473,1,1865,1586,0
92317189839,92317189840,1,1751,2040,0
92318942958,92318942958,0,1728,1842,0
92320605089,92320605091,2,1659,2134,0
92320715219,92320715219,0,1040,1451,0
92322453278,92322453278,0,1482,1985,0
92324305154,92324305157,3,2228,1661,0
92325496147,92325496149,2,1136,1685,0
92327588148,92327588148,0,2469,2408,0
92328038091,92328038093,2,1953,1575,0
92330554291,92330554293,2,1284,1689,0
92334440884,92334440883,-1,1222,1407,0
92338113490,92338113491,1,1697,1985,0
92338170143,92338170145,2,2277,1568,0
92338621353,92338621354,1,1711,1595,0
92338978073,92338978074,1,1684,1908,0
92339431250,92339431251,1,1655,1427,0
92340225526,92340225526,0,1449,1251,0
92340776126,92340776126,0,1070,2100,0
92345922470,92345922470,0,1921,1818,0
92347158331,92347158330,-1,1111,1230,0
92348179116,92348179118,2,1224,1591,0
92348927030,92348927026,-4,1680,5154,0
92351168797,92351168796,-1,1208,1809,0
92356956655,92356956662,7,3739,1842,0
92357277750,92357277750,0,1516,1493,0
92358250258,92358250259,1,1488,2508,0
92358691126,92358691128,2,1033,2028,0
92359425089,92359425091,2,1134,1641,0
92363495058,92363495059,1,1471,1256,0
92364993780,92364993782,2,1829,1406,0
92368336134,92368336134,0,1287,2205,0
92370750562,92370750564,2,1676,1457,0
92376274044,92376274045,1,1775,2272,0
92377406369,92377406371,2,1195,1360,0
92379471415,92379471413,-2,1051,2284,0
92381174612,92381174613,1,1473,1630,0
92382082359,92382082359,0,1145,1280,0
92383026386,92383026386,0,1477,2083,0
92385794638,92385794638,0,957,1847,0
92387439415,92387439408,-7,1376,5950,0
92390676388,92390676387,-1,1166,1507,0
92405541170,92405541171,1,1329,1799,0
92407244365,92407244366,1,1398,1580,0
92407739014,92407739013,-1,1499,2053,0
92409168572,92409168583,11,15834,37750,0
92410630718,92410630718,0,1099,1156,0
92413344013,92413344013,0,1320,1959,0
92414938130,92414938129,-1,1686,1612,0
92415036310,92415036311,1,1102,950,0
92417467302,92417467301,-1,1794,2572,0
92417936147,92417936146,-1,1808,2446,0
92419041521,92419041521,0,1134,1435,0
92422249243,92422249246,3,1511,1512,0
92424581558,92424581559,1,1006,1468,0
92424799166,92424799145,-21,1160,1715,0
92425195746,92425195747,1,1233,1694,0
92425860499,92425860501,2,1741,1841,0
92426208275,92426208286,11,1040,1799,0
92428016377,92428016376,-1,1490,2466,0
92428517070,92428517064,-6,1048,3455,0
92429693583,92429693584,1,1137,1681,0
92430589581,92430589581,0,1411,2658,0
92430995986,92430995984,-2,1160,1830,0
92433616132,92433616134,2,1231,1903,0
92434604279,92434604279,0,1321,1509,0
92442573827,92442573829,2,1233,1083,0
92445716597,92445716597,0,1190,2062,0
92446704336,92446704338,2,1094,942,0
92449546846,92449546846,0,1217,1624,0
92449852162,92449852148,-14,4597,1488,0
92451488993,92451488991,-2,1828,1298,0
92458529650,92458529647,-3,966,1345,0
92465353507,92465353506,-1,1226,1451,0
92467004748,92467004746,-2,1296,1854,0
92467533636,92467533659,23,1857,1817,0
92467896558,92467896561,3,1354,1770,0
92468636067,92468636070,3,1807,1414,0
92471317509,92471317510,1,1172,926,0
92471776132,92471776133,1,1554,2128,0
92475643399,92475643399,0,1215,1242,0
92478211252,92478211257,5,2732,1617,0
92479055679,92479055678,-1,1612,2095,0
92481158403,92481158402,-1,1890,2182,0
92483155558,92483155559,1,1701,1715,0
92483466315,92483466322,7,6725,3077,0
92487792751,92487792750,-1,1706,1680,0
92489234542,92489234526,-16,1057,1956,0
92491373259,92491373259,0,942,1003,0
92491782548,92491782530,-18,1435,1519,0
92494374861,92494374861,0,1251,1662,0
92495612276,92495612282,6,1229,1140,0
92497239102,92497239100,-2,1337,1638,0
92498668275,92498668277,2,1945,1927,0
92498922329,92498922330,1,1226,2012,0
92502312691,92502312690,-1,1883,2044,0
92502541977,92502541970,-7,1623,6411,0
92504418930,92504418930,0,1592,2260,0
92505987543,92505987547,4,1487,2159,0
92508326873,92508326873,0,1406,1610,0
92509822174,92509822182,8,1397,1443,0
92512488728,92512488733,5,2382,1740,0
92515177793,92515177796,3,1459,1636,0
92518135418,92518135419,1,1360,1721,0
92521937427,92521937429,2,984,1412,0
92523943619,92523943634,15,1253,917,0
92524715246,92524715248,2,1292,1737,0
92526352222,92526352222,0,1287,2132,0
92527575128,92527575129,1,1485,1780,0
92528929445,92528929446,1,11831,12153,0
92532098643,92532098643,0,1452,1991,0
92532396422,92532396421,-1,1772,2036,0
92540049690,92540049693,3,1184,913,0
92542460649,92542460648,-1,1002,2188,0
92543029935,92543029932,-3,38443,20450,0
92545936812,92545936808,-4,1279,4337,0
92552063513,92552063517,4,2503,1470,0
92552613526,92552613527,1,1822,2363,0
92556092718,92556092721,3,1874,1453,0
92556732439,92556732437,-2,1538,2116,0
92559730204,92559730204,0,1602,1469,0
92560221049,92560221050,1,1444,1547,0
92564184746,92564184745,-1,1551,1881,0
92566349058,92566349059,1,1285,1458,0
92566427430,92566427432,2,1154,1636,0
92567424239,92567424243,4,1291,1333,0
92571063019,92571063019,0,1478,1114,0
92571290537,92571290538,1,1308,1739,0
92575388382,92575388382,0,1389,1611,0
92576859933,92576859933,0,1393,2172,0
92577723742,92577723741,-1,1088,1640,0
92581302381,92581302382,1,1623,1383,0
92582460337,92582460338,1,1410,1874,0
92584257647,92584257649,2,1972,2708,0
92584315563,92584315566,3,1878,1896,0
92584523397,92584523396,-1,1474,2023,0
92585348829,92585348823,-6,1106,1383,0
92586348766,92586348767,1,1517,1868,0
92588110755,92588110756,1,1422,1963,0
92589731834,92589731840,6,1579,1286,0
92592982194,92592982197,3,940,1041,0
92593080470,92593080470,0,1567,1764,0
92594135362,92594135361,-1,1402,1503,0
92594467447,92594467438,-9,1085,1339,0
92596533598,92596533597,-1,1344,1158,0
92597476042,92597476041,-1,1754,2257,0
92598736219,92598736218,-1,1424,1365,0
92603375847,92603375846,-1,900,1214,0
92604723796,92604723810,14,575,2093,0
92605505737,92605505736,-1,1176,1246,0
92605930689,92605930688,-1,1294,1634,0
92605998088,92605998093,5,2015,1272,0
92608600345,92608600351,6,1416,1069,0
92610044678,92610044679,1,974,1419,0
92610677369,92610677369,0,769,995,0
92610980111,92610980111,0,1980,2842,0
92612758490,92612758490,0,1337,1222,0
92615942187,92615942189,2,1059,1339,0
92617240710,92617240707,-3,840,1414,0
92619353917,92619353918,1,1204,1670,0
92621914551,92621914553,2,953,1794,0
92624249025,92624249025,0,850,1426,0
92628975118,92628975119,1,1374,1266,0
92634075197,92634075200,3,1137,1179,0
92636537409,92636537409,0,1307,1700,0
92639671972,92639671973,1,697,1241,0
92641645665,92641645667,2,1285,2139,0
92643024149,92643024150,1,1891,3033,0
92643795362,92643795361,-1,1469,1635,0
92643868205,92643868207,2,1252,1278,0
92643970084,92643970106,22,1342,1778,0
92644754846,92644754850,4,2312,1134,0
92648992233,92648992234,1,2035,2543,0
92650504515,92650504514,-1,815,1253,0
92650533718,92650533717,-1,767,1852,0
92652482919,92652482919,0,1647,2110,0
92653245395,92653245395,0,1290,1474,0
92656863483,92656863483,0,1942,2050,0
92657002314,92657002314,0,1027,1491,0
92657316845,92657316843,-2,1686,1582,0
92659127794,92659127795,1,1730,2044,0
92665883446,92665883446,0,1386,1497,0
92668302131,92668302131,0,1265,1832,0
92673158449,92673158448,-1,2764,4430,0
92677923868,92677923867,-1,1347,2121,0
92678589614,92678589617,3,542,1417,0
92683959737,92683959738,1,1176,1775,0
92684726094,92684726095,1,1983,1455,0
92686152154,92686152153,-1,1566,3061,0
92686644386,92686644385,-1,859,1554,0
92688657966,92688657965,-1,1938,2130,0
92688969268,92688969266,-2,877,1765,0
92691530873,92691530874,1,1625,1349,0
92693606494,92693606493,-1,1171,1528,0
92695318739,92695318738,-1,1180,1454,0
92697629470,92697629470,0,1628,1616,0
92698692248,92698692250,2,1513,2780,0
92698993749,92698993750,1,1409,1677,0
92701455599,92701455603,4,1774,933,0
92703442394,92703442396,2,1460,1788,0
92703636011,92703636013,2,1247,987,0
92705409780,92705409786,6,2666,1402,0
92706879605,92706879607,2,1721,1801,0
92710580335,92710580352,17,1438,1327,0
92715269009,92715269010,1,1634,1653,0
92716418132,92716418133,1,1641,1695,0
92716615855,92716615855,0,742,1552,0
92718679086,92718679086,0,777,1393,0
92718905726,92718905726,0,1165,1545,0
92719598334,92719598337,3,1151,1980,0
92720474409,92720474411,2,1110,1387,0
92722315087,92722315086,-1,991,1572,0
92727360155,92727360155,0,1151,1637,0
92727613976,92727613976,0,1651,2103,0
92729813338,92729813341,3,1226,1626,0
92730359222,92730359223,1,1249,1158,0
92732432219,92732432219,0,1058,1188,0
92732724033,92732724032,-1,1484,1829,0
92734113559,92734113561,2,1618,1387,0
92735908449,92735908451,2,1101,1848,0
92736416275,92736416277,2,1663,1925,0
92740009527,92740009526,-1,1462,2373,0
92741856222,92741856225,3,898,913,0
92743413507,92743413506,-1,1357,1246,0
92745121571,92745121570,-1,1249,1603,0
92745347799,92745347815,16,736,1389,0
92746356210,92746356210,0,5760,19237,0
92748719878,92748719875,-3,469,678,0
92750111374,92750111375,1,1800,1801,0
92751341298,92751341301,3,1474,1493,0
92752400358,92752400358,0,1607,1795,0
92755521438,92755521452,14,1388,1120,0
92755996994,92755996996,2,1118,1435,0
92757480870,92757480871,1,1471,1919,0
92760736031,92760736029,-2,1061,1810,0
92761943402,92761943403,1,1655,2468,0
92766100962,92766100965,3,1326,1790,0
92766310934,92766310935,1,1233,1335,0
92766954981,92766954982,1,1752,1908,0
92768008580,92768008580,0,1423,1879,0
92769567510,92769567511,1,1857,2130,0
92770316609,92770316606,-3,1499,2067,0
92774077423,92774077423,0,1544,2126,0
92774670644,92774670638,-6,972,4436,0
92775323380,92775323380,0,1352,2369,0
92775666878,92775666859,-19,682,528,0
92776734304,92776734303,-1,1575,1761,0
92776901031,92776901027,-4,971,1031,0
92778672960,92778672959,-1,1380,1216,0
92785638542,92785638542,0,1242,1580,0
92790749309,92790749311,2,2997,17280,0
92794979147,92794979146,-1,1614,1467,0
92799077930,92799077931,1,1866,1215,0
92802208923,92802208925,2,1055,1705,0
92802571755,92802571756,1,1032,1565,0
92804389436,92804389435,-1,2709,4282,0
92804573725,92804573724,-1,1890,2230,0
92804981393,92804981395,2,999,1165,0
92806624939,92806624939,0,1509,1897,0
92807726559,92807726559,0,678,1423,0
92807813187,92807813188,1,926,1738,0
92808838252,92808838247,-5,278,1239,0
92812894875,92812894873,-2,1042,1896,0
92816006474,92816006475,1,1427,967,0
92818554545,92818554545,0,1122,1782,0
92819805873,92819805874,1,1064,1662,0
92826499823,92826499823,0,1654,1551,0
92826746599,92826746614,15,917,1329,0
92828976003,92828976004,1,1158,1461,0
92830664318,92830664319,1,957,1142,0
92831071841,92831071842,1,1719,1981,0
92833791017,92833791015,-2,1202,1501,0
92834898617,92834898615,-2,1264,1972,0
92836972842,92836972842,0,1636,963,0
92841470102,92841470096,-6,19340,14432,0
92842957433,92842957431,-2,1688,1698,0
92843809598,92843809598,0,1472,2065,0
92845948814,92845948817,3,1675,1627,0
92846679301,92846679303,2,1347,1748,0
92846872966,92846872966,0,1463,2187,0
92852730809,92852730810,1,1542,1884,0
92855192095,92855192097,2,1281,1625,0
92857621893,92857621895,2,2084,2437,0
92861493035,92861493034,-1,2607,3770,0
92863704188,92863704189,1,1544,1599,0
92863900607,92863900605,-2,1352,1273,0
92864579491,92864579493,2,522,324,0
92866134498,92866134496,-2,2116,2241,0
92868258646,92868258646,0,2142,2107,0
92868484267,92868484266,-1,1242,1904,0
92870550243,92870550242,-1,1297,1436,0
92876852446,92876852451,5,2953,2064,0
92878354801,92878354806,5,1079,1134,0
92878605685,92878605683,-2,1460,1711,0
92879781036,92879781042,6,1289,1337,0
92882522219,92882522222,3,1856,2144,0
92883250727,92883250726,-1,1179,1695,0
92885460942,92885460942,0,699,1003,0
92887848718,92887848717,-1,1336,1805,0
92888456486,92888456487,1,1107,1821,0
92892407675,92892407677,2,1023,1879,0
92893409896,92893409894,-2,1393,2042,0
92895471396,92895471396,0,1664,2182,0
92900549698,92900549698,0,1214,1701,0
92904336440,92904336446,6,1473,1652,0
92907262418,92907262423,5,2286,1816,0
92909370174,92909370174,0,1144,2128,0
92912858976,92912858974,-2,1522,1447,0
92915458448,92915458450,2,1551,2169,0
92916060121,92916060126,5,2434,1341,0
92923991633,92923991634,1,1350,1568,0
92926925775,92926925774,-1,1816,2361,0
92929564682,92929564681,-1,1217,1589,0
92931097521,92931097524,3,1649,1510,0
92934477228,92934477227,-1,1711,2517,0
92934572729,92934572731,2,1874,2216,0
92935275933,92935275939,6,2622,1094,0
92937847643,92937847644,1,1273,1866,0
92939459826,92939459829,3,1249,1013,0
92941286325,92941286325,0,1497,1501,0
92944719382,92944719385,3,1522,1529,0
92948175901,92948175902,1,1847,2119,0
92953088082,92953088090,8,829,1624,0
92956141711,92956141709,-2,925,3049,0
92958035376,92958035378,2,1306,1354,0
92958721171,92958721170,-1,1593,1650,0
92960546814,92960546814,0,1147,1931,0
92961595771,92961595769,-2,1051,1406,0
92962686079,92962686082,3,1681,1169,0
92963053394,92963053394,0,1339,1660,0
92969357340,92969357342,2,1369,1581,0
92976289371,92976289367,-4,1450,2276,0
92976684903,92976684902,-1,1394,2318,0
92978909955,92978909957,2,1816,2627,0
92979800658,92979800658,0,1205,2026,0
92980888777,92980888777,0,1365,1209,0
92980977231,92980977231,0,1086,1527,0
92984076038,92984076037,-1,1578,3527,0
92987403678,92987403679,1,1951,2183,0
92988105994,92988105975,-19,1581,1368,0
92988193325,92988193323,-2,1269,2180,0
92989037273,92989037269,-4,2125,5828,0
92993594924,92993594924,0,1584,2039,0
92995505077,92995505079,2,1667,1569,0
92996064711,92996064712,1,1534,1736,0
92998155136,92998155139,3,1315,1553,0
92999732293,92999732293,0,1411,1288,0
93007157406,93007157408,2,2176,1906,0
93009538451,93009538452,1,1557,2673,0
93009724640,93009724639,-1,1833,2018,0
93010520190,93010520185,-5,1073,3753,0
93011547989,93011547989,0,1641,1639,0
93012249694,93012249681,-13,4037,15485,0
93012781138,93012781137,-1,954,1216,0
93015235782,93015235784,2,1444,1330,0
93016299246,93016299249,3,1479,1414,0
93018295626,93018295628,2,2134,1649,0
93019377038,93019377039,1,1302,1921,0
93019437928,93019437922,-6,1336,1771,0
93020059222,93020059222,0,749,1376,0
93020648108,93020648110,2,1636,2097,0
93029328755,93029328754,-1,1276,1395,0
93029502063,93029502062,-1,971,1511,0
93029899338,93029899337,-1,1648,1664,0
93030672033,93030672033,0,1783,1746,0
93035406882,93035406885,3,1394,1057,0
93036488358,93036488358,0,1200,1823,0
93036646967,93036646969,2,1086,1851,0
93036695815,93036695817,2,1729,1737,0
93037263674,93037263673,-1,1153,1423,0
93040656530,93040656531,1,1353,1548,0
93041782467,93041782462,-5,1120,2188,0
93042172026,93042172025,-1,1451,1701,0
93042625426,93042625427,1,1718,2215,0
93046405378,93046405378,0,1608,2456,0
93048593914,93048593915,1,1032,1468,0
93050246983,93050246985,2,858,2242,0
93054477685,93054477687,2,1538,1716,0
93060355297,93060355293,-4,1009,3267,0
93061690775,93061690774,-1,1414,2005,0
93061958500,93061958499,-1,1260,1272,0
93067507231,93067507226,-5,21591,11209,0
93068840005,93068840007,2,1684,2029,0
93069086975,93069086974,-1,1233,2177,0
93079852183,93079852182,-1,1559,1749,0
93080509339,93080509338,-1,1181,1227,0
93081683634,93081683630,-4,1225,4381,0
93081859099,93081859097,-2,1003,1751,0
93086043809,93086043810,1,831,1673,0
93087367585,93087367577,-8,941,3417,0
93089050163,93089050165,2,1593,2165,0
93091612020,93091612021,1,1380,1399,0
93093516493,93093516493,0,1029,1364,0
93097800730,93097800726,-4,1591,4540,0
93102990253,93102990254,1,1427,1485,0
93103588828,93103588826,-2,1130,1967,0
93104157153,93104157159,6,3020,874,0
93104305934,93104305935,1,538,652,0
93104955031,93104955029,-2,1252,2360,0
93105877565,93105877586,21,1032,1736,0
93107081298,93107081301,3,1238,1243,0
93108175552,93108175550,-2,1272,1524,0
93109046260,93109046261,1,1604,1330,0
93111901258,93111901258,0,1278,1794,0
93112332330,93112332331,1,1512,2194,0
93112563038,93112563039,1,1078,1530,0
93112691884,93112691883,-1,1227,1843,0
93112770200,93112770218,18,940,1567,0
93115326925,93115326927,2,1031,1583,0
93116622962,93116622963,1,1834,2637,0
93116771678,93116771679,1,1435,1460,0
93116823490,93116823490,0,676,1242,0
93117180790,93117180787,-3,1191,1627,0
93119807266,93119807265,-1,1479,2331,0
93120092333,93120092331,-2,1678,2277,0
93121850695,93121850695,0,1679,2505,0
93122099291,93122099290,-1,1404,1752,0
93123133820,93123133818,-2,1490,1740,0
93125045422,93125045423,1,1312,1618,0
93125072491,93125072468,-23,1016,1109,0
93127339246,93127339245,-1,1245,1182,0
93127774850,93127774854,4,3417,1114,0
93130207579,93130207580,1,1504,1401,0
93132721562,93132721581,19,1450,1331,0
93134461837,93134461837,0,1502,1804,0
93134654150,93134654170,20,1248,1709,0
93137449293,93137449295,2,1892,2030,0
93139432899,93139432909,10,944,1588,0
93143001445,93143001446,1,1313,1384,0
93147773604,93147773604,0,1921,2685,0
93147919441,93147919441,0,1227,1122,0
93148868314,93148868318,4,1157,1646,0
93152237294,93152237297,3,1458,1524,0
93155491134,93155491134,0,1328,1682,0
93156179632,93156179634,2,1769,1775,0
93156458486,93156458486,0,1030,1805,0
93156887438,93156887437,-1,1385,1726,0
93158744257,93158744257,0,1467,1586,0
93158809988,93158809989,1,1206,1500,0
93161241519,93161241521,2,1752,1680,0
93161991949,93161991948,-1,1418,2035,0
93165141512,93165141512,0,1564,1662,0
93165986343,93165986343,0,1010,941,0
93168029530,93168029531,1,1134,1651,0
93169096902,93169096902,0,1597,2019,0
93173013754,93173013756,2,1606,2380,0
93173044552,93173044554,2,239,975,0
93173128600,93173128593,-7,34312,16770,0
93175932278,93175932280,2,1561,1801,0
93178639509,93178639511,2,730,683,0
93179740515,93179740515,0,1881,2608,0
93181046279,93181046284,5,2790,1770,0
93181456915,93181456917,2,2064,1875,0
93181900393,93181900385,-8,1251,5670,0
93182423098,93182423098,0,1698,1988,0
93182524070,93182524069,-1,1595,1905,0
93187219314,93187219310,-4,1134,1561,0
93189731102,93189731102,0,1648,2512,0
93189794198,93189794198,0,763,1427,0
93192846646,93192846646,0,1304,1762,0
93194576395,93194576393,-2,1037,1611,0
93195771573,93195771574,1,1457,2208,0
93196528454,93196528455,1,2041,2454,0
93198582000,93198582001,1,1535,1957,0
93200026325,93200026318,-7,1311,5552,0
93201827443,93201827445,2,1562,2170,0
93203764681,93203764681,0,1561,1843,0
93204277552,93204277554,2,1205,1737,0
93206160710,93206160705,-5,29850,12749,0
93209407777,93209407778,1,1409,2309,0
93210505374,93210505375,1,1608,1618,0
93215941870,93215941871,1,1269,1352,0
93218020079,93218020078,-1,1291,1849,0
93218694727,93218694728,1,2100,1934,0
93226949174,93226949174,0,1664,1891,0
93230916874,93230916874,0,1199,1503,0
93231749259,93231749260,1,1061,1256,0
93235416448,93235416449,1,1353,1623,0
93235529263,93235529264,1,1161,1720,0
93236361108,93236361105,-3,24555,11080,0
93236757045,93236757044,-1,1967,1508,0
93238267852,93238267852,0,1117,1748,0
93240806363,93240806362,-1,1225,1377,0
93241136135,93241136137,2,1838,1648,0
93242488465,93242488466,1,12941,14218,0
93245324370,93245324373,3,1884,1414,0
93247079970,93247079967,-3,1013,1814,0
93248141121,93248141127,6,2070,1331,0
93248487662,93248487662,0,1108,1491,0
93249320907,93249320911,4,1432,1902,0
93253365195,93253365198,3,1255,1784,0
93255485239,93255485240,1,1542,1599,0
93257764587,93257764589,2,1644,1525,0
93258138685,93258138686,1,1390,1063,0
93259901395,93259901397,2,1180,1062,0
93261514945,93261514946,1,1612,1928,0
93270960378,93270960379,1,1376,1268,0
93271646134,93271646134,0,1533,1608,0
93272990107,93272990109,2,1988,2359,0
93273739077,93273739078,1,1085,1312,0
93273995887,93273995901,14,1234,1132,0
93274390575,93274390575,0,1257,2015,0
93276929868,93276929871,3,1630,2496,0
93277544081,93277544080,-1,936,1493,0
93281258609,93281258609,0,2109,1762,0
93281668834,93281668835,1,1052,1156,0
93281997660,93281997661,1,1802,1595,0
93289989598,93289989598,0,1309,1372,0
93290441635,93290441641,6,2875,1896,0
93291122270,93291122270,0,1647,1902,0
93291297490,93291297491,1,1116,1905,0
93292234827,93292234829,2,1590,1273,0
93292844367,93292844347,-20,1233,1488,0
93295311086,93295311086,0,1387,1556,0
93295722261,93295722262,1,2089,1653,0
93296199826,93296199825,-1,1032,1398,0
93298325557,93298325558,1,1703,1577,0
93298670053,93298670054,1,1264,1797,0
93300720771,93300720774,3,1531,1426,0
93301572898,93301572899,1,1866,2077,0
93303356700,93303356683,-17,1284,3931,0
93306145274,93306145275,1,549,1181,0
93306665575,93306665577,2,1073,1322,0
93309110762,93309110765,3,4024,2715,0
93312338227,93312338230,3,1437,1466,0
93318935725,93318935726,1,2348,1987,0
93319529414,93319529416,2,1666,1712,0
93325405309,93325405307,-2,950,1968,0
93325622697,93325622697,0,1139,1565,0
93327571735,93327571734,-1,773,1850,0
93329036237,93329036241,4,2694,1537,0
93329778529,93329778531,2,1093,1607,0
93330028388,93330028378,-10,982,1043,0
93331224328,93331224327,-1,1438,1096,0
93332214298,93332214296,-2,1241,1982,0
93333680557,93333680558,1,1828,1393,0
93336806853,93336806855,2,1184,2031,0
93338174441,93338174442,1,1140,1972,0
93339385510,93339385510,0,1959,2511,0
93339819314,93339819314,0,1208,1720,0
93340754192,93340754195,3,1307,1107,0
93348199280,93348199282,2,1501,1577,0
93349618867,93349618864,-3,1306,1710,0
93350928159,93350928162,3,1400,1332,0
93353797827,93353797827,0,668,1688,0
93358253360,93358253359,-1,1539,1770,0
93360689175,93360689174,-1,1320,1731,0
93362363068,93362363074,6,4906,2415,0
93362468338,93362468338,0,1229,1540,0
93366121214,93366121215,1,748,1114,0
93368311230,93368311230,0,1489,1145,0
93369436781,93369436785,4,1861,1272,0
93369942558,93369942557,-1,872,1682,0
93370370986,93370370986,0,1676,1359,0
93373882345,93373882346,1,1461,1737,0
93374999930,93374999930,0,1222,1798,0
93375159741,93375159729,-12,175,2745,0
93376967570,93376967573,3,1928,1457,0
93380396409,93380396409,0,1459,1517,0
93382521623,93382521625,2,614,1130,0
93390139956,93390139958,2,1081,1777,0
93390456224,93390456225,1,1692,1791,0
93391175397,93391175405,8,1035,1380,0
93392532903,93392532906,3,1710,1495,0
93393781815,93393781815,0,1200,2920,0
93395844638,93395844642,4,970,756,0
93396713183,93396713183,0,865,1101,0
93398201340,93398201341,1,1268,1689,0
93398565020,93398565017,-3,2409,4944,0
93398784337,93398784337,0,1242,1855,0
93399708652,93399708652,0,1481,2158,0
93403862417,93403862419,2,1334,2107,0
93404099662,93404099663,1,1024,1529,0
93414978901,93414978901,0,1185,1786,0
93415755759,93415755761,2,772,1908,0
93419002826,93419002829,3,1280,1111,0
93419565442,93419565442,0,1231,1512,0
93420264719,93420264719,0,2114,2033,0
93421903458,93421903459,1,1615,1978,0
93423867791,93423867791,0,836,1190,0
93425052194,93425052197,3,1613,1112,0
93428084021,93428084002,-19,5344,2979,0
93429793930,93429793929,-1,1061,2087,0
93429827182,93429827182,0,1280,2000,0
93430785443,93430785443,0,1728,1893,0
93431012000,93431011998,-2,1105,2030,0
93432334979,93432334982,3,1157,1670,0
93435699887,93435699890,3,1226,1646,0
93435866930,93435866935,5,2100,1576,0
93436879108,93436879110,2,1225,1664,0
93437934113,93437934114,1,1454,1625,0
93440799863,93440799867,4,1103,1115,0
93442292845,93442292851,6,2957,1183,0
93445967979,93445967980,1,1350,1674,0
93448859214,93448859217,3,1394,934,0
93449911402,93449911401,-1,835,2019,0
93452871271,93452871270,-1,1427,2105,0
93452921362,93452921361,-1,1408,1933,0
93455826327,93455826321,-6,31733,14894,0
93456458661,93456458662,1,1695,1629,0
93461147749,93461147749,0,1775,2406,0
93461956862,93461956858,-4,1680,1318,0
93464046507,93464046507,0,925,2045,0
93466699551,93466699553,2,1824,2137,0
93468248017,93468248017,0,885,1828,0
93475382558,93475382555,-3,1120,2934,0
93479193229,93479193229,0,1351,1590,0
93479753067,93479753066,-1,1230,1405,0
93479940013,93479940013,0,872,1614,0
93481857906,93481857907,1,1531,1426,0
93483354715,93483354714,-1,2097,1726,0
93486145649,93486145648,-1,1230,1457,0
93486842779,93486842781,2,1219,1029,0
93488292825,93488292825,0,1660,2597,0
93488768358,93488768357,-1,1214,1354,0
93490903249,93490903247,-2,1288,2064,0
93496407351,93496407354,3,1920,1582,0
93497207395,93497207393,-2,573,1428,0
93502931984,93502931985,1,1162,1730,0
93504222510,93504222506,-4,1720,2445,0
93505238874,93505238875,1,1266,1288,0
93505811021,93505811022,1,1600,1876,0
93508976224,93508976218,-6,2327,9274,0
93509507930,93509507930,0,978,1076,0
93510145764,93510145765,1,1619,1383,0
93512025614,93512025615,1,1073,1680,0
93512676290,93512676291,1,1224,1192,0
93513345449,93513345449,0,1258,1964,0
93514666219,93514666219,0,1745,2062,0
93515088238,93515088238,0,1360,1746,0
93518194905,93518194903,-2,556,2034,0
93518653042,93518653042,0,1360,1659,0
93519981859,93519981857,-2,1073,1605,0
93523921560,93523921564,4,1738,1671,0
93526305206,93526305206,0,1421,1610,0
93527585778,93527585779,1,1786,2001,0
93528813908,93528813909,1,1157,1673,0
93529465387,93529465387,0,1491,1995,0
93529930579,93529930591,12,686,1125,0
93531025185,93531025184,-1,1273,1134,0
93533056122,93533056121,-1,1276,1715,0
93533638970,93533638971,1,653,855,0
93534736289,93534736290,1,1690,2625,0
93535180885,93535180883,-2,960,1509,0
93536323157,93536323159,2,1098,1063,0
93544018230,93544018228,-2,1136,1982,0
93544177594,93544177593,-1,1461,3296,0
93546506582,93546506582,0,1228,1318,0
93549166393,93549166394,1,1533,2336,0
93549824060,93549824049,-11,1306,1835,0
93552875586,93552875586,0,1608,1923,0
93554826964,93554826966,2,1504,1792,0
93555014513,93555014510,-3,982,3129,0
93557000730,93557000730,0,1970,3099,0
93558396928,93558396924,-4,1164,1621,0
93559261103,93559261105,2,856,1142,0
93559938901,93559938902,1,1395,1200,0
93561516984,93561516984,0,1831,2413,0
93564855382,93564855381,-1,1445,2204,0
93567368810,93567368806,-4,1063,3912,0
93572893413,93572893411,-2,1298,2550,0
93572960350,93572960353,3,1005,2092,0
93578855203,93578855203,0,1696,2063,0
93585514841,93585514842,1,1070,1574,0
93587722398,93587722397,-1,1071,993,0
93587963686,93587963686,0,1645,1719,0
93588895803,93588895799,-4,1028,1320,0
93590844401,93590844401,0,1036,1243,0
93594172796,93594172797,1,1337,1198,0
93594457342,93594457342,0,1438,1328,0
93598849890,93598849892,2,31113,30087,0
93600018859,93600018861,2,1287,2418,0
93602867911,93602867912,1,1218,1386,0
93606031574,93606031573,-1,1470,1681,0
93606495426,93606495428,2,1059,2068,0
93609213192,93609213189,-3,2404,4554,0
93612007375,93612007374,-1,1377,1901,0
93615273305,93615273307,2,1185,1295,0
93616804377,93616804376,-1,1909,1677,0
93618522751,93618522754,3,1443,1891,0
93618937425,93618937425,0,1601,1772,0
93621596461,93621596457,-4,1370,2150,0
93624307772,93624307774,2,1872,1728,0
93626847643,93626847642,-1,1278,1067,0
93631621430,93631621433,3,1649,1780,0
93632686051,93632686051,0,1250,1897,0
93633248828,93633248829,1,1611,1783,0
93636550192,93636550193,1,1333,1981,0
93641730874,93641730876,2,1273,2128,0
93643187180,93643187182,2,1197,1307,0
93643722499,93643722494,-5,2458,7577,0
93644099282,93644099269,-13,896,1259,0
93647207372,93647207373,1,1220,1498,0
93647385497,93647385498,1,1509,1259,0
93648485072,93648485071,-1,1019,932,0
93650033271,93650033270,-1,1492,2396,0
93650733135,93650733135,0,1165,1816,0
93653585153,93653585155,2,1730,2345,0
93656932899,93656932901,2,1413,1854,0
93657007545,93657007546,1,1560,1957,0
93658978742,93658978742,0,1124,1957,0
93662298358,93662298358,0,1220,1786,0
93663075070,93663075069,-1,1527,2127,0
93663124832,93663124834,2,962,1345,0
93666045323,93666045329,6,3804,2066,0
93666821118,93666821120,2,1051,1385,0
93670317335,93670317337,2,1279,1377,0
93671955287,93671955287,0,1324,1551,0
93672637400,93672637400,0,1220,1986,0
93673917255,93673917251,-4,1110,2823,0
93674662547,93674662548,1,1362,2003,0
93675326904,93675326905,1,988,1525,0
93677245981,93677245980,-1,1310,2300,0
93678911121,93678911124,3,1251,1535,0
93682689406,93682689406,0,1489,2020,0
93687233861,93687233862,1,1487,2242,0
93687555179,93687555186,7,2888,1105,0
93691340142,93691340145,3,1735,1643,0
93691561728,93691561727,-1,1398,1840,0
93691670626,93691670625,-1,1403,1735,0
93691900903,93691900904,1,2272,2185,0
93692239108,93692239111,3,1199,1270,0
93694418239,93694418252,13,348,1535,0
93695902634,93695902635,1,1516,1404,0
93696398109,93696398110,1,1399,1805,0
93697246217,93697246223,6,3277,1112,0
93697829858,93697829858,0,1350,1342,0
93698685385,93698685386,1,1331,1620,0
93700836599,93700836600,1,1118,1811,0
93701582286,93701582283,-3,1036,1512,0
93702497753,93702497754,1,1451,1238,0
93703048954,93703048954,0,1185,1739,0
93703331510,93703331511,1,1153,1347,0
93704752314,93704752313,-1,1088,1822,0
93705533846,93705533845,-1,1524,1970,0
93707607043,93707607042,-1,1472,1929,0
93707921967,93707921966,-1,2158,2665,0
93709241048,93709241049,1,1437,1753,0
93709356229,93709356227,-2,1232,1488,0
93711298947,93711298949,2,1177,1190,0
93721544017,93721544018,1,1735,1589,0
93723875094,93723875097,3,1304,1472,0
93725671862,93725671863,1,1836,1984,0
93728105757,93728105758,1,1503,1483,0
93731636918,93731636919,1,930,1338,0
93732100098,93732100099,1,1926,1683,0
93733085381,93733085382,1,1261,1460,0
93734019466,93734019467,1,1127,1952,0
93739499835,93739499837,2,2195,1579,0
93739870937,93739870939,2,1266,1480,0
93743016313,93743016303,-10,1337,1414,0
93743244569,93743244567,-2,1440,1352,0
93747066674,93747066675,1,1421,2029,0
93749133093,93749133095,2,1089,1275,0
93749973453,93749973455,2,1052,1063,0
93750641133,93750641134,1,1208,2067,0
93751098557,93751098546,-11,3081,21746,0
93752318862,93752318863,1,1298,2009,0
93754887538,93754887542,4,1281,828,0
93756224309,93756224309,0,1617,2077,0
93762780490,93762780490,0,1245,1592,0
93763505377,93763505378,1,1516,1622,0
93764326298,93764326297,-1,886,1448,0
93766169845,93766169844,-1,1695,1842,0
93767047411,93767047411,0,2371,2467,0
93767478515,93767478515,0,725,1444,0
93774830918,93774830922,4,1422,1128,0
93775708602,93775708602,0,1143,1561,0
93778702053,93778702054,1,1207,1481,0
93780121787,93780121787,0,1343,1277,0
93781739164,93781739165,1,1152,1218,0
93786766655,93786766658,3,1434,1887,0
93788028860,93788028858,-2,1217,1338,0
93790638938,93790638937,-1,1412,3369,0
93792094784,93792094785,1,2282,1802,0
93793265126,93793265127,1,1185,1521,0
93796466061,93796466061,0,1060,1497,0
93799253480,93799253478,-2,1358,1796,0
93802133854,93802133857,3,1171,1703,0
93803060494,93803060483,-11,1406,1544,0
93804812150,93804812137,-13,1386,1558,0
93805290618,93805290618,0,1287,1366,0
93805338634,93805338635,1,1882,1469,0
93806535633,93806535634,1,1658,1763,0
93807660170,93807660169,-1,1536,1419,0
93810241723,93810241726,3,1542,1291,0
93812034634,93812034637,3,1121,1345,0
93813252028,93813252025,-3,1644,4429,0
93815193455,93815193458,3,1181,1375,0
93815580375,93815580373,-2,1024,1848,0
93823283011,93823283014,3,1797,1274,0
93823395068,93823395068,0,1476,1755,0
93829874814,93829874814,0,1513,1324,0
93835001570,93835001570,0,1581,1592,0
93836154645,93836154645,0,2027,1947,0
93839003857,93839003856,-1,1615,2187,0
93840283554,93840283553,-1,1587,1617,0
93841458433,93841458434,1,1310,1245,0
93844230871,93844230872,1,1245,1352,0
93844538493,93844538494,1,1369,2141,0
93848786606,93848786609,3,1240,2056,0
93848916477,93848916477,0,1511,2043,0
93849397583,93849397584,1,1737,1738,0
93851134377,93851134378,1,1625,1881,0
93852994650,93852994651,1,1309,1535,0
93858259897,93858259898,1,1011,904,0
93860894693,93860894693,0,811,1325,0
93862736566,93862736573,7,9145,30883,0
93863730537,93863730535,-2,1017,1410,0
93867004026,93867004028,2,736,1155,0
93869771106,93869771111,5,2846,1580,0
93871239746,93871239750,4,2054,2062,0
93875848753,93875848755,2,1364,1331,0
93876778918,93876778921,3,1458,1907,0
93881302953,93881302954,1,908,1580,0
93881511630,93881511614,-16,1086,1968,0
93881687543,93881687543,0,1017,1283,0
93882313109,93882313110,1,1284,1531,0
93886282258,93886282260,2,914,1335,0
93887004026,93887004028,2,1635,1223,0
93888865065,93888865067,2,1767,1556,0
93890110822,93890110822,0,1623,1757,0
93891168797,93891168798,1,1034,1716,0
93896154583,93896154584,1,1920,2384,0
93896609349,93896609348,-1,1339,1626,0
93897002886,93897002886,0,850,1896,0
93900812977,93900812978,1,1055,1644,0
93900973117,93900973118,1,1270,1579,0
93904336627,93904336626,-1,1332,2037,0
93904653389,93904653395,6,13690,5604,0
93904988853,93904988853,0,1575,1884,0
93905449814,93905449809,-5,1676,5264,0
93910867910,93910867910,0,1962,1809,0
93913783671,93913783670,-1,1156,2198,0
93918865744,93918865744,0,1162,2262,0
93920398995,93920398995,0,1489,1807,0
93924908223,93924908226,3,1830,1640,0
93929349580,93929349580,0,1371,1480,0
93930652945,93930652946,1,1160,1705,0
93930780822,93930780825,3,928,1653,0
93931374721,93931374720,-1,1358,1442,0
93931728692,93931728692,0,1342,1906,0
93932778429,93932778449,20,395,1006,0
93941097467,93941097467,0,1390,2015,0
93943005517,93943005517,0,1095,1309,0
93943344565,93943344566,1,1004,1785,0
93943525917,93943525916,-1,1547,2130,0
93944686866,93944686869,3,1656,2209,0
93946175913,93946175913,0,1309,2192,0
93953474838,93953474838,0,1117,885,0
93959770861,93959770863,2,1333,2358,0
93961211309,93961211331,22,1251,1679,0
93961386101,93961386102,1,1378,1513,0
93962952483,93962952482,-1,1154,1902,0
93964029375,93964029378,3,1645,2376,0
93965633778,93965633780,2,1553,1705,0
93966325934,93966325934,0,1462,2155,0
93966874486,93966874485,-1,1258,1808,0
93968925337,93968925338,1,1668,2126,0
93969192763,93969192766,3,1439,1241,0
93969292697,93969292706,9,14233,22526,0
93970383635,93970383634,-1,1303,2595,0
93975072387,93975072389,2,1425,1469,0
93975671139,93975671141,2,1311,1958,0
93976174954,93976174962,8,88999,34741,0
93979242833,93979242833,0,1153,1962,0
93980190574,93980190574,0,1544,1894,0
93980968882,93980968886,4,1680,1666,0
93982462129,93982462128,-1,977,1908,0
93982567404,93982567404,0,969,1332,0
93986064839,93986064842,3,1606,1411,0
93987910044,93987910046,2,1420,1785,0
93987961697,93987961697,0,1088,1457,0
93989073762,93989073763,1,1293,1898,0
93993319869,93993319869,0,1387,2023,0
93994931394,93994931395,1,1133,1663,0
93998907689,93998907690,1,1510,1615,0
93999811916,93999811918,2,2304,1824,0
94003302930,94003302931,1,1620,1687,0
94006807309,94006807314,5,1604,1114,0
94010031011,94010031009,-2,1114,1365,0
94011454162,94011454163,1,1344,1986,0
94013929718,94013929720,2,886,1414,0
94014795645,94014795645,0,1514,1649,0
94016108018,94016108020,2,1953,1990,0
94017210966,94017210962,-4,2601,6346,0
94018599003,94018599005,2,1505,1980,0
94020364485,94020364483,-2,1284,2132,0
94021229131,94021229132,1,1571,2198,0
94022806719,94022806717,-2,959,1141,0
94023638815,94023638815,0,1416,1423,0
94024693374,94024693373,-1,1261,1602,0
94025056467,94025056470,3,1856,1540,0
94028891733,94028891734,1,1334,1754,0
94029617227,94029617230,3,1613,1503,0
94041163965,94041163965,0,1266,1120,0
94042666110,94042666127,17,866,1015,0
94043146825,94043146832,7,5535,2303,0
94046713503,94046713506,3,1578,1291,0
94047612018,94047612018,0,1491,1899,0
94050571143,94050571143,0,1269,1499,0
94053088410,94053088408,-2,1028,1893,0
94059542033,94059542034,1,1340,1522,0
94061319275,94061319274,-1,1572,2888,0
94064043091,94064043090,-1,1178,1669,0
94064839854,94064839857,3,1597,1681,0
94067434562,94067434563,1,1324,1561,0
94070023292,94070023293,1,1345,2028,0
94072250669,94072250670,1,1351,1620,0
94075407265,94075407265,0,1410,1432,0
94078997842,94078997834,-8,722,3271,0
94079642358,94079642357,-1,149,2213,0
94079725280,94079725299,19,1155,1413,0
94080634861,94080634861,0,1577,2041,0
94081398887,94081398886,-1,1612,2090,0
94082475766,94082475766,0,1659,2554,0
94084698719,94084698720,1,1043,1434,0
94085079577,94085079581,4,1507,1651,0
94087051710,94087051711,1,1100,1189,0
94087246564,94087246587,23,1261,1194,0
94088129997,94088129998,1,1281,1952,0
94088590822,94088590821,-1,1936,1599,0
94092088360,94092088363,3,1124,1392,0
94092565006,94092565007,1,1632,1973,0
94093702465,94093702469,4,1673,1761,0
94094002432,94094002433,1,942,2018,0
94097770550,94097770549,-1,1374,1484,0
94099058137,94099058137,0,1453,1604,0
94101917446,94101917446,0,666,884,0
94103666017,94103666015,-2,1101,2320,0
94105712410,94105712411,1,1499,1808,0
94109537898,94109537898,0,1116,1488,0
94109799813,94109799815,2,1480,995,0
94113320136,94113320134,-2,934,1644,0
94115712745,94115712745,0,1448,2243,0
94117376390,94117376390,0,928,1405,0
94119718269,94119718268,-1,1563,1685,0
94123609854,94123609855,1,2123,1826,0
94124083171,94124083169,-2,1068,1273,0
94126174873,94126174874,1,1355,1739,0
94126502540,94126502526,-14,177,592,0
94130779206,94130779205,-1,950,1595,0
94135818112,94135818111,-1,1176,1660,0
94136488743,94136488745,2,1422,1682,0
94137480090,94137480093,3,1370,1677,0
94144138338,94144138339,1,1679,1200,0
94144374112,94144374114,2,1570,1257,0
94145662301,94145662301,0,1323,1420,0
94145837192,94145837211,19,1381,1899,0
94146101854,94146101851,-3,1423,2478,0
94147241408,94147241410,2,1642,2005,0
94148652375,94148652375,0,1469,1657,0
94151642897,94151642899,2,1345,1441,0
94152135881,94152135882,1,1709,1305,0
94154097493,94154097494,1,2138,2095,0
94156407890,94156407894,4,1506,1198,0
94159902226,94159902227,1,1219,1471,0
94160539527,94160539531,4,1117,1338,0
94161719531,94161719534,3,1391,2019,0
94163135378,94163135381,3,1443,1517,0
94164599956,94164599954,-2,2481,4425,0
94167683201,94167683202,1,1250,1546,0
94167881339,94167881338,-1,1328,1185,0
94168980272,94168980272,0,2604,2699,0
94174073077,94174073078,1,1465,1371,0
94179530779,94179530775,-4,782,960,0
94180236176,94180236176,0,1635,2286,0
94181538619,94181538619,0,1263,1350,0
94183614258,94183614259,1,1674,1769,0
94184286351,94184286350,-1,951,1396,0
94184330515,94184330516,1,1040,1650,0
94190908927,94190908926,-1,1397,927,0
94193416889,94193416886,-3,1077,1658,0
94194274910,94194274909,-1,773,837,0
94195797578,94195797580,2,1554,1400,0
94197449605,94197449605,0,1717,1873,0
94201026945,94201026946,1,1276,1438,0
94202242774,94202242773,-1,1551,1495,0
94203057816,94203057814,-2,1499,2619,0
94203779554,94203779554,0,1305,1759,0
94205347465,94205347470,5,2765,1397,0
94205740145,94205740145,0,1510,1623,0
94211188095,94211188094,-1,1615,1755,0
94215061195,94215061193,-2,2297,4533,0
94219505415,94219505414,-1,2254,2527,0
94221056953,94221056949,-4,1316,1136,0
94232649409,94232649407,-2,905,2019,0
94234880646,94234880642,-4,829,1313,0
94235535085,94235535085,0,1328,1368,0
94239146881,94239146882,1,1249,1761,0
94239642573,94239642573,0,1962,1910,0
94242036126,94242036127,1,1431,1654,0
94253190407,94253190406,-1,1088,1413,0
94255374257,94255374256,-1,992,1675,0
94257410237,94257410241,4,4328,2680,0
94258054902,94258054902,0,1527,1689,0
94262781942,94262781942,0,1081,1202,0
94265453881,94265453881,0,1787,1485,0
94270144520,94270144525,5,1670,1850,0
94270512022,94270512022,0,1268,1260,0
94271945570,94271945573,3,926,1751,0
94272003582,94272003585,3,280,1484,0
94273566440,94273566446,6,3387,1194,0
94273789115,94273789096,-19,1420,1572,0
94273975421,94273975433,12,155,2294,0
94274250665,94274250665,0,1867,2389,0
94276429609,94276429610,1,1666,1672,0
94278166276,94278166276,0,1076,1561,0
94278832999,94278832998,-1,1929,3009,0
94278942334,94278942334,0,1591,2038,0
94281399054,94281399056,2,1890,2292,0
94281726370,94281726370,0,1318,1860,0
94282916107,94282916107,0,1332,1422,0
94284754612,94284754614,2,1464,1948,0
94288311141,94288311142,1,2415,2040,0
94289470459,94289470459,0,1544,1435,0
94289995018,94289995017,-1,1850,1620,0
94290698814,94290698816,2,1688,1625,0
94291598468,94291598468,0,1595,1823,0
94292268658,94292268659,1,1491,1518,0
94294930675,94294930674,-1,1143,1379,0
94300225043,94300225046,3,1513,1140,0
94300661631,94300661633,2,2046,1727,0
94302566450,94302566458,8,2222,1343,0
94309402911,94309402908,-3,783,1601,0
94311500973,94311500974,1,1504,1727,0
94314630435,94314630434,-1,1024,1744,0
94316190551,94316190553,2,852,1642,0
94317923086,94317923086,0,1413,1319,0
94318361094,94318361098,4,1661,904,0
94319043587,94319043589,2,1714,1981,0
94319370812,94319370812,0,1331,1392,0
94320664232,94320664235,3,2095,1253,0
94322991581,94322991587,6,4242,1417,0
94326109281,94326109284,3,1439,1069,0
94328676970,94328676975,5,1687,720,0
94329333768,94329333766,-2,1529,1215,0
94330201148,94330201151,3,1385,1290,0
94330737371,94330737369,-2,750,928,0
94330991647,94330991649,2,861,1377,0
94333538070,94333538072,2,2046,2000,0
94336049033,94336049034,1,1535,1481,0
94337196255,94337196253,-2,1339,1655,0
94339593226,94339593235,9,13675,21732,0
94342605603,94342605601,-2,1549,1653,0
94343133719,94343133721,2,1435,1409,0
94346905690,94346905693,3,1715,1659,0
94349054376,94349054377,1,1605,2019,0
94350566114,94350566128,14,1491,1326,0
94351311910,94351311911,1,1415,1293,0
94352078165,94352078165,0,823,1849,0
94352585600,94352585609,9,216,2499,0
94353670135,94353670135,0,1655,1789,0
94358711753,94358711752,-1,1502,1698,0
94359079610,94359079617,7,3003,1481,0
94359970293,94359970293,0,1856,1552,0
94364799094,94364799093,-1,1401,2052,0
94365649934,94365649933,-1,1310,1591,0
94370222230,94370222227,-3,2026,3534,0
94374290618,94374290618,0,1271,1464,0
94376435146,94376435145,-1,1257,2126,0
94381237038,94381237037,-1,1479,1847,0
94382411191,94382411193,2,1342,1469,0
94383128904,94383128901,-3,2085,2935,0
94388283329,94388283334,5,2779,1590,0
94390554265,94390554266,1,1811,2061,0
94393762237,94393762237,0,1223,1191,0
94399903028,94399903029,1,1501,2068,0
94401469484,94401469486,2,1476,1682,0
94405191995,94405191998,3,1677,1456,0
94405635095,94405635094,-1,1613,1788,0
94408342518,94408342518,0,1493,1336,0
94408937902,94408937903,1,1216,1769,0
94410183172,94410183173,1,973,2278,0
94414123349,94414123349,0,1001,1524,0
94415895510,94415895510,0,1114,1474,0
94418460318,94418460318,0,1536,1853,0
94419501113,94419501113,0,1158,1908,0
94420584081,94420584081,0,1840,2483,0
94420828654,94420828654,0,1204,1767,0
94421436522,94421436528,6,3677,2034,0
94421670371,94421670365,-6,1779,7083,0
94422485618,94422485618,0,1559,1389,0
94422818683,94422818661,-22,1115,1648,0
94426761453,94426761454,1,2165,2299,0
94429162074,94429162074,0,1573,2499,0
94429620898,94429620898,0,1176,2212,0
94431227532,94431227533,1,1653,2006,0
94431543141,94431543135,-6,750,4179,0
94433927302,94433927302,0,907,1069,0
94435240161,94435240161,0,1230,1628,0
94443835013,94443835012,-1,957,1907,0
94444781482,94444781480,-2,1531,1510,0
94445170327,94445170327,0,1300,1878,0
94449112762,94449112763,1,805,1769,0
94451219523,94451219516,-7,1857,9454,0
94451782305,94451782305,0,1207,1979,0
94453296281,94453296282,1,1005,1087,0
94460709210,94460709211,1,1152,1535,0
94463766352,94463766353,1,1241,1390,0
94468081235,94468081235,0,1560,1131,0
94472225033,94472225037,4,1412,1065,0
94477656833,94477656826,-7,2545,7437,0
94478270545,94478270546,1,1323,1353,0
94480326689,94480326689,0,1434,2451,0
94480904323,94480904325,2,1395,1451,0
94481726652,94481726654,2,1369,1420,0
94482419991,94482419991,0,1747,2305,0
94484257087,94484257087,0,1157,1480,0
94488065395,94488065391,-4,977,1170,0
94489481273,94489481275,2,937,1474,0
94490662161,94490662162,1,969,1639,0
94491283749,94491283749,0,1429,1397,0
94492432842,94492432841,-1,1122,1194,0
94494115329,94494115327,-2,1077,1523,0
94495566855,94495566854,-1,1673,1879,0
94495829811,94495829810,-1,1789,2542,0
94496166261,94496166268,7,2301,734,0
94497420811,94497420822,11,1285,1501,0
94502351228,94502351233,5,2949,1261,0
94503190213,94503190210,-3,1245,1702,0
94504522043,94504522045,2,1144,1882,0
94505677900,94505677901,1,1380,1409,0
94506785145,94506785145,0,1189,1732,0
94509869604,94509869602,-2,980,643,0
94511366940,94511366941,1,1386,1780,0
94512524094,94512524094,0,1263,1767,0
94513581912,94513581914,2,1658,2151,0
94514174918,94514174918,0,1835,2392,0
94515668463,94515668462,-1,1153,1377,0
94516579634,94516579633,-1,1227,1048,0
94518190049,94518190046,-3,1253,1366,0
94518988365,94518988365,0,1558,1836,0
94522105549,94522105549,0,1398,2367,0
94523794905,94523794906,1,1429,2230,0
94525685591,94525685593,2,1156,1793,0
94527426144,94527426151,7,2923,1193,0
94527811666,94527811666,0,1071,1663,0
94531660591,94531660589,-2,1443,2130,0
94534809798,94534809798,0,1054,947,0
94538888779,94538888778,-1,963,1275,0
94538987439,94538987445,6,396,498,0
94543813402,94543813406,4,1655,1510,0
94549989874,94549989875,1,1932,2216,0
94552290991,94552290990,-1,1870,1443,0
94555273498,94555273499,1,1312,1386,0
94557682881,94557682880,-1,1148,1837,0
94559267669,94559267669,0,1153,1547,0
94559418546,94559418545,-1,983,1076,0
94560410297,94560410296,-1,1415,2067,0
94563979475,94563979473,-2,1351,2044,0
94564518809,94564518809,0,1888,1918,0
94565886793,94565886794,1,1849,1498,0
94566373111,94566373112,1,1971,1891,0
94570610563,94570610563,0,1205,1152,0
94571823674,94571823674,0,1454,1605,0
94577904367,94577904370,3,1364,1343,0
94578331961,94578331963,2,2593,2921,0
94580227199,94580227197,-2,1519,2152,0
94583569346,94583569345,-1,975,1491,0
94584984737,94584984741,4,1402,1686,0
94586774459,94586774459,0,1608,2138,0
94588878990,94588878991,1,1159,1039,0
94589132757,94589132758,1,1739,1685,0
94590253415,94590253417,2,1867,1911,0
94591385299,94591385301,2,1485,1490,0
94592424205,94592424205,0,1410,1718,0
94596121576,94596121572,-4,1362,4938,0
94597358357,94597358358,1,1057,1226,0
94598449229,94598449229,0,1439,2000,0
94600995161,94600995162,1,1572,1652,0
94602076878,94602076882,4,988,1054,0
94603830673,94603830676,3,1386,1252,0
94607691786,94607691787,1,1783,1759,0
94614438843,94614438845,2,1470,1655,0
94616232446,94616232449,3,3356,2901,0
94617117889,94617117889,0,1601,2005,0
94619781236,94619781234,-2,1531,1572,0
94622120209,94622120209,0,1437,1439,0
94626619566,94626619566,0,1381,2019,0
94627607114,94627607118,4,3157,2401,0
94631759468,94631759468,0,1258,1942,0
94631881079,94631881080,1,1313,2001,0
94632331595,94632331591,-4,47263,17584,0
94632923383,94632923386,3,1417,1470,0
94634241505,94634241507,2,1052,1389,0
94634602248,94634602250,2,1091,1178,0
94635602993,94635602995,2,1491,1837,0
94639408210,94639408209,-1,1094,1870,0
94640687263,94640687265,2,1169,1592,0
94644468013,94644468014,1,1280,1782,0
94646159934,94646159934,0,1148,1464,0
94648425470,94648425467,-3,1046,3842,0
94650331581,94650331579,-2,1117,1763,0
94650395210,94650395210,0,1111,1501,0
94651434583,94651434583,0,916,1478,0
94651618770,94651618766,-4,917,3215,0
94651950627,94651950626,-1,1719,2035,0
94652304486,94652304486,0,1076,1606,0
94653308586,94653308585,-1,1107,1579,0
94654513759,94654513761,2,1359,1678,0
94655643033,94655643027,-6,1067,3009,0
94658843348,94658843342,-6,1852,2913,0
94661987821,94661987821,0,1479,1731,0
94666861339,94666861340,1,1124,1549,0
94669331298,94669331298,0,1673,1630,0
94673346779,94673346778,-1,1585,1604,0
94674961022,94674961022,0,1102,1498,0
94675526022,94675526022,0,1169,1493,0
94677457946,94677457945,-1,852,1299,0
94678707022,94678707023,1,704,1008,0
94682603569,94682603571,2,1012,1337,0
94688542694,94688542694,0,2182,1883,0
94692066433,94692066433,0,2059,2080,0
94693801907,94693801909,2,1356,1289,0
94693917221,94693917230,9,3930,2252,0
94694896019,94694896021,2,1017,1406,0
94695323141,94695323142,1,1321,1533,0
94695455952,94695455953,1,1219,1475,0
94697216706,94697216706,0,1843,2258,0
94697689621,94697689621,0,1702,2497,0
94698581294,94698581294,0,1092,1435,0
94698937141,94698937149,8,3152,1257,0
94700149717,94700149718,1,1328,1668,0
94704099175,94704099178,3,2012,1859,0
94705829985,94705829989,4,1587,1095,0
94707749891,94707749890,-1,1274,1533,0
94716571296,94716571298,2,1209,2280,0
94717577710,94717577711,1,1743,2268,0
94720518849,94720518851,2,1102,1207,0
94721095494,94721095494,0,1956,2337,0
94723007802,94723007805,3,1398,2177,0
94724825242,94724825242,0,1556,2215,0
94726470386,94726470387,1,1197,1688,0
94730093755,94730093756,1,1353,1411,0
94730713567,94730713567,0,1237,1504,0
94736249811,94736249811,0,954,1621,0
94736277249,94736277247,-2,1542,1735,0
94737150374,94737150374,0,1735,2546,0
94738763775,94738763775,0,1750,1620,0
94741330525,94741330526,1,1554,1721,0
94744445801,94744445802,1,1672,1585,0
94745677949,94745677949,0,1894,2044,0
94745960753,94745960759,6,1696,925,0
94749790218,94749790226,8,2598,1186,0
94750881655,94750881654,-1,1147,1749,0
94751852090,94751852097,7,2993,1422,0
94752739437,94752739438,1,1291,1553,0
94755257006,94755257006,0,1305,1356,0
94756121458,94756121458,0,974,1658,0
94756223625,94756223626,1,1487,1668,0
94764454137,94764454139,2,1194,2002,0
94773499606,94773499607,1,1154,1755,0
94774445774,94774445782,8,3200,1896,0
94779982297,94779982295,-2,16280,16235,0
94784977194,94784977195,1,1555,1480,0
94786810966,94786810961,-5,4765,12249,0
94790417005,94790417007,2,1026,1154,0
94792046057,94792046058,1,933,1634,0
94792870829,94792870829,0,1331,1857,0
94796795773,94796795774,1,1246,1598,0
94801246337,94801246338,1,1752,1687,0
94803428094,94803428093,-1,1075,1666,0
94803976849,94803976849,0,1643,2322,0
94808497917,94808497919,2,1006,2103,0
94810732428,94810732430,2,1818,1317,0
94812133466,94812133465,-1,889,1702,0
94812637165,94812637173,8,1265,1519,0
94815009079,94815009083,4,1191,1022,0
94816650500,94816650501,1,1713,1511,0
94824658089,94824658091,2,1211,1746,0
94824913586,94824913587,1,1559,1164,0
94826729111,94826729111,0,1691,2139,0
94827974466,94827974465,-1,1812,1909,0
94829490231,94829490231,0,1097,1811,0
94829901780,94829901780,0,1390,1675,0
94831045747,94831045747,0,1219,2263,0
94831127730,94831127731,1,1798,2222,0
94833053608,94833053609,1,1437,1581,0
94837546839,94837546838,-1,1295,1184,0
94841320104,94841320094,-10,943,1119,0
94842978392,94842978391,-1,1346,1940,0
94844626141,94844626142,1,1938,2097,0
94851383877,94851383877,0,1424,2115,0
94851681904,94851681903,-1,1115,1481,0
94854840190,94854840189,-1,1577,1212,0
94857291223,94857291223,0,1840,2286,0
94858013206,94858013208,2,1312,1719,0
94859779074,94859779080,6,3132,1743,0
94859884412,94859884413,1,1317,1447,0
94860235935,94860235934,-1,1508,1819,0
94864489724,94864489742,18,1117,1414,0
94866557306,94866557307,1,1659,2125,0
94869336802,94869336798,-4,1433,3627,0
94870086091,94870086091,0,1389,1626,0
94871726973,94871726974,1,1019,1067,0
94873508788,94873508789,1,1263,1371,0
94879648205,94879648205,0,2032,2787,0
94883759482,94883759482,0,1229,2030,0
94891269416,94891269417,1,1318,2043,0
94892540066,94892540066,0,1683,1937,0
94892955576,94892955578,2,1309,2304,0
94894248095,94894248097,2,1559,1887,0
94894992221,94894992228,7,5064,2035,0
94896656899,94896656899,0,1114,1198,0
94898915421,94898915443,22,1196,1039,0
94902422598,94902422598,0,1327,1593,0
94906388942,94906388942,0,1637,1586,0
94907137678,94907137678,0,1094,1941,0
94909270428,94909270429,1,1005,1706,0
94911201801,94911201805,4,1948,1438,0
94914382529,94914382529,0,1621,1804,0
94916177609,94916177610,1,1456,2534,0
94917206467,94917206466,-1,1127,1926,0
94920103339,94920103342,3,2172,1526,0
94920936302,94920936303,1,1287,1453,0
94923061205,94923061205,0,1714,1778,0
94928614911,94928614911,0,1391,2173,0
94929764987,94929764988,1,887,1141,0
94931724307,94931724307,0,1230,2059,0
94933820674,94933820674,0,1708,1893,0
94933958978,94933958977,-1,1548,1918,0
94935435473,94935435473,0,1216,1758,0
94936030938,94936030939,1,1809,2141,0
94941148393,94941148391,-2,1931,1638,0
94945354818,94945354818,0,1853,1712,0
94947387647,94947387646,-1,1155,2144,0
94948358996,94948358993,-3,1599,2007,0
94948720171,94948720171,0,1305,2306,0
94948764005,94948764006,1,1846,1111,0
94950169875,94950169877,2,1699,1933,0
94953960543,94953960542,-1,1129,1521,0
94956923262,94956923263,1,1103,1541,0
94958516337,94958516339,2,1506,1930,0
94958856791,94958856796,5,1377,1300,0
94959975913,94959975913,0,1470,1670,0
94960224911,94960224911,0,882,1533,0
94963935193,94963935194,1,1514,1735,0
94966870329,94966870329,0,1905,1454,0
94966958341,94966958341,0,1876,1798,0
94967762662,94967762663,1,1734,1728,0
94970745117,94970745117,0,1296,1532,0
94970922878,94970922877,-1,1392,2141,0
94972367811,94972367813,2,1088,1864,0
94972563547,94972563548,1,1818,2738,0
94976116979,94976116983,4,1849,2101,0
94976529740,94976529742,2,1335,1674,0
94977843649,94977843650,1,1394,1489,0
94980770777,94980770783,6,3038,1413,0
94984098427,94984098427,0,1138,1389,0
94990443378,94990443380,2,1262,1274,0
94993841137,94993841137,0,1792,1749,0
94998272214,94998272218,4,1516,1775,0
94999736451,94999736455,4,1785,1536,0
95001987317,95001987318,1,1555,1769,0
95006037037,95006037037,0,1347,1847,0
95006716766,95006716770,4,1662,1342,0
95010954939,95010954933,-6,1041,4166,0
95011793741,95011793742,1,1612,1788,0
95016373950,95016373950,0,816,1737,0
95020150723,95020150722,-1,1012,2106,0
95020965831,95020965830,-1,872,1475,0
95024551279,95024551279,0,1028,1517,0
95026169118,95026169133,15,207,829,0
95026445898,95026445898,0,1727,2045,0
95026991651,95026991650,-1,1239,2029,0
95027274787,95027274793,6,2222,1170,0
95028571174,95028571177,3,1638,2025,0
95033050282,95033050282,0,1316,1666,0
95037082387,95037082389,2,895,1488,0
95043957237,95043957242,5,2728,1036,0
95045073777,95045073777,0,1471,1927,0
95047956284,95047956282,-2,1587,2243,0
95048437433,95048437433,0,1205,1564,0
95049235044,95049235045,1,1692,1533,0
95050445707,95050445707,0,1361,1496,0
95051145352,95051145353,1,1523,1508,0
95054422842,95054422843,1,1046,1359,0
95055069862,95055069862,0,979,1406,0
95057257274,95057257279,5,1871,1278,0
95057493326,95057493316,-10,1244,400,0
95058995841,95058995841,0,1867,2118,0
95059852221,95059852226,5,3028,909,0
95062157929,95062157929,0,1188,1549,0
95064147975,95064147974,-1,2206,4618,0
95064701397,95064701399,2,1043,1031,0
95068472583,95068472583,0,985,1546,0
95072737647,95072737650,3,1604,1827,0
95075898951,95075898950,-1,1416,2031,0
95077698534,95077698533,-1,1499,1984,0
95078402623,95078402625,2,2978,2798,0
95080005898,95080005899,1,1764,1932,0
95080203446,95080203446,0,1558,1949,0
95080434309,95080434310,1,1489,1748,0
95086068854,95086068858,4,1809,1771,0
95087722761,95087722754,-7,840,2850,0
95090008870,95090008870,0,1574,1649,0
95093576098,95093576099,1,1812,2546,0
95094126021,95094126007,-14,1322,2426,0
95098965546,95098965546,0,2413,1693,0
95099769647,95099769649,2,1483,1433,0
95101100239,95101100235,-4,807,1427,0
95104436742,95104436735,-7,1875,7825,0
95109405066,95109405066,0,1110,1664,0
95109614247,95109614251,4,1847,1246,0
95110524774,95110524775,1,15704,20417,0
95116579495,95116579499,4,1735,1995,0
95118824305,95118824305,0,2250,2777,0
95124692695,95124692693,-2,898,1706,0
95125163236,95125163234,-2,1292,1358,0
95125426140,95125426138,-2,1057,1279,0
95127663134,95127663134,0,1583,1596,0
95129789926,95129789927,1,3984,3166,0
95130345018,95130345019,1,2365,2641,0
95136907273,95136907271,-2,1438,1780,0
95137233723,95137233722,-1,1445,1592,0
95137682410,95137682411,1,932,915,0
95138936351,95138936352,1,1320,1641,0
95140325298,95140325297,-1,1477,1752,0
95143636091,95143636091,0,1309,1676,0
95145423558,95145423559,1,1439,2168,0
95146142090,95146142090,0,1746,1325,0
95146203972,95146203973,1,1062,1641,0
95147851311,95147851310,-1,1240,2406,0
95149815778,95149815778,0,1465,2145,0
95150343886,95150343886,0,1380,1375,0
95151457670,95151457670,0,1373,1655,0
95152130285,95152130286,1,1461,1627,0
95160203811,95160203813,2,1352,1311,0
95163201135,95163201130,-5,1136,4444,0
95164849518,95164849517,-1,1224,2843,0
95165641406,95165641407,1,1691,2121,0
95166687015,95166687018,3,2016,1517,0
95171091035,95171091037,2,1816,1613,0
95174491885,95174491887,2,1839,1781,0
95174543758,95174543757,-1,1561,1979,0
95175377390,95175377389,-1,1289,1844,0
95175479953,95175479954,1,1017,1806,0
95177230837,95177230839,2,1490,1434,0
95178998645,95178998645,0,1363,1801,0
95182139644,95182139641,-3,1267,1140,0
95183947510,95183947509,-1,1526,1697,0
95185016690,95185016690,0,1047,882,0
95185634629,95185634631,2,1265,1856,0
95188488811,95188488812,1,1478,1315,0
95188858014,95188858014,0,1508,2298,0
95191278206,95191278206,0,1304,1696,0
95193564215,95193564216,1,2034,2298,0
95194050016,95194050017,1,1237,1582,0
95197607562,95197607563,1,1095,2042,0
95202634845,95202634831,-14,746,195,0
95203310289,95203310286,-3,905,1224,0
95207133926,95207133927,1,1739,2562,0
95207724369,95207724370,1,929,1630,0
95207769127,95207769107,-20,1659,2061,0
95214207547,95214207548,1,1249,1487,0
95216871762,95216871761,-1,1413,1829,0
95217366345,95217366343,-2,1484,1286,0
95217872923,95217872921,-2,1497,1331,0
95222867998,95222867999,1,1372,1975,0
95223770859,95223770861,2,1244,1866,0
95225441730,95225441729,-1,1480,2234,0
95226517245,95226517247,2,1392,881,0
95226547652,95226547644,-8,1113,1593,0
95232087588,95232087589,1,1394,1626,0
95237350621,95237350622,1,1321,1252,0
95241647528,95241647527,-1,2308,2774,0
95245887754,95245887755,1,1067,1224,0
95246386318,95246386317,-1,2088,4593,0
95249006651,95249006650,-1,1426,1547,0
95249513266,95249513249,-17,701,528,0
95253379618,95253379623,5,2278,1610,0
95257307692,95257307692,0,1571,2420,0
95260731621,95260731622,1,1441,1687,0
95262222519,95262222521,2,1407,1080,0
95269866366,95269866366,0,1179,1512,0
95276246210,95276246212,2,1382,1728,0
95278214571,95278214570,-1,1939,1766,0
95280155111,95280155111,0,1460,1749,0
95282766586,95282766586,0,967,1657,0
95285684914,95285684914,0,1445,1840,0
95285819478,95285819459,-19,1603,2098,0
95286482477,95286482464,-13,1354,1491,0
95289254326,95289254329,3,1234,1192,0
95290280561,95290280562,1,1383,1572,0
95293453050,95293453053,3,1519,1748,0
95296937057,95296937058,1,1567,1747,0
95297112878,95297112880,2,611,1092,0
95297206550,95297206539,-11,1109,1835,0
95301807250,95301807251,1,1167,1426,0
95304533508,95304533508,0,855,1379,0
95304951775,95304951773,-2,1050,1705,0
95306359230,95306359212,-18,1000,1275,0
95306880011,95306880010,-1,902,1447,0
95309898990,95309898993,3,1035,1182,0
95314496025,95314496025,0,1302,1149,0
95315230518,95315230518,0,1622,2226,0
95316205103,95316205105,2,1519,1675,0
95316339645,95316339644,-1,925,1749,0
95319162443,95319162442,-1,1164,1584,0
95319588731,95319588732,1,1451,1582,0
95319714709,95319714703,-6,1146,1040,0
95323896810,95323896810,0,1183,1489,0
95325151602,95325151608,6,3469,1530,0
95325375887,95325375886,-1,1825,2309,0
95325427461,95325427460,-1,1045,1810,0
95326641586,95326641585,-1,1143,1323,0
95327047789,95327047787,-2,1337,2101,0
95327290647,95327290626,-21,1009,1263,0
95329742438,95329742439,1,1562,2152,0
95330919739,95330919740,1,1531,1767,0
95332427990,95332427989,-1,1271,2031,0
95335589998,95335590017,19,973,1203,0
95338179856,95338179853,-3,730,1068,0
95339715997,95339715995,-2,1096,1321,0
95340441691,95340441691,0,1104,1330,0
95342322618,95342322618,0,1736,1267,0
95343565594,95343565595,1,650,709,0
95353753887,95353753890,3,7473,4737,0
95353934736,95353934732,-4,26145,13495,0
95354248488,95354248489,1,1588,1886,0
95354754239,95354754256,17,904,3177,0
95358479955,95358479958,3,2188,2126,0
95359066261,95359066261,0,1537,1368,0
95363621826,95363621829,3,1246,1874,0
95366456455,95366456455,0,1589,1640,0
95366852074,95366852077,3,455,1044,0
95370171407,95370171409,2,1119,1463,0
95370719409,95370719406,-3,1251,1193,0
95371865941,95371865925,-16,1030,1184,0
95373037287,95373037287,0,1143,1663,0
95379331379,95379331378,-1,1553,1830,0
95382628627,95382628627,0,1198,1720,0
95383435269,95383435271,2,1314,1263,0
95385764520,95385764523,3,1730,1195,0
95389334966,95389334966,0,1077,1066,0
95391335021,95391335019,-2,46707,22818,0
95399349318,95399349324,6,2872,1183,0
95401115295,95401115295,0,1331,1075,0
95403184959,95403184959,0,1428,1862,0
95403697059,95403697058,-1,984,1691,0
95406606467,95406606467,0,1728,1729,0
95408961389,95408961389,0,958,1475,0
95409807505,95409807505,0,1495,1954,0
95410883459,95410883459,0,1594,1398,0
95413294731,95413294730,-1,1377,1886,0
95413592911,95413592912,1,1169,1316,0
95414119434,95414119435,1,1883,1905,0
95416373363,95416373364,1,1095,1615,0
95422623241,95422623241,0,1657,1350,0
95428139601,95428139603,2,1387,1496,0
95431254495,95431254494,-1,866,1699,0
95435521562,95435521563,1,1954,2145,0
95436992949,95436992951,2,1234,1926,0
95439490605,95439490605,0,1682,1401,0
95439721612,95439721612,0,19601,15091,0
95440466701,95440466708,7,11839,28574,0
95441056393,95441056396,3,1818,1299,0
95446418379,95446418380,1,1179,1865,0
95457842072,95457842071,-1,1224,2184,0
95457965218,95457965220,2,1400,2058,0
95462507590,95462507590,0,1610,2166,0
95467709891,95467709891,0,1712,1803,0
95468909839,95468909841,2,1049,1382,0
95469269111,95469269111,0,1175,1403,0
95469696039,95469696038,-1,1598,2221,0
95472979054,95472979055,1,1581,1840,0
95479532178,95479532179,1,1736,1503,0
95480642915,95480642896,-19,953,1126,0
95481453550,95481453552,2,1005,1536,0
95483257906,95483257907,1,1307,1692,0
95483702434,95483702437,3,1347,1097,0
95485618282,95485618281,-1,1169,1278,0
95487337093,95487337094,1,1091,1530,0
95489428574,95489428579,5,1958,1536,0
95489660242,95489660242,0,1300,1572,0
95490096038,95490096038,0,1277,1775,0
95490159752,95490159753,1,1757,2453,0
95490271295,95490271293,-2,1349,2380,0
95490542494,95490542496,2,1301,2133,0
95491326764,95491326764,0,1643,1728,0
95493215322,95493215329,7,1647,906,0
95494983090,95494983091,1,1248,1193,0
95497903462,95497903465,3,1531,1171,0
95501415525,95501415526,1,1037,1736,0
95503607691,95503607689,-2,1235,1336,0
95507494834,95507494834,0,1420,1391,0
95508546053,95508546053,0,1103,1801,0
95511354746,95511354746,0,1670,1373,0
95515202113,95515202113,0,1274,1155,0
95515834669,95515834668,-1,1327,1556,0
95520168108,95520168108,0,1040,1453,0
95521223910,95521223914,4,1566,1307,0
95523982673,95523982675,2,2232,1674,0
95524666819,95524666820,1,1074,1058,0
95526877445,95526877446,1,1059,1763,0
95531457607,95531457606,-1,1256,2138,0
95531537690,95531537690,0,1286,1998,0
95532020193,95532020192,-1,1384,2291,0
95533461880,95533461882,2,1748,1105,0
95533601975,95533601980,5,2686,1688,0
95539066414,95539066420,6,1660,1490,0
95541230838,95541230837,-1,1470,1938,0
95547090397,95547090406,9,2571,1125,0
95547799362,95547799363,1,1328,1520,0
95548989982,95548989978,-4,2831,4896,0
95551782398,95551782398,0,1829,2071,0
95551841427,95551841429,2,1366,1751,0
95553629217,95553629218,1,1179,1633,0
95555192749,95555192749,0,1410,2356,0
95557346923,95557346926,3,2047,2154,0
95562381144,95562381164,20,1246,1597,0
95566538881,95566538883,2,1288,1684,0
95573775381,95573775381,0,1311,2309,0
95573949473,95573949473,0,1287,1345,0
95574712331,95574712330,-1,1435,2298,0
95577208622,95577208622,0,1349,1387,0
95579301770,95579301768,-2,1203,1167,0
95582779533,95582779534,1,1390,1858,0
95583244514,95583244516,2,1117,1635,0
95585527445,95585527445,0,1218,1638,0
95590895166,95590895151,-15,412,1279,0
95593222738,95593222737,-1,1299,2736,0
95593943348,95593943369,21,1220,1319,0
95594631676,95594631677,1,1809,2328,0
95594832281,95594832282,1,1105,1521,0
95594957822,95594957821,-1,1629,2028,0
95596405277,95596405277,0,1262,1614,0
95600936811,95600936811,0,1039,1323,0
95601993811,95601993813,2,844,1482,0
95603473945,95603473945,0,1381,1642,0
95604033798,95604033798,0,1509,2115,0
95605353211,95605353213,2,1480,1875,0
95608426761,95608426765,4,5604,4562,0
95614981414,95614981415,1,1345,1539,0
95617790011,95617790012,1,1245,1202,0
95618677377,95618677375,-2,1172,1454,0
95618966646,95618966627,-19,1286,1767,0
95619543566,95619543566,0,1569,1431,0
95621191962,95621191962,0,1575,1353,0
95623587731,95623587730,-1,1290,1591,0
95624736775,95624736754,-21,26,3239,0
95626522126,95626522127,1,1206,1617,0
95627370278,95627370280,2,1018,1688,0
95628647219,95628647218,-1,1276,1395,0
95630654430,95630654430,0,1638,1929,0
95633557991,95633557991,0,1459,1850,0
95633729110,95633729110,0,1451,1695,0
95635847637,95635847637,0,1344,2020,0
95639374245,95639374248,3,1685,1315,0
95640898538,95640898538,0,1356,1822,0
95641236081,95641236093,12,1152,1808,0
95641565822,95641565823,1,1097,1142,0
95642624302,95642624303,1,1934,1203,0
95645306140,95645306141,1,1588,1747,0
95647161783,95647161782,-1,1453,1940,0
95648923198,95648923196,-2,1446,2091,0
95653090439,95653090439,0,1219,1197,0
95654211411,95654211413,2,1647,2042,0
95654332689,95654332691,2,1511,1445,0
95655460202,95655460202,0,1182,2030,0
95658574457,95658574458,1,1547,1729,0
95661970266,95661970266,0,795,1474,0
95664222875,95664222875,0,1612,2379,0
95668341951,95668341949,-2,976,1125,0
95671504946,95671504944,-2,1112,1512,0
95672664876,95672664878,2,1069,1787,0
95673400050,95673400055,5,2841,1499,0
95677021237,95677021237,0,1384,1746,0
95678676072,95678676073,1,2174,1435,0
95679633061,95679633065,4,1475,1950,0
95679752581,95679752582,1,1552,1685,0
95681344955,95681344955,0,904,1424,0
95681555394,95681555391,-3,1385,1725,0
95683837042,95683837040,-2,1279,1676,0
95688674178,95688674179,1,1552,1975,0
95691862458,95691862457,-1,1301,1752,0
95694492125,95694492130,5,4107,2527,0
95694985122,95694985122,0,1147,1271,0
95700204590,95700204588,-2,1045,2851,0
95705962780,95705962779,-1,1187,1354,0
95706989141,95706989141,0,1476,1696,0
95707319197,95707319198,1,1027,1296,0
95710586498,95710586499,1,1342,1299,0
95711037445,95711037445,0,1362,2175,0
95712871258,95712871261,3,1532,1491,0
95718141870,95718141889,19,1325,1120,0
95721722880,95721722882,2,1119,833,0
95722033913,95722033914,1,1152,1546,0
95724850574,95724850570,-4,880,1637,0
95725839420,95725839421,1,1761,2018,0
95735969414,95735969416,2,1127,1602,0
95740307126,95740307126,0,1192,1673,0
95745429679,95745429681,2,1124,1615,0
95746753421,95746753422,1,1657,2191,0
95747387795,95747387797,2,1253,1377,0
95748304942,95748304942,0,1198,1616,0
95748486990,95748486989,-1,1842,1849,0
95749419738,95749419737,-1,1358,2270,0
95749997703,95749997703,0,1219,1635,0
95750493669,95750493669,0,1335,1756,0
95753579294,95753579294,0,929,1538,0
95754020342,95754020342,0,1163,1696,0
95754151071,95754151048,-23,1332,1546,0
95761008094,95761008094,0,1769,1986,0
95763436070,95763436071,1,1955,1542,0
95763904755,95763904754,-1,1542,1455,0
95764823690,95764823690,0,1456,1765,0
95772262150,95772262150,0,1330,1452,0
95774524274,95774524275,1,686,956,0
95775380165,95775380166,1,1414,2161,0
95776133083,95776133082,-1,1463,1601,0
95776348481,95776348488,7,2579,1590,0
95776412893,95776412890,-3,1338,1631,0
95780465454,95780465455,1,1732,1907,0
95781460653,95781460655,2,1667,1081,0
95785399067,95785399067,0,1505,1608,0
95786929778,95786929773,-5,1191,4441,0
95791992684,95791992685,1,1502,2085,0
95792346480,95792346477,-3,1438,1430,0
95792631835,95792631836,1,1391,1462,0
95792910461,95792910459,-2,1214,1048,0
95794401030,95794401030,0,1095,1168,0
95797278105,95797278105,0,1119,1517,0
95798703405,95798703400,-5,9883,41746,0
95799638283,95799638283,0,1757,2220,0
95799888813,95799888814,1,1244,1652,0
95800102495,95800102495,0,1109,1833,0
95801140695,95801140697,2,1588,1452,0
95805466939,95805466947,8,3853,1414,0
95808221897,95808221895,-2,1606,1398,0
95809256286,95809256287,1,1531,2465,0
95809787319,95809787311,-8,30418,11761,0
95810277535,95810277541,6,3525,1482,0
95814096053,95814096055,2,1528,2433,0
95819075291,95819075291,0,1772,1844,0
95820033467,95820033466,-1,1274,1574,0
95820490927,95820490929,2,1736,1631,0
95821783459,95821783461,2,1231,1760,0
95821874115,95821874116,1,1477,1614,0
95823078410,95823078405,-5,1996,4930,0
95824337670,95824337671,1,1033,1414,0
95828485578,95828485579,1,1214,1541,0
95828759281,95828759292,11,1480,1388,0
95830252107,95830252109,2,1366,1893,0
95830742694,95830742694,0,1025,2038,0
95831168522,95831168523,1,1090,1654,0
95831313063,95831313062,-1,1067,1921,0
95831561887,95831561890,3,1147,1051,0
95831709234,95831709234,0,910,1414,0
95832393214,95832393216,2,1134,1859,0
95832449554,95832449556,2,1245,1540,0
95834032389,95834032391,2,1315,1341,0
95840256448,95840256449,1,1546,1552,0
95843204990,95843204992,2,680,1070,0
95847018628,95847018628,0,985,1178,0
95849677046,95849677045,-1,1494,2056,0
95851293186,95851293186,0,2210,2106,0
95857718026,95857718027,1,1092,1705,0
95858782819,95858782818,-1,1331,899,0
95859420573,95859420579,6,6086,1648,0
95860544473,95860544475,2,976,1201,0
95861832851,95861832850,-1,1403,1938,0
95864516229,95864516230,1,1122,1573,0
95869379907,95869379907,0,1429,1599,0
95873945654,95873945655,1,1430,2328,0
95881452345,95881452351,6,3342,1339,0
95884346951,95884346957,6,1824,992,0
95885390745,95885390744,-1,1432,1702,0
95891454973,95891454970,-3,1321,1336,0
95897916461,95897916461,0,1063,1238,0
95903018818,95903018819,1,1433,1894,0
95905708571,95905708570,-1,1406,1647,0
95905790010,95905790008,-2,1713,1795,0
95911157982,95911157982,0,950,1494,0
95911420794,95911420794,0,1769,1818,0
95915840376,95915840377,1,1086,1962,0
95917980985,95917980987,2,2142,2337,0
95925965901,95925965901,0,2227,2142,0
95931276070,95931276074,4,1598,1626,0
95931548362,95931548362,0,1120,1199,0
95933901824,95933901822,-2,1287,2006,0
95934443399,95934443401,2,1230,1299,0
95938109037,95938109038,1,1688,1874,0
95946347282,95946347283,1,857,1083,0
95947693342,95947693342,0,1551,1754,0
95949297797,95949297798,1,936,1415,0
95951168345,95951168341,-4,983,1673,0
95954963833,95954963834,1,1317,2166,0
95956023702,95956023718,16,1942,1074,0
95960160551,95960160551,0,1035,1656,0
95961861270,95961861291,21,1294,1669,0
95964260933,95964260930,-3,1309,1739,0
95964890371,95964890370,-1,863,1662,0
95965047507,95965047508,1,1138,2164,0
95966046153,95966046155,2,1186,1392,0
95967501171,95967501170,-1,1121,1579,0
95968612427,95968612426,-1,924,1116,0
95970559031,95970559033,2,1286,1688,0
95971616756,95971616768,12,12431,38108,0
95974188150,95974188150,0,1164,1012,0
95976132593,95976132596,3,4775,24219,0
95985653030,95985653030,0,1239,1862,0
95986379624,95986379622,-2,1704,1441,0
95987312215,95987312217,2,1922,2319,0
95987447873,95987447875,2,1398,1479,0
95991334042,95991334043,1,1551,1315,0
95991405519,95991405513,-6,832,4637,0
95991755918,95991755920,2,1798,1577,0
95992616920,95992616921,1,1115,1814,0
95993839606,95993839609,3,1083,1339,0
95994997491,95994997490,-1,1105,1391,0
95996966554,95996966554,0,1028,1439,0
95997295093,95997295098,5,1232,1480,0
96000692305,96000692305,0,1083,1972,0
96001308563,96001308567,4,1794,1599,0
96002781012,96002781019,7,2509,1500,0
96004046284,96004046284,0,1139,1625,0
96006640593,96006640593,0,1007,1035,0
96008924858,96008924860,2,1071,1718,0
96009351467,96009351470,3,1199,1803,0
96010981235,96010981237,2,1314,1862,0
96011630620,96011630619,-1,1072,1287,0
96011877073,96011877074,1,1281,1568,0
96014001087,96014001086,-1,1548,2639,0
96016075437,96016075435,-2,1526,1413,0
96019100461,96019100458,-3,1742,1477,0
96019535946,96019535945,-1,1243,1379,0
96021822138,96021822136,-2,52746,30551,0
96023950708,96023950709,1,1583,1461,0
96025372293,96025372294,1,2316,1885,0
96026052294,96026052295,1,1561,1526,0
96027227316,96027227315,-1,1314,1813,0
96032352423,96032352424,1,1182,1889,0
96033381477,96033381478,1,1691,1103,0
96036309841,96036309842,1,1432,1963,0
96042758793,96042758794,1,1550,2252,0
96046480890,96046480894,4,1766,1992,0
96047406137,96047406134,-3,1980,2206,0
96048238483,96048238482,-1,1231,2580,0
96051917097,96051917097,0,1145,1130,0
96055190036,96055190037,1,1346,1479,0
96057983887,96057983886,-1,1405,1307,0
96059978485,96059978484,-1,1775,2983,0
96061412017,96061412017,0,1506,1837,0
96061572051,96061572052,1,1325,1551,0
96065264198,96065264202,4,1513,1284,0
96067233643,96067233643,0,1589,1770,0
96068665661,96068665663,2,1346,1745,0
96069403948,96069403946,-2,1977,1888,0
96073513455,96073513458,3,1673,1455,0
96074545393,96074545397,4,1518,1171,0
96074864866,96074864866,0,1509,2803,0
96079994275,96079994275,0,1088,1373,0
96081506199,96081506200,1,1398,1670,0
96086308086,96086308086,0,1231,1344,0
96087587603,96087587606,3,2452,2259,0
96091912230,96091912230,0,2116,2177,0
96092454083,96092454083,0,1037,1196,0
96093126966,96093126965,-1,1395,1853,0
96097990178,96097990181,3,585,913,0
96099624114,96099624113,-1,1762,2650,0
96100352572,96100352569,-3,1172,1380,0
96101489937,96101489936,-1,1533,2078,0
96104154859,96104154859,0,1424,1649,0
96104899242,96104899243,1,1568,1960,0
96105813099,96105813101,2,1445,1921,0
96106245991,96106245991,0,1271,1657,0
96110650569,96110650569,0,1254,1582,0
96111104142,96111104133,-9,24220,15415,0
96111355312,96111355312,0,1379,1929,0
96112183255,96112183254,-1,1146,2212,0
96114828967,96114828962,-5,1189,2449,0
96114869807,96114869814,7,2116,1034,0
96116798400,96116798402,2,1823,1785,0
96116973286,96116973285,-1,1598,2399,0
96120092390,96120092390,0,1535,1688,0
96120836894,96120836885,-9,1504,4397,0
96126537434,96126537435,1,1615,1757,0
96128232010,96128232011,1,1587,1337,0
96128795251,96128795252,1,1533,1839,0
96129217296,96129217298,2,1742,1117,0
96135022646,96135022646,0,1068,1739,0
96136935424,96136935421,-3,38373,25812,0
96144948882,96144948889,7,3892,1521,0
96145921705,96145921703,-2,1424,1411,0
96148096222,96148096223,1,1830,1471,0
96148238379,96148238379,0,1685,2190,0
96148360614,96148360614,0,2000,1531,0
96150123222,96150123223,1,1099,1565,0
96151616630,96151616630,0,1138,1673,0
96153177877,96153177878,1,1379,1527,0
96153284826,96153284827,1,1321,1278,0
96155429286,96155429286,0,1065,1304,0
96156732354,96156732356,2,1671,1707,0
96158660893,96158660893,0,1655,1763,0
96158876080,96158876077,-3,1459,3482,0
96160513019,96160513023,4,1012,742,0
96163029929,96163029927,-2,1748,2024,0
96164361215,96164361215,0,1045,1550,0
96167228134,96167228135,1,1314,1623,0
96172198375,96172198376,1,1150,1282,0
96173767611,96173767612,1,1794,2104,0
96174679217,96174679219,2,1305,2186,0
96175982593,96175982594,1,1172,1155,0
96179212991,96179212994,3,1674,2108,0
96179325989,96179325990,1,1387,1720,0
96180760855,96180760860,5,1938,1266,0
96182516234,96182516235,1,1063,998,0
96183418655,96183418655,0,581,597,0
96184615678,96184615679,1,789,2001,0
96185606042,96185606034,-8,1289,4931,0
96189203842,96189203842,0,1202,1774,0
96195049149,96195049150,1,1560,1490,0
96197815620,96197815621,1,1377,1888,0
96198366644,96198366646,2,1580,1958,0
96204009613,96204009613,0,1275,1695,0
96205582944,96205582945,1,2108,1897,0
96205923863,96205923864,1,1308,1866,0
96207576144,96207576142,-2,1568,1538,0
96210552083,96210552084,1,1366,1817,0
96212556517,96212556538,21,1425,1459,0
96215256311,96215256311,0,1496,1938,0
96215451635,96215451634,-1,990,1579,0
96223661125,96223661123,-2,1316,2100,0
96225967438,96225967439,1,1386,1684,0
96229207296,96229207294,-2,827,894,0
96233882270,96233882272,2,1578,1431,0
96235817212,96235817214,2,1745,1808,0
96237878909,96237878911,2,1283,812,0
96242621167,96242621167,0,1322,1520,0
96243330525,96243330523,-2,1252,1591,0
96245225381,96245225384,3,1710,1563,0
96246277762,96246277763,1,869,1627,0
96250785699,96250785699,0,1271,1491,0
96253251374,96253251374,0,2043,2171,0
96254189199,96254189198,-1,1482,2110,0
96255930399,96255930399,0,1578,1991,0
96260316223,96260316217,-6,928,2594,0
96265823826,96265823828,2,1433,1630,0
96265920244,96265920246,2,2349,2014,0
96269417623,96269417624,1,1757,1943,0
96272571265,96272571266,1,1505,1708,0
96275364148,96275364148,0,1027,1557,0
96277916703,96277916704,1,1334,1891,0
96278429857,96278429858,1,1192,1679,0
96280920555,96280920555,0,1437,1498,0
96283361220,96283361222,2,1592,2003,0
96284160338,96284160338,0,1542,1519,0
96290666561,96290666562,1,1568,1959,0
96291183255,96291183255,0,1173,1218,0
96292491365,96292491369,4,1570,1911,0
96294205907,96294205908,1,1031,1256,0
96296113362,96296113362,0,1392,1419,0
96298928307,96298928306,-1,1590,1896,0
96302342238,96302342238,0,1454,1489,0
96306548939,96306548934,-5,1979,5796,0
96308582961,96308582960,-1,1472,1177,0
96309700027,96309700023,-4,1356,2516,0
96312146122,96312146125,3,2301,1458,0
96315832270,96315832270,0,1856,1580,0
96317733921,96317733922,1,14561,17509,0
96320128639,96320128640,1,1083,1734,0
96322292913,96322292914,1,1919,1908,0
96323504430,96323504431,1,1229,940,0
96324383922,96324383923,1,1180,1784,0
96325462842,96325462841,-1,1331,2266,0
96326941742,96326941744,2,1711,1479,0
96327979615,96327979618,3,1476,1851,0
96328817898,96328817898,0,1081,1693,0
96331859686,96331859690,4,1343,1636,0
96332857414,96332857397,-17,1121,2231,0
96333005471,96333005462,-9,1608,1927,0
96336479554,96336479557,3,1525,1281,0
96337078945,96337078946,1,1810,1480,0
96338546779,96338546781,2,1793,1520,0
96338581357,96338581357,0,1321,1621,0
96339172273,96339172274,1,1210,1617,0
96339644095,96339644096,1,1260,1590,0
96340750862,96340750863,1,1826,2004,0
96341410962,96341410965,3,3139,2588,0
96341628644,96341628645,1,1303,2037,0
96342159567,96342159567,0,1288,2421,0
96346112912,96346112913,1,1502,1815,0
96349244297,96349244297,0,798,1559,0
96349775821,96349775822,1,1813,1663,0
96351085714,96351085715,1,1500,1684,0
96352267791,96352267790,-1,1252,1590,0
96352597058,96352597059,1,1211,1435,0
96354678157,96354678157,0,1501,1882,0
96355608107,96355608106,-1,1678,1804,0
96356533270,96356533269,-1,966,2208,0
96357607103,96357607102,-1,1461,1626,0
96360072491,96360072492,1,2245,2334,0
96361016739,96361016742,3,1598,1207,0
96361890701,96361890702,1,1940,1728,0
96362086922,96362086922,0,1484,1956,0
96364967873,96364967876,3,2423,1362,0
96365212038,96365212038,0,1266,1164,0
96365943909,96365943912,3,1214,1580,0
96366604618,96366604618,0,738,759,0
96369271489,96369271487,-2,1302,1951,0
96372610389,96372610390,1,1572,1167,0
96373325794,96373325793,-1,1360,1637,0
96379494586,96379494586,0,1398,2310,0
96380997903,96380997907,4,1097,1828,0
96382045643,96382045658,15,26623,12187,0
96383904434,96383904434,0,1248,1443,0
96389590134,96389590135,1,1640,2085,0
96392406082,96392406082,0,1139,1486,0
96395099117,96395099116,-1,1244,1665,0
96395512533,96395512531,-2,1606,3269,0
96395919429,96395919431,2,1345,1782,0
96397385730,96397385731,1,1162,1758,0
96399788819,96399788818,-1,1602,1645,0
96404826832,96404826831,-1,1133,2017,0
96404954112,96404954113,1,1116,1697,0
96405321063,96405321063,0,1025,1661,0
96406577409,96406577411,2,1230,1162,0
96408601396,96408601397,1,1755,1733,0
96409834826,96409834827,1,1935,2554,0
96411521506,96411521507,1,3293,13939,0
96412180146,96412180148,2,1311,2584,0
96415106922,96415106921,-1,895,1590,0
96417251362,96417251365,3,856,858,0
96417790131,96417790132,1,1495,1686,0
96418323716,96418323715,-1,1280,2169,0
96420248390,96420248390,0,1147,1623,0
96420411598,96420411600,2,1456,2406,0
96420564770,96420564769,-1,1238,2131,0
96422025141,96422025141,0,1369,1346,0
96423150193,96423150195,2,1280,1336,0
96425468023,96425468023,0,1092,1413,0
96435722330,96435722330,0,1063,1100,0
96440176155,96440176152,-3,1202,2631,0
96444712404,96444712404,0,1141,1700,0
96445979173,96445979173,0,1108,1729,0
96446776419,96446776419,0,2053,1845,0
96446883494,96446883492,-2,1415,2096,0
96448034771,96448034771,0,741,757,0
96451539004,96451539002,-2,807,1809,0
96451808854,96451808854,0,1923,2347,0
96454115726,96454115726,0,1728,1631,0
96455227902,96455227906,4,1896,30771,0
96456690579,96456690581,2,916,1217,0
96458688205,96458688202,-3,2942,4773,0
96464442699,96464442699,0,1251,1189,0
96465016135,96465016134,-1,1824,2781,0
96470138625,96470138627,2,1099,1475,0
96473966463,96473966463,0,1455,1256,0
96476790005,96476790006,1,1585,1850,0
96478986269,96478986270,1,1446,1710,0
96479706774,96479706774,0,1181,1073,0
96480706591,96480706593,2,1642,1232,0
96485263314,96485263315,1,1475,2052,0
96486616156,96486616157,1,1611,2081,0
96487166764,96487166763,-1,1288,1356,0
96487805720,96487805730,10,333,1047,0
96488438843,96488438842,-1,2882,4748,0
96489069405,96489069405,0,1458,1554,0
96489351335,96489351339,4,1166,1533,0
96490647503,96490647504,1,1208,1919,0
96490760825,96490760825,0,1125,1745,0
96494885930,96494885930,0,1554,1468,0
96495809951,96495809951,0,1801,2230,0
96496720937,96496720938,1,1401,1712,0
96499543423,96499543420,-3,2712,6455,0
96500104353,96500104354,1,1587,2476,0
96502466955,96502466954,-1,1444,1017,0
96508145793,96508145791,-2,1074,1996,0
96514175083,96514175078,-5,1383,4492,0
96515075967,96515075968,1,1530,1884,0
96519350747,96519350746,-1,1329,1517,0
96521024038,96521024040,2,1434,2092,0
96522638865,96522638870,5,2531,1301,0
96523227267,96523227276,9,1297,1124,0
96523716729,96523716726,-3,1126,1458,0
96526552619,96526552619,0,1078,1217,0
96526925938,96526925938,0,803,1497,0
96527047205,96527047207,2,1376,1588,0
96531722664,96531722666,2,1115,1197,0
96535490007,96535490022,15,245,1206,0
96539983282,96539983279,-3,1283,1463,0
96540297799,96540297798,-1,1323,1766,0
96540768039,96540768037,-2,1382,1981,0
96543707251,96543707249,-2,927,1288,0
96544093522,96544093521,-1,1303,2229,0
96547029638,96547029638,0,1378,1444,0
96549746866,96549746865,-1,1240,1857,0
96554282969,96554282970,1,1496,1766,0
96554679657,96554679658,1,1463,1776,0
96559900590,96559900591,1,1235,1654,0
96560870752,96560870754,2,1693,1728,0
96566933503,96566933502,-1,1494,1582,0
96567237780,96567237773,-7,1485,1827,0
96567995806,96567995806,0,1302,1579,0
96568628584,96568628596,12,1526,1626,0
96571382887,96571382887,0,554,576,0
96572847303,96572847304,1,1591,1521,0
96578944015,96578944018,3,847,1145,0
96579302698,96579302701,3,1438,1819,0
96581871327,96581871328,1,1892,1608,0
96582304271,96582304271,0,1292,2001,0
96584209111,96584209113,2,1806,1614,0
96585777293,96585777295,2,1880,1447,0
96586632610,96586632613,3,1507,1638,0
96589351230,96589351233,3,827,958,0
96592811938,96592811943,5,2075,1925,0
96596206406,96596206406,0,1854,1907,0
96597949048,96597949049,1,876,1517,0
96598040957,96598040955,-2,1312,1256,0
96600190705,96600190686,-19,1197,1772,0
96600352716,96600352716,0,1989,2461,0
96600579255,96600579254,-1,1333,1772,0
96601119630,96601119631,1,1532,1686,0
96603462623,96603462623,0,1295,1846,0
96603688395,96603688397,2,813,1047,0
96606308986,96606308987,1,1747,1681,0
96610393078,96610393079,1,1250,2010,0
96614356915,96614356914,-1,1754,1981,0
96614471666,96614471667,1,1136,1179,0
96615879607,96615879610,3,1200,1676,0
96616225654,96616225658,4,1311,1576,0
96620555488,96620555491,3,1793,1647,0
96627844885,96627844885,0,1404,1795,0
96630674603,96630674606,3,1400,1110,0
96631622531,96631622534,3,944,1106,0
96637267684,96637267685,1,1100,1602,0
96637320862,96637320864,2,1642,1766,0
96638082425,96638082426,1,1694,1869,0
96638952515,96638952521,6,5346,3052,0
96639169593,96639169590,-3,1632,2464,0
96639781781,96639781781,0,1014,1532,0
96643244751,96643244750,-1,1037,974,0
96644433777,96644433778,1,1662,1585,0
96647465750,96647465751,1,1439,1394,0
96647497574,96647497573,-1,2053,2346,0
96650748054,96650748054,0,1037,2080,0
96652088258,96652088258,0,2085,1742,0
96652382762,96652382765,3,1203,1479,0
96654874755,96654874755,0,1904,2037,0
96655845183,96655845183,0,1373,1745,0
96659040914,96659040914,0,951,1952,0
96662009799,96662009799,0,904,907,0
96663254742,96663254734,-8,1974,9668,0
96674466967,96674466968,1,921,1665,0
96677758089,96677758089,0,1328,1757,0
96683050964,96683050972,8,3593,1191,0
96684655289,96684655290,1,1673,1967,0
96685595806,96685595805,-1,1719,1821,0
96686977438,96686977439,1,1450,1480,0
96688453631,96688453631,0,3478,4309,0
96693163099,96693163104,5,1746,1179,0
96694213142,96694213142,0,1037,1504,0
96700459270,96700459271,1,1325,1599,0
96702404618,96702404618,0,1308,1273,0
96702511197,96702511198,1,1119,1022,0
96703767566,96703767566,0,1009,1471,0
96705359046,96705359047,1,1373,1493,0
96710240621,96710240625,4,3295,2551,0
96710794843,96710794844,1,1894,2436,0
96712077545,96712077546,1,1018,1353,0
96714663823,96714663825,2,1092,1525,0
96716418486,96716418488,2,1339,1733,0
96716805502,96716805507,5,1337,1091,0
96718169584,96718169590,6,4116,1775,0
96720987580,96720987576,-4,22361,13701,0
96721885847,96721885848,1,1968,2114,0
96722792708,96722792708,0,2448,2501,0
96727588514,96727588517,3,1838,1706,0
96730147485,96730147486,1,1935,2122,0
96731203858,96731203858,0,2369,2534,0
96732946019,96732946021,2,1569,1487,0
96733125817,96733125817,0,1318,2138,0
96734358623,96734358613,-10,1603,1694,0
96738410967,96738410954,-13,1679,2555,0
96746773362,96746773365,3,2153,1643,0
96747513157,96747513158,1,557,729,0
96747841886,96747841894,8,20140,14071,0
96748383726,96748383726,0,1112,1903,0
96749754070,96749754072,2,1479,1634,0
96750002027,96750002026,-1,1527,1863,0
96752804249,96752804249,0,1444,1768,0
96758887538,96758887541,3,1166,1324,0
96761706973,96761706970,-3,1178,1660,0
96763227365,96763227366,1,1883,2249,0
96765488881,96765488879,-2,1369,2068,0
96769711749,96769711750,1,1597,1683,0
96773177064,96773177066,2,1039,809,0
96774815431,96774815433,2,971,1472,0
96776329508,96776329506,-2,1762,2011,0
96777430346,96777430346,0,1430,2116,0
96777854170,96777854166,-4,1807,4415,0
96778012029,96778012030,1,1033,2315,0
96781408130,96781408132,2,1989,1873,0
96782321602,96782321605,3,1362,1666,0
96785407873,96785407879,6,2495,1270,0
96787393771,96787393771,0,896,1505,0
96789588222,96789588221,-1,1203,1998,0
96790556038,96790556040,2,972,1850,0
96790688302,96790688292,-10,1144,1470,0
96792041354,96792041355,1,990,1576,0
96792536910,96792536910,0,1911,1363,0
96793545396,96793545399,3,1755,2010,0
96795638781,96795638781,0,927,1185,0
96798264194,96798264194,0,1340,2176,0
96798434845,96798434851,6,2975,1311,0
96801078876,96801078876,0,1344,1724,0
96805654946,96805654947,1,946,1481,0
96806784685,96806784685,0,1840,1373,0
96807341361,96807341360,-1,1509,2324,0
96808761157,96808761159,2,1423,1330,0
96809721569,96809721568,-1,1356,2091,0
96815460510,96815460507,-3,743,1414,0
96818697637,96818697639,2,1758,1802,0
96822441817,96822441819,2,9583,8112,0
96824172022,96824172023,1,1258,1616,0
96825701632,96825701637,5,2348,1306,0
96827254560,96827254542,-18,1272,1613,0
96831744994,96831744994,0,1274,1357,0
96833455755,96833455755,0,1774,1549,0
96834151178,96834151180,2,1190,1470,0
96835036694,96835036693,-1,1221,1817,0
96835923074,96835923074,0,1809,1985,0
96837328059,96837328063,4,3187,1916,0
96840700450,96840700447,-3,1275,1874,0
96842178274,96842178273,-1,1220,1755,0
96844294692,96844294694,2,1605,1621,0
96844487701,96844487702,1,1090,1384,0
96846483702,96846483703,1,1063,1233,0
96849326925,96849326925,0,871,1917,0
96851625194,96851625193,-1,1309,1880,0
96855235382,96855235383,1,983,1270,0
96859357151,96859357152,1,1618,1896,0
96861373057,96861373057,0,1683,2164,0
96866070471,96866070472,1,1615,2399,0
96868313147,96868313147,0,798,1004,0
96870383426,96870383425,-1,853,1360,0
96870423411,96870423410,-1,936,1958,0
96870928699,96870928701,2,965,1322,0
96877637147,96877637146,-1,1226,1287,0
96878098314,96878098311,-3,1091,2156,0
96878952086,96878952086,0,1447,2323,0
96880932698,96880932699,1,1001,641,0
96884257078,96884257081,3,1306,1530,0
96897053291,96897053288,-3,631,2007,0
96900958832,96900958827,-5,1181,1608,0
96906089029,96906089030,1,1588,1586,0
96908927627,96908927630,3,1896,1260,0
96909428678,96909428677,-1,1240,1682,0
96909844078,96909844080,2,1373,2420,0
96912138483,96912138482,-1,1108,1802,0
96913477114,96913477123,9,19007,52024,0
96917691222,96917691223,1,1264,1717,0
96924613490,96924613498,8,1423,1348,0
96924877658,96924877659,1,1499,1334,0
96925160739,96925160740,1,1546,1735,0
96926092451,96926092451,0,1460,1481,0
96926702157,96926702157,0,1239,1923,0
96928183639,96928183639,0,1219,1339,0
96929465510,96929465510,0,1397,2143,0
96931173206,96931173209,3,1057,1284,0
96931778203,96931778207,4,1267,1145,0
96932254528,96932254530,2,835,1969,0
96933526340,96933526338,-2,1581,2414,0
96936544076,96936544072,-4,1332,2012,0
96939036617,96939036619,2,1475,1564,0
96939157783,96939157783,0,1712,1640,0
96939227899,96939227899,0,1280,1163,0
96940660578,96940660579,1,1784,1667,0
96941324917,96941324911,-6,3002,11748,0
96943120650,96943120650,0,1550,1482,0
96945125261,96945125261,0,1604,1855,0
96945229174,96945229175,1,791,1338,0
96946479559,96946479560,1,869,1379,0
96958872429,96958872447,18,1340,1562,0
96959074234,96959074212,-22,1128,1601,0
96961500419,96961500420,1,1306,1728,0
96962417962,96962417963,1,1433,1715,0
96963617064,96963617063,-1,1444,2205,0
96963911957,96963911959,2,969,1286,0
96964486927,96964486927,0,1887,2214,0
96967083607,96967083606,-1,1262,1492,0
96967548084,96967548083,-1,963,1732,0
96967907115,96967907115,0,1516,1179,0
96970204202,96970204202,0,890,1326,0
96971077950,96971077950,0,895,2214,0
96972348311,96972348314,3,1256,1041,0
96984739860,96984739860,0,1504,1651,0
96987749434,96987749435,1,1660,1902,0
96987895418,96987895418,0,975,1129,0
96992149613,96992149612,-1,1529,1191,0
96993177843,96993177837,-6,1476,8217,0
96994003690,96994003691,1,815,1030,0
97000330343,97000330346,3,1740,1396,0
97003014742,97003014743,1,1109,1299,0
97006591564,97006591564,0,1117,1177,0
97006741101,97006741102,1,1400,1525,0
97007759154,97007759157,3,1716,1892,0
97008320639,97008320636,-3,1044,1665,0
97009646530,97009646531,1,1568,1159,0
97011739609,97011739611,2,1015,1755,0
97012075539,97012075538,-1,1158,1782,0
97012366631,97012366628,-3,1249,1935,0
97016185443,97016185443,0,1992,2074,0
97022798190,97022798189,-1,1627,2789,0
97026203350,97026203350,0,1403,1910,0
97027538179,97027538181,2,1004,1259,0
97028647784,97028647783,-1,1339,1881,0
97030084667,97030084667,0,1619,1677,0
97032073262,97032073263,1,1403,1665,0
97034729442,97034729440,-2,994,1375,0
97034998121,97034998121,0,1276,1392,0
97042900261,97042900261,0,1628,1682,0
97044078090,97044078091,1,1498,1692,0
97044139510,97044139509,-1,1458,1543,0
97045779542,97045779542,0,1349,1422,0
97047946206,97047946206,0,1602,1641,0
97048235454,97048235454,0,1281,1193,0
97048568633,97048568634,1,1500,1334,0
97050099045,97050099045,0,1100,1507,0
97050906622,97050906623,1,1424,1931,0
97051600385,97051600391,6,4708,33320,0
97054847375,97054847377,2,1484,1828,0
97058923595,97058923597,2,2275,1831,0
97059487074,97059487070,-4,1875,3675,0
97065766270,97065766267,-3,675,1085,0
97066826474,97066826469,-5,930,2705,0
97070664707,97070664708,1,1381,1687,0
97072664729,97072664729,0,1342,2029,0
97074141635,97074141635,0,1381,1586,0
97076455386,97076455384,-2,1237,1992,0
97081930792,97081930790,-2,1369,2339,0
97082199279,97082199258,-21,1067,2137,0
97082843826,97082843827,1,1504,1421,0
97083509992,97083509994,2,1604,2442,0
97087522558,97087522560,2,1153,1580,0
97092248853,97092248849,-4,1095,2181,0
97093263250,97093263251,1,1329,1182,0
97093796494,97093796494,0,1357,1722,0
97094259911,97094259911,0,1036,2239,0
97094949523,97094949523,0,1268,874,0
97098512954,97098512954,0,988,1011,0
97099246222,97099246224,2,717,1491,0
97100885118,97100885122,4,3950,3756,0
97103800941,97103800943,2,2056,2178,0
97106115137,97106115116,-21,2034,1295,0
97106864674,97106864674,0,1598,2054,0
97112003905,97112003908,3,1272,1307,0
97117026834,97117026834,0,1243,1445,0
97121835715,97121835715,0,1369,1440,0
97126257005,97126256999,-6,1134,1844,0
97127295815,97127295816,1,1488,1863,0
97131787224,97131787222,-2,1415,1912,0
97131842430,97131842431,1,1253,1608,0
97136358770,97136358762,-8,879,2324,0
97137855050,97137855050,0,1129,1358,0
97141964201,97141964202,1,1216,1258,0
97142704241,97142704236,-5,1590,4114,0
97143555243,97143555238,-5,1591,3299,0
97144205354,97144205354,0,2024,1367,0
97144708410,97144708411,1,46075,56356,0
97145532046,97145532046,0,1520,1856,0
97145984418,97145984418,0,1798,1748,0
97147000727,97147000732,5,8552,33361,0
97147882694,97147882691,-3,1357,1384,0
97149541146,97149541147,1,809,1207,0
97150370921,97150370922,1,1375,1285,0
97152146738,97152146738,0,1244,1698,0
97152298767,97152298769,2,2335,1756,0
97153676287,97153676286,-1,1988,1613,0
97158398379,97158398380,1,1653,1786,0
97160037189,97160037190,1,1033,1551,0
97164253277,97164253278,1,1419,1421,0
97167597375,97167597353,-22,895,1396,0
97172628987,97172628989,2,1457,1320,0
97180054336,97180054338,2,1106,1078,0
97181956912,97181956929,17,48,795,0
97190831077,97190831079,2,1160,1010,0
97191475003,97191475005,2,1565,2302,0
97193310911,97193310913,2,1642,1403,0
97195859370,97195859369,-1,1830,1650,0
97198490058,97198490059,1,1537,1574,0
97200072206,97200072203,-3,1151,1558,0
97201086053,97201086054,1,1517,1531,0
97201488457,97201488459,2,1147,2223,0
97203126014,97203126013,-1,960,1555,0
97205655511,97205655509,-2,1114,1720,0
97209293547,97209293549,2,1547,1328,0
97209348970,97209348970,0,1445,1470,0
97212406978,97212406980,2,1191,2197,0
97221363785,97221363789,4,1425,1014,0
97222283542,97222283542,0,1181,1652,0
97229547065,97229547063,-2,941,1484,0
97231028043,97231028024,-19,1020,1291,0
97232787653,97232787654,1,1524,1346,0
97237278750,97237278751,1,1247,1743,0
97249215657,97249215661,4,1667,1211,0
97253057053,97253057060,7,13223,26020,0
97253624915,97253624914,-1,1542,1238,0
97256581890,97256581891,1,1702,1949,0
97264320801,97264320803,2,1205,1277,0
97265560566,97265560582,16,1766,1969,0
97267064926,97267064927,1,1344,1397,0
97267835368,97267835367,-1,686,1648,0
97269808342,97269808342,0,1985,2147,0
97271052154,97271052154,0,1359,1291,0
97273137162,97273137162,0,1456,2772,0
97273608106,97273608105,-1,1269,2206,0
97274807724,97274807726,2,1945,1732,0
97274949453,97274949455,2,1843,2319,0
97276645234,97276645235,1,1748,1734,0
97277469089,97277469092,3,1319,1643,0
97280709150,97280709149,-1,1621,1829,0
97282761346,97282761344,-2,1131,2072,0
97284816004,97284816004,0,1402,1796,0
97288023109,97288023110,1,1132,1878,0
97288396147,97288396147,0,1354,2115,0
97292285480,97292285482,2,1303,1557,0
97292790406,97292790407,1,1142,1253,0
97293251331,97293251333,2,1939,2305,0
97295456263,97295456262,-1,1232,1527,0
97302137488,97302137489,1,1635,1693,0
97304499877,97304499877,0,993,1314,0
97305435973,97305435975,2,1460,1533,0
97306625818,97306625821,3,2318,1629,0
97307444119,97307444119,0,1413,1318,0
97317904966,97317904965,-1,884,1521,0
97318843635,97318843637,2,1372,1660,0
97319422154,97319422154,0,1706,2091,0
97322658279,97322658275,-4,1028,1870,0
97323021691,97323021692,1,1247,1308,0
97325361287,97325361285,-2,2191,3077,0
97326042086,97326042089,3,1291,1782,0
97326751152,97326751154,2,1687,2240,0
97333002715,97333002717,2,1202,1577,0
97335929613,97335929613,0,1471,2163,0
97339095632,97339095630,-2,1832,1799,0
97339702785,97339702786,1,1040,1551,0
97342270546,97342270546,0,1167,2019,0
97345965647,97345965647,0,1070,1948,0
97347353863,97347353861,-2,976,1429,0
97347790108,97347790126,18,461,663,0
97347876301,97347876304,3,1235,1475,0
97348474917,97348474918,1,1347,1626,0
97351034752,97351034774,22,898,1484,0
97355781210,97355781210,0,1548,1869,0
97362772793,97362772794,1,1455,1752,0
97363531956,97363531959,3,1710,1550,0
97364368633,97364368635,2,2378,2095,0
97365273649,97365273651,2,1427,2040,0
97375458190,97375458190,0,1548,1970,0
97375941030,97375941037,7,2229,1581,0
97377165857,97377165859,2,1727,1451,0
97377642168,97377642165,-3,1658,2220,0
97380588661,97380588661,0,1140,1751,0
97384012463,97384012460,-3,1032,1399,0
97390033652,97390033651,-1,1356,1580,0
97393227337,97393227337,0,1477,1458,0
97396099505,97396099505,0,1061,1563,0
97397863046,97397863044,-2,1057,1423,0
97402918562,97402918562,0,1286,1774,0
97406019572,97406019574,2,1588,1498,0
97411086664,97411086665,1,1310,1896,0
97414187687,97414187670,-17,1477,813,0
97414650594,97414650595,1,1500,2059,0
97417636254,97417636254,0,1404,2094,0
97422039018,97422039018,0,1373,1680,0
97423516989,97423516990,1,1578,1529,0
97423722246,97423722246,0,772,1228,0
97430108949,97430108947,-2,1279,1398,0
97431483410,97431483405,-5,1703,3645,0
97431627163,97431627166,3,1276,1518,0
97431754968,97431754968,0,1136,1416,0
97434770648,97434770647,-1,1618,1632,0
97437318153,97437318151,-2,1635,1811,0
97439301903,97439301902,-1,1024,1671,0
97441375085,97441375084,-1,1727,2043,0
97443262315,97443262311,-4,1467,2371,0
97444888412,97444888413,1,1785,1442,0
97446075010,97446075009,-1,1023,1935,0
97449128090,97449128088,-2,1632,2347,0
97456331974,97456331973,-1,1893,2311,0
97458678415,97458678415,0,2136,2170,0
97464407461,97464407460,-1,1682,2349,0
97468206853,97468206853,0,938,1391,0
97468378151,97468378151,0,1350,1956,0
97469299158,97469299176,18,1097,1380,0
97472953055,97472953054,-1,1428,1838,0
97473513890,97473513891,1,1001,1446,0
97474170974,97474170973,-1,1585,2170,0
97475113918,97475113919,1,1300,1337,0
97476301454,97476301455,1,1342,2157,0
97477400973,97477400966,-7,987,2430,0
97484374325,97484374324,-1,1403,1796,0
97485379470,97485379454,-16,1165,2134,0
97486195013,97486195014,1,1290,1167,0
97486905814,97486905818,4,988,750,0
97492837563,97492837553,-10,7125,15938,0
97495507406,97495507405,-1,1340,1822,0
97496594102,97496594102,0,1348,1762,0
97496935772,97496935771,-1,1472,1190,0
97497694666,97497694665,-1,1508,1921,0
97504539548,97504539550,2,1681,1472,0
97504678046,97504678046,0,1094,2316,0
97509383257,97509383258,1,1635,1622,0
97514290155,97514290155,0,708,975,0
97514375758,97514375758,0,990,1440,0
97516327239,97516327222,-17,1409,996,0
97519324295,97519324294,-1,1286,1608,0
97522282166,97522282171,5,8349,4600,0
97524421350,97524421351,1,1972,1713,0
97525417074,97525417071,-3,1531,1900,0
97525510522,97525510521,-1,1330,1864,0
97528881527,97528881528,1,1078,1561,0
97532595950,97532595950,0,1506,1850,0
97532662546,97532662541,-5,27532,14867,0
97533066618,97533066615,-3,1200,1984,0
97533166618,97533166617,-1,1504,2301,0
97533955058,97533955059,1,1380,1784,0
97534046402,97534046402,0,1720,2008,0
97534289458,97534289461,3,1019,1551,0
97539042530,97539042532,2,1142,1650,0
97543879015,97543879014,-1,1049,1374,0
97545142790,97545142790,0,1277,903,0
97553182577,97553182570,-7,2867,7912,0
97553421887,97553421888,1,1267,1563,0
97556491098,97556491090,-8,1624,8311,0
97557649410,97557649409,-1,1030,1112,0
97558127921,97558127922,1,1612,2431,0
97561563073,97561563074,1,1463,1511,0
97563892057,97563892058,1,1446,1491,0
97563929935,97563929934,-1,1209,1239,0
97564661369,97564661369,0,1632,2102,0
97567223360,97567223361,1,1228,1514,0
97570364029,97570364028,-1,1407,1648,0
97575037433,97575037433,0,931,1471,0
97575185878,97575185879,1,1350,1162,0
97575480438,97575480438,0,1601,1905,0
97575651300,97575651301,1,1910,2598,0
97579058006,97579058004,-2,1368,1929,0
97580630775,97580630775,0,1202,1772,0
97582179135,97582179135,0,149,1329,0
97584088130,97584088130,0,973,1678,0
97589126058,97589126059,1,1725,2137,0
97592589385,97592589386,1,883,1824,0
97598047619,97598047619,0,1246,1126,0
97603038409,97603038409,0,1647,1798,0
97606375874,97606375875,1,1371,1742,0
97606632882,97606632884,2,1154,1634,0
97606827743,97606827744,1,1375,1138,0
97607392930,97607392929,-1,1247,1692,0
97610592260,97610592257,-3,1421,1892,0
97615350598,97615350598,0,1084,1930,0
97616442964,97616442966,2,1051,1435,0
97616527783,97616527782,-1,1175,1423,0
97617388865,97617388864,-1,1240,1857,0
97617489319,97617489319,0,1460,1123,0
97619448352,97619448351,-1,1367,1604,0
97619765730,97619765730,0,1626,1662,0
97620701370,97620701372,2,1339,1821,0
97621860987,97621860986,-1,1776,1847,0
97622879599,97622879599,0,1074,1494,0
97625973218,97625973198,-20,1427,2182,0
97627132826,97627132826,0,1121,1626,0
97628552378,97628552380,2,1287,1697,0
97629375386,97629375387,1,1585,1718,0
97633226893,97633226893,0,1140,1369,0
97634406700,97634406704,4,1715,1543,0
97637643359,97637643361,2,2524,1673,0
97639779995,97639779997,2,1218,1290,0
97648032167,97648032165,-2,827,1887,0
97648174222,97648174242,20,683,1406,0
97652302738,97652302739,1,1493,1516,0
97652622615,97652622613,-2,1364,1692,0
97655151116,97655151112,-4,1713,4915,0
97655747623,97655747605,-18,1385,2904,0
97658480196,97658480187,-9,1418,7951,0
97660906263,97660906263,0,1994,2230,0
97663443280,97663443282,2,1515,1668,0
97664909735,97664909737,2,1151,1251,0
97667450543,97667450543,0,1855,2084,0
97667576554,97667576555,1,1115,1134,0
97669340019,97669340018,-1,1229,2168,0
97673907049,97673907051,2,1904,2510,0
97674153885,97674153872,-13,1201,1866,0
97675996751,97675996749,-2,1320,2452,0
97678425747,97678425746,-1,1415,1881,0
97678710010,97678710009,-1,1192,1423,0
97682558029,97682558030,1,1154,1813,0
97684480013,97684480014,1,932,1129,0
97685460521,97685460520,-1,1562,2112,0
97687689126,97687689126,0,1528,2163,0
97688176821,97688176818,-3,1092,2217,0
97689397242,97689397243,1,3126,3481,0
97689738579,97689738580,1,1168,1391,0
97690937906,97690937907,1,29122,19018,0
97693720028,97693720030,2,1777,1736,0
97694335318,97694335316,-2,1138,2366,0
97697973359,97697973359,0,1187,1882,0
97698077823,97698077825,2,1490,1473,0
97698675321,97698675322,1,1495,2032,0
97700271739,97700271741,2,1123,1533,0
97701704235,97701704237,2,811,897,0
97704910916,97704910919,3,1885,1828,0
97705738404,97705738406,2,1568,1852,0
97706052063,97706052063,0,1749,1459,0
97706897277,97706897281,4,1288,1541,0
97711714378,97711714378,0,1365,1632,0
97712304827,97712304829,2,1788,1509,0
97714005805,97714005806,1,1138,1497,0
97716270011,97716270011,0,1078,1422,0
97719273194,97719273194,0,1413,2124,0
97721165587,97721165589,2,1407,1494,0
97723445850,97723445849,-1,1277,1749,0
97726161346,97726161347,1,1073,1265,0
97727658555,97727658555,0,2449,2171,0
97735109030,97735109034,4,1698,1811,0
97736789893,97736789894,1,1499,1499,0
97738945377,97738945378,1,1171,2233,0
97745550006,97745550006,0,1529,2132,0
97753526858,97753526858,0,1347,1856,0
97754646097,97754646096,-1,1311,1571,0
97759618658,97759618661,3,1520,1475,0
97760968510,97760968510,0,2067,1995,0
97762204090,97762204091,1,1347,1550,0
97762479033,97762479055,22,1143,1557,0
97762509457,97762509462,5,1220,1321,0
97765793167,97765793166,-1,2013,3211,0
97766540376,97766540377,1,1802,2395,0
97766914550,97766914550,0,1266,2142,0
97767492889,97767492890,1,1235,1523,0
97773108665,97773108667,2,665,1226,0
97775353455,97775353456,1,1133,2087,0
97775516079,97775516082,3,2405,2035,0
97780877498,97780877498,0,1150,2191,0
97782964438,97782964440,2,1073,1362,0
97785476817,97785476818,1,1101,1251,0
97788639949,97788639949,0,1767,1858,0
97789765171,97789765167,-4,974,3532,0
97790503522,97790503524,2,928,1878,0
97791209220,97791209218,-2,1364,1937,0
97791418599,97791418600,1,1072,1910,0
97793317605,97793317606,1,1480,1857,0
97794521446,97794521446,0,1600,1495,0
97794557086,97794557081,-5,1197,2703,0
97795390927,97795390929,2,1593,1603,0
97797499170,97797499169,-1,1310,1740,0
97798371898,97798371898,0,1727,2250,0
97799135418,97799135419,1,1395,1514,0
97801584264,97801584256,-8,35035,13474,0
97802978676,97802978680,4,2293,2004,0
97804410723,97804410725,2,1119,1320,0
97808550922,97808550911,-11,968,134,0
97818135721,97818135723,2,1170,2392,0
97819898973,97819898972,-1,1198,1638,0
97821790094,97821790095,1,1188,1506,0
97821907025,97821907023,-2,1618,1765,0
97824056473,97824056475,2,2089,1845,0
97824891134,97824891135,1,7990,8111,0
97826922458,97826922450,-8,1609,8356,0
97827292531,97827292528,-3,824,1954,0
97829696015,97829696024,9,16045,10791,0
97834431286,97834431293,7,4363,1767,0
97837601554,97837601557,3,1111,1398,0
97838684830,97838684830,0,2257,2168,0
97839910582,97839910578,-4,925,3142,0
97843786098,97843786099,1,1470,1828,0
97844403247,97844403249,2,1736,1833,0
97844989234,97844989233,-1,1060,1692,0
97846996281,97846996282,1,1798,1804,0
97852144831,97852144829,-2,1816,1589,0
97855506599,97855506600,1,1170,1860,0
97855622449,97855622446,-3,1950,2428,0
97856421297,97856421299,2,1620,1601,0
97858885738,97858885739,1,1723,1696,0
97861359689,97861359688,-1,1314,1500,0
97866261235,97866261235,0,1475,2196,0
97866567327,97866567330,3,1245,1537,0
97867170543,97867170547,4,1263,1350,0
97868671967,97868671967,0,909,1736,0
97869099783,97869099783,0,1313,2157,0
97873710424,97873710425,1,1169,1688,0
97876995745,97876995743,-2,2501,4563,0
97877392519,97877392519,0,1426,1558,0
97877913494,97877913493,-1,954,1706,0
97878678146,97878678147,1,1184,1463,0
97885488183,97885488182,-1,1352,1420,0
97888927663,97888927662,-1,1194,1576,0
97889398944,97889398943,-1,1444,2099,0
97892679365,97892679367,2,2002,1911,0
97894525477,97894525478,1,1487,1806,0
97894937642,97894937643,1,1055,1882,0
97896023461,97896023464,3,4133,2635,0
97902169746,97902169747,1,423,660,0
97904157542,97904157536,-6,2151,9418,0
97914397511,97914397515,4,2571,1248,0
97916158330,97916158330,0,1656,1553,0
97917328869,97917328866,-3,2624,4532,0
97918465302,97918465281,-21,1556,1523,0
97920696078,97920696080,2,1139,2019,0
97921980710,97921980709,-1,1176,2239,0
97922211192,97922211192,0,2133,2393,0
97925633745,97925633751,6,3087,1206,0
97934094930,97934094931,1,1434,2699,0
97934420608,97934420628,20,1414,1300,0
97936811237,97936811238,1,1280,1299,0
97937406750,97937406748,-2,1245,1436,0
97937719515,97937719493,-22,855,1550,0
97938020893,97938020894,1,1570,1773,0
97939297274,97939297275,1,838,1357,0
97940852638,97940852637,-1,1527,2637,0
97946294854,97946294855,1,1440,2374,0
97947490850,97947490850,0,1204,1516,0
97948994611,97948994610,-1,818,1404,0
97951852102,97951852109,7,3534,1276,0
97953232811,97953232813,2,1317,1655,0
97953277623,97953277621,-2,1534,3122,0
97955068895,97955068894,-1,1365,1580,0
97961465187,97961465189,2,1388,1824,0
97961555210,97961555210,0,1958,1679,0
97961643522,97961643522,0,1181,1516,0
97970509339,97970509341,2,1413,1933,0
97975267139,97975267159,20,1437,1652,0
97978293795,97978293794,-1,1409,1361,0
97981306658,97981306658,0,1437,1434,0
97983978363,97983978363,0,1095,1684,0
97984671305,97984671303,-2,1385,1874,0
97985239136,97985239135,-1,1322,2475,0
97989434578,97989434579,1,1867,1929,0
97990341238,97990341238,0,1316,1513,0
97992321332,97992321331,-1,1627,1848,0
97992475889,97992475890,1,1098,1429,0
97995001347,97995001346,-1,1226,1377,0
97996110820,97996110819,-1,1024,1179,0
97996665707,97996665707,0,1276,1478,0
97998138562,97998138566,4,1500,1141,0
98000616689,98000616687,-2,2044,4122,0
98002230526,98002230526,0,1368,1981,0
98002530398,98002530397,-1,1987,2300,0
98005097459,98005097461,2,1358,1300,0
98006008118,98006008118,0,1032,1293,0
98009255448,98009255450,2,1504,2192,0
98009892433,98009892435,2,1391,2254,0
98010312039,98010312042,3,1518,1705,0
98010556733,98010556733,0,1430,1957,0
98011007277,98011007278,1,928,1254,0
98012349134,98012349135,1,1130,1308,0
98012811609,98012811611,2,1099,962,0
98017749683,98017749681,-2,866,1262,0
98018286715,98018286721,6,80073,41821,0
98018974423,98018974417,-6,1207,6658,0
98023249530,98023249531,1,1606,1590,0
98028925868,98028925868,0,1991,2475,0
98029655472,98029655470,-2,1139,1619,0
98035031405,98035031403,-2,1254,2197,0
98036289743,98036289742,-1,828,2142,0
98038235211,98038235214,3,1629,2011,0
98038835145,98038835146,1,1475,1560,0
98041700530,98041700531,1,938,943,0
98045020700,98045020701,1,1900,2248,0
98047528237,98047528235,-2,1980,1775,0
98048336313,98048336315,2,1587,1393,0
98051188430,98051188432,2,1885,1475,0
98052231674,98052231674,0,1505,1384,0
98053896687,98053896688,1,1994,2161,0
98054006437,98054006435,-2,1379,2121,0
98058747663,98058747665,2,1075,2096,0
98059197564,98059197563,-1,1125,1183,0
98062376246,98062376247,1,1715,1628,0
98063994146,98063994145,-1,1749,1755,0
98064773004,98064773006,2,1707,1672,0
98068292650,98068292651,1,991,1386,0
98071448681,98071448680,-1,1269,1755,0
98075910971,98075910973,2,1204,1648,0
98076319711,98076319708,-3,1022,1795,0
98079624914,98079624914,0,1934,2314,0
98079985198,98079985198,0,1647,1698,0
98083102739,98083102741,2,1680,1693,0
98083597906,98083597906,0,1577,2394,0
98087830852,98087830853,1,1817,2009,0
98091416962,98091416962,0,1550,1650,0
98091621843,98091621843,0,899,1644,0
98092997804,98092997805,1,1164,1721,0
98094439930,98094439929,-1,1256,1781,0
98096659991,98096659994,3,1638,1346,0
98096860484,98096860482,-2,851,1086,0
98099467042,98099467043,1,1241,1205,0
98101374698,98101374699,1,1632,1975,0
98102059937,98102059937,0,1227,1676,0
98104647484,98104647502,18,288,1053,0
98109759701,98109759698,-3,1340,2731,0
98110969107,98110969107,0,935,1951,0
98116900511,98116900509,-2,1094,1430,0
98118194958,98118194956,-2,1411,1490,0
98118665389,98118665390,1,724,1207,0
98120200280,98120200290,10,395,591,0
98120791522,98120791527,5,1188,1493,0
98123708910,98123708910,0,1430,1842,0
98123749135,98123749136,1,1973,1530,0
98124350409,98124350409,0,1033,1543,0
98125994460,98125994462,2,1135,1911,0
98126277732,98126277730,-2,769,1103,0
98128060920,98128060921,1,1686,1665,0
98128246573,98128246574,1,1323,1295,0
98130365774,98130365775,1,1455,1789,0
98130617314,98130617314,0,1833,2361,0
98131135835,98131135834,-1,880,1095,0
98136630146,98136630150,4,1255,1313,0
98138119018,98138119019,1,1341,1722,0
98140847923,98140847925,2,1708,1857,0
98143227299,98143227303,4,1437,1416,0
98144070250,98144070250,0,966,975,0
98145363357,98145363357,0,1506,1964,0
98145888877,98145888877,0,1422,1607,0
98147659808,98147659809,1,2072,2210,0
98156694163,98156694165,2,908,1246,0
98159607490,98159607490,0,1740,2827,0
98160299471,98160299470,-1,1388,2234,0
98160497535,98160497534,-1,1269,1787,0
98160582652,98160582653,1,1521,2089,0
98160728857,98160728859,2,1555,1391,0
98163952468,98163952463,-5,2391,10875,0
98167404612,98167404606,-6,1742,5534,0
98169472250,98169472250,0,1157,1804,0
98170856561,98170856569,8,3118,1415,0
98172771791,98172771793,2,1595,2583,0
98173374707,98173374709,2,1527,1619,0
98175222705,98175222702,-3,1136,3053,0
98175627323,98175627323,0,1186,1119,0
98178457319,98178457318,-1,1416,1609,0
98180490455,98180490455,0,1329,1789,0
98180864318,98180864319,1,1142,1330,0
98181454945,98181454943,-2,1340,1662,0
98188254350,98188254349,-1,1239,2379,0
98190494510,98190494511,1,1293,1660,0
98191883618,98191883617,-1,1437,2166,0
98193295382,98193295382,0,2026,1926,0
98194485433,98194485433,0,1237,1441,0
98195971459,98195971457,-2,1190,1402,0
98196755709,98196755706,-3,1345,2217,0
98196849245,98196849251,6,5124,1645,0
98200349317,98200349316,-1,1458,1888,0
98200773257,98200773258,1,1199,1706,0
98202157916,98202157934,18,837,1067,0
98203310514,98203310516,2,1084,1284,0
98203629278,98203629281,3,1416,1985,0
98204529205,98204529205,0,1498,2079,0
98214714491,98214714495,4,1011,1490,0
98215845707,98215845698,-9,1329,3174,0
98218207829,98218207830,1,1338,1826,0
98218290508,98218290504,-4,1229,1692,0
98220641868,98220641870,2,1025,1005,0
98221378460,98221378459,-1,1059,1481,0
98222245191,98222245168,-23,1446,1978,0
98226155148,98226155149,1,1065,1528,0
98231955982,98231955982,0,1422,1479,0
98234379731,98234379733,2,1043,1041,0
98237954757,98237954760,3,1180,1309,0
98239876245,98239876245,0,1206,1596,0
98242460342,98242460340,-2,1214,2241,0
98242672140,98242672162,22,488,648,0
98244517732,98244517730,-2,1116,1283,0
98247792010,98247792010,0,1256,1993,0
98252752834,98252752834,0,1679,1898,0
98253202350,98253202349,-1,1890,2040,0
98256267492,98256267493,1,1803,1865,0
98256559514,98256559513,-1,1643,1482,0
98257463968,98257463967,-1,1088,1494,0
98257945129,98257945130,1,1544,2019,0
98258086316,98258086318,2,1517,1728,0
98258421481,98258421478,-3,1856,2574,0
98258643983,98258643965,-18,1414,1839,0
98262777759,98262777758,-1,969,1322,0
98265910093,98265910096,3,1196,1595,0
98266052149,98266052156,7,5247,2651,0
98266520778,98266520779,1,1032,2163,0
98267127277,98267127278,1,1880,1333,0
98269386059,98269386060,1,1306,1414,0
98271380982,98271380983,1,1572,1825,0
98272731796,98272731776,-20,125,1044,0
98274228567,98274228565,-2,1045,2102,0
98274314042,98274314043,1,1172,1212,0
98276500729,98276500730,1,1198,1292,0
98277653430,98277653431,1,1392,1414,0
98279260422,98279260423,1,1683,2148,0
98281168947,98281168950,3,1492,1337,0
98281921034,98281921034,0,1917,1938,0
98282586536,98282586552,16,1915,6973,0
98283754691,98283754693,2,1146,1647,0
98285857557,98285857557,0,1330,1977,0
98289677402,98289677402,0,1179,1295,0
98291460378,98291460377,-1,1163,1525,0
98292846779,98292846778,-1,1179,1803,0
98292970982,98292970983,1,2262,1875,0
98293238976,98293238977,1,1068,1918,0
98295007150,98295007155,5,1507,1337,0
98296353624,98296353628,4,1433,2073,0
98298737669,98298737670,1,1452,1099,0
98299273620,98299273620,0,2220,2079,0
98302041777,98302041778,1,1220,1652,0
98302631647,98302631650,3,929,1204,0
98305802883,98305802882,-1,674,1677,0
98307267813,98307267814,1,1400,1660,0
98307458007,98307458009,2,1446,2079,0
98308330698,98308330707,9,2336,745,0
98309070549,98309070528,-21,3147,1385,0
98311519581,98311519581,0,1439,1816,0
98312892625,98312892627,2,1323,1721,0
98314923019,98314923020,1,910,1157,0
98318187134,98318187135,1,1306,1670,0
98319242295,98319242297,2,966,1559,0
98323198343,98323198345,2,1504,1596,0
98323533009,98323533010,1,1500,1568,0
98326537706,98326537706,0,1435,1268,0
98328936146,98328936146,0,1527,1504,0
98335263390,98335263391,1,1458,2024,0
98338176250,98338176250,0,1213,1899,0
98340981361,98340981362,1,1368,2072,0
98345139466,98345139467,1,1029,1285,0
98347318506,98347318505,-1,1358,2111,0
98348287669,98348287668,-1,1596,2095,0
98352312783,98352312782,-1,893,1271,0
98352560318,98352560321,3,3114,1246,0
98353086897,98353086898,1,1641,1477,0
98353239085,98353239085,0,1212,1647,0
98353850626,98353850624,-2,1547,1918,0
98354452608,98354452611,3,1328,941,0
98356709323,98356709325,2,3210,1863,0
98357234720,98357234734,14,16938,6962,0
98357858907,98357858907,0,1615,1657,0
98357984933,98357984931,-2,1331,1473,0
98358846803,98358846803,0,1866,1264,0
98360040469,98360040469,0,1452,1443,0
98360183082,98360183083,1,1892,1737,0
98364355698,98364355695,-3,978,1818,0
98364971059,98364971058,-1,1634,2168,0
98366419361,98366419361,0,1726,2087,0
98367136878,98367136879,1,1224,1229,0
98381476847,98381476846,-1,1127,1638,0
98382789034,98382789033,-1,1515,1897,0
98385015788,98385015786,-2,1589,1683,0
98388325606,98388325603,-3,692,2120,0
98389300045,98389300045,0,1643,1216,0
98398257010,98398257010,0,1724,2390,0
98399442966,98399442966,0,1536,1508,0
98402031811,98402031811,0,1203,1908,0
98404512743,98404512742,-1,1468,1033,0
98408343435,98408343438,3,1068,1197,0
98414043071,98414043073,2,1882,2341,0
98414391498,98414391498,0,1400,1638,0
98415992229,98415992226,-3,1356,2056,0
98420882650,98420882657,7,6130,2223,0
98422304438,98422304437,-1,1818,2521,0
98422388893,98422388885,-8,1372,2091,0
98425108961,98425108958,-3,1136,1317,0
98425848756,98425848745,-11,1425,1534,0
98426035556,98426035555,-1,1338,2000,0
98427177157,98427177156,-1,966,1107,0
98432302575,98432302576,1,1612,2196,0
98432824364,98432824365,1,1084,1301,0
98437618459,98437618458,-1,1041,1256,0
98440896095,98440896096,1,2260,2193,0
98445751963,98445751963,0,1221,1883,0
98451856401,98451856401,0,1894,2819,0
98452111750,98452111750,0,1414,1778,0
98454778938,98454778938,0,1131,1546,0
98457740711,98457740712,1,1409,1556,0
98462231330,98462231330,0,1437,1810,0
98462797145,98462797145,0,1287,2185,0
98463192630,98463192633,3,1777,1739,0
98465124077,98465124076,-1,1230,1592,0
98467341055,98467341054,-1,1210,2266,0
98467861895,98467861894,-1,1049,1550,0
98469856624,98469856625,1,1814,1668,0
98470204685,98470204691,6,1356,961,0
98472744610,98472744611,1,1349,1831,0
98478289711,98478289710,-1,1154,1050,0
98479528982,98479528981,-1,1832,2219,0
98480125702,98480125703,1,1275,1329,0
98480387493,98480387494,1,1803,1804,0
98480948473,98480948473,0,1027,1717,0
98482332304,98482332306,2,1714,1472,0
98482607072,98482607074,2,1314,1549,0
98483846162,98483846166,4,1265,869,0
98484181018,98484181016,-2,1232,2099,0
98492174326,98492174327,1,1320,1230,0
98492660793,98492660784,-9,47410,10005,0
98503346946,98503346946,0,1229,1528,0
98503582230,98503582228,-2,1180,1647,0
98508497088,98508497089,1,1806,1922,0
98513013085,98513013087,2,1984,960,0
98513172241,98513172242,1,968,2008,0
98513748550,98513748550,0,1651,1554,0
98514410198,98514410199,1,1223,1272,0
98515600202,98515600203,1,1314,1462,0
98520212999,98520212999,0,1360,2581,0
98521457361,98521457362,1,1264,1345,0
98521835834,98521835834,0,1210,1701,0
98526746601,98526746605,4,2201,1356,0
98528397642,98528397642,0,1479,2348,0
98528900561,98528900554,-7,2016,5877,0
98529730846,98529730847,1,1551,2033,0
98533026367,98533026367,0,1106,2026,0
98536068113,98536068115,2,1478,1424,0
98536575142,98536575143,1,1467,1634,0
98541473314,98541473314,0,1506,1759,0
98541566310,98541566310,0,1196,1315,0
98542829469,98542829470,1,1739,1517,0
98544334257,98544334258,1,1407,1356,0
98545585154,98545585151,-3,1584,2071,0
98546537938,98546537938,0,1239,1752,0
98547830676,98547830677,1,1403,1733,0
98549856018,98549856019,1,1058,1302,0
98551684727,98551684726,-1,1230,1320,0
98551944238,98551944238,0,1714,2052,0
98552478992,98552478990,-2,1052,1654,0
98554893653,98554893653,0,2328,1749,0
98557121058,98557121058,0,1439,2154,0
98559118429,98559118429,0,1604,1970,0
98559379250,98559379252,2,1243,1218,0
98559826971,98559826972,1,1643,2038,0
98563177797,98563177802,5,10553,7575,0
98565773216,98565773216,0,1819,2514,0
98567519849,98567519847,-2,1259,1732,0
98571464219,98571464217,-2,1302,1320,0
98578007657,98578007658,1,1121,1428,0
98578765233,98578765234,1,1056,1903,0
98580022631,98580022630,-1,2542,3968,0
98580087349,98580087350,1,1011,1109,0
98586888965,98586888966,1,1198,1561,0
98587360660,98587360657,-3,1833,2031,0
98588010611,98588010618,7,3781,1658,0
98593570086,98593570086,0,1072,1443,0
98594174759,98594174761,2,1411,1570,0
98596476474,98596476473,-1,1143,1793,0
98596910625,98596910627,2,1614,1412,0
98597586511,98597586509,-2,1645,2948,0
98597857751,98597857751,0,1226,1471,0
98598081002,98598081002,0,1187,1442,0
98600002555,98600002554,-1,1566,2115,0
98600281805,98600281805,0,1280,1475,0
98601670366,98601670366,0,1836,1684,0
98601890664,98601890667,3,1401,1420,0
98603879989,98603879987,-2,1026,1639,0
98604608492,98604608494,2,1383,1319,0
98607118622,98607118618,-4,909,1611,0
98608100395,98608100396,1,1871,1614,0
98608642727,98608642726,-1,753,2010,0
98608932056,98608932052,-4,1422,2393,0
98609511310,98609511309,-1,1679,1762,0
98617037746,98617037743,-3,1149,2219,0
98618554157,98618554157,0,1253,2042,0
98620030129,98620030108,-21,1394,1066,0
98620439881,98620439882,1,1437,1597,0
98623807853,98623807853,0,1692,2635,0
98626128990,98626128990,0,1188,1294,0
98627059988,98627059988,0,1548,2200,0
98629564281,98629564279,-2,1484,1636,0
98633935154,98633935155,1,1175,2253,0
98634147574,98634147595,21,1105,1545,0
98635090453,98635090452,-1,1567,1843,0
98638576001,98638576002,1,1097,1801,0
98639674758,98639674757,-1,1160,1671,0
98641132802,98641132802,0,2071,2029,0
98642602265,98642602266,1,577,1350,0
98646237878,98646237879,1,1009,1256,0
98653425998,98653425998,0,1166,1368,0
98663498951,98663498945,-6,1395,3917,0
98665197171,98665197170,-1,1400,1798,0
98666481794,98666481796,2,1393,1393,0
98669701923,98669701925,2,1216,1520,0
98669817910,98669817910,0,1018,1362,0
98670676826,98670676826,0,1763,1563,0
98671950901,98671950901,0,1312,1753,0
98681991767,98681991770,3,1293,1488,0
98683966062,98683966067,5,1271,832,0
98685307418,98685307418,0,1995,2063,0
98685522091,98685522090,-1,1215,1124,0
98686611474,98686611474,0,1443,1940,0
98687619176,98687619174,-2,1776,1827,0
98690000849,98690000850,1,1601,1719,0
98694070338,98694070340,2,1297,1503,0
98695653049,98695653050,1,1446,1044,0
98700394646,98700394642,-4,754,2146,0
98702594558,98702594558,0,1377,1804,0
98705880189,98705880190,1,2187,1904,0
98706498944,98706498945,1,1002,1589,0
98709511258,98709511259,1,1988,1927,0
98714604790,98714604791,1,1205,1402,0
98720025014,98720025013,-1,1199,1265,0
98721827778,98721827778,0,566,750,0
98722667134,98722667135,1,1333,1914,0
98723450746,98723450747,1,1666,1651,0
98723786968,98723786961,-7,1718,6697,0
98724417916,98724417919,3,1571,1433,0
98725079494,98725079495,1,1408,984,0
98726520867,98726520888,21,1313,1138,0
98726630793,98726630794,1,985,1636,0
98727965025,98727965027,2,1427,1703,0
98728578662,98728578667,5,905,1196,0
98731180863,98731180866,3,804,1529,0
98731679583,98731679583,0,899,1330,0
98735711421,98735711421,0,1857,2076,0
98738268878,98738268877,-1,1437,1476,0
98741833129,98741833138,9,17008,26849,0
98744814698,98744814699,1,906,1185,0
98747206794,98747206796,2,1517,1406,0
98747528761,98747528762,1,1013,1326,0
98749379290,98749379288,-2,1550,2837,0
98756048162,98756048158,-4,1098,1791,0
98757041181,98757041182,1,1141,1364,0
98757476171,98757476170,-1,1071,1215,0
98759665765,98759665766,1,1899,1993,0
98760469115,98760469116,1,1658,1345,0
98761551922,98761551920,-2,1127,2104,0
98761801913,98761801914,1,1293,2226,0
98765604562,98765604562,0,816,1211,0
98768408289,98768408289,0,1617,2175,0
98769794565,98769794563,-2,1240,1897,0
98773062037,98773062039,2,1365,1376,0
98774294663,98774294665,2,1324,1342,0
98774330046,98774330045,-1,1418,2152,0
98774529234,98774529233,-1,1473,1518,0
98775777857,98775777857,0,1974,2113,0
98776265553,98776265554,1,1621,1740,0
98779631914,98779631914,0,1988,2198,0
98779855028,98779855030,2,1423,2279,0
98781692391,98781692392,1,2540,2189,0
98782808185,98782808188,3,8545,27065,0
98786178367,98786178367,0,1379,1533,0
98788911569,98788911570,1,1337,1848,0
98791531344,98791531344,0,1331,1998,0
98796446759,98796446764,5,1364,1931,0
98796702506,98796702507,1,1302,1803,0
98800911809,98800911806,-3,886,933,0
98802512855,98802512862,7,1224,464,0
98803095994,98803095994,0,1568,1562,0
98806579862,98806579859,-3,1291,1972,0
98806707830,98806707832,2,1350,1585,0
98807573709,98807573710,1,1015,1097,0
98808293596,98808293597,1,1358,1280,0
98810527487,98810527487,0,877,1424,0
98811318443,98811318445,2,1861,1853,0
98812677395,98812677392,-3,1445,1681,0
98813855017,98813855018,1,1741,2239,0
98815463963,98815463966,3,839,931,0
98818302020,98818302027,7,1280,1264,0
98820146375,98820146376,1,1613,1364,0
98827231577,98827231578,1,1775,1280,0
98829835590,98829835592,2,1183,1772,0
98832033406,98832033407,1,1294,1547,0
98832540785,98832540786,1,1672,2040,0
98834296485,98834296486,1,1720,1783,0
98836350565,98836350565,0,1632,2158,0
98836499038,98836499039,1,2050,1937,0
98836545200,98836545198,-2,969,1337,0
98837829981,98837829984,3,852,1544,0
98838137828,98838137849,21,1749,2000,0
98841818224,98841818224,0,1362,1942,0
98842706384,98842706384,0,1151,1327,0
98844724179,98844724181,2,831,1799,0
98848874142,98848874141,-1,1901,2395,0
98850266124,98850266124,0,1508,1752,0
98852399681,98852399682,1,1612,1259,0
98855221977,98855221975,-2,1846,1885,0
98861864390,98861864389,-1,892,1159,0
98861901711,98861901707,-4,141,1227,0
98876255201,98876255209,8,3201,1321,0
98880429971,98880429973,2,1149,1302,0
98881093145,98881093147,2,927,1051,0
98883779541,98883779542,1,1547,2223,0
98885062615,98885062618,3,1308,1398,0
98895665176,98895665193,17,110,1486,0
98896310114,98896310114,0,1875,1269,0
98901828242,98901828244,2,2115,2286,0
98901973502,98901973502,0,1694,1954,0
98903422461,98903422461,0,1419,2066,0
98903511427,98903511430,3,1483,1946,0
98904007575,98904007574,-1,1360,1477,0
98904106970,98904106971,1,1213,1543,0
98906291463,98906291465,2,1931,2413,0
98908272577,98908272578,1,1290,1335,0
98915499009,98915499009,0,1430,1686,0
98918344563,98918344562,-1,1532,1401,0
98921242591,98921242590,-1,987,1336,0
98922451378,98922451379,1,1341,1347,0
98922917077,98922917079,2,1668,2111,0
98923611429,98923611428,-1,778,1736,0
98925664427,98925664427,0,1662,1943,0
98927338992,98927338989,-3,1180,1761,0
98930379106,98930379101,-5,1497,1819,0
98930770623,98930770624,1,1150,1110,0
98930994570,98930994570,0,1617,2223,0
98931622846,98931622845,-1,1584,1298,0
98938867245,98938867246,1,937,1471,0
98940130117,98940130117,0,1497,1545,0
98944365446,98944365447,1,826,1692,0
98945098081,98945098082,1,1736,1348,0
98947254878,98947254877,-1,1252,1517,0
98947300888,98947300888,0,1367,1887,0
98949007142,98949007142,0,1452,1478,0
98951307921,98951307919,-2,1658,2404,0
98953600375,98953600374,-1,1734,2343,0
98954581138,98954581145,7,13975,20032,0
98955980451,98955980453,2,1067,1495,0
98958232286,98958232290,4,1689,1469,0
98959746175,98959746173,-2,1349,2211,0
98961852023,98961852024,1,1429,1643,0
98962062530,98962062530,0,1889,2711,0
98964637454,98964637455,1,1412,2233,0
98964827549,98964827552,3,1152,1129,0
98965782078,98965782078,0,1301,1731,0
98971899707,98971899711,4,1195,1084,0
98972419086,98972419088,2,1489,2170,0
98974723464,98974723466,2,1164,1148,0
98974949195,98974949197,2,1513,1777,0
98979234681,98979234681,0,1567,1976,0
98982380351,98982380351,0,1816,2268,0
98983617618,98983617618,0,916,1436,0
98984065942,98984065943,1,1190,1199,0
98984667694,98984667695,1,1743,1553,0
98989517289,98989517285,-4,900,1565,0
98994696943,98994696941,-2,1540,1820,0
98997517693,98997517694,1,1346,1285,0
98998225099,98998225100,1,1841,2077,0
99003421048,99003421048,0,1248,1870,0
99004091098,99004091101,3,1216,2015,0
99011423482,99011423468,-14,1269,1228,0
99014032462,99014032465,3,1366,1470,0
99015632359,99015632362,3,1537,1525,0
99017102948,99017102951,3,647,1757,0
99018495770,99018495770,0,831,1342,0
99019728954,99019728954,0,1204,1835,0
99019795118,99019795120,2,1409,1774,0
99020196238,99020196242,4,1088,1252,0
99022009899,99022009898,-1,1453,1485,0
99030369314,99030369314,0,922,1806,0
99032121261,99032121261,0,1253,1306,0
99032751467,99032751466,-1,1374,1815,0
99033113044,99033113046,2,1131,1366,0
99034775978,99034775977,-1,1756,2010,0
99037097733,99037097734,1,1151,1440,0
99038161430,99038161446,16,15701,24112,0
99038972861,99038972861,0,2327,1903,0
99039389770,99039389770,0,954,1605,0
99040037762,99040037763,1,1208,1300,0
99040076908,99040076911,3,1224,1539,0
99044614354,99044614355,1,1387,1348,0
99046152162,99046152162,0,1853,1694,0
99047026418,99047026419,1,1128,1237,0
99052793783,99052793783,0,1243,971,0
99053049151,99053049151,0,1587,2109,0
99053595789,99053595790,1,1781,2347,0
99054820218,99054820218,0,1140,1648,0
99055031390,99055031408,18,25,1828,0
99058031727,99058031727,0,1293,1138,0
99062004331,99062004331,0,1325,2016,0
99062336102,99062336103,1,1315,1727,0
99063855354,99063855353,-1,1512,1396,0
99067767124,99067767121,-3,1429,1521,0
99070490630,99070490631,1,1700,1460,0
99071402778,99071402778,0,2233,3700,0
99072051462,99072051470,8,3936,1350,0
99072280473,99072280475,2,1579,1583,0
99072826615,99072826614,-1,895,1552,0
99079321206,99079321206,0,1258,2155,0
99081748567,99081748566,-1,888,1474,0
99083097799,99083097799,0,1371,1619,0
99086748037,99086748039,2,4412,3263,0
99086943942,99086943942,0,1516,1744,0
99088610301,99088610304,3,9323,7995,0
99091702546,99091702547,1,1315,1670,0
99092599766,99092599770,4,1942,1888,0
99094730605,99094730607,2,1713,1796,0
99096480177,99096480180,3,864,1488,0
99099269552,99099269548,-4,1148,2021,0
99100339888,99100339890,2,1254,1046,0
99106999857,99106999858,1,1020,1564,0
99109600266,99109600266,0,1910,1882,0
99114910539,99114910534,-5,1204,5171,0
99117239306,99117239306,0,1464,1740,0
99120231023,99120231024,1,1188,1530,0
99123642161,99123642162,1,831,1076,0
99125515658,99125515657,-1,1242,1614,0
99127854730,99127854730,0,1579,1725,0
99128744789,99128744790,1,1545,1417,0
99130348454,99130348455,1,1352,1544,0
99133025668,99133025666,-2,1038,1764,0
99135570974,99135570973,-1,1448,1690,0
99135848522,99135848523,1,2130,1923,0
99136402039,99136402041,2,1698,1120,0
99138625059,99138625058,-1,1909,2089,0
99140149658,99140149658,0,1326,1266,0
99141187139,99141187136,-3,1496,1946,0
99142522740,99142522750,10,1354,1368,0
99144213051,99144213050,-1,1548,1619,0
99147209394,99147209394,0,664,1096,0
99149083410,99149083413,3,1751,1585,0
99149603435,99149603436,1,1065,1873,0
99150636601,99150636602,1,1172,1954,0
99151125914,99151125914,0,1649,1469,0
99153751402,99153751403,1,1642,2183,0
99153846055,99153846058,3,1431,1366,0
99154761046,99154761062,16,1272,1300,0
99155520570,99155520573,3,1757,1729,0
99155783233,99155783233,0,1122,1295,0
99157244549,99157244549,0,1994,2473,0
99157978411,99157978413,2,1653,2017,0
99158746445,99158746455,10,10548,32941,0
99161449265,99161449265,0,1138,1333,0
99162474690,99162474691,1,1663,1780,0
99162879519,99162879521,2,1221,1706,0
99164013290,99164013291,1,1055,1127,0
99165157186,99165157186,0,1790,2271,0
99170947537,99170947537,0,1813,1956,0
99172651896,99172651897,1,1368,1545,0
99174593329,99174593330,1,1116,1621,0
99175401592,99175401591,-1,1540,1097,0
99182672297,99182672298,1,1929,1922,0
99185653140,99185653120,-20,1025,1275,0
99185867360,99185867366,6,3713,3678,0
99186011210,99186011210,0,1002,1019,0
99187359509,99187359509,0,1956,2330,0
99188346266,99188346265,-1,1527,2224,0
99189747953,99189747949,-4,1492,2832,0
99190656301,99190656299,-2,1810,1895,0
99190983575,99190983574,-1,1115,1987,0
99193419302,99193419302,0,1112,1672,0
99193822629,99193822629,0,1248,2032,0
99200224429,99200224429,0,1249,1881,0
99200812597,99200812590,-7,965,1312,0
99203053126,99203053126,0,1241,1944,0
99203288963,99203288962,-1,1273,2156,0
99209698281,99209698282,1,1177,2205,0
99210478391,99210478392,1,1620,1866,0
99211232675,99211232674,-1,1262,1228,0
99212229415,99212229401,-14,46838,8932,0
99217610118,99217610118,0,2094,1818,0
99220898623,99220898625,2,1168,1394,0
99221210622,99221210623,1,1724,2052,0
99222668674,99222668674,0,1263,2095,0
99223163654,99223163654,0,693,1251,0
99223501145,99223501145,0,1506,1719,0
99224440923,99224440923,0,1053,1210,0
99225035941,99225035944,3,2001,1722,0
99226276189,99226276189,0,1553,1365,0
99232692949,99232692948,-1,1397,1629,0
99233484510,99233484504,-6,2066,8972,0
99234288107,99234288109,2,1120,1436,0
99236421387,99236421385,-2,876,1301,0
99236765211,99236765221,10,1550,1442,0
99237510993,99237510995,2,1476,1755,0
99238203532,99238203533,1,1293,1472,0
99239170481,99239170482,1,1975,1562,0
99240066565,99240066574,9,17618,15187,0
99243158927,99243158926,-1,898,893,0
99243259963,99243259943,-20,1776,1823,0
99245924499,99245924498,-1,234,1769,0
99250759775,99250759772,-3,1120,2864,0
99251052431,99251052429,-2,1129,1441,0
99251243604,99251243605,1,2224,1863,0
99251848659,99251848660,1,1259,2440,0
99251953403,99251953405,2,1091,2103,0
99254877140,99254877135,-5,1089,2860,0
99256841650,99256841650,0,1536,1223,0
99257127230,99257127229,-1,1450,1312,0
99257946572,99257946581,9,4896,1329,0
99259763832,99259763832,0,1588,1474,0
99260116823,99260116826,3,931,1189,0
99267894820,99267894825,5,4981,2756,0
99271611118,99271611119,1,893,1345,0
99274698521,99274698520,-1,1236,1825,0
99279797888,99279797889,1,1194,1602,0
99281268110,99281268110,0,1377,1674,0
99283226798,99283226801,3,1858,2188,0
99285275872,99285275874,2,1444,2281,0
99286284215,99286284214,-1,1863,2764,0
99286371415,99286371414,-1,1343,1535,0
99288221778,99288221779,1,979,1133,0
99289184306,99289184307,1,1118,1625,0
99289479720,99289479722,2,1951,2336,0
99293935222,99293935222,0,1139,1877,0
99295349784,99295349790,6,3724,1436,0
99295693061,99295693063,2,1242,1301,0
99296253807,99296253806,-1,1172,2302,0
99302286621,99302286621,0,1851,1776,0
99302431439,99302431439,0,1961,2185,0
99303236921,99303236922,1,2078,1664,0
99303594526,99303594529,3,960,1451,0
99305240162,99305240161,-1,1012,1819,0
99307600298,99307600297,-1,1645,1832,0
99307679454,99307679454,0,1591,2338,0
99308209246,99308209246,0,1199,1436,0
99309738182,99309738185,3,1173,1718,0
99310372449,99310372430,-19,1184,1604,0
99312511092,99312511094,2,1112,2052,0
99313150904,99313150905,1,1579,2292,0
99318199882,99318199887,5,1351,683,0
99320334682,99320334685,3,2961,3077,0
99325519610,99325519609,-1,967,1631,0
99326710888,99326710881,-7,2003,8015,0
99327921814,99327921814,0,1413,1466,0
99331086090,99331086090,0,1063,1187,0
99332759536,99332759535,-1,1455,1880,0
99333464691,99333464694,3,1547,1651,0
99336675897,99336675894,-3,1370,2577,0
99337708689,99337708689,0,1404,1503,0
99342595057,99342595057,0,1375,1915,0
99343441411,99343441411,0,1038,1794,0
99343725450,99343725450,0,1378,1418,0
99343838607,99343838607,0,1249,1621,0
99344140862,99344140863,1,1578,1795,0
99345007994,99345007994,0,1247,1085,0
99345641059,99345641062,3,802,1427,0
99346532249,99346532250,1,1167,2235,0
99346766657,99346766662,5,2480,1205,0
99346847369,99346847371,2,1233,1306,0
99349852903,99349852902,-1,2284,4050,0
99350017345,99350017346,1,1563,1844,0
99352510110,99352510108,-2,762,1917,0
99352968689,99352968701,12,12424,44996,0
99357991280,99357991282,2,1268,1148,0
99359066478,99359066477,-1,1331,1264,0
99360929693,99360929694,1,1398,1183,0
99361957266,99361957266,0,1536,1910,0
99363863615,99363863616,1,1089,1577,0
99366586188,99366586194,6,2236,1023,0
99371029374,99371029374,0,1422,1837,0
99372088226,99372088229,3,1120,764,0
99375773122,99375773122,0,1694,2154,0
99378102574,99378102574,0,1654,2033,0
99378254013,99378254014,1,1882,1541,0
99379201231,99379201231,0,1207,1465,0
99381601946,99381601947,1,1333,910,0
99382335902,99382335909,7,14134,28438,0
99385713798,99385713797,-1,1034,1235,0
99389852693,99389852696,3,1330,1536,0
99390584473,99390584474,1,2042,2112,0
99391680921,99391680922,1,1207,2024,0
99393373337,99393373337,0,1377,1746,0
99394567298,99394567298,0,1568,2810,0
99398132339,99398132342,3,1013,1397,0
99399538608,99399538613,5,1115,1472,0
99400546983,99400546985,2,1512,1265,0
99401832769,99401832767,-2,1648,1748,0
99406150801,99406150801,0,1186,1630,0
99409837517,99409837519,2,1692,2077,0
99410050678,99410050679,1,1231,1826,0
99412600896,99412600915,19,1233,1767,0
99413125198,99413125201,3,1267,1723,0
99415457138,99415457143,5,4858,2212,0
99416123750,99416123748,-2,1473,1525,0
99416531036,99416531034,-2,1111,2063,0
99418381120,99418381118,-2,1173,1703,0
99420395126,99420395125,-1,1116,1213,0
99421001567,99421001567,0,1128,1739,0
99421569770,99421569773,3,1758,1659,0
99421620278,99421620280,2,1331,1614,0
99422604705,99422604706,1,1439,1512,0
99427930505,99427930506,1,1038,1093,0
99430413046,99430413047,1,1983,2072,0
99430700753,99430700754,1,1338,1110,0
99430984839,99430984839,0,1917,2298,0
99434541183,99434541182,-1,1070,1680,0
99434912917,99434912917,0,1639,1711,0
99435113581,99435113582,1,2124,2268,0
99435283109,99435283102,-7,1925,9864,0
99436253567,99436253566,-1,1115,1772,0
99436951531,99436951534,3,1339,1276,0
99439988237,99439988238,1,1652,1734,0
99440821182,99440821182,0,1388,2107,0
99441396846,99441396845,-1,1539,1728,0
99441834483,99441834482,-1,1423,2471,0
99443618022,99443618025,3,1962,2310,0
99447927137,99447927137,0,1350,2121,0
99450929952,99450929950,-2,1365,1550,0
99451356082,99451356083,1,1472,1652,0
99453183299,99453183299,0,1350,2019,0
99453865319,99453865314,-5,953,1890,0
99465204417,99465204415,-2,2006,2981,0
99467949729,99467949728,-1,1434,1567,0
99469330634,99469330637,3,1224,1343,0
99469834289,99469834289,0,1331,1848,0
99475931320,99475931313,-7,1358,1667,0
99476619370,99476619370,0,1923,1818,0
99478680592,99478680595,3,1195,1572,0
99479404999,99479404999,0,1558,1747,0
99480801918,99480801917,-1,1621,2219,0
99481404641,99481404641,0,1012,1670,0
99483040936,99483040938,2,1206,1495,0
99489525091,99489525091,0,1906,1930,0
99492174935,99492174937,2,822,1025,0
99493028819,99493028822,3,975,1210,0
99493229436,99493229431,-5,887,748,0
99494486191,99494486193,2,897,1410,0
99496156508,99496156509,1,1681,2015,0
99497542603,99497542605,2,1195,1661,0
99498548373,99498548374,1,1978,1670,0
99502388919,99502388918,-1,1364,1334,0
99505030993,99505030986,-7,2810,12652,0
99507734638,99507734638,0,1628,1608,0
99509012012,99509012011,-1,1175,1712,0
99510064878,99510064879,1,1052,928,0
99515297558,99515297558,0,1356,1615,0
99516675222,99516675222,0,1433,1508,0
99517629209,99517629210,1,1498,1854,0
99519381249,99519381244,-5,1303,4311,0
99521187469,99521187470,1,1282,1643,0
99522378576,99522378575,-1,1263,1328,0
99523069379,99523069380,1,1831,1813,0
99523479046,99523479046,0,1282,905,0
99524331453,99524331454,1,1390,1989,0
99526725174,99526725166,-8,1162,1127,0
99527087753,99527087754,1,1305,1661,0
99529501945,99529501947,2,1274,1886,0
99531732769,99531732769,0,1526,2410,0
99535091771,99535091773,2,1134,1615,0
99535728491,99535728490,-1,1116,2375,0
99536891557,99536891558,1,1141,1809,0
99538172800,99538172801,1,1058,1103,0
99541674243,99541674245,2,1083,1369,0
99543698206,99543698205,-1,1391,1760,0
99544325862,99544325862,0,1031,1443,0
99544406207,99544406207,0,895,1588,0
99549862197,99549862198,1,6458,6396,0
99551622791,99551622790,-1,1434,1636,0
99552431759,99552431760,1,1493,1648,0
99552548398,99552548399,1,882,1783,0
99556763878,99556763878,0,1376,1434,0
99557393323,99557393323,0,1611,2074,0
99558381423,99558381426,3,1189,1505,0
99559589767,99559589770,3,1801,1415,0
99560673210,99560673215,5,1383,1246,0
99565164535,99565164535,0,960,1746,0
99567741581,99567741582,1,1494,1658,0
99569337231,99569337231,0,1496,1560,0
99570743221,99570743222,1,1776,1596,0
99575531379,99575531378,-1,698,1029,0
99580051022,99580051022,0,1472,1412,0
99580076160,99580076163,3,2020,2054,0
99580443855,99580443855,0,2021,2265,0
99581447042,99581447041,-1,1170,1853,0
99582250931,99582250931,0,752,2035,0
99582978935,99582978932,-3,1354,1574,0
99584961050,99584961053,3,1392,1263,0
99586144146,99586144150,4,4101,2926,0
99586169382,99586169382,0,1406,1653,0
99588602624,99588602624,0,1205,1456,0
99595505586,99595505586,0,1382,2158,0
99595617137,99595617134,-3,1551,1665,0
99596579268,99596579268,0,1274,1249,0
99597035519,99597035521,2,1587,1967,0
99597580470,99597580472,2,1299,1536,0
99597682029,99597682029,0,539,918,0
99601763709,99601763710,1,1089,1244,0
99603143242,99603143241,-1,1630,1737,0
99605424061,99605424043,-18,1091,618,0
99605582087,99605582088,1,2094,1908,0
99605942919,99605942917,-2,1225,2127,0
99605998222,99605998223,1,1079,1921,0
99608739914,99608739914,0,1490,1435,0
99609414189,99609414188,-1,1445,1909,0
99613774839,99613774841,2,1096,1441,0
99614817842,99614817843,1,1253,1408,0
99618478814,99618478815,1,1508,1639,0
99620183459,99620183458,-1,1555,2337,0
99623271014,99623271015,1,1681,3016,0
99626699699,99626699699,0,1277,1677,0
99628008125,99628008126,1,1638,1190,0
99630963387,99630963386,-1,1213,1283,0
99631532346,99631532345,-1,1027,1175,0
99632504266,99632504265,-1,1630,2515,0
99637645802,99637645803,1,1783,1638,0
99640410635,99640410636,1,1384,1857,0
99641794110,99641794114,4,858,1237,0
99647237063,99647237069,6,3240,1258,0
99649736748,99649736747,-1,1149,1776,0
99652502269,99652502269,0,1174,2327,0
99653159333,99653159330,-3,1431,2029,0
99656135057,99656135054,-3,1996,1566,0
99656939842,99656939842,0,1355,2266,0
99659274532,99659274534,2,2214,1694,0
99660053885,99660053885,0,801,1139,0
99660528208,99660528210,2,873,1535,0
99663131160,99663131162,2,1191,992,0
99665468589,99665468590,1,1654,1700,0
99665726487,99665726489,2,942,898,0
99668809718,99668809719,1,1769,2460,0
99669827915,99669827915,0,1799,2206,0
99670426730,99670426731,1,1613,1421,0
99671479503,99671479503,0,1649,1656,0
99672147558,99672147555,-3,1444,2118,0
99673895107,99673895108,1,1502,1738,0
99675865827,99675865829,2,1527,2001,0
99676992186,99676992186,0,1344,1814,0
99681091835,99681091829,-6,1110,2182,0
99682401074,99682401074,0,1441,1596,0
99685360498,99685360499,1,935,1508,0
99686393863,99686393863,0,1533,1848,0
99688527611,99688527612,1,1215,1129,0
99694618361,99694618359,-2,1620,1849,0
99694694701,99694694705,4,152,707,0
99695568385,99695568366,-19,66,1319,0
99697181180,99697181179,-1,1169,1313,0
99698953703,99698953702,-1,1747,1943,0
99702973305,99702973305,0,2259,2859,0
99703884901,99703884902,1,1194,1920,0
99706452063,99706452064,1,567,974,0
99712373006,99712373005,-1,1296,1842,0
99713704772,99713704773,1,1350,2341,0
99716672213,99716672213,0,1274,1485,0
99716699251,99716699262,11,787,1810,0
99720136310,99720136308,-2,1315,1858,0
99721642365,99721642365,0,974,1529,0
99724701552,99724701553,1,1521,1832,0
99727791485,99727791486,1,1152,917,0
99729032982,99729032983,1,1138,1310,0
99734339435,99734339435,0,918,1566,0
99735364447,99735364447,0,1930,1244,0
99736395922,99736395924,2,1719,2228,0
99739442434,99739442434,0,1466,1683,0
99739881346,99739881365,19,1292,1562,0
99742991190,99742991191,1,1286,1371,0
99743732000,99743732000,0,2025,1848,0
99744440092,99744440092,0,1532,2048,0
99744865361,99744865366,5,3061,1307,0
99748565566,99748565570,4,2730,1646,0
99755656290,99755656310,20,1446,1916,0
99756495263,99756495263,0,1647,1910,0
99756883162,99756883163,1,1240,1352,0
99758487895,99758487897,2,3512,2535,0
99761958178,99761958178,0,2103,2172,0
99763836185,99763836187,2,1523,1264,0
99766000131,99766000131,0,1168,1536,0
99771862149,99771862149,0,1121,1806,0
99773055196,99773055214,18,1639,2085,0
99774363417,99774363417,0,724,1384,0
99774663686,99774663687,1,1347,1257,0
99775351278,99775351279,1,1593,1119,0
99776625519,99776625519,0,1894,1650,0
99777042586,99777042589,3,1331,1652,0
99777761285,99777761286,1,999,1286,0
99780517239,99780517239,0,1162,2166,0
99780821986,99780821987,1,1120,1146,0
99781109334,99781109342,8,5461,1284,0
99783391172,99783391170,-2,1176,1771,0
99785873168,99785873167,-1,1396,1456,0
99786081398,99786081393,-5,1922,8701,0
99787596130,99787596130,0,1491,2531,0
99788514095,99788514096,1,1330,1264,0
99790276163,99790276163,0,1508,1968,0
99795026134,99795026130,-4,1300,5187,0
99796697021,99796697021,0,1298,1720,0
99801348830,99801348831,1,1618,1764,0
99801381745,99801381745,0,1251,1408,0
99805223476,99805223474,-2,1045,1752,0
99807273750,99807273750,0,1631,1873,0
99807568852,99807568852,0,1345,2288,0
99810078738,99810078739,1,1495,1633,0
99810360867,99810360864,-3,41078,17276,0
99815018515,99815018515,0,899,1647,0
99819066290,99819066291,1,1200,1487,0
99819184542,99819184543,1,1839,2182,0
99820664103,99820664106,3,1346,1032,0
99821236385,99821236385,0,1599,1263,0
99822831083,99822831086,3,1263,1110,0
99828288658,99828288662,4,2356,1702,0
99830177910,99830177910,0,1276,1222,0
99830449461,99830449460,-1,1671,1495,0
99837948758,99837948758,0,1549,2269,0
99838703684,99838703683,-1,1810,2280,0
99841007857,99841007857,0,1172,1551,0
99842779213,99842779215,2,863,1572,0
99846110653,99846110653,0,1205,1631,0
99846254391,99846254381,-10,1120,1921,0
99850273608,99850273610,2,1701,1689,0
99852694381,99852694390,9,1536,801,0
99853787235,99853787235,0,1016,1472,0
99854247875,99854247874,-1,2222,2050,0
99854493049,99854493051,2,906,1876,0
99856108073,99856108078,5,66737,32785,0
99856347990,99856347990,0,1164,1545,0
99858129701,99858129701,0,1094,1992,0
99859234354,99859234357,3,667,871,0
99860165791,99860165802,11,11727,30382,0
99866855582,99866855586,4,1299,1444,0
99869584357,99869584354,-3,1472,1638,0
99875300541,99875300544,3,1670,1103,0
99884436849,99884436851,2,1490,1591,0
99886662737,99886662739,2,1141,1288,0
99887655270,99887655270,0,1149,1856,0
99892017713,99892017695,-18,810,1238,0
99892207105,99892207106,1,1244,1881,0
99893518750,99893518750,0,1540,1396,0
99894075198,99894075199,1,859,1679,0
99898447018,99898447018,0,1313,1051,0
99898573337,99898573337,0,1410,1803,0
99900913558,99900913558,0,1526,1910,0
99906553733,99906553732,-1,1509,1218,0
99908610870,99908610868,-2,1062,1459,0
99913166771,99913166773,2,2051,1801,0
99916921292,99916921294,2,1972,2028,0
99917173446,99917173447,1,744,1125,0
99917977761,99917977761,0,1643,1593,0
99918643875,99918643875,0,1908,1778,0
99919336474,99919336475,1,1596,1902,0
99923293902,99923293902,0,963,1784,0
99923527609,99923527609,0,1428,1519,0
99925867546,99925867545,-1,774,1090,0
99930337454,99930337454,0,1387,1546,0
99932135758,99932135763,5,2498,1153,0
99932325044,99932325045,1,1635,2311,0
99934865082,99934865082,0,1535,1578,0
99939294811,99939294814,3,1368,1208,0
99939743182,99939743186,4,360,3129,0
99941258430,99941258429,-1,761,1295,0
99947062919,99947062920,1,1089,1356,0
99954049901,99954049905,4,1227,1314,0
99958262657,99958262658,1,1425,1782,0
99961467293,99961467289,-4,813,1301,0
99963530729,99963530732,3,1292,1444,0
99965930834,99965930835,1,1320,1771,0
99968247678,99968247677,-1,1176,1975,0
99972047119,99972047119,0,1574,1282,0
99972214338,99972214338,0,1209,1415,0
99973861575,99973861576,1,3234,3419,0
99974676691,99974676689,-2,1502,1969,0
99974760412,99974760413,1,1385,1595,0
99976701122,99976701121,-1,1125,1514,0
99983899086,99983899087,1,1268,1687,0
99987071051,99987071050,-1,1588,1766,0
99989363750,99989363750,0,1741,1971,0
99990235520,99990235526,6,3250,1400,0
99990730028,99990730031,3,1664,1364,0
99997058108,99997058131,23,957,1182,0
100000150682,100000150685,3,1557,1470,0
100000602979,100000602979,0,1212,1064,0
100007028983,100007028987,4,2350,1295,0
100008307561,100008307562,1,1256,1431,0
100010343400,100010343402,2,1253,1483,0
100018741947,100018741946,-1,1516,1725,0
100019211965,100019211967,2,1315,1772,0
100022567350,100022567351,1,1295,1562,0
100023362061,100023362059,-2,1319,1714,0
100025092254,100025092257,3,1674,1500,0
100025582582,100025582586,4,2290,2156,0
100026190948,100026190954,6,3122,1838,0
100027887321,100027887321,0,1267,2031,0
100031050586,100031050564,-22,773,1247,0
100032854230,100032854230,0,1404,2181,0
100035105437,100035105439,2,619,1200,0
100041662987,100041662990,3,1621,1403,0
100042188470,100042188470,0,1153,1866,0
100044064227,100044064226,-1,1280,2552,0
100045294334,100045294335,1,1801,1908,0
100045420918,100045420917,-1,1421,1644,0
100045549352,100045549350,-2,1743,2661,0
100048633340,100048633342,2,1406,1761,0
100049942932,100049942930,-2,2030,4722,0
100050138250,100050138250,0,1254,1544,0
100050777536,100050777538,2,1402,1855,0
100050964809,100050964806,-3,9187,15995,0
100051896994,100051896996,2,1496,1685,0
100054305603,100054305604,1,1522,1227,0
100056936874,100056936872,-2,1239,1959,0
100058083618,100058083619,1,1606,2063,0
100061042346,100061042347,1,1274,1651,0
100061096694,100061096697,3,39008,25045,0
100062507420,100062507421,1,1576,2134,0
100067115061,100067115062,1,2076,2176,0
100069296436,100069296436,0,2002,2419,0
100069412175,100069412175,0,505,865,0
100070164007,100070164007,0,1377,1714,0
100076737471,100076737468,-3,924,1348,0
100080984527,100080984528,1,1232,1863,0
100083506788,100083506772,-16,1063,1046,0
100087292769,100087292769,0,1609,2172,0
100088714400,100088714404,4,1912,1880,0
100089043594,100089043595,1,1448,2076,0
100089242382,100089242380,-2,1510,3670,0
100090151637,100090151638,1,1463,1385,0
100090623160,100090623159,-1,1563,1773,0
100092768743,100092768744,1,1421,2529,0
100092887036,100092887035,-1,1302,2151,0
100093219322,100093219325,3,1479,996,0
100096476532,100096476532,0,1658,1656,0
100098073953,100098073952,-1,1820,1563,0
100102411908,100102411909,1,1520,1418,0
100103073108,100103073129,21,193,1406,0
100103758161,100103758162,1,31638,38204,0
100104971058,100104971057,-1,1326,1176,0
100105680961,100105680961,0,1657,1567,0
100105875206,100105875211,5,1812,804,0
100106100115,100106100113,-2,1076,1421,0
100106685844,100106685847,3,1004,1152,0
100107989290,100107989291,1,1476,1610,0
100108694675,100108694679,4,1866,1313,0
100109453247,100109453241,-6,46440,21903,0
100109633973,100109633975,2,1381,1528,0
100111116492,100111116495,3,1799,1674,0
100111375279,100111375280,1,917,1173,0
100111847969,100111847971,2,1095,1742,0
100112814747,100112814747,0,824,930,0
100113422139,100113422141,2,1764,1759,0
100114237694,100114237696,2,1467,1501,0
100114836559,100114836559,0,1504,1986,0
100114988564,100114988562,-2,1649,1170,0
100115449489,100115449493,4,3424,1809,0
100116242063,100116242063,0,1145,1301,0
100117404505,100117404510,5,8807,3996,0
100118085959,100118085961,2,1773,2072,0
100119120256,100119120258,2,1182,1128,0
100120225758,100120225759,1,1795,1830,0
100121963086,100121963087,1,1059,1522,0
100124613309,100124613302,-7,1179,1915,0
100125245981,100125245982,1,1154,1393,0
100125927526,100125927526,0,954,1696,0
100129934415,100129934415,0,1073,1651,0
100130499871,100130499873,2,1406,1772,0
100131202460,100131202468,8,1055,1202,0
100131592510,100131592514,4,985,1863,0
100133469474,100133469476,2,22425,40644,0
100133838562,100133838565,3,2107,1793,0
100135370209,100135370209,0,1135,1701,0
100135773132,100135773142,10,1480,1548,0
100136889031,100136889030,-1,1441,2057,0
100138315442,100138315443,1,1499,1650,0
100140655286,100140655289,3,1402,1229,0
100141332354,100141332354,0,948,1648,0
100142950353,100142950354,1,1219,1531,0
100143619997,100143619998,1,1596,1117,0
100144512070,100144512072,2,1892,2184,0
100151799674,100151799677,3,1677,1816,0
100154462031,100154462029,-2,1550,2577,0
100154982966,100154982960,-6,1523,3498,0
100157564926,100157564926,0,1298,1490,0
100159192080,100159192081,1,1384,2589,0
100165550922,100165550923,1,1464,1627,0
100165654297,100165654301,4,1400,1721,0
100168145632,100168145632,0,1618,1643,0
100170738715,100170738714,-1,1213,1915,0
100174136138,100174136141,3,1171,1476,0
100175944611,100175944612,1,1396,2117,0
100178763807,100178763806,-1,1412,1595,0
100181317186,100181317188,2,718,1161,0
100185027751,100185027750,-1,1187,1354,0
100185298983,100185298985,2,1339,1239,0
100186436131,100186436130,-1,1169,1183,0
100188762809,100188762807,-2,1121,1446,0
100188906590,100188906591,1,1874,2238,0
100189044768,100189044767,-1,959,1479,0
100189550688,100189550690,2,1103,1371,0
100190273287,100190273288,1,1507,1618,0
100190468352,100190468354,2,1702,2666,0
100191524242,100191524243,1,1033,1102,0
100191971888,100191971882,-6,1167,3374,0
100194808597,100194808596,-1,1192,1843,0
100196827725,100196827726,1,1381,1841,0
100200876794,100200876807,13,10067,41575,0
100202281826,100202281830,4,1253,1163,0
100204721731,100204721731,0,1541,2099,0
100206193558,100206193555,-3,1506,1696,0
100207828604,100207828603,-1,1874,2680,0
100212250257,100212250256,-1,1086,1755,0
100214148987,100214148987,0,1542,1900,0
100219639783,100219639785,2,1147,2038,0
100219679567,100219679569,2,928,912,0
100227565661,100227565660,-1,2003,2778,0
100230432881,100230432882,1,1376,1333,0
100232370855,100232370854,-1,1719,1501,0
100235237770,100235237770,0,1525,1510,0
100235303234,100235303213,-21,1246,1681,0
100238764393,100238764394,1,1217,1432,0
100241959842,100241959841,-1,1867,2319,0
100242980253,100242980250,-3,1316,810,0
100243010413,100243010413,0,1457,1518,0
100244985018,100244985018,0,1423,1150,0
100251285622,100251285624,2,1633,2226,0
100256657949,100256657950,1,1628,1897,0
100261133541,100261133542,1,1628,1657,0
100261736319,100261736315,-4,1260,2117,0
100264415031,100264415030,-1,1299,2008,0
100265264319,100265264326,7,2400,1430,0
100266245851,100266245853,2,818,1191,0
100269201555,100269201557,2,820,1445,0
100269545662,100269545662,0,1377,1930,0
100273893525,100273893527,2,1248,891,0
100277190301,100277190302,1,1116,1669,0
100279316223,100279316222,-1,1325,1848,0
100282453985,100282453989,4,1913,1504,0
100284086623,100284086626,3,1562,1808,0
100284115891,100284115893,2,1430,1480,0
100285055309,100285055307,-2,996,1509,0
100290018079,100290018078,-1,1383,1090,0
100290770296,100290770294,-2,1417,1908,0
100291974421,100291974414,-7,483,1579,0
100294956591,100294956590,-1,1045,1137,0
100298095875,100298095875,0,1695,1971,0
100300124269,100300124266,-3,1109,1299,0
100303408129,100303408128,-1,1483,1891,0
100306846050,100306846056,6,22739,55477,0
100311640103,100311640104,1,1820,2029,0
100314382765,100314382767,2,1244,1977,0
100315457899,100315457899,0,1161,1985,0
100317458643,100317458642,-1,1742,2101,0
100318549194,100318549195,1,1658,1295,0
100319135579,100319135580,1,1830,2168,0
100325138735,100325138735,0,1796,2124,0
100325952655,100325952655,0,1723,1615,0
100327108887,100327108888,1,1163,2142,0
100331830898,100331830898,0,1034,1611,0
100336092558,100336092559,1,1569,1483,0
100336230421,100336230423,2,1628,1950,0
100337674223,100337674237,14,1279,1222,0
100340092878,100340092879,1,1083,1461,0
100343724721,100343724720,-1,1077,1345,0
100344825444,100344825446,2,1567,1457,0
100346303302,100346303302,0,1360,1401,0
100348168111,100348168112,1,1607,2312,0
100348372245,100348372246,1,994,1754,0
100350385631,100350385631,0,1657,2153,0
100351927392,100351927394,2,1735,2405,0
100352392708,100352392708,0,1567,1618,0
100352740011,100352740015,4,1338,1005,0
100355250395,100355250395,0,1076,1541,0
100355951149,100355951150,1,1326,1839,0
100357893898,100357893897,-1,891,2179,0
100360563159,100360563161,2,1221,1283,0
100361905185,100361905185,0,1827,2554,0
100362784641,100362784641,0,1876,2485,0
100364805212,100364805213,1,1027,1938,0
100365730552,100365730543,-9,644,1766,0
100367161334,100367161334,0,1571,2190,0
100368862607,100368862607,0,1556,1694,0
100370823922,100370823923,1,1561,1319,0
100373235344,100373235341,-3,1089,2483,0
100375329586,100375329585,-1,1537,1357,0
100383398341,100383398341,0,1111,1296,0
100386904862,100386904862,0,975,1717,0
100387092258,100387092259,1,1678,1922,0
100387243470,100387243470,0,1266,1859,0
100388036921,100388036924,3,2658,1971,0
100389523334,100389523329,-5,1587,3729,0
100391444231,100391444231,0,1498,1909,0
100391773050,100391773052,2,1644,1581,0
100392255694,100392255694,0,1091,1580,0
100393106827,100393106829,2,1145,1224,0
100393932057,100393932061,4,17693,2751,0
100394687670,100394687674,4,1197,1332,0
100397234746,100397234743,-3,997,1948,0
100401201825,100401201825,0,1251,1494,0
100403287069,100403287070,1,1256,929,0
100407679402,100407679402,0,1346,2193,0
100408388991,100408388993,2,773,1406,0
100412122298,100412122299,1,948,1131,0
100412400156,100412400157,1,1847,1966,0
100414271005,100414271003,-2,1210,1756,0
100415649407,100415649405,-2,1245,1288,0
100416749022,100416749025,3,1047,1106,0
100419357435,100419357437,2,1485,1992,0
100419968514,100419968514,0,1141,1216,0
100420022920,100420022939,19,1672,1804,0
100420857473,100420857474,1,1673,2066,0
100422971754,100422971757,3,1264,1722,0
100424811525,100424811526,1,1425,1769,0
100427490670,100427490669,-1,1031,1402,0
100428145335,100428145335,0,1388,2531,0
100428263554,100428263554,0,1785,1712,0
100429198847,100429198847,0,1515,1653,0
100431147051,100431147051,0,1510,1833,0
100431178846,100431178845,-1,1044,1840,0
100431791136,100431791138,2,1616,1580,0
100432125550,100432125554,4,1237,1454,0
100432656555,100432656555,0,1135,1982,0
100433040409,100433040411,2,9208,8230,0
100433585152,100433585153,1,1555,1673,0
100434247245,100434247247,2,1752,1851,0
100436013637,100436013637,0,1466,1700,0
100436284231,100436284230,-1,1026,1262,0
100444516114,100444516115,1,1218,2049,0
100446414629,100446414631,2,1842,1865,0
100447340113,100447340114,1,829,1660,0
100452642548,100452642552,4,3188,2109,0
100461513245,100461513230,-15,649,1601,0
100466284030,100466284031,1,1467,1437,0
100467006826,100467006828,2,1251,1280,0
100470655942,100470655944,2,1682,1330,0
100472913891,100472913890,-1,973,2142,0
100473314977,100473314959,-18,1524,751,0
100474357590,100474357592,2,1087,1589,0
100474939869,100474939869,0,1101,1549,0
100475539334,100475539334,0,1472,2067,0
100478573240,100478573241,1,1366,1765,0
100479243488,100479243492,4,3367,1768,0
100480686164,100480686166,2,1752,1866,0
100482872702,100482872702,0,1082,1068,0
100486120602,100486120602,0,1358,1586,0
100488397777,100488397778,1,1234,1162,0
100492103582,100492103581,-1,905,1618,0
100497173794,100497173793,-1,745,1229,0
100500614402,100500614404,2,1425,1504,0
100503268831,100503268831,0,1597,2339,0
100503454422,100503454419,-3,1297,1693,0
100503873532,100503873525,-7,828,2273,0
100504967137,100504967139,2,1456,1275,0
100505464959,100505464958,-1,1047,1957,0
100506670404,100506670403,-1,1197,1333,0
100507182278,100507182280,2,51411,46857,0
100507463186,100507463188,2,947,2076,0
100508571586,100508571585,-1,1166,1819,0
100513711234,100513711232,-2,1363,1648,0
100515586111,100515586105,-6,1809,6785,0
100518048462,100518048463,1,1787,2109,0
100523372078,100523372076,-2,1252,2186,0
100527612726,100527612719,-7,2269,10391,0
100530750724,100530750726,2,1387,1638,0
100533960877,100533960878,1,1768,1865,0
100534455241,100534455242,1,1587,2065,0
100537363438,100537363438,0,864,1122,0
100540060747,100540060746,-1,1283,1561,0
100540148309,100540148319,10,1367,1409,0
100542133648,100542133646,-2,1586,1606,0
100543255709,100543255707,-2,1093,2117,0
100544212348,100544212348,0,1337,1642,0
100545759343,100545759342,-1,1445,1957,0
100549412254,100549412253,-1,1478,1466,0
100551188670,100551188674,4,844,1292,0
100552842922,100552842921,-1,1169,1553,0
100553048093,100553048095,2,1875,1466,0
100553312846,100553312846,0,1293,2047,0
100554588763,100554588763,0,1894,2820,0
100558325590,100558325591,1,1786,1477,0
100558576343,100558576342,-1,1778,2173,0
100558675994,100558675993,-1,1618,1708,0
100562407771,100562407771,0,1477,1984,0
100566422044,100566422033,-11,1362,1700,0
100571356002,100571356002,0,1285,1495,0
100572403008,100572403010,2,1297,1465,0
100572705705,100572705704,-1,1201,1281,0
100573783795,100573783790,-5,1508,3353,0
100576590177,100576590178,1,1303,1546,0
100578039161,100578039163,2,1089,1355,0
100578198163,100578198165,2,1495,2024,0
100578223627,100578223626,-1,1076,1161,0
100578372688,100578372688,0,1352,2293,0
100579127739,100579127738,-1,1228,2039,0
100581033704,100581033708,4,1080,1081,0
100582821555,100582821554,-1,1504,2171,0
100583036473,100583036473,0,1918,2028,0
100583320462,100583320464,2,1135,1384,0
100583719962,100583719962,0,1498,1864,0
100585979599,100585979600,1,1180,1641,0
100590662298,100590662298,0,1300,2252,0
100594324809,100594324802,-7,16,2202,0
100594740065,100594740062,-3,1611,1476,0
100597143029,100597143030,1,1803,1430,0
100598828550,100598828551,1,1525,1784,0
100602633982,100602633977,-5,670,2433,0
100608042576,100608042575,-1,1242,1592,0
100609461174,100609461175,1,1816,1618,0
100609593298,100609593299,1,1523,1724,0
100612886694,100612886696,2,1662,1330,0
100614151610,100614151610,0,953,1347,0
100614506415,100614506416,1,1709,1847,0
100617534245,100617534243,-2,1497,1471,0
100619764652,100619764651,-1,1734,1955,0
100620424831,100620424826,-5,924,2982,0
100622722443,100622722446,3,1100,1265,0
100628475066,100628475065,-1,822,1252,0
100633060031,100633060030,-1,1629,1977,0
100634216421,100634216422,1,1171,1275,0
100636271842,100636271842,0,1045,1540,0
100639097606,100639097607,1,1962,1458,0
100639781355,100639781358,3,1013,1104,0
100641796226,100641796226,0,1534,1660,0
100641905582,100641905583,1,1281,1765,0
100646806054,100646806055,1,1129,1176,0
100647679690,100647679692,2,1158,1267,0
100653696276,100653696276,0,1395,1612,0
100655877604,100655877603,-1,1699,2387,0
100660373635,100660373634,-1,1873,1531,0
100661267730,100661267729,-1,1592,2508,0
100663972569,100663972570,1,1430,1598,0
100664632938,100664632944,6,3403,2021,0
100664918766,100664918766,0,1761,1916,0
100666639946,100666639945,-1,1472,1598,0
100667025188,100667025186,-2,1412,1751,0
100670082638,100670082638,0,1317,1814,0
100673829807,100673829786,-21,1383,2148,0
100674257511,100674257513,2,1643,1499,0
100674474302,100674474305,3,1572,1275,0
100674581602,100674581605,3,1446,1170,0
100676095721,100676095725,4,1739,1677,0
100683488535,100683488536,1,1749,1549,0
100690611637,100690611638,1,1545,1023,0
100692252873,100692252875,2,1935,1444,0
100692891723,100692891723,0,1400,1463,0
100698000071,100698000071,0,1525,1418,0
100699173370,100699173371,1,1239,2197,0
100701618998,100701618999,1,1000,1052,0
100705358373,100705358373,0,1448,1751,0
100706340535,100706340553,18,899,3052,0
100706910513,100706910517,4,1538,1643,0
100711014095,100711014094,-1,946,1264,0
100713071406,100713071405,-1,1649,2014,0
100713510829,100713510828,-1,1260,1141,0
100718340880,100718340882,2,1609,1989,0
100718571641,100718571640,-1,1349,1682,0
100722527560,100722527562,2,1825,1806,0
100723141587,100723141591,4,1732,1509,0
100725182403,100725182403,0,1453,2168,0
100727515969,100727515970,1,1367,1814,0
100728562005,100728562008,3,1293,1531,0
100728754151,100728754146,-5,1365,1291,0
100731196753,100731196755,2,1248,1883,0
100732481358,100732481357,-1,1702,1740,0
100733139782,100733139783,1,1089,1259,0
100733946853,100733946854,1,1818,1884,0
100734927185,100734927186,1,994,1241,0
100735036123,100735036122,-1,1187,1521,0
100740428397,100740428395,-2,1037,994,0
100740665253,100740665274,21,647,669,0
100741035093,100741035094,1,1321,1514,0
100742256048,100742256050,2,1518,1859,0
100743905354,100743905356,2,1126,1684,0
100746431433,100746431431,-2,1433,2291,0
100749305304,100749305306,2,2159,1902,0
100749972617,100749972615,-2,1221,1541,0
100750626306,100750626306,0,1378,2457,0
100750849754,100750849753,-1,1450,2078,0
100754675179,100754675178,-1,1252,2442,0
100755472827,100755472827,0,2119,1375,0
100759751631,100759751629,-2,879,1432,0
100760333513,100760333514,1,1614,1733,0
100760682330,100760682328,-2,857,1245,0
100761568755,100761568754,-1,1459,1423,0
100763882144,100763882144,0,1161,1791,0
100764741655,100764741657,2,1339,1663,0
100766005007,100766005008,1,1592,1984,0
100766440421,100766440438,17,1263,1619,0
100769212326,100769212324,-2,1352,2600,0
100769976162,100769976163,1,1357,1878,0
100770851881,100770851881,0,1003,1061,0
100773255450,100773255450,0,1427,1787,0
100775290052,100775290063,11,1184,1129,0
100778229590,100778229589,-1,1274,1920,0
100779116780,100779116781,1,1075,935,0
100783898022,100783898021,-1,1642,1676,0
100784160320,100784160319,-1,1891,2470,0
100790743667,100790743665,-2,660,994,0
100794729140,100794729140,0,1106,1676,0
100795272946,100795272945,-1,1341,1880,0
100797404674,100797404676,2,1113,1389,0
100799099652,100799099653,1,1656,2049,0
100805889340,100805889342,2,1187,1280,0
100807970562,100807970564,2,1521,1579,0
100808815822,100808815821,-1,1121,1735,0
100811089835,100811089836,1,1718,1715,0
100811618980,100811618980,0,1177,1928,0
100812098140,100812098154,14,485,2693,0
100814233023,100814233022,-1,1616,2073,0
100815666726,100815666728,2,1369,2140,0
100817355600,100817355602,2,2338,1636,0
100821672973,100821672973,0,2130,2709,0
100823313786,100823313788,2,1612,2204,0
100825870234,100825870234,0,1561,1442,0
100831581412,100831581406,-6,1226,3637,0
100835662147,100835662146,-1,1690,1647,0
100836410459,100836410457,-2,1176,1439,0
100838124746,100838124747,1,1723,2093,0
100841634506,100841634503,-3,1738,1965,0
100843111715,100843111721,6,3668,1571,0
100848652651,100848652630,-21,1599,1163,0
100850861799,100850861799,0,1413,1212,0
100854934273,100854934273,0,1530,1328,0
100856959126,100856959143,17,1047,1348,0
100863969123,100863969123,0,1222,1524,0
100870542471,100870542469,-2,1045,1586,0
100876424258,100876424256,-2,1016,2661,0
100876717354,100876717354,0,935,1454,0
100882042205,100882042206,1,1332,1612,0
100887105285,100887105289,4,1234,1770,0
100889148486,100889148488,2,1842,1987,0
100892681541,100892681534,-7,1163,5678,0
100898176063,100898176065,2,906,1579,0
100898562854,100898562855,1,1063,1484,0
100899238611,100899238613,2,1593,2058,0
100900959933,100900959933,0,1612,1915,0
100904842459,100904842462,3,1596,1883,0
100905913136,100905913135,-1,1087,1298,0
100912034338,100912034343,5,1658,1363,0
100914666040,100914666042,2,2094,2923,0
100915141014,100915141016,2,1497,1630,0
100921369438,100921369440,2,1542,1897,0
100922309210,100922309211,1,975,896,0
100925337807,100925337808,1,1593,2317,0
100928716389,100928716390,1,1070,1967,0
100930224382,100930224374,-8,1096,7785,0
100930939661,100930939663,2,1425,1328,0
100931442570,100931442569,-1,855,1317,0
100932478286,100932478287,1,1673,1740,0
100932635131,100932635130,-1,1419,1614,0
100932991698,100932991698,0,1185,1830,0
100937256894,100937256893,-1,1668,1791,0
100937777037,100937777042,5,5524,1606,0
100938128189,100938128190,1,1494,1808,0
100942100823,100942100825,2,2163,1736,0
100943836881,100943836883,2,1321,1332,0
100946200446,100946200447,1,981,1634,0
100948057160,100948057161,1,1372,1694,0
100950573075,100950573074,-1,1356,1979,0
100957930394,100957930398,4,1676,1312,0
100961829964,100961829981,17,7483,14922,0
100965660295,100965660295,0,1092,1610,0
100970591165,100970591164,-1,1247,1180,0
100971378459,100971378462,3,1025,1061,0
100972841825,100972841826,1,1506,1681,0
100972891682,100972891680,-2,1022,1318,0
100974220690,100974220686,-4,1544,2268,0
100976756925,100976756927,2,1753,2016,0
100977510445,100977510443,-2,1247,1507,0
100983425864,100983425863,-1,1562,2315,0
100986379903,100986379902,-1,1107,1602,0
100987650324,100987650325,1,1797,1754,0
100989756062,100989756063,1,2106,1977,0
100990419752,100990419754,2,1478,1714,0
100990458320,100990458325,5,4060,2566,0
100990548023,100990548023,0,1006,1206,0
100992745329,100992745326,-3,1085,2194,0
100998104398,100998104397,-1,1279,1585,0
100999541377,100999541377,0,1573,1623,0
101000059879,101000059859,-20,1192,2234,0
101000918245,101000918247,2,841,1396,0
101004323942,101004323943,1,1477,1480,0
101004449262,101004449261,-1,1000,1348,0
101005610731,101005610735,4,2139,999,0
101006951085,101006951085,0,944,1097,0
101009085125,101009085126,1,1008,1447,0
101009562785,101009562786,1,1041,1689,0
101010512842,101010512842,0,886,1621,0
101010611374,101010611374,0,1161,1411,0
101011163626,101011163626,0,1461,2023,0
101014653533,101014653533,0,1887,2121,0
101016008469,101016008470,1,1175,1668,0
101019291856,101019291857,1,1289,1732,0
101019689254,101019689253,-1,1717,1961,0
101022150138,101022150138,0,1060,1194,0
101023976902,101023976901,-1,1026,2266,0
101025348254,101025348253,-1,1658,1561,0
101030420605,101030420625,20,1433,1930,0
101032029646,101032029647,1,1367,1248,0
101032341298,101032341298,0,1756,1616,0
101035180594,101035180596,2,1542,826,0
101035208379,101035208374,-5,1400,1090,0
101036599647,101036599648,1,1603,2067,0
101039890410,101039890406,-4,6243,13656,0
101043336699,101043336697,-2,1918,2648,0
101043890437,101043890438,1,974,1727,0
101046688366,101046688365,-1,995,1356,0
101047383471,101047383473,2,868,1477,0
101052064708,101052064707,-1,1919,2729,0
101053608772,101053608766,-6,1444,3221,0
101059416534,101059416536,2,1824,1882,0
101060639438,101060639441,3,2107,1688,0
101061621152,101061621151,-1,1529,1469,0
101062818229,101062818228,-1,1361,1293,0
101065433506,101065433514,8,14007,29387,0
101066383647,101066383646,-1,1314,1750,0
101068861023,101068861030,7,4290,1590,0
101070205369,101070205367,-2,1394,1990,0
101070858546,101070858547,1,1507,2354,0
101074297370,101074297370,0,1570,2415,0
101075067029,101075067029,0,1056,1544,0
101076384217,101076384218,1,1639,1810,0
101079864830,101079864832,2,1654,1288,0
101083237810,101083237811,1,535,1323,0
101089501175,101089501177,2,1555,1701,0
101090991346,101090991347,1,1250,1195,0
101092881279,101092881278,-1,2195,2097,0
101097948401,101097948402,1,1563,1447,0
101105758079,101105758080,1,9107,19721,0
101106444322,101106444321,-1,1449,1402,0
101107017107,101107017107,0,1321,1766,0
101109483262,101109483261,-1,1323,2595,0
101113131651,101113131653,2,1552,1593,0
101119174868,101119174869,1,1656,2226,0
101120979985,101120979985,0,1118,1624,0
101122374790,101122374791,1,2048,2318,0
101125452214,101125452214,0,1562,1527,0
101127847860,101127847864,4,1404,1280,0
101130219554,101130219556,2,1418,2318,0
101131921378,101131921379,1,1229,1810,0
101136557458,101136557457,-1,918,1447,0
101139123028,101139123032,4,3423,1316,0
101140759505,101140759504,-1,1628,1723,0
101142368896,101142368897,1,1176,1441,0
101142756412,101142756410,-2,850,1265,0
101150104517,101150104518,1,1778,2481,0
101151587038,101151587040,2,975,1776,0
101152459759,101152459763,4,1682,1557,0
101153474885,101153474886,1,1619,2067,0
101153612751,101153612750,-1,2075,2091,0
101154964995,101154964997,2,1657,1752,0
101158854471,101158854472,1,1467,2155,0
101158963442,101158963442,0,1665,1776,0
101159589293,101159589294,1,1805,2091,0
101160354334,101160354333,-1,1047,1097,0
101161395042,101161395042,0,1120,1614,0
101163703227,101163703226,-1,1561,1883,0
101167062518,101167062520,2,1499,1711,0
101167359149,101167359149,0,2035,1942,0
101167597543,101167597542,-1,1341,1954,0
101169301252,101169301254,2,1196,1329,0
101171137200,101171137193,-7,10692,14237,0
101172263601,101172263600,-1,1426,2054,0
101175942245,101175942244,-1,1522,1435,0
101176409137,101176409138,1,1416,1322,0
101182998334,101182998334,0,1530,1806,0
101184952171,101184952171,0,1318,1788,0
101185297201,101185297200,-1,1400,1618,0
101190935481,101190935482,1,1885,1764,0
101191386426,101191386426,0,1393,2298,0
101192447115,101192447114,-1,1356,1638,0
101192966090,101192966089,-1,1529,1896,0
101194093458,101194093457,-1,1918,2731,0
101197840933,101197840933,0,1380,1681,0
101199730232,101199730234,2,1250,1691,0
101200717102,101200717102,0,1829,1902,0
101200889794,101200889794,0,1435,1432,0
101201062496,101201062495,-1,1669,2475,0
101203024682,101203024682,0,1040,1162,0
101204411999,101204412000,1,1522,2231,0
101210359051,101210359053,2,1313,1634,0
101210834075,101210834077,2,1052,1397,0
101221614204,101221614201,-3,1139,2509,0
101223664314,101223664314,0,1010,1343,0
101225237358,101225237360,2,1006,1154,0
101228375586,101228375586,0,1243,1843,0
101228911333,101228911327,-6,1042,1962,0
101231007443,101231007445,2,937,1373,0
101233684127,101233684130,3,1478,1689,0
101233915811,101233915813,2,1219,1579,0
101234412017,101234412022,5,2444,1470,0
101234769589,101234769590,1,1650,1687,0
101239311399,101239311398,-1,1770,1560,0
101242723686,101242723686,0,1817,1832,0
101247355910,101247355909,-1,1400,2051,0
101254792754,101254792755,1,1965,1574,0
101255118521,101255118522,1,1317,1633,0
101257324090,101257324093,3,1007,1089,0
101258645195,101258645172,-23,835,1782,0
101259383306,101259383306,0,1610,1812,0
101266324155,101266324154,-1,1925,1710,0
101266915938,101266915939,1,1767,1444,0
101268932597,101268932597,0,1489,1669,0
101269501920,101269501920,0,1231,1617,0
101270742463,101270742463,0,1232,1887,0
101273732050,101273732051,1,1436,1967,0
101273958894,101273958892,-2,1079,1906,0
101275592591,101275592590,-1,1119,1504,0
101278610471,101278610467,-4,1226,2129,0
101279633758,101279633757,-1,1146,2023,0
101280620830,101280620833,3,1237,1808,0
101282400063,101282400065,2,999,1617,0
101288001595,101288001594,-1,1647,1138,0
101289525386,101289525385,-1,1228,1672,0
101291747586,101291747585,-1,1030,1474,0
101293391837,101293391838,1,1359,1603,0
101294198485,101294198485,0,1465,1768,0
101297395194,101297395195,1,1571,2234,0
101297986583,101297986584,1,1230,1444,0
101302595326,101302595327,1,1086,1747,0
101305091326,101305091325,-1,741,1467,0
101306123705,101306123703,-2,1029,1899,0
101307944183,101307944185,2,976,1191,0
101315337861,101315337860,-1,1628,1194,0
101317906671,101317906670,-1,932,1138,0
101318237566,101318237567,1,1817,1607,0
101320865256,101320865257,1,1487,1428,0
101321185534,101321185514,-20,1381,1338,0
101321764687,101321764687,0,1220,1462,0
101323034313,101323034313,0,1317,1497,0
101323487705,101323487706,1,1036,1134,0
101323818454,101323818455,1,1684,2192,0
101324396932,101324396932,0,1135,1348,0
101328417067,101328417068,1,1492,2060,0
101328819395,101328819395,0,1025,2054,0
101333442128,101333442124,-4,2019,4748,0
101335124869,101335124870,1,1448,2859,0
101335454094,101335454094,0,1496,1524,0
101336036439,101336036438,-1,981,1979,0
101339080444,101339080446,2,1536,1682,0
101343193498,101343193498,0,1553,1669,0
101344622186,101344622194,8,9771,37417,0
101346907547,101346907550,3,1338,1815,0
101347898124,101347898126,2,1315,971,0
101352031062,101352031061,-1,904,1031,0
101354302931,101354302932,1,1316,1290,0
101355118102,101355118101,-1,869,1494,0
101356458770,101356458771,1,1348,2085,0
101359112803,101359112805,2,1320,1308,0
101360441394,101360441395,1,879,1010,0
101362686766,101362686766,0,613,1993,0
101363940154,101363940154,0,883,1493,0
101365482073,101365482073,0,1311,1822,0
101366826967,101366826964,-3,1023,2108,0
101367686194,101367686195,1,1143,1962,0
101373067541,101373067541,0,1459,1651,0
101374622666,101374622667,1,959,1324,0
101376184149,101376184151,2,925,1331,0
101378877747,101378877747,0,1220,1877,0
101380337547,101380337549,2,1099,907,0
101384923466,101384923465,-1,1127,1394,0
101386441269,101386441270,1,1123,1593,0
101387425778,101387425780,2,1104,1744,0
101388304683,101388304684,1,1441,1557,0
101390653734,101390653734,0,1680,1679,0
101392455906,101392455903,-3,515,300,0
101393194405,101393194406,1,1633,1917,0
101393795049,101393795049,0,1574,1892,0
101394473761,101394473762,1,1087,1726,0
101395265081,101395265083,2,1323,1988,0
101395377763,101395377765,2,1958,1873,0
101397498529,101397498531,2,1171,1707,0
101399463982,101399463983,1,1021,1175,0
101402176464,101402176465,1,2009,2248,0
101403886079,101403886078,-1,989,1812,0
101405182921,101405182922,1,974,1521,0
101405986498,101405986499,1,1366,2129,0
101406515298,101406515298,0,1709,1770,0
101407753199,101407753200,1,1982,1489,0
101409645897,101409645898,1,1349,1567,0
101410237338,101410237354,16,1030,1581,0
101412697140,101412697141,1,1653,1728,0
101414426002,101414426005,3,1711,1605,0
101417369490,101417369490,0,1937,1110,0
101418175402,101418175403,1,1626,1532,0
101419117334,101419117336,2,1079,1544,0
101419684826,101419684825,-1,1655,2418,0
101419803048,101419803048,0,1014,1601,0
101422209554,101422209554,0,896,1042,0
101423025998,101423026005,7,2144,1126,0
101423307895,101423307892,-3,872,2473,0
101423483367,101423483369,2,1018,1168,0
101425856429,101425856429,0,1595,1886,0
101427698141,101427698141,0,1871,2061,0
101428858378,101428858378,0,1752,1465,0
101429721730,101429721731,1,931,1613,0
101431665438,101431665438,0,1669,1588,0
101432179438,101432179439,1,1698,1082,0
101433496158,101433496159,1,1254,1864,0
101434953749,101434953751,2,1584,1703,0
101436380838,101436380838,0,1323,1388,0
101439638127,101439638122,-5,1488,3552,0
101443263107,101443263107,0,1054,2072,0
101443822519,101443822519,0,937,1647,0
101444237821,101444237821,0,1615,1683,0
101447365709,101447365710,1,1075,1286,0
101447772110,101447772118,8,2145,574,0
101448034287,101448034286,-1,1028,1649,0
101448409916,101448409917,1,1843,2293,0
101450401133,101450401137,4,1928,1138,0
101453205663,101453205665,2,1171,1472,0
101453975663,101453975660,-3,1546,2226,0
101454320960,101454320961,1,1343,1436,0
101456543840,101456543839,-1,1140,1509,0
101457204039,101457204041,2,1865,1617,0
101457329337,101457329338,1,1252,1859,0
101458521258,101458521258,0,1566,2195,0
101458819966,101458819965,-1,1961,2614,0
101459709896,101459709897,1,1533,2088,0
101466207986,101466207986,0,1386,1554,0
101467641900,101467641900,0,1706,1548,0
101467744918,101467744918,0,1059,2159,0
101469701530,101469701528,-2,1422,2243,0
101471821343,101471821343,0,1561,1344,0
101472732821,101472732815,-6,2025,7437,0
101473919892,101473919893,1,1351,2039,0
101476614394,101476614393,-1,1401,2340,0
101478195665,101478195665,0,1207,1703,0
101478909447,101478909433,-14,371,1236,0
101481694647,101481694648,1,1851,1559,0
101482198847,101482198847,0,1621,1382,0
101485327949,101485327950,1,1288,2163,0
101491407418,101491407419,1,1640,2512,0
101494375122,101494375131,9,3110,898,0
101495735966,101495735966,0,1136,1652,0
101496727722,101496727722,0,1762,2211,0
101496936286,101496936289,3,1765,2039,0
101498087779,101498087780,1,1535,1512,0
101501447560,101501447559,-1,1174,1836,0
101505227365,101505227363,-2,1427,1481,0
101506684232,101506684235,3,1267,1434,0
101507451658,101507451664,6,2835,1451,0
101509394283,101509394285,2,772,1247,0
101510725563,101510725563,0,1530,2330,0
101513752999,101513752999,0,1488,1388,0
101515021967,101515021967,0,1423,1886,0
101515465550,101515465551,1,1329,1646,0
101520962421,101520962424,3,1299,1688,0
101521967082,101521967084,2,1555,1976,0
101523937210,101523937214,4,1254,1194,0
101524297877,101524297878,1,1118,1334,0
101525757454,101525757455,1,3053,4629,0
101532539390,101532539390,0,1630,1861,0
101537227315,101537227312,-3,806,1590,0
101539129970,101539129970,0,1406,2038,0
101543934849,101543934848,-1,1642,1854,0
101547268476,101547268477,1,1486,1466,0
101549075519,101549075519,0,1409,1987,0
101551210983,101551210981,-2,1249,2097,0
101553108735,101553108735,0,931,835,0
101553704103,101553704105,2,2146,1759,0
101555731391,101555731393,2,1356,1554,0
101559507424,101559507425,1,1086,1294,0
101561023120,101561023120,0,1267,1696,0
101561088455,101561088457,2,1609,2031,0
101562068832,101562068833,1,1564,1625,0
101566653421,101566653421,0,938,1452,0
101567960443,101567960445,2,1172,1310,0
101568396893,101568396892,-1,988,1869,0
101571255602,101571255604,2,1861,1982,0
101571685754,101571685754,0,1548,1449,0
101573243458,101573243458,0,1470,1669,0
101574154942,101574154946,4,1777,1762,0
101577507195,101577507195,0,1384,1489,0
101580662909,101580662910,1,1537,2313,0
101583796623,101583796622,-1,1451,1453,0
101584095970,101584095970,0,932,1366,0
101585403671,101585403671,0,1172,1211,0
101588772694,101588772694,0,1465,1822,0
101589949609,101589949609,0,1290,1739,0
101590686127,101590686138,11,11957,34796,0
101592169458,101592169458,0,1815,2064,0
101593320242,101593320244,2,914,1274,0
101594811203,101594811202,-1,1723,1823,0
101596329227,101596329226,-1,1231,1222,0
101600641622,101600641622,0,1314,1817,0
101601256094,101601256094,0,1776,2167,0
101602190106,101602190107,1,1747,1752,0
101603002146,101603002164,18,1689,1437,0
101604514253,101604514253,0,1505,1735,0
101612568431,101612568431,0,1513,1671,0
101613423065,101613423067,2,1100,1173,0
101613954268,101613954268,0,2060,1817,0
101615098968,101615098970,2,1675,1782,0
101615512871,101615512872,1,1353,1667,0
101616957594,101616957599,5,2280,1188,0
101620226018,101620226018,0,969,1227,0
101622281027,101622281030,3,1884,1408,0
101627113630,101627113631,1,2146,1706,0
101628438630,101628438629,-1,1621,1790,0
101629992719,101629992719,0,1315,1759,0
101634114966,101634114969,3,1681,1329,0
101636289333,101636289330,-3,1808,3544,0
101637368969,101637368971,2,1339,1712,0
101638095489,101638095490,1,1441,1761,0
101638692951,101638692951,0,1420,1273,0
101644214862,101644214869,7,1948,1066,0
101644792689,101644792690,1,999,1631,0
101649795851,101649795853,2,1428,1099,0
101662719734,101662719735,1,1958,2868,0
101668077526,101668077526,0,1270,1502,0
101670529602,101670529604,2,1531,1737,0
101671851173,101671851175,2,1456,979,0
101673566399,101673566399,0,681,1419,0
101675880097,101675880095,-2,1078,2086,0
101679350915,101679350916,1,1756,1738,0
101695142587,101695142590,3,1540,1479,0
101696598658,101696598658,0,1611,1557,0
101698473397,101698473396,-1,1200,2456,0
101699605558,101699605556,-2,942,1764,0
101701855191,101701855191,0,1370,1945,0
101704858936,101704858952,16,1658,1762,0
101706140982,101706140982,0,1746,2116,0
101708974876,101708974874,-2,1715,1421,0
101709669522,101709669519,-3,1034,1421,0
101710295034,101710295034,0,1530,1874,0
101714639590,101714639591,1,1548,1983,0
101715812088,101715812089,1,1364,2133,0
101716003919,101716003919,0,937,1684,0
101716121857,101716121858,1,1216,2065,0
101719556627,101719556629,2,1375,2467,0
101722443178,101722443178,0,987,1782,0
101722732686,101722732685,-1,3848,6191,0
101722828373,101722828379,6,4576,3055,0
101724500638,101724500638,0,1575,2088,0
101725591558,101725591559,1,1944,1939,0
101726916098,101726916098,0,1605,1722,0
101731430718,101731430719,1,1678,1994,0
101734147995,101734147997,2,1024,1779,0
101734762921,101734762921,0,1424,2137,0
101736567801,101736567802,1,1571,1985,0
101740084380,101740084379,-1,1374,1996,0
101741353154,101741353154,0,784,1905,0
101743194562,101743194563,1,1758,2507,0
101743434046,101743434042,-4,2376,6624,0
101743544254,101743544256,2,1181,1549,0
101744839203,101744839203,0,1064,1437,0
101745247001,101745247003,2,1502,1422,0
101749333545,101749333545,0,1651,2130,0
101750246023,101750246022,-1,968,1297,0
101751474346,101751474352,6,2301,935,0
101752981590,101752981591,1,1014,1657,0
101757778631,101757778631,0,1801,2086,0
101757977797,101757977798,1,1382,1552,0
101758751945,101758751946,1,1328,1531,0
101759030662,101759030663,1,1281,1505,0
101760059870,101760059870,0,1184,1422,0
101760148563,101760148566,3,1189,2102,0
101760956759,101760956758,-1,1179,2090,0
101763943543,101763943542,-1,1287,1385,0
101764571390,101764571390,0,1145,1498,0
101765788183,101765788189,6,4520,1946,0
101770434207,101770434210,3,2114,2145,0
101771790578,101771790580,2,968,1129,0
101773459158,101773459157,-1,1155,1628,0
101773639128,101773639130,2,1763,1332,0
101776788362,101776788363,1,1641,2326,0
101776867066,101776867067,1,758,834,0
101778295230,101778295230,0,1850,2001,0
101778839408,101778839409,1,1176,1868,0
101781934298,101781934297,-1,864,1353,0
101782766346,101782766346,0,1792,2609,0
101782812347,101782812346,-1,1309,1415,0
101791876091,101791876091,0,1193,947,0
101793820822,101793820822,0,1395,1850,0
101799978593,101799978593,0,1871,1952,0
101807256329,101807256331,2,1475,2219,0
101807600364,101807600359,-5,1095,1589,0
101810398995,101810398994,-1,1063,1265,0
101810835632,101810835634,2,1273,1490,0
101815477965,101815477964,-1,1202,1557,0
101816322615,101816322614,-1,1111,1567,0
101816684525,101816684530,5,2314,1439,0
101817187933,101817187934,1,1507,1644,0
101817458029,101817458029,0,1649,1747,0
101817682510,101817682510,0,2481,4286,0
101820109939,101820109942,3,1025,938,0
101823110006,101823110007,1,1221,1839,0
101824991706,101824991684,-22,2521,1186,0
101827132659,101827132659,0,1604,2088,0
101831815762,101831815762,0,1972,1685,0
101835050390,101835050390,0,997,1052,0
101837390658,101837390660,2,1357,1715,0
101838658074,101838658069,-5,557,3445,0
101840111547,101840111548,1,1697,1806,0
101840586109,101840586109,0,1180,1808,0
101842725898,101842725895,-3,1381,1688,0
101843174790,101843174793,3,1680,1783,0
101844039573,101844039573,0,1811,2073,0
101848718782,101848718783,1,896,1490,0
101849690304,101849690303,-1,1103,1389,0
101851258509,101851258522,13,280,2238,0
101851824799,101851824785,-14,347,2065,0
101855910185,101855910185,0,1118,1554,0
101857566235,101857566242,7,10452,30290,0
101859682006,101859682007,1,1016,1148,0
101861000168,101861000169,1,1722,2201,0
101861222231,101861222232,1,1613,1332,0
101868760494,101868760495,1,1088,1684,0
101869184577,101869184575,-2,1040,1323,0
101870718211,101870718211,0,1882,1552,0
101879199319,101879199318,-1,1175,1257,0
101880637710,101880637694,-16,1124,1706,0
101881525929,101881525931,2,1442,1805,0
101893747099,101893747098,-1,1149,1418,0
101894118829,101894118829,0,1446,1795,0
101895284255,101895284256,1,969,1424,0
101895919310,101895919318,8,1259,1442,0
101900147058,101900147062,4,1956,1994,0
101902395511,101902395508,-3,879,2182,0
101905606380,101905606379,-1,1658,2457,0
101906044684,101906044684,0,27976,2017,0
101908706133,101908706134,1,789,1296,0
101910517848,101910517850,2,996,951,0
101910678169,101910678171,2,1792,1750,0
101912496545,101912496546,1,1109,1656,0
101913681873,101913681874,1,1710,1841,0
101914994609,101914994610,1,1339,1614,0
101916237867,101916237870,3,1736,1471,0
101917646138,101917646141,3,1833,1878,0
101918149673,101918149671,-2,1116,981,0
101921319459,101921319460,1,1776,1851,0
101924537566,101924537566,0,1243,2013,0
101925436196,101925436194,-2,1016,1114,0
101930631663,101930631661,-2,1758,2568,0
101930681958,101930681958,0,1125,1361,0
101931420754,101931420755,1,1415,1455,0
101931973991,101931973993,2,1225,955,0
101935597270,101935597271,1,1499,1460,0
101936130178,101936130178,0,1534,1589,0
101936576627,101936576623,-4,2647,4570,0
101939541674,101939541679,5,2405,1400,0
101941151528,101941151534,6,2401,1261,0
101946518284,101946518285,1,2119,2413,0
101947408470,101947408471,1,761,1118,0
101948596344,101948596346,2,1477,1550,0
101950029933,101950029920,-13,1039,1528,0
101951404458,101951404458,0,1512,1759,0
101951547546,101951547546,0,1566,2054,0
101952969156,101952969157,1,1617,1674,0
101953690387,101953690386,-1,1921,1980,0
101955981402,101955981397,-5,23249,9654,0
101964497326,101964497324,-2,2115,4303,0
101965717009,101965717008,-1,1368,1518,0
101968247234,101968247234,0,1441,1285,0
101972305835,101972305834,-1,1008,2084,0
101972635146,101972635148,2,820,1124,0
101973007734,101973007731,-3,1054,1465,0
101973733702,101973733703,1,1594,1586,0
101977017635,101977017635,0,1277,1325,0
101979566458,101979566459,1,1456,1210,0
101980248350,101980248349,-1,1814,1880,0
101982564464,101982564462,-2,1232,1746,0
101982851398,101982851399,1,1718,1727,0
101986734298,101986734298,0,1893,1864,0
101989611786,101989611788,2,1302,1083,0
101994124923,101994124924,1,1548,2326,0
101998186822,101998186819,-3,1446,2107,0
101998249333,101998249333,0,1232,1749,0
102003359553,102003359554,1,1097,1108,0
102003843078,102003843078,0,1219,1261,0
102014130915,102014130917,2,1749,1522,0
102014738156,102014738136,-20,1095,1093,0
102017095999,102017095982,-17,1875,533,0
102018925408,102018925410,2,1054,1479,0
102019383680,102019383681,1,1496,1377,0
102019589746,102019589746,0,1662,1614,0
102019779953,102019779951,-2,1118,1907,0
102023323099,102023323102,3,1776,1709,0
102024698790,102024698793,3,1561,2275,0
102025461386,102025461386,0,1253,1988,0
102025577238,102025577241,3,1554,1328,0
102029998101,102029998101,0,1497,1837,0
102030387791,102030387778,-13,381,1154,0
102030652158,102030652159,1,1986,2206,0
102033303070,102033303069,-1,966,1477,0
102033845122,102033845125,3,1873,1535,0
102033935198,102033935198,0,1458,2337,0
102034232419,102034232420,1,1721,1690,0
102035296541,102035296541,0,1542,1694,0
102037190294,102037190295,1,1517,2323,0
102038415695,102038415695,0,1630,1768,0
102039279650,102039279654,4,1190,725,0
102039588590,102039588590,0,1990,1987,0
102040517263,102040517263,0,1784,1627,0
102040588904,102040588905,1,1198,1521,0
102041277161,102041277162,1,1045,1161,0
102045346319,102045346319,0,978,2200,0
102048575521,102048575526,5,11185,6180,0
102048964926,102048964927,1,1579,2076,0
102049041477,102049041478,1,1420,1862,0
102050059412,102050059419,7,3121,1227,0
102050591077,102050591077,0,1826,1849,0
102053639560,102053639561,1,1312,1564,0
102054761637,102054761640,3,973,1231,0
102056614751,102056614751,0,1626,1730,0
102059283337,102059283337,0,1442,1528,0
102060714593,102060714594,1,1307,1730,0
102062435127,102062435118,-9,25467,13259,0
102065706354,102065706352,-2,1273,1559,0
102069199943,102069199944,1,1057,1483,0
102070174778,102070174780,2,1128,1503,0
102075632269,102075632269,0,1723,1575,0
102076411870,102076411869,-1,992,1327,0
102076741251,102076741253,2,1303,1689,0
102079115089,102079115090,1,1435,1704,0
102080781445,102080781447,2,1573,1657,0
102081770533,102081770534,1,1414,1496,0
102083526680,102083526678,-2,1400,1715,0
102084295519,102084295521,2,1747,2206,0
102085442930,102085442933,3,1248,1862,0
102089316106,102089316106,0,1053,1629,0
102089492350,102089492346,-4,1014,2299,0
102094253896,102094253897,1,1574,2143,0
102100253521,102100253524,3,1515,1123,0
102100964381,102100964383,2,965,1161,0
102112827115,102112827117,2,1278,1904,0
102113335912,102113335912,0,1619,2093,0
102115398269,102115398270,1,1104,1435,0
102117582416,102117582416,0,1731,2014,0
102121079062,102121079061,-1,1194,1761,0
102128058287,102128058286,-1,863,1484,0
102129587272,102129587271,-1,1287,1976,0
102129630462,102129630461,-1,1890,2305,0
102132258678,102132258686,8,3338,1745,0
102136709587,102136709588,1,1551,2159,0
102138835415,102138835415,0,794,1121,0
102140206397,102140206398,1,1244,1517,0
102140341782,102140341782,0,1284,2098,0
102140933963,102140933963,0,1396,1750,0
102142440268,102142440261,-7,1257,1816,0
102146180380,102146180379,-1,1662,2133,0
102147908741,102147908742,1,1125,1347,0
102148540327,102148540326,-1,850,2212,0
102148773116,102148773117,1,1021,1534,0
102151711783,102151711783,0,970,1164,0
102153865759,102153865761,2,1359,1568,0
102158970174,102158970175,1,1113,1078,0
102161153587,102161153589,2,1108,1163,0
102161318687,102161318690,3,1278,1219,0
102161767891,102161767891,0,1635,1844,0
102163336648,102163336649,1,1508,1611,0
102164624148,102164624149,1,1516,1604,0
102165154772,102165154773,1,1267,1289,0
102167783774,102167783775,1,1079,1614,0
102171755479,102171755479,0,1632,1405,0
102172193391,102172193393,2,998,1959,0
102174194870,102174194871,1,1142,1070,0
102178790610,102178790613,3,1258,1963,0
102180231159,102180231157,-2,813,1163,0
102181699993,102181700012,19,1270,2573,0
102182376406,102182376406,0,1323,2083,0
102182741162,102182741160,-2,1079,1875,0
102183300371,102183300373,2,1158,1192,0
102185608413,102185608415,2,1155,1344,0
102188545179,102188545182,3,1644,1722,0
102188611756,102188611755,-1,1697,1347,0
102188849338,102188849340,2,1844,1629,0
102192075626,102192075626,0,1448,1732,0
102195181438,102195181438,0,900,1831,0
102198489463,102198489463,0,996,1687,0
102200455141,102200455140,-1,1096,1059,0
102200994917,102200994918,1,35060,36884,0
102204924088,102204924088,0,1525,1764,0
102208037004,102208037002,-2,1250,1152,0
102208644519,102208644520,1,1100,1549,0
102209715769,102209715766,-3,1199,1283,0
102209897408,102209897424,16,1156,1117,0
102214671984,102214671983,-1,1760,1826,0
102214891213,102214891207,-6,1348,4396,0
102217071609,102217071611,2,1211,1429,0
102222118253,102222118253,0,1186,1564,0
102228295890,102228295893,3,1410,1411,0
102229003915,102229003915,0,1560,1819,0
102233672142,102233672146,4,3878,3081,0
102236093182,102236093185,3,1650,1937,0
102240998893,102240998894,1,929,1562,0
102243500891,102243500891,0,1292,1790,0
102244985285,102244985286,1,1017,1702,0
102245136653,102245136650,-3,1582,1624,0
102245705978,102245705977,-1,1479,1813,0
102251642310,102251642310,0,1910,1273,0
102251984366,102251984369,3,1425,1452,0
102252397428,102252397431,3,1540,1422,0
102256261353,102256261353,0,1411,1290,0
102258001298,102258001298,0,1097,1692,0
102261462765,102261462766,1,1517,1919,0
102262828346,102262828346,0,2111,2787,0
102264387977,102264387978,1,1437,1844,0
102264814956,102264814939,-17,1351,1607,0
102266128765,102266128765,0,1804,1847,0
102270548685,102270548683,-2,1043,1392,0
102271548002,102271548002,0,1012,1519,0
102271777802,102271777804,2,1243,1016,0
102273271092,102273271094,2,781,1070,0
102275900920,102275900917,-3,1198,3255,0
102276343836,102276343841,5,2618,1760,0
102277581877,102277581878,1,1494,1606,0
102278531207,102278531207,0,1699,1921,0
102282211997,102282212000,3,1502,1613,0
102286193494,102286193494,0,1197,1506,0
102287434611,102287434614,3,1746,1813,0
102288468769,102288468757,-12,1123,1667,0
102289464022,102289464018,-4,1134,2082,0
102290184455,102290184454,-1,1497,2134,0
102290672866,102290672866,0,1010,1924,0
102290964473,102290964473,0,28334,35837,0
102291958126,102291958129,3,422,1160,0
102294118039,102294118040,1,1564,1709,0
102295063565,102295063565,0,1613,1945,0
102297611638,102297611637,-1,814,1576,0
102300582571,102300582571,0,1386,1137,0
102302466996,102302467015,19,1282,1506,0
102303784479,102303784479,0,1566,2004,0
102303945686,102303945686,0,1615,1283,0
102307956734,102307956733,-1,1564,1879,0
102308532965,102308532967,2,1633,1492,0
102311949038,102311949038,0,1829,1454,0
102313213095,102313213098,3,1499,1690,0
102313664420,102313664417,-3,985,1245,0
102317071867,102317071865,-2,886,3094,0
102319388243,102319388242,-1,974,1585,0
102321569931,102321569934,3,1578,1752,0
102321724762,102321724762,0,2341,2126,0
102322220970,102322220971,1,1323,1440,0
102323696030,102323696030,0,1300,1582,0
102323830999,102323830998,-1,875,1720,0
102328940015,102328940012,-3,30407,28364,0
102330124529,102330124527,-2,1983,2258,0
102335828781,102335828782,1,1743,2031,0
102335998485,102335998470,-15,1570,2364,0
102337215349,102337215348,-1,1707,2689,0
102338774878,102338774883,5,1368,1235,0
102344940778,102344940778,0,1200,1384,0
102347675038,102347675038,0,1354,1736,0
102348396725,102348396725,0,1178,1501,0
102348616279,102348616278,-1,1009,1193,0
102353452671,102353452672,1,1144,2151,0
102356708757,102356708757,0,1875,1533,0
102360809694,102360809695,1,1536,1689,0
102361943012,102361943012,0,1327,1946,0
102364553910,102364553911,1,1225,2355,0
102366329817,102366329818,1,1231,1863,0
102372048383,102372048381,-2,4823,9113,0
102374212121,102374212120,-1,1534,1693,0
102377881258,102377881258,0,2093,2542,0
102378623306,102378623307,1,1452,1559,0
102380023875,102380023877,2,1614,1525,0
102383872769,102383872769,0,1043,1985,0
102384093709,102384093707,-2,1126,1545,0
102385749436,102385749436,0,2338,1608,0
102387121755,102387121757,2,995,1160,0
102389578623,102389578622,-1,1220,1488,0
102391597117,102391597116,-1,1619,1629,0
102395361575,102395361575,0,1509,1504,0
102395957257,102395957256,-1,1269,2278,0
102399388285,102399388285,0,1442,1106,0
102400223596,102400223593,-3,1161,2121,0
102401818211,102401818211,0,1385,1207,0
102402511073,102402511073,0,944,1333,0
102404038754,102404038756,2,1468,1963,0
102406469026,102406469027,1,1085,1182,0
102407185694,102407185697,3,1617,1381,0
102409435256,102409435256,0,1318,1522,0
102410267988,102410267988,0,1352,1976,0
102417385409,102417385409,0,1371,1802,0
102418581021,102418581021,0,1487,1947,0
102419939203,102419939203,0,963,1680,0
102422934429,102422934430,1,1835,1516,0
102425050884,102425050885,1,1620,1438,0
102429960991,102429960993,2,1356,1257,0
102433040158,102433040160,2,1337,1576,0
102434181410,102434181410,0,1061,1295,0
102435016643,102435016642,-1,1157,1319,0
102437119270,102437119267,-3,1222,2486,0
102440836660,102440836661,1,2097,2870,0
102443443520,102443443522,2,1360,1743,0
102445576463,102445576464,1,1085,1138,0
102446268166,102446268174,8,4558,1877,0
102447301283,102447301282,-1,1323,1884,0
102449406267,102449406266,-1,1100,1425,0
102449913178,102449913179,1,1146,1674,0
102452012760,102452012760,0,1162,1562,0
102453320113,102453320114,1,1279,1423,0
102454786096,102454786098,2,1192,1221,0
102455257641,102455257641,0,1171,2085,0
102456956045,102456956042,-3,1167,2663,0
102459076260,102459076258,-2,2167,1570,0
102459498414,102459498420,6,4539,2637,0
102464185841,102464185839,-2,1465,1762,0
102465281438,102465281435,-3,858,1196,0
102466020648,102466020649,1,937,1670,0
102470574417,102470574418,1,1542,1650,0
102471489030,102471489033,3,1109,1646,0
102474090818,102474090816,-2,859,1376,0
102475732208,102475732215,7,38,536,0
102477389995,102477389995,0,1446,1864,0
102477863832,102477863833,1,1551,1960,0
102481339325,102481339324,-1,3814,16457,0
102483754262,102483754263,1,1511,1676,0
102484863386,102484863386,0,1292,1716,0
102492207850,102492207850,0,1235,1515,0
102495474866,102495474867,1,1622,2026,0
102500772355,102500772356,1,1469,2313,0
102500810466,102500810468,2,1370,1779,0
102501102444,102501102444,0,1573,2132,0
102506738137,102506738139,2,1153,1414,0
102513272017,102513272022,5,1075,1547,0
102513873142,102513873146,4,1068,1990,0
102515565298,102515565298,0,1142,1388,0
102522137891,102522137891,0,1271,1766,0
102525397966,102525397966,0,1330,2587,0
102526732403,102526732403,0,1803,1526,0
102530340634,102530340633,-1,1283,1873,0
102530964510,102530964511,1,1668,1822,0
102531138411,102531138390,-21,1409,1896,0
102533919077,102533919078,1,1413,1957,0
102534486281,102534486282,1,869,1463,0
102535754495,102535754497,2,1112,1103,0
102537863865,102537863866,1,786,1627,0
102538410135,102538410130,-5,1045,2104,0
102539248485,102539248486,1,1372,1158,0
102540582917,102540582919,2,1332,2000,0
102540821308,102540821290,-18,1245,1582,0
102543314658,102543314658,0,1300,1883,0
102546089510,102546089512,2,1228,1652,0
102552274807,102552274805,-2,1299,1266,0
102553081975,102553081974,-1,1668,1821,0
102555397017,102555397018,1,1137,963,0
102556420624,102556420622,-2,1251,2006,0
102556545883,102556545883,0,1067,1185,0
102561043524,102561043526,2,1897,1543,0
102561087933,102561087934,1,1111,1104,0
102562865194,102562865194,0,1132,1982,0
102563449238,102563449238,0,1838,1893,0
102564631433,102564631434,1,1556,1300,0
102565836838,102565836839,1,1480,2280,0
102567949251,102567949249,-2,792,1842,0
102568590966,102568590965,-1,1389,1901,0
102571919589,102571919589,0,1458,2868,0
102572238391,102572238385,-6,1469,3117,0
102572707193,102572707194,1,1439,1715,0
102578186554,102578186558,4,1247,1158,0
102580264829,102580264829,0,1728,1246,0
102580557019,102580557019,0,968,1867,0
102581392438,102581392439,1,1075,1907,0
102582365564,102582365546,-18,1410,1702,0
102583011958,102583011959,1,836,1471,0
102584744282,102584744282,0,912,1111,0
102590250557,102590250558,1,1679,1809,0
102590300787,102590300783,-4,794,2009,0
102591362122,102591362121,-1,1194,1149,0
102592168414,102592168416,2,1377,1424,0
102595953657,102595953673,16,535,1973,0
102598113716,102598113717,1,1743,1787,0
102603148505,102603148506,1,1113,1882,0
102604533016,102604533010,-6,26358,16284,0
102607690270,102607690271,1,1257,1159,0
102609574974,102609574974,0,1561,1058,0
102610867032,102610867030,-2,1744,1961,0
102614522060,102614522065,5,5914,2885,0
102616961622,102616961622,0,1522,1770,0
102623768038,102623768042,4,2249,1246,0
102624127538,102624127541,3,1409,1245,0
102624619505,102624619506,1,1491,1893,0
102626006941,102626006942,1,1943,1847,0
102630997216,102630997216,0,1675,2018,0
102631478737,102631478737,0,1176,1735,0
102633452059,102633452059,0,1512,2100,0
102637126090,102637126089,-1,1307,1603,0
102637760686,102637760686,0,1427,1619,0
102646319826,102646319827,1,1078,1348,0
102647136771,102647136770,-1,1646,1719,0
102650776203,102650776205,2,1411,1630,0
102653127617,102653127618,1,1641,2497,0
102658736465,102658736466,1,1446,1708,0
102658929025,102658929032,7,5984,2769,0
102659407114,102659407114,0,1759,1481,0
102660766926,102660766927,1,1133,1095,0
102662290518,102662290520,2,10598,20868,0
102664470453,102664470454,1,1557,1316,0
102666252423,102666252423,0,1007,1288,0
102667645881,102667645877,-4,29254,15831,0
102670116394,102670116394,0,1340,2180,0
102671414093,102671414087,-6,698,1395,0
102678469254,102678469254,0,1091,1740,0
102678581799,102678581798,-1,1484,1726,0
102678793323,102678793323,0,1421,1460,0
102684214306,102684214307,1,1796,1630,0
102686026729,102686026729,0,1476,1839,0
102690736421,102690736414,-7,2303,7639,0
102694212803,102694212803,0,1264,1403,0
102695184742,102695184741,-1,15152,21388,0
102706361944,102706361942,-2,1416,763,0
102708899423,102708899425,2,1497,1428,0
102709696062,102709696067,5,1610,1495,0
102711026701,102711026710,9,13550,31972,0
102719237581,102719237582,1,1270,1983,0
102720633446,102720633447,1,1716,1614,0
102721184734,102721184735,1,1147,1336,0
102722252311,102722252310,-1,1109,766,0
102728050858,102728050857,-1,1287,1742,0
102729168877,102729168878,1,1134,1320,0
102730063341,102730063341,0,1461,1052,0
102732798547,102732798548,1,1483,1387,0
102733046451,102733046453,2,1822,1828,0
102733941250,102733941253,3,1284,1197,0
102735182169,102735182170,1,1800,1964,0
102741576460,102741576460,0,1390,2232,0
102741787174,102741787170,-4,569,1658,0
102746273960,102746273959,-1,1772,1414,0
102749007637,102749007634,-3,1422,2469,0
102750716833,102750716829,-4,35352,12532,0
102751476354,102751476355,1,1631,2651,0
102753650439,102753650439,0,960,2011,0
102754092546,102754092546,0,1199,1496,0
102754191160,102754191162,2,1695,1549,0
102755787030,102755787029,-1,1259,1340,0
102764101343,102764101344,1,1452,1720,0
102766221566,102766221566,0,1171,1619,0
102767683222,102767683229,7,9313,18759,0
102773116902,102773116901,-1,771,1376,0
102773305247,102773305250,3,1888,1961,0
102775854870,102775854872,2,1055,1647,0
102776862472,102776862471,-1,1921,1937,0
102779398050,102779398051,1,1089,1742,0
102779791023,102779791023,0,1344,1866,0
102780834373,102780834374,1,1061,1215,0
102781966739,102781966745,6,2966,1324,0
102782944100,102782944099,-1,1851,2339,0
102783428597,102783428592,-5,30525,12357,0
102784896830,102784896830,0,1422,1740,0
102785972069,102785972067,-2,1162,1658,0
102787045661,102787045661,0,1290,1522,0
102788491498,102788491499,1,1219,1633,0
102789457631,102789457632,1,1223,1947,0
102791091593,102791091586,-7,1171,3827,0
102792304795,102792304790,-5,20890,10561,0
102792609199,102792609198,-1,692,1064,0
102792809957,102792809953,-4,947,1553,0
102795817505,102795817503,-2,1236,1780,0
102796526719,102796526737,18,559,1173,0
102800335635,102800335633,-2,1429,1488,0
102800557520,102800557520,0,1599,1983,0
102804099184,102804099185,1,1479,1290,0
102804171252,102804171254,2,1276,1353,0
102810157619,102810157620,1,892,1642,0
102812214746,102812214745,-1,1836,1943,0
102814067226,102814067226,0,944,1374,0
102816286239,102816286238,-1,795,1119,0
102818848265,102818848266,1,1011,1446,0
102819630945,102819630946,1,1322,1689,0
102820192614,102820192622,8,3579,1327,0
102822500138,102822500141,3,1023,1867,0
102825807359,102825807360,1,1645,2134,0
102827989527,102827989526,-1,1165,1908,0
102829056781,102829056782,1,1494,1604,0
102837507690,102837507691,1,1401,2069,0
102838132539,102838132539,0,1095,1260,0
102840007794,102840007789,-5,1276,2650,0
102840356483,102840356484,1,1598,1417,0
102840486001,102840486001,0,1526,1891,0
102841341455,102841341455,0,1399,1099,0
102842652213,102842652214,1,1489,1869,0
102844280670,102844280669,-1,1627,2135,0
102844514419,102844514421,2,1166,1130,0
102844871322,102844871319,-3,1502,2517,0
102848306925,102848306924,-1,1164,1540,0
102851700224,102851700229,5,4335,2867,0
102854635597,102854635598,1,1065,1102,0
102855537404,102855537403,-1,1008,1098,0
102862603081,102862603100,19,1356,1019,0
102866724120,102866724120,0,1002,1506,0
102870961485,102870961487,2,1450,1858,0
102873107614,102873107613,-1,1162,1623,0
102874194905,102874194906,1,1492,1874,0
102875263020,102875263006,-14,1390,1462,0
102877140746,102877140748,2,1250,1465,0
102877787479,102877787478,-1,960,1368,0
102881735785,102881735786,1,22075,16669,0
102886064680,102886064681,1,2029,2650,0
102886845129,102886845130,1,2365,1620,0
102888847502,102888847503,1,1035,1926,0
102890539276,102890539277,1,1356,1732,0
102891318380,102891318381,1,1913,2038,0
102892019455,102892019456,1,1790,2335,0
102894132990,102894132990,0,1217,1518,0
102897346682,102897346682,0,1481,2649,0
102899005991,102899005992,1,1186,1536,0
102899640294,102899640296,2,1922,2015,0
102902641379,102902641382,3,1937,1861,0
102906299947,102906299946,-1,1537,3712,0
102907505258,102907505258,0,1555,2029,0
102907729475,102907729476,1,1397,2087,0
102908174338,102908174338,0,1661,1743,0
102912764222,102912764201,-21,1453,1418,0
102914392311,102914392311,0,1122,2017,0
102915478658,102915478659,1,1744,2041,0
102916599133,102916599132,-1,1231,1860,0
102916845930,102916845929,-1,1422,850,0
102919242076,102919242075,-1,1248,2178,0
102922513725,102922513727,2,1106,1443,0
102923356680,102923356679,-1,2011,1731,0
102923964362,102923964362,0,1529,1484,0
102925406860,102925406866,6,9097,34829,0
102926548417,102926548418,1,1278,1398,0
102926772552,102926772563,11,474,511,0
102927056462,102927056462,0,1249,990,0
102928440243,102928440235,-8,1220,5025,0
102929407424,102929407419,-5,1447,3720,0
102931701312,102931701312,0,1166,1590,0
102933967847,102933967846,-1,1310,1708,0
102935686114,102935686098,-16,1334,1252,0
102936571170,102936571171,1,1510,1510,0
102938243891,102938243893,2,1157,1421,0
102939495930,102939495930,0,1174,1626,0
102940177414,102940177414,0,1553,2109,0
102943695518,102943695518,0,1428,1435,0
102946560878,102946560878,0,1227,2521,0
102949325202,102949325203,1,1150,1586,0
102951526310,102951526310,0,1521,2232,0
102953374855,102953374854,-1,1207,1676,0
102958050989,102958050990,1,1361,1861,0
102958787739,102958787738,-1,1183,1631,0
102959099340,102959099341,1,1494,2045,0
102962909615,102962909614,-1,1281,1629,0
102963142724,102963142744,20,1097,2329,0
102963456744,102963456751,7,3761,1296,0
102964505067,102964505066,-1,1048,1833,0
102966243589,102966243589,0,1102,1714,0
102967798679,102967798679,0,1344,1800,0
102970970463,102970970469,6,48294,25934,0
102971103565,102971103568,3,1340,1408,0
102971816882,102971816884,2,1217,1174,0
102974450162,102974450164,2,1282,1459,0
102975866686,102975866705,19,1220,1564,0
102976797507,102976797518,11,1702,1596,0
102977779446,102977779448,2,1248,1927,0
102978472178,102978472159,-19,1611,2132,0
102980069019,102980069018,-1,1817,2053,0
102981418417,102981418414,-3,1285,1370,0
102981546209,102981546210,1,1004,1680,0
102984042045,102984042050,5,1374,1579,0
102985383050,102985383054,4,1785,1739,0
102985833215,102985833216,1,1596,1542,0
102988105565,102988105564,-1,1222,1400,0
102991574011,102991574011,0,1158,1755,0
102997551441,102997551442,1,1662,1791,0
102998131679,102998131678,-1,1271,1696,0
103002241432,103002241432,0,1864,2333,0
103002515201,103002515198,-3,1300,2042,0
103002778957,103002778958,1,1245,1264,0
103003072214,103003072210,-4,45,1277,0
103003334365,103003334353,-12,1280,1410,0
103007251642,103007251646,4,1646,1520,0
103007679459,103007679460,1,2003,2515,0
103009259750,103009259750,0,1125,1070,0
103010270675,103010270674,-1,975,1317,0
103011458750,103011458754,4,1686,1459,0
103015989698,103015989699,1,1106,1928,0
103016575612,103016575613,1,1310,1456,0
103018470546,103018470547,1,1106,1826,0
103020179846,103020179846,0,1271,1553,0
103020302604,103020302585,-19,1326,1804,0
103021239735,103021239734,-1,1414,1891,0
103023175105,103023175099,-6,855,2764,0
103025596646,103025596646,0,1854,1677,0
103026107362,103026107366,4,1296,1443,0
103026551443,103026551442,-1,1163,1579,0
103027679310,103027679310,0,1294,1417,0
103028850394,103028850394,0,1019,1447,0
103030320819,103030320798,-21,5445,33742,0
103034632225,103034632220,-5,3022,8235,0
103038296818,103038296817,-1,1482,1703,0
103042374600,103042374599,-1,1740,2415,0
103044448715,103044448716,1,1386,1973,0
103047798073,103047798073,0,1916,2549,0
103049515745,103049515750,5,5081,2078,0
103049589355,103049589356,1,1451,1938,0
103052294021,103052294023,2,1026,1968,0
103055462404,103055462404,0,1948,2800,0
103057213750,103057213750,0,1216,1873,0
103058620258,103058620257,-1,1434,1571,0
103059426542,103059426545,3,1372,1499,0
103062054313,103062054316,3,1406,1466,0
103062525358,103062525358,0,1154,1919,0
103062761726,103062761725,-1,1402,1605,0
103064267697,103064267695,-2,1380,1761,0
103066446126,103066446127,1,731,1444,0
103067350776,103067350777,1,1722,2369,0
103067409871,103067409871,0,1846,1832,0
103067851490,103067851490,0,1494,1936,0
103078249210,103078249210,0,1284,1879,0
103080692982,103080692983,1,1500,1932,0
103082578420,103082578421,1,1153,1523,0
103085078865,103085078865,0,1264,2002,0
103090398770,103090398768,-2,1439,1603,0
103092107719,103092107717,-2,1160,1839,0
103092825870,103092825870,0,1169,1941,0
103098177593,103098177593,0,1812,2038,0
103103948667,103103948666,-1,1330,1898,0
103109666659,103109666642,-17,1188,1174,0
103110288854,103110288856,2,1310,1625,0
103111657171,103111657170,-1,1264,2038,0
103113642933,103113642934,1,2003,2259,0
103114249277,103114249270,-7,726,3855,0
103114539229,103114539230,1,915,1476,0
103116877523,103116877525,2,1881,2256,0
103119458622,103119458623,1,910,1365,0
103119953915,103119953914,-1,1293,1311,0
103120476945,103120476946,1,1584,1866,0
103121075912,103121075914,2,1385,1173,0
103121750028,103121750029,1,1168,1243,0
103124726484,103124726486,2,1558,1807,0
103125229376,103125229377,1,1583,2056,0
103129430809,103129430809,0,1712,2192,0
103131111685,103131111686,1,1087,1863,0
103131792028,103131792027,-1,1163,1765,0
103137603725,103137603726,1,1113,1578,0
103140094562,103140094564,2,1239,1067,0
103143461790,103143461788,-2,1234,1804,0
103146929136,103146929143,7,4839,1732,0
103149225325,103149225326,1,1471,1650,0
103152333429,103152333426,-3,1010,2952,0
103153636966,103153636965,-1,1541,1642,0
103154117847,103154117847,0,984,1095,0
103155719539,103155719541,2,1427,1738,0
103156427922,103156427920,-2,1117,2155,0
103158212995,103158212994,-1,766,1397,0
103158550359,103158550377,18,1363,1524,0
103158829122,103158829118,-4,1020,2733,0
103159003167,103159003164,-3,996,2339,0
103159223521,103159223518,-3,1183,1786,0
103159256766,103159256771,5,1246,728,0
103161047695,103161047695,0,1560,1979,0
103163990734,103163990737,3,1939,1658,0
103164989323,103164989322,-1,749,1409,0
103169640953,103169640953,0,43622,20638,0
103173270289,103173270290,1,1507,1424,0
103174830490,103174830491,1,1386,1141,0
103184232166,103184232166,0,1046,1308,0
103184703642,103184703643,1,1981,2384,0
103187484790,103187484790,0,1223,1985,0
103189352099,103189352101,2,1746,1666,0
103190119676,103190119676,0,1079,1445,0
103190361423,103190361422,-1,1134,2092,0
103194327318,103194327318,0,1519,1368,0
103194810675,103194810675,0,1341,1202,0
103195867509,103195867509,0,1697,1552,0
103201993697,103201993698,1,1654,2090,0
103202697277,103202697277,0,1498,2479,0
103205516325,103205516325,0,1637,1515,0
103209548087,103209548089,2,1209,1639,0
103211977814,103211977814,0,542,1224,0
103215377415,103215377415,0,1280,1693,0
103216236248,103216236251,3,1621,1285,0
103223102456,103223102455,-1,694,1644,0
103223203373,103223203360,-13,85,510,0
103224818978,103224818978,0,1357,1381,0
103225286665,103225286665,0,1261,1665,0
103226231025,103226231023,-2,1149,2290,0
103228478114,103228478115,1,1990,2368,0
103230359834,103230359835,1,1587,2149,0
103232136527,103232136525,-2,968,1231,0
103234276389,103234276394,5,4906,2209,0
103234520815,103234520815,0,1572,1827,0
103238420554,103238420554,0,1451,1701,0
103238525971,103238525973,2,1972,2094,0
103238889805,103238889806,1,1811,2267,0
103240030011,103240030009,-2,1117,1982,0
103240347277,103240347278,1,1342,1579,0
103241171851,103241171851,0,1440,2204,0
103241989315,103241989317,2,1102,1763,0
103245749749,103245749749,0,961,1574,0
103251299826,103251299844,18,1052,2497,0
103252619707,103252619705,-2,746,1316,0
103253794534,103253794534,0,1251,1404,0
103255273483,103255273485,2,1182,1721,0
103255460934,103255460948,14,1073,1264,0
103257295143,103257295143,0,1589,1842,0
103261864261,103261864255,-6,1523,4767,0
103264337884,103264337886,2,1787,2063,0
103265958318,103265958319,1,1445,1748,0
103266152849,103266152847,-2,1237,1493,0
103268401646,103268401652,6,5963,2118,0
103272113010,103272113010,0,1398,1555,0
103275202334,103275202334,0,1446,1512,0
103278851740,103278851740,0,1232,1536,0
103280461737,103280461738,1,1793,1919,0
103282149864,103282149864,0,1410,1889,0
103282978742,103282978743,1,1371,1561,0
103283641170,103283641166,-4,1132,3000,0
103287795906,103287795908,2,1611,1895,0
103288752499,103288752495,-4,683,2598,0
103293816635,103293816635,0,1498,1315,0
103297696343,103297696347,4,1326,1612,0
103303547854,103303547857,3,1748,969,0
103309647503,103309647497,-6,1419,4431,0
103309932738,103309932738,0,1748,2515,0
103310375421,103310375443,22,867,213,0
103313604618,103313604617,-1,1519,1476,0
103313914358,103313914358,0,1102,1515,0
103314970049,103314970049,0,1202,1410,0
103316551469,103316551470,1,1589,1544,0
103316944314,103316944334,20,912,1050,0
103319676717,103319676716,-1,1147,2280,0
103320398535,103320398534,-1,1226,973,0
103321179901,103321179901,0,1853,2578,0
103321928630,103321928621,-9,1436,1125,0
103323301658,103323301657,-1,1518,1764,0
103323557904,103323557904,0,1376,2568,0
103328326027,103328326020,-7,1119,6291,0
103334595339,103334595339,0,1774,1264,0
103335340765,103335340766,1,1810,1409,0
103338722538,103338722539,1,798,1054,0
103339006792,103339006792,0,1789,1477,0
103339600522,103339600522,0,1681,1565,0
103340328392,103340328394,2,2512,2007,0
103341353156,103341353157,1,1652,2090,0
103342280745,103342280744,-1,1516,1679,0
103345199680,103345199677,-3,1722,1735,0
103346495278,103346495277,-1,1804,1831,0
103347933935,103347933929,-6,802,2764,0
103349337001,103349337002,1,1281,1466,0
103351922761,103351922763,2,1512,1629,0
103352613418,103352613413,-5,1397,4654,0
103352664644,103352664651,7,4178,925,0
103354909625,103354909625,0,1592,1798,0
103356327366,103356327366,0,714,1977,0
103356388643,103356388642,-1,1253,1963,0
103356577833,103356577824,-9,23130,12989,0
103358955268,103358955269,1,1699,1869,0
103359023094,103359023097,3,1309,1508,0
103359791079,103359791080,1,1327,1228,0
103365259670,103365259671,1,1138,2039,0
103365324618,103365324618,0,1853,1745,0
103369235626,103369235627,1,1964,1870,0
103373672073,103373672070,-3,1140,1444,0
103375527516,103375527519,3,1707,886,0
103380219610,103380219613,3,1254,1654,0
103380669467,103380669468,1,1404,2038,0
103381036934,103381036935,1,1885,2318,0
103383438277,103383438279,2,1369,1534,0
103388845661,103388845665,4,1730,1434,0
103389942893,103389942894,1,1453,1535,0
103390195694,103390195694,0,1100,2089,0
103390878148,103390878148,0,1587,2144,0
103392156474,103392156474,0,1248,1806,0
103395720737,103395720739,2,1970,1260,0
103396150365,103396150367,2,1419,1181,0
103397136573,103397136574,1,1267,1957,0
103398185365,103398185365,0,1792,1788,0
103399231173,103399231173,0,1405,1979,0
103403103938,103403103938,0,1157,1573,0
103403472755,103403472761,6,8571,36224,0
103403812436,103403812435,-1,1005,1091,0
103404529530,103404529531,1,1122,1694,0
103404921163,103404921162,-1,1360,1359,0
103405260993,103405260990,-3,1223,1434,0
103407151943,103407151935,-8,1167,6071,0
103409143318,103409143319,1,1022,1249,0
103409413634,103409413635,1,1269,1613,0
103411419266,103411419265,-1,1571,2214,0
103417606750,103417606750,0,1329,2046,0
103422955361,103422955368,7,12639,5365,0
103424007306,103424007309,3,1334,1112,0
103430207482,103430207481,-1,1567,1791,0
103431102470,103431102471,1,9162,11913,0
103433780829,103433780830,1,1178,1663,0
103436063781,103436063782,1,1019,1792,0
103436232340,103436232339,-1,1851,2194,0
103442416920,103442416919,-1,1279,1908,0
103450247337,103450247335,-2,1557,2309,0
103451232746,103451232745,-1,1284,1869,0
103452216427,103452216427,0,1553,2009,0
103456726083,103456726077,-6,1516,6260,0
103461959199,103461959199,0,933,1616,0
103464541266,103464541259,-7,853,1725,0
103469524932,103469524929,-3,1411,3972,0
103471507152,103471507154,2,741,1476,0
103480461570,103480461571,1,1885,1925,0
103480833613,103480833614,1,1681,1948,0
103481865007,103481865007,0,1127,1255,0
103489496973,103489496975,2,1484,2157,0
103489794779,103489794781,2,1080,1227,0
103493468968,103493468967,-1,1359,1622,0
103495057856,103495057857,1,1165,1574,0
103495126653,103495126653,0,1893,2709,0
103501756107,103501756106,-1,1426,1636,0
103504591655,103504591650,-5,532,1375,0
103506175198,103506175199,1,1633,1747,0
103507449731,103507449730,-1,1666,1627,0
103507703771,103507703773,2,1519,1490,0
103510885419,103510885421,2,1344,1630,0
103511485701,103511485704,3,1322,1814,0
103512331457,103512331458,1,1559,1349,0
103512425837,103512425836,-1,1578,1754,0
103512957576,103512957578,2,1329,1842,0
103514761890,103514761891,1,1246,1605,0
103514842021,103514842022,1,1608,1878,0
103515162914,103515162916,2,1369,1731,0
103515561762,103515561759,-3,916,969,0
103515859869,103515859868,-1,922,1386,0
103516011397,103516011398,1,1510,1395,0
103521196779,103521196782,3,1790,1469,0
103521477189,103521477172,-17,547,451,0
103522898307,103522898306,-1,704,2150,0
103525089658,103525089659,1,1423,1669,0
103525554803,103525554802,-1,1326,1535,0
103528088450,103528088449,-1,1291,1809,0
103528360986,103528360988,2,1188,1695,0
103528518799,103528518799,0,1240,1755,0
103530594883,103530594882,-1,1648,1919,0
103531446914,103531446909,-5,1110,5527,0
103532907833,103532907833,0,1727,2418,0
103533159269,103533159268,-1,1133,1318,0
103535352393,103535352394,1,2341,1761,0
103536364273,103536364273,0,1836,2120,0
103538246053,103538246053,0,3412,4104,0
103540754106,103540754116,10,10181,42797,0
103542037320,103542037322,2,1360,1441,0
103544659280,103544659270,-10,697,2082,0
103551141333,103551141331,-2,1926,2678,0
103555555937,103555555918,-19,1219,1899,0
103556623916,103556623914,-2,999,1236,0
103560091612,103560091615,3,1780,1484,0
103562322386,103562322386,0,1322,1331,0
103563467861,103563467862,1,1950,2090,0
103564193490,103564193492,2,1407,1422,0
103565124654,103565124656,2,1008,1238,0
103567056875,103567056875,0,1242,1310,0
103568195770,103568195770,0,1925,2756,0
103568530374,103568530375,1,960,2073,0
103571883494,103571883493,-1,754,1573,0
103574624359,103574624367,8,3356,898,0
103575025198,103575025198,0,1529,1980,0
103577609347,103577609350,3,862,874,0
103578206948,103578206949,1,1222,1357,0
103587149440,103587149439,-1,1426,1846,0
103587284677,103587284674,-3,1296,1408,0
103587549026,103587549028,2,1020,1222,0
103594216495,103594216497,2,1737,1823,0
103595089126,103595089126,0,1346,1381,0
103595182888,103595182886,-2,1847,1785,0
103595973265,103595973265,0,1016,1784,0
103597162815,103597162816,1,1436,2295,0
103598470470,103598470470,0,1199,1829,0
103601630845,103601630844,-1,1352,1862,0
103603000663,103603000661,-2,1191,2178,0
103605364783,103605364782,-1,867,1323,0
103606038174,103606038177,3,1709,1533,0
103609063250,103609063250,0,1020,1282,0
103609848407,103609848403,-4,1168,1185,0
103612530406,103612530406,0,1587,1750,0
103614573917,103614573908,-9,1235,244,0
103615103130,103615103131,1,1400,2805,0
103616686792,103616686791,-1,1837,1249,0
103616909294,103616909294,0,2097,2526,0
103618304210,103618304212,2,9619,8811,0
103620332796,103620332796,0,1499,1286,0
103620416434,103620416432,-2,1094,1068,0
103621720595,103621720595,0,1415,1803,0
103623521204,103623521204,0,1521,1756,0
103624589403,103624589406,3,1748,1859,0
103625394141,103625394137,-4,1109,2477,0
103626512531,103626512535,4,1997,1442,0
103629443103,103629443101,-2,1040,2032,0
103631284510,103631284513,3,1483,1496,0
103635804619,103635804620,1,1784,1917,0
103641484150,103641484151,1,1722,1440,0
103642398517,103642398518,1,1962,1697,0
103644078460,103644078462,2,1051,1492,0
103644371381,103644371382,1,833,1209,0
103645238175,103645238174,-1,1270,1467,0
103645330203,103645330206,3,1388,1338,0
103648297437,103648297437,0,1552,1589,0
103649390451,103649390451,0,1396,1460,0
103660366086,103660366086,0,1649,1744,0
103660777014,103660777025,11,1520,1507,0
103662581571,103662581572,1,1306,1773,0
103662662913,103662662913,0,2119,2048,0
103669230771,103669230770,-1,1901,2293,0
103669285484,103669285484,0,1727,1572,0
103674150645,103674150648,3,1257,1261,0
103675065719,103675065719,0,880,934,0
103677245768,103677245770,2,1319,1547,0
103681174483,103681174483,0,845,1288,0
103682249923,103682249925,2,2223,2255,0
103684677953,103684677956,3,2879,2315,0
103689138001,103689138003,2,1109,1033,0
103690109691,103690109691,0,1097,1614,0
103690418646,103690418645,-1,1148,1409,0
103691959163,103691959183,20,890,1583,0
103694809970,103694809954,-16,1624,1850,0
103695127986,103695127986,0,1512,1674,0
103695365401,103695365405,4,2055,1394,0
103698074137,103698074135,-2,1249,1448,0
103701480962,103701480962,0,1787,1842,0
103702366345,103702366346,1,1296,1462,0
103704367898,103704367898,0,622,1059,0
103704954445,103704954448,3,5706,4947,0
103707295929,103707295931,2,1697,1921,0
103709525063,103709525062,-1,1730,2224,0
103710387049,103710387049,0,1454,1953,0
103715242361,103715242362,1,1170,1228,0
103717557804,103717557806,2,1686,1422,0
103718470582,103718470583,1,975,1646,0
103722547447,103722547446,-1,1550,2121,0
103724661276,103724661275,-1,1457,2144,0
103728032676,103728032677,1,986,1292,0
103736455750,103736455751,1,1391,784,0
103742750023,103742750024,1,1142,1771,0
103743766202,103743766222,20,1362,1748,0
103748596878,103748596878,0,1751,2427,0
103750044434,103750044434,0,1469,1765,0
103751132978,103751132978,0,1278,1882,0
103753068889,103753068888,-1,1359,2414,0
103753318587,103753318589,2,1533,1561,0
103760141350,103760141347,-3,1047,1698,0
103760718802,103760718803,1,823,1346,0
103763753690,103763753683,-7,1308,2021,0
103766109213,103766109218,5,2928,1603,0
103766701080,103766701083,3,2324,1963,0
103768847315,103768847317,2,1003,1319,0
103769466478,103769466480,2,853,1642,0
103774531597,103774531600,3,1046,1895,0
103774599738,103774599719,-19,24638,27465,0
103778300446,103778300449,3,1080,1456,0
103780524745,103780524745,0,1515,1829,0
103780549830,103780549829,-1,1418,1981,0
103781425666,103781425667,1,1349,1639,0
103782706794,103782706796,2,1361,1527,0
103788625242,103788625240,-2,1673,2292,0
103789072236,103789072236,0,1019,1229,0
103793015597,103793015598,1,2025,1740,0
103794616390,103794616391,1,2050,2610,0
103795851773,103795851775,2,1404,1725,0
103795906506,103795906507,1,1106,1321,0
103796986863,103796986857,-6,26963,8727,0
103797430163,103797430165,2,1015,1586,0
103797546877,103797546878,1,1536,1625,0
103799957508,103799957509,1,1304,1580,0
103805689415,103805689415,0,1383,1776,0
103806064716,103806064717,1,1078,1619,0
103810077218,103810077219,1,1997,1844,0
103815043239,103815043242,3,1372,1651,0
103815368839,103815368838,-1,1223,2030,0
103817319982,103817319981,-1,1416,1266,0
103818390435,103818390452,17,2003,1725,0
103820160097,103820160097,0,1248,1721,0
103820633421,103820633422,1,1471,1757,0
103824311775,103824311778,3,1852,1718,0
103824583886,103824583886,0,1575,2161,0
103825145649,103825145654,5,2322,1610,0
103826457176,103826457175,-1,2061,1889,0
103827622735,103827622736,1,1062,1681,0
103828889079,103828889078,-1,1225,1750,0
103830091249,103830091249,0,948,1647,0
103832002615,103832002616,1,2187,2332,0
103832701019,103832701021,2,1687,2224,0
103835478899,103835478898,-1,921,1151,0
103836567681,103836567682,1,2188,2369,0
103843754884,103843754885,1,1460,1182,0
103845512722,103845512723,1,735,1392,0
103845825909,103845825906,-3,1191,1768,0
103848592165,103848592165,0,718,861,0
103848771730,103848771709,-21,766,584,0
103849592838,103849592840,2,1454,1452,0
103853283234,103853283236,2,1874,1773,0
103854114315,103854114313,-2,1489,1940,0
103854960971,103854960966,-5,935,1432,0
103855289945,103855289950,5,1965,1252,0
103856499831,103856499831,0,943,1119,0
103858978462,103858978464,2,2219,2028,0
103859430819,103859430819,0,1811,1906,0
103859637841,103859637841,0,1391,2102,0
103860898717,103860898719,2,1323,960,0
103861952238,103861952238,0,1476,1793,0
103864357657,103864357657,0,1539,1776,0
103865464722,103865464722,0,1386,1347,0
103867897107,103867897106,-1,1290,1954,0
103868273241,103868273244,3,1868,1502,0
103872822302,103872822301,-1,801,963,0
103876430627,103876430627,0,878,1951,0
103877748062,103877748063,1,1468,1822,0
103879546259,103879546261,2,1428,1397,0
103883132588,103883132590,2,1332,1442,0
103883651849,103883651849,0,1155,1248,0
103884043806,103884043806,0,1475,1298,0
103884792654,103884792654,0,2113,1863,0
103888335798,103888335798,0,1297,1133,0
103889025524,103889025522,-2,1424,1055,0
103891751198,103891751199,1,1718,2385,0
103893148653,103893148653,0,1492,1857,0
103895361900,103895361900,0,1526,1656,0
103896375831,103896375831,0,1175,1749,0
103904046545,103904046548,3,2047,1940,0
103904354897,103904354899,2,1401,1186,0
103905385554,103905385554,0,818,1113,0
103907097710,103907097711,1,1128,1418,0
103907439536,103907439537,1,1603,1458,0
103907626519,103907626519,0,2335,2974,0
103907658411,103907658413,2,1163,1566,0
103909149692,103909149698,6,3477,1553,0
103909851218,103909851222,4,1388,1099,0
103911579783,103911579783,0,1543,1643,0
103911687553,103911687555,2,970,1066,0
103916168821,103916168821,0,1179,1887,0
103916272686,103916272686,0,1108,1784,0
103916668516,103916668516,0,1363,1409,0
103921006178,103921006178,0,1400,2072,0
103923381554,103923381553,-1,1242,1712,0
103923713398,103923713398,0,1881,1768,0
103924439086,103924439087,1,1653,1866,0
103926126840,103926126842,2,1975,1467,0
103927814582,103927814582,0,1023,1926,0
103930803147,103930803148,1,1853,2100,0
103931223630,103931223629,-1,1688,2386,0
103931782967,103931782970,3,982,859,0
103932626502,103932626502,0,962,1362,0
103936290764,103936290763,-1,1947,2758,0
103940384476,103940384477,1,1498,1568,0
103940933258,103940933260,2,1098,1062,0
103942522913,103942522914,1,857,815,0
103942854814,103942854814,0,539,1529,0
103942910102,103942910105,3,2511,2432,0
103943342482,103943342481,-1,1339,1474,0
103943619581,103943619579,-2,1260,1518,0
103946097089,103946097090,1,1501,1894,0
103948891790,103948891789,-1,1551,1879,0
103953144932,103953144939,7,3121,1965,0
103954761450,103954761449,-1,1865,2098,0
103955609853,103955609855,2,1278,1260,0
103956749471,103956749470,-1,1423,1946,0
103957103769,103957103770,1,1325,1785,0
103957281792,103957281793,1,1618,1759,0
103959850346,103959850350,4,3661,2756,0
103961808881,103961808882,1,1274,1219,0
103962456965,103962456966,1,1685,1382,0
103964439957,103964439962,5,16383,8367,0
103966112050,103966112050,0,1976,2008,0
103967109721,103967109722,1,1511,1772,0
103968794362,103968794362,0,1149,1531,0
103969370340,103969370342,2,900,1116,0
103972689501,103972689502,1,1022,1238,0
103973800239,103973800239,0,821,1267,0
103976422763,103976422762,-1,1879,2043,0
103977930206,103977930213,7,4608,1805,0
103978033023,103978033026,3,1399,1568,0
103980535598,103980535599,1,1262,1832,0
103981070961,103981070961,0,950,1050,0
103983612882,103983612883,1,1156,1559,0
103986675296,103986675298,2,1304,992,0
103989036893,103989036886,-7,53156,26321,0
103989417909,103989417906,-3,1006,2020,0
103993345271,103993345272,1,918,1648,0
103996516750,103996516752,2,1495,1663,0
103996783086,103996783087,1,1255,1599,0
103999471766,103999471766,0,1541,1370,0
103999595329,103999595334,5,603,1113,0
104000141190,104000141190,0,1543,1376,0
104002451783,104002451783,0,1270,1674,0
104002615783,104002615785,2,1551,2049,0
104004081046,104004081046,0,1295,1642,0
104004887389,104004887389,0,969,2118,0
104006295506,104006295509,3,1519,1731,0
104010245598,104010245598,0,822,777,0
104012933431,104012933430,-1,1391,1905,0
104014571794,104014571793,-1,1399,1351,0
104014702438,104014702438,0,1626,1554,0
104015748497,104015748499,2,1487,1614,0
104019916712,104019916712,0,1398,1650,0
104020843334,104020843326,-8,32104,13504,0
104021992617,104021992617,0,1291,1382,0
104022688832,104022688834,2,992,1119,0
104025767549,104025767551,2,1522,1671,0
104027150866,104027150866,0,1517,1761,0
104029207688,104029207689,1,1324,1749,0
104030651231,104030651234,3,820,1388,0
104032193781,104032193781,0,1983,2058,0
104035853071,104035853074,3,1393,1551,0
104036928242,104036928243,1,836,1149,0
104042327117,104042327119,2,1316,1701,0
104043632697,104043632699,2,1257,1532,0
104044430405,104044430417,12,17508,9444,0
104047770364,104047770366,2,1870,2776,0
104048676894,104048676893,-1,1681,1844,0
104050480418,104050480420,2,747,1423,0
104051395413,104051395411,-2,1185,1978,0
104053385321,104053385321,0,2002,1806,0
104057784146,104057784146,0,1381,2358,0
104058390156,104058390158,2,1241,1742,0
104060300294,104060300298,4,1999,1850,0
104063280649,104063280652,3,1462,1428,0
104065870393,104065870402,9,14777,20803,0
104068326774,104068326775,1,1197,1416,0
104069408345,104069408346,1,1168,994,0
104071018398,104071018398,0,1162,1143,0
104071743312,104071743315,3,1064,1043,0
104072011063,104072011062,-1,1280,1455,0
104073701410,104073701394,-16,1652,1017,0
104081466373,104081466373,0,2016,2178,0
104081920154,104081920154,0,1407,2141,0
104083727791,104083727790,-1,948,1537,0
104085831941,104085831942,1,1359,2206,0
104085984490,104085984489,-1,1396,1364,0
104086662415,104086662402,-13,1395,1403,0
104095470411,104095470413,2,1332,1527,0
104096012682,104096012682,0,1678,2108,0
104098000206,104098000207,1,1850,1976,0
104098491787,104098491788,1,2101,1568,0
104100310478,104100310478,0,1621,2088,0
104100970484,104100970485,1,985,1822,0
104102637370,104102637370,0,2324,2786,0
104102958278,104102958278,0,1167,1074,0
104103268543,104103268538,-5,2206,5825,0
104109039862,104109039867,5,1414,1205,0
104109611486,104109611487,1,1548,1775,0
104112880442,104112880442,0,934,1026,0
104114286650,104114286653,3,1957,2257,0
104114543521,104114543522,1,1556,1803,0
104116077126,104116077127,1,1864,2106,0
104118947234,104118947234,0,1865,1950,0
104125411025,104125411026,1,853,1273,0
104128050968,104128050968,0,1323,1566,0
104128688933,104128688935,2,1509,1126,0
104129209699,104129209699,0,1153,1913,0
104136057168,104136057170,2,1755,1544,0
104138325730,104138325729,-1,1025,1633,0
104140531321,104140531319,-2,1047,1999,0
104142327710,104142327705,-5,1972,8777,0
104143370076,104143370077,1,1919,1846,0
104150150095,104150150094,-1,904,1854,0
104153302772,104153302772,0,1476,2182,0
104154467269,104154467267,-2,993,1782,0
104155613259,104155613260,1,1520,1854,0
104159919222,104159919224,2,1577,1589,0
104162879931,104162879935,4,1557,1056,0
104166813073,104166813071,-2,1330,1725,0
104169931210,104169931209,-1,1096,1522,0
104170609686,104170609689,3,1357,1494,0
104172363407,104172363409,2,1451,1682,0
104173273686,104173273683,-3,891,2551,0
104174142469,104174142474,5,1448,1035,0
104174253487,104174253488,1,1239,1636,0
104174875929,104174875929,0,1135,1441,0
104175493507,104175493507,0,960,1204,0
104177522774,104177522773,-1,1484,1607,0
104178684622,104178684623,1,2161,2366,0
104180471493,104180471495,2,1330,1429,0
104181474687,104181474687,0,1167,930,0
104182765089,104182765089,0,1336,1203,0
104185048506,104185048506,0,1165,2197,0
104186045250,104186045249,-1,1332,2166,0
104195506798,104195506798,0,1777,2914,0
104195648037,104195648038,1,1331,1273,0
104198950524,104198950517,-7,1041,7791,0
104203102422,104203102422,0,1291,1621,0
104213156414,104213156415,1,1398,1466,0
104217763175,104217763175,0,920,1866,0
104220761388,104220761388,0,1285,2023,0
104221683066,104221683064,-2,771,1285,0
104222673802,104222673805,3,1798,1461,0
104226223052,104226223050,-2,1348,1491,0
104230752846,104230752847,1,1197,1881,0
104233552628,104233552628,0,1383,1215,0
104235097727,104235097726,-1,894,1671,0
104235139241,104235139242,1,1634,1611,0
104237465651,104237465653,2,1210,1760,0
104238914932,104238914929,-3,905,1737,0
104239950638,104239950639,1,923,1254,0
104240497942,104240497944,2,1328,1550,0
104241636125,104241636126,1,938,932,0
104241715725,104241715727,2,1713,1680,0
104242963154,104242963155,1,1372,1211,0
104244134294,104244134294,0,1247,1101,0
104248137475,104248137477,2,1150,1826,0
104248682885,104248682886,1,2920,3683,0
104248885721,104248885719,-2,1558,1688,0
104252345169,104252345170,1,1169,1259,0
104252805630,104252805632,2,1596,1830,0
104253424849,104253424847,-2,1592,1730,0
104254635239,104254635239,0,1400,1579,0
104255465518,104255465517,-1,1343,2212,0
104256893290,104256893286,-4,1160,3242,0
104257388686,104257388687,1,1225,1218,0
104261162551,104261162553,2,1285,1731,0
104263486864,104263486863,-1,867,1147,0
104266469224,104266469232,8,18187,34975,0
104266708274,104266708275,1,1568,1478,0
104267313334,104267313337,3,1421,1995,0
104267612650,104267612651,1,932,985,0
104269282803,104269282803,0,1310,1189,0
104272285955,104272285955,0,1406,1996,0
104273504927,104273504931,4,863,1487,0
104276355645,104276355646,1,1400,1846,0
104276454454,104276454454,0,1490,1861,0
104276978265,104276978266,1,1216,1931,0
104277418747,104277418746,-1,1227,1712,0
104277770220,104277770219,-1,1271,1717,0
104282681499,104282681497,-2,994,2036,0
104284445973,104284445973,0,1809,2328,0
104286244826,104286244827,1,1485,1968,0
104287899339,104287899341,2,1839,2435,0
104288807430,104288807431,1,1199,1761,0
104290076266,104290076270,4,1556,1080,0
104291099770,104291099769,-1,1337,1298,0
104292366703,104292366703,0,967,1449,0
104292604708,104292604710,2,1041,1249,0
104294753931,104294753933,2,1747,2547,0
104295048849,104295048849,0,1260,1480,0
104298439052,104298439050,-2,1204,2007,0
104302503942,104302503941,-1,1306,1653,0
104304543190,104304543191,1,1266,1457,0
104305730790,104305730791,1,832,1839,0
104306560745,104306560746,1,1299,1185,0
104309346085,104309346084,-1,1369,1825,0
104316886593,104316886594,1,2042,1984,0
104319266489,104319266488,-1,2104,1779,0
104319308853,104319308853,0,1900,2531,0
104320430383,104320430382,-1,1765,2150,0
104321722955,104321722953,-2,1108,2408,0
104324461942,104324461942,0,1660,2442,0
104324755302,104324755305,3,1819,1479,0
104325432058,104325432062,4,1633,1522,0
104325805147,104325805146,-1,1245,1469,0
104330195293,104330195295,2,1315,1879,0
104331984677,104331984677,0,1408,1776,0
104334594322,104334594323,1,1809,2285,0
104334861170,104334861170,0,945,1833,0
104336028024,104336028025,1,1336,2218,0
104336655599,104336655600,1,1152,1328,0
104339033539,104339033539,0,1378,1226,0
104341675033,104341675034,1,1286,1855,0
104342629587,104342629586,-1,1657,2029,0
104343569383,104343569383,0,1200,1911,0
104344474461,104344474462,1,1523,1594,0
104345144005,104345144007,2,1403,1566,0
104347161642,104347161642,0,1806,2502,0
104348035537,104348035531,-6,436,1418,0
104349266870,104349266870,0,1919,1816,0
104350311620,104350311620,0,1185,1829,0
104352253691,104352253690,-1,1333,1225,0
104356239714,104356239717,3,1693,1783,0
104357656995,104357656994,-1,1486,1643,0
104358557894,104358557897,3,1181,1609,0
104359385231,104359385230,-1,1552,2076,0
104365482031,104365482032,1,1383,2014,0
104366613359,104366613339,-20,27788,27106,0
104366898721,104366898722,1,1196,1389,0
104369604735,104369604734,-1,872,2431,0
104375496689,104375496691,2,1651,2022,0
104377711696,104377711702,6,8799,24763,0
104381141612,104381141610,-2,850,1250,0
104381415396,104381415396,0,2357,2240,0
104381884990,104381884990,0,1330,1744,0
104383097711,104383097711,0,1240,1766,0
104387240391,104387240394,3,1327,1328,0
104388611782,104388611781,-1,1344,2211,0
104389703777,104389703778,1,2212,2366,0
104390204585,104390204586,1,1333,1464,0
104395683145,104395683146,1,1401,1739,0
104397458212,104397458213,1,1136,1448,0
104398981101,104398981087,-14,1056,1942,0
104399243242,104399243243,1,1489,2012,0
104399978761,104399978763,2,1082,2020,0
104402746663,104402746662,-1,1047,1660,0
104403188991,104403188990,-1,1246,1635,0
104406827227,104406827228,1,1288,1536,0
104409940012,104409940011,-1,1574,1523,0
104412332135,104412332139,4,1418,1939,0
104413528242,104413528243,1,1565,1764,0
104414601752,104414601753,1,1596,1434,0
104416024436,104416024438,2,1324,1416,0
104418576183,104418576184,1,1657,1887,0
104419233493,104419233495,2,1738,1124,0
104422271635,104422271635,0,1617,1857,0
104422588254,104422588254,0,1414,2280,0
104423760653,104423760669,16,625,1411,0
104424623765,104424623763,-2,1324,1915,0
104425242631,104425242633,2,2694,2198,0
104427797993,104427797993,0,1877,1954,0
104430131366,104430131365,-1,1344,1448,0
104431765856,104431765849,-7,2206,6901,0
104432538519,104432538519,0,1558,2103,0
104432835850,104432835850,0,1095,950,0
104440990849,104440990850,1,1660,1966,0
104443089318,104443089319,1,1324,1958,0
104445138905,104445138906,1,2039,1697,0
104445258908,104445258909,1,1730,2351,0
104448419377,104448419378,1,1363,1816,0
104449428702,104449428702,0,1541,1609,0
104452377836,104452377834,-2,1292,1686,0
104457567580,104457567580,0,968,385,0
104458770913,104458770914,1,1147,1453,0
104464126691,104464126689,-2,1357,1707,0
104466689705,104466689711,6,1481,1120,0
104467984447,104467984446,-1,1162,1655,0
104468041157,104468041157,0,1007,1317,0
104468606970,104468606970,0,1209,1880,0
104470622671,104470622666,-5,1028,3185,0
104472061106,104472061107,1,1459,1399,0
104473179294,104473179296,2,2156,1831,0
104473982589,104473982590,1,1631,1508,0
104476231778,104476231760,-18,1054,562,0
104477360881,104477360885,4,1702,1415,0
104479786269,104479786270,1,1522,1970,0
104481519892,104481519890,-2,1498,2569,0
104485898170,104485898170,0,960,1695,0
104490761785,104490761785,0,1514,1629,0
104493618422,104493618424,2,1279,1426,0
104494021746,104494021746,0,1838,2294,0
104495447893,104495447895,2,1830,1573,0
104500211318,104500211318,0,1076,1328,0
104500342044,104500342033,-11,1165,1750,0
104503705818,104503705820,2,1613,1297,0
104506151027,104506151027,0,2087,1919,0
104509189434,104509189435,1,1336,1337,0
104511134863,104511134861,-2,1077,2621,0
104511743625,104511743626,1,1368,1719,0
104512356807,104512356808,1,1400,1670,0
104512585349,104512585348,-1,1574,2332,0
104513295497,104513295498,1,1311,1999,0
104519675553,104519675553,0,880,1396,0
104521641106,104521641107,1,1249,1401,0
104524108238,104524108238,0,1222,1945,0
104526138552,104526138565,13,1335,2205,0
104529703227,104529703230,3,1084,1628,0
104529841729,104529841730,1,1214,1539,0
104531407027,104531407026,-1,849,1141,0
104532121659,104532121662,3,1112,961,0
104535552338,104535552338,0,1431,1733,0
104536433264,104536433265,1,1251,1944,0
104539149120,104539149122,2,1815,1713,0
104544789810,104544789810,0,1956,1948,0
104547907247,104547907246,-1,1513,2532,0
104548173133,104548173140,7,6512,2596,0
104551170266,104551170266,0,1613,2028,0
104552131653,104552131653,0,2175,2178,0
104554717026,104554717026,0,1289,2195,0
104555261533,104555261534,1,1793,1424,0
104556791458,104556791461,3,1498,1554,0
104558236900,104558236899,-1,1525,1796,0
104559119641,104559119642,1,506,958,0
104562796670,104562796671,1,1511,1572,0
104562871538,104562871537,-1,2098,1806,0
104565996769,104565996770,1,1446,2091,0
104567032509,104567032512,3,1423,1722,0
104578519647,104578519650,3,1009,1135,0
104583524431,104583524431,0,1677,1828,0
104584421966,104584421965,-1,1162,1671,0
104585101658,104585101659,1,1482,965,0
104587674995,104587674997,2,1984,1686,0
104588036075,104588036075,0,1658,2047,0
104589013523,104589013523,0,1087,1091,0
104591726505,104591726505,0,1256,1406,0
104595896955,104595896956,1,1411,2090,0
104598809705,104598809705,0,1392,1277,0
104599873677,104599873681,4,2071,1595,0
104600518038,104600518040,2,1632,1627,0
104603363662,104603363663,1,1722,1900,0
104605331004,104605331005,1,2003,1892,0
104606906501,104606906503,2,1297,1566,0
104606977375,104606977375,0,1285,1414,0
104610187038,104610187040,2,4414,4827,0
104612576661,104612576662,1,679,1545,0
104614572576,104614572575,-1,1041,1310,0
104614971651,104614971670,19,1264,1912,0
104617657531,104617657530,-1,1200,1835,0
104617826896,104617826879,-17,201,1085,0
104619574455,104619574457,2,1679,1409,0
104620311150,104620311152,2,1564,1889,0
104621300345,104621300346,1,1574,1409,0
104622388378,104622388377,-1,1002,1653,0
104622572454,104622572454,0,1263,1855,0
104625694731,104625694732,1,1278,1413,0
104629848449,104629848451,2,796,1196,0
104632813874,104632813875,1,1427,1518,0
104634676455,104634676459,4,1255,909,0
104635307046,104635307048,2,1188,1687,0
104637692824,104637692826,2,1447,2045,0
104638192912,104638192930,18,603,608,0
104639947209,104639947209,0,1267,1872,0
104641806507,104641806509,2,1955,1376,0
104645236999,104645237003,4,1209,1281,0
104646039835,104646039837,2,1174,2414,0
104652722667,104652722669,2,2183,1867,0
104653545631,104653545635,4,2065,1129,0
104653715967,104653715962,-5,912,1186,0
104653848567,104653848568,1,1719,2410,0
104657308046,104657308036,-10,40097,16319,0
104659414810,104659414813,3,1473,1465,0
104660564359,104660564358,-1,1676,2287,0
104661801987,104661801987,0,1355,1303,0
104663156430,104663156431,1,1612,1397,0
104663221957,104663221958,1,2239,1943,0
104665149125,104665149126,1,1412,1340,0
104665512343,104665512342,-1,1074,1214,0
104665986959,104665986959,0,1893,2205,0
104666292367,104666292367,0,1799,2153,0
104667485873,104667485871,-2,1402,1730,0
104667692215,104667692216,1,1005,1370,0
104668990226,104668990225,-1,852,834,0
104671033645,104671033646,1,1791,1472,0
104671233942,104671233927,-15,1338,725,0
104671947890,104671947900,10,1528,1806,0
104673228465,104673228471,6,2333,928,0
104674978739,104674978739,0,1630,1139,0
104678102487,104678102488,1,1026,2013,0
104679811893,104679811893,0,1607,1333,0
104680444949,104680444949,0,1378,1718,0
104685874713,104685874714,1,1115,1885,0
104691890413,104691890415,2,2095,2273,0
104694088635,104694088633,-2,1576,1663,0
104696608027,104696608028,1,1609,1444,0
104700047383,104700047385,2,1707,1416,0
104703263047,104703263050,3,1390,1596,0
104708393038,104708393039,1,1382,1934,0
104708749975,104708749976,1,1170,1411,0
104709571438,104709571442,4,1434,1297,0
104711744950,104711744950,0,1615,1967,0
104715884598,104715884599,1,1379,1806,0
104716202251,104716202251,0,1408,1265,0
104720813807,104720813807,0,1177,1783,0
104721282050,104721282053,3,1614,1857,0
104723235829,104723235829,0,1281,1481,0
104724589567,104724589570,3,1009,1130,0
104726711544,104726711543,-1,1285,1359,0
104728848918,104728848919,1,1082,1578,0
104729773265,104729773265,0,1667,1484,0
104733261737,104733261738,1,1257,1609,0
104734573438,104734573438,0,1015,1313,0
104735687978,104735687979,1,1461,2217,0
104738925574,104738925575,1,1566,1617,0
104742147433,104742147433,0,1543,1851,0
104743381534,104743381535,1,1445,1718,0
104745876545,104745876547,2,1492,1529,0
104750498302,104750498309,7,3222,1717,0
104751154834,104751154833,-1,1382,2162,0
104753445185,104753445187,2,716,1095,0
104754302859,104754302860,1,1359,1004,0
104755385807,104755385808,1,1564,1780,0
104756360689,104756360690,1,1188,1379,0
104758106396,104758106398,2,1433,1701,0
104758896568,104758896569,1,1440,2200,0
104759444774,104759444777,3,1273,1871,0
104760799348,104760799346,-2,1220,1643,0
104761027733,104761027732,-1,1006,1527,0
104762875854,104762875854,0,1505,1267,0
104763087138,104763087138,0,650,1817,0
104763628788,104763628811,23,756,1788,0
104765053260,104765053259,-1,1198,1389,0
104765183901,104765183901,0,1188,2077,0
104767699658,104767699644,-14,1896,749,0
104771313934,104771313935,1,1298,886,0
104775457455,104775457454,-1,1353,1921,0
104778187312,104778187310,-2,1389,2080,0
104778685674,104778685675,1,1705,1315,0
104778810993,104778810993,0,1469,2122,0
104779148981,104779148977,-4,189,435,0
104780696358,104780696358,0,1454,1985,0
104782722350,104782722352,2,1171,1008,0
104785915075,104785915074,-1,1232,1712,0
104787542589,104787542588,-1,869,1464,0
104787928504,104787928505,1,1221,2042,0
104788126958,104788126964,6,40284,26627,0
104788691191,104788691193,2,1184,1150,0
104790828529,104790828530,1,1664,2189,0
104792002336,104792002335,-1,1392,2092,0
104792611622,104792611643,21,1577,1405,0
104792871970,104792871970,0,1159,1566,0
104798143541,104798143542,1,1830,1877,0
104799681217,104799681220,3,1310,1548,0
104803568648,104803568649,1,1649,1594,0
104804404294,104804404294,0,1569,1812,0
104805470517,104805470523,6,1949,1628,0
104806767469,104806767470,1,1748,2181,0
104811194471,104811194473,2,1948,2273,0
104816676601,104816676602,1,1491,1403,0
104816899646,104816899647,1,1872,2400,0
104817790321,104817790318,-3,975,2521,0
104820299146,104820299153,7,3045,1357,0
104824082618,104824082621,3,1721,1988,0
104824271751,104824271753,2,780,1696,0
104825486219,104825486218,-1,953,1264,0
104828994559,104828994558,-1,1032,1329,0
104829334270,104829334276,6,2364,1342,0
104829764673,104829764674,1,1545,1910,0
104831366653,104831366652,-1,1483,1971,0
104833227647,104833227647,0,1317,1874,0
104834561517,104834561517,0,1744,1841,0
104835299982,104835299982,0,1544,1773,0
104839330759,104839330761,2,1260,1319,0
104842876630,104842876628,-2,1140,2038,0
104844968777,104844968779,2,863,2048,0
104852291561,104852291560,-1,1008,1888,0
104853677602,104853677601,-1,1554,1889,0
104855035827,104855035826,-1,1154,1996,0
104856452306,104856452306,0,1763,1242,0
104856967158,104856967158,0,1214,1098,0
104862031487,104862031487,0,1323,1480,0
104862312953,104862312954,1,1399,1414,0
104862490128,104862490131,3,1276,1222,0
104863194485,104863194485,0,780,1000,0
104867769149,104867769150,1,1124,2040,0
104871695458,104871695440,-18,1279,1331,0
104872231573,104872231591,18,1695,2142,0
104875965426,104875965427,1,1293,1549,0
104877234564,104877234566,2,1398,1686,0
104878863582,104878863584,2,1539,1731,0
104879105514,104879105526,12,2948,1171,0
104879610488,104879610487,-1,1977,1427,0
104881220999,104881220998,-1,1158,1819,0
104882147977,104882147977,0,1001,1622,0
104882219004,104882219005,1,1367,1637,0
104883841063,104883841061,-2,797,1622,0
104885787790,104885787791,1,1776,1830,0
104886197361,104886197362,1,1413,1696,0
104886660681,104886660696,15,1281,1535,0
104890316467,104890316467,0,1205,1744,0
104891837044,104891837044,0,1447,1602,0
104892736226,104892736227,1,1005,1133,0
104894557998,104894557997,-1,1067,976,0
104897886803,104897886801,-2,1229,1997,0
104898348703,104898348703,0,1205,1686,0
104900632625,104900632625,0,1775,2143,0
104901561440,104901561441,1,1049,1475,0
104904381668,104904381661,-7,12691,19667,0
104904744822,104904744822,0,1397,2051,0
104905400058,104905400058,0,1198,1588,0
104906987543,104906987542,-1,1899,2629,0
104907445511,104907445511,0,1476,2556,0
104908802667,104908802667,0,1669,1382,0
104913615429,104913615435,6,2647,1350,0
104914759458,104914759461,3,1133,1092,0
104916413439,104916413441,2,1935,2493,0
104918839917,104918839917,0,1483,1536,0
104924749722,104924749721,-1,1277,1670,0
104926084089,104926084089,0,1515,1922,0
104926166334,104926166315,-19,935,1767,0
104927088014,104927088013,-1,1377,1497,0
104927441346,104927441348,2,718,777,0
104929705322,104929705317,-5,1180,4174,0
104930934741,104930934741,0,881,1338,0
104932074242,104932074242,0,2590,2486,0
104932180518,104932180519,1,1716,1831,0
104932354702,104932354703,1,1108,1219,0
104932720975,104932720981,6,1308,1488,0
104932977043,104932977043,0,663,1165,0
104938096761,104938096760,-1,1596,1454,0
104939526687,104939526685,-2,1202,1542,0
104942143712,104942143710,-2,1347,2473,0
104949858078,104949858080,2,1073,1390,0
104951574222,104951574222,0,1268,1620,0
104952153390,104952153388,-2,1181,1535,0
104953118479,104953118479,0,1386,1885,0
104958622213,104958622213,0,1379,1864,0
104960585758,104960585758,0,913,1974,0
104963532166,104963532167,1,1556,2119,0
104963609758,104963609746,-12,1660,1416,0
104965073606,104965073607,1,1263,1263,0
104965905190,104965905189,-1,7558,14683,0
104969542807,104969542806,-1,1168,1541,0
104973180273,104973180271,-2,1567,2503,0
104973603459,104973603455,-4,3513,12031,0
104975328075,104975328077,2,1339,1797,0
104979918278,104979918279,1,1391,1582,0
104980076034,104980076034,0,1344,2247,0
104980467782,104980467783,1,877,1677,0
104982293046,104982293046,0,1287,1547,0
104988123086,104988123087,1,1487,1234,0
104990658243,104990658244,1,1058,1585,0
104996724246,104996724248,2,1871,1872,0
105000991234,105000991240,6,3221,1545,0
105001599467,105001599468,1,1736,1712,0
105002717490,105002717490,0,1530,1567,0
105006153274,105006153274,0,838,1215,0
105008399535,105008399533,-2,1130,1123,0
105012662719,105012662721,2,1288,1862,0
105013816145,105013816147,2,1020,844,0
105014705877,105014705875,-2,1420,1158,0
105015377019,105015377018,-1,1351,2252,0
105016217370,105016217371,1,1299,1494,0
105022171067,105022171068,1,1087,1410,0
105027736287,105027736290,3,1497,1195,0
105029345302,105029345303,1,1807,1952,0
105029956535,105029956533,-2,1239,1660,0
105030478710,105030478712,2,1117,1581,0
105032237818,105032237818,0,1631,1340,0
105033155193,105033155179,-14,3361,1344,0
105033589007,105033589005,-2,1194,2050,0
105035734371,105035734373,2,1279,1138,0
105036816359,105036816358,-1,1177,2065,0
105038876794,105038876795,1,1379,1601,0
105039719198,105039719199,1,1150,1466,0
105040198170,105040198170,0,1447,1585,0
105046451482,105046451485,3,1654,1631,0
105048155886,105048155886,0,1201,2030,0
105048468734,105048468738,4,1412,1492,0
105048565239,105048565231,-8,988,1029,0
105048973378,105048973379,1,1539,1941,0
105049431079,105049431082,3,1247,1410,0
105051613522,105051613522,0,1525,1936,0
105055369402,105055369406,4,1295,1506,0
105056515376,105056515377,1,1667,1927,0
105057852624,105057852623,-1,999,864,0
105058807553,105058807567,14,21984,26008,0
105061062627,105061062628,1,1052,1367,0
105063845832,105063845833,1,1267,1891,0
105065223810,105065223809,-1,1395,1784,0
105067583103,105067583103,0,1010,1579,0
105068329953,105068329955,2,1587,1704,0
105068982254,105068982250,-4,1840,2022,0
105075751028,105075751027,-1,743,1136,0
105076344805,105076344805,0,1825,1971,0
105077026825,105077026824,-1,1530,2631,0
105077208770,105077208768,-2,1047,1338,0
105078295968,105078295969,1,1594,1757,0
105081416062,105081416062,0,921,1411,0
105083261619,105083261621,2,1345,1764,0
105086010958,105086010958,0,950,1580,0
105087884559,105087884559,0,1613,1712,0
105089649742,105089649741,-1,1292,1681,0
105092653274,105092653273,-1,7886,12265,0
105092730178,105092730179,1,1679,1761,0
105093027915,105093027916,1,1687,2305,0
105093946461,105093946461,0,1224,1760,0
105094892574,105094892566,-8,2452,8324,0
105095502925,105095502925,0,2069,2093,0
105099720690,105099720692,2,1243,1889,0
105100380664,105100380664,0,1137,1424,0
105100732974,105100732975,1,1406,1654,0
105102706668,105102706673,5,3433,2522,0
105102988487,105102988486,-1,1564,1919,0
105106121650,105106121651,1,1777,1150,0
105106192553,105106192554,1,1516,1470,0
105109904146,105109904145,-1,1655,1747,0
105110735818,105110735819,1,970,1436,0
105112737514,105112737514,0,1383,1732,0
105114145990,105114145993,3,2281,1943,0
105115179974,105115179973,-1,1182,1026,0
105117217719,105117217723,4,960,1074,0
105121164375,105121164373,-2,1195,1702,0
105121440895,105121440896,1,1746,1812,0
105126398153,105126398156,3,701,1074,0
105127116455,105127116455,0,1500,1764,0
105128235424,105128235425,1,1302,1572,0
105131335894,105131335897,3,1761,1252,0
105135563879,105135563880,1,2718,2096,0
105135964190,105135964189,-1,1577,2139,0
105136437668,105136437670,2,1737,1531,0
105136806377,105136806378,1,1126,1334,0
105139650965,105139650964,-1,975,1675,0
105141352001,105141352002,1,2356,1710,0
105146175151,105146175163,12,706,261,0
105147707794,105147707796,2,1509,1641,0
105148002271,105148002253,-18,524,394,0
105151837514,105151837516,2,1398,1927,0
105152268407,105152268409,2,1811,2560,0
105153167943,105153167943,0,1023,1506,0
105156389190,105156389193,3,1414,1502,0
105159204778,105159204778,0,1305,1342,0
105159561996,105159561999,3,1785,1514,0
105160785983,105160785980,-3,759,1919,0
105160997446,105160997462,16,359,1611,0
105163644253,105163644254,1,1444,2125,0
105163737554,105163737554,0,1365,1936,0
105170180513,105170180513,0,977,1414,0
105172495041,105172495041,0,689,1176,0
105174009607,105174009609,2,1848,1926,0
105174916266,105174916267,1,1127,1736,0
105175688807,105175688805,-2,1348,1638,0
105176542052,105176542053,1,1119,2046,0
105177718790,105177718790,0,867,1084,0
105179208047,105179208049,2,1312,1755,0
105182606835,105182606835,0,1974,1110,0
105186624650,105186624651,1,1335,1631,0
105189694902,105189694902,0,1228,1670,0
105193380614,105193380603,-11,21,1180,0
105196685506,105196685509,3,2899,1862,0
105197708334,105197708337,3,1292,1640,0
105199532878,105199532879,1,949,1022,0
105201586902,105201586899,-3,1699,3003,0
105201783802,105201783802,0,1460,1225,0
105202303209,105202303209,0,1323,2399,0
105202433557,105202433557,0,1280,1552,0
105203110353,105203110355,2,1088,1064,0
105204431526,105204431526,0,873,1320,0
105209442814,105209442814,0,1443,1914,0
105210433786,105210433785,-1,1232,1537,0
105214797561,105214797561,0,1664,1326,0
105217321825,105217321826,1,1439,1768,0
105220397953,105220397953,0,1666,1968,0
105221576073,105221576076,3,1303,1585,0
105222590948,105222590948,0,1111,1730,0
105223225570,105223225569,-1,1087,1373,0
105226607035,105226607036,1,1276,2296,0
105227114718,105227114718,0,1651,1701,0
105229491007,105229491011,4,2020,1642,0
105232668209,105232668212,3,1051,1765,0
105235734866,105235734866,0,1267,1693,0
105237450735,105237450743,8,1167,1265,0
105238727307,105238727306,-1,1317,1571,0
105239751823,105239751825,2,1171,1577,0
105240316040,105240316046,6,4401,1188,0
105241048170,105241048170,0,1189,1551,0
105245816787,105245816786,-1,1092,1502,0
105247150358,105247150359,1,1452,2353,0
105250874766,105250874767,1,1259,1700,0
105252877158,105252877164,6,4394,2575,0
105255396094,105255396093,-1,1170,1811,0
105263077250,105263077250,0,1221,1395,0
105264064607,105264064608,1,1153,2228,0
105268383206,105268383209,3,1017,1393,0
105268456148,105268456149,1,1407,1341,0
105271687892,105271687894,2,821,881,0
105271715085,105271715064,-21,1456,1786,0
105273691083,105273691085,2,1658,1389,0
105273783184,105273783187,3,1463,1391,0
105276821709,105276821712,3,1818,1350,0
105281325029,105281325022,-7,1246,5642,0
105283817727,105283817728,1,1397,1631,0
105285895402,105285895402,0,1118,2555,0
105292365292,105292365290,-2,1518,2806,0
105294446722,105294446722,0,1194,1211,0
105295334803,105295334802,-1,1519,1733,0
105297087495,105297087496,1,1046,1313,0
105297136361,105297136361,0,1371,1495,0
105298787955,105298787955,0,1296,1343,0
105299267570,105299267569,-1,1628,2327,0
105300929035,105300929036,1,1257,1517,0
105302181087,105302181086,-1,1859,1823,0
105304637638,105304637641,3,1400,810,0
105306126778,105306126778,0,1289,1923,0
105306707002,105306706999,-3,1144,2104,0
105306763910,105306763913,3,2275,2371,0
105307335200,105307335201,1,1407,1674,0
105311723634,105311723635,1,852,1058,0
105313687667,105313687670,3,1582,2296,0
105316956670,105316956670,0,1611,2696,0
105318100422,105318100424,2,1213,987,0
105318816143,105318816146,3,1324,1722,0
105320367954,105320367959,5,1324,1017,0
105321978577,105321978578,1,1700,1547,0
105323445446,105323445447,1,2116,1862,0
105328184783,105328184789,6,2068,1154,0
105329669073,105329669074,1,1455,1747,0
105331431861,105331431861,0,877,2038,0
105341365573,105341365569,-4,764,1377,0
105342252877,105342252857,-20,1284,1380,0
105344301930,105344301930,0,1178,1623,0
105349651891,105349651887,-4,3015,7434,0
105353320443,105353320442,-1,1403,2240,0
105354882314,105354882313,-1,1527,1879,0
105355602314,105355602317,3,1470,1703,0
105355695367,105355695365,-2,1252,1648,0
105359184858,105359184858,0,1838,2240,0
105360775913,105360775913,0,1016,1681,0
105361443642,105361443641,-1,1646,2344,0
105362685818,105362685817,-1,2533,3644,0
105363644262,105363644262,0,1268,1456,0
105365666670,105365666669,-1,1008,2160,0
105370677150,105370677151,1,888,1278,0
105371545802,105371545804,2,1075,1756,0
105372529626,105372529627,1,1799,2613,0
105373492623,105373492625,2,1361,1401,0
105374431333,105374431338,5,1600,1583,0
105375409389,105375409391,2,899,925,0
105377603692,105377603694,2,1597,1211,0
105378521094,105378521097,3,1878,1286,0
105379954375,105379954378,3,1363,1719,0
105382353939,105382353939,0,825,1186,0
105383446979,105383446976,-3,65783,58605,0
105387122059,105387122062,3,1104,1362,0
105388839549,105388839545,-4,1091,3842,0
105390260234,105390260230,-4,1960,6655,0
105397321674,105397321673,-1,925,1402,0
105399127950,105399127949,-1,1298,1864,0
105400204322,105400204322,0,1469,1979,0
105401149863,105401149865,2,1531,1552,0
105401189718,105401189720,2,1870,1329,0
105401763822,105401763824,2,1844,1461,0
105402236431,105402236430,-1,1466,2091,0
105405819994,105405819994,0,1455,1963,0
105406083976,105406083978,2,1748,1711,0
105408545923,105408545923,0,1637,1297,0
105410162298,105410162299,1,1775,2193,0
105410562115,105410562117,2,1517,1656,0
105411587065,105411587070,5,6461,1683,0
105413527633,105413527634,1,1613,1876,0
105419519306,105419519305,-1,1388,1647,0
105421705146,105421705142,-4,1147,3278,0
105423026861,105423026862,1,992,1172,0
105423599535,105423599538,3,1932,2129,0
105424433110,105424433112,2,2106,1406,0
105424665680,105424665693,13,1292,1985,0
105425223541,105425223535,-6,1239,1546,0
105427099006,105427099008,2,939,1228,0
105428246810,105428246818,8,2238,1708,0
105429529250,105429529251,1,1726,1456,0
105434881647,105434881646,-1,1224,2102,0
105437808552,105437808552,0,1437,2454,0
105438183285,105438183286,1,1205,2349,0
105440104330,105440104330,0,1048,1766,0
105441746425,105441746424,-1,1792,2419,0
105442262072,105442262074,2,1542,1623,0
105445552284,105445552286,2,1895,1526,0
105447825842,105447825842,0,1515,1805,0
105448267949,105448267949,0,1815,1919,0
105449349670,105449349670,0,1322,2060,0
105449724501,105449724507,6,1255,1107,0
105450699257,105450699263,6,3563,1617,0
105451693773,105451693773,0,1171,1616,0
105451767576,105451767574,-2,1418,2291,0
105458803064,105458803066,2,1092,1177,0
105459017262,105459017247,-15,1163,1397,0
105461075870,105461075871,1,2126,1837,0
105462452144,105462452144,0,1770,1377,0
105463738234,105463738235,1,1322,2031,0
105464290572,105464290566,-6,34615,9111,0
105464760896,105464760895,-1,1807,2291,0
105465452499,105465452477,-22,1068,850,0
105470043243,105470043245,2,1692,1467,0
105470564538,105470564541,3,1517,1610,0
105472992486,105472992481,-5,1046,2902,0
105476117055,105476117056,1,1832,2626,0
105477353055,105477353055,0,1346,1945,0
105477771813,105477771814,1,1465,1643,0
105485724405,105485724406,1,1377,1560,0
105485829729,105485829729,0,1269,1768,0
105490579003,105490579004,1,946,664,0
105492363433,105492363434,1,1570,1983,0
105495523535,105495523534,-1,1168,1530,0
105496551422,105496551423,1,1585,1658,0
105496766645,105496766645,0,1595,1542,0
105499888474,105499888475,1,755,968,0
105502392238,105502392236,-2,21102,7412,0
105504528875,105504528876,1,1492,2351,0
105506518090,105506518090,0,1401,1802,0
105508548490,105508548490,0,1557,2149,0
105510192897,105510192898,1,1661,1621,0
105511165147,105511165159,12,1061,1424,0
105515134866,105515134869,3,1293,2259,0
105516480606,105516480606,0,1027,1203,0
105516971705,105516971707,2,2637,1898,0
105517399541,105517399542,1,1060,1750,0
105518876683,105518876683,0,1660,1843,0
105519811873,105519811886,13,1124,951,0
105520528030,105520528030,0,1831,1900,0
105523609954,105523609953,-1,1072,1610,0
105524141873,105524141880,7,14547,18219,0
105526035710,105526035709,-1,1387,1728,0
105527747813,105527747810,-3,1363,2359,0
105528712226,105528712228,2,1568,1684,0
105531627689,105531627691,2,1343,1891,0
105532162835,105532162835,0,1190,1842,0
105532218788,105532218794,6,6314,3196,0
105533564282,105533564281,-1,1306,1341,0
105535200425,105535200423,-2,1625,1446,0
105535642083,105535642079,-4,2253,4636,0
105537189455,105537189459,4,2113,1518,0
105541560425,105541560426,1,1003,971,0
105548822846,105548822847,1,993,1822,0
105550012639,105550012639,0,1199,2255,0
105552973703,105552973706,3,1414,1435,0
105553712974,105553712974,0,1150,1108,0
105553913550,105553913550,0,1291,1757,0
105556186132,105556186125,-7,1573,4035,0
105557772210,105557772209,-1,1235,1382,0
105561206469,105561206466,-3,871,2581,0
105562574033,105562574034,1,1065,1282,0
105562914372,105562914353,-19,1705,1134,0
105563811768,105563811764,-4,1371,3147,0
105564553831,105564553829,-2,1478,2043,0
105569537767,105569537768,1,1213,1400,0
105571211730,105571211735,5,2263,1855,0
105571856275,105571856276,1,1438,2262,0
105573245275,105573245275,0,1052,1924,0
105573691974,105573691975,1,1110,1201,0
105575346752,105575346752,0,1578,1736,0
105575850438,105575850438,0,1116,2316,0
105576881670,105576881670,0,1257,1892,0
105581751783,105581751784,1,1210,1809,0
105582292378,105582292381,3,1498,1609,0
105589558685,105589558686,1,1960,1746,0
105589685334,105589685336,2,1864,1873,0
105593053410,105593053409,-1,1688,1724,0
105593549909,105593549909,0,725,1067,0
105594057263,105594057262,-1,1418,2429,0
105594319613,105594319613,0,1642,2537,0
105594800189,105594800191,2,1122,1754,0
105595262231,105595262230,-1,827,1171,0
105596502643,105596502644,1,1026,914,0
105597060074,105597060074,0,1392,2140,0
105598031442,105598031441,-1,1233,1271,0
105598452038,105598452038,0,1608,1825,0
105598609046,105598609051,5,3106,1601,0
105600067686,105600067687,1,1545,1617,0
105601900638,105601900638,0,1156,2182,0
105608380442,105608380442,0,1245,1558,0
105610173263,105610173262,-1,1613,1849,0
105610390838,105610390840,2,1509,1973,0
105616671949,105616671949,0,1375,1824,0
105617642557,105617642558,1,1879,2239,0
105618662765,105618662764,-1,1397,1734,0
105618957319,105618957317,-2,1393,1545,0
105619974662,105619974656,-6,34028,13195,0
105621273085,105621273083,-2,3059,4061,0
105623151607,105623151606,-1,1409,1147,0
105625107235,105625107238,3,1595,1682,0
105625409941,105625409941,0,2641,4625,0
105625555234,105625555234,0,978,2311,0
105625734062,105625734063,1,1069,1023,0
105627728172,105627728175,3,1360,1816,0
105628953807,105628953803,-4,890,1371,0
105633043182,105633043182,0,1299,1735,0
105633187283,105633187283,0,1478,1504,0
105635161326,105635161326,0,1446,1907,0
105636418403,105636418403,0,1299,1096,0
105637368034,105637368034,0,1154,1554,0
105640984113,105640984114,1,1876,2468,0
105641723877,105641723877,0,1804,2004,0
105641846803,105641846804,1,1564,1478,0
105646889811,105646889811,0,1510,1802,0
105652167625,105652167625,0,1086,1834,0
105654017741,105654017742,1,1410,1859,0
105659996114,105659996114,0,1070,1513,0
105660080566,105660080566,0,1566,1825,0
105660246679,105660246679,0,1351,2377,0
105660760147,105660760148,1,1989,2429,0
105660924227,105660924227,0,945,1808,0
105662742941,105662742942,1,1103,1640,0
105664305782,105664305784,2,1527,988,0
105667310577,105667310579,2,1197,1222,0
105669895630,105669895633,3,1235,1085,0
105670832390,105670832390,0,820,1094,0
105672106795,105672106794,-1,1107,1525,0
105673624430,105673624419,-11,1312,1526,0
105674477049,105674477050,1,987,1681,0
105674821523,105674821526,3,1315,1239,0
105674850396,105674850397,1,1383,1321,0
105677221625,105677221626,1,1229,1619,0
105679439727,105679439730,3,1675,1677,0
105691992683,105691992686,3,1736,1011,0
105692765113,105692765114,1,1389,1605,0
105693885380,105693885381,1,1851,2048,0
105694253010,105694253010,0,1277,1600,0
105694933662,105694933670,8,1383,1186,0
105696277798,105696277796,-2,1252,1224,0
105697646901,105697646901,0,817,934,0
105702763055,105702763056,1,1461,2166,0
105702980514,105702980513,-1,997,1902,0
105704158779,105704158764,-15,1287,825,0
105704617817,105704617816,-1,1508,2017,0
105705277498,105705277501,3,1537,1556,0
105711148110,105711148111,1,879,1252,0
105714206565,105714206566,1,1316,1621,0
105715000294,105715000295,1,1277,1417,0
105715948913,105715948913,0,1796,1150,0
105716184954,105716184957,3,1193,1978,0
105716514808,105716514807,-1,1782,1334,0
105717494358,105717494358,0,1535,1592,0
105719646483,105719646483,0,1986,2025,0
105729029426,105729029426,0,1094,1033,0
105731849989,105731849988,-1,2003,2070,0
105732261998,105732262002,4,1207,1208,0
105732314246,105732314259,13,25222,59588,0
105732732315,105732732318,3,1491,1322,0
105734051368,105734051370,2,1192,2201,0
105738975584,105738975585,1,754,1328,0
105741773919,105741773919,0,981,1215,0
105742678677,105742678677,0,1650,1710,0
105749092270,105749092270,0,1699,2036,0
105749133417,105749133417,0,1279,1432,0
105754855287,105754855298,11,1242,1834,0
105755645084,105755645087,3,1635,1250,0
105759273767,105759273767,0,1463,1281,0
105759429369,105759429375,6,2805,1338,0
105759832969,105759832966,-3,1377,1966,0
105762539466,105762539465,-1,1191,1651,0
105764042978,105764042978,0,1285,1562,0
105767652614,105767652615,1,1187,1862,0
105768498562,105768498563,1,1602,1491,0
105769678121,105769678122,1,1375,1487,0
105771236710,105771236711,1,1289,1512,0
105771501726,105771501727,1,1223,1581,0
105771973991,105771973993,2,1190,1177,0
105774160989,105774160990,1,1552,1874,0
105775660377,105775660378,1,2050,1711,0
105778549589,105778549588,-1,3051,4131,0
105779030477,105779030479,2,1274,1467,0
105779928032,105779928030,-2,1432,1357,0
105781397740,105781397741,1,1547,1307,0
105786692322,105786692321,-1,1260,1663,0
105786788361,105786788360,-1,1709,2147,0
105794666551,105794666553,2,1749,1550,0
105798111746,105798111746,0,1098,1382,0
105805123011,105805123012,1,1279,1741,0
105807420630,105807420630,0,1765,1416,0
105811040415,105811040415,0,1086,1485,0
105811999217,105811999218,1,1243,2255,0
105812998289,105812998289,0,945,2009,0
105815730268,105815730269,1,1219,977,0
105816617678,105816617678,0,1495,1834,0
105818980393,105818980393,0,1124,1525,0
105820185357,105820185357,0,1477,1170,0
105822675797,105822675798,1,1376,2138,0
105824252531,105824252532,1,1220,1177,0
105826539955,105826539954,-1,1265,2280,0
105830472326,105830472326,0,1039,2120,0
105835158898,105835158898,0,1223,1685,0
105837503855,105837503854,-1,1420,1665,0
105841520121,105841520118,-3,1091,1458,0
105844519775,105844519775,0,1342,1876,0
105845572510,105845572511,1,1260,1425,0
105848938205,105848938204,-1,1264,2248,0
105850233034,105850233035,1,1366,1618,0
105851538371,105851538371,0,683,748,0
105853090759,105853090755,-4,1155,1963,0
105853287025,105853287025,0,1395,1401,0
105853732231,105853732250,19,39963,21750,0
105856601019,105856601019,0,1242,2155,0
105858828223,105858828231,8,4369,1339,0
105860289822,105860289823,1,1359,1455,0
105860969404,105860969402,-2,1210,1931,0
105863301349,105863301350,1,1820,1704,0
105863790709,105863790709,0,1176,1371,0
105863985118,105863985118,0,1807,2320,0
105870670376,105870670379,3,1047,901,0
105873071346,105873071349,3,1513,1500,0
105875686026,105875686022,-4,1179,1961,0
105878837525,105878837526,1,1703,1531,0
105880326195,105880326195,0,1071,1365,0
105880589897,105880589897,0,1568,1887,0
105889271258,105889271258,0,1592,1968,0
105891033335,105891033335,0,1750,1837,0
105892026138,105892026139,1,1368,1284,0
105896621851,105896621850,-1,950,1359,0
105899894057,105899894058,1,1160,973,0
105900637538,105900637537,-1,1360,1519,0
105903531570,105903531569,-1,1600,1081,0
105903882241,105903882242,1,1459,1812,0
105905284449,105905284449,0,1150,1509,0
105905344813,105905344810,-3,28654,71500,0
105907851338,105907851339,1,1123,1457,0
105913107190,105913107190,0,925,1508,0
105914225239,105914225238,-1,1085,1289,0
105914457657,105914457679,22,1303,1269,0
105914769223,105914769234,11,599,1137,0
105915889198,105915889198,0,1472,1754,0
105917493695,105917493697,2,1775,1335,0
105921701614,105921701618,4,1784,1096,0
105921745311,105921745317,6,1498,1364,0
105922623763,105922623764,1,1352,1364,0
105922961446,105922961447,1,1677,2327,0
105925369194,105925369193,-1,1380,1479,0
105927081648,105927081650,2,1402,1770,0
105929760007,105929760007,0,1116,1381,0
105931541293,105931541295,2,1237,1855,0
105931850874,105931850876,2,1541,2293,0
105932567615,105932567617,2,1609,1335,0
105933113202,105933113206,4,1848,2034,0
105933571943,105933571943,0,574,838,0
105938089297,105938089298,1,1216,1314,0
105938656531,105938656532,1,1457,2084,0
105939162670,105939162677,7,1255,1511,0
105941532874,105941532873,-1,917,1971,0
105941947537,105941947538,1,1311,1717,0
105945440590,105945440589,-1,1526,1598,0
105945996438,105945996438,0,1414,2010,0
105946808566,105946808577,11,1384,1375,0
105947855903,105947855903,0,1468,1629,0
105951005986,105951005986,0,1587,1748,0
105953672330,105953672330,0,1042,1315,0
105957001234,105957001234,0,1448,2416,0
105963046805,105963046806,1,1640,1566,0
105968175058,105968175058,0,1721,1713,0
105968979462,105968979462,0,1265,1639,0
105970065456,105970065459,3,1200,1151,0
105977671426,105977671424,-2,1514,1266,0
105978200042,105978200042,0,1398,1612,0
105982679381,105982679380,-1,1398,1717,0
105989899560,105989899561,1,1879,2614,0
105989970427,105989970427,0,1215,2853,0
105992186623,105992186624,1,1524,1407,0
105995102214,105995102214,0,1540,1979,0
105998897997,105998897991,-6,2228,7882,0
105999191413,105999191412,-1,1737,2798,0
106000074023,106000074024,1,1113,1337,0
106001444421,106001444421,0,930,1259,0
106002516338,106002516338,0,1007,1210,0
106008212724,106008212734,10,1227,1933,0
106010676009,106010676010,1,1158,1724,0
106010950397,106010950398,1,1571,1432,0
106012017066,106012017070,4,1270,1643,0
106015111880,106015111881,1,1362,2169,0
106017542498,106017542496,-2,1028,2058,0
106019476819,106019476821,2,1325,1688,0
106020618048,106020618048,0,1059,1441,0
106022498611,106022498609,-2,1199,2023,0
106029841054,106029841054,0,1370,1273,0
106029976985,106029976987,2,1075,1837,0
106036039601,106036039601,0,1281,1442,0
106039016361,106039016361,0,693,944,0
106046271647,106046271649,2,1337,1590,0
106054448037,106054448038,1,1428,1042,0
106057922190,106057922190,0,1428,2029,0
106058850536,106058850549,13,755,4479,0
106059721890,106059721882,-8,924,4334,0
106060819632,106060819633,1,820,1258,0
106063352451,106063352451,0,1262,1400,0
106063604618,106063604617,-1,790,1169,0
106066324650,106066324670,20,1174,1488,0
106071001706,106071001705,-1,1256,1207,0
106073008557,106073008557,0,1633,2087,0
106074664153,106074664155,2,1232,1753,0
106078231975,106078231974,-1,993,901,0
106078470232,106078470230,-2,1595,1820,0
106080651163,106080651163,0,1354,1331,0
106082309724,106082309725,1,1779,1667,0
106082963098,106082963099,1,1298,1781,0
106083384416,106083384417,1,1342,1641,0
106088989671,106088989671,0,1331,1836,0
106090297546,106090297546,0,1283,1702,0
106094912954,106094912954,0,1806,2223,0
106095162331,106095162331,0,1389,1466,0
106096876345,106096876347,2,1309,1556,0
106097003285,106097003286,1,992,1031,0
106100981694,106100981694,0,1255,1774,0
106102742481,106102742474,-7,3808,13724,0
106105117438,106105117444,6,1044,1513,0
106109128897,106109128890,-7,774,2121,0
106112478864,106112478865,1,1835,1790,0
106113018043,106113018043,0,1309,1498,0
106113415927,106113415926,-1,1423,1768,0
106115427911,106115427911,0,24775,18829,0
106117317345,106117317344,-1,1219,2372,0
106117715947,106117715947,0,1607,1688,0
106118948102,106118948104,2,1334,1429,0
106125592840,106125592839,-1,1445,2578,0
106126555634,106126555634,0,1235,1395,0
106127146667,106127146677,10,1404,1483,0
106127594279,106127594281,2,1303,957,0
106129975070,106129975070,0,1405,1108,0
106130781633,106130781632,-1,2291,2816,0
106130986189,106130986189,0,1373,2557,0
106131024375,106131024373,-2,1200,2020,0
106131189243,106131189245,2,1632,1987,0
106131959893,106131959893,0,1514,1351,0
106136119960,106136119959,-1,1671,1946,0
106139296278,106139296278,0,937,2029,0
106148075804,106148075810,6,3620,1772,0
106150397678,106150397677,-1,1847,2289,0
106150934063,106150934062,-1,1558,2298,0
106151730512,106151730511,-1,1570,1806,0
106154476958,106154476960,2,1164,1324,0
106155634846,106155634846,0,1799,1946,0
106156872077,106156872080,3,1399,1588,0
106157789436,106157789438,2,1573,1410,0
106159043182,106159043181,-1,1599,2179,0
106160189568,106160189567,-1,891,2082,0
106164737537,106164737537,0,1545,1883,0
106167225851,106167225851,0,1414,1394,0
106167393390,106167393410,20,924,1278,0
106167998250,106167998250,0,977,1216,0
106174435971,106174435971,0,687,1221,0
106179031415,106179031412,-3,1543,1746,0
106182496281,106182496282,1,1143,1398,0
106182756325,106182756325,0,1693,1974,0
106188441962,106188441959,-3,1222,2298,0
106188967166,106188967165,-1,1513,2222,0
106189539182,106189539181,-1,1258,1810,0
106190707302,106190707302,0,847,1677,0
106192428126,106192428126,0,1024,1631,0
106193195767,106193195769,2,1639,2152,0
106196201767,106196201748,-19,1223,1176,0
106197955985,106197955986,1,1228,1316,0
106200707063,106200707062,-1,1132,1397,0
106200748702,106200748705,3,2196,1524,0
106200907337,106200907338,1,2339,1701,0
106202690768,106202690769,1,1869,2055,0
106202927887,106202927889,2,1125,893,0
106202964911,106202964918,7,1222,1934,0
106203520091,106203520090,-1,1235,1331,0
106203655145,106203655147,2,3287,3054,0
106204101264,106204101266,2,1003,1536,0
106207131994,106207131993,-1,1349,1698,0
106210713246,106210713245,-1,1676,2281,0
106212591874,106212591875,1,1550,1640,0
106212633766,106212633765,-1,1378,1813,0
106212821056,106212821061,5,22045,20520,0
106214598334,106214598333,-1,1767,1813,0
106214819588,106214819577,-11,1583,1909,0
106215843606,106215843604,-2,1445,1526,0
106217427282,106217427282,0,1314,1732,0
106217989436,106217989437,1,1495,1379,0
106220649982,106220649985,3,1031,1336,0
106223706987,106223706988,1,1715,1915,0
106227509702,106227509703,1,1189,1539,0
106231928630,106231928632,2,1312,1681,0
106232345363,106232345367,4,1689,1377,0
106234481218,106234481214,-4,1750,2261,0
106235304383,106235304382,-1,1406,1768,0
106235435074,106235435071,-3,1652,5241,0
106246529150,106246529150,0,985,1871,0
106246992957,106246992956,-1,819,827,0
106247678451,106247678451,0,1795,2366,0
106250628975,106250628977,2,1731,1756,0
106254875926,106254875925,-1,1141,1369,0
106257164811,106257164810,-1,1521,1673,0
106257372278,106257372279,1,940,1430,0
106258761558,106258761559,1,1071,1566,0
106261998129,106261998133,4,2186,1856,0
106263075455,106263075455,0,742,1043,0
106265978823,106265978822,-1,1106,1733,0
106266763942,106266763941,-1,766,1621,0
106268634977,106268634978,1,1631,1663,0
106269134687,106269134687,0,974,1418,0
106271762955,106271762956,1,1898,1888,0
106276283765,106276283767,2,1487,2004,0
106279210365,106279210365,0,1815,1638,0
106281037476,106281037475,-1,1179,1335,0
106284420706,106284420706,0,1205,1542,0
106284574819,106284574816,-3,1316,2967,0
106286879834,106286879832,-2,1174,1544,0
106288709346,106288709344,-2,1366,2024,0
106289941187,106289941183,-4,1086,1822,0
106294362397,106294362398,1,1181,1463,0
106294408514,106294408516,2,1647,1576,0
106295089897,106295089891,-6,1702,6959,0
106295878415,106295878414,-1,1603,1666,0
106295985701,106295985702,1,1085,1927,0
106297150719,106297150719,0,1789,1909,0
106298035802,106298035802,0,1512,1634,0
106299369455,106299369456,1,22654,43746,0
106299622464,106299622465,1,1256,1568,0
106299826410,106299826406,-4,2481,6589,0
106300611576,106300611576,0,1990,2467,0
106304833338,106304833340,2,1299,1143,0
106306335498,106306335500,2,1444,1724,0
106307188710,106307188710,0,1881,1848,0
106307781835,106307781838,3,1594,1346,0
106307991781,106307991781,0,1543,1731,0
106310183830,106310183830,0,1245,1409,0
106313248090,106313248089,-1,829,1861,0
106316461253,106316461253,0,1066,1594,0
106316784523,106316784527,4,1376,1343,0
106320908864,106320908865,1,1405,1358,0
106320968989,106320968987,-2,1575,2728,0
106327113813,106327113811,-2,879,1448,0
106331873965,106331873966,1,1602,2125,0
106335033334,106335033337,3,1615,1352,0
106335642497,106335642496,-1,809,1064,0
106337331672,106337331672,0,1078,1507,0
106337448122,106337448123,1,1311,1792,0
106339584222,106339584220,-2,1552,2001,0
106344313670,106344313670,0,1850,2727,0
106345032018,106345032019,1,1037,1369,0
106346864098,106346864104,6,1140,1340,0
106348098026,106348098024,-2,918,1570,0
106348485647,106348485649,2,1730,1960,0
106350524562,106350524561,-1,2177,2558,0
106352126245,106352126245,0,1283,1372,0
106353704153,106353704152,-1,23863,21712,0
106355593365,106355593367,2,1397,1071,0
106355907309,106355907310,1,1574,1970,0
106357247938,106357247938,0,1490,1996,0
106361600234,106361600234,0,1352,1585,0
106362642474,106362642477,3,1020,1189,0
106365639505,106365639506,1,1020,1976,0
106368287473,106368287474,1,1452,2095,0
106373823738,106373823747,9,2604,1431,0
106378864636,106378864635,-1,1713,1987,0
106379093145,106379093142,-3,1235,2104,0
106380328794,106380328792,-2,1750,2338,0
106381740128,106381740129,1,1207,1459,0
106384981897,106384981899,2,1505,2170,0
106385379358,106385379357,-1,1388,1391,0
106388443149,106388443150,1,1175,1741,0
106390817301,106390817304,3,1116,1632,0
106392575556,106392575556,0,1575,1653,0
106392659083,106392659083,0,1299,1306,0
106392806777,106392806778,1,1661,1819,0
106393321970,106393321970,0,1030,1219,0
106393874470,106393874471,1,1723,2328,0
106394485378,106394485374,-4,1532,2142,0
106394670569,106394670569,0,1733,2334,0
106397132714,106397132714,0,1162,1299,0
106400076010,106400076012,2,1293,1242,0
106400339711,106400339711,0,1237,1998,0
106403473222,106403473223,1,1423,1540,0
106405563184,106405563184,0,1400,2165,0
106409474562,106409474562,0,1336,1369,0
106414228282,106414228282,0,1016,1836,0
106415378401,106415378399,-2,1087,2311,0
106416197118,106416197115,-3,1062,2503,0
106417676001,106417676002,1,1925,2257,0
106418679228,106418679228,0,1356,1876,0
106421654774,106421654774,0,1788,1399,0
106426672678,106426672678,0,1644,1273,0
106428084670,106428084670,0,897,1457,0
106432423470,106432423469,-1,983,1601,0
106435622239,106435622239,0,1156,1872,0
106435842802,106435842801,-1,2140,2181,0
106439095149,106439095150,1,1933,1992,0
106440866419,106440866418,-1,1628,2473,0
106442161205,106442161206,1,1352,1206,0
106444179829,106444179826,-3,1337,2015,0
106444624590,106444624590,0,1320,1640,0
106446276885,106446276885,0,1158,1583,0
106447985511,106447985511,0,1263,1171,0
106453222826,106453222839,13,15874,25222,0
106455539934,106455539934,0,1284,2145,0
106458969074,106458969074,0,1186,1841,0
106464394799,106464394802,3,1021,1433,0
106466315531,106466315530,-1,1265,2029,0
106468142243,106468142246,3,1368,1607,0
106472246263,106472246262,-1,1267,1424,0
106475605423,106475605443,20,1010,1564,0
106476706370,106476706372,2,1916,1797,0
106476965471,106476965472,1,1411,1433,0
106477960334,106477960333,-1,1357,1575,0
106478257774,106478257774,0,1339,1762,0
106479086267,106479086266,-1,1159,1855,0
106483087078,106483087081,3,995,1475,0
106483276014,106483276031,17,1064,1224,0
106485797317,106485797317,0,1701,2171,0
106485908316,106485908308,-8,1166,1586,0
106486969438,106486969434,-4,1894,4334,0
106487020666,106487020666,0,1316,1848,0
106487103809,106487103811,2,1448,1463,0
106488739945,106488739945,0,1211,1389,0
106491224891,106491224892,1,972,1419,0
106493769133,106493769134,1,1394,1935,0
106495597695,106495597694,-1,1416,1756,0
106495798233,106495798233,0,1438,1886,0
106497525450,106497525449,-1,1187,1616,0
106499914499,106499914509,10,1329,1660,0
106501259098,106501259100,2,1133,1359,0
106502291803,106502291803,0,1439,2222,0
106509329739,106509329751,12,13034,39245,0
106510844096,106510844095,-1,1332,1605,0
106513709533,106513709515,-18,4384,1862,0
106514039039,106514039037,-2,1716,1543,0
106514149239,106514149236,-3,1169,1752,0
106517053609,106517053607,-2,1186,1134,0
106519470481,106519470477,-4,1119,2498,0
106523885159,106523885159,0,1745,2835,0
106524951735,106524951735,0,1528,1821,0
106527172064,106527172065,1,2525,2773,0
106528643404,106528643386,-18,1393,1454,0
106529168521,106529168522,1,2149,2747,0
106530370989,106530370989,0,1142,2096,0
106531843117,106531843118,1,1284,1871,0
106533967142,106533967149,7,3415,1580,0
106534422566,106534422566,0,1089,1802,0
106536200754,106536200755,1,1509,1452,0
106536342189,106536342189,0,1569,1746,0
106536565783,106536565783,0,1238,1839,0
106537116437,106537116438,1,1210,1829,0
106541273377,106541273375,-2,1406,1647,0
106547149485,106547149485,0,1388,1657,0
106556016365,106556016363,-2,1011,1365,0
106556352566,106556352567,1,790,1434,0
106556571979,106556571980,1,1245,1679,0
106557819823,106557819823,0,1290,2180,0
106562820643,106562820643,0,758,1246,0
106565803588,106565803590,2,1564,2637,0
106566752301,106566752302,1,1815,1420,0
106568283319,106568283319,0,902,1406,0
106570812714,106570812710,-4,1261,1903,0
106573407030,106573407030,0,1497,1718,0
106576168717,106576168716,-1,1404,1769,0
106580287374,106580287372,-2,1205,1477,0
106585693546,106585693546,0,1524,1679,0
106585841062,106585841060,-2,1207,2252,0
106589934015,106589934014,-1,917,1545,0
106592477228,106592477231,3,1414,1198,0
106598144618,106598144619,1,943,1960,0
106601332215,106601332217,2,1424,1578,0
106602396264,106602396261,-3,1372,2416,0
106602822935,106602822935,0,1590,2134,0
106610263581,106610263581,0,1457,1591,0
106610960917,106610960918,1,1681,1723,0
106613791569,106613791569,0,1386,1446,0
106614961350,106614961349,-1,1548,2059,0
106619539701,106619539704,3,1634,1815,0
106622348107,106622348105,-2,891,2227,0
106627336884,106627336886,2,1276,1565,0
106628292367,106628292369,2,1028,1422,0
106631340830,106631340829,-1,1323,1488,0
106639285788,106639285783,-5,1218,2356,0
106642770426,106642770426,0,1610,1227,0
106653710644,106653710643,-1,1272,1439,0
106653971049,106653971050,1,2095,2222,0
106654324361,106654324360,-1,1257,1489,0
106654630863,106654630863,0,1034,1386,0
106656957402,106656957400,-2,1303,2212,0
106657052894,106657052894,0,1147,1299,0
106661001162,106661001160,-2,1757,1792,0
106663202342,106663202345,3,1215,1479,0
106669078102,106669078102,0,1270,1634,0
106669989534,106669989512,-22,395,411,0
106674558390,106674558391,1,738,592,0
106677094426,106677094427,1,1599,1299,0
106681507268,106681507269,1,1258,1503,0
106682942559,106682942559,0,1106,2390,0
106683147348,106683147337,-11,1234,1178,0
106684505594,106684505594,0,1450,1552,0
106684916587,106684916586,-1,1382,1300,0
106693422551,106693422552,1,1537,1860,0
106693621656,106693621676,20,1434,1492,0
106699437202,106699437203,1,1677,1435,0
106700490107,106700490108,1,1303,2051,0
106703461165,106703461165,0,1030,1305,0
106703992746,106703992745,-1,1199,1695,0
106706105010,106706105008,-2,1320,1914,0
106708905060,106708905058,-2,725,1854,0
106712759126,106712759126,0,1405,1626,0
106715990122,106715990122,0,1693,1746,0
106717656404,106717656403,-1,1543,1614,0
106719488802,106719488803,1,1308,1910,0
106724976029,106724976029,0,1626,1998,0
106725195559,106725195540,-19,974,938,0
106725780591,106725780590,-1,1362,2088,0
106726228343,106726228344,1,663,1440,0
106729227175,106729227178,3,846,1304,0
106729407155,106729407156,1,1368,1481,0
106731445741,106731445743,2,1510,1271,0
106733999466,106733999465,-1,1422,2407,0
106735439262,106735439263,1,2090,2450,0
106740244322,106740244323,1,1870,1640,0
106743740856,106743740855,-1,1471,2355,0
106745808104,106745808105,1,1803,1902,0
106754080025,106754080030,5,2470,1456,0
106754215813,106754215812,-1,1547,1939,0
106755742439,106755742438,-1,1113,1492,0
106756647694,106756647696,2,1580,1679,0
106760080069,106760080069,0,1353,1848,0
106765601551,106765601546,-5,1693,3579,0
106767165478,106767165478,0,1352,1693,0
106770996241,106770996235,-6,1087,4369,0
106773627404,106773627402,-2,1278,1769,0
106774925024,106774925024,0,1537,1475,0
106778789835,106778789830,-5,1191,1586,0
106779546406,106779546407,1,1089,1754,0
106779648601,106779648601,0,1505,1773,0
106781228006,106781228007,1,1621,1873,0
106784968203,106784968198,-5,751,2258,0
106785483522,106785483522,0,687,1478,0
106789773898,106789773897,-1,1375,1381,0
106791069462,106791069462,0,927,1630,0
106795819848,106795819849,1,1479,2119,0
106796843698,106796843699,1,1030,1499,0
106797026021,106797026022,1,1241,1248,0
106798632937,106798632938,1,1321,1260,0
106802863168,106802863172,4,712,1135,0
106805375938,106805375938,0,2010,2016,0
106805644671,106805644671,0,1096,1097,0
106806731519,106806731518,-1,1623,2565,0
106812275353,106812275354,1,1316,2053,0
106815701231,106815701232,1,1544,1776,0
106818098738,106818098738,0,1387,1715,0
106822022667,106822022667,0,1703,1447,0
106822471770,106822471770,0,1156,1555,0
106823489794,106823489794,0,1139,1543,0
106828326874,106828326873,-1,1258,1469,0
106831497159,106831497158,-1,1245,1504,0
106833211795,106833211797,2,1071,1743,0
106835855825,106835855825,0,1421,1239,0
106836736239,106836736228,-11,1113,1572,0
106837392014,106837392034,20,1024,1400,0
106838486342,106838486346,4,1009,1163,0
106842731222,106842731220,-2,1131,2260,0
106843151054,106843151054,0,1166,1461,0
106844937332,106844937332,0,1740,1606,0
106847901099,106847901100,1,1161,1487,0
106849924157,106849924157,0,1524,1991,0
106850287751,106850287751,0,1094,1256,0
106850869382,106850869382,0,1414,1614,0
106852046123,106852046123,0,1437,2371,0
106853448942,106853448941,-1,1642,2537,0
106855921094,106855921095,1,1193,1367,0
106856254704,106856254705,1,1429,1164,0
106856737679,106856737682,3,1393,1653,0
106857883362,106857883363,1,1508,1914,0
106859798735,106859798737,2,1122,1535,0
106860066943,106860066945,2,1073,1440,0
106861382981,106861382986,5,2031,1138,0
106869318573,106869318576,3,1156,1416,0
106870571675,106870571675,0,1231,2016,0
106871040317,106871040315,-2,1280,2111,0
106873044306,106873044306,0,1285,1589,0
106874024038,106874024040,2,792,975,0
106875011738,106875011737,-1,1492,2711,0
106876678173,106876678174,1,1165,1217,0
106880573862,106880573862,0,1796,3379,0
106884600893,106884600895,2,1422,1536,0
106885010507,106885010509,2,2069,2146,0
106887528866,106887528866,0,1191,1385,0
106892184600,106892184601,1,2085,2333,0
106898298484,106898298484,0,1253,1618,0
106900862742,106900862742,0,963,792,0
106901860458,106901860457,-1,2244,3985,0
106905198650,106905198670,20,1703,2050,0
106905823902,106905823898,-4,1415,2400,0
106908087938,106908087937,-1,1779,2045,0
106909443211,106909443215,4,1859,1869,0
106916987422,106916987421,-1,1071,2176,0
106920987243,106920987221,-22,2436,1875,0
106923191946,106923191946,0,1499,1173,0
106926751751,106926751750,-1,982,1464,0
106931934235,106931934234,-1,1249,1806,0
106933913470,106933913470,0,906,1684,0
106935138444,106935138446,2,1595,1645,0
106937857277,106937857278,1,1532,1615,0
106939005095,106939005094,-1,1556,1743,0
106939710614,106939710614,0,1274,2055,0
106942218199,106942218200,1,1734,1916,0
106942496962,106942496963,1,1276,1619,0
106942864178,106942864179,1,1012,1379,0
106945464896,106945464897,1,1534,2095,0
106946781616,106946781615,-1,1666,1962,0
106947019140,106947019141,1,1098,1179,0
106954716462,106954716461,-1,1907,1985,0
106958551618,106958551618,0,1609,2180,0
106958763416,106958763418,2,1691,1590,0
106960037816,106960037818,2,878,1168,0
106962724053,106962724053,0,996,1709,0
106963813464,106963813462,-2,1149,1492,0
106964249804,106964249791,-13,917,1843,0
106967158134,106967158137,3,1559,1653,0
106967319402,106967319403,1,1297,1701,0
106970512701,106970512702,1,1647,2081,0
106974563234,106974563237,3,1388,1440,0
106974900988,106974900985,-3,940,1627,0
106979756919,106979756918,-1,969,1980,0
106980305659,106980305659,0,1127,1985,0
106983378390,106983378410,20,1546,1712,0
106984258475,106984258479,4,1369,1393,0
106986065535,106986065537,2,1378,1483,0
106988912392,106988912388,-4,1960,6492,0
106993384416,106993384416,0,1372,1731,0
106997138667,106997138666,-1,1379,1429,0
106998636581,106998636579,-2,1670,1814,0
107000254776,107000254778,2,1220,1483,0
107004460593,107004460594,1,1203,1197,0
107007249558,107007249560,2,1267,1583,0
107007975754,107007975756,2,1259,1290,0
107008849114,107008849115,1,938,1419,0
107010557853,107010557853,0,1710,1838,0
107010709146,107010709149,3,1821,1688,0
107013853394,107013853394,0,1333,1369,0
107014052871,107014052870,-1,773,1404,0
107015190718,107015190718,0,1243,1194,0
107017176679,107017176678,-1,1488,3152,0
107017745777,107017745778,1,1872,1940,0
107020127309,107020127309,0,1155,1516,0
107027068264,107027068264,0,1680,1824,0
107034450518,107034450519,1,1878,1708,0
107035390768,107035390770,2,1922,1424,0
107036543797,107036543797,0,1390,1894,0
107038646091,107038646090,-1,1945,2261,0
107039986425,107039986447,22,1261,2024,0
107042847442,107042847441,-1,1825,2003,0
107045046517,107045046514,-3,1828,3812,0
107047430466,107047430466,0,1620,2370,0
107047995195,107047995196,1,1247,1284,0
107051311568,107051311568,0,1490,1915,0
107057339466,107057339466,0,1443,1656,0
107058189329,107058189329,0,1022,1353,0
107059195956,107059195942,-14,1364,2058,0
107059558966,107059558973,7,10487,36260,0
107061087900,107061087901,1,1479,1762,0
107061166839,107061166858,19,1442,2186,0
107063464530,107063464529,-1,1179,1702,0
107066486739,107066486740,1,1076,1913,0
107067913294,107067913294,0,1892,2931,0
107068097787,107068097788,1,1784,1823,0
107075592474,107075592475,1,1419,1379,0
107075735814,107075735812,-2,1393,1885,0
107077185377,107077185379,2,1733,1588,0
107077913182,107077913182,0,1832,1324,0
107081452507,107081452507,0,599,1287,0
107081815849,107081815850,1,1671,1968,0
107082949225,107082949226,1,773,716,0
107083085769,107083085771,2,1529,1654,0
107086861947,107086861949,2,1062,1387,0
107098145358,107098145359,1,1287,1541,0
107100535783,107100535790,7,2905,1111,0
107101360891,107101360891,0,2111,2118,0
107103787757,107103787758,1,1602,1896,0
107105385537,107105385523,-14,1294,1367,0
107109296077,107109296077,0,1393,2095,0
107110443943,107110443954,11,1162,1310,0
107112485662,107112485663,1,1861,1896,0
107113080181,107113080183,2,606,403,0
107114332662,107114332665,3,776,1152,0
107115363245,107115363246,1,957,1808,0
107116063737,107116063734,-3,1453,1718,0
107118002114,107118002112,-2,1574,2268,0
107122806353,107122806350,-3,1194,1925,0
107124677905,107124677906,1,1068,1235,0
107125309923,107125309922,-1,1951,2209,0
107126193101,107126193102,1,1198,1278,0
107126743330,107126743330,0,2078,2216,0
107126973016,107126973016,0,1220,1780,0
107131917090,107131917092,2,6437,5846,0
107132161814,107132161815,1,1357,1178,0
107136155038,107136155039,1,1234,1479,0
107136845557,107136845555,-2,956,1910,0
107137093503,107137093510,7,163,2081,0
107142272180,107142272181,1,1644,1751,0
107146117565,107146117565,0,1817,1794,0
107148979746,107148979747,1,1835,1827,0
107152733590,107152733590,0,1481,1612,0
107154221047,107154221046,-1,1479,2238,0
107157084970,107157084969,-1,991,2327,0
107157633976,107157633978,2,1420,1640,0
107158149226,107158149225,-1,794,1629,0
107158846168,107158846169,1,1116,1670,0
107159813614,107159813614,0,1556,1698,0
107164657979,107164657978,-1,1408,1988,0
107165229868,107165229854,-14,1746,1442,0
107166986041,107166986043,2,1976,1706,0
107168576223,107168576223,0,1073,1631,0
107172170578,107172170579,1,1183,1514,0
107175733898,107175733899,1,1455,1322,0
107179391602,107179391602,0,1323,1505,0
107182450728,107182450732,4,1777,1344,0
107184162522,107184162521,-1,1357,2055,0
107184539210,107184539211,1,1595,1500,0
107186669992,107186669994,2,1405,1806,0
107190378280,107190378280,0,1681,2767,0
107192566023,107192566032,9,1262,1322,0
107197058839,107197058840,1,1441,1892,0
107197316358,107197316354,-4,858,2731,0
107198779366,107198779367,1,1184,1316,0
107199447438,107199447437,-1,1323,2054,0
107200036902,107200036902,0,1427,1973,0
107202028893,107202028894,1,1216,1414,0
107202489608,107202489608,0,1606,1774,0
107202834554,107202834547,-7,1008,4375,0
107203124002,107203124003,1,1300,1336,0
107205034474,107205034476,2,1868,1484,0
107208070299,107208070300,1,1313,2298,0
107209001593,107209001593,0,1441,2114,0
107211736710,107211736709,-1,1631,1757,0
107212980477,107212980470,-7,2441,6274,0
107213754585,107213754586,1,1326,1261,0
107215282561,107215282564,3,1311,2229,0
107218239138,107218239139,1,1459,1905,0
107220030701,107220030701,0,1570,1947,0
107221446054,107221446058,4,1523,1202,0
107224042467,107224042470,3,1537,1544,0
107224442426,107224442427,1,1413,1829,0
107225138890,107225138891,1,1714,1234,0
107226979946,107226979949,3,1191,1578,0
107233904784,107233904783,-1,1296,1778,0
107240972030,107240972031,1,1311,1064,0
107243223934,107243223935,1,1103,900,0
107244163380,107244163381,1,1103,1548,0
107244316210,107244316206,-4,1083,1770,0
107245345038,107245345038,0,1222,1281,0
107246897630,107246897630,0,1498,1363,0
107247678913,107247678915,2,1779,1299,0
107250873182,107250873182,0,994,2276,0
107251424747,107251424745,-2,1147,2629,0
107254034930,107254034932,2,1978,1634,0
107254357502,107254357503,1,1206,1958,0
107255750125,107255750125,0,1287,1462,0
107256448515,107256448515,0,1095,1477,0
107261885178,107261885178,0,1367,1285,0
107262997966,107262997967,1,1356,1427,0
107264697881,107264697883,2,1027,1387,0
107264736941,107264736942,1,1863,2422,0
107265805980,107265805986,6,2231,1218,0
107269470780,107269470781,1,1241,1732,0
107270347700,107270347723,23,964,1239,0
107272376868,107272376869,1,1489,2172,0
107273246298,107273246298,0,1538,1973,0
107273966653,107273966653,0,1325,1170,0
107276242172,107276242177,5,4421,2656,0
107286739246,107286739246,0,1667,2330,0
107287027350,107287027350,0,1211,853,0
107287539305,107287539301,-4,48761,20967,0
107288753222,107288753222,0,1849,1574,0
107299750254,107299750255,1,1012,1149,0
107301433003,107301433015,12,1513,1528,0
107302382487,107302382488,1,1514,1805,0
107304799923,107304799923,0,1496,2051,0
107306058105,107306058104,-1,1105,2096,0
107306109102,107306109081,-21,1034,1807,0
107307057034,107307057034,0,1498,1436,0
107308332698,107308332698,0,1380,1257,0
107311538496,107311538494,-2,1845,1587,0
107312757847,107312757847,0,1358,1952,0
107312837785,107312837785,0,1120,1407,0
107313659786,107313659787,1,1097,1989,0
107315450926,107315450926,0,1514,1897,0
107316645926,107316645923,-3,1167,2045,0
107317009646,107317009646,0,1186,1216,0
107317444005,107317444005,0,1924,1859,0
107317715917,107317715917,0,1038,1738,0
107317839313,107317839314,1,2092,2284,0
107317924912,107317924912,0,1664,2020,0
107320854572,107320854574,2,1952,2218,0
107326683198,107326683200,2,1603,1316,0
107328398505,107328398505,0,1045,1392,0
107328762121,107328762122,1,1275,1289,0
107330439586,107330439586,0,1336,1376,0
107331440606,107331440609,3,1155,1353,0
107331783286,107331783285,-1,1163,1547,0
107332492080,107332492079,-1,1498,1627,0
107333590350,107333590351,1,1380,1807,0
107343475003,107343475002,-1,1163,1460,0
107347746203,107347746206,3,1088,1688,0
107355831899,107355831899,0,586,1248,0
107359361205,107359361207,2,1393,1426,0
107360753902,107360753906,4,1784,1418,0
107361152570,107361152568,-2,1467,1884,0
107361457901,107361457902,1,1346,1142,0
107361932347,107361932350,3,1504,1296,0
107364610120,107364610121,1,705,791,0
107370233179,107370233181,2,1598,1405,0
107371892963,107371892965,2,933,1442,0
107372658897,107372658898,1,1175,1799,0
107373775294,107373775295,1,1452,1762,0
107379095066,107379095067,1,909,1999,0
107379725483,107379725482,-1,890,1137,0
107379992061,107379992060,-1,1914,2085,0
107381139546,107381139546,0,969,1015,0
107385274556,107385274553,-3,825,1296,0
107386082856,107386082874,18,891,1243,0
107387304066,107387304066,0,1289,1674,0
107388364243,107388364243,0,1412,1315,0
107389510791,107389510789,-2,1758,2011,0
107392223211,107392223213,2,1214,2028,0
107392623210,107392623213,3,1312,1510,0
107393010041,107393010024,-17,1167,1213,0
107394026374,107394026375,1,1769,2392,0
107394273602,107394273603,1,1608,1427,0
107395089805,107395089807,2,1505,1738,0
107399346387,107399346388,1,1514,1782,0
107404255987,107404255989,2,848,1397,0
107405471999,107405471998,-1,1480,1837,0
107406422826,107406422826,0,1447,1904,0
107408059134,107408059134,0,1499,2434,0
107408142167,107408142167,0,1315,1472,0
107409032142,107409032144,2,1620,1771,0
107411042630,107411042612,-18,943,860,0
107411285073,107411285080,7,2714,1768,0
107412413898,107412413898,0,925,1602,0
107413798287,107413798288,1,1470,1433,0
107415454655,107415454655,0,978,1267,0
107416193699,107416193699,0,1383,2074,0
107417753469,107417753448,-21,912,1422,0
107418286054,107418286038,-16,1133,1738,0
107420071102,107420071105,3,1173,1502,0
107424535291,107424535289,-2,1307,2766,0
107426050352,107426050358,6,374,1651,0
107426859508,107426859507,-1,1100,1669,0
107428947970,107428947965,-5,18231,11734,0
107429148252,107429148251,-1,1963,2325,0
107430676670,107430676670,0,1782,1305,0
107436736858,107436736858,0,1030,1488,0
107438364332,107438364336,4,1491,1902,0
107443839754,107443839753,-1,1257,1490,0
107444142527,107444142531,4,1844,1281,0
107444902144,107444902147,3,1743,1746,0
107445457203,107445457199,-4,1157,1900,0
107446278167,107446278166,-1,1410,1865,0
107446986967,107446986967,0,1100,1535,0
107447109999,107447109999,0,1251,1772,0
107453606337,107453606339,2,1429,1595,0
107456968743,107456968742,-1,1431,2352,0
107458916021,107458916022,1,1590,1931,0
107460054223,107460054222,-1,896,1876,0
107462196221,107462196227,6,1221,1068,0
107465369495,107465369496,1,1780,2058,0
107467488646,107467488647,1,1373,1586,0
107469120683,107469120685,2,1096,1644,0
107472701825,107472701826,1,1891,1495,0
107476177330,107476177333,3,1958,2231,0
107479246961,107479246971,10,1503,1366,0
107480674457,107480674455,-2,1709,1728,0
107481956314,107481956313,-1,938,803,0
107483266299,107483266301,2,1406,1452,0
107484967295,107484967295,0,1641,1854,0
107486668191,107486668190,-1,1235,2227,0
107487516458,107487516471,13,1617,1607,0
107488248746,107488248745,-1,1561,2101,0
107488550585,107488550586,1,1589,1788,0
107489901388,107489901385,-3,1761,4055,0
107492995470,107492995471,1,925,1360,0
107495372047,107495372046,-1,1168,1639,0
107496436142,107496436141,-1,1461,2130,0
107497510445,107497510442,-3,991,1882,0
107502751743,107502751745,2,853,1084,0
107507543314,107507543314,0,1761,2006,0
107508076215,107508076216,1,1345,1330,0
107509165650,107509165662,12,1553,1152,0
107510601676,107510601677,1,1639,1832,0
107510700644,107510700646,2,1038,1483,0
107512883766,107512883766,0,1316,1206,0
107513056396,107513056386,-10,1224,2213,0
107517075297,107517075297,0,813,1752,0
107517375520,107517375521,1,1440,2676,0
107520052902,107520052902,0,2128,2224,0
107529356161,107529356162,1,920,1023,0
107530099525,107530099525,0,2034,2660,0
107531766049,107531766049,0,1754,2119,0
107534503467,107534503467,0,1080,1561,0
107536436666,107536436667,1,1582,1662,0
107537435610,107537435611,1,1473,1818,0
107546496183,107546496178,-5,1087,2444,0
107550210006,107550210006,0,1423,1229,0
107551095667,107551095666,-1,2152,2036,0
107554741746,107554741746,0,1744,2434,0
107557497678,107557497678,0,1152,1372,0
107557875145,107557875146,1,947,1116,0
107559422978,107559422977,-1,1568,1971,0
107561026286,107561026287,1,1650,1362,0
107561126075,107561126056,-19,1681,1014,0
107568453498,107568453498,0,1228,1573,0
107568840426,107568840426,0,1375,1349,0
107573891822,107573891822,0,1055,1592,0
107575128651,107575128651,0,850,1301,0
107575308918,107575308921,3,1773,1352,0
107575900341,107575900348,7,835,1765,0
107576552550,107576552555,5,5341,2983,0
107578405105,107578405105,0,1687,2031,0
107578546544,107578546545,1,1518,1943,0
107581463718,107581463720,2,1103,1660,0
107581811281,107581811286,5,2094,1375,0
107583353430,107583353431,1,1094,1243,0
107583466825,107583466826,1,1370,1563,0
107583557955,107583557956,1,1023,1971,0
107583849296,107583849313,17,1138,1651,0
107585415690,107585415690,0,1468,2017,0
107588829517,107588829516,-1,1615,1597,0
107588979725,107588979729,4,1416,1643,0
107592475206,107592475206,0,1143,1879,0
107593022730,107593022731,1,1426,2181,0
107593418604,107593418607,3,1267,1151,0
107594796192,107594796194,2,1088,1278,0
107597643254,107597643255,1,1677,1894,0
107600046309,107600046309,0,1718,1963,0
107600435929,107600435929,0,1161,2176,0
107601796338,107601796339,1,1105,1158,0
107602600881,107602600882,1,1647,1997,0
107603453560,107603453562,2,1784,1897,0
107612687802,107612687801,-1,1344,2418,0
107612927451,107612927452,1,1018,1612,0
107618487346,107618487346,0,985,1184,0
107619083097,107619083098,1,1499,1347,0
107619646559,107619646552,-7,729,2948,0
107623058402,107623058402,0,1281,1648,0
107623577742,107623577744,2,1525,1474,0
107623812541,107623812543,2,1352,1812,0
107625095971,107625095971,0,1170,1611,0
107625244629,107625244627,-2,1279,1149,0
107626534274,107626534274,0,1592,1619,0
107630279851,107630279861,10,13553,33374,0
107631279370,107631279369,-1,1322,1056,0
107634679184,107634679184,0,1184,1419,0
107635559963,107635559963,0,1493,1989,0
107636939403,107636939403,0,1241,1598,0
107637059499,107637059501,2,1630,2107,0
107637565258,107637565257,-1,1425,1915,0
107637895150,107637895153,3,1308,1375,0
107642865187,107642865190,3,1553,1072,0
107652284991,107652284991,0,1054,1651,0
107653195178,107653195159,-19,1699,1484,0
107653244426,107653244428,2,1465,1542,0
107654442034,107654442035,1,1316,1538,0
107654609962,107654609970,8,4134,1250,0
107654684106,107654684109,3,1119,1589,0
107658856327,107658856326,-1,1149,1492,0
107661408954,107661408953,-1,1418,1865,0
107664173460,107664173461,1,1711,1606,0
107665464114,107665464116,2,1815,2349,0
107668331602,107668331603,1,1557,2075,0
107669740922,107669740921,-1,1298,1435,0
107671728669,107671728669,0,1113,1811,0
107672085524,107672085518,-6,1201,5795,0
107683732845,107683732845,0,1256,1774,0
107683964495,107683964493,-2,1813,2005,0
107684773113,107684773114,1,896,1724,0
107685305770,107685305770,0,1641,1548,0
107687278790,107687278789,-1,1508,1660,0
107688911072,107688911073,1,1508,1562,0
107692139039,107692139016,-23,1327,2245,0
107694981857,107694981856,-1,1869,2654,0
107703009709,107703009709,0,1122,2075,0
107703400711,107703400711,0,1089,1208,0
107710551010,107710551010,0,1502,2014,0
107714857043,107714857046,3,1728,1919,0
107715211142,107715211142,0,1599,1736,0
107715486541,107715486542,1,1225,1440,0
107718102378,107718102378,0,1201,2124,0
107720836338,107720836340,2,1688,2000,0
107722883985,107722883986,1,1734,1622,0
107726953514,107726953515,1,939,938,0
107727200675,107727200677,2,1155,1423,0
107730643080,107730643082,2,1999,2287,0
107733823994,107733823993,-1,2065,2285,0
107735201245,107735201247,2,1658,2870,0
107735473462,107735473463,1,954,1135,0
107736311858,107736311858,0,1568,1496,0
107736977307,107736977307,0,1089,1196,0
107740854496,107740854496,0,1607,1927,0
107740971254,107740971253,-1,1774,2096,0
107741308354,107741308367,13,11629,51067,0
107744361615,107744361615,0,1517,1713,0
107747450602,107747450603,1,1707,1867,0
107751769304,107751769302,-2,1651,1340,0
107752656714,107752656714,0,1130,2193,0
107762397381,107762397382,1,1305,1142,0
107766740807,107766740808,1,1836,2508,0
107767347930,107767347933,3,1137,1313,0
107771148387,107771148386,-1,929,1510,0
107774276738,107774276738,0,1550,1626,0
107776156994,107776156994,0,1345,1662,0
107776788343,107776788347,4,954,1442,0
107781402012,107781402016,4,4387,3025,0
107783046557,107783046558,1,1541,2110,0
107789662279,107789662279,0,1214,1854,0
107791902059,107791902060,1,1063,1434,0
107792408541,107792408541,0,1117,1261,0
107797852606,107797852604,-2,1045,1796,0
107798659439,107798659439,0,1056,1770,0
107798869958,107798869959,1,1779,1959,0
107799420069,107799420069,0,1715,1670,0
107799832164,107799832166,2,1464,1545,0
107800556477,107800556479,2,311,204,0
107803253489,107803253486,-3,1225,1964,0
107804315406,107804315407,1,1161,1780,0
107804413854,107804413854,0,1733,3198,0
107806523164,107806523164,0,1342,2552,0
107808561425,107808561426,1,1953,1752,0
107809249913,107809249913,0,1422,1893,0
107810117999,107810117995,-4,5843,13738,0
107811098150,107811098150,0,1869,1807,0
107811215427,107811215429,2,2056,2045,0
107813892809,107813892810,1,1481,1707,0
107814899204,107814899227,23,1429,2158,0
107819501298,107819501298,0,1450,1739,0
107822174827,107822174826,-1,818,1400,0
107822628766,107822628768,2,1784,1724,0
107827217618,107827217618,0,1775,2028,0
107828530154,107828530157,3,4598,2325,0
107835657565,107835657566,1,1701,1471,0
107838506179,107838506183,4,1723,2422,0
107840396442,107840396443,1,1329,1153,0
107844688458,107844688458,0,1233,1200,0
107845424718,107845424719,1,841,1254,0
107847123851,107847123853,2,1096,1819,0
107847419013,107847419012,-1,1187,1830,0
107850508916,107850508918,2,1415,1587,0
107852227469,107852227471,2,1727,1222,0
107863059726,107863059728,2,1338,1264,0
107863413582,107863413585,3,863,1069,0
107864015669,107864015654,-15,738,1565,0
107864713018,107864713017,-1,1270,1784,0
107866913547,107866913547,0,1121,1461,0
107868008574,107868008573,-1,1518,2219,0
107871659176,107871659174,-2,1463,2529,0
107873500149,107873500151,2,2026,1509,0
107874483170,107874483173,3,1815,1743,0
107877138482,107877138482,0,1419,2284,0
107881402142,107881402143,1,1571,1676,0
107886843461,107886843463,2,1816,1827,0
107889012765,107889012769,4,2202,1948,0
107889152587,107889152591,4,1905,1709,0
107890704113,107890704115,2,1996,2014,0
107893261102,107893261106,4,1602,2505,0
107893787239,107893787238,-1,840,1176,0
107894773703,107894773701,-2,921,1294,0
107896464462,107896464462,0,979,1286,0
107899805571,107899805571,0,1106,1475,0
107902261674,107902261677,3,981,1718,0
107902675805,107902675807,2,1221,1400,0
107906025539,107906025540,1,1230,1685,0
107906599572,107906599572,0,1928,1321,0
107906631949,107906631962,13,155,788,0
107910973742,107910973742,0,1129,1732,0
107911838258,107911838259,1,1502,2463,0
107913146425,107913146426,1,1154,1676,0
107915580915,107915580916,1,1209,1513,0
107917813882,107917813887,5,2080,1431,0
107917932012,107917931993,-19,1770,2202,0
107919202873,107919202874,1,1671,1803,0
107921855887,107921855888,1,1598,1656,0
107923458977,107923458979,2,2205,2112,0
107923661506,107923661505,-1,1338,2007,0
107924215638,107924215657,19,372,1170,0
107925873114,107925873114,0,1261,1954,0
107926169055,107926169057,2,1538,1629,0
107926951263,107926951266,3,1180,1167,0
107927066036,107927066035,-1,1702,1814,0
107927211263,107927211261,-2,1177,1262,0
107928833891,107928833891,0,1218,1540,0
107929367890,107929367894,4,1779,1536,0
107933686758,107933686759,1,841,1608,0
107934338478,107934338483,5,1892,1521,0
107938054974,107938054973,-1,1144,1872,0
107939737397,107939737397,0,1621,1895,0
107940979902,107940979901,-1,1593,2059,0
107946481866,107946481865,-1,1116,1273,0
107947908218,107947908218,0,1668,1899,0
107948300604,107948300605,1,1287,1919,0
107954285127,107954285126,-1,1157,1445,0
107954311647,107954311654,7,4647,1478,0
107954526845,107954526847,2,1508,1180,0
107956281206,107956281207,1,2088,2305,0
107961452843,107961452846,3,1429,1434,0
107962111035,107962111038,3,1453,2088,0
107962354809,107962354809,0,888,1425,0
107964782356,107964782358,2,1459,1532,0
107970338151,107970338154,3,1654,1605,0
107970812355,107970812357,2,2165,1933,0
107970869293,107970869299,6,7573,2442,0
107971108509,107971108513,4,1107,1656,0
107974413522,107974413522,0,1889,2058,0
107979417566,107979417564,-2,1398,1509,0
107981191974,107981191976,2,1515,1410,0
107982049974,107982049976,2,1483,1529,0
107982657574,107982657574,0,1312,1717,0
107984217118,107984217120,2,1207,1442,0
107987413908,107987413910,2,1978,1510,0
107987943143,107987943145,2,1338,1193,0
107989181544,107989181544,0,1203,1461,0
107995910738,107995910738,0,1583,2196,0
107996434538,107996434541,3,1578,1522,0
107998452362,107998452365,3,1769,1736,0
108000128117,108000128117,0,1344,2129,0
108003453792,108003453793,1,1495,1876,0
108005313013,108005313014,1,1806,2421,0
108005838069,108005838070,1,1377,1736,0
108006943923,108006943927,4,22287,20947,0
108008195234,108008195239,5,1652,1372,0
108014402215,108014402215,0,1691,1737,0
108015901931,108015901934,3,1649,878,0
108017352286,108017352285,-1,1651,2002,0
108017587951,108017587951,0,1508,2079,0
108018561379,108018561380,1,1337,1834,0
108019727123,108019727100,-23,794,647,0
108021412208,108021412206,-2,3056,3807,0
108021727626,108021727621,-5,1867,8554,0
108024919135,108024919133,-2,1067,1533,0
108027050565,108027050566,1,1246,1760,0
108027335374,108027335373,-1,1447,1330,0
108027463978,108027463977,-1,691,1380,0
108031371548,108031371547,-1,1662,2294,0
108031609242,108031609246,4,1262,933,0
108032303075,108032303076,1,936,1314,0
108032861082,108032861082,0,1514,2004,0
108034819502,108034819502,0,1139,1638,0
108035175831,108035175828,-3,1047,1558,0
108037389739,108037389740,1,1270,1882,0
108038928090,108038928090,0,1548,2648,0
108042602646,108042602648,2,1253,1772,0
108043495814,108043495816,2,4637,5242,0
108043602177,108043602176,-1,1131,1568,0
108044117265,108044117265,0,1476,1660,0
108044515062,108044515065,3,1642,1830,0
108045346377,108045346377,0,1718,1628,0
108047839316,108047839317,1,958,1648,0
108048696006,108048696006,0,1533,1146,0
108049775127,108049775127,0,1517,2096,0
108054040375,108054040377,2,1298,1612,0
108054690474,108054690475,1,1743,1645,0
108055917444,108055917445,1,1484,1475,0
108056432461,108056432463,2,1886,1810,0
108061877837,108061877837,0,891,1984,0
108063283627,108063283617,-10,1030,982,0
108064581706,108064581706,0,1240,1439,0
108068332839,108068332839,0,838,1508,0
108068769753,108068769749,-4,1194,2350,0
108069981683,108069981682,-1,1152,1700,0
108070464694,108070464694,0,1443,2112,0
108071511965,108071511966,1,1487,2122,0
108073589762,108073589762,0,949,1200,0
108077086085,108077086086,1,1276,1802,0
108079866513,108079866509,-4,1522,2832,0
108083319376,108083319374,-2,1431,1446,0
108083440664,108083440668,4,1033,1581,0
108085109072,108085109069,-3,1284,1730,0
108086828958,108086828959,1,1455,1285,0
108087142410,108087142410,0,1309,2500,0
108088567903,108088567908,5,3390,1777,0
108089749340,108089749341,1,1394,1985,0
108090068513,108090068514,1,1703,2509,0
108090646342,108090646343,1,788,711,0
108091399765,108091399765,0,1453,1726,0
108092662042,108092662042,0,1497,2290,0
108092882414,108092882430,16,13802,55060,0
108093626304,108093626314,10,10434,42751,0
108098022360,108098022360,0,1142,2196,0
108098059343,108098059362,19,816,1116,0
108099089489,108099089491,2,1503,1706,0
108099214735,108099214735,0,1353,2017,0
108099747097,108099747097,0,1650,1482,0
108101858158,108101858157,-1,1277,1996,0
108102321978,108102321978,0,1293,1884,0
108106297902,108106297903,1,1773,1594,0
108107784715,108107784713,-2,1541,3536,0
108108943546,108108943545,-1,1199,1646,0
108111312819,108111312814,-5,686,2128,0
108112809209,108112809209,0,1268,1715,0
108113030365,108113030351,-14,1517,1912,0
108115260749,108115260750,1,1065,1179,0
108116177615,108116177616,1,1438,1404,0
108117790553,108117790558,5,2351,1389,0
108118447316,108118447319,3,41155,36680,0
108120012102,108120012103,1,1405,1764,0
108121674549,108121674549,0,998,1834,0
108122393241,108122393242,1,1238,1022,0
108123628409,108123628414,5,2523,1779,0
108124298860,108124298862,2,1979,1531,0
108125080769,108125080769,0,1154,1543,0
108125872841,108125872846,5,4292,1928,0
108128119650,108128119654,4,1800,1496,0
108131820214,108131820214,0,1584,1284,0
108133640085,108133640085,0,1825,2739,0
108137438454,108137438455,1,1827,1609,0
108137516731,108137516730,-1,1285,1859,0
108137825709,108137825711,2,1538,1309,0
108138138372,108138138372,0,1319,1222,0
108138420864,108138420871,7,5195,22153,0
108139082213,108139082212,-1,1198,1268,0
108143946520,108143946521,1,1398,1778,0
108146208630,108146208631,1,2953,4064,0
108147669607,108147669596,-11,1041,1472,0
108148285751,108148285752,1,1156,1715,0
108152777671,108152777669,-2,1182,2748,0
108154324753,108154324754,1,1515,1690,0
108155765303,108155765302,-1,1966,2229,0
108155809541,108155809541,0,1670,1746,0
108156653318,108156653318,0,975,1691,0
108157344844,108157344844,0,1861,2023,0
108160520026,108160520025,-1,1574,1112,0
108162564206,108162564211,5,1161,1100,0
108163678618,108163678596,-22,1252,1811,0
108167615306,108167615306,0,1347,1926,0
108169557950,108169557951,1,1637,2294,0
108170259014,108170259014,0,917,1915,0
108171958337,108171958341,4,1754,1793,0
108173844430,108173844430,0,1887,1444,0
108173905053,108173905055,2,1313,1443,0
108174484218,108174484217,-1,1959,1998,0
108175657875,108175657871,-4,708,1574,0
108175945654,108175945674,20,554,1410,0
108176248815,108176248793,-22,982,3279,0
108176461666,108176461667,1,1586,1410,0
108178665278,108178665280,2,1122,1725,0
108179361714,108179361721,7,5848,2124,0
108179900783,108179900782,-1,2181,2546,0
108184095105,108184095101,-4,1213,2668,0
108184427561,108184427561,0,1436,1207,0
108185696243,108185696242,-1,1453,1432,0
108186495650,108186495651,1,1139,935,0
108194290021,108194290022,1,1613,2005,0
108194830154,108194830153,-1,909,1214,0
108197708702,108197708701,-1,1054,1696,0
108198821134,108198821133,-1,1303,1478,0
108202727688,108202727686,-2,1084,2059,0
108204037788,108204037781,-7,1892,5113,0
108207431640,108207431641,1,1282,1493,0
108214168327,108214168327,0,1421,1435,0
108214589829,108214589830,1,1267,1029,0
108217231290,108217231290,0,1531,1493,0
108217516960,108217516962,2,1474,1806,0
108218052919,108218052919,0,936,1937,0
108220556408,108220556407,-1,1137,1441,0
108221144842,108221144843,1,1513,2152,0
108222611874,108222611873,-1,1507,1666,0
108223949546,108223949544,-2,1054,1376,0
108225260950,108225260950,0,1746,1796,0
108225481570,108225481570,0,1349,2240,0
108226486949,108226486949,0,1408,1382,0
108231170052,108231170052,0,981,1223,0
108236008186,108236008186,0,1312,1357,0
108239277677,108239277676,-1,1527,1908,0
108243214011,108243214011,0,1292,1895,0
108244644990,108244644989,-1,1252,1900,0
108248442703,108248442703,0,1949,1996,0
108252732114,108252732114,0,1273,1572,0
108252903159,108252903159,0,1502,1879,0
108254419835,108254419835,0,1047,1638,0
108254520386,108254520367,-19,967,1825,0
108254740965,108254740966,1,1859,1525,0
108256550922,108256550921,-1,1492,1676,0
108260092210,108260092210,0,797,1337,0
108263322210,108263322212,2,1278,1582,0
108267139650,108267139651,1,772,1349,0
108267231679,108267231679,0,849,826,0
108268512828,108268512829,1,1207,1518,0
108268878472,108268878471,-1,1697,1868,0
108273808924,108273808924,0,1113,1487,0
108274082584,108274082583,-1,1297,1797,0
108274380445,108274380426,-19,1492,2774,0
108275227951,108275227951,0,997,2009,0
108277353891,108277353893,2,1609,1620,0
108277884526,108277884528,2,1586,1101,0
108279545950,108279545950,0,1402,2065,0
108280051705,108280051705,0,1461,912,0
108281568126,108281568123,-3,1351,1730,0
108286203016,108286203016,0,1310,1953,0
108290741893,108290741897,4,3635,1611,0
108302310975,108302310980,5,1869,1550,0
108310068060,108310068061,1,701,864,0
108310756153,108310756153,0,1289,1103,0
108313976414,108313976414,0,1152,1354,0
108315050514,108315050515,1,1225,1569,0
108315764282,108315764281,-1,1576,1414,0
108316208990,108316208990,0,1902,1234,0
108318864685,108318864685,0,1079,2251,0
108319036254,108319036254,0,1713,1681,0
108320204847,108320204849,2,1364,2546,0
108320900762,108320900765,3,2453,1602,0
108323240607,108323240608,1,1363,1672,0
108325604421,108325604418,-3,1236,1252,0
108326102614,108326102614,0,1509,1520,0
108326267431,108326267430,-1,849,1346,0
108326592898,108326592898,0,1275,1427,0
108327059847,108327059846,-1,1226,1753,0
108331407506,108331407506,0,1157,1077,0
108331892643,108331892661,18,1351,1231,0
108333352086,108333352086,0,1460,1423,0
108333861299,108333861297,-2,1021,1623,0
108333922186,108333922188,2,1410,1539,0
108337930389,108337930390,1,1024,1485,0
108342833755,108342833755,0,1695,2601,0
108348734161,108348734162,1,1139,1645,0
108357334522,108357334520,-2,1228,2421,0
108364780005,108364780006,1,956,1252,0
108367304262,108367304262,0,1156,1720,0
108370685722,108370685725,3,1695,1727,0
108372309323,108372309321,-2,871,2055,0
108374045618,108374045619,1,759,1314,0
108375614478,108375614478,0,1177,2110,0
108377686922,108377686923,1,1187,1632,0
108382095314,108382095314,0,1122,1575,0
108383417652,108383417654,2,1387,1774,0
108387311601,108387311604,3,1754,1612,0
108387741133,108387741134,1,1888,1838,0
108389606212,108389606212,0,1375,1564,0
108391667014,108391667014,0,1413,2693,0
108394372020,108394372022,2,1712,1708,0
108394618934,108394618941,7,2633,1401,0
108395457125,108395457124,-1,1438,2438,0
108401181875,108401181876,1,1352,1502,0
108404852655,108404852657,2,1625,1778,0
108405287184,108405287186,2,1014,1492,0
108407062326,108407062327,1,1650,2508,0
108411633132,108411633136,4,1423,1653,0
108416898276,108416898276,0,1299,1923,0
108417292881,108417292886,5,3188,2470,0
108418018281,108418018282,1,1918,1614,0
108419083721,108419083720,-1,1473,1164,0
108422363501,108422363501,0,1376,1810,0
108422518903,108422518922,19,1056,1575,0
108422721036,108422721036,0,1411,1839,0
108424740671,108424740674,3,1420,2111,0
108426525997,108426525998,1,1716,1851,0
108427160359,108427160339,-20,1714,1722,0
108430242076,108430242075,-1,1722,1848,0
108433358366,108433358365,-1,1308,1753,0
108437226827,108437226829,2,1183,1678,0
108437833387,108437833386,-1,1461,1843,0
108439661658,108439661654,-4,1112,1997,0
108440680834,108440680834,0,908,1309,0
108441448919,108441448920,1,2207,1878,0
108442323238,108442323239,1,1486,1799,0
108442645149,108442645151,2,627,1359,0
108442954118,108442954118,0,1582,2524,0
108446372390,108446372391,1,1128,1453,0
108447827788,108447827789,1,1550,1289,0
108448275674,108448275674,0,1792,1974,0
108448316974,108448316975,1,1975,1673,0
108448828689,108448828688,-1,1453,1679,0
108451774386,108451774388,2,2119,2282,0
108453872390,108453872390,0,1903,2383,0
108457974002,108457974002,0,1822,1156,0
108459362267,108459362269,2,1553,1716,0
108462326222,108462326220,-2,1902,3939,0
108462947461,108462947461,0,1559,1609,0
108464407984,108464407983,-1,987,1273,0
108465948614,108465948617,3,1422,1433,0
108468394576,108468394576,0,1326,1889,0
108471257094,108471257094,0,890,1385,0
108476905551,108476905553,2,1220,1320,0
108478437926,108478437927,1,1974,2199,0
108480828237,108480828234,-3,967,2585,0
108484074324,108484074325,1,1209,1388,0
108491762001,108491762001,0,1083,1584,0
108493239038,108493239041,3,1765,1403,0
108499886801,108499886802,1,1595,1807,0
108506126663,108506126665,2,177,1584,0
108508193688,108508193686,-2,1134,2158,0
108510794150,108510794147,-3,1476,3088,0
108511214767,108511214767,0,1257,1302,0
108512082018,108512082018,0,1469,1948,0
108513334538,108513334539,1,1952,1667,0
108515653769,108515653774,5,2332,1413,0
108517973657,108517973659,2,1451,1907,0
108518469928,108518469926,-2,1859,1522,0
108522039805,108522039807,2,1239,1753,0
108522372087,108522372088,1,1583,2883,0
108522690578,108522690582,4,3277,2156,0
108523919182,108523919181,-1,1231,1495,0
108525553601,108525553602,1,1185,1230,0
108526701683,108526701683,0,1003,2112,0
108529056668,108529056668,0,1865,1998,0
108529311110,108529311110,0,1476,1752,0
108530196423,108530196425,2,1191,1573,0
108531831741,108531831742,1,1232,1891,0
108532005826,108532005827,1,1062,1360,0
108536253716,108536253714,-2,1339,1516,0
108537474485,108537474486,1,1311,935,0
108538593587,108538593588,1,821,1654,0
108544831981,108544831981,0,1486,1276,0
108545797945,108545797944,-1,892,1309,0
108547663794,108547663794,0,1715,1647,0
108548480580,108548480580,0,1532,1842,0
108551797548,108551797569,21,1661,7460,0
108556685230,108556685229,-1,1457,1566,0
108558719710,108558719709,-1,621,944,0
108558989698,108558989697,-1,1723,2079,0
108563133119,108563133122,3,1405,1195,0
108563215968,108563215969,1,1444,1685,0
108564805490,108564805510,20,888,419,0
108567128829,108567128830,1,1249,1286,0
108569958970,108569958969,-1,1154,1665,0
108574786119,108574786121,2,1314,1315,0
108576810554,108576810549,-5,2195,7567,0
108576837318,108576837313,-5,795,2624,0
108579804429,108579804427,-2,1959,2186,0
108579908479,108579908479,0,1278,1755,0
108583593573,108583593574,1,1242,2790,0
108583897535,108583897537,2,1177,1467,0
108585998147,108585998148,1,1758,1971,0
108587167583,108587167584,1,1957,1929,0
108587343397,108587343398,1,2052,1815,0
108592844610,108592844611,1,2162,1599,0
108593489157,108593489158,1,1290,1332,0
108593814913,108593814910,-3,1695,2732,0
108594184239,108594184240,1,1285,1692,0
108594560662,108594560663,1,789,1587,0
108596544367,108596544369,2,1299,1274,0
108599674085,108599674086,1,856,1184,0
108601636806,108601636806,0,963,1798,0
108605462482,108605462482,0,1391,1834,0
108612121110,108612121114,4,1523,1345,0
108614764727,108614764727,0,646,1046,0
108616614451,108616614450,-1,1500,2903,0
108619046863,108619046865,2,2259,2315,0
108621525642,108621525642,0,1076,2093,0
108622176158,108622176170,12,442,1770,0
108624084254,108624084259,5,2037,1374,0
108624447601,108624447601,0,1294,2302,0
108625397705,108625397706,1,963,1239,0
108630063595,108630063595,0,1260,1446,0
108630445908,108630445907,-1,1650,1672,0
108632725283,108632725281,-2,1367,1671,0
108634322113,108634322111,-2,1411,2531,0
108643292126,108643292124,-2,1542,2084,0
108648168677,108648168676,-1,1111,1697,0
108654778961,108654778962,1,923,1609,0
108654865711,108654865713,2,1428,1179,0
108655685054,108655685054,0,1476,1607,0
108655962229,108655962230,1,639,946,0
108657724573,108657724573,0,1466,2299,0
108659031799,108659031799,0,1357,1574,0
108661451386,108661451389,3,940,1911,0
108664340987,108664340988,1,1373,1543,0
108668023999,108668024001,2,1012,2079,0
108668554566,108668554567,1,2098,1944,0
108673747130,108673747130,0,1497,1594,0
108675481350,108675481352,2,1518,1755,0
108679918874,108679918872,-2,1035,2860,0
108681299106,108681299110,4,1547,1596,0
108683389154,108683389153,-1,1375,1965,0
108688929104,108688929100,-4,1411,2499,0
108689850223,108689850225,2,1779,1537,0
108690791155,108690791155,0,1960,2179,0
108691424123,108691424125,2,1346,1488,0
108691692418,108691692419,1,1665,1802,0
108693309929,108693309930,1,1784,2099,0
108694034250,108694034250,0,1140,1451,0
108694329826,108694329827,1,943,1011,0
108694421590,108694421593,3,2551,1545,0
108696433854,108696433855,1,1234,1578,0
108697066294,108697066290,-4,952,2932,0
108698228934,108698228935,1,1266,1103,0
108701603727,108701603729,2,1117,1275,0
108702866669,108702866671,2,1867,2054,0
108704475619,108704475620,1,1563,1885,0
108706563526,108706563527,1,1200,1486,0
108707057134,108707057153,19,1667,1527,0
108708298462,108708298462,0,1564,1380,0
108710622499,108710622497,-2,1154,1259,0
108714190658,108714190657,-1,1577,2571,0
108714265166,108714265165,-1,668,1344,0
108716914418,108716914418,0,1309,1176,0
108718613973,108718613974,1,1640,1680,0
108720301963,108720301962,-1,1621,1851,0
108725157975,108725157977,2,1179,1464,0
108727156043,108727156045,2,1586,1737,0
108730245998,108730245998,0,1763,1731,0
108730529176,108730529190,14,772,2693,0
108730633910,108730633910,0,1097,1925,0
108731683615,108731683616,1,895,1294,0
108732928313,108732928313,0,1793,2400,0
108733450310,108733450310,0,1684,2081,0
108735392910,108735392918,8,2597,846,0
108735992006,108735992007,1,1450,1301,0
108737480646,108737480646,0,1153,1703,0
108739506635,108739506653,18,1135,1549,0
108741056661,108741056658,-3,1700,3098,0
108741972374,108741972375,1,1030,1708,0
108742373395,108742373394,-1,1778,2243,0
108743516230,108743516231,1,1166,1588,0
108744384324,108744384330,6,3358,1419,0
108746327989,108746327990,1,1419,1784,0
108749425362,108749425361,-1,1079,1723,0
108754065925,108754065926,1,2015,1688,0
108754413958,108754413959,1,1278,1757,0
108754470737,108754470739,2,1519,1768,0
108757571078,108757571076,-2,1435,1604,0
108759943640,108759943640,0,1599,2299,0
108763982796,108763982797,1,1205,1171,0
108767517309,108767517310,1,1034,1181,0
108767704151,108767704151,0,1500,2268,0
108767995433,108767995432,-1,1349,1519,0
108768176734,108768176733,-1,1356,2538,0
108773272168,108773272169,1,1314,1724,0
108773451710,108773451711,1,1151,1566,0
108774251353,108774251355,2,1570,1332,0
108775543951,108775543951,0,1487,1346,0
108778947499,108778947501,2,953,1352,0
108779557506,108779557511,5,597,67,0
108780452444,108780452442,-2,1524,1279,0
108781063413,108781063411,-2,836,987,0
108787925807,108787925808,1,2039,2039,0
108788918426,108788918426,0,1416,1908,0
108791120015,108791120014,-1,945,1909,0
108793361357,108793361361,4,1755,951,0
108796535221,108796535220,-1,1269,1956,0
108797244120,108797244118,-2,1183,2390,0
108797275197,108797275197,0,1764,1951,0
108797609502,108797609502,0,908,1206,0
108807703034,108807703032,-2,789,1647,0
108809737143,108809737143,0,1076,1745,0
108814122670,108814122673,3,1404,2066,0
108815149708,108815149707,-1,2087,1865,0
108816768725,108816768726,1,1537,1713,0
108816911653,108816911654,1,1725,2076,0
108821884626,108821884626,0,1259,1680,0
108823101674,108823101695,21,1318,2704,0
108823275025,108823275026,1,1444,1721,0
108824205965,108824205965,0,1181,1790,0
108826383105,108826383106,1,1197,1168,0
108827727186,108827727188,2,1485,1583,0
108828459165,108828459164,-1,1085,1595,0
108831511639,108831511638,-1,1493,1563,0
108832409762,108832409763,1,1299,1458,0
108834064078,108834064077,-1,1255,1744,0
108839910773,108839910773,0,1076,729,0
108840031998,108840032012,14,404,1528,0
108841571934,108841571931,-3,1247,2435,0
108843781814,108843781815,1,886,1302,0
108845755804,108845755802,-2,1099,1309,0
108847266299,108847266299,0,1487,1654,0
108847333147,108847333145,-2,1209,1365,0
108848626454,108848626453,-1,1245,1404,0
108851876492,108851876493,1,1651,1635,0
108852883434,108852883434,0,1250,1671,0
108853017853,108853017840,-13,1225,1396,0
108853808617,108853808619,2,1120,1091,0
108858736672,108858736671,-1,1643,2159,0
108859279480,108859279479,-1,1973,2134,0
108859931649,108859931650,1,273,619,0
108860825998,108860825999,1,2266,2695,0
108863605262,108863605263,1,1573,2251,0
108865156398,108865156397,-1,1192,1679,0
108867290285,108867290286,1,1393,1694,0
108870010761,108870010760,-1,1551,1882,0
108870470299,108870470302,3,2256,2085,0
108870820051,108870820049,-2,903,2167,0
108874419518,108874419518,0,1311,2153,0
108876809434,108876809436,2,1704,1770,0
108877477872,108877477879,7,1651,1367,0
108878891766,108878891765,-1,1412,1600,0
108881578175,108881578178,3,1474,1610,0
108882587865,108882587865,0,1709,1782,0
108885132802,108885132803,1,1223,1922,0
108886342071,108886342072,1,1224,1954,0
108887545435,108887545438,3,1422,1700,0
108888512347,108888512349,2,956,1876,0
108888918502,108888918511,9,371,514,0
108889621127,108889621127,0,1340,1586,0
108892671676,108892671675,-1,1365,1839,0
108894583013,108894583013,0,1895,1748,0
108895991586,108895991586,0,2278,2242,0
108899018162,108899018146,-16,1076,1398,0
108899909234,108899909235,1,1194,1196,0
108904285478,108904285481,3,1713,1995,0
108905696369,108905696369,0,1588,2155,0
108908389666,108908389666,0,1426,1189,0
108909529103,108909529101,-2,1119,1639,0
108916057570,108916057570,0,1135,1691,0
108917650438,108917650440,2,2004,1875,0
108923004877,108923004877,0,1479,1808,0
108924619091,108924619091,0,1204,801,0
108926792445,108926792449,4,3490,2049,0
108926934474,108926934473,-1,893,1237,0
108927975966,108927975968,2,1250,1193,0
108928889440,108928889440,0,1282,1892,0
108929382979,108929382981,2,1342,1473,0
108930780306,108930780301,-5,1610,6916,0
108931782915,108931782917,2,1648,1576,0
108933047930,108933047931,1,1567,1335,0
108933345933,108933345931,-2,1260,1918,0
108934585386,108934585386,0,1185,1593,0
108935379350,108935379371,21,765,1085,0
108938161638,108938161639,1,1670,1852,0
108940375919,108940375923,4,1514,1527,0
108940658778,108940658779,1,1330,1885,0
108943921678,108943921678,0,1451,1616,0
108945176822,108945176823,1,1636,2187,0
108946443454,108946443454,0,1279,2148,0
108947257235,108947257234,-1,1252,2169,0
108949222046,108949222046,0,1033,1296,0
108952745006,108952745010,4,1046,1911,0
108953297246,108953297249,3,1731,1698,0
108956855094,108956855095,1,1514,1467,0
108959515788,108959515789,1,1809,1407,0
108961903900,108961903902,2,848,1790,0
108965982334,108965982335,1,1364,1424,0
108968607121,108968607122,1,21990,25645,0
108970253750,108970253750,0,1594,1782,0
108970607458,108970607457,-1,1621,2559,0
108972469406,108972469412,6,1734,1311,0
108975494834,108975494839,5,1226,1801,0
108977765243,108977765242,-1,1895,2048,0
108978084851,108978084851,0,795,1183,0
108978976635,108978976637,2,1928,2533,0
108984969844,108984969845,1,1000,1047,0
108985850211,108985850194,-17,1525,1483,0
108992008728,108992008729,1,1607,2304,0
108994235599,108994235599,0,957,1572,0
108994872658,108994872661,3,1372,2318,0
108996540812,108996540813,1,1407,1572,0
108996751981,108996751981,0,1979,2748,0
108997125622,108997125623,1,1655,1863,0
108998195873,108998195873,0,1464,1736,0
108998861773,108998861773,0,1534,1762,0
109001144221,109001144218,-3,1316,1789,0
109004615514,109004615515,1,1555,1505,0
109007500443,109007500441,-2,1662,3120,0
109009525729,109009525725,-4,1061,3817,0
109009766060,109009766059,-1,1407,1588,0
109009995861,109009995841,-20,1234,3257,0
109014664735,109014664734,-1,1635,2609,0
109022152145,109022152146,1,1579,2639,0
109022552627,109022552625,-2,1573,1809,0
109023889606,109023889607,1,1416,2155,0
109024009647,109024009649,2,1567,1438,0
109025252634,109025252633,-1,1525,1314,0
109026026257,109026026255,-2,1483,1276,0
109030586073,109030586080,7,2653,1199,0
109030780561,109030780554,-7,675,3279,0
109037543905,109037543907,2,1208,929,0
109039755206,109039755206,0,1359,1508,0
109041018178,109041018178,0,1058,1585,0
109042292525,109042292525,0,1094,1764,0
109045728526,109045728527,1,1299,1247,0
109046684018,109046684019,1,1371,1744,0
109048805537,109048805537,0,1191,1819,0
109048936587,109048936588,1,1076,1382,0
109049252994,109049252994,0,1475,1831,0
109049503641,109049503641,0,1357,1385,0
109051243802,109051243804,2,1084,1454,0
109051826483,109051826487,4,1293,1146,0
109052511694,109052511709,15,1362,1267,0
109053412718,109053412716,-2,1796,1716,0
109053760704,109053760702,-2,1143,1867,0
109055293972,109055293970,-2,1104,1598,0
109055704942,109055704943,1,888,1432,0
109056302426,109056302426,0,1411,1364,0
109057795334,109057795334,0,2172,1782,0
109057893620,109057893621,1,842,1547,0
109067422755,109067422750,-5,1013,2172,0
109075327754,109075327754,0,1160,1344,0
109082005189,109082005190,1,990,1150,0
109084630341,109084630339,-2,1083,1456,0
109085075547,109085075527,-20,32455,26003,0
109091384423,109091384422,-1,1348,929,0
109102479560,109102479556,-4,1490,3064,0
109104454822,109104454822,0,1300,1307,0
109105189063,109105189057,-6,1857,7634,0
109106358489,109106358493,4,1690,1957,0
109108291480,109108291481,1,1581,1406,0
109108574945,109108574945,0,1473,1669,0
109109793780,109109793779,-1,18496,13710,0
109114104694,109114104697,3,933,1544,0
109116833600,109116833602,2,1292,1176,0
109117631370,109117631370,0,1634,2352,0
109118026857,109118026856,-1,1061,2110,0
109120998989,109120998988,-1,1424,2143,0
109123894023,109123894025,2,1113,1569,0
109124466722,109124466723,1,1332,1697,0
109125804146,109125804146,0,1592,1564,0
109125916346,109125916347,1,2127,2141,0
109129310385,109129310383,-2,906,1153,0
109131185566,109131185566,0,1770,1561,0
109131401549,109131401546,-3,1006,1752,0
109132618767,109132618762,-5,584,2417,0
109136765331,109136765343,12,959,982,0
109139047194,109139047196,2,2038,1528,0
109139526785,109139526786,1,1230,1442,0
109141255161,109141255162,1,1815,2217,0
109141579307,109141579307,0,1076,972,0
109141856207,109141856206,-1,1535,1217,0
109144596931,109144596930,-1,1364,1733,0
109149038586,109149038583,-3,848,1791,0
109150772063,109150772062,-1,1657,1318,0
109150954970,109150954970,0,1635,1808,0
109154142011,109154142011,0,1681,1898,0
109154831714,109154831717,3,1957,1853,0
109156174367,109156174370,3,1340,1461,0
109156639401,109156639401,0,2659,2247,0
109159435629,109159435627,-2,962,1278,0
109160779779,109160779778,-1,983,1428,0
109161906737,109161906730,-7,2431,7247,0
109162253839,109162253842,3,1630,1718,0
109164237223,109164237222,-1,1329,1852,0
109166814293,109166814293,0,1475,2061,0
109168890098,109168890102,4,1608,1262,0
109175467478,109175467478,0,1332,1713,0
109176328021,109176328021,0,1217,1382,0
109179554146,109179554147,1,1088,1088,0
109179622401,109179622401,0,1321,1290,0
109183565978,109183565980,2,3470,2862,0
109184348220,109184348222,2,1670,1714,0
109184375474,109184375475,1,1859,1325,0
109185801036,109185801034,-2,1530,1473,0
109188719634,109188719635,1,1044,1971,0
109191432962,109191432977,15,2176,1372,0
109195854514,109195854515,1,1252,1023,0
109198346691,109198346690,-1,853,1589,0
109200987715,109200987717,2,1117,2315,0
109203627246,109203627246,0,1164,1539,0
109204585450,109204585447,-3,1355,2061,0
109208605422,109208605423,1,1110,1183,0
109211694811,109211694813,2,1778,1398,0
109212319683,109212319683,0,1487,1310,0
109217465658,109217465658,0,1455,1836,0
109217617311,109217617317,6,3713,2006,0
109218434706,109218434709,3,1661,1557,0
109219250798,109219250801,3,1615,1413,0
109225523179,109225523181,2,1258,1718,0
109226044382,109226044383,1,1417,1686,0
109227113912,109227113910,-2,1374,1804,0
109229391861,109229391862,1,1748,1665,0
109231768407,109231768409,2,2087,1456,0
109231818569,109231818571,2,1370,1713,0
109232040717,109232040718,1,12186,14373,0
109234924765,109234924765,0,1436,1634,0
109234957737,109234957720,-17,4573,1152,0
109235475020,109235475019,-1,1198,1736,0
109236881109,109236881110,1,1571,1764,0
109237030546,109237030559,13,1040,1236,0
109237515644,109237515646,2,1265,1432,0
109241337031,109241337033,2,1675,1429,0
109241734209,109241734188,-21,945,1710,0
109242958275,109242958274,-1,1365,1537,0
109247599113,109247599113,0,1169,1691,0
109248546802,109248546800,-2,2317,4794,0
109250233894,109250233893,-1,3026,3468,0
109251783435,109251783433,-2,1427,2015,0
109252606021,109252606022,1,1535,2381,0
109253340666,109253340666,0,1220,1361,0
109260757255,109260757254,-1,1207,1575,0
109262402217,109262402217,0,1082,1644,0
109265955607,109265955606,-1,1446,2071,0
109273969287,109273969287,0,1496,1502,0
109275072478,109275072478,0,1192,1276,0
109275450709,109275450716,7,2872,1362,0
109277233710,109277233711,1,1437,1514,0
109281670555,109281670556,1,1352,1834,0
109282863083,109282863088,5,1672,949,0
109287349969,109287349973,4,991,1132,0
109290595599,109290595602,3,1361,1634,0
109290922205,109290922206,1,1421,1779,0
109298112714,109298112715,1,1874,1846,0
109299731623,109299731623,0,1907,1413,0
109301004490,109301004489,-1,1409,1110,0
109303776705,109303776706,1,956,1041,0
109305377190,109305377187,-3,943,2793,0
109307145327,109307145327,0,1513,1436,0
109310213187,109310213187,0,1370,1862,0
109310571394,109310571394,0,1475,1893,0
109313116697,109313116695,-2,1209,1243,0
109319984510,109319984510,0,2084,2272,0
109320170426,109320170427,1,1777,1046,0
109320780492,109320780493,1,1846,2321,0
109324814376,109324814377,1,1217,2472,0
109326779823,109326779826,3,1891,1363,0
109327355715,109327355717,2,1307,914,0
109330636166,109330636167,1,1128,1551,0
109330986582,109330986583,1,1138,1726,0
109331075703,109331075704,1,1333,1929,0
109333024192,109333024190,-2,2781,4533,0
109333730577,109333730583,6,2324,1492,0
109336384971,109336384971,0,1553,1478,0
109336649986,109336649990,4,1603,1804,0
109336804374,109336804374,0,1323,1444,0
109337453621,109337453624,3,1007,1483,0
109338506087,109338506089,2,1157,1361,0
109339305230,109339305229,-1,1903,1965,0
109342143506,109342143507,1,1648,1780,0
109344519206,109344519206,0,994,1295,0
109345796771,109345796769,-2,1817,1519,0
109346017040,109346017039,-1,1736,1266,0
109347139825,109347139826,1,1217,1191,0
109353496493,109353496494,1,1430,1798,0
109357571618,109357571617,-1,1445,1964,0
109358304315,109358304314,-1,1464,1697,0
109358880137,109358880138,1,1364,1260,0
109359742289,109359742291,2,1211,1027,0
109364220400,109364220402,2,1126,1900,0
109365662019,109365662021,2,1447,1322,0
109367259836,109367259849,13,12244,42627,0
109367570854,109367570856,2,481,177,0
109375478582,109375478581,-1,2308,3928,0
109378499070,109378499070,0,1221,1440,0
109378681175,109378681177,2,1415,1864,0
109378879138,109378879138,0,1115,1653,0
109380305862,109380305862,0,1756,2036,0
109382686334,109382686337,3,957,2204,0
109383091157,109383091157,0,1864,2093,0
109385043356,109385043356,0,1217,1382,0
109386016845,109386016848,3,2142,1531,0
109386452201,109386452202,1,1530,2232,0
109391308717,109391308718,1,1593,1867,0
109394435418,109394435398,-20,1563,1391,0
109396425721,109396425721,0,1068,1996,0
109396708840,109396708840,0,1259,1027,0
109397127875,109397127878,3,1560,1846,0
109399673553,109399673553,0,1400,1802,0
109400131525,109400131541,16,1028,1350,0
109400805849,109400805850,1,1472,2058,0
109405140200,109405140200,0,1312,1707,0
109405798797,109405798799,2,2206,1444,0
109407190019,109407190021,2,1366,1489,0
109409079290,109409079292,2,1320,1963,0
109409570438,109409570439,1,1842,1411,0
109410114258,109410114257,-1,1507,1424,0
109412645276,109412645277,1,1504,1732,0
109412870947,109412870953,6,1594,1261,0
109418764013,109418764014,1,1522,1477,0
109420195653,109420195653,0,1367,1266,0
109420695763,109420695758,-5,804,3917,0
109420830613,109420830605,-8,25,1267,0
109423534991,109423534993,2,1209,1534,0
109430411215,109430411214,-1,1162,1155,0
109431926834,109431926835,1,1655,1867,0
109432093471,109432093473,2,1324,1322,0
109434112347,109434112345,-2,1169,1626,0
109435214170,109435214170,0,1962,1879,0
109437428889,109437428883,-6,1172,4811,0
109438298622,109438298614,-8,1184,1561,0
109440679366,109440679367,1,1211,1459,0
109446174547,109446174548,1,740,1797,0
109447423722,109447423728,6,2066,1154,0
109450022977,109450022978,1,1267,1298,0
109451412446,109451412447,1,1110,1495,0
109452454213,109452454211,-2,1383,1679,0
109452665070,109452665070,0,1145,1268,0
109458044870,109458044870,0,1260,1898,0
109461131586,109461131584,-2,1307,1840,0
109462464067,109462464062,-5,1274,5421,0
109464153590,109464153590,0,1052,1593,0
109464566857,109464566855,-2,1293,1057,0
109470809666,109470809650,-16,1348,1887,0
109474618769,109474618769,0,1236,1871,0
109477740399,109477740401,2,1314,1363,0
109481689147,109481689149,2,1640,2101,0
109481978546,109481978546,0,1735,2121,0
109482858636,109482858637,1,1711,2076,0
109483577151,109483577147,-4,613,1471,0
109485255387,109485255387,0,2000,2414,0
109486994209,109486994202,-7,3212,12849,0
109489999577,109489999577,0,1052,1669,0
109491186326,109491186328,2,1501,1751,0
109493347738,109493347738,0,1195,1964,0
109494693618,109494693617,-1,1485,1885,0
109497089793,109497089793,0,1164,2574,0
109497846979,109497846981,2,1246,1535,0
109498930994,109498930995,1,1734,1751,0
109501193463,109501193461,-2,1663,1893,0
109509798758,109509798760,2,1718,1792,0
109510650831,109510650831,0,2392,2131,0
109517420238,109517420233,-5,834,2519,0
109520202005,109520202005,0,998,1884,0
109521421721,109521421721,0,1551,1945,0
109521590619,109521590622,3,1409,1826,0
109523989298,109523989297,-1,1604,2016,0
109526228434,109526228435,1,906,1460,0
109527266214,109527266194,-20,1431,1344,0
109527957045,109527957047,2,1836,1693,0
109530586218,109530586217,-1,1028,1701,0
109532156752,109532156771,19,1531,1426,0
109533184353,109533184351,-2,1045,2007,0
109535184321,109535184319,-2,972,1336,0
109536570914,109536570915,1,1622,1877,0
109536813443,109536813445,2,1652,1630,0
109537482503,109537482502,-1,1011,1196,0
109541039319,109541039318,-1,1798,1644,0
109541954626,109541954624,-2,1050,1316,0
109543764680,109543764681,1,3042,3641,0
109548712800,109548712801,1,1254,1170,0
109549166095,109549166094,-1,1746,1622,0
109550355810,109550355810,0,904,1156,0
109555567669,109555567670,1,1543,1319,0
109556922409,109556922409,0,1549,1798,0
109557005613,109557005601,-12,1348,1729,0
109563679319,109563679318,-1,1233,1185,0
109565940526,109565940528,2,914,1637,0
109568051494,109568051493,-1,1196,2015,0
109569600827,109569600826,-1,952,1010,0
109572987862,109572987853,-9,877,3917,0
109575656322,109575656322,0,1999,2012,0
109578583773,109578583770,-3,1857,1654,0
109584485705,109584485709,4,1085,1236,0
109588266851,109588266850,-1,949,877,0
109590554305,109590554304,-1,1162,2308,0
109592360477,109592360477,0,1704,1895,0
109592427440,109592427438,-2,1697,1700,0
109593548317,109593548315,-2,1922,2059,0
109595490105,109595490105,0,1863,1314,0
109598589332,109598589333,1,1533,1953,0
109599840921,109599840921,0,1237,1459,0
109602376151,109602376151,0,1314,1037,0
109602891675,109602891675,0,1464,1510,0
109610718919,109610718920,1,1383,1386,0
109612624886,109612624886,0,1438,1538,0
109612778501,109612778507,6,2390,1536,0
109612884770,109612884770,0,1550,1471,0
109614966698,109614966698,0,1526,2425,0
109615287597,109615287618,21,29,1865,0
109615568657,109615568653,-4,54249,27704,0
109620271604,109620271604,0,1400,2114,0
109622347503,109622347503,0,917,1537,0
109623615134,109623615126,-8,1156,1839,0
109629359055,109629359055,0,1016,1329,0
109629955578,109629955579,1,1665,1412,0
109631056524,109631056524,0,1476,1754,0
109631779478,109631779478,0,1152,1720,0
109635500156,109635500155,-1,2201,2652,0
109638440531,109638440532,1,1766,2034,0
109642737861,109642737854,-7,2189,7823,0
109646019496,109646019500,4,1675,1517,0
109648017942,109648017942,0,1114,1508,0
109649719354,109649719357,3,44191,3642,0
109650634582,109650634578,-4,993,2285,0
109652172873,109652172873,0,1363,1439,0
109656015551,109656015550,-1,997,1503,0
109656536782,109656536782,0,1400,2111,0
109660774671,109660774672,1,1546,1899,0
109662532623,109662532622,-1,1434,1232,0
109662776871,109662776870,-1,1411,2095,0
109667889996,109667889994,-2,1231,1968,0
109669239975,109669239955,-20,237,554,0
109673994927,109673994922,-5,913,3627,0
109676569427,109676569426,-1,1359,1645,0
109678275595,109678275595,0,1474,1672,0
109678703222,109678703226,4,1316,2180,0
109680573506,109680573506,0,994,996,0
109681137592,109681137593,1,985,1280,0
109684792805,109684792805,0,1620,2064,0
109685826563,109685826562,-1,1223,2147,0
109688422382,109688422382,0,1581,1693,0
109690140051,109690140052,1,1407,1370,0
109690803054,109690803038,-16,1447,1896,0
109697865419,109697865420,1,1254,1803,0
109702134242,109702134241,-1,1206,2068,0
109705422482,109705422482,0,1184,1474,0
109709180951,109709180953,2,1186,778,0
109711824105,109711824106,1,1405,1367,0
109713093070,109713093069,-1,2380,3755,0
109717302551,109717302553,2,1450,2712,0
109718097023,109718097025,2,1196,1522,0
109719593670,109719593672,2,1485,2241,0
109720421593,109720421594,1,818,2037,0
109724838127,109724838128,1,1582,1266,0
109725126429,109725126438,9,1609,290,0
109725562399,109725562398,-1,1073,1611,0
109730666770,109730666770,0,1643,1852,0
109731942121,109731942121,0,1556,1790,0
109737708679,109737708678,-1,1419,1727,0
109740597981,109740597983,2,1384,1918,0
109748311227,109748311231,4,1168,1099,0
109749709665,109749709666,1,945,970,0
109750818014,109750818014,0,983,1720,0
109751815031,109751815030,-1,1138,1800,0
109755191718,109755191718,0,1465,2435,0
109756019356,109756019378,22,196,454,0
109757349422,109757349425,3,2083,2008,0
109758563505,109758563504,-1,1852,2052,0
109758889428,109758889430,2,1468,1569,0
109759246223,109759246225,2,1186,1187,0
109759383011,109759383010,-1,691,1044,0
109762187098,109762187097,-1,1305,1989,0
109763454577,109763454575,-2,1323,1895,0
109764176730,109764176729,-1,771,1703,0
109767645187,109767645188,1,1495,2287,0
109768154597,109768154599,2,1457,1961,0
109769453551,109769453550,-1,1512,1711,0
109772074263,109772074266,3,18772,50060,0
109772580081,109772580082,1,838,1124,0
109777167695,109777167690,-5,1334,3969,0
109777358110,109777358110,0,1185,1442,0
109778479311,109778479312,1,1518,2377,0
109779490752,109779490753,1,1638,1952,0
109780059714,109780059715,1,1143,1955,0
109780509839,109780509838,-1,1223,2268,0
109781196404,109781196389,-15,920,1181,0
109784497150,109784497151,1,1011,1662,0
109784805311,109784805318,7,12584,22439,0
109789452223,109789452221,-2,900,1230,0
109790810242,109790810241,-1,1180,1471,0
109791276407,109791276402,-5,992,3385,0
109795498562,109795498565,3,1280,1678,0
109797458221,109797458221,0,1295,1616,0
109798678077,109798678078,1,2042,2375,0
109802980601,109802980602,1,1945,2847,0
109804009174,109804009174,0,1667,1913,0
109807400189,109807400189,0,1888,1926,0
109808127339,109808127336,-3,805,1671,0
109809281567,109809281569,2,2021,1901,0
109812682750,109812682750,0,1231,1684,0
109812742340,109812742338,-2,1430,1379,0
109813688859,109813688857,-2,1618,2595,0
109813906567,109813906566,-1,1111,1614,0
109817176806,109817176806,0,1704,1784,0
109821402642,109821402642,0,1359,2106,0
109822311836,109822311835,-1,1345,1498,0
109827051375,109827051374,-1,1199,1705,0
109833259946,109833259946,0,1657,2129,0
109837121947,109837121944,-3,1183,1493,0
109840798266,109840798264,-2,2116,4932,0
109842035314,109842035314,0,1785,1824,0
109844043927,109844043927,0,1580,2410,0
109844548498,109844548497,-1,1731,3240,0
109846850145,109846850166,21,622,1134,0
109850309290,109850309290,0,1722,2455,0
109850347771,109850347770,-1,1211,1163,0
109851601771,109851601776,5,4704,2129,0
109855259073,109855259073,0,1329,1576,0
109856592542,109856592542,0,1195,1851,0
109860467240,109860467241,1,1306,1418,0
109862108533,109862108534,1,1543,1822,0
109866139977,109866139973,-4,886,1587,0
109866787762,109866787761,-1,1144,1433,0
109867504568,109867504567,-1,1509,2065,0
109868689526,109868689528,2,1003,1244,0
109869365306,109869365307,1,1256,1989,0
109870170781,109870170781,0,929,1154,0
109875838706,109875838706,0,1599,2297,0
109875883524,109875883520,-4,2435,7328,0
109879876109,109879876110,1,1713,2263,0
109883653826,109883653827,1,1159,1706,0
109884396815,109884396816,1,1057,2209,0
109887392842,109887392843,1,1120,1416,0
109887890026,109887890026,0,987,1776,0
109888960911,109888960911,0,1463,1831,0
109891006155,109891006155,0,1030,2027,0
109892448575,109892448575,0,1440,2106,0
109893110597,109893110595,-2,1117,1786,0
109895486485,109895486486,1,1110,1008,0
109896276769,109896276770,1,1425,2275,0
109896618477,109896618478,1,1455,1415,0
109897715925,109897715927,2,1050,1449,0
109898680353,109898680352,-1,1536,2127,0
109898860762,109898860762,0,998,2148,0
109900420364,109900420366,2,1225,1414,0
109900872104,109900872105,1,1809,1917,0
109901522563,109901522562,-1,1308,1508,0
109902296586,109902296586,0,2080,1624,0
109904075738,109904075737,-1,1410,1699,0
109906229567,109906229567,0,1157,1710,0
109908393414,109908393417,3,1300,1622,0
109911438126,109911438127,1,2012,2720,0
109912517739,109912517741,2,1182,1235,0
109919523082,109919523082,0,1144,1764,0
109920707918,109920707918,0,1200,1646,0
109922577638,109922577641,3,1331,1279,0
109926879374,109926879375,1,1307,1689,0
109927049507,109927049507,0,1326,1626,0
109930564861,109930564862,1,1336,1557,0
109931609005,109931609009,4,1824,1063,0
109939816138,109939816138,0,993,937,0
109941897721,109941897722,1,1217,1566,0
109944455293,109944455294,1,1326,1333,0
109946711133,109946711134,1,1470,1552,0
109947780844,109947780843,-1,1068,1542,0
109950999890,109950999889,-1,1058,1218,0
109953670230,109953670228,-2,1582,2204,0
109953851544,109953851544,0,1150,1524,0
109954757950,109954757951,1,1323,1593,0
109955953043,109955953043,0,1473,1697,0
109957051066,109957051066,0,1454,1545,0
109957397293,109957397298,5,2186,1107,0
109957846914,109957846913,-1,1460,1543,0
109959169249,109959169246,-3,874,1655,0
109961053286,109961053285,-1,1234,1071,0
109962829431,109962829433,2,1649,1786,0
109965964595,109965964598,3,1694,1606,0
109967928701,109967928688,-13,1506,676,0
109970656243,109970656243,0,1324,2015,0
109971904019,109971904017,-2,1064,2181,0
109974113026,109974113025,-1,1056,1338,0
109974771198,109974771189,-9,1237,1461,0
109976875800,109976875814,14,2203,5276,0
109977151502,109977151502,0,1155,1583,0
109978525826,109978525825,-1,884,1789,0
109984816642,109984816647,5,1382,1540,0
109986317605,109986317606,1,1440,2050,0
110000931921,110000931923,2,985,1293,0
110001013594,110001013595,1,1896,2427,0
110001814358,110001814361,3,1758,1865,0
110002204569,110002204570,1,949,1909,0
110004501902,110004501910,8,3678,1296,0
110008461399,110008461399,0,860,1237,0
110008788143,110008788144,1,1663,2244,0
110011282053,110011282056,3,1511,1511,0
110012310291,110012310292,1,1181,1501,0
110012383403,110012383422,19,1490,1678,0
110014467673,110014467672,-1,1631,1519,0
110019892571,110019892573,2,1392,2063,0
110020153968,110020153968,0,1018,1510,0
110020691492,110020691483,-9,35,835,0
110022817279,110022817281,2,1391,1464,0
110024128209,110024128207,-2,1333,1298,0
110024605407,110024605405,-2,667,1737,0
110025658704,110025658702,-2,1048,1053,0
110027031795,110027031795,0,1214,1689,0
110028555820,110028555822,2,2259,1658,0
110031149416,110031149417,1,1445,1629,0
110032639387,110032639387,0,1612,1774,0
110035151732,110035151733,1,1299,1665,0
110035304205,110035304189,-16,199,686,0
110035899176,110035899175,-1,1326,1599,0
110039666322,110039666325,3,3635,4583,0
110042353559,110042353559,0,1264,1690,0
110044755081,110044755081,0,1534,1769,0
110046822817,110046822818,1,813,1240,0
110046914151,110046914151,0,1425,1771,0
110047349872,110047349873,1,1116,1278,0
110048332811,110048332789,-22,1103,938,0
110051049183,110051049183,0,2005,1653,0
110052646434,110052646434,0,1759,1659,0
110054253133,110054253132,-1,1307,1590,0
110057989857,110057989858,1,1293,1862,0
110062983913,110062983914,1,1119,1428,0
110064638530,110064638531,1,1286,1601,0
110066014099,110066014099,0,1383,1945,0
110067721860,110067721860,0,1177,1663,0
110074923451,110074923451,0,1490,1863,0
110077191310,110077191308,-2,1274,1042,0
110079458472,110079458474,2,1523,2571,0
110079961744,110079961743,-1,1257,2191,0
110081858900,110081858898,-2,1389,2098,0
110082345510,110082345510,0,730,1436,0
110084505146,110084505146,0,853,1315,0
110088259858,110088259858,0,1366,1763,0
110090629759,110090629761,2,1444,1788,0
110092469418,110092469420,2,1598,1753,0
110093585437,110093585439,2,1513,1530,0
110096563524,110096563525,1,2148,2104,0
110097181271,110097181273,2,1182,1444,0
110098020965,110098020963,-2,1415,1976,0
110101321026,110101321023,-3,1061,1218,0
110101683100,110101683101,1,905,1954,0
110103415230,110103415223,-7,1835,5854,0
110106742332,110106742333,1,1452,2600,0
110107776614,110107776614,0,1460,1302,0
110108187181,110108187177,-4,797,3421,0
110108882662,110108882658,-4,2205,5409,0
110109369018,110109369015,-3,539,792,0
110110088994,110110088993,-1,1462,2107,0
110110572091,110110572092,1,1609,1707,0
110112373460,110112373460,0,1348,1420,0
110113567902,110113567902,0,1574,1533,0
110115632086,110115632085,-1,1137,1720,0
110117241629,110117241646,17,934,1314,0
110118122182,110118122176,-6,1477,4552,0
110118405676,110118405674,-2,948,1792,0
110119560831,110119560831,0,1896,2234,0
110119854238,110119854239,1,1289,1248,0
110122425561,110122425559,-2,931,1956,0
110122705674,110122705674,0,1550,1765,0
110126324030,110126324031,1,1192,1508,0
110127518663,110127518665,2,1416,1740,0
110134272235,110134272235,0,1747,1918,0
110139587937,110139587937,0,2043,2282,0
110139908602,110139908601,-1,877,2046,0
110140650521,110140650521,0,1355,1854,0
110141817626,110141817626,0,1627,1794,0
110142486678,110142486678,0,1790,1814,0
110149178573,110149178575,2,2027,2030,0
110149870391,110149870390,-1,1232,1448,0
110151682362,110151682362,0,1344,1646,0
110160416663,110160416665,2,1463,1434,0
110161759898,110161759898,0,2141,2550,0
110163636451,110163636445,-6,784,3618,0
110164133719,110164133720,1,1893,2227,0
110167456113,110167456114,1,1140,1310,0
110168550406,110168550410,4,1650,1115,0
110172897520,110172897520,0,1147,1689,0
110173169717,110173169720,3,1705,1740,0
110173681095,110173681095,0,1101,1641,0
110174403869,110174403869,0,1776,2486,0
110177601099,110177601099,0,1427,1540,0
110179131070,110179131071,1,1559,1390,0
110181131855,110181131857,2,1892,2394,0
110181293029,110181293028,-1,1593,1839,0
110181957188,110181957186,-2,1418,1978,0
110182202601,110182202602,1,1031,1942,0
110182562083,110182562079,-4,1286,2409,0
110184572833,110184572834,1,1241,1613,0
110186926021,110186926022,1,1182,1421,0
110192640107,110192640084,-23,548,640,0
110192901674,110192901676,2,1539,1577,0
110193648605,110193648587,-18,1488,1155,0
110194000135,110194000124,-11,1864,1605,0
110196984267,110196984271,4,2038,1795,0
110200514314,110200514315,1,1527,1180,0
110206271340,110206271339,-1,1751,1468,0
110207921350,110207921351,1,1303,1435,0
110208585086,110208585090,4,6388,4812,0
110209731206,110209731206,0,1302,1574,0
110211200307,110211200307,0,1314,1548,0
110215920821,110215920828,7,1589,776,0
110217158410,110217158410,0,1619,1132,0
110219959097,110219959098,1,1191,1433,0
110220023643,110220023647,4,1120,1167,0
110220276174,110220276174,0,1483,1982,0
110220702094,110220702088,-6,21905,12756,0
110221770685,110221770705,20,1203,1600,0
110225215642,110225215642,0,946,1416,0
110225300113,110225300112,-1,1673,1468,0
110225464526,110225464527,1,1251,1765,0
110225723382,110225723384,2,1696,1880,0
110230501623,110230501624,1,1383,2031,0
110233343158,110233343158,0,1191,1518,0
110233971822,110233971822,0,1138,1386,0
110237787657,110237787656,-1,1508,2149,0
110240126599,110240126599,0,1494,1509,0
110240628935,110240628938,3,3978,2505,0
110241125061,110241125063,2,1430,1284,0
110241712414,110241712414,0,992,1566,0
110242553110,110242553102,-8,620,1997,0
110242966146,110242966145,-1,1119,1240,0
110243514329,110243514331,2,1049,1077,0
110244564170,110244564166,-4,1168,2436,0
110244706974,110244706973,-1,1358,1778,0
110245456907,110245456907,0,1083,2042,0
110245680953,110245680954,1,1398,2023,0
110247042289,110247042287,-2,1009,1732,0
110249776947,110249776945,-2,1415,1769,0
110257397460,110257397458,-2,1730,2039,0
110257514907,110257514909,2,1667,1454,0
110258649158,110258649176,18,170,8367,0
110261646963,110261646964,1,1170,1653,0
110261951607,110261951605,-2,1294,1598,0
110268469605,110268469607,2,1281,1450,0
110272820594,110272820594,0,1391,2133,0
110276913726,110276913729,3,1335,970,0
110278945858,110278945857,-1,1472,1930,0
110279093995,110279093997,2,1413,1924,0
110285406659,110285406661,2,791,1187,0
110287162056,110287162058,2,1562,1893,0
110287929469,110287929490,21,1497,1959,0
110291498719,110291498717,-2,1376,863,0
110292328102,110292328107,5,1718,1396,0
110292780103,110292780103,0,1607,1863,0
110292855491,110292855491,0,1216,1202,0
110293587206,110293587203,-3,1347,1789,0
110294983769,110294983769,0,1441,2165,0
110297846134,110297846135,1,1743,2369,0
110306709605,110306709607,2,921,859,0
110314836464,110314836462,-2,1109,1219,0
110315625558,110315625574,16,739,1736,0
110320711062,110320711062,0,886,1053,0
110326541813,110326541811,-2,1250,1357,0
110329566278,110329566279,1,1286,2010,0
110329840054,110329840057,3,1447,865,0
110332495036,110332495039,3,3847,21552,0
110333514442,110333514441,-1,1494,1713,0
110333686882,110333686890,8,3554,1582,0
110335498538,110335498538,0,1531,1580,0
110338206201,110338206201,0,1511,1910,0
110339073563,110339073563,0,1468,2172,0
110339373252,110339373249,-3,1125,2089,0
110340997710,110340997711,1,1475,1580,0
110341859517,110341859515,-2,924,1781,0
110342803232,110342803233,1,2391,3155,0
110343513977,110343513998,21,910,1259,0
110344007290,110344007290,0,1404,1719,0
110344906525,110344906525,0,1798,1742,0
110346515839,110346515839,0,1273,1816,0
110350940434,110350940434,0,904,1023,0
110354523630,110354523630,0,1579,1717,0
110361386157,110361386159,2,1512,1440,0
110363286438,110363286439,1,1293,2147,0
110365243054,110365243055,1,1812,1366,0
110366033718,110366033718,0,1575,1728,0
110369479196,110369479196,0,1659,1505,0
110369581296,110369581309,13,513,2003,0
110370529729,110370529730,1,1571,2035,0
110372840960,110372840978,18,1251,1298,0
110374412379,110374412379,0,2096,2226,0
110379987598,110379987599,1,1024,2044,0
110383042109,110383042109,0,2369,2387,0
110383713113,110383713114,1,1617,1533,0
110383970430,110383970430,0,1319,2223,0
110384505415,110384505414,-1,1723,1897,0
110386033555,110386033555,0,1155,1716,0
110387759090,110387759089,-1,905,1474,0
110392404283,110392404282,-1,1756,1868,0
110400014717,110400014718,1,1823,2299,0
110400875750,110400875749,-1,1188,1781,0
110402024626,110402024631,5,1682,1148,0
110404887931,110404887932,1,1090,1197,0
110406417845,110406417846,1,1251,2599,0
110409903006,110409903007,1,1031,1425,0
110410423659,110410423658,-1,1655,2327,0
110411255151,110411255151,0,1604,1899,0
110411721625,110411721627,2,1142,1920,0
110413987145,110413987143,-2,696,1152,0
110414859106,110414859106,0,1216,1468,0
110414985158,110414985162,4,1608,1333,0
110415667654,110415667659,5,1842,1364,0
110422220324,110422220326,2,1844,1232,0
110422634706,110422634707,1,839,1280,0
110427938414,110427938417,3,1495,1593,0
110430085911,110430085910,-1,945,1196,0
110430370874,110430370876,2,1319,1141,0
110432283910,110432283910,0,1064,1514,0
110433112277,110433112276,-1,2228,1753,0
110434602461,110434602461,0,1714,2610,0
110435650934,110435650935,1,1346,1465,0
110437373063,110437373063,0,1022,1105,0
110437671570,110437671571,1,1119,1100,0
110440640055,110440640058,3,1388,1214,0
110440976461,110440976462,1,1812,2258,0
110442283182,110442283186,4,1756,1166,0
110443445224,110443445224,0,1648,2910,0
110443640394,110443640393,-1,1360,1891,0
110445031957,110445031957,0,1239,1364,0
110454391777,110454391778,1,1102,1637,0
110456460629,110456460630,1,996,1426,0
110458055863,110458055863,0,908,1394,0
110463760154,110463760154,0,1624,1424,0
110465033335,110465033340,5,3042,1599,0
110466083958,110466083958,0,1790,2118,0
110466695208,110466695210,2,899,1810,0
110467683533,110467683537,4,1615,1878,0
110469533111,110469533111,0,1482,1842,0
110470932894,110470932893,-1,1300,1846,0
110471604776,110471604775,-1,1478,2165,0
110472888256,110472888257,1,1529,1901,0
110473255503,110473255506,3,1370,2016,0
110479572362,110479572366,4,4352,3156,0
110481885094,110481885093,-1,1349,1703,0
110484062986,110484062966,-20,4437,832,0
110484600506,110484600503,-3,933,1367,0
110487073419,110487073418,-1,1217,1550,0
110492259661,110492259660,-1,1287,1840,0
110493758118,110493758118,0,1720,1380,0
110498390495,110498390493,-2,1078,1998,0
110498784466,110498784466,0,1101,1323,0
110500761123,110500761103,-20,3496,935,0
110501177195,110501177195,0,1351,1400,0
110501513458,110501513459,1,1189,1490,0
110502662788,110502662775,-13,1418,1887,0
110505976458,110505976470,12,16357,31399,0
110508613678,110508613679,1,1641,1772,0
110509055329,110509055329,0,1485,1304,0
110511931491,110511931491,0,1431,1552,0
110513275798,110513275799,1,1115,1505,0
110515264434,110515264434,0,1404,1768,0
110517688711,110517688709,-2,1032,1303,0
110520122099,110520122100,1,1104,922,0
110521013330,110521013330,0,1176,813,0
110525372510,110525372510,0,1381,1443,0
110526836917,110526836917,0,1694,1869,0
110527202177,110527202178,1,1298,1359,0
110528699652,110528699652,0,1316,1654,0
110531021966,110531021966,0,1473,1990,0
110537078773,110537078774,1,1382,1429,0
110539366560,110539366561,1,1733,1949,0
110541271116,110541271117,1,1251,1521,0
110545890818,110545890812,-6,16471,18042,0
110546915979,110546915981,2,2138,1804,0
110547860431,110547860438,7,1973,1296,0
110548614104,110548614105,1,895,929,0
110550338055,110550338057,2,1297,1877,0
110555783611,110555783611,0,1790,2779,0
110555913586,110555913587,1,1640,2050,0
110556313410,110556313410,0,1580,2360,0
110562707414,110562707417,3,1837,1367,0
110564289987,110564289987,0,1582,2085,0
110569405249,110569405249,0,1520,1268,0
110570747877,110570747878,1,1496,1671,0
110571674993,110571674995,2,1587,1349,0
110572367067,110572367067,0,1153,2058,0
110573639378,110573639378,0,1378,1457,0
110574459738,110574459741,3,1144,1650,0
110574619869,110574619867,-2,1367,1935,0
110574686406,110574686409,3,1075,1465,0
110574820258,110574820257,-1,1066,1622,0
110577358105,110577358105,0,1537,1516,0
110582219422,110582219422,0,1114,1155,0
110585443634,110585443633,-1,1595,1582,0
110589235865,110589235863,-2,888,2576,0
110590004950,110590004952,2,942,1873,0
110590668777,110590668778,1,1224,1553,0
110590909898,110590909902,4,1020,1752,0
110599990746,110599990746,0,1355,2155,0
110600529418,110600529418,0,1952,1839,0
110600726659,110600726655,-4,830,2328,0
110602312455,110602312457,2,2083,2068,0
110604244461,110604244455,-6,918,2277,0
110604418743,110604418745,2,1548,1966,0
110604566731,110604566731,0,1426,1674,0
110607154059,110607154057,-2,1160,1369,0
110608577723,110608577722,-1,1333,1833,0
110609311145,110609311146,1,1135,2114,0
110612202702,110612202701,-1,1136,1874,0
110613026627,110613026626,-1,1536,2140,0
110615500885,110615500886,1,1793,2068,0
110616160573,110616160573,0,1665,1736,0
110618553017,110618553019,2,1498,1205,0
110625094865,110625094868,3,1037,454,0
110625980949,110625980950,1,1279,1440,0
110629327130,110629327129,-1,1060,1574,0
110630440958,110630440960,2,1738,1195,0
110634810269,110634810270,1,1613,1289,0
110638126522,110638126522,0,1545,2714,0
110638347869,110638347871,2,953,1477,0
110639987617,110639987618,1,2164,2293,0
110641457116,110641457118,2,1612,1668,0
110643118666,110643118669,3,1485,1337,0
110646207619,110646207621,2,1384,1727,0
110647403059,110647403058,-1,1536,2052,0
110649346765,110649346767,2,1164,1486,0
110651948428,110651948426,-2,1356,1856,0
110658378919,110658378917,-2,1212,1577,0
110658459279,110658459278,-1,1413,1659,0
110660187689,110660187689,0,1151,1700,0
110661716454,110661716454,0,910,1308,0
110663652898,110663652899,1,1855,1800,0
110665496572,110665496575,3,2035,1168,0
110666683062,110666683062,0,1121,1513,0
110668636144,110668636144,0,1134,1339,0
110669003326,110669003325,-1,1046,1693,0
110671374129,110671374121,-8,1185,1546,0
110671788244,110671788238,-6,1429,1826,0
110672490290,110672490291,1,1284,1215,0
110673246582,110673246582,0,1338,1744,0
110676326433,110676326433,0,1886,2082,0
110679319522,110679319520,-2,1198,1669,0
110680349538,110680349538,0,1376,1913,0
110681872173,110681872179,6,1921,1456,0
110684669519,110684669518,-1,1170,2408,0
110686939352,110686939353,1,1931,1962,0
110687020729,110687020729,0,1398,1487,0
110688055056,110688055055,-1,1243,1537,0
110690413611,110690413610,-1,1557,2611,0
110692205215,110692205215,0,1310,1765,0
110693255363,110693255362,-1,1183,1528,0
110694197466,110694197467,1,1167,1597,0
110696867622,110696867620,-2,1306,1504,0
110700937738,110700937738,0,1415,2292,0
110705003370,110705003370,0,980,1570,0
110706526278,110706526278,0,992,1888,0
110706624125,110706624122,-3,1345,1477,0
110707691439,110707691439,0,1257,2155,0
110708271862,110708271861,-1,1875,2372,0
110709074006,110709074007,1,1408,1386,0
110709222278,110709222280,2,1297,1821,0
110711999746,110711999745,-1,1029,1221,0
110713911146,110713911146,0,821,1648,0
110715101836,110715101838,2,1498,1583,0
110716625790,110716625791,1,1155,1462,0
110718473346,110718473347,1,1062,1272,0
110718660595,110718660595,0,1100,1559,0
110720451564,110720451562,-2,1876,2665,0
110721577019,110721577018,-1,1230,1313,0
110721866161,110721866154,-7,1083,4697,0
110722870849,110722870850,1,1602,1365,0
110726279259,110726279259,0,1357,1256,0
110726540439,110726540442,3,1401,1891,0
110726609630,110726609633,3,1189,1847,0
110731018866,110731018866,0,962,1193,0
110734776623,110734776621,-2,1287,1762,0
110735017631,110735017633,2,1977,1687,0
110736642985,110736642987,2,998,1045,0
110737098189,110737098190,1,3286,4094,0
110737797218,110737797219,1,1404,2050,0
110738878699,110738878699,0,2285,2057,0
110739670732,110739670731,-1,1240,1344,0
110740177674,110740177674,0,1232,1524,0
110742318244,110742318247,3,1203,1703,0
110746914862,110746914861,-1,2062,2460,0
110749695774,110749695775,1,1042,1458,0
110750382570,110750382570,0,1371,1393,0
110751418333,110751418334,1,1155,1392,0
110751523766,110751523767,1,1544,1710,0
110754777418,110754777420,2,1829,1530,0
110759075266,110759075266,0,1457,1906,0
110765013566,110765013567,1,2495,3185,0
110765786498,110765786491,-7,1155,3816,0
110769358786,110769358786,0,1359,2004,0
110770218027,110770218026,-1,1065,1270,0
110773547933,110773547933,0,1240,1701,0
110774498978,110774498980,2,1095,1223,0
110777362563,110777362551,-12,1249,2013,0
110780442645,110780442645,0,1290,1745,0
110780630606,110780630608,2,1115,1260,0
110784670119,110784670119,0,1150,1427,0
110785137669,110785137667,-2,1888,1870,0
110788217267,110788217267,0,955,1117,0
110796211648,110796211650,2,822,1358,0
110800893261,110800893264,3,1199,1461,0
110802800338,110802800335,-3,1159,2128,0
110803032570,110803032570,0,1367,1934,0
110804071248,110804071265,17,635,940,0
110805434261,110805434263,2,1217,1170,0
110807969591,110807969591,0,787,1138,0
110810021382,110810021382,0,1517,1035,0
110812704902,110812704904,2,1486,1668,0
110813496781,110813496782,1,1147,1195,0
110814293180,110814293178,-2,28603,10727,0
110814319062,110814319064,2,1733,1326,0
110816280365,110816280365,0,1538,1587,0
110816931382,110816931385,3,1487,1660,0
110818272870,110818272868,-2,712,937,0
110818725852,110818725851,-1,974,1152,0
110821351142,110821351142,0,1014,1441,0
110822260402,110822260403,1,1381,1696,0
110824269553,110824269554,1,995,1687,0
110826202427,110826202430,3,1678,1370,0
110827889514,110827889515,1,1500,1569,0
110828328220,110828328220,0,1858,2000,0
110832472431,110832472433,2,1377,1188,0
110833158085,110833158085,0,965,1071,0
110835073239,110835073239,0,1502,1312,0
110840084564,110840084564,0,1190,1507,0
110841409102,110841409081,-21,894,2190,0
110844062009,110844062009,0,1382,1567,0
110848941663,110848941662,-1,804,1001,0
110853863909,110853863910,1,1276,1453,0
110854627139,110854627140,1,1643,1768,0
110854752341,110854752344,3,1214,2039,0
110856907146,110856907146,0,898,1069,0
110857526737,110857526751,14,1138,1342,0
110858855370,110858855370,0,1387,2133,0
110860099195,110860099194,-1,1026,1131,0
110864446499,110864446490,-9,1443,4397,0
110864909133,110864909134,1,1465,1521,0
110866184374,110866184370,-4,2320,5653,0
110870512055,110870512058,3,1408,1755,0
110871279675,110871279675,0,27958,20745,0
110872913363,110872913362,-1,522,926,0
110875501093,110875501092,-1,1669,1745,0
110881536831,110881536830,-1,864,1812,0
110883377695,110883377695,0,1099,1816,0
110884196503,110884196504,1,2216,2213,0
110888002571,110888002573,2,851,1066,0
110888093588,110888093590,2,1093,1086,0
110889774873,110889774889,16,1598,1392,0
110890458991,110890458990,-1,1482,2020,0
110891892481,110891892482,1,1453,1716,0
110892779467,110892779469,2,1192,1776,0
110893350505,110893350521,16,306,604,0
110895511538,110895511538,0,973,1394,0
110895834966,110895834966,0,1301,1998,0
110900916031,110900916030,-1,1258,2212,0
110900994772,110900994765,-7,1121,2039,0
110907610178,110907610180,2,1211,2500,0
110910373825,110910373825,0,1453,1936,0
110914024231,110914024231,0,1344,1369,0
110917777117,110917777122,5,1041,557,0
110918116013,110918116031,18,1546,2093,0
110918404454,110918404455,1,1473,2153,0
110920212085,110920212084,-1,1191,2072,0
110926523042,110926523037,-5,1153,4103,0
110927646769,110927646770,1,1253,1190,0
110929561518,110929561523,5,4692,2022,0
110930755852,110930755854,2,1324,1624,0
110932024761,110932024762,1,1435,1926,0
110933083786,110933083790,4,1693,1399,0
110934839918,110934839925,7,9157,2236,0
110935077453,110935077455,2,1550,1758,0
110935288455,110935288455,0,1673,2584,0
110935973015,110935973014,-1,1746,2002,0
110936026168,110936026176,8,4390,1454,0
110937838395,110937838400,5,4602,2171,0
110939716908,110939716908,0,1143,1746,0
110940134966,110940134967,1,1306,1652,0
110945380375,110945380374,-1,1435,2659,0
110946731931,110946731929,-2,1042,1757,0
110948153426,110948153428,2,4157,3798,0
110948382419,110948382421,2,1902,1957,0
110949088110,110949088111,1,748,1338,0
110952643769,110952643771,2,1852,1411,0
110953551023,110953551023,0,1300,1238,0
110953621987,110953621989,2,1399,1730,0
110955135798,110955135799,1,892,930,0
110956410639,110956410639,0,1360,820,0
110957545234,110957545235,1,1775,2251,0
110958895485,110958895486,1,1802,2269,0
110959874771,110959874770,-1,1590,1910,0
110963165175,110963165177,2,1009,1626,0
110965304204,110965304206,2,1357,1637,0
110971050327,110971050328,1,786,1311,0
110971355558,110971355558,0,990,914,0
110973030635,110973030635,0,1256,1335,0
110973673902,110973673903,1,1665,2053,0
110975871445,110975871446,1,1431,2567,0
110979681287,110979681287,0,1326,1338,0
110980153975,110980153975,0,1483,1435,0
110983530521,110983530518,-3,1137,1829,0
110986180546,110986180548,2,876,1197,0
110989072571,110989072572,1,1550,1771,0
110991001380,110991001385,5,5014,2829,0
110992817956,110992817955,-1,1451,1662,0
110994951963,110994951966,3,1194,1502,0
110997293377,110997293377,0,1701,2367,0
110998544017,110998544018,1,1470,1279,0
111000869697,111000869699,2,1740,1531,0
111002363777,111002363756,-21,1174,1703,0
111005557831,111005557833,2,1276,1367,0
111008930090,111008930091,1,1048,1442,0
111010305628,111010305628,0,2100,1378,0
111010810431,111010810433,2,1685,1392,0
111016574672,111016574690,18,378,842,0
111017614742,111017614743,1,1629,2075,0
111017703647,111017703648,1,1269,1740,0
111017783079,111017783081,2,1826,2255,0
111020975955,111020975957,2,1784,1470,0
111023086918,111023086918,0,1329,1141,0
111024096536,111024096537,1,1230,1677,0
111024553710,111024553711,1,1694,2385,0
111026621438,111026621437,-1,1618,1476,0
111029586058,111029586060,2,1194,1914,0
111032445001,111032445001,0,1356,1686,0
111035088354,111035088353,-1,1139,1399,0
111040536161,111040536155,-6,1143,3574,0
111042026309,111042026310,1,860,878,0
111042664042,111042664044,2,1932,2035,0
111044265711,111044265713,2,1190,2131,0
111045372044,111045372046,2,1346,1254,0
111048481646,111048481646,0,1641,2109,0
111048802337,111048802338,1,1457,1339,0
111049728442,111049728442,0,1654,2003,0
111052532075,111052532077,2,2078,1447,0
111053305985,111053305985,0,1020,1261,0
111055235287,111055235289,2,1576,1472,0
111055785278,111055785278,0,1646,1888,0
111057402449,111057402452,3,2343,2353,0
111057515982,111057515985,3,1369,1324,0
111059813082,111059813083,1,1224,1635,0
111060906887,111060906885,-2,1431,2107,0
111062719694,111062719694,0,1521,1965,0
111063730515,111063730514,-1,742,986,0
111065636366,111065636367,1,1667,1808,0
111068556938,111068556938,0,1314,1803,0
111068932092,111068932091,-1,1449,2364,0
111070709310,111070709310,0,1843,1457,0
111071425354,111071425353,-1,1898,1551,0
111073449497,111073449496,-1,738,1203,0
111074827039,111074827039,0,1190,2014,0
111079162247,111079162249,2,1226,1512,0
111079628710,111079628709,-1,1633,1806,0
111080443005,111080442995,-10,3118,12028,0
111084170951,111084170949,-2,1634,2589,0
111087878589,111087878588,-1,896,1442,0
111097018878,111097018879,1,1008,1379,0
111102520568,111102520566,-2,1706,1730,0
111102647737,111102647741,4,1831,1235,0
111103934927,111103934929,2,750,1525,0
111107450785,111107450791,6,5742,2724,0
111107618523,111107618525,2,1604,2208,0
111109126966,111109126967,1,1576,1641,0
111112040243,111112040244,1,1569,2086,0
111112730289,111112730289,0,927,783,0
111113492213,111113492214,1,1471,1781,0
111115883446,111115883447,1,1324,1271,0
111116175587,111116175588,1,1598,2006,0
111116393251,111116393249,-2,1072,1595,0
111120798913,111120798914,1,888,1676,0
111122556184,111122556185,1,1512,2145,0
111122727095,111122727101,6,1429,917,0
111127358370,111127358371,1,1293,1506,0
111127441237,111127441221,-16,1596,6071,0
111131238952,111131238954,2,1568,1951,0
111132102810,111132102811,1,1357,2280,0
111134708241,111134708239,-2,1742,2003,0
111134764469,111134764471,2,1051,1879,0
111134852958,111134852955,-3,897,1127,0
111138185091,111138185094,3,2219,2251,0
111140736083,111140736082,-1,1385,1993,0
111140996238,111140996238,0,1455,1984,0
111141995032,111141995031,-1,1407,2021,0
111144987441,111144987442,1,1463,1268,0
111146031023,111146031022,-1,1099,1545,0
111147807471,111147807473,2,930,1421,0
111148863783,111148863762,-21,1184,1583,0
111154971406,111154971405,-1,1108,2055,0
111161170455,111161170455,0,1480,2055,0
111164815362,111164815361,-1,1816,1861,0
111164857061,111164857058,-3,1428,1961,0
111166558962,111166558963,1,1213,1553,0
111167444453,111167444454,1,1748,1546,0
111167681581,111167681599,18,1292,1409,0
111174165149,111174165163,14,14620,36626,0
111176322231,111176322233,2,1154,1169,0
111179366903,111179366902,-1,1220,1577,0
111179515121,111179515121,0,1232,1839,0
111180018090,111180018091,1,1414,1696,0
111180112220,111180112223,3,1207,955,0
111181459401,111181459402,1,1213,1887,0
111181614912,111181614913,1,1281,1728,0
111182267299,111182267298,-1,1504,1306,0
111183684188,111183684190,2,1250,1315,0
111184370591,111184370584,-7,1429,1426,0
111188792049,111188792049,0,1020,1046,0
111192333370,111192333370,0,1780,1917,0
111194447903,111194447906,3,967,1488,0
111195167010,111195167010,0,1687,2001,0
111196382218,111196382219,1,758,1217,0
111197979731,111197979731,0,1190,2039,0
111200622549,111200622550,1,2039,1269,0
111200905590,111200905591,1,1719,2158,0
111202022502,111202022498,-4,1123,2689,0
111203782299,111203782298,-1,1211,1852,0
111204144430,111204144435,5,4474,2832,0
111205138301,111205138301,0,1327,1612,0
111206081397,111206081397,0,1724,1761,0
111206209204,111206209197,-7,1249,4617,0
111212895058,111212895065,7,5836,2095,0
111213682985,111213682987,2,2217,1399,0
111215302821,111215302821,0,1852,2285,0
111216036024,111216036026,2,1167,1910,0
111226732274,111226732275,1,1387,1925,0
111227484778,111227484777,-1,2300,3021,0
111227771045,111227771045,0,1617,2022,0
111233130836,111233130842,6,3254,1871,0
111235315634,111235315635,1,1120,1312,0
111236204273,111236204274,1,4888,4986,0
111236550223,111236550226,3,1498,2017,0
111239859311,111239859313,2,1124,1265,0
111240066114,111240066114,0,1793,1519,0
111240108827,111240108804,-23,1334,1175,0
111240272175,111240272188,13,1284,1487,0
111244754730,111244754726,-4,2327,4902,0
111247155505,111247155491,-14,1735,1039,0
111252627083,111252627084,1,1164,2272,0
111257168073,111257168073,0,1902,1710,0
111257720763,111257720767,4,1626,1614,0
111258927036,111258927036,0,1390,1863,0
111265024813,111265024811,-2,1016,1637,0
111266750236,111266750237,1,1292,1947,0
111267405998,111267406003,5,4133,2346,0
111268770667,111268770666,-1,694,1547,0
111271545518,111271545520,2,1879,1644,0
111271642176,111271642176,0,1141,1972,0
111271704309,111271704310,1,1820,1637,0
111275804861,111275804851,-10,42846,9263,0
111276480136,111276480137,1,1256,1334,0
111278208875,111278208877,2,1423,1283,0
111278416970,111278416968,-2,2195,2657,0
111279552474,111279552474,0,1056,1942,0
111280576835,111280576835,0,1779,1630,0
111284060600,111284060607,7,3041,1489,0
111284288593,111284288597,4,985,1187,0
111284888192,111284888191,-1,1006,1863,0
111285291143,111285291143,0,871,1462,0
111289435037,111289435037,0,1254,2737,0
111289699762,111289699763,1,1529,1377,0
111291641022,111291641027,5,1328,1193,0
111292506005,111292506009,4,4154,3248,0
111292718005,111292718008,3,2691,2157,0
111293816788,111293816781,-7,1650,7555,0
111295472991,111295472990,-1,1054,1372,0
111295736509,111295736509,0,1444,1922,0
111295797461,111295797464,3,866,1464,0
111297776839,111297776853,14,26476,12975,0
111297823498,111297823499,1,1137,1639,0
111300102682,111300102683,1,2198,2081,0
111300947558,111300947557,-1,1386,1313,0
111303515193,111303515194,1,678,1058,0
111304865898,111304865899,1,1457,1987,0
111304955774,111304955794,20,1766,2265,0
111311101709,111311101708,-1,1118,1211,0
111311903339,111311903338,-1,1271,1591,0
111312024930,111312024931,1,1521,1453,0
111318490141,111318490142,1,1393,1783,0
111320563255,111320563256,1,1193,1722,0
111321504301,111321504297,-4,1992,7211,0
111323974221,111323974227,6,1645,934,0
111326568594,111326568596,2,1889,1687,0
111328910821,111328910825,4,1407,1307,0
111331610227,111331610225,-2,1160,1732,0
111333376897,111333376897,0,1730,1955,0
111334182069,111334182069,0,1018,1738,0
111335200658,111335200658,0,1820,2125,0
111338637882,111338637882,0,1233,1275,0
111339224075,111339224076,1,915,963,0
111339829999,111339830000,1,1211,2024,0
111342335749,111342335746,-3,1612,1956,0
111345471113,111345471107,-6,1297,2604,0
111346224482,111346224483,1,1057,1044,0
111348622417,111348622417,0,583,1122,0
111353880210,111353880210,0,1114,1713,0
111355603058,111355603057,-1,1159,1540,0
111358077982,111358077983,1,1446,1543,0
111363224648,111363224649,1,1525,2438,0
111367245457,111367245456,-1,1294,1400,0
111367951134,111367951135,1,1542,1246,0
111369277466,111369277468,2,1103,1674,0
111372507296,111372507297,1,1861,1878,0
111372690218,111372690218,0,1282,1781,0
111374698646,111374698647,1,960,1443,0
111377124933,111377124933,0,1498,2195,0
111378154438,111378154441,3,1505,1661,0
111379932830,111379932830,0,1256,1241,0
111382498539,111382498541,2,841,1240,0
111388620918,111388620918,0,881,832,0
111390268999,111390268999,0,934,1448,0
111390865945,111390865945,0,1246,1626,0
111391252415,111391252414,-1,840,1674,0
111392604506,111392604500,-6,1811,2211,0
111393116914,111393116914,0,1221,1293,0
111393527499,111393527505,6,43093,23617,0
111395692735,111395692735,0,1205,1663,0
111398466188,111398466187,-1,1197,1353,0
111416830821,111416830821,0,796,1543,0
111418788335,111418788333,-2,1556,1748,0
111418840098,111418840097,-1,1295,2008,0
111423455478,111423455477,-1,1384,1794,0
111423540057,111423540057,0,1207,2070,0
111423716237,111423716231,-6,192,3207,0
111428589597,111428589597,0,1117,1759,0
111430400176,111430400175,-1,1840,1547,0
111430587844,111430587845,1,1009,1397,0
111432516116,111432516119,3,36105,27174,0
111435071165,111435071163,-2,1147,1373,0
111441323350,111441323350,0,1213,1519,0
111442723938,111442723936,-2,1421,1685,0
111446275781,111446275782,1,1115,1553,0
111448099997,111448099990,-7,22537,14260,0
111453121609,111453121610,1,1321,1346,0
111457350783,111457350788,5,2509,1232,0
111459441427,111459441428,1,1206,1814,0
111461315452,111461315453,1,1004,1656,0
111461457998,111461457999,1,1271,1484,0
111463378350,111463378350,0,1864,1237,0
111463588845,111463588846,1,1123,1699,0
111464642878,111464642879,1,1613,1997,0
111467834719,111467834721,2,1287,1847,0
111472288734,111472288735,1,1446,1204,0
111475519342,111475519343,1,796,682,0
111475924070,111475924069,-1,2072,1696,0
111476252402,111476252399,-3,1108,1371,0
111480504849,111480504850,1,1353,1913,0
111481889686,111481889686,0,1219,1699,0
111484951513,111484951513,0,1536,2064,0
111489635833,111489635842,9,1316,2068,0
111489949177,111489949177,0,954,1880,0
111490822268,111490822267,-1,1642,1737,0
111491093851,111491093851,0,1627,1932,0
111491747272,111491747269,-3,1081,2133,0
111495360625,111495360622,-3,23936,14684,0
111499626434,111499626435,1,2160,2369,0
111503454646,111503454636,-10,1143,1179,0
111506028774,111506028777,3,1685,1673,0
111506503063,111506503061,-2,1529,1797,0
111508566849,111508566846,-3,1679,2504,0
111509551915,111509551918,3,1342,1732,0
111511101636,111511101623,-13,185,502,0
111512171822,111512171817,-5,706,1759,0
111513653395,111513653396,1,1060,1344,0
111515072715,111515072715,0,724,1149,0
111517002367,111517002367,0,752,1183,0
111519955758,111519955759,1,1621,1623,0
111520906453,111520906453,0,1310,1860,0
111521143646,111521143645,-1,1758,1864,0
111521860705,111521860706,1,1953,1319,0
111522642405,111522642405,0,1282,1123,0
111523044442,111523044442,0,1099,1393,0
111523752238,111523752238,0,1163,1718,0
111524219070,111524219071,1,1131,1697,0
111524887198,111524887199,1,1946,1964,0
111529916970,111529916971,1,1700,1922,0
111530278486,111530278485,-1,1421,1625,0
111531741215,111531741216,1,1242,1460,0
111532490975,111532490977,2,1513,1612,0
111532868370,111532868370,0,1057,1560,0
111533740054,111533740053,-1,2172,2066,0
111534056773,111534056773,0,1568,2106,0
111536002374,111536002373,-1,1148,1955,0
111537243580,111537243566,-14,961,1642,0
111537636286,111537636283,-3,1003,1427,0
111539634159,111539634159,0,753,1296,0
111540779139,111540779137,-2,1456,1744,0
111545086242,111545086244,2,1257,2023,0
111545628086,111545628084,-2,5955,10521,0
111548543070,111548543069,-1,1269,1376,0
111548931806,111548931806,0,990,1695,0
111549363686,111549363706,20,1842,1782,0
111550150459,111550150458,-1,1202,1891,0
111552007937,111552007938,1,1304,1427,0
111553552202,111553552203,1,1440,2524,0
111554959006,111554959005,-1,1220,1812,0
111555886058,111555886058,0,990,1286,0
111556432143,111556432136,-7,24503,8842,0
111557103967,111557103966,-1,1272,1511,0
111560198286,111560198287,1,1751,1468,0
111560838598,111560838598,0,930,1617,0
111564952759,111564952742,-17,1144,1759,0
111569353205,111569353203,-2,804,1276,0
111569832077,111569832066,-11,1112,1583,0
111570485722,111570485725,3,1086,1549,0
111571543282,111571543278,-4,767,1516,0
111576737746,111576737747,1,1615,2248,0
111578215386,111578215386,0,1534,1435,0
111582547084,111582547086,2,1823,1052,0
111584597479,111584597479,0,1451,1235,0
111585185533,111585185536,3,1743,1778,0
111585257118,111585257126,8,2947,942,0
111586504553,111586504539,-14,2691,1011,0
111592082130,111592082132,2,1225,1903,0
111594784294,111594784294,0,1353,1590,0
111599820571,111599820571,0,668,512,0
111600971179,111600971179,0,1293,1500,0
111601664761,111601664759,-2,1493,1597,0
111606279520,111606279521,1,1290,2053,0
111615490708,111615490709,1,1771,1794,0
111616229050,111616229049,-1,1197,1544,0
111616511323,111616511325,2,919,1268,0
111625104497,111625104500,3,1332,1778,0
111625184907,111625184907,0,1356,1649,0
111626226697,111626226693,-4,1532,1979,0
111627110501,111627110501,0,1332,1017,0
111629800809,111629800809,0,1798,1804,0
111633957799,111633957801,2,1677,1902,0
111635421434,111635421435,1,1493,1566,0
111635831203,111635831203,0,1478,1478,0
111636367693,111636367694,1,1294,1692,0
111638435954,111638435955,1,1393,1533,0
111639752099,111639752099,0,865,950,0
111642770431,111642770431,0,1151,1267,0
111643067189,111643067188,-1,1612,1790,0
111644877866,111644877866,0,1255,1563,0
111645864548,111645864547,-1,1376,1696,0
111646916928,111646916926,-2,996,1875,0
111652781764,111652781751,-13,7169,991,0
111653213780,111653213781,1,1103,1425,0
111656371493,111656371491,-2,1458,2483,0
111659571983,111659571986,3,2057,1439,0
111661113687,111661113689,2,761,940,0
111662099233,111662099234,1,1385,1908,0
111666905492,111666905515,23,1058,1343,0
111668514340,111668514340,0,1177,1803,0
111676897305,111676897305,0,1944,2260,0
111685658269,111685658269,0,1316,1580,0
111688757266,111688757266,0,1217,1576,0
111691020034,111691020036,2,1537,1759,0
111693222452,111693222453,1,1851,1734,0
111694596175,111694596174,-1,1735,1752,0
111694842297,111694842298,1,857,1860,0
111701937781,111701937781,0,1213,1961,0
111702090982,111702090979,-3,1120,1970,0
111710453969,111710453969,0,1630,1305,0
111711180755,111711180754,-1,2147,1794,0
111714698799,111714698798,-1,1177,1755,0
111715834966,111715834971,5,2185,997,0
111718173306,111718173309,3,926,1412,0
111718473653,111718473654,1,1274,1645,0
111718925215,111718925215,0,825,816,0
111719738181,111719738180,-1,1364,1709,0
111726011674,111726011676,2,1337,1733,0
111727071239,111727071238,-1,1012,992,0
111730546281,111730546282,1,1792,2049,0
111730828402,111730828402,0,1248,1881,0
111735178975,111735178975,0,1065,2308,0
111736394476,111736394474,-2,1206,1330,0
111739685759,111739685757,-2,1145,1964,0
111743010449,111743010449,0,2135,1994,0
111744555726,111744555727,1,1330,1767,0
111744644761,111744644763,2,1719,1580,0
111745626370,111745626370,0,1173,1462,0
111746180329,111746180330,1,1034,1469,0
111748366610,111748366611,1,1387,1552,0
111748912138,111748912139,1,1436,2239,0
111749709582,111749709580,-2,1305,2544,0
111750150674,111750150674,0,1553,2137,0
111752613809,111752613813,4,1156,1160,0
111756447673,111756447665,-8,917,3129,0
111758588170,111758588174,4,2294,1697,0
111758784970,111758784968,-2,1755,2098,0
111760295562,111760295562,0,1416,1422,0
111761367683,111761367682,-1,972,1388,0
111762316056,111762316058,2,1350,1438,0
111764670610,111764670614,4,1066,1390,0
111769572743,111769572743,0,1775,1820,0
111769721927,111769721929,2,1503,1695,0
111769996566,111769996568,2,1778,2105,0
111772554782,111772554788,6,3121,1806,0
111775846808,111775846809,1,1762,1977,0
111779154786,111779154786,0,1397,2004,0
111781141303,111781141305,2,1736,1429,0
111782161543,111782161545,2,745,2260,0
111782674110,111782674109,-1,1577,2297,0
111782774838,111782774857,19,1234,2123,0
111786263811,111786263812,1,1116,1632,0
111790858868,111790858869,1,1424,1469,0
111792075016,111792075014,-2,1339,2021,0
111792639134,111792639133,-1,1732,2008,0
111792670438,111792670437,-1,1593,1873,0
111793479478,111793479479,1,1397,1794,0
111795777058,111795777058,0,1614,1687,0
111797396014,111797396015,1,2011,1826,0
111799035071,111799035071,0,1297,1445,0
111802859266,111802859269,3,1411,1928,0
111805639766,111805639764,-2,1080,1962,0
111808017621,111808017620,-1,934,1590,0
111809295431,111809295433,2,1091,1280,0
111811332737,111811332736,-1,1302,1713,0
111815267977,111815267980,3,2248,1483,0
111817268958,111817268959,1,985,1306,0
111820893926,111820893927,1,1938,1476,0
111824426234,111824426235,1,1677,1558,0
111826000891,111826000891,0,1416,1901,0
111827433902,111827433902,0,1768,1575,0
111836685990,111836685990,0,1323,1420,0
111836869139,111836869138,-1,1297,1458,0
111837144829,111837144829,0,1083,214,0
111840445493,111840445491,-2,3665,6634,0
111841217050,111841217052,2,1324,2299,0
111842605769,111842605770,1,1722,1602,0
111844543877,111844543871,-6,846,688,0
111852781848,111852781847,-1,1271,1779,0
111857047802,111857047802,0,1038,1690,0
111860272350,111860272350,0,1143,1692,0
111861906779,111861906778,-1,1443,1203,0
111863565284,111863565284,0,1328,965,0
111864117103,111864117109,6,1793,1137,0
111864909909,111864909912,3,1439,1516,0
111866612189,111866612189,0,2250,1798,0
111867348873,111867348874,1,1137,1522,0
111870366969,111870366971,2,1586,1982,0
111873456598,111873456598,0,1682,1943,0
111873647926,111873647922,-4,47278,19395,0
111875567613,111875567614,1,1942,1999,0
111879274753,111879274755,2,1594,1795,0
111886216895,111886216893,-2,1271,1534,0
111887018116,111887018118,2,1347,1880,0
111888426234,111888426234,0,1168,1664,0
111889530026,111889530026,0,1317,2069,0
111893080603,111893080605,2,1555,1047,0
111894448591,111894448589,-2,1208,2430,0
111895946811,111895946811,0,952,1164,0
111896243109,111896243098,-11,274,541,0
111897463831,111897463833,2,1343,1392,0
111898170546,111898170557,11,848,957,0
111898937440,111898937437,-3,1380,1172,0
111899438323,111899438325,2,1537,1477,0
111899754725,111899754725,0,1318,1383,0
111899903670,111899903679,9,766,257,0
111905681650,111905681652,2,1227,1398,0
111911812114,111911812113,-1,1295,1686,0
111914889483,111914889483,0,1047,1231,0
111914964006,111914964005,-1,1157,1677,0
111918005027,111918005014,-13,1274,1436,0
111918432441,111918432438,-3,841,1556,0
111919111132,111919111133,1,1518,1435,0
111920429839,111920429841,2,1221,1224,0
111921720930,111921720930,0,2017,2100,0
111924730922,111924730923,1,1323,1760,0
111925148576,111925148575,-1,1789,2086,0
111926444012,111926444011,-1,1185,1841,0
111928765106,111928765098,-8,1440,9855,0
111928914433,111928914433,0,1540,2022,0
111929696518,111929696517,-1,973,1086,0
111934954122,111934954129,7,7318,6021,0
111935471377,111935471378,1,1542,2258,0
111942815857,111942815858,1,1244,1620,0
111948501762,111948501761,-1,1252,1614,0
111948794423,111948794425,2,1102,1019,0
111952083411,111952083414,3,1203,1223,0
111953562373,111953562373,0,1733,2017,0
111955067838,111955067838,0,919,977,0
111955603227,111955603226,-1,1235,1468,0
111958921837,111958921838,1,1826,1740,0
111959311466,111959311467,1,1307,1350,0
111960103743,111960103744,1,1536,1301,0
111960383117,111960383115,-2,898,977,0
111963537970,111963537970,0,2018,1568,0
111967275358,111967275359,1,1936,1249,0
111967681486,111967681486,0,1491,1633,0
111970556058,111970556060,2,1178,1962,0
111972194258,111972194258,0,906,1139,0
111972430074,111972430073,-1,1041,1630,0
111974113464,111974113465,1,1520,2030,0
111975556963,111975556963,0,1646,1811,0
111979864238,111979864238,0,1383,2271,0
111985862182,111985862183,1,768,793,0
111986270378,111986270381,3,1263,1489,0
111986508482,111986508482,0,1502,1725,0
111990004152,111990004153,1,1509,2026,0
111990786547,111990786548,1,926,1780,0
111991805834,111991805834,0,1747,1536,0
111992983155,111992983154,-1,1002,1459,0
111993425902,111993425902,0,1323,1182,0
111994054879,111994054881,2,1449,1868,0
111994194042,111994194043,1,1087,1191,0
111996108935,111996108934,-1,1479,1768,0
111998844545,111998844553,8,12109,31577,0
112000967439,112000967438,-1,880,1180,0
112001079270,112001079254,-16,452,420,0
112006819071,112006819062,-9,54,1187,0
112008197735,112008197734,-1,1338,1553,0
112008848566,112008848565,-1,1143,2310,0
112009911881,112009911882,1,1528,1435,0
112012340178,112012340179,1,1933,1841,0
112013741886,112013741886,0,1401,1635,0
112017548458,112017548458,0,858,1208,0
112018326317,112018326319,2,1374,1828,0
112020818230,112020818232,2,1725,1810,0
112021505163,112021505166,3,1217,1699,0
112023413280,112023413281,1,1156,2122,0
112025665275,112025665275,0,1140,996,0
112026082790,112026082787,-3,1385,2009,0
112026566939,112026566940,1,1495,2205,0
112029232518,112029232519,1,1500,1365,0
112029825030,112029825033,3,1722,1842,0
112036087652,112036087650,-2,768,1187,0
112038729332,112038729330,-2,1617,1872,0
112038764448,112038764430,-18,1186,2364,0
112041677570,112041677571,1,1139,2003,0
112043312891,112043312890,-1,1348,1697,0
112044108283,112044108283,0,1852,1568,0
112047238275,112047238279,4,553,786,0
112048157378,112048157378,0,1422,1853,0
112049689653,112049689654,1,1464,1087,0
112050461962,112050461958,-4,1731,3530,0
112051167302,112051167302,0,1389,1967,0
112052065235,112052065235,0,1088,1357,0
112057218012,112057218005,-7,2380,6486,0
112057526012,112057526015,3,1594,1494,0
112057991662,112057991663,1,1013,852,0
112060572473,112060572474,1,1507,1484,0
112061017318,112061017319,1,1131,1526,0
112062254216,112062254217,1,1550,1645,0
112063323574,112063323577,3,1649,1114,0
112064210191,112064210194,3,3581,2769,0
112064993174,112064993174,0,860,1758,0
112069786115,112069786114,-1,1232,1334,0
112074214153,112074214153,0,1348,1974,0
112077162497,112077162497,0,1359,1175,0
112079715285,112079715284,-1,1420,1540,0
112080897926,112080897936,10,1296,1651,0
112081570803,112081570804,1,1903,2250,0
112084063653,112084063652,-1,1799,2358,0
112085666433,112085666430,-3,983,2506,0
112086705779,112086705779,0,944,1120,0
112088314754,112088314755,1,1396,1746,0
112092832344,112092832347,3,2207,1265,0
112092884494,112092884494,0,1078,960,0
112095377292,112095377293,1,1442,1682,0
112095502500,112095502501,1,817,768,0
112097183818,112097183818,0,2010,1788,0
112098621890,112098621891,1,1456,2382,0
112102017010,112102017008,-2,1841,2343,0
112105096121,112105096121,0,1318,1595,0
112105995295,112105995291,-4,923,1273,0
112112969758,112112969757,-1,1033,1209,0
112116972246,112116972245,-1,1415,1309,0
112117537042,112117537042,0,1475,1630,0
112117944050,112117944052,2,1291,1539,0
112120508520,112120508521,1,1373,1407,0
112123320409,112123320415,6,6056,2432,0
112123781090,112123781090,0,1362,1157,0
112124647657,112124647660,3,1440,1652,0
112124731191,112124731191,0,716,1427,0
112126700088,112126700092,4,6378,22111,0
112127066782,112127066783,1,887,1034,0
112134324111,112134324110,-1,1170,1447,0
112135146528,112135146534,6,6655,2053,0
112137749518,112137749517,-1,1397,1706,0
112143562836,112143562835,-1,1797,1819,0
112144440238,112144440236,-2,1584,2236,0
112146793329,112146793330,1,2119,1479,0
112147171543,112147171543,0,1814,2320,0
112148206135,112148206136,1,1772,2087,0
112149807758,112149807757,-1,1392,1354,0
112150015669,112150015671,2,1716,1699,0
112151981202,112151981201,-1,1347,1793,0
112152813946,112152813946,0,1052,1564,0
112154296164,112154296165,1,1230,2185,0
112154990854,112154990855,1,1917,2192,0
112159984345,112159984346,1,1666,2425,0
112160150673,112160150671,-2,1432,1800,0
112160604954,112160604953,-1,1965,2704,0
112161642404,112161642411,7,1157,678,0
112162530515,112162530514,-1,1563,1021,0
112164707836,112164707835,-1,1712,2413,0
112168670840,112168670840,0,1486,1432,0
112169020954,112169020953,-1,1293,1888,0
112170703195,112170703195,0,1066,1398,0
112173929498,112173929500,2,1356,1590,0
112178764685,112178764687,2,1096,1788,0
112179079664,112179079662,-2,1329,1851,0
112180364273,112180364271,-2,1894,1771,0
112186005174,112186005174,0,870,1525,0
112187120810,112187120789,-21,1386,1644,0
112188672202,112188672201,-1,1384,2242,0
112188697715,112188697718,3,1079,969,0
112188711279,112188711278,-1,74,166,0
750599937895077,750599937895077,0,589835,917515,0
750599937895077,750599937895077,0,786443,851978,0
750599937895077,750599937895077,0,917513,983053,0
750599937895077,750599937895077,0,589837,327684,0
750599937895077,750599937895077,0,393221,131077,0
750599937895077,750599937895077,0,1431655766,1431655766,0
112189054705,112189054706,1,1546,1785,0
112190254726,112190254725,-1,1246,2201,0
112190487241,112190487242,1,1662,2193,0
112190727447,112190727451,4,1821,1590,0
112192347722,112192347717,-5,1013,1327,0
112192713984,112192714003,19,1225,1328,0
112194656337,112194656339,2,1089,1570,0
112194970675,112194970675,0,1281,1544,0
112196875485,112196875487,2,1199,1560,0
112203437779,112203437773,-6,645,3349,0
112204155605,112204155606,1,1258,1500,0
112206757740,112206757742,2,2178,1571,0
112208050206,112208050207,1,1546,2290,0
112208187900,112208187902,2,992,1465,0
112210622321,112210622322,1,1335,1612,0
112216259546,112216259547,1,1356,1713,0
112216527683,112216527676,-7,1011,1393,0
112219102475,112219102475,0,1157,2003,0
112225615873,112225615874,1,1659,1928,0
112226492647,112226492647,0,1731,2476,0
112227541479,112227541475,-4,966,2150,0
112234650082,112234650079,-3,1107,1318,0
112243659851,112243659849,-2,1273,2211,0
112243913986,112243913984,-2,884,1712,0
112245106206,112245106207,1,1590,1671,0
112246663374,112246663373,-1,1444,1567,0
112247652767,112247652768,1,922,706,0
112248478191,112248478194,3,1129,1484,0
112255873129,112255873127,-2,1347,1660,0
112257672307,112257672305,-2,1456,1558,0
112257732582,112257732584,2,1203,1845,0
112259045777,112259045777,0,1450,1481,0
112261026241,112261026242,1,1050,1453,0
112262717861,112262717863,2,2051,2094,0
112265618311,112265618314,3,2666,1405,0
112266633791,112266633793,2,1287,2502,0
112274010247,112274010246,-1,1352,2266,0
112275014346,112275014348,2,1433,1715,0
112275456867,112275456866,-1,1000,1540,0
112277778607,112277778606,-1,1888,2356,0
112279372522,112279372522,0,997,2291,0
112286003298,112286003301,3,1278,2030,0
112286688966,112286688968,2,1244,1587,0
112288738982,112288738983,1,1895,2104,0
112291755120,112291755121,1,1370,1396,0
112298919219,112298919219,0,1910,2047,0
112299694119,112299694120,1,1593,1659,0
112300342515,112300342515,0,1141,1238,0
112302564660,112302564656,-4,122133,52693,0
112306154182,112306154181,-1,1516,1565,0
112308315430,112308315430,0,1354,1774,0
112309238263,112309238261,-2,932,1666,0
112310381689,112310381690,1,2001,2214,0
112311034558,112311034556,-2,1283,1661,0
112311703199,112311703199,0,1032,1026,0
112311873115,112311873113,-2,809,1484,0
112314638011,112314638014,3,1166,1594,0
112314884550,112314884546,-4,1199,1237,0
112316526738,112316526738,0,1118,1500,0
112317045338,112317045339,1,1288,1758,0
112319122364,112319122365,1,1180,1675,0
112323197158,112323197158,0,1707,2101,0
112328533594,112328533597,3,1302,1359,0
112329169221,112329169221,0,1328,1446,0
112331541791,112331541791,0,1219,809,0
112336077022,112336077021,-1,1152,1671,0
112339368041,112339368041,0,1583,1710,0
112341067770,112341067770,0,1574,2162,0
112345513507,112345513509,2,1773,2382,0
112345929733,112345929734,1,1070,1656,0
112349698581,112349698581,0,1785,2192,0
112354747346,112354747345,-1,1146,1788,0
112355038835,112355038836,1,1673,1986,0
112356400376,112356400376,0,1287,1494,0
112365249618,112365249620,2,1384,1694,0
112371557130,112371557127,-3,1400,2192,0
112372492811,112372492811,0,1568,1533,0
112376038978,112376038979,1,987,978,0
112376419350,112376419350,0,1748,2061,0
112380216298,112380216299,1,1139,937,0
112381983434,112381983433,-1,1343,2065,0
112384167012,112384167009,-3,2266,4741,0
112388796121,112388796121,0,1061,1301,0
112389675002,112389675002,0,1295,1471,0
112391327714,112391327714,0,1022,1616,0
112392214240,112392214243,3,955,1394,0
112397228059,112397228059,0,1409,1994,0
112397585857,112397585857,0,1468,2031,0
112399440390,112399440389,-1,1751,2150,0
112399752314,112399752313,-1,1374,1012,0
112400307994,112400307993,-1,1286,1327,0
112402208854,112402208854,0,1099,1213,0
112402692650,112402692654,4,4235,2892,0
112402871523,112402871517,-6,1518,5770,0
112402955574,112402955575,1,1410,1581,0
112405924697,112405924694,-3,1481,2366,0
112418311937,112418311938,1,1729,1930,0
112420935539,112420935539,0,728,1437,0
112421951412,112421951411,-1,1493,1966,0
112424343483,112424343483,0,1588,1810,0
112427453053,112427453053,0,1126,1435,0
112430528163,112430528166,3,1441,1415,0
112432901170,112432901178,8,1446,1848,0
112434222464,112434222466,2,961,1491,0
112435879745,112435879746,1,1355,1026,0
112438654133,112438654118,-15,1108,971,0
112440567547,112440567547,0,1209,1914,0
112442773756,112442773754,-2,691,2113,0
112443509608,112443509606,-2,1687,2203,0
112444042443,112444042441,-2,1084,2372,0
112447619453,112447619454,1,1719,1219,0
112452882597,112452882598,1,1292,1337,0
112462527201,112462527201,0,1723,1793,0
112465389621,112465389622,1,1062,965,0
112467123949,112467123949,0,1530,1338,0
112468895138,112468895139,1,1745,1325,0
112476363930,112476363928,-2,995,1537,0
112478043391,112478043398,7,1658,501,0
112478254478,112478254477,-1,580,336,0
112485432685,112485432685,0,1218,1381,0
112485745117,112485745119,2,1421,1471,0
112490729666,112490729666,0,1326,2125,0
112495245638,112495245638,0,831,1242,0
112496299990,112496299990,0,1368,2208,0
112497417621,112497417622,1,1637,1292,0
112497535330,112497535326,-4,1006,2147,0
112497960726,112497960704,-22,1195,1520,0
112501638855,112501638856,1,1010,1353,0
112503352971,112503352971,0,1226,1539,0
112505467610,112505467610,0,1483,1690,0
112505518717,112505518701,-16,1663,811,0
112506300515,112506300515,0,1118,839,0
112506527404,112506527405,1,1205,1241,0
112510137401,112510137405,4,2037,1595,0
112514117279,112514117280,1,1668,2142,0
112516178685,112516178682,-3,1227,1535,0
112518907149,112518907150,1,1319,1804,0
112519905161,112519905163,2,1532,1423,0
112523179186,112523179185,-1,1442,1948,0
112525296515,112525296515,0,1166,1778,0
112526019870,112526019873,3,1432,1598,0
112526596434,112526596412,-22,1460,1549,0
112527721878,112527721878,0,1611,1737,0
112529366266,112529366269,3,1672,1665,0
112532143565,112532143564,-1,1665,1411,0
112534278172,112534278172,0,1175,1443,0
112535738998,112535738999,1,1004,1306,0
112537050182,112537050182,0,1118,1806,0
112537159968,112537159967,-1,1156,1737,0
112537560538,112537560539,1,1307,1992,0
112539132156,112539132157,1,1624,1774,0
112539664659,112539664659,0,2001,2172,0
112545277894,112545277894,0,1445,2034,0
112546074671,112546074672,1,1430,2145,0
112548014683,112548014685,2,1368,1725,0
112550974297,112550974295,-2,1274,1614,0
112553345360,112553345367,7,6773,3015,0
112553958323,112553958322,-1,1834,2314,0
112554103817,112554103817,0,1374,1753,0
112556308853,112556308854,1,1305,1690,0
112557422681,112557422679,-2,1786,1780,0
112557884143,112557884142,-1,1323,1314,0
112564217137,112564217138,1,1125,1923,0
112567593691,112567593693,2,1617,1651,0
112568808705,112568808705,0,1786,1901,0
112569917938,112569917945,7,5195,2709,0
112573529621,112573529643,22,699,990,0
112575374637,112575374637,0,1226,2096,0
112578772459,112578772459,0,1004,1612,0
112582047503,112582047501,-2,1844,2238,0
112582982783,112582982782,-1,1121,1796,0
112583403954,112583403954,0,1563,1435,0
112584280027,112584280028,1,1100,1877,0
112584533701,112584533701,0,1558,1513,0
112585064065,112585064063,-2,1474,2568,0
112587356258,112587356258,0,1141,2122,0
112588626950,112588626949,-1,1056,2281,0
112588663598,112588663578,-20,1241,1232,0
112589079633,112589079634,1,887,1756,0
112589139994,112589139994,0,1234,1661,0
112589800780,112589800780,0,1294,1981,0
112592452077,112592452077,0,988,1669,0
112592945205,112592945223,18,492,1049,0
112593824886,112593824887,1,1382,1428,0
112595114423,112595114423,0,1247,2157,0
112599788098,112599788097,-1,1345,2242,0
112601542478,112601542479,1,1558,1735,0
112601688699,112601688701,2,1405,1783,0
112602651255,112602651249,-6,1062,3204,0
112604183642,112604183642,0,1624,1772,0
112605195671,112605195671,0,1458,1889,0
112609726907,112609726904,-3,986,1908,0
112612074666,112612074666,0,1157,1807,0
112615002686,112615002687,1,1236,1081,0
112616193302,112616193302,0,1105,2041,0
112616532325,112616532325,0,1679,1431,0
112617450478,112617450481,3,1626,1438,0
112618521849,112618521857,8,4954,1355,0
112620645616,112620645617,1,1087,1320,0
112620744174,112620744181,7,1035,1644,0
112621930442,112621930441,-1,810,1249,0
112623651298,112623651297,-1,564,1124,0
112625509217,112625509217,0,1434,1601,0
112626223886,112626223887,1,1670,1954,0
112629620229,112629620230,1,1207,1208,0
112629679251,112629679248,-3,1193,2084,0
112629761318,112629761318,0,1966,1613,0
112633123453,112633123451,-2,1336,1895,0
112634643092,112634643092,0,1151,2182,0
112635450082,112635450081,-1,1552,1544,0
112635873496,112635873495,-1,1146,1911,0
112637102832,112637102833,1,1791,1242,0
112637184535,112637184549,14,955,1543,0
112638596786,112638596786,0,1289,2172,0
112641673379,112641673381,2,1684,1543,0
112641888339,112641888349,10,1103,1284,0
112643090089,112643090110,21,149,1624,0
112644194106,112644194105,-1,1604,1893,0
112645245733,112645245737,4,1383,1055,0
112646968281,112646968281,0,1465,1524,0
112647710394,112647710394,0,1124,1429,0
112653806007,112653806008,1,1250,1664,0
112657124695,112657124696,1,1048,1938,0
112658801630,112658801638,8,4063,1907,0
112660057387,112660057390,3,327,121,0
112662562238,112662562237,-1,1169,1458,0
112662990774,112662990774,0,1146,1603,0
112665579285,112665579287,2,1672,1946,0
112668856449,112668856450,1,1353,1625,0
112671007142,112671007141,-1,808,1079,0
112672381684,112672381683,-1,2002,2256,0
112677303682,112677303681,-1,1458,1907,0
112678390863,112678390863,0,1123,1522,0
112679281135,112679281134,-1,1225,1415,0
112682589871,112682589874,3,1197,1779,0
112684206222,112684206226,4,7656,4036,0
112686478152,112686478151,-1,1277,1851,0
112689816975,112689816975,0,561,1245,0
112690216415,112690216415,0,1117,1538,0
112692917089,112692917094,5,5104,2836,0
112698716613,112698716606,-7,1474,6541,0
112703451598,112703451599,1,1204,2026,0
112704436167,112704436170,3,1922,1329,0
112704687457,112704687471,14,1092,1109,0
112707891690,112707891689,-1,1392,1582,0
112708558608,112708558610,2,1331,1412,0
112710233059,112710233058,-1,1136,1786,0
112710327446,112710327445,-1,30764,56303,0
112711317105,112711317107,2,1614,1485,0
112714591435,112714591436,1,2039,1921,0
112715068122,112715068122,0,911,1092,0
112718859357,112718859358,1,1801,2733,0
112721840994,112721840994,0,1483,1494,0
112722059662,112722059661,-1,1119,1554,0
112722399999,112722399996,-3,1858,3433,0
112726688401,112726688401,0,1802,1584,0
112727269778,112727269778,0,1264,1447,0
112731434240,112731434241,1,1614,2097,0
112731736999,112731736999,0,794,583,0
112732035101,112732035104,3,1587,1665,0
112735148071,112735148070,-1,1401,1520,0
112735840306,112735840305,-1,1029,1434,0
112737525232,112737525232,0,1519,2134,0
112738923855,112738923855,0,1147,2561,0
112740542966,112740542968,2,2089,1677,0
112741756560,112741756561,1,1190,1445,0
112742914550,112742914552,2,1712,2659,0
112747767069,112747767069,0,1345,1474,0
112748407773,112748407774,1,1175,1936,0
112748736214,112748736205,-9,1168,3518,0
112749002159,112749002160,1,1371,1709,0
112757773247,112757773250,3,1760,1938,0
112758878690,112758878690,0,1072,1683,0
112758942822,112758942822,0,1692,1408,0
112759134342,112759134342,0,1232,1474,0
112759431717,112759431718,1,1509,2120,0
112759663966,112759663966,0,1417,1507,0
112760049735,112760049740,5,3485,1138,0
112762335864,112762335863,-1,1727,2342,0
112763920664,112763920657,-7,1913,9291,0
112765131975,112765131974,-1,1931,1640,0
112769325430,112769325433,3,1700,2030,0
112773713219,112773713221,2,1615,2470,0
112778051013,112778051013,0,1811,1767,0
112778701622,112778701625,3,1761,2064,0
112780047539,112780047539,0,2115,2177,0
112783925929,112783925929,0,1148,1528,0
112785077370,112785077370,0,1543,2114,0
112786257502,112786257498,-4,1343,2492,0
112788670286,112788670286,0,672,1609,0
112789729762,112789729754,-8,849,8254,0
112791815399,112791815397,-2,1057,1832,0
112791949075,112791949074,-1,1491,2393,0
112792604174,112792604172,-2,1107,1680,0
112794208610,112794208611,1,1357,1269,0
112794247753,112794247757,4,4415,2750,0
112794697802,112794697802,0,1167,1445,0
112797610443,112797610444,1,1372,1379,0
112798772666,112798772663,-3,1381,2029,0
112803103078,112803103078,0,1722,1561,0
112805247149,112805247145,-4,1249,3156,0
112806122861,112806122862,1,1726,1625,0
112808112778,112808112778,0,1950,2804,0
112809086051,112809086053,2,1326,1671,0
112809128806,112809128807,1,1255,1757,0
112810764218,112810764218,0,1843,2202,0
112811544545,112811544545,0,1416,1778,0
112814659828,112814659830,2,1669,1107,0
112817839348,112817839345,-3,1169,1923,0
112818497568,112818497568,0,1200,1259,0
112821840073,112821840073,0,1589,2175,0
112822920134,112822920134,0,1375,2436,0
112823209185,112823209186,1,1590,1805,0
112823640936,112823640935,-1,1001,1092,0
112824097539,112824097539,0,1158,2311,0
112824373772,112824373770,-2,1243,1434,0
112826127435,112826127438,3,961,1847,0
112828589693,112828589693,0,1144,1843,0
112829739556,112829739557,1,1342,1555,0
112831885726,112831885726,0,1295,1645,0
112836155529,112836155531,2,2056,1943,0
112836629062,112836629043,-19,1319,1972,0
112837808422,112837808422,0,1113,1715,0
112844567853,112844567855,2,1467,1807,0
112844737576,112844737576,0,1399,1314,0
112846935786,112846935787,1,1503,1968,0
112850285358,112850285359,1,2404,2202,0
112852950114,112852950114,0,1662,1690,0
112854268051,112854268052,1,1387,1694,0
112856198562,112856198563,1,1204,1267,0
112861017792,112861017791,-1,1676,2011,0
112862210237,112862210238,1,1934,2341,0
112863183579,112863183579,0,836,1243,0
112865975938,112865975938,0,1125,1521,0
112868414124,112868414121,-3,915,1285,0
112873024897,112873024895,-2,897,3660,0
112876114425,112876114432,7,4684,1499,0
112876324781,112876324782,1,1173,1680,0
112877794418,112877794418,0,2042,2165,0
112880178910,112880178910,0,1219,1700,0
112884369062,112884369061,-1,1248,1484,0
112889362637,112889362637,0,1104,1164,0
112892024306,112892024306,0,982,2000,0
112894550022,112894550025,3,970,977,0
112896056221,112896056225,4,1631,1610,0
112899097713,112899097713,0,1299,1743,0
112901312862,112901312865,3,1593,1263,0
112903084076,112903084072,-4,22880,13675,0
112908393393,112908393391,-2,36598,21558,0
112910389862,112910389864,2,1701,1813,0
112914553123,112914553117,-6,1225,5605,0
112915510894,112915510895,1,1440,1693,0
112915538046,112915538047,1,1174,1893,0
112920298740,112920298739,-1,1356,1482,0
112922393592,112922393593,1,1226,1623,0
112925192678,112925192680,2,2011,1991,0
112928870453,112928870453,0,1416,1719,0
112934833306,112934833304,-2,817,1658,0
112937612306,112937612311,5,8407,3336,0
112938993842,112938993846,4,2356,1574,0
112940772953,112940772954,1,1279,1567,0
112940991911,112940991913,2,1695,2050,0
112943045382,112943045382,0,1182,1570,0
112946010173,112946010173,0,1177,1828,0
112947492586,112947492586,0,1594,2455,0
112947755641,112947755643,2,1423,1628,0
112950332447,112950332445,-2,1184,1621,0
112951030186,112951030187,1,2055,1374,0
112951683282,112951683291,9,1427,1408,0
112955780862,112955780862,0,2093,1964,0
112955855837,112955855837,0,1548,1535,0
112956108595,112956108602,7,4334,1168,0
112959472194,112959472209,15,1912,1099,0
112962487221,112962487221,0,1358,1276,0
112963006809,112963006809,0,1109,1388,0
112966716468,112966716469,1,1254,1345,0
112971709022,112971709022,0,2000,1800,0
112972582794,112972582794,0,1623,2674,0
112973818075,112973818076,1,1243,1630,0
112977300686,112977300687,1,1247,1004,0
112978466338,112978466339,1,944,1764,0
112982454650,112982454650,0,1197,2234,0
112983412297,112983412296,-1,1373,1686,0
112983906958,112983906954,-4,797,1429,0
112992483774,112992483778,4,1473,1181,0
112992659600,112992659601,1,1068,1264,0
112992869953,112992869951,-2,1519,2260,0
112994502267,112994502267,0,1426,976,0
113002312173,113002312172,-1,1466,1480,0
113003682194,113003682195,1,1465,2518,0
113006259210,113006259212,2,1543,1125,0
113007676485,113007676484,-1,2162,2545,0
113008983036,113008983037,1,2210,2092,0
113010365798,113010365798,0,1849,1775,0
113010795727,113010795727,0,2000,2739,0
113011131222,113011131222,0,1063,1731,0
113011357939,113011357937,-2,1277,1749,0
113011695111,113011695093,-18,1226,1531,0
113015034498,113015034498,0,1225,1624,0
113015451683,113015451687,4,2031,1785,0
113015536912,113015536917,5,3579,1625,0
113018811051,113018811050,-1,970,1809,0
113019488350,113019488349,-1,797,1429,0
113022656991,113022656990,-1,625,1024,0
113025418369,113025418367,-2,1286,1768,0
113027803370,113027803373,3,2204,1705,0
113028383702,113028383703,1,1492,1747,0
113031413902,113031413902,0,1083,1803,0
113034346978,113034346979,1,1565,1792,0
113036441270,113036441270,0,800,1599,0
113045974762,113045974761,-1,991,1725,0
113047518986,113047518985,-1,1365,1742,0
113048262611,113048262613,2,1477,1799,0
113050000972,113050000972,0,619,1126,0
113052531219,113052531221,2,1816,1898,0
113053126869,113053126869,0,1361,1834,0
113054587478,113054587477,-1,1331,819,0
113060525193,113060525195,2,1183,863,0
113061288841,113061288842,1,1086,1374,0
113062759477,113062759478,1,1202,1508,0
113062942337,113062942337,0,2106,2091,0
113068193545,113068193546,1,1515,2045,0
113068256879,113068256881,2,1146,1693,0
113070739954,113070739954,0,1222,1862,0
113072068721,113072068721,0,1249,1773,0
113073659346,113073659347,1,1195,1674,0
113073861110,113073861088,-22,494,11057,0
113074195942,113074195943,1,995,1064,0
113076742978,113076742978,0,1685,2527,0
113080798566,113080798565,-1,1978,2124,0
113086586986,113086586985,-1,1299,1728,0
113087381365,113087381359,-6,2979,11924,0
113088687702,113088687702,0,1831,1495,0
113089391378,113089391378,0,1470,1770,0
113091574442,113091574441,-1,1213,2174,0
113091622473,113091622474,1,1170,1756,0
113091912732,113091912730,-2,1963,2593,0
113092389605,113092389605,0,930,1289,0
113097023050,113097023050,0,2338,1939,0
113097111489,113097111493,4,1613,973,0
113100521028,113100521023,-5,785,3633,0
113101946595,113101946609,14,1212,1080,0
113104023710,113104023710,0,2911,4114,0
113107130943,113107130942,-1,1628,1353,0
113115489563,113115489565,2,1241,1676,0
113120566381,113120566382,1,1515,2188,0
113122143985,113122143984,-1,1393,1503,0
113122292951,113122292950,-1,1849,2199,0
113122850070,113122850071,1,1099,1159,0
113123865953,113123865975,22,1420,1639,0
113124063682,113124063680,-2,1311,2842,0
113124461256,113124461262,6,3016,1470,0
113124954040,113124954041,1,1430,2130,0
113130174421,113130174420,-1,1263,1860,0
113130471263,113130471264,1,1398,1641,0
113133880178,113133880180,2,1424,2042,0
113137625594,113137625594,0,1172,1412,0
113137703690,113137703693,3,1249,1745,0
113141824521,113141824516,-5,1016,2536,0
113143195903,113143195903,0,1166,1651,0
113143664964,113143664966,2,1784,2263,0
113147317705,113147317705,0,1056,1330,0
113149339926,113149339925,-1,1459,1368,0
113152112022,113152112021,-1,1136,1991,0
113157580595,113157580597,2,1904,1603,0
113160036082,113160036083,1,39303,32624,0
113160140577,113160140578,1,1552,1391,0
113161266218,113161266222,4,1959,1953,0
113163291527,113163291526,-1,1148,1493,0
113164407566,113164407567,1,1442,1655,0
113165325023,113165325022,-1,1347,1326,0
113166304517,113166304513,-4,1071,2733,0
113168520366,113168520366,0,1277,1633,0
113171623046,113171623045,-1,1055,1746,0
113176764136,113176764135,-1,2031,2245,0
113177054406,113177054407,1,1286,2238,0
113177696593,113177696601,8,2817,1359,0
113187585401,113187585401,0,1052,2046,0
113188250646,113188250643,-3,1155,1721,0
113188873980,113188873981,1,1683,1717,0
113191790485,113191790485,0,1139,1639,0
113192980100,113192980101,1,1434,1567,0
113195712622,113195712622,0,1262,1859,0
113197739404,113197739404,0,1324,1205,0
113198652934,113198652935,1,1732,2243,0
113204859927,113204859927,0,1344,1695,0
113208166157,113208166163,6,2657,1198,0
113211921386,113211921386,0,974,1394,0
113214516612,113214516614,2,1421,1666,0
113216459281,113216459283,2,1394,1199,0
113218421798,113218421801,3,1592,1273,0
113221607832,113221607832,0,1384,1657,0
113221672815,113221672817,2,1246,1652,0
113227925339,113227925341,2,1120,1691,0
113234107737,113234107737,0,1270,1313,0
113235939763,113235939766,3,1369,1104,0
113237393570,113237393572,2,1076,1466,0
113239584393,113239584392,-1,1390,2272,0
113241601348,113241601349,1,2178,2330,0
113242135259,113242135263,4,1291,1112,0
113246003727,113246003726,-1,1044,1568,0
113248089744,113248089742,-2,1615,2115,0
113251185605,113251185605,0,1066,1173,0
113253220138,113253220140,2,628,703,0
113255006862,113255006863,1,1032,746,0
113255196905,113255196906,1,1928,1531,0
113261853925,113261853929,4,1505,1405,0
113261891499,113261891499,0,969,1425,0
113263713797,113263713798,1,1068,1057,0
113264417113,113264417118,5,1646,1240,0
113265843394,113265843394,0,1251,1305,0
113269787470,113269787470,0,1779,1860,0
113271106685,113271106686,1,1465,1666,0
113271255839,113271255842,3,1543,1618,0
113276256267,113276256268,1,1310,1870,0
113279841411,113279841413,2,1501,1949,0
113281823972,113281823972,0,1082,1515,0
113283115212,113283115213,1,1542,1367,0
113284206398,113284206398,0,1337,1532,0
113291537845,113291537845,0,1319,1893,0
113291588510,113291588510,0,1598,1694,0
113293285183,113293285182,-1,1216,1230,0
113299358417,113299358418,1,36416,42562,0
113301371982,113301371985,3,2199,1661,0
113302095710,113302095709,-1,1311,1524,0
113309029037,113309029036,-1,1419,1453,0
113310720533,113310720538,5,1708,1202,0
113311803523,113311803525,2,2024,1724,0
113317700710,113317700713,3,1266,1946,0
113319198628,113319198626,-2,1637,1630,0
113329250398,113329250398,0,1039,1370,0
113331354173,113331354174,1,1091,1425,0
113331591826,113331591828,2,988,1045,0
113333441858,113333441858,0,1296,1704,0
113335439617,113335439618,1,1337,1449,0
113335649874,113335649873,-1,1640,2603,0
113335957642,113335957642,0,1052,1427,0
113335998083,113335998085,2,2016,1882,0
113336698070,113336698071,1,1963,1917,0
113343560839,113343560838,-1,1221,2141,0
113345090920,113345090921,1,1401,1715,0
113345977939,113345977939,0,2008,1971,0
113352842323,113352842323,0,1458,1217,0
113353218018,113353218017,-1,1839,2229,0
113357827913,113357827914,1,1403,2026,0
113364372087,113364372085,-2,982,1810,0
113365434629,113365434629,0,1848,1486,0
113366642786,113366642786,0,1770,2068,0
113369329519,113369329523,4,1570,1110,0
113370037550,113370037550,0,1618,2059,0
113370943255,113370943258,3,1370,1602,0
113374491403,113374491403,0,1201,1245,0
113375962486,113375962487,1,1412,2084,0
113380006163,113380006165,2,876,1714,0
113387313934,113387313935,1,1661,1353,0
113390688799,113390688801,2,1349,1953,0
113391065441,113391065441,0,1417,1358,0
113395636738,113395636738,0,1364,1220,0
113397185848,113397185852,4,1179,1465,0
113397269736,113397269754,18,1648,1631,0
113399531302,113399531302,0,903,1880,0
113407470671,113407470670,-1,975,1371,0
113410244737,113410244734,-3,1203,1563,0
113411256828,113411256831,3,1911,1904,0
113411660833,113411660833,0,1757,2317,0
113411802681,113411802681,0,1197,2137,0
113413034714,113413034715,1,1278,1752,0
113416989218,113416989218,0,1463,1787,0
113417320115,113417320117,2,1131,1297,0
113417590532,113417590535,3,1778,1155,0
113419778993,113419778993,0,1949,1509,0
113419908235,113419908236,1,2176,2120,0
113420140201,113420140201,0,1322,2081,0
113422659425,113422659426,1,1672,1783,0
113423267107,113423267107,0,1617,2569,0
113429117772,113429117773,1,1096,1529,0
113429338363,113429338364,1,1369,1633,0
113431943494,113431943498,4,1419,1305,0
113438158308,113438158307,-1,1626,1855,0
113442348448,113442348451,3,1633,1429,0
113442406122,113442406122,0,2060,2545,0
113445246474,113445246473,-1,1475,2214,0
113445844094,113445844095,1,1425,1505,0
113446741563,113446741563,0,1049,1676,0
113446857902,113446857905,3,1624,2011,0
113447353421,113447353421,0,1112,1708,0
113448607931,113448607931,0,882,958,0
113448992578,113448992579,1,1427,1522,0
113449988035,113449988033,-2,1036,1653,0
113451032313,113451032311,-2,1086,1677,0
113451110106,113451110114,8,4533,2065,0
113453063526,113453063526,0,1389,1417,0
113455034256,113455034255,-1,1228,773,0
113457864472,113457864474,2,2129,2260,0
113458759091,113458759091,0,1191,2277,0
113461152189,113461152189,0,1877,1972,0
113462910987,113462910987,0,1562,1606,0
113464203855,113464203849,-6,786,4157,0
113466261898,113466261899,1,1443,2419,0
113468533097,113468533088,-9,228,5108,0
113469957883,113469957887,4,1455,1869,0
113470986782,113470986784,2,1464,1050,0
113471100583,113471100583,0,833,1691,0
113472770810,113472770813,3,1151,2334,0
113477739646,113477739647,1,968,1475,0
113482811826,113482811828,2,1926,2342,0
113487875753,113487875753,0,1329,1763,0
113489666264,113489666266,2,1739,1813,0
113499807113,113499807113,0,1503,1381,0
113503487800,113503487800,0,1331,1446,0
113506892074,113506892074,0,1481,1986,0
113508195933,113508195933,0,1358,1258,0
113516244938,113516244935,-3,1023,3150,0
113516419555,113516419555,0,846,1414,0
113516947750,113516947750,0,1250,1368,0
113518397803,113518397803,0,1482,1413,0
113520087586,113520087590,4,8704,6262,0
113520402377,113520402378,1,1268,2278,0
113521160328,113521160329,1,2023,1409,0
113521248979,113521248979,0,887,2013,0
113521516288,113521516291,3,1716,1442,0
113523780241,113523780241,0,1227,2058,0
113525137270,113525137263,-7,1021,4372,0
113528262370,113528262368,-2,1247,1774,0
113529006759,113529006759,0,1343,1387,0
113533519213,113533519212,-1,1549,1883,0
113533830129,113533830130,1,1449,1596,0
113534569311,113534569312,1,839,1277,0
113537537587,113537537587,0,1621,1912,0
113538345678,113538345678,0,1127,1048,0
113540157555,113540157555,0,1399,1588,0
113541685744,113541685741,-3,1426,2155,0
113543314620,113543314620,0,1223,1664,0
113543440346,113543440345,-1,1681,1951,0
113544279838,113544279845,7,8071,2409,0
113544891386,113544891387,1,1709,1793,0
113545870426,113545870426,0,1243,1562,0
113546155239,113546155239,0,1373,1777,0
113546416086,113546416089,3,1021,1640,0
113547789560,113547789561,1,1957,2475,0
113549294359,113549294358,-1,918,1180,0
113554385555,113554385557,2,1045,1486,0
113554685550,113554685550,0,920,1647,0
113556520353,113556520354,1,785,1397,0
113557728882,113557728883,1,1652,2151,0
113560522641,113560522642,1,1201,1456,0
113561240800,113561240809,9,10840,30389,0
113561525153,113561525149,-4,1541,4989,0
113568693659,113568693650,-9,1486,1518,0
113569397771,113569397773,2,1592,1408,0
113570231039,113570231041,2,1348,1263,0
113572033115,113572033117,2,1276,1519,0
113572252234,113572252234,0,1006,1179,0
113572334498,113572334478,-20,1577,1628,0
113574907964,113574907966,2,1276,938,0
113579888205,113579888207,2,1658,1472,0
113583083696,113583083697,1,1962,2250,0
113587543721,113587543723,2,989,992,0
113588775996,113588775980,-16,1010,1684,0
113589280994,113589280995,1,1396,1808,0
113591622116,113591622109,-7,1395,1673,0
113593436355,113593436357,2,1539,2074,0
113599996563,113599996578,15,789,1134,0
113601027731,113601027733,2,1540,1547,0
113601834825,113601834826,1,915,1496,0
113602912676,113602912675,-1,1177,1969,0
113603944667,113603944666,-1,1103,1966,0
113605110439,113605110440,1,1023,1417,0
113605469935,113605469934,-1,857,1055,0
113606295311,113606295310,-1,1446,1685,0
113607374553,113607374555,2,1596,1798,0
113608664460,113608664457,-3,821,1572,0
113608832523,113608832529,6,2146,1256,0
113609156917,113609156919,2,1377,1248,0
113610460837,113610460838,1,1848,2172,0
113611706645,113611706647,2,1372,1291,0
113618047747,113618047747,0,1344,2264,0
113619720786,113619720786,0,1471,1146,0
113623966145,113623966144,-1,1569,1772,0
113624778451,113624778454,3,1704,1032,0
113627188670,113627188669,-1,1427,2701,0
113628997334,113628997334,0,1073,2409,0
113629972671,113629972648,-23,958,2801,0
113630120007,113630120007,0,949,1091,0
113632465523,113632465523,0,1719,2214,0
113634700515,113634700507,-8,920,1403,0
113636115127,113636115127,0,681,640,0
113639291690,113639291690,0,1245,1296,0
113641230452,113641230453,1,1466,1511,0
113641581836,113641581838,2,1437,1613,0
113645673577,113645673572,-5,1098,2897,0
113646717631,113646717632,1,1129,1396,0
113647899786,113647899781,-5,1451,1751,0
113652297733,113652297736,3,1497,1819,0
113653474684,113653474685,1,1413,1919,0
113655396914,113655396914,0,1718,2180,0
113655423598,113655423601,3,1888,1597,0
113658726234,113658726237,3,1406,2019,0
113661425907,113661425908,1,1400,1343,0
113664287746,113664287746,0,1880,1807,0
113665722277,113665722278,1,1498,1848,0
113667165102,113667165102,0,1331,1542,0
113667477847,113667477826,-21,1178,1338,0
113668499750,113668499751,1,884,1116,0
113669449759,113669449760,1,1198,1915,0
113670265822,113670265824,2,1828,1343,0
113672511285,113672511285,0,1612,1553,0
113672919178,113672919176,-2,1348,2784,0
113675770015,113675770017,2,3648,4205,0
113680585943,113680585943,0,1958,1580,0
113682846108,113682846109,1,1560,1763,0
113683393095,113683393082,-13,1063,1672,0
113684726378,113684726378,0,1727,1950,0
113691994513,113691994515,2,1498,1861,0
113692089331,113692089334,3,1332,1470,0
113694603921,113694603921,0,1050,2130,0
113697740495,113697740495,0,1314,1653,0
113700737882,113700737881,-1,1084,1601,0
113705467225,113705467227,2,1734,1394,0
113707264310,113707264310,0,1461,2146,0
113710675951,113710675953,2,2110,2059,0
113711515873,113711515873,0,1457,1668,0
113713156613,113713156612,-1,2023,2120,0
113718360658,113718360659,1,1277,1838,0
113718600571,113718600570,-1,1086,1058,0
113718923913,113718923914,1,1376,1843,0
113719468362,113719468365,3,1742,1737,0
113719653467,113719653468,1,917,1469,0
113724576357,113724576357,0,1525,1569,0
113728134875,113728134881,6,2446,1249,0
113728869541,113728869539,-2,1445,2244,0
113729406701,113729406702,1,2379,2152,0
113731994734,113731994735,1,1428,1620,0
113733090333,113733090330,-3,1886,3073,0
113734775857,113734775856,-1,1295,1753,0
113736946484,113736946478,-6,1279,2590,0
113740615719,113740615703,-16,1222,912,0
113743349226,113743349227,1,1897,1743,0
113757426082,113757426081,-1,1551,2551,0
113758929173,113758929175,2,1319,1129,0
113759951938,113759951941,3,2967,1094,0
113763826910,113763826911,1,1546,1966,0
113765071713,113765071713,0,1647,1833,0
113765853835,113765853837,2,1220,1731,0
113768697656,113768697657,1,1315,1967,0
113768802127,113768802106,-21,1410,1439,0
113777626448,113777626449,1,1757,1530,0
113783530182,113783530182,0,1759,1781,0
113784086347,113784086350,3,1272,1373,0
113785552185,113785552189,4,2320,2137,0
113785675827,113785675827,0,856,1982,0
113785839585,113785839585,0,1073,1611,0
113792825446,113792825443,-3,1396,2277,0
113793041231,113793041227,-4,1132,2717,0
113794876597,113794876598,1,2076,1658,0
113801015528,113801015527,-1,1267,1331,0
113806310038,113806310043,5,936,1069,0
113807714413,113807714414,1,1329,1271,0
113809821973,113809821973,0,1653,1747,0
113811166904,113811166906,2,1302,1525,0
113813250201,113813250200,-1,944,1736,0
113817198033,113817198035,2,1380,936,0
113818931723,113818931726,3,1437,1264,0
113824818383,113824818383,0,1481,1777,0
113825248926,113825248927,1,1055,1004,0
113826328979,113826328978,-1,1485,2113,0
113828946441,113828946443,2,1196,1435,0
113829369165,113829369166,1,1235,1654,0
113829505519,113829505521,2,1366,1972,0
113830977346,113830977349,3,1170,1299,0
113840677531,113840677527,-4,1430,4325,0
113841590840,113841590839,-1,1487,2211,0
113841873562,113841873561,-1,1180,1438,0
113846358546,113846358547,1,1632,1753,0
113850147824,113850147826,2,1174,1898,0
113854518818,113854518819,1,1474,1587,0
113854910201,113854910201,0,1765,2009,0
113856521333,113856521331,-2,1324,1601,0
113857820370,113857820369,-1,1254,1176,0
113862253407,113862253407,0,1301,1345,0
113870958019,113870958018,-1,1430,1486,0
113875314509,113875314510,1,1510,1565,0
113879740478,113879740479,1,1093,982,0
113879829015,113879828993,-22,1252,1771,0
113882358014,113882358015,1,1295,1358,0
113882688737,113882688738,1,1671,1637,0
113883298981,113883298983,2,1308,1750,0
113885184481,113885184481,0,1758,2120,0
113885810505,113885810508,3,1123,1555,0
113886485437,113886485439,2,858,1514,0
113887932132,113887932133,1,1063,1232,0
113889600583,113889600583,0,1401,1640,0
113892348579,113892348579,0,1709,2164,0
113897653177,113897653177,0,1154,2095,0
113900853686,113900853686,0,1349,1181,0
113902700101,113902700102,1,1824,2464,0
113903391988,113903391987,-1,2214,2445,0
113903873374,113903873373,-1,1154,1662,0
113906116348,113906116350,2,1202,1878,0
113912950162,113912950162,0,1276,1624,0
113914367998,113914367999,1,1238,1324,0
113914498863,113914498861,-2,1323,1246,0
113916731182,113916731179,-3,1697,2487,0
113919275066,113919275066,0,1263,1970,0
113921869567,113921869568,1,1595,1898,0
113924390501,113924390504,3,1173,1503,0
113926854870,113926854867,-3,1409,2117,0
113927760450,113927760451,1,1393,1356,0
113929007303,113929007306,3,1473,1737,0
113936193165,113936193167,2,1747,1498,0
113938862818,113938862823,5,893,1328,0
113939429581,113939429566,-15,1194,1733,0
113939771924,113939771924,0,1504,1765,0
113940834337,113940834339,2,1762,1690,0
113940984656,113940984657,1,1788,2105,0
113942792194,113942792197,3,1095,1142,0
113943466242,113943466242,0,1411,1857,0
113944794001,113944794002,1,1187,1545,0
113945730727,113945730727,0,875,1197,0
113948676280,113948676278,-2,1393,1034,0
113949402185,113949402188,3,1455,2073,0
113953897062,113953897063,1,1308,1631,0
113954626341,113954626346,5,1271,1330,0
113957053573,113957053573,0,1749,2426,0
113959915548,113959915550,2,1100,1531,0
113963000046,113963000046,0,1254,1843,0
113965214560,113965214560,0,1192,1775,0
113966782677,113966782680,3,1218,1709,0
113967746594,113967746595,1,1121,978,0
113969733062,113969733065,3,1246,1924,0
113969785237,113969785237,0,1245,1540,0
113973677662,113973677662,0,1190,2002,0
113974895375,113974895378,3,1232,1968,0
113978436590,113978436589,-1,1292,1435,0
113978975586,113978975585,-1,1353,1326,0
113980677338,113980677337,-1,1481,2151,0
113980827982,113980827982,0,1592,2232,0
113981858208,113981858209,1,1633,2353,0
113983444931,113983444929,-2,1492,2535,0
113983589578,113983589578,0,874,1824,0
113985631675,113985631677,2,1811,1610,0
113986775753,113986775734,-19,1603,1582,0
113987816486,113987816487,1,1500,1712,0
113990398361,113990398362,1,1967,2107,0
113994642361,113994642361,0,1573,1522,0
113996471170,113996471170,0,1204,2000,0
113998535519,113998535521,2,2666,2463,0
114001100604,114001100605,1,2025,2078,0
114006409924,114006409926,2,2229,1584,0
114007496922,114007496922,0,1216,1896,0
114008423914,114008423915,1,1737,1671,0
114013159166,114013159171,5,2383,1389,0
114015361391,114015361390,-1,889,1403,0
114017950967,114017950965,-2,841,1474,0
114023227168,114023227175,7,3063,1430,0
114024406855,114024406858,3,1572,1807,0
114026121201,114026121197,-4,18421,12030,0
114030554107,114030554103,-4,1100,1972,0
114031024158,114031024158,0,1587,1744,0
114033405182,114033405182,0,1365,1410,0
114037116395,114037116396,1,946,1192,0
114038541990,114038541986,-4,7720,15267,0
114040302162,114040302162,0,1511,2117,0
114043060994,114043060996,2,1152,1167,0
114044668124,114044668126,2,1566,1194,0
114045146745,114045146742,-3,1505,1943,0
114050155226,114050155228,2,1437,1549,0
114050774072,114050774080,8,194,1147,0
114051485826,114051485827,1,1326,1680,0
114054827307,114054827306,-1,1470,1634,0
114056465468,114056465466,-2,1362,2386,0
114058053727,114058053729,2,1876,2056,0
114059626937,114059626941,4,2903,2311,0
114060725313,114060725316,3,928,1266,0
114062455911,114062455910,-1,1010,1469,0
114064475966,114064475969,3,1362,1245,0
114072392214,114072392209,-5,4109,10693,0
114073362315,114073362314,-1,1458,2386,0
114075413599,114075413602,3,1107,1559,0
114077003545,114077003545,0,1901,1892,0
114078435075,114078435076,1,891,1962,0
114080504670,114080504669,-1,1388,2534,0
114082400626,114082400619,-7,2221,6749,0
114091408399,114091408399,0,1059,1025,0
114097059752,114097059753,1,1711,1562,0
114098939750,114098939750,0,1560,1402,0
114100343193,114100343199,6,4565,2507,0
114101521562,114101521561,-1,1372,1737,0
114101829550,114101829550,0,822,1540,0
114103165923,114103165925,2,1794,1991,0
114106293480,114106293483,3,1699,2228,0
114107253113,114107253114,1,1807,1692,0
114111032281,114111032279,-2,1224,1454,0
114112057867,114112057865,-2,1676,2205,0
114112949789,114112949789,0,1349,2415,0
114113153963,114113153962,-1,1230,1286,0
114115479932,114115479937,5,2503,1670,0
114118995366,114118995366,0,1270,1890,0
114120824127,114120824128,1,1412,1585,0
114122816775,114122816774,-1,677,1032,0
114127813586,114127813587,1,1741,2018,0
114129386088,114129386089,1,1199,1526,0
114129453634,114129453634,0,945,1110,0
114131927390,114131927389,-1,608,1020,0
114134312395,114134312410,15,1273,1660,0
114135045867,114135045861,-6,1045,4760,0
114135464870,114135464873,3,1367,1722,0
114135514879,114135514881,2,1156,1863,0
114135917222,114135917223,1,1527,1343,0
114136173585,114136173586,1,1607,1793,0
114137412195,114137412196,1,1379,1886,0
114142686311,114142686310,-1,1392,2522,0
114144069264,114144069265,1,1811,1387,0
114144727430,114144727427,-3,815,1336,0
114150766926,114150766927,1,1313,1801,0
114152112998,114152112998,0,1095,2120,0
114157168523,114157168523,0,1122,1608,0
114158134797,114158134797,0,846,1780,0
114161930628,114161930626,-2,1564,1677,0
114162107047,114162107046,-1,1545,2353,0
114163539714,114163539717,3,1248,1742,0
114165287338,114165287338,0,1385,1505,0
114166697884,114166697882,-2,1112,1260,0
114167150862,114167150863,1,1408,1143,0
114168740026,114168740026,0,889,1313,0
114170104061,114170104061,0,1513,1280,0
114170823810,114170823812,2,1811,1476,0
114176557042,114176557043,1,1514,1488,0
114177681515,114177681514,-1,1237,1507,0
114178588150,114178588150,0,1123,1600,0
114183190958,114183190959,1,1795,1921,0
114185957562,114185957560,-2,1048,1697,0
114186268330,114186268331,1,1050,1930,0
114187300347,114187300365,18,1055,201,0
114188666241,114188666239,-2,1557,1208,0
114189313341,114189313342,1,1378,1624,0
114192153180,114192153183,3,1425,1478,0
114192467841,114192467841,0,1637,2513,0
114194714712,114194714712,0,1440,1382,0
114197018871,114197018870,-1,784,1653,0
114198715863,114198715873,10,12884,41972,0
114199158674,114199158692,18,17594,43760,0
114199581182,114199581182,0,756,765,0
114201662259,114201662258,-1,1477,2522,0
114201801305,114201801305,0,1561,1361,0
114204964610,114204964613,3,2023,1451,0
114205951304,114205951301,-3,1557,1668,0
114210061057,114210061058,1,1535,2280,0
114213297827,114213297825,-2,992,2070,0
114213860713,114213860715,2,1578,1416,0
114214775330,114214775332,2,879,967,0
114216122169,114216122171,2,2108,1955,0
114217388413,114217388414,1,831,779,0
114217786459,114217786460,1,1590,1673,0
114217972670,114217972667,-3,923,1505,0
114219313341,114219313342,1,1624,1496,0
114220037882,114220037882,0,1268,1544,0
114227028190,114227028191,1,1341,1608,0
114227452431,114227452430,-1,1664,1755,0
114228003599,114228003606,7,3448,1146,0
114228411781,114228411780,-1,1618,2280,0
114229817684,114229817685,1,1487,1805,0
114231645070,114231645070,0,1550,1691,0
114233924590,114233924592,2,1281,1714,0
114235773395,114235773397,2,1832,1285,0
114236303132,114236303134,2,969,1513,0
114238372390,114238372389,-1,1273,2275,0
114238418524,114238418525,1,1412,1293,0
114238700450,114238700450,0,938,1156,0
114240663331,114240663333,2,954,1380,0
114243615835,114243615833,-2,1211,1162,0
114244438350,114244438349,-1,901,1606,0
114246625290,114246625293,3,1379,1829,0
114248752677,114248752678,1,1315,1931,0
114249484437,114249484439,2,1110,1455,0
114251575601,114251575609,8,1671,1057,0
114253029350,114253029350,0,1352,1281,0
114254421934,114254421935,1,986,1070,0
114256921475,114256921476,1,1356,1390,0
114257997774,114257997774,0,1804,1964,0
114259333774,114259333777,3,11085,10610,0
114261915959,114261915961,2,1817,2514,0
114263543339,114263543337,-2,1256,2025,0
114263602441,114263602442,1,1477,1772,0
114268825561,114268825562,1,1497,1753,0
114271970634,114271970634,0,1380,2284,0
114274390317,114274390318,1,1343,1741,0
114275716726,114275716726,0,1419,1030,0
114279797681,114279797681,0,1230,1807,0
114280102422,114280102421,-1,1425,1854,0
114284873139,114284873142,3,2500,1512,0
114286529887,114286529888,1,1117,1498,0
114289446009,114289446010,1,1590,2052,0
114290152219,114290152221,2,1401,2124,0
114292031620,114292031624,4,1492,1453,0
114292377919,114292377899,-20,37,1676,0
114293422062,114293422061,-1,1200,1384,0
114295995824,114295995822,-2,1601,1946,0
114297864007,114297864007,0,1752,2281,0
114297899059,114297899065,6,2229,1622,0
114300582399,114300582399,0,1117,1656,0
114302114306,114302114307,1,1559,1317,0
114302224870,114302224854,-16,1110,1550,0
114308357333,114308357334,1,1831,1578,0
114309072873,114309072873,0,1572,2352,0
114309403904,114309403903,-1,1204,1790,0
114311607291,114311607290,-1,1703,1953,0
114312074912,114312074912,0,1339,1927,0
114317348790,114317348786,-4,1552,2655,0
114318771859,114318771859,0,1574,1755,0
114318823845,114318823846,1,1222,1478,0
114321453378,114321453380,2,1789,2032,0
114323811587,114323811586,-1,1233,862,0
114323851822,114323851831,9,670,1851,0
114324935094,114324935094,0,1355,1971,0
114326666950,114326666949,-1,942,1498,0
114328805037,114328805038,1,1215,2119,0
114330108759,114330108759,0,1257,1576,0
114331445545,114331445546,1,1560,2125,0
114335055990,114335055991,1,895,1611,0
114337809587,114337809587,0,1490,1981,0
114339720678,114339720678,0,1036,1758,0
114340591242,114340591242,0,1230,1621,0
114341540935,114341540941,6,1119,1493,0
114341880770,114341880770,0,1286,2162,0
114342811190,114342811191,1,1610,1838,0
114344536845,114344536845,0,1621,1922,0
114345096422,114345096422,0,1316,1229,0
114345269127,114345269127,0,1434,1788,0
114346116381,114346116382,1,1366,1341,0
114347419678,114347419697,19,1296,2404,0
114352024845,114352024846,1,1391,1412,0
114354177854,114354177854,0,1213,1675,0
114355625751,114355625751,0,1055,662,0
114355869822,114355869825,3,1657,1468,0
114356689890,114356689897,7,6039,1623,0
114357766253,114357766251,-2,922,1746,0
114368139074,114368139074,0,1369,1727,0
114368800637,114368800637,0,1345,1870,0
114369206086,114369206089,3,1038,1415,0
114370696334,114370696334,0,1089,1581,0
114370873578,114370873578,0,1011,1547,0
114372165158,114372165158,0,1780,1373,0
114372669513,114372669513,0,1547,1599,0
114373418787,114373418790,3,1143,1474,0
114374348891,114374348893,2,1231,1483,0
114378952051,114378952049,-2,1125,1688,0
114379962755,114379962756,1,1198,2271,0
114381521849,114381521849,0,1482,1956,0
114383048293,114383048294,1,1623,1272,0
114386425998,114386425994,-4,2328,6760,0
114386648311,114386648314,3,1344,1821,0
114386948042,114386948043,1,1899,1823,0
114387733365,114387733371,6,2877,1053,0
114393533878,114393533881,3,1100,1589,0
114393795277,114393795283,6,3397,1430,0
114398446994,114398446994,0,1387,1892,0
114399495645,114399495644,-1,1215,1703,0
114401792558,114401792561,3,1454,1425,0
114402450670,114402450673,3,1542,2341,0
114403618358,114403618357,-1,1328,1903,0
114410885969,114410885971,2,1346,1608,0
114411738853,114411738863,10,92,1244,0
114418390269,114418390267,-2,1188,1764,0
114420442609,114420442610,1,886,1620,0
114423259278,114423259277,-1,1557,2060,0
114424857831,114424857834,3,1138,1440,0
114424904432,114424904431,-1,1459,2037,0
114425038385,114425038386,1,902,951,0
114428481533,114428481533,0,958,1154,0
114430674832,114430674833,1,1100,1553,0
114431940946,114431940946,0,1365,1124,0
114435137183,114435137183,0,1252,2171,0
114435387157,114435387155,-2,1359,1639,0
114435824297,114435824298,1,1562,1772,0
114436294590,114436294591,1,1527,1672,0
114437259920,114437259915,-5,112,12103,0
114437663485,114437663483,-2,1075,1310,0
114437721354,114437721354,0,1323,1514,0
114446708331,114446708331,0,1831,2194,0
114447016421,114447016423,2,1399,2211,0
114447858397,114447858398,1,2049,1976,0
114448148842,114448148841,-1,895,1373,0
114448734674,114448734678,4,1705,1135,0
114449786220,114449786222,2,2385,1619,0
114452158979,114452158978,-1,1046,1373,0
114454959294,114454959295,1,1228,1181,0
114456594889,114456594889,0,1983,1909,0
114457180141,114457180141,0,1060,1163,0
114461954454,114461954455,1,1463,2005,0
114462814588,114462814595,7,3841,2060,0
114463228530,114463228530,0,1583,1880,0
114471731378,114471731378,0,1825,2107,0
114475723331,114475723334,3,19109,38718,0
114478177238,114478177237,-1,2401,4139,0
114479761772,114479761773,1,2780,2581,0
114480404655,114480404655,0,1680,1884,0
114481061486,114481061486,0,1464,1509,0
114482368054,114482368058,4,3661,1388,0
114487037034,114487037034,0,965,1697,0
114490208233,114490208231,-2,1060,1851,0
114490235680,114490235677,-3,6127,14505,0
114495046507,114495046507,0,1255,1411,0
114495975097,114495975097,0,1718,1677,0
114498354777,114498354777,0,1591,1972,0
114499898386,114499898388,2,2722,2867,0
114500718017,114500718037,20,1455,1591,0
114500986672,114500986670,-2,1625,1626,0
114504388081,114504388078,-3,2052,4102,0
114506712598,114506712597,-1,1168,1256,0
114508477558,114508477558,0,1906,1398,0
114508989873,114508989874,1,2022,1923,0
114509015026,114509015025,-1,1653,2098,0
114509564562,114509564562,0,1049,1834,0
114511717028,114511717032,4,15350,21678,0
114512140615,114512140618,3,1284,1973,0
114514681294,114514681293,-1,1359,1542,0
114519305446,114519305446,0,1243,1500,0
114522409170,114522409172,2,1445,2486,0
114524079031,114524079032,1,999,1621,0
114524441318,114524441321,3,1479,1707,0
114525218685,114525218678,-7,1309,7988,0
114527761302,114527761306,4,1233,1384,0
114530433003,114530433002,-1,1732,2025,0
114531763342,114531763341,-1,1721,1928,0
114532082841,114532082834,-7,1454,5275,0
114536923351,114536923352,1,1298,1717,0
114537326103,114537326098,-5,1080,2464,0
114541140633,114541140630,-3,1114,1835,0
114549841706,114549841707,1,1512,1962,0
114550235060,114550235062,2,1630,1436,0
114551432465,114551432467,2,1018,1033,0
114553286330,114553286330,0,1092,1329,0
114559878546,114559878546,0,1723,2110,0
114560480441,114560480442,1,1260,1238,0
114561670492,114561670492,0,1255,1252,0
114566150383,114566150383,0,1296,2210,0
114567937397,114567937398,1,1093,1827,0
114572488978,114572488979,1,1343,2087,0
114573711241,114573711242,1,1680,2023,0
114576150420,114576150418,-2,956,1430,0
114578130402,114578130404,2,1731,1571,0
114578459421,114578459423,2,1411,885,0
114578750276,114578750269,-7,1307,3214,0
114581225638,114581225639,1,1586,1847,0
114583198397,114583198397,0,1612,1908,0
114585905142,114585905144,2,1012,1207,0
114586342217,114586342217,0,961,1249,0
114589508754,114589508754,0,1393,2222,0
114590468426,114590468427,1,1060,946,0
114601569854,114601569854,0,2168,1633,0
114604579590,114604579591,1,1776,1354,0
114604865752,114604865753,1,1221,1096,0
114606035799,114606035798,-1,1359,1201,0
114608716055,114608716057,2,1277,1482,0
114609994802,114609994803,1,907,1015,0
114610891222,114610891219,-3,1058,1361,0
114611236235,114611236234,-1,1236,1913,0
114613098947,114613098950,3,1605,1715,0
114614753084,114614753086,2,998,1311,0
114616179362,114616179367,5,833,1483,0
114617236400,114617236400,0,1415,2403,0
114617938382,114617938383,1,1882,1782,0
114619216019,114619216020,1,1268,1585,0
114619352984,114619352985,1,1971,2426,0
114622927494,114622927494,0,1473,1870,0
114623961263,114623961266,3,980,1238,0
114628445478,114628445479,1,834,1306,0
114631752043,114631752044,1,1234,1591,0
114632845322,114632845322,0,1403,1220,0
114638017990,114638017991,1,1330,1390,0
114643311127,114643311126,-1,1127,1435,0
114643429038,114643429046,8,175,1532,0
114643609040,114643609042,2,1987,1560,0
114644055233,114644055235,2,1716,1951,0
114645351645,114645351646,1,1345,1472,0
114650326592,114650326592,0,1318,1185,0
114652643079,114652643080,1,1245,1916,0
114656197697,114656197695,-2,811,1525,0
114656411942,114656411942,0,1281,1876,0
114658033190,114658033191,1,839,1550,0
114662189955,114662189958,3,3188,2619,0
114666389349,114666389346,-3,1392,3835,0
114668154463,114668154465,2,910,1142,0
114671077559,114671077560,1,1423,1744,0
114676062178,114676062178,0,1662,1892,0
114676575548,114676575548,0,1529,1366,0
114681776065,114681776066,1,1529,1720,0
114682289512,114682289514,2,1526,1691,0
114683282978,114683282977,-1,1398,2348,0
114684693665,114684693663,-2,1402,1460,0
114688265583,114688265584,1,1192,1464,0
114689070723,114689070723,0,2193,2434,0
114689915445,114689915445,0,1813,2139,0
114691004502,114691004503,1,1445,2049,0
114694897757,114694897759,2,1129,1452,0
114695374301,114695374301,0,1186,1581,0
114698313359,114698313361,2,1190,1288,0
114706858430,114706858430,0,1598,1801,0
114719282390,114719282391,1,1283,1364,0
114720431220,114720431218,-2,1117,1770,0
114720680916,114720680917,1,1479,1826,0
114721568718,114721568720,2,949,1439,0
114721806293,114721806293,0,1074,1490,0
114732872426,114732872424,-2,1215,1904,0
114733600818,114733600802,-16,1363,1622,0
114734232972,114734232954,-18,1289,1779,0
114739086915,114739086915,0,1646,1127,0
114740257516,114740257517,1,1407,1992,0
114741774229,114741774234,5,2373,1774,0
114745226887,114745226886,-1,723,718,0
114747370971,114747370970,-1,1105,1952,0
114747692333,114747692333,0,1117,2233,0
114751019205,114751019205,0,1012,1413,0
114751822973,114751822973,0,1408,2365,0
114752962381,114752962381,0,1311,1164,0
114755030855,114755030853,-2,1656,2754,0
114756979717,114756979719,2,1258,2045,0
114757240882,114757240883,1,1475,1779,0
114758818249,114758818249,0,1877,1568,0
114759010645,114759010644,-1,765,2324,0
114762704795,114762704795,0,1059,1874,0
114764707436,114764707438,2,1594,1872,0
114767768158,114767768158,0,2349,3946,0
114769376267,114769376266,-1,1768,2120,0
114769525415,114769525413,-2,1414,2358,0
114770464810,114770464810,0,1308,2545,0
114772743474,114772743474,0,1153,1771,0
114773530732,114773530732,0,1187,1570,0
114773796073,114773796072,-1,2093,2720,0
114773902270,114773902269,-1,1397,1789,0
114777260495,114777260497,2,1403,1602,0
114777439782,114777439782,0,1119,1980,0
114780313454,114780313458,4,1725,846,0
114781227878,114781227878,0,898,1589,0
114782092039,114782092038,-1,878,1042,0
114786093627,114786093626,-1,1510,1580,0
114786297872,114786297874,2,1312,1680,0
114787960475,114787960475,0,1488,1824,0
114788834526,114788834526,0,1138,1191,0
114792474561,114792474562,1,2143,1430,0
114794888067,114794888066,-1,855,843,0
114797554586,114797554588,2,1564,2064,0
114797667806,114797667806,0,1002,1753,0
114798543970,114798543970,0,1283,1464,0
114799055458,114799055459,1,1731,1327,0
114799583045,114799583046,1,1241,2537,0
114801301327,114801301327,0,1493,2122,0
114807250583,114807250587,4,1271,1179,0
114808293519,114808293500,-19,1124,829,0
114809440166,114809440167,1,1800,1308,0
114817986771,114817986771,0,1501,1673,0
114820492942,114820492942,0,1181,1617,0
114823004353,114823004352,-1,1435,2067,0
114825985978,114825985981,3,1307,1364,0
114827033713,114827033714,1,1594,2559,0
114833626943,114833626942,-1,1689,2114,0
114833662566,114833662567,1,1918,1324,0
114835280611,114835280610,-1,712,1383,0
114842145335,114842145335,0,1223,2288,0
114842360178,114842360178,0,1411,2679,0
114843188350,114843188351,1,1589,1266,0
114844878128,114844878127,-1,746,1405,0
114849051732,114849051734,2,1239,1567,0
114849535480,114849535478,-2,1253,2944,0
114852898648,114852898648,0,892,1324,0
114854118059,114854118059,0,935,908,0
114854224049,114854224050,1,1611,1791,0
114855047307,114855047308,1,1032,1485,0
114857588614,114857588613,-1,1179,1236,0
114859822759,114859822766,7,632,1100,0
114860750437,114860750427,-10,1380,1770,0
114861569354,114861569353,-1,1315,2339,0
114862917986,114862917987,1,1583,1933,0
114865110950,114865110952,2,1692,2007,0
114866400150,114866400157,7,13867,6274,0
114867955238,114867955239,1,1927,1966,0
114869336518,114869336519,1,1683,1594,0
114870968804,114870968805,1,902,1784,0
114874786283,114874786282,-1,633,1213,0
114877463142,114877463142,0,1478,1639,0
114880137601,114880137588,-13,1012,1571,0
114883930174,114883930174,0,1390,1989,0
114884725643,114884725642,-1,1254,1898,0
114886610445,114886610448,3,1688,2246,0
114890422929,114890422929,0,3077,4109,0
114890643284,114890643284,0,1329,1181,0
114897258383,114897258382,-1,642,824,0
114898052663,114898052666,3,2559,1709,0
114899975562,114899975566,4,2083,1184,0
114900413753,114900413733,-20,1377,1214,0
114901389311,114901389311,0,1592,2406,0
114902119485,114902119495,10,15610,29204,0
114906951342,114906951343,1,1675,1598,0
114908741489,114908741487,-2,1345,1453,0
114911301022,114911301023,1,1687,2025,0
114912677513,114912677516,3,2753,1609,0
114913877499,114913877498,-1,1217,1620,0
114914730756,114914730757,1,1425,1447,0
114914893296,114914893296,0,1368,1533,0
114915235099,114915235101,2,1364,1676,0
114915845146,114915845146,0,2646,3598,0
114916186158,114916186158,0,1369,1672,0
114922324347,114922324351,4,1318,1113,0
114922454761,114922454763,2,1194,2070,0
114928871855,114928871853,-2,1114,1730,0
114930282229,114930282229,0,1231,1892,0
114937591211,114937591214,3,1397,1852,0
114938031959,114938031959,0,1280,1514,0
114943426366,114943426367,1,890,1111,0
114947038749,114947038749,0,1299,2148,0
114947805861,114947805862,1,1241,1803,0
114954860096,114954860098,2,1293,1850,0
114955163735,114955163736,1,1701,1919,0
114956266696,114956266697,1,1297,1951,0
114957427166,114957427165,-1,1240,1990,0
114960183906,114960183903,-3,1141,825,0
114964943366,114964943368,2,1290,1633,0
114969806258,114969806259,1,1844,1957,0
114971290345,114971290346,1,1430,1227,0
114974600189,114974600189,0,1449,1400,0
114977414963,114977414965,2,1967,2768,0
114981166935,114981166936,1,1192,1828,0
114984272474,114984272473,-1,1392,1656,0
114986284648,114986284650,2,1711,2722,0
114987405243,114987405243,0,1191,1299,0
114988160852,114988160851,-1,1134,1399,0
114988521348,114988521348,0,1427,1810,0
114992175814,114992175815,1,1514,1655,0
114993582250,114993582250,0,1203,1685,0
114994386550,114994386557,7,1236,893,0
114995216581,114995216582,1,1822,2220,0
114996410626,114996410625,-1,1576,1994,0
114996881931,114996881930,-1,1004,1517,0
114997303561,114997303563,2,1522,1355,0
114997525912,114997525909,-3,1493,3420,0
114998625070,114998625070,0,1530,2044,0
115000573634,115000573634,0,1608,1486,0
115001372334,115001372334,0,973,1615,0
115001847851,115001847849,-2,1032,1565,0
115008657106,115008657109,3,1701,2261,0
115009035184,115009035185,1,1595,1605,0
115009214486,115009214486,0,1213,1163,0
115009785254,115009785253,-1,981,1147,0
115010321425,115010321421,-4,1021,2217,0
115011401746,115011401746,0,1822,1731,0
115011933308,115011933308,0,1639,1859,0
115012162781,115012162782,1,1791,1865,0
115012706165,115012706167,2,1993,1722,0
115014069896,115014069897,1,1588,1637,0
115018454982,115018454984,2,1507,1592,0
115019154931,115019154932,1,1681,2260,0
115022063190,115022063190,0,1261,1723,0
115022982323,115022982322,-1,889,1634,0
115029844015,115029844014,-1,1251,1758,0
115035864254,115035864255,1,1045,1528,0
115038630395,115038630395,0,1693,2095,0
115039190358,115039190359,1,1058,1835,0
115040039627,115040039626,-1,2604,4196,0
115040281766,115040281769,3,1842,1825,0
115041387590,115041387590,0,980,1315,0
115042299701,115042299702,1,986,1026,0
115044823066,115044823067,1,1820,1705,0
115046001606,115046001609,3,1374,1385,0
115047337775,115047337774,-1,1265,1411,0
115048750015,115048750016,1,1243,1667,0
115049565493,115049565503,10,13439,19378,0
115053635911,115053635911,0,836,1893,0
115055192235,115055192237,2,1917,1789,0
115056183936,115056183943,7,1193,1399,0
115057714370,115057714370,0,2068,2073,0
115058561938,115058561935,-3,638,1599,0
115059797536,115059797537,1,1426,1916,0
115060556617,115060556616,-1,1594,1346,0
115064848718,115064848720,2,1109,1211,0
115066298413,115066298415,2,1205,1682,0
115067728358,115067728357,-1,1076,1774,0
115067918923,115067918917,-6,2083,9480,0
115070873929,115070873930,1,879,1014,0
115072111570,115072111571,1,1338,1809,0
115074679454,115074679456,2,1050,1520,0
115075280787,115075280782,-5,1470,7111,0
115077951197,115077951198,1,1604,1740,0
115079379611,115079379611,0,780,1223,0
115083696121,115083696119,-2,1167,1560,0
115084131873,115084131874,1,1868,2173,0
115087293062,115087293063,1,579,835,0
115090259826,115090259827,1,1441,1927,0
115092383710,115092383717,7,2554,1523,0
115094384808,115094384809,1,1266,1910,0
115098895095,115098895094,-1,1207,1873,0
115100903307,115100903305,-2,1503,1772,0
115101985680,115101985681,1,2642,2222,0
115104817601,115104817594,-7,2462,7397,0
115105549478,115105549478,0,1252,1358,0
115108333210,115108333210,0,733,1286,0
115109061982,115109061982,0,1076,1503,0
115112321681,115112321682,1,1215,1962,0
115117978523,115117978523,0,1447,1305,0
115121750669,115121750670,1,1702,1366,0
115125771441,115125771440,-1,1198,1279,0
115127108566,115127108565,-1,1335,1749,0
115127204141,115127204148,7,2809,991,0
115135162530,115135162531,1,1175,1286,0
115136820142,115136820142,0,1638,1908,0
115138031727,115138031725,-2,801,2070,0
115138220485,115138220498,13,390,1780,0
115138904610,115138904609,-1,1168,1789,0
115141481922,115141481923,1,1099,1113,0
115142927335,115142927334,-1,1405,1440,0
115144122358,115144122359,1,1551,1468,0
115144632850,115144632850,0,1267,1928,0
115145150180,115145150178,-2,1291,1781,0
115154494842,115154494842,0,1295,2008,0
115154847519,115154847518,-1,1152,2084,0
115165665208,115165665210,2,1304,1455,0
115168543889,115168543889,0,1476,2301,0
115171927207,115171927210,3,1510,2006,0
115173828449,115173828450,1,1878,1862,0
115185989325,115185989326,1,1282,1231,0
115186337389,115186337390,1,985,1207,0
115190003418,115190003419,1,1162,1996,0
115190752445,115190752446,1,1335,1561,0
115191104223,115191104222,-1,902,1259,0
115191406476,115191406476,0,1550,1295,0
115191571964,115191571966,2,1147,1484,0
115192246605,115192246605,0,1615,1730,0
115192741294,115192741297,3,2293,1116,0
115198312798,115198312798,0,1202,1800,0
115201217419,115201217422,3,1270,1477,0
115202049971,115202049973,2,1062,1891,0
115203640433,115203640430,-3,770,1623,0
115204224927,115204224929,2,1556,1553,0
115208316825,115208316826,1,1323,1392,0
115208623929,115208623930,1,1986,2180,0
115209299203,115209299203,0,1041,1697,0
115211681437,115211681437,0,1157,1806,0
115213709259,115213709259,0,1206,1866,0
115220196832,115220196834,2,1393,1439,0
115221272933,115221272935,2,1302,1342,0
115221917058,115221917061,3,1116,957,0
115223925147,115223925146,-1,1433,2433,0
115225225214,115225225218,4,2296,1429,0
115226278928,115226278928,0,1382,1383,0
115239662314,115239662319,5,1239,901,0
115239956433,115239956435,2,2666,2444,0
115240344734,115240344733,-1,841,919,0
115241325807,115241325802,-5,859,1666,0
115243454251,115243454251,0,1489,1344,0
115247132626,115247132632,6,6394,3062,0
115247527527,115247527526,-1,644,896,0
115252088922,115252088921,-1,1746,2058,0
115252803995,115252803989,-6,1456,4372,0
115252855501,115252855500,-1,1343,2539,0
115257615162,115257615163,1,1480,1913,0
115259766535,115259766539,4,1187,1210,0
115260808791,115260808779,-12,1077,1033,0
115260872094,115260872096,2,1107,1662,0
115262188726,115262188726,0,1233,1574,0
115263373268,115263373262,-6,278,761,0
115264546099,115264546099,0,1666,1305,0
115266038420,115266038420,0,1368,1275,0
115268075429,115268075428,-1,1986,2224,0
115272770511,115272770513,2,1227,1216,0
115276731172,115276731173,1,1390,1489,0
115278236221,115278236241,20,534,621,0
115280020837,115280020838,1,1530,1811,0
115281788826,115281788829,3,1390,1672,0
115286494842,115286494843,1,994,1281,0
115286601279,115286601279,0,1783,1959,0
115289928002,115289928003,1,1045,1490,0
115290026535,115290026535,0,2166,2179,0
115290592307,115290592309,2,1664,2315,0
115290944767,115290944767,0,1623,2810,0
115291172235,115291172238,3,1434,1973,0
115292255379,115292255378,-1,1827,3404,0
115293411670,115293411670,0,1578,1815,0
115293843260,115293843261,1,1230,1415,0
115295695334,115295695333,-1,1158,1402,0
115296615449,115296615451,2,1706,1495,0
115299098563,115299098562,-1,976,1030,0
115301169290,115301169290,0,2051,2050,0
115302754330,115302754329,-1,1410,1578,0
115303789803,115303789807,4,1769,1025,0
115304497797,115304497798,1,1681,1746,0
115305449644,115305449638,-6,628,1852,0
115306887366,115306887364,-2,1206,1299,0
115309190653,115309190652,-1,1420,1709,0
115309677172,115309677173,1,1006,1850,0
115314825055,115314825057,2,1219,1705,0
115315187986,115315187986,0,1116,1535,0
115316820774,115316820773,-1,1374,2385,0
115318951805,115318951805,0,1353,2475,0
115321836888,115321836889,1,1331,2369,0
115322968711,115322968713,2,1133,1350,0
115326930304,115326930305,1,955,1586,0
115327487326,115327487326,0,882,1761,0
115328054921,115328054922,1,1206,1249,0
115329404100,115329404102,2,2076,1366,0
115329727054,115329727053,-1,1548,2070,0
115331512047,115331512042,-5,681,544,0
115333063899,115333063898,-1,1021,1432,0
115334555742,115334555744,2,934,1556,0
115337171321,115337171321,0,818,1094,0
115339595188,115339595189,1,1351,1314,0
115339887342,115339887343,1,1169,1548,0
115341067392,115341067393,1,963,1595,0
115342071449,115342071448,-1,1384,1902,0
115344747133,115344747131,-2,1341,1409,0
115346353326,115346353327,1,2164,2493,0
115347530494,115347530495,1,798,1527,0
115347858450,115347858431,-19,1084,1349,0
115348619218,115348619218,0,1070,1141,0
115351316366,115351316367,1,1174,1377,0
115352159850,115352159850,0,1162,1423,0
115352607977,115352607978,1,1761,1167,0
115352759868,115352759869,1,1230,1802,0
115356617579,115356617581,2,833,1394,0
115357839459,115357839453,-6,990,4866,0
115358064702,115358064705,3,1459,1080,0
115359205395,115359205399,4,1869,1141,0
115363828470,115363828468,-2,1528,1610,0
115364182533,115364182532,-1,1517,2398,0
115366771421,115366771421,0,903,1597,0
115367193992,115367193993,1,1389,1548,0
115373275656,115373275654,-2,1123,2602,0
115375599846,115375599850,4,1521,1216,0
115376456866,115376456863,-3,1260,1872,0
115376638727,115376638730,3,1788,1489,0
115385246697,115385246697,0,2685,3682,0
115387885110,115387885110,0,886,1674,0
115391343546,115391343542,-4,1304,1782,0
115394189560,115394189561,1,2030,2575,0
115394265445,115394265443,-2,1728,2008,0
115396912398,115396912398,0,1558,1541,0
115401120668,115401120653,-15,1061,966,0
115402625704,115402625706,2,1471,1422,0
115402785882,115402785881,-1,1698,1403,0
115404112731,115404112732,1,1000,1426,0
115404247435,115404247431,-4,1276,2094,0
115407291331,115407291330,-1,867,1235,0
115408333308,115408333311,3,1795,1685,0
115412589198,115412589196,-2,1288,1626,0
115419846193,115419846190,-3,1118,1754,0
115419879887,115419879886,-1,1111,1389,0
115421004238,115421004240,2,1596,1402,0
115424769658,115424769665,7,1604,1479,0
115425153167,115425153166,-1,1460,1950,0
115426793910,115426793910,0,853,1044,0
115429963358,115429963357,-1,1250,1388,0
115430655038,115430655036,-2,1745,1617,0
115431958381,115431958382,1,1470,1559,0
115432861493,115432861494,1,1769,1925,0
115436695910,115436695910,0,2374,2323,0
115441017264,115441017264,0,1211,1083,0
115443616222,115443616223,1,1077,999,0
115448279585,115448279586,1,1377,2038,0
115449394634,115449394636,2,1739,1419,0
115450107947,115450107947,0,938,2089,0
115458292985,115458292984,-1,1748,1594,0
115460286776,115460286778,2,852,1257,0
115461741601,115461741605,4,1486,1804,0
115462363960,115462363967,7,5664,2720,0
115462692595,115462692598,3,1462,1482,0
115462965545,115462965543,-2,1314,2053,0
115463942826,115463942825,-1,1434,1615,0
115464216129,115464216130,1,1986,1747,0
115464666537,115464666537,0,1461,1753,0
115465116694,115465116694,0,1075,1091,0
115466000510,115466000511,1,884,1569,0
115468690235,115468690237,2,1503,2352,0
115473594127,115473594133,6,5542,2721,0
115476138934,115476138935,1,1199,1283,0
115476537130,115476537134,4,1559,1307,0
115477203416,115477203417,1,1714,1991,0
115477470930,115477470934,4,1445,1571,0
115478895473,115478895474,1,1806,2045,0
115485619830,115485619832,2,867,1110,0
115486896330,115486896330,0,1270,2053,0
115489841772,115489841769,-3,1526,2041,0
115493776524,115493776522,-2,1498,1632,0
115494765234,115494765238,4,1365,1973,0
115497305635,115497305638,3,2207,2779,0
115506809127,115506809126,-1,1232,1552,0
115511778650,115511778649,-1,1533,1536,0
115511875242,115511875244,2,1689,1844,0
115513655986,115513655985,-1,1581,1823,0
115514970428,115514970430,2,1301,1639,0
115515049234,115515049234,0,1653,2022,0
115516227519,115516227519,0,1519,2429,0
115517405968,115517405970,2,1457,2393,0
115518608525,115518608531,6,2061,1109,0
115518663085,115518663085,0,1285,1766,0
115521019318,115521019318,0,1189,1637,0
115522159294,115522159295,1,988,1650,0
115522499405,115522499386,-19,1328,1976,0
115523252609,115523252609,0,1279,1643,0
115525688193,115525688193,0,1611,1497,0
115528640647,115528640646,-1,725,1315,0
115528772194,115528772194,0,1237,1191,0
115533323259,115533323259,0,1113,1363,0
115536309185,115536309185,0,1327,2176,0
115537426457,115537426458,1,1826,1979,0
115540666988,115540666987,-1,1753,1699,0
115542093114,115542093113,-1,1187,1954,0
115542524197,115542524194,-3,1915,2085,0
115544039592,115544039593,1,1762,2112,0
115549892803,115549892781,-22,1080,1503,0
115552649079,115552649082,3,441,890,0
115554821667,115554821667,0,1522,1825,0
115555487437,115555487439,2,1830,1118,0
115556424375,115556424378,3,1446,2051,0
115556804663,115556804662,-1,1478,2267,0
115559440656,115559440657,1,1660,1518,0
115572073514,115572073514,0,1096,1548,0
115572288586,115572288587,1,1440,1603,0
115577525582,115577525582,0,1104,1608,0
115579516141,115579516142,1,1385,1178,0
115580746232,115580746212,-20,723,873,0
115580857774,115580857775,1,1514,2040,0
115583257795,115583257794,-1,1693,2375,0
115584962578,115584962578,0,1686,1526,0
115586635823,115586635823,0,943,1412,0
115590581295,115590581293,-2,1978,2469,0
115593094142,115593094135,-7,1016,4931,0
115596155907,115596155911,4,1726,1989,0
115598687585,115598687582,-3,1317,2207,0
115598812310,115598812297,-13,1170,1297,0
115599558165,115599558167,2,1820,1006,0
115601215494,115601215496,2,1039,1206,0
115602019361,115602019363,2,1002,1464,0
115602293270,115602293291,21,1270,1203,0
115603088118,115603088136,18,217,518,0
115605372447,115605372446,-1,1179,1250,0
115606820937,115606820937,0,1562,1292,0
115613784354,115613784353,-1,1155,1203,0
115615533147,115615533145,-2,1432,1657,0
115618643677,115618643678,1,1295,1703,0
115620241709,115620241710,1,1665,1527,0
115623371755,115623371755,0,1807,1501,0
115623795043,115623795043,0,1038,1416,0
115628434517,115628434518,1,1188,1252,0
115631249833,115631249834,1,1759,1692,0
115631678882,115631678903,21,1422,1748,0
115632254835,115632254834,-1,1105,1475,0
115633232125,115633232126,1,1113,1470,0
115634887547,115634887548,1,1220,1573,0
115637151937,115637151936,-1,2090,2006,0
115638468733,115638468734,1,1513,1725,0
115639693155,115639693153,-2,1513,2111,0
115642484364,115642484361,-3,1997,4338,0
115643307706,115643307705,-1,1039,1483,0
115645758641,115645758642,1,2091,2125,0
115646823281,115646823279,-2,1635,2292,0
115649697522,115649697523,1,1210,1501,0
115653733397,115653733398,1,3234,3484,0
115664231269,115664231267,-2,1039,1532,0
115664745998,115664745998,0,903,1700,0
115665562255,115665562254,-1,1104,2279,0
115667477282,115667477278,-4,1100,1582,0
115668660158,115668660158,0,1879,1850,0
115672450062,115672450063,1,2088,2101,0
115673286829,115673286830,1,965,2147,0
115678524476,115678524474,-2,2223,1824,0
115682556850,115682556851,1,1060,1196,0
115688325839,115688325842,3,1497,1541,0
115691554947,115691554949,2,1593,2211,0
115693382337,115693382342,5,2038,1025,0
115696413091,115696413091,0,1051,1798,0
115699286281,115699286282,1,1573,1809,0
115701584873,115701584874,1,1672,2091,0
115702726316,115702726317,1,1244,1697,0
115704516869,115704516869,0,773,1133,0
115713330701,115713330704,3,4270,2684,0
115715044449,115715044450,1,1358,1884,0
115715339188,115715339207,19,453,811,0
115716584043,115716584044,1,1550,1463,0
115722922048,115722922047,-1,1247,1433,0
115725887446,115725887446,0,1375,1294,0
115726021975,115726021978,3,1347,951,0
115729143788,115729143804,16,307,2034,0
115732880552,115732880551,-1,1788,1491,0
115733124617,115733124619,2,1128,1255,0
115736305357,115736305358,1,1057,1630,0
115738154097,115738154092,-5,820,2253,0
115740072773,115740072774,1,2129,2069,0
115740597499,115740597497,-2,1956,1733,0
115744200109,115744200111,2,1299,1435,0
115746482910,115746482910,0,1573,1750,0
115747298113,115747298115,2,1423,1591,0
115750452121,115750452125,4,2097,1167,0
115751232129,115751232130,1,1381,2089,0
115751322168,115751322171,3,1274,1249,0
115753191094,115753191094,0,1539,1770,0
115757674183,115757674183,0,1412,1033,0
115758038830,115758038830,0,819,1214,0
115761186242,115761186243,1,1476,1481,0
115761677378,115761677381,3,3528,2240,0
115768670074,115768670072,-2,1097,1490,0
115771333770,115771333769,-1,1191,1363,0
115773115535,115773115538,3,1913,1536,0
115774109119,115774109120,1,1374,1904,0
115774205331,115774205331,0,986,1454,0
115775120913,115775120913,0,928,1680,0
115778723435,115778723437,2,1289,2108,0
115779789239,115779789219,-20,1707,1358,0
115780434975,115780434975,0,1015,1328,0
115780811481,115780811481,0,1311,2107,0
115782022606,115782022602,-4,1561,2797,0
115783269848,115783269846,-2,1484,2143,0
115783397770,115783397769,-1,1039,1354,0
115783872158,115783872159,1,939,1236,0
115789119600,115789119599,-1,1683,1219,0
115789920236,115789920238,2,1907,1756,0
115790902233,115790902233,0,1045,1742,0
115793344786,115793344783,-3,1286,1422,0
115794601939,115794601942,3,1165,1089,0
115795037494,115795037489,-5,1154,2492,0
115795156468,115795156458,-10,1068,1911,0
115795711523,115795711523,0,1943,1451,0
115796901693,115796901694,1,1691,1371,0
115797728729,115797728727,-2,1400,1762,0
115798245277,115798245278,1,976,1191,0
115799320357,115799320342,-15,1029,1285,0
115799929180,115799929179,-1,1376,1791,0
115800560302,115800560305,3,1722,1723,0
115801155823,115801155825,2,881,1271,0
115801396641,115801396641,0,1262,1706,0
115804794174,115804794192,18,1534,1257,0
115811191327,115811191329,2,1746,2024,0
115811839785,115811839785,0,1788,2025,0
115812852185,115812852186,1,1981,1706,0
115813155622,115813155621,-1,1156,1680,0
115816911694,115816911695,1,1008,1329,0
115820179232,115820179219,-13,2732,1074,0
115826884301,115826884301,0,1427,2165,0
115829354877,115829354878,1,1140,1281,0
115831204465,115831204466,1,1780,2444,0
115836238989,115836238989,0,1515,1459,0
115838109986,115838109987,1,1495,2059,0
115838147542,115838147542,0,978,1248,0
115838875522,115838875521,-1,1491,1330,0
115841202113,115841202114,1,1465,1164,0
115841942371,115841942372,1,1812,1623,0
115842756881,115842756874,-7,931,4316,0
115843555062,115843555061,-1,987,2177,0
115843619885,115843619907,22,1210,1397,0
115847206742,115847206743,1,1119,1059,0
115848937549,115848937549,0,1308,1775,0
115850119653,115850119651,-2,1992,1522,0
115852429758,115852429757,-1,1442,1656,0
115853907598,115853907599,1,997,1488,0
115856194651,115856194651,0,1018,1176,0
115858994781,115858994782,1,1145,1113,0
115861872286,115861872287,1,1090,1200,0
115863906332,115863906331,-1,1383,1410,0
115865350020,115865350021,1,1559,1588,0
115866794241,115866794241,0,1071,1865,0
115870991823,115870991823,0,1583,1757,0
115871486335,115871486336,1,1891,2395,0
115871878402,115871878403,1,1234,2036,0
115872896789,115872896791,2,845,1600,0
115873799318,115873799322,4,682,868,0
115874650135,115874650134,-1,1322,1944,0
115878376976,115878376978,2,1446,2114,0
115882825126,115882825126,0,1059,1550,0
115888896870,115888896870,0,1083,1804,0
115892297660,115892297661,1,995,1404,0
115892622609,115892622610,1,1255,1578,0
115892750071,115892750074,3,1921,1369,0
115897168185,115897168186,1,958,1693,0
115897483017,115897483017,0,1576,2374,0
115902145927,115902145930,3,1537,1388,0
115902578816,115902578816,0,1873,2437,0
115903049644,115903049646,2,1666,1396,0
115903201407,115903201407,0,1332,1010,0
115905287755,115905287755,0,762,659,0
115908523026,115908523027,1,1469,1648,0
115911832697,115911832693,-4,2361,6656,0
115914982593,115914982593,0,1405,1897,0
115915992619,115915992622,3,1571,1755,0
115916575317,115916575316,-1,3494,4285,0
115918180770,115918180773,3,1365,1779,0
115918820095,115918820095,0,970,1235,0
115920097093,115920097094,1,3016,3574,0
115920871324,115920871325,1,1632,1464,0
115921773918,115921773919,1,1750,2192,0
115922264521,115922264542,21,1400,1736,0
115927678570,115927678570,0,1673,2279,0
115929242002,115929242003,1,1513,2138,0
115930649866,115930649865,-1,1425,2309,0
115931368150,115931368150,0,1399,1845,0
115935370250,115935370249,-1,1367,1623,0
115936163257,115936163259,2,1224,1492,0
115940177601,115940177602,1,1228,1877,0
115940273922,115940273922,0,1225,1993,0
115942513622,115942513621,-1,1711,2549,0
115944807562,115944807565,3,1067,1360,0
115949668023,115949668026,3,1539,1414,0
115954498683,115954498682,-1,1830,2490,0
115955113002,115955113001,-1,1237,1403,0
115955440839,115955440841,2,1433,1876,0
115959111350,115959111352,2,1572,1455,0
115961721778,115961721778,0,1463,1293,0
115962105457,115962105457,0,1620,1973,0
115962933579,115962933582,3,897,1082,0
115963423959,115963423959,0,1275,1603,0
115965076288,115965076291,3,1179,1949,0
115972685931,115972685931,0,1155,1489,0
115974331462,115974331463,1,1184,1459,0
115978002622,115978002620,-2,1816,2677,0
115978891550,115978891550,0,1240,1458,0
115979433043,115979433042,-1,812,1321,0
115981196405,115981196406,1,1114,1148,0
115983174058,115983174058,0,1191,1193,0
115985922664,115985922659,-5,1395,3550,0
115986391718,115986391719,1,1909,2113,0
115987163549,115987163561,12,961,1522,0
115987643446,115987643445,-1,1407,2258,0
115988893666,115988893669,3,1589,1346,0
115989084206,115989084189,-17,1427,1998,0
115989404682,115989404678,-4,2887,5744,0
115991018181,115991018166,-15,1160,1998,0
115991965613,115991965614,1,1730,2472,0
115992056739,115992056738,-1,1130,1887,0
115994810925,115994810926,1,1519,1325,0
115995528976,115995528977,1,1510,1701,0
115996009296,115996009296,0,1224,1368,0
116007564689,116007564690,1,1277,1457,0
116011425630,116011425630,0,1124,1778,0
116013805710,116013805717,7,61162,21780,0
116014310211,116014310210,-1,1471,2496,0
116015371842,116015371840,-2,2285,1894,0
116016716306,116016716309,3,1510,1326,0
116018480360,116018480360,0,1066,1782,0
116022929094,116022929094,0,929,2071,0
116023910143,116023910142,-1,1121,1457,0
116025231897,116025231897,0,1291,1975,0
116029274555,116029274555,0,1172,1627,0
116030356158,116030356157,-1,906,2448,0
116031872198,116031872198,0,1061,1138,0
116033350954,116033350958,4,12616,9767,0
116033525656,116033525658,2,1315,1297,0
116035139935,116035139936,1,1385,2205,0
116037542747,116037542747,0,1368,1541,0
116038346785,116038346785,0,1448,1435,0
116040946641,116040946642,1,1406,1380,0
116042037122,116042037122,0,1576,1688,0
116042343091,116042343090,-1,1475,1568,0
116044565222,116044565221,-1,1151,1739,0
116044895087,116044895089,2,1815,1654,0
116047013210,116047013211,1,1505,1803,0
116048675325,116048675323,-2,1442,1776,0
116049682505,116049682507,2,940,1040,0
116050424249,116050424246,-3,1673,1211,0
116052907266,116052907266,0,1796,2260,0
116056630695,116056630696,1,1449,2082,0
116056941552,116056941553,1,1256,1491,0
116060380613,116060380611,-2,1366,2347,0
116060940458,116060940460,2,1213,1460,0
116063106614,116063106614,0,1507,1394,0
116063582381,116063582384,3,1606,1483,0
116067777611,116067777612,1,1422,1767,0
116070302066,116070302066,0,1274,1963,0
116072100730,116072100729,-1,1212,1995,0
116073210236,116073210239,3,1087,1287,0
116079096635,116079096637,2,1256,1990,0
116079920475,116079920473,-2,1099,2479,0
116080403630,116080403626,-4,2458,5222,0
116080833683,116080833686,3,1563,922,0
116083263837,116083263833,-4,1400,1860,0
116084312295,116084312289,-6,2182,6782,0
116085482276,116085482276,0,2221,2099,0
116086383181,116086383181,0,1582,2042,0
116090119175,116090119174,-1,1244,1460,0
116093451463,116093451462,-1,1423,1960,0
116093536050,116093536050,0,1676,1417,0
116094777050,116094777053,3,1017,808,0
116096038534,116096038531,-3,1065,1599,0
116096437923,116096437925,2,1469,1647,0
116098313430,116098313434,4,1978,1664,0
116099615736,116099615738,2,1754,1304,0
116100947470,116100947469,-1,1223,2023,0
116102391104,116102391117,13,14037,21046,0
116103344646,116103344648,2,1188,1537,0
116105274362,116105274364,2,1272,1840,0
116108062172,116108062172,0,1003,1758,0
116110836778,116110836778,0,1260,1588,0
116113665103,116113665101,-2,1384,2099,0
116114499481,116114499483,2,1267,1702,0
116114614433,116114614434,1,2161,1546,0
116117093033,116117093031,-2,1206,1532,0
116117224862,116117224861,-1,729,1059,0
116124785030,116124785008,-22,2047,615,0
116124975654,116124975655,1,1665,2287,0
116126964731,116126964734,3,1301,1599,0
116127421725,116127421721,-4,1190,1704,0
116127741898,116127741898,0,1169,965,0
116130554510,116130554509,-1,1175,1810,0
116132171263,116132171261,-2,2296,4844,0
116132496399,116132496399,0,1141,1136,0
116136153636,116136153636,0,1083,1418,0
116140867917,116140867913,-4,1538,1466,0
116143327156,116143327161,5,1988,1234,0
116144426231,116144426234,3,1510,1263,0
116148802042,116148802036,-6,1061,4390,0
116149228272,116149228273,1,1262,1653,0
116149285410,116149285410,0,1383,1776,0
116150726670,116150726671,1,1346,1839,0
116151084011,116151084010,-1,1675,1803,0
116154419621,116154419621,0,1497,1534,0
116155605732,116155605735,3,1665,1094,0
116156379019,116156379025,6,1642,1929,0
116157324026,116157324026,0,1416,1574,0
116160493000,116160492999,-1,1302,1324,0
116161327508,116161327510,2,1595,1556,0
116161484981,116161484981,0,2095,1936,0
116163329959,116163329962,3,2105,2333,0
116165616673,116165616664,-9,29238,14482,0
116174736930,116174736934,4,1543,1858,0
116175910382,116175910381,-1,1404,1363,0
116178357598,116178357598,0,1285,1882,0
116179036846,116179036846,0,1348,1545,0
116184579925,116184579926,1,1078,1833,0
116187241550,116187241551,1,1613,1658,0
116188225879,116188225878,-1,2563,3666,0
116188266676,116188266678,2,1185,1523,0
116190225324,116190225325,1,1645,1673,0
116192232899,116192232901,2,1145,1423,0
116192746871,116192746873,2,1706,1557,0
116194812521,116194812522,1,1841,2157,0
116195087506,116195087527,21,1310,1489,0
116195667235,116195667236,1,1580,1962,0
116196314981,116196314982,1,1439,1869,0
116198119992,116198119991,-1,1072,1997,0
116200787313,116200787318,5,2775,1593,0
116200958699,116200958703,4,1169,1140,0
116211571085,116211571086,1,1300,1320,0
116217673615,116217673622,7,2915,1275,0
116218656187,116218656187,0,1517,2133,0
116219492702,116219492703,1,1577,1690,0
116219935107,116219935105,-2,929,1559,0
116220658789,116220658787,-2,1067,1340,0
116222380687,116222380687,0,1504,2142,0
116224516077,116224516078,1,1382,1581,0
116232366006,116232366008,2,1599,1755,0
116236238438,116236238436,-2,1123,2597,0
116238294725,116238294726,1,965,616,0
116240031414,116240031415,1,1624,1699,0
116241081854,116241081855,1,1214,1126,0
116245590510,116245590509,-1,998,1812,0
116248960378,116248960378,0,1399,2005,0
116249469658,116249469662,4,1364,1615,0
116251840999,116251840998,-1,1567,1492,0
116255317699,116255317701,2,1089,1285,0
116257148456,116257148457,1,1508,2350,0
116257876717,116257876715,-2,850,1847,0
116261162868,116261162866,-2,987,1648,0
116263367454,116263367453,-1,1042,2685,0
116264687192,116264687195,3,1733,1463,0
116264917677,116264917678,1,1559,1480,0
116266179415,116266179413,-2,1002,1309,0
116266554544,116266554544,0,1037,1207,0
116270832573,116270832574,1,1023,1380,0
116271202060,116271202061,1,1719,1709,0
116274571783,116274571789,6,3982,1354,0
116277688543,116277688545,2,1753,1996,0
116278219701,116278219702,1,1556,1521,0
116280289471,116280289471,0,1805,2025,0
116280824713,116280824714,1,1661,2192,0
116290069573,116290069572,-1,7172,9636,0
116291961496,116291961498,2,1788,2385,0
116294809023,116294809022,-1,1386,1973,0
116295856975,116295856977,2,1189,1478,0
116297238921,116297238919,-2,1646,1239,0
116298869173,116298869175,2,1619,1429,0
116298932997,116298932999,2,1517,1771,0
116302312586,116302312584,-2,2358,14680,0
116302469157,116302469158,1,990,1755,0
116304790182,116304790183,1,941,1219,0
116306759939,116306759940,1,1534,2140,0
116307959996,116307959997,1,974,2081,0
116309334710,116309334710,0,1189,1087,0
116314500440,116314500439,-1,965,1648,0
116321985438,116321985433,-5,1422,4707,0
116322270034,116322270039,5,2206,1644,0
116324119147,116324119146,-1,1578,1162,0
116326580150,116326580147,-3,757,971,0
116328156805,116328156807,2,1382,1314,0
116329313775,116329313776,1,1635,1859,0
116331626381,116331626383,2,2073,2148,0
116331690278,116331690279,1,1629,1428,0
116332774074,116332774075,1,1349,1297,0
116333865990,116333865990,0,1358,1425,0
116334744491,116334744495,4,1764,1514,0
116335164945,116335164951,6,1259,1525,0
116338321270,116338321271,1,1269,1733,0
116339088326,116339088326,0,1830,1379,0
116340348203,116340348202,-1,1272,1401,0
116343711311,116343711312,1,1793,1650,0
116344736490,116344736490,0,1863,2825,0
116345294630,116345294634,4,1351,1562,0
116345363876,116345363874,-2,1510,2297,0
116347048559,116347048560,1,732,1459,0
116349440607,116349440608,1,2045,2068,0
116354369326,116354369326,0,832,1959,0
116355623984,116355623986,2,1533,1701,0
116357788853,116357788861,8,1335,1637,0
116358233743,116358233750,7,1102,1983,0
116359867549,116359867541,-8,1379,2009,0
116363831911,116363831913,2,1134,1594,0
116364775786,116364775786,0,1648,1562,0
116364927061,116364927060,-1,1252,839,0
116365265635,116365265634,-1,1027,1684,0
116365536568,116365536568,0,1652,2152,0
116367563734,116367563736,2,1386,1914,0
116367815516,116367815516,0,1452,1638,0
116369636680,116369636681,1,2070,1888,0
116370301795,116370301794,-1,1001,1614,0
116370998503,116370998503,0,1678,1394,0
116372315585,116372315582,-3,1354,1878,0
116374502630,116374502632,2,1051,1364,0
116375647782,116375647783,1,1622,2053,0
116376332353,116376332354,1,1209,1764,0
116378892380,116378892399,19,503,8473,0
116379416810,116379416805,-5,668,2901,0
116384429821,116384429824,3,1313,1058,0
116386544850,116386544853,3,17869,13543,0
116386842811,116386842810,-1,1230,1588,0
116391765993,116391765993,0,1421,1876,0
116394748438,116394748438,0,1158,1124,0
116396439182,116396439181,-1,1520,1877,0
116396533711,116396533711,0,37929,30363,0
116397888111,116397888111,0,1275,2250,0
116398176994,116398176994,0,1386,1605,0
116399401756,116399401757,1,1331,1564,0
116400319490,116400319489,-1,1230,1411,0
116403296923,116403296923,0,1328,1525,0
116403884690,116403884691,1,1708,1921,0
116405216483,116405216482,-1,1294,2183,0
116406013679,116406013680,1,1122,1717,0
116406993586,116406993587,1,3433,3749,0
116408787533,116408787533,0,1268,1811,0
116409384308,116409384313,5,3409,2303,0
116411166014,116411166019,5,2781,1221,0
116412115208,116412115229,21,2847,2054,0
116416626580,116416626580,0,1145,1473,0
116421962154,116421962154,0,2589,3702,0
116425948582,116425948583,1,1361,1764,0
116429284133,116429284134,1,928,1600,0
116430065763,116430065764,1,1069,1325,0
116432196598,116432196599,1,1189,2416,0
116432573255,116432573256,1,1473,1578,0
116432915201,116432915201,0,1313,1909,0
116436864391,116436864392,1,1624,1621,0
116437412810,116437412810,0,1274,1804,0
116443146798,116443146798,0,1778,1246,0
116443367898,116443367898,0,1536,2124,0
116444722373,116444722375,2,1671,1394,0
116445625221,116445625223,2,1442,1183,0
116446523085,116446523082,-3,1569,2100,0
116448033892,116448033893,1,1282,1434,0
116450840529,116450840530,1,1460,1448,0
116451222947,116451222946,-1,968,1798,0
116452631859,116452631857,-2,1564,2324,0
116452664793,116452664797,4,1024,1416,0
116455298934,116455298935,1,1398,1886,0
116458043249,116458043249,0,1469,1894,0
116460972243,116460972245,2,678,815,0
116461835009,116461835008,-1,1683,2392,0
116462883087,116462883105,18,880,1711,0
116463249870,116463249871,1,1150,1548,0
116463593718,116463593717,-1,1627,1442,0
116464538290,116464538288,-2,1328,2091,0
116467185378,116467185395,17,17023,33994,0
116469234262,116469234263,1,1260,2098,0
116471419397,116471419397,0,1431,1628,0
116471986898,116471986899,1,1476,1710,0
116472180253,116472180252,-1,1667,1859,0
116473284157,116473284157,0,1971,1537,0
116473993878,116473993878,0,983,1526,0
116475002654,116475002655,1,1471,1725,0
116480614223,116480614225,2,1501,2236,0
116482509696,116482509695,-1,1609,2292,0
116485000784,116485000787,3,1235,1191,0
116485234758,116485234759,1,1035,1397,0
116487539578,116487539579,1,1797,1538,0
116488638900,116488638899,-1,1467,2383,0
116492725975,116492725976,1,1481,1786,0
116494228187,116494228187,0,1045,1224,0
116497301318,116497301315,-3,1074,2778,0
116497615530,116497615528,-2,1078,1688,0
116502083197,116502083202,5,3381,1218,0
116502156297,116502156278,-19,1800,1741,0
116502407755,116502407756,1,1794,2503,0
116507111845,116507111846,1,1464,1578,0
116510332671,116510332670,-1,1179,1107,0
116512099254,116512099253,-1,1211,1835,0
116513970751,116513970750,-1,1394,2452,0
116514073702,116514073704,2,1758,1705,0
116515605795,116515605790,-5,1326,3663,0
116516394441,116516394447,6,7974,4506,0
116516876551,116516876551,0,1199,1374,0
116518397830,116518397829,-1,1440,1418,0
116522595831,116522595833,2,1216,1459,0
116523825444,116523825443,-1,1632,1471,0
116525051165,116525051165,0,1547,1547,0
116525528503,116525528505,2,1025,1579,0
116526374314,116526374314,0,1313,1796,0
116528675323,116528675301,-22,961,729,0
116529621691,116529621690,-1,1478,1634,0
116531589219,116531589220,1,1415,1443,0
116532339331,116532339332,1,815,1755,0
116536595054,116536595054,0,1343,2023,0
116538831448,116538831445,-3,1000,2391,0
116543243589,116543243593,4,1452,1058,0
116545180842,116545180842,0,1468,2044,0
116545842843,116545842843,0,1014,1232,0
116546044836,116546044837,1,1348,1796,0
116551149342,116551149343,1,1334,1584,0
116551487453,116551487457,4,1988,1763,0
116551671474,116551671475,1,1173,1728,0
116554326413,116554326413,0,1520,2107,0
116556809410,116556809410,0,22962,23044,0
116557373690,116557373691,1,1308,1655,0
116558606295,116558606297,2,1271,1756,0
116559048775,116559048776,1,1255,1517,0
116560073470,116560073471,1,1417,2014,0
116572022935,116572022934,-1,2080,1927,0
116572540393,116572540395,2,1587,2002,0
116572736013,116572736018,5,2186,1432,0
116573496006,116573496006,0,1271,2147,0
116573928327,116573928330,3,3205,1582,0
116575782530,116575782530,0,1400,2382,0
116576987445,116576987445,0,1165,1435,0
116578141578,116578141579,1,1222,1457,0
116578807405,116578807406,1,1633,1791,0
116579317274,116579317276,2,1462,1771,0
116580779906,116580779907,1,1169,1567,0
116581221050,116581221051,1,1479,1441,0
116582081533,116582081534,1,1983,2117,0
116593920201,116593920201,0,1993,2093,0
116594329227,116594329226,-1,1774,2047,0
116600132044,116600132047,3,1311,1092,0
116602227035,116602227036,1,920,1524,0
116604813386,116604813386,0,1648,1319,0
116605402362,116605402362,0,1407,1804,0
116607376918,116607376918,0,1188,1430,0
116608623498,116608623498,0,1533,1938,0
116609688718,116609688714,-4,831,3379,0
116613115126,116613115126,0,3019,3542,0
116620512676,116620512677,1,1057,1328,0
116624131195,116624131198,3,1820,1564,0
116626031739,116626031742,3,1101,1862,0
116626374370,116626374370,0,1400,1648,0
116627378921,116627378922,1,1242,1607,0
116628305246,116628305247,1,1007,1339,0
116630693545,116630693544,-1,1467,1890,0
116643675765,116643675765,0,819,1206,0
116644676414,116644676414,0,1729,1817,0
116647059139,116647059139,0,1370,2513,0
116649563283,116649563283,0,1022,883,0
116654704130,116654704122,-8,1014,1384,0
116657098435,116657098435,0,1045,1426,0
116657668658,116657668659,1,1174,2410,0
116661201705,116661201713,8,17121,38626,0
116663288737,116663288738,1,4339,5181,0
116664364147,116664364149,2,742,1709,0
116668255400,116668255399,-1,1512,1814,0
116668618102,116668618102,0,1061,1236,0
116671577626,116671577633,7,2555,1550,0
116671620695,116671620695,0,911,877,0
116674004603,116674004604,1,1174,1492,0
116674538071,116674538069,-2,1807,2243,0
116676952582,116676952583,1,1351,1414,0
116677431134,116677431134,0,1020,1962,0
116681441774,116681441774,0,1477,1982,0
116688776767,116688776761,-6,1047,3472,0
116690017668,116690017670,2,2034,1253,0
116690385538,116690385539,1,1539,1791,0
116694096745,116694096743,-2,1113,1711,0
116697064010,116697064011,1,1736,1685,0
116699111282,116699111279,-3,1390,2187,0
116704155629,116704155630,1,1051,1550,0
116705073399,116705073397,-2,1672,2571,0
116707646386,116707646386,0,1552,2161,0
116712246864,116712246863,-1,18522,11131,0
116717523537,116717523539,2,4155,22200,0
116717592855,116717592857,2,714,1274,0
116723551263,116723551254,-9,722,4268,0
116725799186,116725799186,0,1514,2111,0
116727306583,116727306584,1,2235,2562,0
116728967989,116728967993,4,1800,1466,0
116730422469,116730422475,6,2708,1655,0
116731917942,116731917943,1,2022,2088,0
116734176999,116734176998,-1,1363,1301,0
116735333159,116735333161,2,1105,2176,0
116735568958,116735568937,-21,1229,1792,0
116737797636,116737797639,3,2030,2456,0
116740157383,116740157382,-1,724,1051,0
116744802359,116744802358,-1,1091,1778,0
116745968237,116745968237,0,1437,1157,0
116747666357,116747666357,0,1350,2033,0
116750429624,116750429626,2,2040,1568,0
116751621963,116751621964,1,1215,2459,0
116754423622,116754423621,-1,1149,1556,0
116757120835,116757120834,-1,923,1108,0
116757730459,116757730460,1,1319,1911,0
116759387582,116759387580,-2,852,1740,0
116759768641,116759768640,-1,1169,1545,0
116762363575,116762363575,0,1537,1973,0
116763565008,116763565010,2,1851,2626,0
116764112765,116764112766,1,1416,1879,0
116767642138,116767642137,-1,1100,1065,0
116771868715,116771868718,3,1329,1659,0
116772536378,116772536380,2,1345,1558,0
116776527441,116776527442,1,1455,1633,0
116776878187,116776878193,6,5305,2252,0
116778215857,116778215858,1,1653,1763,0
116780726321,116780726316,-5,752,2821,0
116784581707,116784581709,2,1220,996,0
116785255149,116785255151,2,1519,1600,0
116787088142,116787088142,0,1170,1644,0
116787910273,116787910275,2,1265,1816,0
116795342079,116795342080,1,1291,1664,0
116796043368,116796043368,0,1702,2268,0
116800069829,116800069835,6,2017,1121,0
116807890658,116807890659,1,1164,1339,0
116809791781,116809791782,1,1025,1270,0
116810248251,116810248253,2,891,939,0
116812035384,116812035394,10,12799,32114,0
116814132289,116814132286,-3,1305,2223,0
116818443828,116818443829,1,1465,1941,0
116819995741,116819995742,1,1512,1666,0
116820899442,116820899442,0,1157,1610,0
116822599854,116822599858,4,1968,1486,0
116825064721,116825064722,1,1295,1661,0
116825327361,116825327362,1,1327,1917,0
116827248282,116827248279,-3,1016,2270,0
116827450602,116827450605,3,1172,1651,0
116827659050,116827659050,0,1297,1768,0
116828927617,116828927617,0,1210,1394,0
116829610559,116829610561,2,786,1265,0
116830853437,116830853438,1,1724,1574,0
116831486306,116831486310,4,1542,1425,0
116832672462,116832672467,5,4609,3647,0
116834025351,116834025351,0,1430,1894,0
116838432841,116838432842,1,1258,1646,0
116842762651,116842762651,0,1368,1599,0
116845662186,116845662186,0,939,1545,0
116847167342,116847167342,0,1173,1962,0
116847571213,116847571214,1,1052,1309,0
116849191021,116849191021,0,1705,2266,0
116851638119,116851638121,2,1405,1603,0
116853056578,116853056577,-1,898,1882,0
116853522436,116853522437,1,1000,1537,0
116855635172,116855635163,-9,1318,1201,0
116857134554,116857134555,1,1280,1172,0
116860273982,116860273983,1,1346,1171,0
116860589426,116860589417,-9,36870,13830,0
116861642533,116861642535,2,1073,1095,0
116863896073,116863896074,1,1787,1245,0
116864964760,116864964761,1,1296,1838,0
116867536730,116867536730,0,1023,1259,0
116868350857,116868350858,1,1480,1191,0
116869835166,116869835169,3,1465,1210,0
116869954599,116869954600,1,2019,1921,0
116872171966,116872171967,1,1453,1401,0
116873504454,116873504453,-1,2287,4149,0
116873826335,116873826336,1,1482,1942,0
116874075536,116874075537,1,2022,2162,0
116874760618,116874760618,0,1855,1699,0
116875836447,116875836447,0,881,1550,0
116876109329,116876109327,-2,1399,1552,0
116878552566,116878552567,1,1597,2740,0
116879442555,116879442554,-1,598,724,0
116880233262,116880233263,1,1614,1735,0
116885988111,116885988112,1,1136,1387,0
116887276126,116887276126,0,1300,1403,0
116889352465,116889352466,1,1390,2224,0
116892217865,116892217863,-2,1287,1354,0
116893812447,116893812448,1,1773,2075,0
116894396550,116894396551,1,1131,1936,0
116894720590,116894720591,1,1135,1404,0
116896889873,116896889875,2,950,1460,0
116899526817,116899526817,0,1544,1643,0
116899640599,116899640599,0,924,269,0
116900978534,116900978534,0,956,1591,0
116902934044,116902934044,0,1735,1828,0
116903977039,116903977038,-1,1560,1848,0
116904466998,116904467000,2,1769,1733,0
116907430689,116907430690,1,1100,932,0
116907534498,116907534487,-11,1396,971,0
116908138550,116908138551,1,1723,2478,0
116909637667,116909637669,2,693,736,0
116913377458,116913377455,-3,532,2337,0
116916870661,116916870659,-2,1214,1514,0
116919491258,116919491258,0,1864,2629,0
116923606742,116923606744,2,1191,1549,0
116926381018,116926381017,-1,1138,1671,0
116928132702,116928132702,0,1468,1899,0
116930073271,116930073268,-3,554,1633,0
116930783351,116930783351,0,1371,1353,0
116931517974,116931517976,2,1378,1567,0
116932027473,116932027473,0,1921,1965,0
116932234630,116932234629,-1,1239,1316,0
116935663076,116935663076,0,1404,1098,0
116937491004,116937491005,1,1643,2012,0
116942199506,116942199505,-1,1450,1583,0
116943968958,116943968962,4,1049,894,0
116945144371,116945144371,0,980,1095,0
116949199702,116949199701,-1,1672,2319,0
116950167325,116950167328,3,1694,1623,0
116952231011,116952231014,3,2303,1506,0
116952776087,116952776087,0,999,1460,0
116955898578,116955898578,0,900,1043,0
116956872684,116956872703,19,2886,4282,0
116957120717,116957120716,-1,2534,3538,0
116958372684,116958372685,1,1096,1360,0
116960946769,116960946768,-1,1026,1555,0
116961045907,116961045906,-1,759,1061,0
116961791069,116961791069,0,1422,1887,0
116963187366,116963187368,2,1014,1112,0
116964389797,116964389798,1,1179,2011,0
116964508640,116964508642,2,1665,2087,0
116967494013,116967494013,0,1283,1408,0
116970101809,116970101809,0,1159,1636,0
116972542454,116972542450,-4,1291,2828,0
116973941530,116973941529,-1,1203,1872,0
116975721391,116975721393,2,1603,1332,0
116977395789,116977395787,-2,1835,1528,0
116978628316,116978628314,-2,928,1588,0
116978858120,116978858097,-23,1067,1756,0
116980954906,116980954905,-1,1240,2671,0
116981741783,116981741787,4,1385,1062,0
116983555041,116983555042,1,1572,1483,0
116984817962,116984817963,1,1397,1476,0
116986654779,116986654781,2,1826,1725,0
116986834857,116986834858,1,1258,1185,0
116987029450,116987029453,3,1266,1346,0
116988620191,116988620193,2,1620,1825,0
116991319841,116991319840,-1,1271,2377,0
116991375982,116991375983,1,1259,2068,0
116992441639,116992441638,-1,1403,1346,0
116993227723,116993227723,0,979,1275,0
116993467892,116993467893,1,1566,1861,0
116995381900,116995381902,2,1873,2438,0
116997227578,116997227578,0,931,1483,0
117000950911,117000950913,2,829,1860,0
117004889216,117004889217,1,1093,1826,0
117005316805,117005316808,3,1671,1559,0
117005463563,117005463566,3,1292,1638,0
117005586445,117005586445,0,1831,1869,0
117006807902,117006807883,-19,1357,1689,0
117007208318,117007208314,-4,846,1790,0
117008269569,117008269569,0,1380,1415,0
117008708061,117008708061,0,1852,1499,0
117009235912,117009235913,1,1700,1713,0
117011285843,117011285842,-1,1054,1107,0
117013048999,117013049000,1,1178,1632,0
117016090117,117016090118,1,1402,1258,0
117022686087,117022686089,2,1551,1864,0
117023628811,117023628815,4,1454,1099,0
117025832193,117025832200,7,3753,1363,0
117027178185,117027178186,1,1090,1565,0
117029999386,117029999386,0,2086,2262,0
117030293719,117030293721,2,944,1198,0
117032108764,117032108765,1,1348,1560,0
117034004101,117034004100,-1,1228,1383,0
117034940846,117034940842,-4,2001,6820,0
117035318258,117035318260,2,1204,1565,0
117035540829,117035540816,-13,818,215,0
117038528373,117038528372,-1,4076,17381,0
117041396567,117041396567,0,1519,1508,0
117047992350,117047992349,-1,1174,1261,0
117051336069,117051336070,1,1670,1498,0
117052219851,117052219851,0,1457,1761,0
117053362101,117053362102,1,1280,1359,0
117053447754,117053447754,0,1108,1182,0
117058659843,117058659843,0,1124,1485,0
117060274692,117060274694,2,1253,1338,0
117062463951,117062463951,0,1312,1478,0
117065265555,117065265553,-2,956,1506,0
117067514618,117067514615,-3,1069,1221,0
117067668718,117067668718,0,766,1330,0
117068305898,117068305898,0,1428,1934,0
117072360473,117072360475,2,1526,1488,0
117072754571,117072754591,20,1570,1646,0
117077165973,117077165972,-1,405,738,0
117080177147,117080177150,3,1064,1278,0
117081726827,117081726827,0,924,1524,0
117082431436,117082431439,3,10422,6681,0
117083822732,117083822734,2,1567,1639,0
117085268806,117085268806,0,1056,2078,0
117085766751,117085766751,0,1320,1304,0
117087134378,117087134379,1,1472,2114,0
117091596454,117091596455,1,1214,1109,0
117093095137,117093095138,1,979,1339,0
117099150698,117099150698,0,1282,1534,0
117102834981,117102834980,-1,1043,1856,0
117102963481,117102963480,-1,18227,10582,0
117103168097,117103168097,0,1278,1271,0
117103953697,117103953694,-3,1246,1942,0
117104875001,117104875006,5,753,632,0
117107242039,117107242039,0,994,1180,0
117113425273,117113425274,1,1675,2423,0
117114358176,117114358177,1,1595,1514,0
117114542233,117114542234,1,1814,2084,0
117114640010,117114640010,0,1494,1118,0
117115215336,117115215354,18,226,1297,0
117129839614,117129839617,3,1672,2294,0
117130372122,117130372122,0,1583,1646,0
117132333313,117132333316,3,1684,1840,0
117133338723,117133338723,0,1647,1939,0
117135949519,117135949498,-21,851,1148,0
117138259764,117138259766,2,1298,1818,0
117141229409,117141229407,-2,1605,1392,0
117143403050,117143403048,-2,1373,2417,0
117143697162,117143697162,0,1610,1330,0
117143857663,117143857666,3,1416,1691,0
117151311051,117151311051,0,1526,1067,0
117151471165,117151471162,-3,1643,2201,0
117152608722,117152608721,-1,1599,1393,0
117152692794,117152692796,2,1515,1336,0
117153549718,117153549720,2,1514,2221,0
117157936409,117157936407,-2,1322,2092,0
117159056225,117159056225,0,1544,2145,0
117161458278,117161458278,0,1201,1444,0
117162781238,117162781239,1,1089,1148,0
117165394509,117165394508,-1,1524,1464,0
117168277321,117168277322,1,1236,1319,0
117169207705,117169207710,5,1943,1808,0
117171009018,117171009018,0,1395,2216,0
117171734717,117171734718,1,1464,1716,0
117173704062,117173704066,4,1921,1301,0
117179209463,117179209463,0,1252,1353,0
117181886178,117181886181,3,1424,1558,0
117187044405,117187044399,-6,1292,3406,0
117188608043,117188608044,1,1275,1818,0
117189541506,117189541506,0,1337,1519,0
117190579642,117190579643,1,568,789,0
117191106781,117191106778,-3,1161,1291,0
117194492011,117194492013,2,1657,1618,0
117194966678,117194966677,-1,1401,1563,0
117197595815,117197595814,-1,1123,1776,0
117201730977,117201730977,0,1300,1382,0
117203838028,117203838010,-18,127,1289,0
117206989973,117206989971,-2,1376,1522,0
117207184154,117207184154,0,1517,1970,0
117207511702,117207511702,0,882,1302,0
117208065929,117208065929,0,1493,1711,0
117208982357,117208982357,0,1576,2012,0
117213237702,117213237702,0,958,1181,0
117214182361,117214182365,4,1013,1805,0
117214305058,117214305059,1,1194,1509,0
117214413287,117214413287,0,1251,1556,0
117217885774,117217885754,-20,160,1601,0
117219970531,117219970534,3,1472,1207,0
117220815858,117220815858,0,1023,1284,0
117223093826,117223093827,1,1033,1513,0
117223129320,117223129327,7,359,1258,0
117224234257,117224234258,1,1712,2346,0
117225628098,117225628094,-4,1163,1772,0
117226345559,117226345558,-1,1682,1754,0
117229193915,117229193914,-1,2739,4720,0
117229615874,117229615874,0,1719,2519,0
117231050281,117231050282,1,1003,1254,0
117235938854,117235938857,3,1181,1535,0
117237386681,117237386679,-2,1655,1765,0
117238799887,117238799890,3,1451,1337,0
117245349251,117245349263,12,282,1878,0
117246314393,117246314392,-1,1480,1869,0
117247209654,117247209658,4,811,1368,0
117247809292,117247809293,1,1582,1764,0
117248729003,117248729004,1,1487,1719,0
117249553553,117249553554,1,1149,1865,0
117250382975,117250382975,0,1349,1819,0
117251640605,117251640607,2,491,878,0
117252105053,117252105035,-18,1174,1646,0
117255697928,117255697929,1,1520,2159,0
117255767467,117255767466,-1,1172,1424,0
117261696001,117261696003,2,1524,1472,0
117262005665,117262005667,2,2134,2441,0
117262270079,117262270081,2,1321,1800,0
117263644323,117263644322,-1,1236,2129,0
117264759345,117264759345,0,1309,1764,0
117265437414,117265437417,3,722,1126,0
117266672649,117266672650,1,1840,1701,0
117270155822,117270155822,0,1439,2085,0
117272959054,117272959054,0,1359,1975,0
117273628534,117273628535,1,1232,1258,0
117275489707,117275489712,5,1816,1780,0
117277887271,117277887271,0,1721,2068,0
117281957663,117281957664,1,1688,1843,0
117282863136,117282863136,0,1357,1651,0
117284235046,117284235042,-4,929,1395,0
117285697785,117285697782,-3,732,1771,0
117287693871,117287693870,-1,1277,1424,0
117289356159,117289356160,1,1215,1708,0
117291107734,117291107734,0,1222,1695,0
117296784110,117296784110,0,1905,2774,0
117298933259,117298933261,2,1876,1591,0
117303244250,117303244250,0,871,1454,0
117303399184,117303399189,5,1337,1290,0
117307785559,117307785563,4,3745,2301,0
117308288509,117308288510,1,1212,1845,0
117310093953,117310093953,0,959,1901,0
117310589454,117310589454,0,1553,1839,0
117313885442,117313885442,0,1036,2038,0
117318707304,117318707305,1,1125,1888,0
117326052331,117326052332,1,994,1262,0
117326432249,117326432250,1,1613,2213,0
117326667349,117326667353,4,1989,1516,0
117326884979,117326884956,-23,2056,1569,0
117327050165,117327050167,2,973,1447,0
117327506886,117327506887,1,1423,1448,0
117331003973,117331003971,-2,1665,2288,0
117332697285,117332697292,7,1817,1196,0
117333512499,117333512498,-1,1375,2232,0
117335450308,117335450307,-1,1289,1700,0
117336836961,117336836966,5,1684,1381,0
117340033781,117340033781,0,1348,1593,0
117340684954,117340684969,15,1154,1048,0
117341358510,117341358511,1,1389,1489,0
117342980440,117342980439,-1,1311,1650,0
117343727486,117343727486,0,1565,1840,0
117344547714,117344547715,1,1668,1881,0
117345861664,117345861663,-1,1280,1361,0
117346266042,117346266045,3,956,1308,0
117348746618,117348746618,0,1461,1029,0
117351275986,117351275987,1,1562,1577,0
117360151587,117360151587,0,1357,1287,0
117361245111,117361245110,-1,1120,1299,0
117361479231,117361479231,0,1915,2179,0
117363414502,117363414498,-4,1181,2862,0
117364089071,117364089073,2,1171,1701,0
117365566509,117365566531,22,200,1150,0
117369326671,117369326671,0,1064,1459,0
117370877118,117370877118,0,1591,2277,0
117372613708,117372613708,0,1562,1837,0
117374673697,117374673697,0,1995,2057,0
117375420218,117375420222,4,2765,2399,0
117378771035,117378771040,5,3739,1655,0
117381831345,117381831344,-1,1457,3036,0
117383126548,117383126547,-1,895,1133,0
117384444787,117384444789,2,1833,1350,0
117388656315,117388656315,0,1734,1449,0
117389641418,117389641419,1,1159,1881,0
117390233610,117390233610,0,997,1249,0
117391216862,117391216863,1,784,1183,0
117392501370,117392501366,-4,923,3287,0
117393674446,117393674448,2,1813,1969,0
117397472958,117397472958,0,1206,1496,0
117399176017,117399176018,1,1111,1568,0
117399556527,117399556527,0,1405,2055,0
117406153843,117406153843,0,2253,2485,0
117410876552,117410876553,1,1254,1539,0
117413901319,117413901318,-1,1140,1090,0
117418156468,117418156468,0,1414,1850,0
117418430057,117418430056,-1,1530,1493,0
117420789545,117420789546,1,1338,1934,0
117422722909,117422722910,1,946,791,0
117424535810,117424535802,-8,26503,13828,0
117428034063,117428034060,-3,1273,1856,0
117429594605,117429594607,2,1776,1395,0
117430300482,117430300483,1,1387,1297,0
117442165559,117442165568,9,1918,869,0
117443487451,117443487465,14,26684,14107,0
117444186762,117444186762,0,1557,2097,0
117444706242,117444706242,0,1375,1717,0
117446015204,117446015206,2,1635,1906,0
117451638387,117451638386,-1,1335,1452,0
117453784334,117453784333,-1,1269,1610,0
117455286691,117455286697,6,2948,1970,0
117455396939,117455396938,-1,1694,2412,0
117457775094,117457775094,0,1076,1620,0
117459448767,117459448766,-1,612,1263,0
117460108534,117460108531,-3,1723,1943,0
117461247650,117461247651,1,918,1217,0
117462591210,117462591211,1,1314,2200,0
117464847390,117464847393,3,1817,2202,0
117465382177,117465382178,1,1500,2400,0
117466914410,117466914414,4,915,1554,0
117468248982,117468248965,-17,1322,1315,0
117468838385,117468838387,2,1386,1364,0
117472234279,117472234279,0,1360,1049,0
117474165706,117474165706,0,1394,1350,0
117476261056,117476261056,0,1894,2266,0
117476871934,117476871933,-1,4900,8897,0
117477566190,117477566189,-1,981,1283,0
117479954308,117479954310,2,1173,1539,0
117481322974,117481322975,1,892,1183,0
117482162127,117482162128,1,1688,1115,0
117483309769,117483309769,0,898,1879,0
117484090602,117484090598,-4,1549,2950,0
117492654274,117492654272,-2,1237,1610,0
117498600954,117498600960,6,1650,1696,0
117500465706,117500465708,2,1273,1530,0
117501140411,117501140410,-1,1609,1552,0
117501214401,117501214402,1,1207,1404,0
117501500790,117501500790,0,1476,1098,0
117505619881,117505619881,0,1046,1938,0
117509913656,117509913655,-1,9970,13797,0
117511441949,117511441950,1,1575,1537,0
117512372146,117512372145,-1,1359,1534,0
117512397608,117512397626,18,878,1705,0
117512411184,117512411182,-2,213,124,0
117513039803,117513039805,2,1786,1920,0
117515264301,117515264295,-6,1079,4449,0
117517806448,117517806446,-2,891,1276,0
117518467682,117518467681,-1,1045,1392,0
117518513611,117518513610,-1,1494,1703,0
117519874596,117519874597,1,1061,1588,0
117521811230,117521811230,0,964,1787,0
117522021991,117522021990,-1,1115,1481,0
117522178158,117522178178,20,295,1003,0
117522577151,117522577150,-1,1140,1337,0
117526779979,117526779978,-1,878,1303,0
117527212075,117527212074,-1,1376,1985,0
117531072597,117531072597,0,1000,1859,0
117539476539,117539476539,0,1149,1857,0
117548329390,117548329391,1,1686,1739,0
117551533307,117551533307,0,1600,1780,0
117553345603,117553345604,1,1346,1428,0
117555410526,117555410527,1,1163,1476,0
117556887801,117556887799,-2,1403,1079,0
117557118549,117557118553,4,1465,1257,0
117563180790,117563180790,0,1767,2395,0
117563967859,117563967862,3,1469,1531,0
117564846130,117564846112,-18,804,2976,0
117565273726,117565273725,-1,2771,2674,0
117565916312,117565916311,-1,1175,1727,0
117567411591,117567411590,-1,2248,2950,0
117572797938,117572797940,2,1687,1920,0
117575024385,117575024391,6,1309,646,0
117576307090,117576307098,8,10083,42223,0
117580166365,117580166366,1,1522,1508,0
117582901663,117582901663,0,994,2065,0
117585470365,117585470366,1,1436,1430,0
117589292109,117589292110,1,1578,1414,0
117589714651,117589714629,-22,1564,1443,0
117595042385,117595042385,0,1999,1778,0
117599042765,117599042766,1,1340,1166,0
117603442502,117603442502,0,710,1577,0
117605647032,117605647034,2,1345,1714,0
117605785274,117605785265,-9,1196,5605,0
117606357951,117606357949,-2,1448,2261,0
117607888768,117607888768,0,967,1624,0
117610477579,117610477581,2,952,1251,0
117611720129,117611720131,2,1473,1410,0
117612593442,117612593443,1,1112,1423,0
117612892755,117612892755,0,1198,1639,0
117613476226,117613476227,1,1286,1611,0
117616142099,117616142101,2,1437,1507,0
117616631859,117616631859,0,1699,2236,0
117618544273,117618544273,0,2428,2227,0
117623421543,117623421545,2,1921,1846,0
117623471282,117623471284,2,1219,1718,0
117629504358,117629504359,1,1552,1597,0
117635630899,117635630898,-1,1402,1564,0
117643599491,117643599491,0,1768,2435,0
117656691428,117656691430,2,2062,1979,0
117661144690,117661144691,1,1405,1660,0
117666610302,117666610305,3,2285,927,0
117669171721,117669171721,0,1135,1499,0
117669394871,117669394870,-1,1268,2009,0
117670409697,117670409694,-3,1384,2208,0
117672145229,117672145230,1,1031,1797,0
117674632730,117674632730,0,1646,1441,0
117676580074,117676580073,-1,1357,1736,0
117676620391,117676620390,-1,986,1003,0
117678846733,117678846731,-2,1639,1879,0
117680732842,117680732846,4,1292,983,0
117681585949,117681585950,1,1692,1339,0
117681763777,117681763779,2,1701,1524,0
117682287866,117682287868,2,1107,1402,0
117682694591,117682694594,3,1559,963,0
117684195634,117684195635,1,1232,1579,0
117687197905,117687197907,2,1499,1149,0
117689532386,117689532385,-1,9064,10554,0
117690144271,117690144271,0,1942,1617,0
117690943967,117690943970,3,1588,1702,0
117691208391,117691208393,2,1813,1313,0
117691370480,117691370478,-2,1764,1945,0
117697981553,117697981553,0,1396,1924,0
117701476645,117701476644,-1,1243,1775,0
117703401673,117703401675,2,1785,1509,0
117705362667,117705362669,2,1209,1663,0
117707061129,117707061129,0,1179,1286,0
117716365798,117716365800,2,1279,1344,0
117717689203,117717689203,0,1549,1643,0
117720991079,117720991081,2,1374,1065,0
117721569992,117721569976,-16,43,2648,0
117723045094,117723045094,0,1201,2397,0
117724254151,117724254150,-1,2056,2216,0
117726678817,117726678818,1,1099,1950,0
117728925348,117728925354,6,1886,702,0
117730920672,117730920678,6,9058,4053,0
117731596544,117731596549,5,4953,2274,0
117734618317,117734618311,-6,94,6188,0
117737016279,117737016266,-13,1241,1739,0
117739039083,117739039084,1,1812,1512,0
117739597077,117739597077,0,1275,1804,0
117739945529,117739945529,0,1615,1942,0
117741202798,117741202799,1,1979,2304,0
117743862265,117743862266,1,1597,1972,0
117745154294,117745154297,3,975,1855,0
117748223901,117748223901,0,1871,2242,0
117749783829,117749783829,0,1192,2266,0
117750026262,117750026261,-1,880,1788,0
117754235891,117754235890,-1,1307,1816,0
117757599114,117757599114,0,538,1002,0
117757982966,117757982947,-19,941,1060,0
117758219341,117758219341,0,1416,1821,0
117758591798,117758591798,0,936,1853,0
117758679739,117758679742,3,1454,1220,0
117758821673,117758821672,-1,2113,2402,0
117759952842,117759952844,2,2400,1744,0
117761843428,117761843429,1,1911,1373,0
117764594439,117764594439,0,1054,1113,0
117764976714,117764976734,20,1302,1297,0
117766286854,117766286850,-4,2189,6821,0
117768852081,117768852084,3,1374,1317,0
117770030675,117770030675,0,1414,2162,0
117772210127,117772210127,0,1254,1657,0
117772887957,117772887959,2,1391,1160,0
117776619049,117776619049,0,1072,1083,0
117777152714,117777152714,0,1901,2133,0
117777402980,117777402978,-2,981,1666,0
117778132389,117778132391,2,1196,1287,0
117778678075,117778678074,-1,1402,1592,0
117783183645,117783183645,0,1314,1098,0
117784229600,117784229602,2,1495,1989,0
117785107148,117785107151,3,1870,1866,0
117785468885,117785468878,-7,994,958,0
117785750600,117785750602,2,1462,1574,0
117785979924,117785979925,1,1512,1954,0
117787132638,117787132639,1,1665,2458,0
117790783573,117790783573,0,1432,1554,0
117791618887,117791618889,2,1037,1383,0
117792037274,117792037274,0,1278,1320,0
117793002011,117793002013,2,1706,1504,0
117794658306,117794658307,1,956,2100,0
117795209174,117795209157,-17,999,1137,0
117797247795,117797247798,3,1557,1524,0
117802347841,117802347841,0,2043,1833,0
117802743651,117802743651,0,1488,1645,0
117803613730,117803613730,0,897,1719,0
117808548646,117808548646,0,1442,1333,0
117809821941,117809821941,0,1398,1679,0
117811602102,117811602103,1,1529,1564,0
117812531690,117812531692,2,1838,1894,0
117813874851,117813874855,4,3279,2724,0
117815144151,117815144152,1,1575,1444,0
117815361110,117815361111,1,1366,1257,0
117819429030,117819429032,2,1058,1765,0
117820541707,117820541706,-1,1081,1125,0
117821480695,117821480694,-1,987,2000,0
117822515619,117822515619,0,1265,1646,0
117822869565,117822869564,-1,1869,1783,0
117823380689,117823380689,0,1191,1972,0
117824961634,117824961635,1,1062,1167,0
117825431433,117825431432,-1,1440,1816,0
117830951414,117830951414,0,1676,1719,0
117831042117,117831042113,-4,806,1520,0
117831577007,117831577007,0,1223,1469,0
117832437368,117832437367,-1,1312,2115,0
117833583618,117833583617,-1,1362,2015,0
117834809145,117834809145,0,1256,1600,0
117835079696,117835079698,2,933,1381,0
117837884605,117837884611,6,3126,1325,0
117838048937,117838048939,2,2013,2260,0
117838101331,117838101331,0,779,1311,0
117838825086,117838825091,5,1537,916,0
117842364222,117842364222,0,1198,1281,0
117847475911,117847475910,-1,1523,1463,0
117849724034,117849724036,2,827,1110,0
117855080652,117855080652,0,1793,2305,0
117855969326,117855969325,-1,1157,1814,0
117857735550,117857735550,0,1438,2118,0
117858082366,117858082366,0,1072,1635,0
117862663586,117862663606,20,1207,1531,0
117865389398,117865389398,0,1194,1745,0
117866727562,117866727563,1,1715,2202,0
117867778622,117867778621,-1,1479,1119,0
117870489822,117870489822,0,1131,1576,0
117875249505,117875249505,0,1003,1674,0
117882349660,117882349679,19,1504,1173,0
117882536529,117882536530,1,1127,1839,0
117884059729,117884059735,6,2910,1640,0
117886870882,117886870890,8,4104,1193,0
117886938989,117886938993,4,1798,1427,0
117888818626,117888818627,1,1351,1866,0
117889261158,117889261163,5,1812,621,0
117889996027,117889996028,1,1442,2074,0
117891956845,117891956847,2,1925,1307,0
117893170402,117893170402,0,1062,1663,0
117893577270,117893577291,21,1912,2270,0
117896684907,117896684910,3,969,1491,0
117897410679,117897410678,-1,1543,1948,0
117898909535,117898909534,-1,1311,1075,0
117899424614,117899424611,-3,1191,1566,0
117899931281,117899931282,1,1059,1129,0
117900906937,117900906937,0,1375,2213,0
117901200205,117901200206,1,1016,1150,0
117902969554,117902969555,1,1427,1746,0
117906346791,117906346791,0,2037,2370,0
117906487053,117906487051,-2,1247,1378,0
117913936162,117913936146,-16,1426,1978,0
117916362477,117916362481,4,1760,1560,0
117916552090,117916552089,-1,1323,2385,0
117916640998,117916641001,3,1546,2162,0
117921879810,117921879792,-18,886,1503,0
117922261445,117922261445,0,1149,1391,0
117922429770,117922429774,4,1638,1613,0
117922904594,117922904590,-4,945,1945,0
117924060498,117924060496,-2,588,935,0
117926136270,117926136270,0,1521,1454,0
117927915019,117927915018,-1,1322,1281,0
117936181330,117936181330,0,1381,2254,0
117939147450,117939147450,0,1583,1416,0
117943162114,117943162114,0,1160,1910,0
117946006386,117946006390,4,2303,2103,0
117946435990,117946435989,-1,1265,2019,0
117951847403,117951847403,0,1279,1369,0
117954753985,117954753985,0,1349,1822,0
117955299562,117955299562,0,1686,1888,0
117956131238,117956131238,0,912,1197,0
117959229319,117959229297,-22,1141,1533,0
117962306889,117962306890,1,1610,1979,0
117968332233,117968332234,1,963,833,0
117968793229,117968793231,2,1524,1433,0
117970840906,117970840906,0,1407,1621,0
117972382799,117972382798,-1,1308,1925,0
117973480383,117973480387,4,1169,1028,0
117975024370,117975024370,0,1080,2047,0
117977804990,117977804990,0,1731,1958,0
117978294758,117978294757,-1,1384,2234,0
117979650463,117979650462,-1,1194,1386,0
117981190303,117981190302,-1,1685,1408,0
117982132457,117982132457,0,1212,1994,0
117983057150,117983057131,-19,732,1444,0
117983637673,117983637673,0,1329,1811,0
117985383515,117985383515,0,1468,1423,0
117986609485,117986609486,1,1538,1976,0
117987398601,117987398603,2,1494,1240,0
117988260146,117988260146,0,1197,1703,0
117988640036,117988640033,-3,1456,1467,0
117988858325,117988858326,1,1361,2179,0
117989057793,117989057794,1,1321,1897,0
117989329303,117989329302,-1,1166,2312,0
117990913508,117990913507,-1,1372,1551,0
117991291735,117991291736,1,1332,2136,0
117993560690,117993560690,0,1364,1313,0
117994485574,117994485578,4,1906,1087,0
117995231538,117995231539,1,1130,1846,0
117998789787,117998789788,1,1691,2011,0
117999516315,117999516316,1,1397,2146,0
118006745057,118006745059,2,1578,1434,0
118010424843,118010424842,-1,891,1665,0
118017455951,118017455950,-1,1142,1924,0
118019098020,118019098018,-2,1034,1391,0
118020135863,118020135865,2,1165,1405,0
118020861582,118020861582,0,1285,1821,0
118021744689,118021744689,0,912,1319,0
118022576799,118022576801,2,1616,2069,0
118023861037,118023861040,3,1142,1421,0
118024496871,118024496890,19,946,942,0
118025562202,118025562201,-1,1284,1593,0
118027208470,118027208476,6,1398,1096,0
118030055247,118030055248,1,1643,1873,0
118030190522,118030190522,0,1116,1038,0
118033233845,118033233844,-1,1727,2074,0
118034682436,118034682438,2,1199,1763,0
118039683950,118039683951,1,1411,1770,0
118041381100,118041381105,5,2119,1292,0
118045996489,118045996490,1,1124,1465,0
118047234645,118047234642,-3,991,2790,0
118053105662,118053105661,-1,526,1103,0
118053788374,118053788371,-3,967,2124,0
118054638126,118054638129,3,1111,1499,0
118058235908,118058235909,1,1867,2011,0
118060452722,118060452721,-1,1212,1768,0
118065266042,118065266044,2,1446,1713,0
118067482712,118067482713,1,1597,1872,0
118069070307,118069070308,1,1566,2117,0
118076408259,118076408254,-5,1238,5683,0
118076842742,118076842744,2,926,1415,0
118079204809,118079204809,0,1345,1567,0
118079918256,118079918271,15,5,779,0
118083013869,118083013870,1,1073,1488,0
118084066308,118084066301,-7,2982,7097,0
118084834582,118084834586,4,1733,1273,0
118086530697,118086530697,0,1828,1804,0
118092324546,118092324546,0,1376,1690,0
118093012076,118093012077,1,1910,1774,0
118094583991,118094583993,2,1550,1653,0
118095491330,118095491329,-1,1461,1306,0
118095789430,118095789418,-12,135,800,0
118099050868,118099050867,-1,1708,1698,0
118101228474,118101228470,-4,1098,2062,0
118104138739,118104138739,0,1461,1749,0
118106020431,118106020430,-1,1469,1384,0
118107453202,118107453205,3,1698,1998,0
118108514394,118108514396,2,1609,1814,0
118109385471,118109385471,0,1309,1779,0
118112925146,118112925149,3,11208,7104,0
118113080183,118113080186,3,1384,1409,0
118122665074,118122665075,1,1478,1565,0
118125735727,118125735728,1,1352,1151,0
118127420617,118127420618,1,1267,1771,0
118127474277,118127474283,6,3556,1484,0
118130131090,118130131086,-4,1214,3733,0
118131518117,118131518118,1,1312,1667,0
118132525737,118132525739,2,1859,1919,0
118134402408,118134402409,1,1558,1970,0
118134645422,118134645421,-1,1283,1639,0
118137408214,118137408218,4,1133,1437,0
118138148218,118138148219,1,1447,1877,0
118138281533,118138281533,0,2095,2403,0
118140190177,118140190177,0,2059,2920,0
118140559194,118140559197,3,1002,1648,0
118145949894,118145949896,2,1665,2042,0
118149790942,118149790943,1,1341,1585,0
118152193031,118152193029,-2,1415,1825,0
118154218861,118154218841,-20,1019,1799,0
118154640954,118154640959,5,1703,1242,0
118164641493,118164641494,1,2415,3352,0
118167672893,118167672891,-2,985,1682,0
118171053179,118171053178,-1,1083,1429,0
118171467603,118171467605,2,2189,1984,0
118173853109,118173853110,1,1839,2037,0
118180206187,118180206187,0,1259,1263,0
118183450189,118183450194,5,3416,1762,0
118186498944,118186498946,2,941,1487,0
118188477085,118188477085,0,1477,1427,0
118189760957,118189760955,-2,1418,1506,0
118190818574,118190818573,-1,1198,1591,0
118191293239,118191293237,-2,1377,2549,0
118192917389,118192917391,2,1243,2010,0
118193671230,118193671229,-1,2003,2251,0
118194030105,118194030103,-2,1185,1826,0
118194948257,118194948257,0,1223,1862,0
118196551646,118196551646,0,1613,1917,0
118198533414,118198533413,-1,1516,1580,0
118200181557,118200181563,6,6491,1926,0
118203152401,118203152399,-2,1616,2178,0
118207520390,118207520389,-1,1249,1426,0
118208509230,118208509233,3,1682,1394,0
118211435739,118211435742,3,1451,1825,0
118211695108,118211695106,-2,1041,1598,0
118212913814,118212913815,1,1214,1706,0
118220034165,118220034166,1,1446,1161,0
118229158074,118229158074,0,1316,1745,0
118229529446,118229529447,1,1675,1808,0
118233346098,118233346102,4,1553,1672,0
118234937898,118234937897,-1,1219,1617,0
118235866371,118235866372,1,1520,1557,0
118235966464,118235966465,1,1971,4102,0
118236963069,118236963066,-3,795,1193,0
118237155669,118237155691,22,1729,5008,0
118242632682,118242632683,1,2045,1422,0
118243907897,118243907898,1,1498,1312,0
118245655277,118245655280,3,1596,1995,0
118246024899,118246024900,1,1263,1553,0
118247836002,118247836002,0,1266,1710,0
118247912441,118247912448,7,20665,37334,0
118248659246,118248659245,-1,1653,1229,0
118259840250,118259840250,0,1106,2639,0
118261355871,118261355871,0,1636,2010,0
118263850141,118263850141,0,1312,1603,0
118264545373,118264545373,0,988,1555,0
118264726695,118264726696,1,997,1292,0
118265269591,118265269591,0,1323,1949,0
118265719234,118265719234,0,1371,1750,0
118273050385,118273050385,0,488,1129,0
118277438749,118277438751,2,1140,1792,0
118278955985,118278955966,-19,1363,1666,0
118279214934,118279214935,1,1563,1479,0
118282811634,118282811635,1,1913,1673,0
118283178037,118283178035,-2,1488,2352,0
118284457193,118284457194,1,1215,1679,0
118287410201,118287410201,0,1565,2054,0
118288276553,118288276554,1,1332,1711,0
118292890769,118292890771,2,1884,1292,0
118294270482,118294270483,1,1578,1685,0
118299548454,118299548457,3,2145,1887,0
118300316992,118300316989,-3,906,2067,0
118303294962,118303294983,21,498,639,0
118303973251,118303973254,3,1880,1367,0
118304494473,118304494474,1,1329,1196,0
118306534608,118306534609,1,1615,2133,0
118309990208,118309990207,-1,728,1045,0
118311628695,118311628696,1,1158,1904,0
118312348141,118312348143,2,1392,1691,0
118315932648,118315932644,-4,1353,1856,0
118316272689,118316272690,1,1171,1895,0
118317685926,118317685925,-1,1342,2018,0
118318806641,118318806641,0,1263,1857,0
118318997494,118318997498,4,1117,914,0
118319542901,118319542902,1,1278,1249,0
118327416862,118327416863,1,1176,1653,0
118327787378,118327787374,-4,23458,59877,0
118328466799,118328466800,1,1367,1366,0
118329382594,118329382594,0,674,993,0
118330328551,118330328550,-1,954,2070,0
118334718894,118334718894,0,1362,1801,0
118338339829,118338339826,-3,790,2615,0
118342857014,118342857014,0,1370,1363,0
118345538562,118345538561,-1,1073,1652,0
118346169536,118346169535,-1,1569,1760,0
118348417134,118348417134,0,1255,1685,0
118349550564,118349550563,-1,1071,1649,0
118353872418,118353872418,0,1118,1364,0
118355055796,118355055797,1,1013,1002,0
118357820433,118357820438,5,2940,1807,0
118358050791,118358050790,-1,1346,1653,0
118361827051,118361827049,-2,1580,2147,0
118362524730,118362524731,1,1929,2333,0
118365058141,118365058141,0,1414,1683,0
118367719880,118367719883,3,1709,1228,0
118369428525,118369428525,0,1336,1509,0
118370887106,118370887106,0,1181,2147,0
118371451349,118371451346,-3,1712,1931,0
118372313582,118372313584,2,1141,1238,0
118375204354,118375204351,-3,1625,2506,0
118375267013,118375266998,-15,1014,2619,0
118376487709,118376487706,-3,857,2492,0
118378100801,118378100814,13,973,1163,0
118380881790,118380881790,0,1007,1021,0
118381166082,118381166083,1,1771,1544,0
118381523597,118381523606,9,1299,1082,0
118384563461,118384563459,-2,843,1170,0
118386053123,118386053122,-1,1304,1656,0
118387161922,118387161923,1,2118,3130,0
118390223102,118390223103,1,1560,1718,0
118390750048,118390750049,1,1839,1272,0
118391463876,118391463877,1,1157,1313,0
118392200615,118392200615,0,1842,1849,0
118396309617,118396309618,1,1474,1349,0
118401311012,118401311012,0,1655,1492,0
118402667432,118402667433,1,1337,1553,0
118404963599,118404963602,3,1420,1395,0
118405189915,118405189922,7,6454,2545,0
118407568419,118407568420,1,1107,1279,0
118408666922,118408666920,-2,1449,2214,0
118409155686,118409155687,1,1153,1419,0
118409755719,118409755719,0,940,963,0
118412921451,118412921449,-2,1404,1118,0
118416646532,118416646534,2,2411,1998,0
118424698867,118424698867,0,1519,1493,0
118425402206,118425402206,0,1064,1752,0
118425739780,118425739780,0,1479,1734,0
118428519621,118428519620,-1,1288,1242,0
118428954466,118428954466,0,1806,2284,0
118429620315,118429620316,1,1374,1948,0
118432034385,118432034385,0,1272,1789,0
118432652587,118432652588,1,854,1552,0
118432834330,118432834332,2,1306,1136,0
118435219739,118435219739,0,1404,1302,0
118437467151,118437467149,-2,1152,1366,0
118438006229,118438006231,2,2021,2641,0
118440250469,118440250467,-2,1391,1354,0
118441268469,118441268469,0,1474,2513,0
118444792683,118444792693,10,1320,1558,0
118447935413,118447935414,1,865,958,0
118450506791,118450506790,-1,1151,2376,0
118451788422,118451788422,0,1364,1949,0
118454635749,118454635749,0,1203,2271,0
118458508702,118458508705,3,1894,1619,0
118466120930,118466120932,2,818,1393,0
118467325378,118467325385,7,3467,1452,0
118471412133,118471412131,-2,1267,1477,0
118471964387,118471964389,2,992,1115,0
118473446335,118473446334,-1,924,1062,0
118479365361,118479365361,0,917,1880,0
118485781470,118485781469,-1,1542,2341,0
118487368855,118487368855,0,1944,1578,0
118487707422,118487707421,-1,804,1641,0
118489623601,118489623601,0,1302,1367,0
118493581409,118493581408,-1,1461,1937,0
118496126215,118496126217,2,816,1512,0
118498499955,118498499956,1,1353,2030,0
118511039468,118511039469,1,1628,1757,0
118512661238,118512661239,1,2018,2017,0
118522134068,118522134069,1,1395,2197,0
118522967106,118522967108,2,1395,1912,0
118524849865,118524849866,1,1344,1311,0
118525494327,118525494329,2,1648,1301,0
118526634470,118526634470,0,1204,2293,0
118530934614,118530934616,2,1261,1518,0
118531228581,118531228582,1,1947,2628,0
118531355936,118531355936,0,1722,1876,0
118540724839,118540724838,-1,1146,1797,0
118541845384,118541845386,2,1670,2565,0
118546175186,118546175188,2,1710,1846,0
118551902278,118551902279,1,1271,2255,0
118552484857,118552484856,-1,1265,1727,0
118552543966,118552543962,-4,120,1343,0
118552579271,118552579270,-1,1197,1374,0
118553119060,118553119061,1,1646,2083,0
118557189821,118557189821,0,1580,2020,0
118559967764,118559967764,0,1503,1759,0
118565661499,118565661502,3,990,1573,0
118567123245,118567123246,1,1799,1607,0
118567293194,118567293190,-4,411,1056,0
118569628536,118569628559,23,297,593,0
118581907999,118581907999,0,1159,1931,0
118583090259,118583090259,0,1150,1513,0
118584425198,118584425197,-1,1319,1660,0
118585387046,118585387048,2,1016,1145,0
118585907654,118585907646,-8,244,249,0
118589819563,118589819567,4,1394,1082,0
118589892594,118589892597,3,1851,2551,0
118594106843,118594106844,1,1160,1444,0
118596295351,118596295353,2,1485,1943,0
118597589631,118597589635,4,1418,1036,0
118603135301,118603135301,0,1392,1980,0
118603234368,118603234370,2,1307,1835,0
118604207713,118604207714,1,1082,1174,0
118606757505,118606757507,2,1716,1334,0
118606935158,118606935175,17,940,993,0
118607419550,118607419550,0,1481,1238,0
118610420587,118610420587,0,910,1879,0
118612459495,118612459473,-22,1685,1783,0
118614527550,118614527551,1,9691,9542,0
118621085974,118621085975,1,1260,1525,0
118622307459,118622307458,-1,1220,1517,0
118623904602,118623904603,1,1075,1477,0
118624149042,118624149042,0,1297,2251,0
118630233314,118630233314,0,1775,2015,0
118634340837,118634340838,1,1831,2670,0
118637562068,118637562066,-2,1011,1427,0
118638856350,118638856351,1,2031,1807,0
118639307922,118639307922,0,1190,1888,0
118639477917,118639477918,1,1609,1899,0
118641058878,118641058877,-1,1664,1846,0
118641986511,118641986510,-1,1431,1677,0
118642264543,118642264543,0,1230,925,0
118646015243,118646015242,-1,1475,2444,0
118646941397,118646941397,0,1381,1729,0
118647556805,118647556826,21,1412,2082,0
118648456976,118648456969,-7,1345,4725,0
118650184796,118650184797,1,1150,1517,0
118650661892,118650661891,-1,1083,1239,0
118652143745,118652143745,0,915,921,0
118652544438,118652544437,-1,1706,2483,0
118655498595,118655498595,0,1502,1747,0
118657580054,118657580054,0,1834,1581,0
118659512389,118659512391,2,1464,1385,0
118659981307,118659981310,3,1244,1834,0
118661564486,118661564487,1,1973,2704,0
118662224823,118662224819,-4,1252,2056,0
118662494859,118662494857,-2,1317,1733,0
118662630345,118662630347,2,1091,2092,0
118663712071,118663712076,5,1245,1066,0
118668313098,118668313096,-2,1248,1760,0
118668453915,118668453918,3,1232,1000,0
118671106705,118671106705,0,1635,1667,0
118671311637,118671311630,-7,871,1392,0
118671865942,118671865941,-1,1649,1624,0
118677884829,118677884830,1,971,1022,0
118678375573,118678375574,1,1453,1760,0
118682012755,118682012754,-1,1322,1710,0
118684858795,118684858796,1,2158,2137,0
118686227701,118686227702,1,1211,1171,0
118687548862,118687548866,4,1233,1159,0
118689906122,118689906128,6,2984,1797,0
118690387514,118690387496,-18,1146,1582,0
118690592497,118690592498,1,1697,1737,0
118692607114,118692607118,4,1731,1568,0
118693498158,118693498161,3,2044,1685,0
118693918731,118693918732,1,1451,1373,0
118697162975,118697162973,-2,1316,2071,0
118697470200,118697470216,16,775,1268,0
118698577565,118698577566,1,1365,1690,0
118700576045,118700576045,0,1120,1524,0
118704011170,118704011172,2,1327,2393,0
118709149955,118709149954,-1,1368,1605,0
118709361565,118709361562,-3,1193,1937,0
118710279360,118710279360,0,1197,1607,0
118711163404,118711163398,-6,2126,7450,0
118711266910,118711266909,-1,1506,1238,0
118716973664,118716973665,1,1902,2202,0
118721738766,118721738769,3,2108,1712,0
118726004110,118726004110,0,1480,1942,0
118726662237,118726662237,0,1438,2492,0
118733165198,118733165193,-5,2509,9471,0
118734743732,118734743732,0,1301,1435,0
118735894248,118735894249,1,1712,2230,0
118737966290,118737966290,0,1047,1263,0
118738676670,118738676672,2,1661,1460,0
118741155958,118741155958,0,1657,1666,0
118741181348,118741181347,-1,1360,1636,0
118741400103,118741400102,-1,1507,1318,0
118741426527,118741426529,2,1617,1657,0
118743112305,118743112306,1,1483,1628,0
118745917712,118745917712,0,793,1220,0
118752188302,118752188299,-3,956,1147,0
118752386953,118752386953,0,1460,1718,0
118757891609,118757891610,1,1362,1684,0
118758000594,118758000594,0,1123,1584,0
118759670331,118759670351,20,795,1608,0
118760016279,118760016278,-1,1056,1598,0
118762024366,118762024369,3,1957,1400,0
118762622174,118762622174,0,1405,1905,0
118764844487,118764844487,0,1386,2196,0
118768084817,118768084819,2,1268,1542,0
118768895230,118768895230,0,1361,1368,0
118770683614,118770683609,-5,1134,3445,0
118770953107,118770953106,-1,1296,2169,0
118771177802,118771177802,0,1294,1736,0
118772465738,118772465741,3,2266,1795,0
118773204160,118773204161,1,1876,2201,0
118773800881,118773800882,1,986,1812,0
118775772017,118775772019,2,2003,1268,0
118781266928,118781266930,2,1334,1241,0
118781365906,118781365906,0,1522,2074,0
118781859178,118781859181,3,1130,1200,0
118785549006,118785549007,1,1460,2072,0
118788212275,118788212277,2,1559,1566,0
118789387942,118789387943,1,722,679,0
118793673726,118793673725,-1,1354,1431,0
118794125586,118794125590,4,1259,1593,0
118796137539,118796137538,-1,1077,786,0
118796548382,118796548366,-16,222,1620,0
118802778821,118802778821,0,1461,2213,0
118803838062,118803838063,1,1321,1314,0
118805000283,118805000284,1,1806,1505,0
118805534678,118805534678,0,1823,1770,0
118808888289,118808888291,2,1120,1715,0
118813532018,118813532018,0,867,1282,0
118813661409,118813661410,1,2739,3018,0
118820450394,118820450393,-1,819,2005,0
118823477299,118823477300,1,1440,1413,0
118823844369,118823844368,-1,1886,1768,0
118827586626,118827586626,0,1229,1655,0
118832519063,118832519063,0,1582,1691,0
118834988090,118834988091,1,1406,1438,0
118835982574,118835982595,21,1560,1545,0
118838307495,118838307493,-2,1442,1478,0
118840120046,118840120046,0,1491,1272,0
118840615033,118840615034,1,1923,1843,0
118844393832,118844393831,-1,1438,1774,0
118844517981,118844517980,-1,1563,1589,0
118845817137,118845817138,1,1312,1184,0
118848623979,118848623979,0,1107,1115,0
118849134325,118849134326,1,1726,1791,0
118854479471,118854479470,-1,743,1054,0
118857203276,118857203278,2,1514,1264,0
118861400609,118861400612,3,1212,1614,0
118861898359,118861898361,2,1433,1612,0
118863903514,118863903513,-1,1428,2518,0
118863977513,118863977513,0,1152,2104,0
118864391950,118864391951,1,1505,1633,0
118864431425,118864431426,1,1590,1477,0
118865193917,118865193920,3,1939,2126,0
118866070582,118866070586,4,1103,1110,0
118866943584,118866943584,0,1526,1497,0
118867399657,118867399658,1,2055,1875,0
118868745138,118868745139,1,1765,1769,0
118869353083,118869353082,-1,1416,1619,0
118870134930,118870134930,0,1625,2202,0
118873462802,118873462801,-1,1266,1895,0
118874189317,118874189319,2,1599,1551,0
118878754299,118878754298,-1,1177,1254,0
118883066629,118883066637,8,1083,970,0
118883624122,118883624129,7,11751,21338,0
118885725218,118885725218,0,1146,1459,0
118886637502,118886637504,2,778,902,0
118887548462,118887548462,0,782,1432,0
118890328256,118890328261,5,1566,1139,0
118896134938,118896134938,0,1506,1295,0
118896482630,118896482634,4,1561,1153,0
118903844259,118903844259,0,1012,1891,0
118905403346,118905403346,0,1392,1892,0
118906550611,118906550605,-6,1171,4094,0
118907148820,118907148821,1,1545,2006,0
118908475140,118908475143,3,1531,1649,0
118909463134,118909463134,0,1577,2171,0
118913102583,118913102587,4,1774,1579,0
118915849926,118915849928,2,1622,1910,0
118918585365,118918585366,1,1468,1731,0
118918937679,118918937679,0,1219,1718,0
118924714328,118924714329,1,1415,1647,0
118927254158,118927254158,0,1236,1887,0
118927734775,118927734781,6,3089,1380,0
118928919153,118928919155,2,1433,2134,0
118935693911,118935693910,-1,1293,1603,0
118937443176,118937443177,1,1855,2420,0
118938390087,118938390086,-1,1467,1828,0
118942592666,118942592666,0,1553,1847,0
118943269462,118943269462,0,1564,2247,0
118943933146,118943933146,0,1009,960,0
118946237705,118946237708,3,1590,923,0
118950447130,118950447129,-1,1580,1254,0
118951350392,118951350401,9,27,3768,0
118951800430,118951800432,2,1370,1579,0
118953581967,118953581970,3,930,1492,0
118954155569,118954155564,-5,1332,9045,0
118955663002,118955663003,1,963,1519,0
118965169835,118965169835,0,1324,1680,0
118965387995,118965387997,2,1515,1153,0
118966330294,118966330296,2,1077,1381,0
118967746560,118967746560,0,1473,2345,0
118971267090,118971267085,-5,1164,3499,0
118971530822,118971530823,1,1490,1814,0
118972632236,118972632236,0,1828,1938,0
118977443631,118977443630,-1,1013,1581,0
118978406135,118978406134,-1,1202,1616,0
118984595045,118984595048,3,1351,1494,0
