fTNear,fTFar,fDelT,fQNear,fQFar,d
119183968398,119183968399,1,33,46,10
1734208,1734209,1,974,2009,10
1842189,1842187,-2,1458,1826,10
2678295,2678294,-1,898,1063,10
9281442,9281439,-3,1555,3147,10
11225641,11225639,-2,1426,2256,10
12211437,12211435,-2,1443,2464,10
14148170,14148170,0,1277,1775,10
15634344,15634345,1,1106,1835,10
18682347,18682345,-2,1008,2022,10
19172778,19172777,-1,1138,2012,10
22025875,22025874,-1,1485,1894,10
22242429,22242427,-2,1273,2047,10
24344566,24344563,-3,1445,2611,10
25757787,25757785,-2,1205,2149,10
26930893,26930893,0,787,1665,10
28955846,28955842,-4,2297,4202,10
29318953,29318950,-3,1134,1988,10
32136195,32136194,-1,1471,2359,10
32517369,32517369,0,3387,3351,10
39905682,39905678,-4,1328,3661,10
44507947,44507945,-2,778,1804,10
44546049,44546046,-3,874,2300,10
47031606,47031605,-1,1062,1910,10
48712507,48712512,5,2732,1416,10
50429239,50429237,-2,1140,2596,10
50567256,50567251,-5,1423,2074,10
52319987,52319987,0,1083,1793,10
54691523,54691522,-1,1590,1992,10
55689832,55689828,-4,1781,2769,10
57903556,57903553,-3,1226,1808,10
65001274,65001273,-1,1142,1597,10
65065239,65065238,-1,1146,1646,10
66689876,66689894,18,1168,2510,10
66986499,66986498,-1,1947,3736,10
67161364,67161364,0,1414,2620,10
69531050,69531049,-1,1373,1979,10
69735100,69735099,-1,990,2015,10
70225825,70225822,-3,1112,2089,10
71269867,71269866,-1,953,1418,10
71754258,71754257,-1,1124,1981,10
73563965,73563966,1,1277,2173,10
73845924,73845918,-6,790,3549,10
85148707,85148707,0,860,1453,10
87244487,87244489,2,841,1179,10
87532472,87532471,-1,1796,1992,10
90010275,90010270,-5,909,3726,10
91992749,91992749,0,903,1654,10
95658059,95658055,-4,1199,1888,10
95696242,95696236,-6,931,1573,10
95900130,95900130,0,1217,1772,10
96626209,96626207,-2,1279,1909,10
100620309,100620308,-1,965,1965,10
103554136,103554136,0,1530,3099,10
109219991,109219987,-4,1026,1879,10
111459982,111459982,0,1158,1933,10
112030131,112030131,0,971,1884,10
116714452,116714449,-3,1149,2451,10
117121926,117121904,-22,2096,1083,10
117336081,117336080,-1,1091,2406,10
125519541,125519540,-1,1240,827,10
132081566,132081563,-3,1031,2380,10
135550066,135550066,0,1438,1951,10
135967643,135967641,-2,979,2110,10
136229348,136229346,-2,1109,1608,10
138162395,138162402,7,2893,1216,10
138404651,138404650,-1,943,2021,10
141725846,141725846,0,1420,2386,10
147521039,147521039,0,1900,2080,10
147646422,147646422,0,2252,3237,10
149618162,149618162,0,1162,1885,10
151280266,151280263,-3,1178,2426,10
166229894,166229893,-1,1504,1189,10
169803154,169803154,0,1351,2846,10
178368145,178368144,-1,1189,2034,10
179183015,179183013,-2,1518,2288,10
184074975,184074973,-2,1681,2376,10
185799091,185799091,0,1511,1824,10
187145846,187145847,1,1249,2026,10
187318427,187318427,0,1596,2777,10
187884678,187884674,-4,1335,1711,10
193143290,193143291,1,890,1287,10
194019469,194019469,0,1161,1687,10
195613704,195613702,-2,720,1259,10
207123010,207123008,-2,1258,1792,10
219039024,219039029,5,11611,6857,10
221956011,221956009,-2,509,801,10
223966170,223966170,0,1561,2253,10
224299527,224299534,7,2942,1568,10
225541572,225541570,-2,1590,2674,10
226732982,226732979,-3,1286,1792,10
227295262,227295261,-1,837,2320,10
229067541,229067539,-2,777,1686,10
231287493,231287491,-2,1036,1435,10
232241466,232241466,0,1112,1945,10
232812798,232812798,0,1244,1303,10
242186770,242186773,3,1618,2001,10
244290043,244290040,-3,938,1510,10
250857773,250857769,-4,1287,1751,10
255856413,255856411,-2,1377,2851,10
256282914,256282914,0,1357,2376,10
260300926,260300924,-2,1356,2293,10
263957972,263957970,-2,1260,2281,10
266979390,266979389,-1,1100,2468,10
270011471,270011470,-1,1951,1833,10
270973154,270973153,-1,1341,1950,10
272198012,272198011,-1,1522,1907,10
274899143,274899141,-2,907,1886,10
276543437,276543437,0,1386,1759,10
278031265,278031269,4,3375,2286,10
287714974,287714995,21,886,1188,10
289097033,289097031,-2,866,1332,10
294723867,294723868,1,1702,2425,10
295559070,295559070,0,1055,1356,10
297953890,297953891,1,1439,1326,10
302690090,302690095,5,3488,1602,10
305936131,305936128,-3,1595,1845,10
306701293,306701296,3,1595,1755,10
307471884,307471883,-1,1005,1692,10
308312174,308312171,-3,693,1334,10
310178603,310178601,-2,1083,1447,10
311557677,311557675,-2,1066,2054,10
312804506,312804503,-3,1049,1535,10
313706626,313706624,-2,1125,1962,10
319365497,319365494,-3,1289,2369,10
325409846,325409843,-3,1215,2478,10
325695390,325695389,-1,1354,2169,10
326903303,326903301,-2,1339,1694,10
332264792,332264791,-1,1526,3221,10
332492337,332492358,21,1024,1177,10
334757165,334757162,-3,1100,1852,10
339252254,339252252,-2,1236,1939,10
351396238,351396237,-1,1008,1716,10
354005502,354005503,1,958,1872,10
359120973,359120971,-2,1468,1468,10
360571042,360571041,-1,758,1799,10
366004293,366004291,-2,1539,2330,10
366055243,366055261,18,847,1703,10
368867891,368867886,-5,1512,3700,10
372362520,372362518,-2,830,1095,10
374665415,374665414,-1,1317,1596,10
374849947,374849963,16,785,1674,10
381230923,381230918,-5,1251,3029,10
384236533,384236533,0,991,1941,10
386491225,386491226,1,1184,2062,10
386640731,386640730,-1,1502,2050,10
386691518,386691518,0,1206,1829,10
387946941,387946937,-4,1362,2909,10
388167794,388167791,-3,1661,2579,10
389815294,389815294,0,1536,2517,10
389957314,389957315,1,772,983,10
391888671,391888670,-1,806,1774,10
393100875,393100875,0,873,1086,10
393338746,393338747,1,544,1155,10
394212875,394212869,-6,987,2814,10
394639719,394639718,-1,938,2022,10
394771403,394771404,1,1825,2271,10
400883230,400883230,0,2244,1760,10
404263503,404263500,-3,1552,2757,10
404414770,404414766,-4,838,1760,10
408070073,408070070,-3,1000,2069,10
415110194,415110193,-1,34418,54852,10
418024514,418024511,-3,527,1179,10
421154499,421154502,3,1763,1526,10
423981939,423981937,-2,1151,1299,10
429516842,429516835,-7,1055,3146,10
430070298,430070297,-1,879,1024,10
432006572,432006572,0,1418,2190,10
433627074,433627075,1,1034,1891,10
435343958,435343959,1,1342,1334,10
438702882,438702881,-1,619,984,10
439433979,439433978,-1,1363,2208,10
439599398,439599398,0,1277,2589,10
440166780,440166779,-1,1034,2370,10
440424609,440424598,-11,197,4400,10
448315189,448315189,0,1223,2261,10
450312282,450312288,6,2848,1151,10
452072644,452072643,-1,1544,2520,10
452274107,452274105,-2,870,1276,10
456270345,456270344,-1,1387,2499,10
463459753,463459752,-1,1262,2026,10
468462644,468462642,-2,1102,2847,10
469516953,469516951,-2,1163,2264,10
471501496,471501493,-3,804,1915,10
473435643,473435643,0,1078,1838,10
476017238,476017238,0,2929,3188,10
478464307,478464305,-2,1114,1895,10
482233234,482233238,4,1745,1848,10
484270173,484270173,0,1444,1675,10
490753679,490753677,-2,1857,2695,10
493635074,493635076,2,1193,1729,10
494838689,494838687,-2,1350,2024,10
495646915,495646914,-1,653,1831,10
495948714,495948714,0,859,1634,10
506984695,506984693,-2,1248,1585,10
507494499,507494501,2,812,1109,10
508887762,508887762,0,1253,1598,10
509005798,509005797,-1,1696,2481,10
509217996,509218002,6,4321,2191,10
509544604,509544602,-2,1765,2196,10
518378982,518378981,-1,1065,1303,10
521985905,521985900,-5,1500,2762,10
522375066,522375061,-5,1161,2664,10
527091922,527091923,1,2554,2688,10
529134262,529134262,0,1217,2078,10
533293796,533293795,-1,733,1719,10
534779498,534779498,0,1531,2467,10
535961285,535961286,1,1416,1883,10
538474906,538474905,-1,1326,1905,10
538938559,538938556,-3,1138,1663,10
540785854,540785853,-1,1654,2634,10
542094783,542094782,-1,1207,245,10
544116110,544116109,-1,1654,2337,10
545614858,545614862,4,2668,1511,10
548289042,548289039,-3,1593,3275,10
548766242,548766239,-3,1710,2213,10
549337064,549337063,-1,875,1472,10
557045598,557045594,-4,1527,2327,10
559612734,559612733,-1,1386,1716,10
562091119,562091137,18,727,212,10
562501138,562501136,-2,1281,2253,10
564980954,564980954,0,1362,1355,10
569318832,569318830,-2,1064,2246,10
574023139,574023138,-1,1221,2255,10
575014726,575014724,-2,813,1682,10
579992002,579992000,-2,1336,1908,10
580875599,580875600,1,1994,1969,10
583748398,583748397,-1,965,1991,10
585631898,585631898,0,1375,1941,10
586852622,586852621,-1,1146,1758,10
589294598,589294598,0,1102,2072,10
590885476,590885477,1,1186,1543,10
599780457,599780456,-1,1105,1646,10
601400926,601400926,0,1376,1797,10
607084945,607084945,0,1484,2050,10
611856278,611856278,0,1480,1936,10
619637002,619637002,0,1281,1528,10
620970385,620970382,-3,1831,2673,10
627610193,627610201,8,5873,1404,10
628709785,628709781,-4,918,967,10
630392527,630392524,-3,1643,3058,10
632968218,632968215,-3,1396,2548,10
633442966,633442964,-2,1335,2232,10
636287069,636287070,1,1557,1652,10
641182517,641182516,-1,1187,1533,10
641350536,641350529,-7,1347,2465,10
642757006,642757007,1,1509,2299,10
643022662,643022662,0,1363,2298,10
646306847,646306854,7,3579,2516,10
649539495,649539494,-1,1817,2692,10
650352245,650352246,1,851,1273,10
652538325,652538322,-3,1241,2015,10
653664513,653664512,-1,1343,2114,10
654935202,654935201,-1,1169,1261,10
656697631,656697631,0,1250,1284,10
657949671,657949670,-1,1214,1853,10
660325310,660325307,-3,1371,1928,10
664299721,664299718,-3,924,1707,10
667474095,667474091,-4,956,1169,10
669819902,669819903,1,1145,1638,10
671537851,671537851,0,1258,1914,10
675021955,675021954,-1,1078,1507,10
677307499,677307498,-1,1004,1821,10
677490815,677490813,-2,1234,1904,10
678188451,678188450,-1,1289,2003,10
679498210,679498209,-1,1565,2095,10
689527091,689527088,-3,1387,1934,10
689884948,689884946,-2,1103,1610,10
693693794,693693793,-1,1132,1413,10
694724650,694724655,5,5065,20532,10
699893898,699893894,-4,1266,1984,10
700148911,700148910,-1,1531,2247,10
700280509,700280510,1,1380,2528,10
701692098,701692098,0,1595,2497,10
705390643,705390644,1,1184,1837,10
708609459,708609458,-1,1352,1756,10
711857885,711857884,-1,1440,2996,10
712723527,712723527,0,1206,1581,10
718997454,718997453,-1,1131,1919,10
719500224,719500243,19,89,1007,10
726028706,726028706,0,1091,1981,10
726186937,726186958,21,872,1817,10
735676891,735676890,-1,1144,2344,10
736760323,736760308,-15,1312,2220,10
741574054,741574053,-1,1159,1270,10
744072435,744072434,-1,1270,1811,10
745411289,745411293,4,1180,1477,10
751189350,751189350,0,821,1394,10
752789102,752789099,-3,1676,2301,10
753481043,753481041,-2,1184,2077,10
764903210,764903209,-1,1422,2298,10
765185589,765185586,-3,1422,1989,10
766367962,766367961,-1,959,1409,10
768017098,768017098,0,946,1673,10
768304163,768304183,20,892,2505,10
769410348,769410353,5,3057,1590,10
770715465,770715462,-3,1413,2689,10
773114207,773114206,-1,939,1605,10
773680803,773680801,-2,1443,2901,10
776751572,776751569,-3,1140,1681,10
779884863,779884857,-6,1165,4930,10
780114966,780114966,0,1143,1417,10
783339603,783339602,-1,1313,2098,10
784883054,784883051,-3,4565,8036,10
785678837,785678837,0,1593,1716,10
787233739,787233738,-1,1120,2499,10
791764845,791764845,0,1464,1629,10
792365292,792365290,-2,1071,2084,10
792682497,792682490,-7,905,1423,10
801839882,801839882,0,1233,2164,10
802819446,802819440,-6,659,3842,10
803599707,803599704,-3,821,1358,10
804756388,804756386,-2,688,1066,10
808224959,808224956,-3,1224,1896,10
808313197,808313197,0,707,1395,10
809068543,809068542,-1,754,1270,10
812884298,812884294,-4,1630,2184,10
813193268,813193266,-2,973,1431,10
813554730,813554751,21,475,1261,10
817936727,817936725,-2,1099,1419,10
820790078,820790074,-4,579,1801,10
821382786,821382783,-3,1181,2258,10
822911744,822911742,-2,1157,1919,10
824744426,824744425,-1,856,1122,10
826613834,826613833,-1,1092,1651,10
828012190,828012190,0,1036,1695,10
828691337,828691337,0,1209,1258,10
830286937,830286937,0,1092,2059,10
834020502,834020500,-2,1158,2653,10
835071207,835071209,2,752,1698,10
837572576,837572570,-6,1410,1633,10
840662370,840662374,4,12245,7693,10
845559417,845559415,-2,958,1949,10
853143789,853143785,-4,954,1617,10
853728122,853728122,0,1985,2363,10
853803646,853803646,0,1213,1716,10
854021838,854021837,-1,1586,2343,10
855171335,855171326,-9,38021,13448,10
855252802,855252798,-4,1037,1808,10
858618142,858618143,1,878,1844,10
860515819,860515817,-2,929,2517,10
864495751,864495750,-1,1293,1989,10
867296842,867296842,0,1685,2344,10
871386613,871386613,0,1210,1619,10
875489279,875489282,3,1360,1431,10
875870473,875870470,-3,1105,1837,10
876495283,876495282,-1,1067,1575,10
883155749,883155748,-1,1421,1941,10
883588225,883588221,-4,1681,2311,10
885000250,885000246,-4,660,2587,10
889604698,889604697,-1,980,1845,10
897824595,897824594,-1,1576,1943,10
900785305,900785305,0,1438,2561,10
901587422,901587421,-1,987,1932,10
907485441,907485442,1,1551,1990,10
909639730,909639729,-1,824,1973,10
913214274,913214272,-2,1307,2809,10
914056353,914056354,1,1308,2045,10
914647948,914647949,1,1128,1604,10
916294255,916294255,0,1086,1250,10
917560101,917560101,0,1106,1815,10
918437527,918437527,0,1394,1269,10
921157145,921157143,-2,754,2001,10
922310960,922310964,4,33867,23095,10
924425448,924425446,-2,1140,1674,10
924801303,924801322,19,722,1176,10
925824573,925824573,0,1193,2109,10
926213537,926213521,-16,296,10393,10
929291612,929291610,-2,1306,1792,10
931840580,931840578,-2,1292,2294,10
933218214,933218222,8,4273,1496,10
935477106,935477103,-3,1167,1387,10
935907961,935907961,0,1061,1344,10
939862218,939862217,-1,943,1932,10
941429455,941429454,-1,1068,2193,10
943687313,943687320,7,4670,1364,10
947698683,947698681,-2,1040,1495,10
950537610,950537610,0,937,1461,10
951151770,951151766,-4,1751,2174,10
952388418,952388415,-3,925,1471,10
952971955,952971954,-1,1112,887,10
955600405,955600402,-3,1168,3236,10
959209043,959209042,-1,788,1833,10
959858571,959858570,-1,1971,2778,10
962198509,962198508,-1,614,1329,10
964596882,964596877,-5,1043,2315,10
966956148,966956154,6,2359,1296,10
969460174,969460174,0,953,1486,10
972724978,972724978,0,1483,2305,10
974678761,974678757,-4,1233,2070,10
980696226,980696227,1,1502,1785,10
981947214,981947213,-1,1374,2258,10
982875531,982875530,-1,739,1544,10
995582879,995582876,-3,1232,2250,10
995738338,995738335,-3,1371,2549,10
998456053,998456052,-1,1825,2219,10
1000252330,1000252329,-1,1066,1168,10
1000987419,1000987417,-2,1184,2506,10
1004909010,1004909008,-2,1618,2498,10
1007406287,1007406285,-2,1175,1738,10
1010998818,1010998818,0,1305,1347,10
1012382931,1012382930,-1,1105,1737,10
1012550102,1012550105,3,2827,2667,10
1015065247,1015065246,-1,1113,1723,10
1019161027,1019161026,-1,1742,2833,10
1019346722,1019346723,1,1797,2319,10
1021745546,1021745542,-4,1643,4434,10
1023155642,1023155644,2,2851,2589,10
1025923432,1025923432,0,1065,2485,10
1037423754,1037423750,-4,1142,2041,10
1039616586,1039616586,0,1013,1615,10
1047861069,1047861069,0,1386,1958,10
1048094354,1048094349,-5,1041,2445,10
1048235068,1048235068,0,1379,1946,10
1050524865,1050524863,-2,1371,2208,10
1054609662,1054609661,-1,1231,1999,10
1055483332,1055483336,4,2196,1906,10
1056478137,1056478157,20,1344,2002,10
1057992526,1057992529,3,1283,916,10
1063341774,1063341774,0,1389,1367,10
1070128923,1070128922,-1,1196,1566,10
1070643702,1070643701,-1,552,1133,10
1071757956,1071757956,0,1620,2137,10
1074614766,1074614766,0,1484,1509,10
1074913529,1074913526,-3,1824,2460,10
1079114614,1079114615,1,1198,1768,10
1083638747,1083638745,-2,1277,1836,10
1085558003,1085558003,0,921,1162,10
1091295939,1091295938,-1,1354,1830,10
1091779865,1091779869,4,2179,1720,10
1092965684,1092965684,0,1080,1966,10
1095972576,1095972573,-3,1041,1792,10
1098039571,1098039570,-1,1358,2077,10
1098310577,1098310574,-3,1094,2569,10
1101412461,1101412463,2,1356,1506,10
1108146247,1108146245,-2,1112,1852,10
1111609421,1111609418,-3,1383,2478,10
1114147230,1114147235,5,7273,20492,10
1115440125,1115440122,-3,1517,2000,10
1115899032,1115899032,0,1575,2504,10
1125368402,1125368399,-3,908,1295,10
1125852079,1125852077,-2,865,2212,10
1127376759,1127376757,-2,1345,1946,10
1128154742,1128154743,1,1156,1463,10
1128626818,1128626811,-7,1145,4368,10
1129590057,1129590056,-1,1146,2630,10
1129825341,1129825344,3,983,1367,10
1133323715,1133323734,19,39347,18453,10
1133626853,1133626851,-2,1562,2096,10
1141930477,1141930460,-17,1156,1295,10
1143035453,1143035453,0,1167,1678,10
1148364277,1148364278,1,1312,1715,10
1149080901,1149080898,-3,1543,2610,10
1157559282,1157559270,-12,240,891,10
1161238478,1161238482,4,3688,2235,10
1166608942,1166608951,9,10011,36998,10
1172198202,1172198207,5,2833,1703,10
1174557155,1174557148,-7,1036,12226,10
1175687002,1175687002,0,1083,1260,10
1179908259,1179908259,0,1087,2008,10
1180467157,1180467159,2,1442,1416,10
1180841838,1180841837,-1,1051,1984,10
1183984506,1183984505,-1,835,1479,10
1185643183,1185643182,-1,1253,2284,10
1186556595,1186556585,-10,1141,1789,10
1189546623,1189546626,3,1791,2216,10
1194725262,1194725262,0,1411,2445,10
1196023519,1196023518,-1,1318,2183,10
1196126017,1196126012,-5,1108,2500,10
1199938225,1199938224,-1,1336,2674,10
1200773698,1200773697,-1,1721,2786,10
1212880466,1212880465,-1,1021,1740,10
1213756410,1213756410,0,1383,1748,10
1215262238,1215262236,-2,1503,1805,10
1232520843,1232520842,-1,1657,1982,10
1235142675,1235142674,-1,1834,1845,10
1242291469,1242291467,-2,1446,1662,10
1242664417,1242664421,4,2563,1598,10
1243922191,1243922188,-3,995,2102,10
1244602913,1244602911,-2,785,1073,10
1245517002,1245517000,-2,1009,1466,10
1248536346,1248536346,0,1147,2005,10
1249290940,1249290938,-2,1278,1493,10
1249992331,1249992330,-1,1416,2245,10
1252035797,1252035793,-4,2212,11799,10
1253337231,1253337244,13,12763,49476,10
1254031605,1254031610,5,2739,1714,10
1254556666,1254556665,-1,1415,1553,10
1254626546,1254626551,5,2237,1504,10
1255202851,1255202849,-2,930,2125,10
1255717440,1255717438,-2,1010,1805,10
1255862920,1255862919,-1,1232,1713,10
1256490609,1256490608,-1,946,1356,10
1270350407,1270350405,-2,1277,2460,10
1275515717,1275515714,-3,1106,1940,10
1275788054,1275788053,-1,873,1833,10
1278220547,1278220545,-2,1065,2196,10
1280247139,1280247139,0,1042,1557,10
1281936541,1281936541,0,1380,2453,10
1285762821,1285762815,-6,480,971,10
1288922841,1288922842,1,866,1475,10
1291254134,1291254116,-18,2534,1859,10
1292431698,1292431701,3,715,1853,10
1294516049,1294516046,-3,1805,3089,10
1295425345,1295425342,-3,1755,2682,10
1296457821,1296457818,-3,1227,1573,10
1297602466,1297602463,-3,1314,2159,10
1297689758,1297689757,-1,997,2159,10
1300480282,1300480282,0,1169,1373,10
1300530947,1300530946,-1,1265,3212,10
1300752189,1300752189,0,1783,2565,10
1303747259,1303747258,-1,1457,1704,10
1308066822,1308066822,0,1528,1596,10
1309742710,1309742708,-2,955,1559,10
1313478969,1313478966,-3,918,2169,10
1314663646,1314663645,-1,1771,2496,10
1315578234,1315578231,-3,1325,2071,10
1316794652,1316794658,6,2290,1193,10
1322611280,1322611278,-2,1495,2311,10
1324572812,1324572809,-3,1095,1628,10
1325098984,1325098983,-1,1471,2292,10
1325350387,1325350387,0,1000,1415,10
1326534824,1326534823,-1,907,1728,10
1328410985,1328410984,-1,1529,2539,10
1338296712,1338296709,-3,28201,13682,10
1338906037,1338906042,5,2970,1113,10
1341570977,1341570978,1,1378,1377,10
1343187622,1343187620,-2,980,1448,10
1349515142,1349515143,1,1323,1901,10
1353322003,1353322000,-3,1066,2723,10
1355058054,1355058050,-4,1513,2623,10
1361809878,1361809878,0,1144,1670,10
1361862977,1361862975,-2,1243,1693,10
1363242950,1363242955,5,2714,1238,10
1364780017,1364780014,-3,1249,1706,10
1366089262,1366089260,-2,1179,2494,10
1367639603,1367639603,0,956,1788,10
1368152426,1368152426,0,1253,1893,10
1372039082,1372039080,-2,1789,2420,10
1373037988,1373037998,10,14713,30872,10
1374076967,1374076967,0,803,1534,10
1377835973,1377835970,-3,1839,2642,10
1378363659,1378363662,3,132,615,10
1378929615,1378929614,-1,1133,2532,10
1379848627,1379848624,-3,1004,1684,10
1381356589,1381356588,-1,1151,1756,10
1381562816,1381562814,-2,1111,1841,10
1382393843,1382393841,-2,1386,2306,10
1389521768,1389521768,0,1084,2148,10
1389747924,1389747938,14,352,642,10
1390801672,1390801669,-3,1526,3522,10
1392249952,1392249951,-1,1211,1497,10
1392754768,1392754766,-2,1819,2422,10
1397027603,1397027598,-5,1280,2407,10
1401119339,1401119338,-1,786,1952,10
1406182142,1406182141,-1,949,2026,10
1409059455,1409059475,20,911,1144,10
1416116198,1416116198,0,1530,1498,10
1418033774,1418033770,-4,798,1335,10
1421559522,1421559520,-2,1300,3022,10
1422842267,1422842267,0,1054,1530,10
1423524774,1423524772,-2,827,1646,10
1427844391,1427844393,2,13912,13620,10
1430590572,1430590570,-2,1298,1512,10
1431618611,1431618598,-13,1126,1691,10
1432610858,1432610858,0,1314,1975,10
1433488967,1433488981,14,592,740,10
1434325572,1434325569,-3,1843,2863,10
1437315210,1437315210,0,1238,1440,10
1439101259,1439101260,1,933,1315,10
1440507173,1440507169,-4,724,2876,10
1442506150,1442506150,0,1210,1550,10
1444593932,1444593930,-2,1303,2281,10
1446788683,1446788681,-2,1449,2576,10
1448493802,1448493801,-1,1232,2052,10
1452664530,1452664529,-1,1545,2400,10
1453332867,1453332866,-1,2353,3717,10
1456555015,1456555014,-1,1388,2543,10
1457217655,1457217655,0,1393,1976,10
1457243682,1457243682,0,1345,2382,10
1459910479,1459910478,-1,1543,2355,10
1460783615,1460783613,-2,783,1549,10
1462970502,1462970502,0,809,1656,10
1465855343,1465855343,0,924,1342,10
1465997470,1465997471,1,1189,1375,10
1466623373,1466623370,-3,1432,2863,10
1472193388,1472193384,-4,1148,1454,10
1472598532,1472598546,14,286,1682,10
1474432453,1474432449,-4,1101,1467,10
1476544638,1476544636,-2,1288,1593,10
1476827578,1476827579,1,1230,2131,10
1479651862,1479651866,4,1819,1586,10
1481985426,1481985424,-2,1106,1700,10
1484289929,1484289929,0,1283,1606,10
1484673786,1484673784,-2,1932,2272,10
1486994741,1486994734,-7,1324,4779,10
1490988090,1490988084,-6,796,3627,10
1492816059,1492816057,-2,1125,1213,10
1495072278,1495072276,-2,1409,2558,10
1498067542,1498067539,-3,1611,3140,10
1500578884,1500578883,-1,1912,2740,10
1501385175,1501385173,-2,1548,2107,10
1505116650,1505116649,-1,969,1741,10
1507103474,1507103473,-1,1542,2345,10
1509591553,1509591554,1,1189,1667,10
1509755519,1509755518,-1,1601,1507,10
1512517362,1512517360,-2,1517,3148,10
1513011847,1513011846,-1,1034,1096,10
1521379807,1521379805,-2,1148,2637,10
1524511975,1524511975,0,1042,1334,10
1524877361,1524877361,0,550,1467,10
1536606574,1536606573,-1,1009,1932,10
1540668437,1540668436,-1,1461,1828,10
1542308157,1542308155,-2,1942,4484,10
1545959284,1545959282,-2,1587,2236,10
1546651634,1546651632,-2,1090,1815,10
1550334017,1550334017,0,1892,2024,10
1555234258,1555234259,1,1938,1331,10
1555611790,1555611790,0,1172,1787,10
1555777870,1555777868,-2,1258,1916,10
1556802105,1556802103,-2,1338,1522,10
1557596305,1557596303,-2,1149,2236,10
1561443298,1561443298,0,1511,2502,10
1564970327,1564970324,-3,1073,2211,10
1565097926,1565097926,0,1478,1993,10
1566257250,1566257247,-3,1442,1899,10
1567284167,1567284171,4,1178,1096,10
1569146220,1569146217,-3,32857,14819,10
1571111482,1571111486,4,3014,1762,10
1577354808,1577354801,-7,740,3400,10
1579351221,1579351220,-1,1402,1895,10
1582484015,1582484015,0,1006,2232,10
1585605977,1585605974,-3,2104,3934,10
1586038393,1586038391,-2,1161,2242,10
1586667354,1586667354,0,1113,1654,10
1592309778,1592309777,-1,982,1897,10
1594966399,1594966397,-2,1082,2075,10
1595002886,1595002886,0,1610,2274,10
1595599727,1595599727,0,1505,1646,10
1600712914,1600712912,-2,1116,1263,10
1601476206,1601476205,-1,1024,1842,10
1602932392,1602932391,-1,1798,2499,10
1603597957,1603597955,-2,1044,1427,10
1605818723,1605818731,8,9998,34647,10
1611446950,1611446950,0,979,1686,10
1619085879,1619085878,-1,1119,910,10
1620472678,1620472684,6,1268,1434,10
1621533680,1621533678,-2,1207,2475,10
1623163653,1623163651,-2,1110,2412,10
1623963642,1623963641,-1,1020,1560,10
1627143059,1627143058,-1,1368,1259,10
1627555033,1627555033,0,1869,2099,10
1632130556,1632130561,5,3416,1979,10
1632571378,1632571377,-1,1299,1859,10
1633296075,1633296078,3,2052,2178,10
1637766912,1637766914,2,1869,1739,10
1640811191,1640811191,0,806,1503,10
1640880020,1640880020,0,2169,3185,10
1641150179,1641150178,-1,1670,1485,10
1643178937,1643178936,-1,830,1698,10
1643859002,1643859000,-2,1387,2115,10
1644691729,1644691726,-3,1599,2546,10
1646396899,1646396896,-3,890,1433,10
1647786237,1647786235,-2,1188,2201,10
1649651108,1649651115,7,590,1510,10
1652487433,1652487433,0,1729,1525,10
1652808580,1652808580,0,1013,1526,10
1653488990,1653488990,0,1233,1803,10
1661380986,1661380986,0,999,775,10
1662097426,1662097425,-1,1366,1849,10
1663626074,1663626072,-2,1200,2533,10
1667956018,1667956017,-1,791,1547,10
1669448774,1669448774,0,1846,1227,10
1672600029,1672600029,0,1418,1883,10
1675600019,1675600018,-1,930,1553,10
1676448870,1676448866,-4,1372,2441,10
1678628902,1678628901,-1,1139,1776,10
1678842291,1678842289,-2,799,2411,10
1682883103,1682883101,-2,1056,2131,10
1683750174,1683750174,0,899,1510,10
1685037456,1685037454,-2,1364,2421,10
1686640946,1686640946,0,1821,2600,10
1687253523,1687253522,-1,1139,1668,10
1692742111,1692742114,3,1884,1860,10
1693630745,1693630742,-3,782,1683,10
1693911764,1693911761,-3,763,1921,10
1694842406,1694842406,0,1234,1759,10
1698991484,1698991482,-2,1108,2025,10
1705328426,1705328429,3,4467,3140,10
1707109069,1707109070,1,2033,3081,10
1713085931,1713085929,-2,1633,2283,10
1715833467,1715833465,-2,1331,2203,10
1718774461,1718774458,-3,824,1573,10
1719360499,1719360498,-1,663,1752,10
1724212506,1724212503,-3,946,2161,10
1724544127,1724544125,-2,1090,1625,10
1729319054,1729319053,-1,1975,2825,10
1731858349,1731858350,1,1065,2045,10
1735042880,1735042883,3,2012,1525,10
1738171763,1738171765,2,1129,1499,10
1738894497,1738894494,-3,1472,2724,10
1740128002,1740128010,8,10094,1999,10
1740765914,1740765914,0,1758,2217,10
1742260794,1742260793,-1,1694,2140,10
1742651530,1742651528,-2,914,1326,10
1746049382,1746049381,-1,1516,2441,10
1748660527,1748660526,-1,788,2042,10
1749543460,1749543475,15,952,2359,10
1750329442,1750329442,0,993,1552,10
1750363951,1750363949,-2,1255,2186,10
1753606522,1753606520,-2,1225,2056,10
1758679016,1758679011,-5,1874,5128,10
1759046442,1759046441,-1,1258,1626,10
1759916358,1759916358,0,940,1138,10
1763752859,1763752858,-1,1479,1908,10
1766372550,1766372547,-3,1088,3041,10
1767367245,1767367243,-2,1012,1706,10
1771650007,1771650005,-2,1210,1794,10
1776676414,1776676414,0,830,984,10
1778886239,1778886239,0,1807,1433,10
1779936395,1779936395,0,990,1814,10
1781125811,1781125810,-1,1094,1239,10
1783205965,1783205965,0,1399,1655,10
1783929237,1783929236,-1,1139,1575,10
1785538720,1785538717,-3,1087,2061,10
1786592510,1786592510,0,917,1466,10
1796957603,1796957605,2,891,1499,10
1799963933,1799963931,-2,717,1958,10
1801171865,1801171863,-2,1671,2244,10
1804136689,1804136687,-2,1283,1808,10
1805871843,1805871844,1,810,1745,10
1810819525,1810819525,0,1252,1704,10
1812656409,1812656408,-1,1339,1959,10
1812829027,1812829027,0,725,1382,10
1816813302,1816813300,-2,1047,1749,10
1819078415,1819078413,-2,1318,3068,10
1819104090,1819104089,-1,1342,2343,10
1820729791,1820729793,2,1388,1490,10
1823967569,1823967569,0,1142,2117,10
1825283579,1825283579,0,1139,1490,10
1831268734,1831268731,-3,1122,2276,10
1832184805,1832184802,-3,1159,2253,10
1833348528,1833348527,-1,1001,1497,10
1833761608,1833761605,-3,1286,2106,10
1837773477,1837773477,0,775,755,10
1838016356,1838016354,-2,1627,2482,10
1838218513,1838218511,-2,1336,2074,10
1842076181,1842076180,-1,1246,2262,10
1844504325,1844504324,-1,1363,2388,10
1847297114,1847297120,6,2294,1526,10
1850756909,1850756910,1,1227,1297,10
1857750181,1857750179,-2,991,1547,10
1859649619,1859649616,-3,1532,2371,10
1864499558,1864499557,-1,963,1700,10
1867400647,1867400646,-1,892,1558,10
1868241611,1868241611,0,1110,2027,10
1869372494,1869372492,-2,1180,1703,10
1870714064,1870714061,-3,1084,2310,10
1870826411,1870826396,-15,1316,2087,10
1872788301,1872788302,1,1619,2064,10
1874566599,1874566598,-1,1444,2185,10
1878317920,1878317918,-2,1466,2035,10
1882363759,1882363758,-1,836,1932,10
1882533024,1882533032,8,105,1072,10
1885288386,1885288384,-2,1003,2263,10
1885716754,1885716753,-1,1059,1909,10
1888575918,1888575917,-1,1188,1807,10
1895588178,1895588177,-1,679,1757,10
1899394030,1899394030,0,917,1740,10
1900497863,1900497862,-1,1766,1864,10
1901476350,1901476346,-4,1074,1727,10
1903208349,1903208346,-3,1998,1977,10
1903340424,1903340422,-2,1652,1844,10
1903955214,1903955211,-3,967,1578,10
1908575706,1908575705,-1,770,2133,10
1911434610,1911434606,-4,1788,4807,10
1913457890,1913457886,-4,1092,3360,10
1914860295,1914860294,-1,801,2167,10
1915125324,1915125336,12,3897,1481,10
1915418674,1915418674,0,1440,2441,10
1918761721,1918761720,-1,1483,2166,10
1919276979,1919276977,-2,1081,1284,10
1922131254,1922131251,-3,712,1915,10
1922569132,1922569142,10,31,820,10
1923935867,1923935873,6,1445,1090,10
1925041437,1925041438,1,1013,1511,10
1926139339,1926139334,-5,1240,3224,10
1933881722,1933881721,-1,1205,1705,10
1934054694,1934054691,-3,1329,2013,10
1935010553,1935010555,2,1148,1314,10
1937296006,1937296006,0,934,1615,10
1940740771,1940740770,-1,737,1106,10
1941843037,1941843035,-2,870,1298,10
1943244791,1943244790,-1,947,1610,10
1944880843,1944880841,-2,1253,3457,10
1945796328,1945796327,-1,1632,1499,10
1946491677,1946491671,-6,1057,3572,10
1948482126,1948482125,-1,919,1538,10
1949438305,1949438302,-3,1432,1807,10
1952693234,1952693233,-1,1409,1650,10
1952956085,1952956085,0,1046,1945,10
1955802870,1955802873,3,2638,1965,10
1958025351,1958025350,-1,1372,1578,10
1958139715,1958139716,1,1017,1515,10
1959295762,1959295759,-3,959,1903,10
1960224825,1960224822,-3,1310,1428,10
1961988982,1961988983,1,1506,2817,10
1962379103,1962379101,-2,771,2031,10
1963350478,1963350477,-1,1361,1610,10
1967468149,1967468147,-2,1432,2563,10
1967711003,1967710986,-17,1077,1373,10
1967861429,1967861427,-2,1660,2887,10
1968941759,1968941756,-3,985,1690,10
1970329522,1970329522,0,1539,2205,10
1971900389,1971900386,-3,882,2097,10
1972091694,1972091702,8,1710,550,10
1972951361,1972951366,5,2186,1819,10
1981335551,1981335549,-2,1618,2098,10
1985290980,1985290977,-3,1441,1907,10
1986615770,1986615769,-1,1438,1737,10
1988636514,1988636512,-2,1335,2189,10
1988750218,1988750218,0,2122,2597,10
1989970473,1989970471,-2,1219,1405,10
1991216901,1991216901,0,1325,2473,10
1994039421,1994039420,-1,1200,2322,10
1995598800,1995598802,2,2373,1993,10
2000112405,2000112406,1,1675,1576,10
2000538914,2000538913,-1,881,2131,10
2002000569,2002000567,-2,1159,2760,10
2003582301,2003582302,1,1804,2261,10
2005227708,2005227702,-6,840,2247,10
2005759262,2005759262,0,1553,2176,10
2006016781,2006016783,2,1901,1856,10
2006162006,2006162002,-4,1477,2013,10
2007991695,2007991694,-1,1069,1850,10
2016663446,2016663443,-3,1287,2155,10
2017068451,2017068449,-2,986,1593,10
2018728011,2018728009,-2,1197,1731,10
2021100225,2021100223,-2,1196,1721,10
2027472517,2027472510,-7,2036,9858,10
2030490535,2030490533,-2,1006,1585,10
2031433245,2031433245,0,1534,1958,10
2033072298,2033072299,1,1043,1437,10
2033905046,2033905038,-8,904,2213,10
2034667219,2034667217,-2,757,1245,10
2036935233,2036935233,0,1164,1976,10
2037084318,2037084318,0,2158,2556,10
2037382942,2037382941,-1,1249,2427,10
2037896279,2037896278,-1,1129,1661,10
2038006915,2038006923,8,337,1024,10
2038882708,2038882726,18,1597,2209,10
2038954938,2038954954,16,438,1596,10
2041086641,2041086640,-1,630,1733,10
2047413959,2047413965,6,10521,36719,10
2048285455,2048285455,0,1269,1955,10
2049419898,2049419896,-2,1138,2640,10
2049805313,2049805293,-20,323,834,10
2050340911,2050340910,-1,914,1993,10
2050732178,2050732177,-1,1295,1415,10
2055268720,2055268717,-3,1487,3159,10
2058940052,2058940050,-2,1872,2437,10
2061014543,2061014541,-2,1074,1590,10
2061372819,2061372822,3,1730,1749,10
2062643674,2062643679,5,4352,2534,10
2074274969,2074274966,-3,1382,3301,10
2075689178,2075689177,-1,1383,2046,10
2078667999,2078667998,-1,1635,3066,10
2079063331,2079063326,-5,1026,3674,10
2079184042,2079184041,-1,1068,1913,10
2082320065,2082320065,0,1645,2810,10
2082798430,2082798430,0,1258,1353,10
2084029985,2084029985,0,1430,2367,10
2087195039,2087195038,-1,1007,1745,10
2090594979,2090594976,-3,1057,2473,10
2099257286,2099257282,-4,1028,1748,10
2099964114,2099964112,-2,1319,2187,10
2100497577,2100497575,-2,1062,2239,10
2103671041,2103671039,-2,1087,2215,10
2103833694,2103833690,-4,1254,1594,10
2103877338,2103877336,-2,1038,2009,10
2106058860,2106058845,-15,3197,1514,10
2107536219,2107536218,-1,1235,2458,10
2112238687,2112238689,2,1695,1513,10
2112446027,2112446025,-2,1203,2604,10
2113295347,2113295345,-2,802,1810,10
2114813182,2114813180,-2,813,1299,10
2115411523,2115411522,-1,1152,1987,10
2116267295,2116267294,-1,744,1441,10
2121413239,2121413234,-5,1023,2408,10
2122120107,2122120086,-21,815,1745,10
2128435027,2128435025,-2,1254,2622,10
2130151287,2130151287,0,1397,2047,10
2131501867,2131501871,4,2503,2043,10
2132375037,2132375041,4,1538,639,10
2133318162,2133318160,-2,1289,1975,10
2133420665,2133420687,22,1524,2818,10
2136613951,2136613949,-2,913,1610,10
2138438917,2138438915,-2,1156,1643,10
2141702199,2141702198,-1,2532,4454,10
2143216773,2143216770,-3,1370,1989,10
2143471261,2143471259,-2,1302,2169,10
2150462955,2150462953,-2,1169,2264,10
2152022271,2152022269,-2,1027,1878,10
2159663282,2159663279,-3,1222,1766,10
2161033233,2161033235,2,1935,1515,10
2161276154,2161276150,-4,772,1469,10
2169976428,2169976410,-18,982,1957,10
2171256657,2171256653,-4,1418,2745,10
2171789001,2171789002,1,3253,2399,10
2173032594,2173032592,-2,1080,2365,10
2176193161,2176193162,1,1241,1373,10
2178148185,2178148181,-4,2410,5660,10
2179885334,2179885333,-1,1454,2251,10
2181945175,2181945177,2,1178,1672,10
2182451194,2182451206,12,21062,895,10
2184603335,2184603330,-5,1164,2002,10
2186858742,2186858746,4,2202,1648,10
2189444834,2189444832,-2,915,1604,10
2194091702,2194091688,-14,1906,1251,10
2194570812,2194570827,15,340,2714,10
2194648931,2194648930,-1,1178,1325,10
2194888050,2194888049,-1,977,2198,10
2197412587,2197412587,0,902,1992,10
2200711313,2200711309,-4,1323,2289,10
2209158017,2209158018,1,1360,1968,10
2217183834,2217183833,-1,1256,1734,10
2218756986,2218756982,-4,1144,1690,10
2219052977,2219052965,-12,333,694,10
2221884808,2221884805,-3,1036,2134,10
2225973288,2225973286,-2,1208,1793,10
2226016563,2226016577,14,277,914,10
2230939906,2230939906,0,1228,2165,10
2233582315,2233582297,-18,1027,1616,10
2234413052,2234413070,18,329,888,10
2234738615,2234738614,-1,1059,2203,10
2240063376,2240063378,2,1126,1835,10
2241557862,2241557859,-3,827,2225,10
2244116278,2244116276,-2,1445,1844,10
2245639118,2245639117,-1,1305,1494,10
2249042278,2249042279,1,1101,2085,10
2259664793,2259664791,-2,1352,1957,10
2260044119,2260044119,0,1120,945,10
2262589473,2262589472,-1,1131,1991,10
2263970341,2263970338,-3,1359,1686,10
2268101074,2268101073,-1,1203,2376,10
2272286874,2272286874,0,904,2113,10
2277220962,2277220959,-3,1088,2432,10
2281944529,2281944534,5,1185,1434,10
2282109290,2282109290,0,1808,2625,10
2285631492,2285631490,-2,1255,1586,10
2285705338,2285705337,-1,1002,1139,10
2288722791,2288722789,-2,1324,2032,10
2289330130,2289330127,-3,450,1180,10
2291090198,2291090197,-1,1113,1950,10
2293393788,2293393776,-12,1372,2215,10
2294406479,2294406486,7,2228,1439,10
2297173218,2297173217,-1,1562,2777,10
2298764894,2298764893,-1,2034,2374,10
2300074673,2300074671,-2,916,2137,10
2300275410,2300275417,7,10222,29846,10
2300979050,2300979049,-1,1067,2088,10
2303167034,2303167034,0,3210,3664,10
2304310484,2304310482,-2,1017,1329,10
2313119450,2313119449,-1,1488,1988,10
2313264439,2313264438,-1,715,1231,10
2320630553,2320630551,-2,1543,3078,10
2322986515,2322986511,-4,1261,2473,10
2331989827,2331989825,-2,1586,2263,10
2338506318,2338506317,-1,1371,1906,10
2338801171,2338801166,-5,845,3003,10
2343811571,2343811570,-1,1202,1771,10
2351098504,2351098503,-1,1487,2222,10
2353269653,2353269649,-4,839,2132,10
2356432684,2356432680,-4,1259,2437,10
2358070203,2358070205,2,831,2044,10
2359027271,2359027268,-3,1833,2351,10
2362316211,2362316209,-2,1193,2301,10
2366516168,2366516170,2,1123,594,10
2367538526,2367538525,-1,752,1407,10
2370367913,2370367912,-1,1304,2023,10
2370888849,2370888849,0,1330,2313,10
2371450285,2371450282,-3,1148,2231,10
2371988839,2371988834,-5,21083,13414,10
2372211922,2372211915,-7,1397,142,10
2374725358,2374725356,-2,976,2366,10
2375698624,2375698646,22,1311,2185,10
2376522022,2376522018,-4,980,1469,10
2379771134,2379771134,0,1397,2019,10
2387025750,2387025749,-1,942,1983,10
2387316890,2387316904,14,179,1600,10
2387884609,2387884608,-1,1068,1784,10
2388127860,2388127871,11,12389,42937,10
2390785645,2390785644,-1,1497,1835,10
2392536936,2392536935,-1,1022,1420,10
2394805267,2394805266,-1,1166,1681,10
2397005416,2397005418,2,2898,2271,10
2405851360,2405851355,-5,1193,2263,10
2412834319,2412834317,-2,1049,2204,10
2413462185,2413462183,-2,1194,2376,10
2415245459,2415245462,3,1140,1469,10
2416079041,2416079041,0,1628,1779,10
2419162417,2419162415,-2,1299,2408,10
2420470262,2420470262,0,1277,1516,10
2427123305,2427123303,-2,1250,2136,10
2428842979,2428842978,-1,868,1251,10
2431896330,2431896330,0,1564,1568,10
2432673359,2432673358,-1,1252,1823,10
2434163437,2434163437,0,1033,1802,10
2435993007,2435993019,12,12634,38948,10
2437609061,2437609054,-7,1283,4978,10
2438236629,2438236622,-7,1534,5459,10
2438414321,2438414321,0,1414,1824,10
2439434849,2439434847,-2,1262,2582,10
2441186171,2441186168,-3,953,1864,10
2452210813,2452210834,21,1112,1982,10
2452612426,2452612426,0,323,931,10
2455332046,2455332047,1,1419,1428,10
2455554438,2455554438,0,1535,1379,10
2457048207,2457048207,0,1110,1390,10
2457213120,2457213117,-3,855,1787,10
2459180858,2459180856,-2,1549,2182,10
2459868998,2459868997,-1,1204,2514,10
2463114007,2463114006,-1,1911,1809,10
2463207019,2463207017,-2,941,2488,10
2463444876,2463444874,-2,1142,2653,10
2463756334,2463756333,-1,1358,1775,10
2464515501,2464515501,0,1091,2174,10
2464845358,2464845358,0,895,1107,10
2466597511,2466597510,-1,1391,2169,10
2467305126,2467305126,0,1921,2434,10
2469987403,2469987401,-2,1377,1610,10
2470917189,2470917187,-2,1139,1870,10
2475163429,2475163429,0,905,1868,10
2476042969,2476042963,-6,838,3331,10
2476253476,2476253490,14,695,1953,10
2485491563,2485491563,0,676,820,10
2486319575,2486319587,12,13567,39688,10
2492730735,2492730734,-1,1487,2078,10
2494355614,2494355613,-1,1134,1731,10
2498799416,2498799414,-2,1223,1743,10
2499259015,2499259014,-1,826,1306,10
2500409678,2500409675,-3,1433,2208,10
2504647050,2504647049,-1,1188,2089,10
2505481552,2505481551,-1,1408,3079,10
2506079978,2506079976,-2,1537,1702,10
2510800527,2510800524,-3,1338,2073,10
2511660682,2511660681,-1,1231,1814,10
2514866233,2514866233,0,1299,1241,10
2517944401,2517944403,2,1344,1712,10
2520004024,2520004031,7,14372,19062,10
2520531301,2520531299,-2,2140,2480,10
2520951067,2520951074,7,2210,1607,10
2527644997,2527644996,-1,1148,1426,10
2528082262,2528082262,0,654,1237,10
2529871422,2529871430,8,3052,1539,10
2532984179,2532984177,-2,1146,1455,10
2536387466,2536387466,0,1138,1735,10
2537026743,2537026741,-2,2954,3106,10
2537759300,2537759318,18,15790,56280,10
2539912239,2539912237,-2,1239,1656,10
2545343414,2545343413,-1,1927,2962,10
2546688189,2546688184,-5,1615,3580,10
2547895748,2547895748,0,1642,2095,10
2549005506,2549005495,-11,1246,1944,10
2554903074,2554903073,-1,964,2163,10
2558354921,2558354921,0,1857,2327,10
2558735208,2558735205,-3,1297,1953,10
2559180867,2559180865,-2,788,2320,10
2559475324,2559475339,15,908,1712,10
2561552385,2561552383,-2,1035,2500,10
2563426659,2563426665,6,6217,1589,10
2565496488,2565496509,21,588,3167,10
2565627415,2565627413,-2,1116,1667,10
2567515018,2567515016,-2,1381,3139,10
2570389050,2570389050,0,1052,1765,10
2571136388,2571136386,-2,1438,2095,10
2573364881,2573364880,-1,1576,2545,10
2574423000,2574422998,-2,1183,1979,10
2576962391,2576962390,-1,1052,1292,10
2579780102,2579780102,0,1505,2228,10
2585436407,2585436406,-1,894,1469,10
2586161549,2586161550,1,1265,1369,10
2592468303,2592468313,10,3589,3002,10
2594144030,2594144026,-4,1329,1903,10
2594878418,2594878415,-3,1222,2082,10
2594938729,2594938750,21,767,2005,10
2595463018,2595463015,-3,1373,1995,10
2595893099,2595893098,-1,1112,2348,10
2597445015,2597445012,-3,1047,1538,10
2599454827,2599454827,0,1347,1820,10
2600086450,2600086445,-5,886,2523,10
2600804102,2600804101,-1,1008,1906,10
2602124096,2602124117,21,1401,2561,10
2603652975,2603652954,-21,1239,1762,10
2604635988,2604635985,-3,1154,2334,10
2606099394,2606099391,-3,1321,1992,10
2606197210,2606197188,-22,843,1607,10
2608528237,2608528238,1,1650,1493,10
2609862941,2609862943,2,1713,2121,10
2610264384,2610264383,-1,966,1465,10
2611845565,2611845565,0,1656,2324,10
2613090445,2613090443,-2,966,1106,10
2614084799,2614084798,-1,754,1519,10
2614305985,2614305982,-3,931,2304,10
2618405482,2618405477,-5,1270,3373,10
2620454354,2620454355,1,1159,1396,10
2621012529,2621012525,-4,841,2767,10
2621315817,2621315815,-2,871,1131,10
2623093841,2623093838,-3,1907,2983,10
2624424072,2624424069,-3,1428,1767,10
2627169470,2627169468,-2,839,1980,10
2627468649,2627468651,2,1079,1209,10
2630379671,2630379670,-1,2114,4315,10
2631271599,2631271598,-1,1044,1056,10
2633179175,2633179178,3,1688,1376,10
2636331821,2636331819,-2,1260,2465,10
2638431743,2638431743,0,1195,2032,10
2639267003,2639267002,-1,1459,1768,10
2645175688,2645175683,-5,1316,2093,10
2646060229,2646060230,1,1404,1090,10
2649980670,2649980669,-1,972,1705,10
2650611657,2650611654,-3,1729,2738,10
2654773950,2654773947,-3,1302,2229,10
2664740421,2664740422,1,1520,2040,10
2667891805,2667891802,-3,1120,2294,10
2668812011,2668812011,0,1442,1639,10
2671190954,2671190956,2,1170,1868,10
2678494586,2678494585,-1,1505,2304,10
2679683602,2679683602,0,1325,1479,10
2681011660,2681011654,-6,1090,2245,10
2681512368,2681512366,-2,1619,1961,10
2683612037,2683612038,1,1352,1532,10
2683643923,2683643930,7,1217,1955,10
2685121344,2685121342,-2,1501,2247,10
2685710299,2685710295,-4,1347,2194,10
2689117732,2689117730,-2,1081,1343,10
2689207842,2689207842,0,30968,38541,10
2691579219,2691579217,-2,880,2038,10
2691726266,2691726283,17,977,1392,10
2693157617,2693157615,-2,1426,1813,10
2699211696,2699211693,-3,1263,2547,10
2699780724,2699780722,-2,1132,1880,10
2702068766,2702068770,4,3754,1865,10
2703173244,2703173249,5,2363,1969,10
2706969873,2706969870,-3,1218,2186,10
2709744311,2709744309,-2,1087,2387,10
2710602817,2710602814,-3,908,1769,10
2713155532,2713155532,0,1822,3157,10
2714009523,2714009522,-1,1289,1475,10
2717240887,2717240890,3,1428,1502,10
2720465033,2720465035,2,1041,2136,10
2722352459,2722352456,-3,1189,3042,10
2725638850,2725638849,-1,768,1796,10
2730639186,2730639184,-2,1438,1562,10
2732093799,2732093799,0,563,1493,10
2733032797,2733032799,2,902,917,10
2734493624,2734493624,0,925,1792,10
2735968338,2735968337,-1,1240,1812,10
2737449990,2737449990,0,2209,1920,10
2738306193,2738306192,-1,1464,2095,10
2743024710,2743024710,0,1431,2232,10
2743245300,2743245298,-2,1015,2267,10
2745197353,2745197351,-2,1341,2039,10
2746349710,2746349710,0,1259,1948,10
2748095057,2748095055,-2,1760,1955,10
2748423834,2748423829,-5,979,2406,10
2753860399,2753860398,-1,1505,2291,10
2755446309,2755446307,-2,1501,2672,10
2756910437,2756910437,0,1354,1802,10
2758818878,2758818877,-1,1465,2037,10
2760323799,2760323797,-2,1362,1592,10
2762147459,2762147457,-2,854,1381,10
2763804151,2763804150,-1,785,1090,10
2769697013,2769697011,-2,985,2048,10
2773786019,2773786017,-2,522,1290,10
2780452191,2780452189,-2,1077,1957,10
2780800408,2780800406,-2,1062,2203,10
2781373003,2781373002,-1,1375,1618,10
2782415705,2782415704,-1,1331,2466,10
2782622862,2782622861,-1,1001,1771,10
2784476398,2784476398,0,1247,1595,10
2786376514,2786376514,0,1792,2064,10
2792165895,2792165894,-1,1398,2295,10
2792354508,2792354510,2,1560,1904,10
2793327349,2793327346,-3,1314,2470,10
2799020980,2799020981,1,1673,1933,10
2800770239,2800770238,-1,885,1230,10
2801527787,2801527786,-1,1183,2303,10
2808831016,2808831014,-2,1149,2309,10
2810882979,2810882978,-1,902,1284,10
2813414731,2813414731,0,975,1921,10
2816100839,2816100837,-2,1136,1911,10
2816889637,2816889634,-3,1198,2518,10
2817460858,2817460847,-11,987,1233,10
2817915116,2817915118,2,39269,25923,10
2821223850,2821223850,0,1085,1244,10
2821285079,2821285087,8,12472,25863,10
2822007634,2822007632,-2,1432,2075,10
2825140621,2825140620,-1,1688,2199,10
2831696454,2831696456,2,1487,2249,10
2833364039,2833364038,-1,1236,2207,10
2836156701,2836156698,-3,1120,2152,10
2837540427,2837540426,-1,1186,2147,10
2837598491,2837598490,-1,1031,1265,10
2843686285,2843686284,-1,1158,1560,10
2845231432,2845231430,-2,1369,1886,10
2848691595,2848691594,-1,906,2180,10
2848780804,2848780819,15,141,1480,10
2854916473,2854916472,-1,1256,1721,10
2861325370,2861325368,-2,1343,2088,10
2863826774,2863826790,16,982,1745,10
2864865604,2864865603,-1,1713,2176,10
2868412094,2868412094,0,856,1646,10
2874962839,2874962837,-2,1169,1759,10
2875548828,2875548826,-2,848,1389,10
2875822359,2875822361,2,926,1617,10
2876139920,2876139918,-2,1727,2160,10
2877354343,2877354341,-2,795,2094,10
2881187244,2881187242,-2,1411,1887,10
2882341451,2882341451,0,1026,1277,10
2883423694,2883423697,3,1534,2167,10
2884923754,2884923755,1,1020,2017,10
2885136945,2885136945,0,1140,1530,10
2888156019,2888156020,1,810,1667,10
2889022891,2889022890,-1,1441,1657,10
2889210451,2889210453,2,1203,1580,10
2890294573,2890294563,-10,1120,1584,10
2891114174,2891114172,-2,1416,2733,10
2896957668,2896957668,0,1077,1900,10
2897227450,2897227447,-3,1267,3212,10
2898353362,2898353375,13,402,1070,10
2899782214,2899782209,-5,1081,3041,10
2901016917,2901016916,-1,1496,2009,10
2901139576,2901139598,22,886,1618,10
2902007761,2902007766,5,4522,2151,10
2902230686,2902230686,0,1134,1616,10
2906826182,2906826182,0,1172,1926,10
2908806151,2908806148,-3,1022,1972,10
2908871270,2908871269,-1,1824,2236,10
2910263569,2910263563,-6,1248,1780,10
2911504162,2911504162,0,1603,2094,10
2923370398,2923370395,-3,1694,2544,10
2927878739,2927878736,-3,1410,1689,10
2928578410,2928578414,4,5316,3220,10
2932330002,2932329999,-3,785,2016,10
2934833683,2934833680,-3,1268,1626,10
2936764818,2936764817,-1,927,2111,10
2939391406,2939391408,2,1216,1598,10
2940252843,2940252841,-2,1106,1988,10
2940957207,2940957226,19,1297,2053,10
2946458934,2946458936,2,1713,1855,10
2947545567,2947545567,0,920,1845,10
2950471326,2950471326,0,1733,2773,10
2952074969,2952074969,0,863,1994,10
2952349278,2952349277,-1,1026,2296,10
2955558956,2955558974,18,1668,2406,10
2957185410,2957185409,-1,685,968,10
2961940651,2961940650,-1,1403,1876,10
2962471760,2962471757,-3,947,1748,10
2964365518,2964365514,-4,991,1983,10
2964855829,2964855826,-3,1162,2233,10
2964957597,2964957593,-4,849,2079,10
2968110518,2968110508,-10,1562,717,10
2973412958,2973412954,-4,985,2016,10
2980083389,2980083389,0,1099,1851,10
2980420855,2980420854,-1,1007,1622,10
2980870441,2980870463,22,1629,1770,10
2982045631,2982045632,1,1356,1928,10
2982866512,2982866511,-1,1028,1542,10
2986953155,2986953153,-2,1154,2547,10
2991469646,2991469639,-7,1339,4233,10
2993283908,2993283905,-3,1339,1863,10
2995428622,2995428621,-1,1378,1890,10
2996026662,2996026660,-2,1387,1980,10
2998167736,2998167735,-1,1315,1984,10
2998826701,2998826708,7,9492,3247,10
3000334794,3000334794,0,857,777,10
3004062177,3004062175,-2,1043,1817,10
3006209691,3006209690,-1,1070,1923,10
3007149842,3007149844,2,868,1330,10
3008187983,3008187980,-3,1264,1894,10
3008339018,3008339015,-3,1279,1642,10
3009796908,3009796909,1,1295,2144,10
3010595325,3010595327,2,1017,2439,10
3012803370,3012803368,-2,959,1478,10
3014781499,3014781499,0,1445,2369,10
3015349536,3015349535,-1,1864,2836,10
3017894714,3017894711,-3,1224,2317,10
3022393183,3022393181,-2,1202,1650,10
3026693459,3026693458,-1,1211,2326,10
3033196269,3033196265,-4,1528,2257,10
3033837997,3033837994,-3,1367,2350,10
3034258113,3034258134,21,1248,1951,10
3037198355,3037198352,-3,1303,1685,10
3038490325,3038490322,-3,1002,1943,10
3041923893,3041923892,-1,1627,3013,10
3042994363,3042994374,11,491,1703,10
3045163086,3045163086,0,1145,1754,10
3045373479,3045373475,-4,740,1507,10
3047667796,3047667789,-7,2001,5890,10
3049087093,3049087091,-2,1142,2521,10
3053701037,3053701034,-3,1052,1636,10
3058455533,3058455528,-5,1469,2922,10
3062331070,3062331069,-1,1566,2524,10
3064506549,3064506549,0,934,1567,10
3068083634,3068083631,-3,983,1439,10
3068884017,3068884015,-2,1046,2232,10
3069878618,3069878615,-3,1152,1645,10
3070505035,3070505033,-2,1475,2318,10
3070908598,3070908596,-2,1119,1842,10
3076594219,3076594219,0,1146,1907,10
3077729112,3077729111,-1,1320,1966,10
3077918757,3077918754,-3,1417,2575,10
3079579197,3079579195,-2,1432,1741,10
3082068782,3082068779,-3,1393,1552,10
3085319166,3085319163,-3,948,1270,10
3087046710,3087046710,0,1110,1838,10
3092101350,3092101358,8,19058,53060,10
3095247222,3095247222,0,767,1115,10
3099915562,3099915561,-1,1010,1810,10
3100977106,3100977104,-2,1012,2328,10
3101255740,3101255738,-2,1090,2127,10
3101705041,3101705039,-2,981,1751,10
3104232998,3104232998,0,1402,1862,10
3107747021,3107747007,-14,1686,3149,10
3108812163,3108812162,-1,1353,2477,10
3108844393,3108844391,-2,898,1353,10
3108975506,3108975519,13,243,1166,10
3110240582,3110240582,0,1122,1772,10
3113484283,3113484266,-17,1128,1842,10
3115774618,3115774618,0,2955,4017,10
3116700094,3116700095,1,1674,1589,10
3117224756,3117224755,-1,1136,2155,10
3118389216,3118389215,-1,1577,1899,10
3120755598,3120755602,4,2047,1509,10
3120793933,3120793934,1,867,1159,10
3124039282,3124039282,0,1793,2944,10
3124602532,3124602529,-3,1736,2291,10
3124930579,3124930577,-2,1048,2642,10
3127697700,3127697700,0,1236,2155,10
3129276548,3129276550,2,1038,1564,10
3130219229,3130219225,-4,1349,2624,10
3130878003,3130878023,20,604,1153,10
3132885125,3132885124,-1,957,1878,10
3133078535,3133078533,-2,1181,1740,10
3135730150,3135730156,6,2181,1423,10
3135878114,3135878110,-4,1376,2221,10
3137319770,3137319769,-1,1218,1582,10
3140413016,3140413014,-2,1262,1443,10
3144300467,3144300466,-1,1075,1958,10
3145344156,3145344154,-2,1240,1765,10
3147097378,3147097377,-1,1084,1945,10
3147180202,3147180203,1,1429,1996,10
3147682796,3147682793,-3,1393,2372,10
3148133483,3148133480,-3,1287,2194,10
3148182633,3148182630,-3,1249,1673,10
3151905753,3151905751,-2,1280,2482,10
3152348134,3152348133,-1,1225,1577,10
3156958782,3156958781,-1,1242,2005,10
3156998121,3156998121,0,1144,2118,10
3167963285,3167963286,1,1214,1918,10
3168535589,3168535589,0,1398,1881,10
3169559619,3169559614,-5,1020,2296,10
3169897916,3169897914,-2,5750,8641,10
3170674000,3170673999,-1,1019,1610,10
3174286595,3174286592,-3,635,1669,10
3179808444,3179808443,-1,1721,2433,10
3181801578,3181801578,0,1303,1863,10
3181873984,3181873967,-17,118,660,10
3183081739,3183081739,0,1343,2195,10
3183515972,3183515970,-2,899,1246,10
3183895410,3183895417,7,4169,2224,10
3184067699,3184067698,-1,1003,1645,10
3185767152,3185767150,-2,1085,2137,10
3190275751,3190275751,0,1604,1305,10
3191036620,3191036618,-2,1405,2025,10
3191998734,3191998730,-4,1224,2434,10
3192981277,3192981273,-4,1351,2778,10
3196587262,3196587259,-3,1247,1870,10
3200219327,3200219325,-2,1218,2041,10
3200891844,3200891842,-2,1398,2448,10
3206455608,3206455605,-3,1511,1944,10
3208107447,3208107445,-2,1112,2298,10
3211298665,3211298662,-3,1218,2152,10
3211438495,3211438493,-2,927,2010,10
3212770831,3212770830,-1,1255,1736,10
3214946211,3214946208,-3,1215,2115,10
3215202762,3215202761,-1,1065,1791,10
3218519626,3218519624,-2,1839,2268,10
3223969922,3223969918,-4,903,1049,10
3224328178,3224328175,-3,944,2572,10
3224497146,3224497145,-1,1213,2148,10
3224719422,3224719421,-1,1205,1353,10
3225511954,3225511954,0,820,1744,10
3227072950,3227072947,-3,910,1946,10
3230619308,3230619307,-1,992,2786,10
3232463238,3232463237,-1,1047,2362,10
3233011365,3233011363,-2,859,1784,10
3233415489,3233415492,3,67599,50139,10
3235639333,3235639334,1,1104,1696,10
3236269503,3236269502,-1,1243,2203,10
3236625002,3236625001,-1,948,1444,10
3236881397,3236881395,-2,1203,2212,10
3237535005,3237535002,-3,1168,2195,10
3241458819,3241458821,2,1283,2226,10
3245213475,3245213477,2,1309,1762,10
3247983041,3247983041,0,2046,2598,10
3251859203,3251859204,1,3196,3961,10
3254447357,3254447358,1,1402,1896,10
3256168351,3256168350,-1,1148,2098,10
3256730518,3256730514,-4,816,1228,10
3259738778,3259738776,-2,1296,2185,10
3260277954,3260277951,-3,1272,2073,10
3264658929,3264658929,0,1282,2138,10
3266159562,3266159561,-1,527,1785,10
3267385819,3267385819,0,1038,1880,10
3268692878,3268692877,-1,1434,2352,10
3269882350,3269882348,-2,1404,2783,10
3273736867,3273736868,1,1263,1568,10
3275157661,3275157659,-2,1324,2657,10
3276628438,3276628435,-3,1081,1857,10
3277206715,3277206714,-1,1066,1654,10
3277463442,3277463445,3,91,3226,10
3281838956,3281838955,-1,2191,2905,10
3282933362,3282933341,-21,1137,2526,10
3282986698,3282986697,-1,1335,1424,10
3283141401,3283141399,-2,1231,2193,10
3283503410,3283503413,3,1595,1970,10
3284624877,3284624881,4,2596,1652,10
3291261155,3291261153,-2,461,1086,10
3298054362,3298054373,11,1145,1824,10
3303988019,3303988018,-1,1078,2230,10
3304151829,3304151826,-3,1135,2722,10
3306276870,3306276868,-2,927,2875,10
3307394195,3307394194,-1,1224,1798,10
3307762267,3307762272,5,707,1232,10
3314324249,3314324248,-1,1139,1850,10
3316631082,3316631079,-3,1141,2300,10
3318411249,3318411249,0,1149,1553,10
3319571856,3319571854,-2,1627,2149,10
3320053070,3320053066,-4,1269,3229,10
3320736774,3320736772,-2,1374,2262,10
3320775538,3320775535,-3,1096,2133,10
3322475428,3322475428,0,1059,2002,10
3324711694,3324711694,0,1393,2569,10
3327315667,3327315671,4,1508,502,10
3330851336,3330851342,6,6619,1960,10
3331063498,3331063497,-1,882,2275,10
3337476522,3337476519,-3,1645,2143,10
3342745296,3342745298,2,1622,2240,10
3347029135,3347029139,4,1821,1340,10
3347586129,3347586127,-2,1312,2194,10
3348364522,3348364527,5,1075,2105,10
3352662217,3352662217,0,1948,2289,10
3353071605,3353071602,-3,1663,2733,10
3357570113,3357570110,-3,598,1169,10
3370520454,3370520446,-8,24035,15542,10
3373991951,3373991950,-1,1506,2183,10
3374694916,3374694915,-1,1176,2030,10
3378259597,3378259601,4,5619,2525,10
3379821109,3379821107,-2,1116,1965,10
3380257202,3380257201,-1,1192,1681,10
3381670172,3381670170,-2,1299,2785,10
3383067237,3383067235,-2,2449,4303,10
3384036441,3384036439,-2,1322,1944,10
3386408923,3386408922,-1,1309,1920,10
3387006890,3387006893,3,48004,39116,10
3388683217,3388683217,0,899,1963,10
3389809643,3389809643,0,1325,2654,10
3393150027,3393150027,0,1583,2038,10
3397885880,3397885874,-6,87,766,10
3400168381,3400168378,-3,1431,2276,10
3400848567,3400848569,2,1976,2029,10
3401195941,3401195937,-4,1464,2048,10
3401523704,3401523685,-19,1096,4056,10
3401743718,3401743715,-3,1051,2560,10
3408528075,3408528073,-2,1045,1820,10
3408660878,3408660877,-1,1468,2272,10
3411721634,3411721631,-3,1176,2141,10
3414418335,3414418333,-2,1200,1725,10
3422402046,3422402046,0,12858,17100,10
3427468974,3427468968,-6,34387,15037,10
3427754450,3427754450,0,1214,1971,10
3429138763,3429138762,-1,927,1918,10
3430838222,3430838220,-2,1001,1636,10
3437314591,3437314590,-1,1365,2451,10
3437484743,3437484741,-2,1158,1780,10
3442110738,3442110744,6,1209,1599,10
3444705851,3444705851,0,1089,1760,10
3448769943,3448769938,-5,1058,2147,10
3448812687,3448812686,-1,1044,1876,10
3450558321,3450558321,0,1084,2865,10
3454149065,3454149064,-1,1266,1981,10
3454836667,3454836667,0,820,1655,10
3464631678,3464631674,-4,1672,2748,10
3466896407,3466896406,-1,1092,1966,10
3469325670,3469325669,-1,1458,2410,10
3472374446,3472374447,1,962,1951,10
3480464279,3480464279,0,1812,2916,10
3481806954,3481806954,0,1613,2829,10
3483280594,3483280595,1,1334,1867,10
3486583485,3486583483,-2,1063,1634,10
3489418982,3489418980,-2,973,2144,10
3494671908,3494671906,-2,1233,2457,10
3494760556,3494760556,0,1226,3113,10
3496300514,3496300513,-1,1122,1820,10
3496387299,3496387297,-2,1390,1882,10
3497814081,3497814082,1,2119,3261,10
3499593849,3499593847,-2,880,1461,10
3500750287,3500750287,0,973,1797,10
3501466425,3501466428,3,2683,1492,10
3503707890,3503707889,-1,1113,1398,10
3505295784,3505295802,18,736,1437,10
3507486885,3507486891,6,3710,1427,10
3508107606,3508107607,1,1519,1762,10
3508414827,3508414824,-3,1604,3191,10
3509038006,3509038005,-1,1306,2745,10
3512440667,3512440664,-3,993,2639,10
3513247767,3513247762,-5,1413,2649,10
3513793117,3513793117,0,990,1710,10
3513861683,3513861671,-12,1012,1176,10
3514811383,3514811380,-3,1958,5547,10
3514895064,3514895062,-2,1538,2320,10
3516954969,3516954967,-2,1385,1755,10
3518899030,3518899026,-4,499,1078,10
3522739296,3522739303,7,3061,1333,10
3523106342,3523106341,-1,1093,1334,10
3524195322,3524195321,-1,1201,2118,10
3533096882,3533096881,-1,1170,1983,10
3534557958,3534557958,0,1396,1579,10
3539236430,3539236419,-11,926,1476,10
3540718042,3540718042,0,1194,1665,10
3541695575,3541695573,-2,1192,2443,10
3544669303,3544669301,-2,1294,2748,10
3545480331,3545480322,-9,1003,1181,10
3546746714,3546746713,-1,1192,1843,10
3550174609,3550174609,0,3226,4170,10
3552422556,3552422573,17,418,1390,10
3554067363,3554067345,-18,1248,1860,10
3555945106,3555945105,-1,1391,1860,10
3557338190,3557338189,-1,1112,2748,10
3557716671,3557716674,3,2367,1892,10
3557895950,3557895949,-1,1190,2987,10
3558714023,3558714022,-1,1410,2165,10
3562551190,3562551189,-1,1687,2284,10
3562872569,3562872568,-1,1148,1441,10
3567674389,3567674389,0,1463,1737,10
3569600298,3569600299,1,1316,1976,10
3572876982,3572876982,0,1615,2927,10
3584386842,3584386846,4,1406,1454,10
3584987265,3584987263,-2,1121,2103,10
3585446550,3585446548,-2,962,2004,10
3585683162,3585683181,19,1036,1697,10
3591398581,3591398579,-2,909,1174,10
3594278439,3594278437,-2,1069,1272,10
3599475582,3599475581,-1,1180,1068,10
3604516098,3604516096,-2,1630,1856,10
3605222082,3605222083,1,1347,1891,10
3605792629,3605792626,-3,1546,2010,10
3607054173,3607054170,-3,951,1065,10
3607490751,3607490750,-1,749,961,10
3608795826,3608795825,-1,1609,2953,10
3609636913,3609636913,0,1796,1799,10
3610969740,3610969739,-1,1275,1885,10
3612424402,3612424402,0,1169,1066,10
3614236975,3614236973,-2,1052,1726,10
3622132198,3622132198,0,1080,1880,10
3622956927,3622956926,-1,1895,2571,10
3627741435,3627741433,-2,817,999,10
3630565213,3630565212,-1,1007,2887,10
3630799683,3630799682,-1,1449,2055,10
3633364747,3633364745,-2,984,1401,10
3634404282,3634404262,-20,1194,1988,10
3635635182,3635635183,1,1141,1615,10
3637115698,3637115699,1,1096,1798,10
3638933318,3638933317,-1,1141,1444,10
3640611798,3640611793,-5,1025,2133,10
3641027318,3641027317,-1,1750,2021,10
3643013374,3643013372,-2,1231,2856,10
3646005343,3646005340,-3,1256,2662,10
3646125313,3646125307,-6,1000,1833,10
3646460040,3646460026,-14,1013,1569,10
3648148299,3648148298,-1,1413,2013,10
3650253839,3650253838,-1,1002,1701,10
3653232891,3653232890,-1,1004,2163,10
3653717506,3653717505,-1,990,1860,10
3654008505,3654008526,21,116,865,10
3660430546,3660430543,-3,771,1773,10
3661592791,3661592790,-1,1535,2212,10
3664566567,3664566570,3,952,797,10
3667844439,3667844439,0,1227,2316,10
3671226263,3671226262,-1,726,1188,10
3672283642,3672283641,-1,1214,1934,10
3676685341,3676685340,-1,1175,1486,10
3679038877,3679038873,-4,1559,2635,10
3679775371,3679775370,-1,1037,1943,10
3680142786,3680142785,-1,1448,2017,10
3682421827,3682421825,-2,1317,1990,10
3684813703,3684813694,-9,31986,12907,10
3685272362,3685272350,-12,43800,13856,10
3686570670,3686570669,-1,1056,1373,10
3687928234,3687928231,-3,1220,2127,10
3691141597,3691141596,-1,1034,2062,10
3692234931,3692234930,-1,827,1264,10
3694192419,3694192418,-1,895,1340,10
3695098529,3695098528,-1,1634,1619,10
3699365485,3699365482,-3,923,2606,10
3700762922,3700762922,0,1174,1781,10
3702849082,3702849078,-4,1058,1877,10
3708370714,3708370712,-2,762,1493,10
3709660387,3709660386,-1,1303,1733,10
3715591622,3715591620,-2,2287,3082,10
3724715162,3724715163,1,1344,1650,10
3728807285,3728807285,0,1233,2283,10
3732295629,3732295626,-3,1892,2143,10
3733401759,3733401758,-1,1137,1927,10
3733678907,3733678905,-2,1710,1378,10
3739353306,3739353311,5,1815,1283,10
3742671956,3742671963,7,10997,3889,10
3743060963,3743060966,3,19635,30389,10
3760676715,3760676712,-3,874,1513,10
3762718451,3762718450,-1,1339,1307,10
3763421685,3763421681,-4,892,2056,10
3764745714,3764745711,-3,1192,2050,10
3765969219,3765969218,-1,1143,2366,10
3766866294,3766866293,-1,1431,2037,10
3768660990,3768660989,-1,1236,2012,10
3772277622,3772277621,-1,971,1659,10
3775571893,3775571890,-3,1567,1987,10
3776980747,3776980745,-2,1023,1777,10
3788716818,3788716817,-1,1133,1702,10
3789939334,3789939331,-3,978,2173,10
3796147306,3796147306,0,1014,1084,10
3799132870,3799132868,-2,782,1486,10
3799506770,3799506766,-4,1617,3499,10
3802378950,3802378950,0,1014,1616,10
3805303303,3805303302,-1,1003,1847,10
3810445071,3810445069,-2,1302,1879,10
3813868804,3813868804,0,1025,1330,10
3815267166,3815267166,0,1352,2319,10
3819255317,3819255316,-1,1330,2111,10
3820981415,3820981414,-1,1359,2285,10
3822127459,3822127455,-4,948,2309,10
3823435737,3823435738,1,2191,3045,10
3828737269,3828737266,-3,1166,1394,10
3829146259,3829146262,3,2616,1912,10
3832797730,3832797727,-3,1314,2375,10
3833436384,3833436386,2,1571,1635,10
3837423607,3837423606,-1,1272,2027,10
3838399158,3838399158,0,1641,3011,10
3839206699,3839206697,-2,1186,2213,10
3840975014,3840975013,-1,1134,2005,10
3841432369,3841432367,-2,1296,2262,10
3841828298,3841828287,-11,582,6146,10
3842090407,3842090404,-3,1544,3637,10
3843001461,3843001461,0,1264,2410,10
3844415788,3844415788,0,1651,2075,10
3847627483,3847627479,-4,1337,2035,10
3851962606,3851962605,-1,851,1640,10
3852485157,3852485157,0,1222,1671,10
3854124991,3854124991,0,1048,2112,10
3856005739,3856005737,-2,1107,2445,10
3856040658,3856040678,20,344,1095,10
3858274124,3858274124,0,1181,1627,10
3858406859,3858406858,-1,1138,1567,10
3863456603,3863456602,-1,1449,1913,10
3864253233,3864253233,0,1155,2681,10
3864725826,3864725825,-1,1398,2793,10
3869710503,3869710506,3,1521,1639,10
3871621326,3871621324,-2,930,1025,10
3875601325,3875601323,-2,834,1459,10
3875951411,3875951412,1,724,1596,10
3884372170,3884372168,-2,1232,1778,10
3890788995,3890788994,-1,1165,1558,10
3900448829,3900448828,-1,1186,1882,10
3902564625,3902564623,-2,1618,2871,10
3903132525,3903132524,-1,1093,1965,10
3905500816,3905500813,-3,1397,2006,10
3909568435,3909568435,0,1310,2302,10
3910026682,3910026686,4,1999,1389,10
3912095074,3912095072,-2,836,1568,10
3919086488,3919086486,-2,1180,1334,10
3919835675,3919835675,0,1055,933,10
3921487025,3921487033,8,8741,31958,10
3924053296,3924053294,-2,1023,2148,10
3928744653,3928744654,1,1499,2586,10
3931890153,3931890156,3,15061,12726,10
3934331659,3934331658,-1,1148,2044,10
3934444955,3934444954,-1,1142,2777,10
3936892899,3936892896,-3,1068,1750,10
3938908246,3938908258,12,1193,1545,10
3939361546,3939361543,-3,659,1936,10
3939448064,3939448071,7,20598,22096,10
3942389955,3942389953,-2,1131,2969,10
3949735202,3949735199,-3,824,1699,10
3951565495,3951565493,-2,1305,2832,10
3953154547,3953154546,-1,929,1568,10
3953194961,3953194961,0,815,1543,10
3956179796,3956179795,-1,1812,2307,10
3956329566,3956329566,0,1216,1605,10
3956692270,3956692267,-3,1103,2387,10
3958195634,3958195633,-1,1370,1666,10
3960776319,3960776317,-2,533,964,10
3961454780,3961454803,23,933,2153,10
3962161046,3962161046,0,901,1147,10
3974387242,3974387240,-2,1589,2801,10
3976591258,3976591255,-3,1425,1610,10
3979932280,3979932280,0,1967,1713,10
3981584321,3981584321,0,1268,1960,10
3984791850,3984791847,-3,1140,1970,10
3987136286,3987136283,-3,1055,1661,10
3988269090,3988269090,0,1316,1710,10
3988542670,3988542667,-3,994,1480,10
3994109947,3994109944,-3,1008,2555,10
3994676852,3994676870,18,4083,9244,10
3997572463,3997572462,-1,1398,1690,10
3998114813,3998114813,0,1048,1938,10
3998781421,3998781418,-3,988,1874,10
4000396138,4000396137,-1,1052,1672,10
4001965365,4001965364,-1,1274,1427,10
4002488790,4002488789,-1,2006,3069,10
4003051955,4003051950,-5,982,2475,10
4004426527,4004426527,0,1188,1905,10
4007953569,4007953565,-4,1143,2156,10
4010412649,4010412649,0,1878,2566,10
4013537370,4013537370,0,954,1283,10
4014206222,4014206222,0,1016,1508,10
4016828483,4016828481,-2,1096,2198,10
4017485098,4017485096,-2,907,1144,10
4019489668,4019489667,-1,1376,1472,10
4022145827,4022145826,-1,1640,2502,10
4022197218,4022197218,0,1527,1888,10
4022426033,4022426029,-4,1232,1642,10
4023775954,4023775951,-3,801,1285,10
4024398857,4024398852,-5,2496,6532,10
4032003792,4032003791,-1,1623,1946,10
4032042451,4032042449,-2,1363,2664,10
4036022772,4036022770,-2,1261,2011,10
4038078240,4038078244,4,1516,995,10
4043579406,4043579405,-1,1207,2398,10
4049719680,4049719678,-2,1014,1790,10
4061222694,4061222695,1,1035,2168,10
4061345647,4061345642,-5,839,2376,10
4061561521,4061561542,21,1153,2350,10
4069705780,4069705780,0,1491,2092,10
4070009142,4070009138,-4,1145,1864,10
4071083317,4071083316,-1,1050,2599,10
4071602804,4071602805,1,1541,1906,10
4074508197,4074508196,-1,1017,1116,10
4078343648,4078343646,-2,863,1510,10
4078544746,4078544765,19,565,3279,10
4085722035,4085722022,-13,65,861,10
4088641203,4088641201,-2,1352,2323,10
4089919630,4089919630,0,1414,1538,10
4091218903,4091218898,-5,1269,2080,10
4093236018,4093236016,-2,1273,1508,10
4098172562,4098172560,-2,1240,1852,10
4101527179,4101527174,-5,1364,2143,10
4102192213,4102192215,2,1543,1787,10
4103508195,4103508191,-4,1456,3103,10
4104397578,4104397576,-2,1174,2114,10
4107550821,4107550818,-3,1079,1861,10
4113750659,4113750660,1,1320,1857,10
4117565041,4117565039,-2,1008,1607,10
4123758663,4123758662,-1,1466,2286,10
4129390514,4129390514,0,1014,1870,10
4131789213,4131789211,-2,883,1750,10
4133574318,4133574318,0,1158,2158,10
4135663393,4135663392,-1,1414,2181,10
4139023813,4139023809,-4,1208,1841,10
4140197674,4140197673,-1,1128,2288,10
4144003967,4144003966,-1,1312,2130,10
4149287950,4149287950,0,1786,2184,10
4150732757,4150732756,-1,718,1288,10
4153280946,4153280945,-1,1489,1740,10
4164403340,4164403337,-3,928,2063,10
4164620263,4164620263,0,1464,2141,10
4164694491,4164694511,20,2102,2646,10
4165523715,4165523713,-2,1212,2059,10
4169370294,4169370293,-1,1366,1948,10
4170913316,4170913316,0,1183,2087,10
4172224841,4172224829,-12,1177,1713,10
4173427013,4173427010,-3,1321,3333,10
4182307261,4182307262,1,1620,1287,10
4183155336,4183155334,-2,1586,2699,10
4184623382,4184623379,-3,1159,1447,10
4188405559,4188405558,-1,1259,1855,10
4190025838,4190025835,-3,1223,1945,10
4190519523,4190519518,-5,1024,2691,10
4191664922,4191664922,0,938,1075,10
4191831363,4191831363,0,1187,1736,10
4192493318,4192493318,0,2487,3296,10
4193440219,4193440218,-1,1246,2402,10
4197541235,4197541234,-1,905,1691,10
4197711805,4197711805,0,1258,1872,10
4198710657,4198710657,0,931,2533,10
4198774702,4198774701,-1,880,1470,10
4200025444,4200025440,-4,1132,2192,10
4200195910,4200195907,-3,939,1262,10
4205914662,4205914662,0,1475,1482,10
4206623566,4206623566,0,1252,2162,10
4213012411,4213012410,-1,1427,2229,10
4214416486,4214416487,1,1463,1722,10
4215404380,4215404378,-2,1335,1998,10
4215684562,4215684562,0,1121,1542,10
4221997267,4221997266,-1,1320,2671,10
4225284917,4225284914,-3,1147,2099,10
4225341611,4225341609,-2,1311,2733,10
4225542321,4225542308,-13,1219,1413,10
4227082094,4227082092,-2,1348,1726,10
4227370607,4227370607,0,1195,1560,10
4230169654,4230169650,-4,1015,2293,10
4234149335,4234149334,-1,1239,1765,10
4234197798,4234197795,-3,1339,2739,10
4239535414,4239535413,-1,1360,1332,10
4240636087,4240636088,1,1449,1835,10
4241742994,4241742994,0,1486,3122,10
4242116353,4242116352,-1,888,1373,10
4243068578,4243068577,-1,1275,1756,10
4244043834,4244043823,-11,37473,15225,10
4244339906,4244339907,1,1438,1380,10
4248935586,4248935584,-2,1683,2205,10
4250213267,4250213266,-1,1863,3121,10
4251668512,4251668510,-2,808,1720,10
4257782885,4257782881,-4,1379,2639,10
4260891383,4260891379,-4,1401,1909,10
4261677837,4261677836,-1,1317,2274,10
4262679342,4262679342,0,1082,1428,10
4263625971,4263625974,3,247,1484,10
4264265406,4264265406,0,1475,1546,10
4274220357,4274220357,0,1756,1883,10
4279941832,4279941831,-1,859,1069,10
4280265020,4280265039,19,1071,1808,10
4281076664,4281076666,2,1323,1413,10
4281817095,4281817097,2,1522,1666,10
4283266709,4283266706,-3,1285,2616,10
4283328730,4283328730,0,1179,2259,10
4284389886,4284389883,-3,1333,1066,10
4286236829,4286236826,-3,1010,1759,10
4286804801,4286804800,-1,985,1618,10
4288719981,4288719978,-3,1220,3302,10
4288979184,4288979182,-2,1477,2862,10
4289535983,4289535981,-2,1473,1653,10
4291393032,4291393030,-2,995,1575,10
4292436941,4292436941,0,1542,2532,10
4294538068,4294538067,-1,970,2003,10
4294814564,4294814563,-1,2316,5057,10
4296424613,4296424611,-2,1405,2228,10
4297849952,4297849950,-2,870,1136,10
4298794445,4298794450,5,2084,1869,10
4303748180,4303748179,-1,912,2090,10
4306590974,4306590973,-1,1292,1733,10
4309007887,4309007886,-1,1002,1174,10
4310508199,4310508194,-5,1012,2536,10
4313123842,4313123839,-3,1255,2159,10
4322037387,4322037385,-2,1034,2052,10
4329201328,4329201326,-2,1163,1924,10
4335979238,4335979237,-1,1754,2606,10
4338721095,4338721093,-2,1450,1928,10
4339531346,4339531350,4,7858,6256,10
4340580479,4340580464,-15,1509,1957,10
4341324186,4341324185,-1,1209,2247,10
4342274009,4342274009,0,1225,2243,10
4343080047,4343080045,-2,1055,1925,10
4346888070,4346888070,0,942,1409,10
4350260561,4350260558,-3,1174,2060,10
4350933594,4350933594,0,460,1282,10
4353282105,4353282107,2,1698,1998,10
4353373886,4353373886,0,1112,2238,10
4354448398,4354448397,-1,1030,2110,10
4356928353,4356928356,3,1480,1493,10
4357551890,4357551889,-1,1039,2110,10
4357682862,4357682865,3,1072,1704,10
4359348515,4359348514,-1,934,1847,10
4360124714,4360124712,-2,1546,2416,10
4360393771,4360393769,-2,1243,2472,10
4364574730,4364574728,-2,1023,1917,10
4365257521,4365257522,1,880,1621,10
4365467242,4365467241,-1,1412,1659,10
4371487728,4371487727,-1,1641,1834,10
4373407779,4373407765,-14,1148,6104,10
4374806043,4374806040,-3,1056,2386,10
4375962855,4375962856,1,2422,2992,10
4376849078,4376849075,-3,1067,1813,10
4377624941,4377624939,-2,1077,1960,10
4378445175,4378445173,-2,1707,2079,10
4382014217,4382014217,0,1829,2382,10
4383168823,4383168821,-2,1280,2613,10
4383678293,4383678292,-1,1310,1922,10
4385494966,4385494963,-3,1091,2496,10
4387623132,4387623134,2,2249,2487,10
4388983073,4388983067,-6,1209,2645,10
4392650258,4392650258,0,1341,2303,10
4394392820,4394392816,-4,1385,2721,10
4395106229,4395106226,-3,1105,2194,10
4408559186,4408559186,0,1247,2066,10
4410493885,4410493884,-1,1552,2195,10
4422103510,4422103509,-1,1374,1500,10
4425930134,4425930132,-2,877,2212,10
4428056272,4428056272,0,1183,1403,10
4428281080,4428281102,22,1840,1940,10
4432648577,4432648575,-2,1485,2146,10
4434437448,4434437447,-1,1692,2024,10
4436647782,4436647778,-4,1007,2877,10
4440546606,4440546605,-1,1591,2105,10
4444241129,4444241130,1,2208,2324,10
4444395705,4444395703,-2,906,1717,10
4445079591,4445079587,-4,1173,1678,10
4452219483,4452219481,-2,1230,2304,10
4455125766,4455125769,3,4153,3071,10
4455963777,4455963769,-8,1144,1794,10
4462585880,4462585874,-6,2371,9558,10
4466898115,4466898115,0,1120,2153,10
4467991064,4467991062,-2,1230,2105,10
4469433445,4469433462,17,1430,2021,10
4472242524,4472242522,-2,893,1215,10
4474777512,4474777510,-2,1391,2209,10
4476211958,4476211956,-2,1040,1926,10
4476328761,4476328752,-9,1273,1961,10
4477005397,4477005393,-4,1296,2934,10
4477229646,4477229644,-2,1524,3005,10
4478978095,4478978091,-4,1380,1232,10
4482526029,4482526027,-2,1553,2072,10
4485968042,4485968042,0,1340,1541,10
4487973012,4487973010,-2,1221,2087,10
4493642324,4493642322,-2,1049,1992,10
4497570642,4497570642,0,1501,1758,10
4499806151,4499806149,-2,1213,1545,10
4504947369,4504947368,-1,1734,3081,10
4508293606,4508293605,-1,1027,1890,10
4515694373,4515694371,-2,1521,2685,10
4516638695,4516638695,0,1375,1621,10
4520704198,4520704198,0,789,1147,10
4523749121,4523749121,0,1128,2355,10
4525545850,4525545850,0,1685,1877,10
4532564238,4532564233,-5,1037,1793,10
4534631870,4534631866,-4,968,2402,10
4534974177,4534974199,22,973,2158,10
4536498563,4536498541,-22,976,2424,10
4538211542,4538211541,-1,1308,2348,10
4538565786,4538565781,-5,2812,7272,10
4540510108,4540510106,-2,837,1766,10
4544446766,4544446762,-4,782,1812,10
4545549150,4545549151,1,991,1670,10
4545771823,4545771822,-1,1067,2331,10
4547110053,4547110054,1,739,1139,10
4550107179,4550107178,-1,1257,2288,10
4550525847,4550525847,0,1510,2137,10
4552002795,4552002793,-2,1253,2193,10
4552149986,4552149978,-8,1424,2250,10
4557818273,4557818273,0,1390,2318,10
4558449718,4558449717,-1,1090,1444,10
4560590777,4560590776,-1,1358,2076,10
4571344562,4571344560,-2,1610,2241,10
4571599285,4571599284,-1,1073,1915,10
4573256010,4573256011,1,1068,2352,10
4574431165,4574431165,0,972,1993,10
4574813270,4574813269,-1,893,1741,10
4582645695,4582645694,-1,1184,1316,10
4587046333,4587046330,-3,1540,1512,10
4587750107,4587750105,-2,1104,1952,10
4587962762,4587962765,3,1782,919,10
4591292282,4591292286,4,1134,1009,10
4593096510,4593096506,-4,1386,2621,10
4595977588,4595977587,-1,1789,2651,10
4597045108,4597045106,-2,1190,1794,10
4598309183,4598309182,-1,1359,2535,10
4598954678,4598954678,0,970,1658,10
4602134051,4602134050,-1,1059,2159,10
4603811082,4603811081,-1,1201,1553,10
4604140385,4604140406,21,60,1049,10
4605017793,4605017786,-7,1684,5227,10
4607253406,4607253406,0,1225,2021,10
4607392865,4607392878,13,449,843,10
4609498010,4609498009,-1,1007,1764,10
4609813515,4609813513,-2,1027,1933,10
4611421994,4611421991,-3,1192,4267,10
4618256318,4618256317,-1,1638,2175,10
4618480230,4618480229,-1,766,1546,10
4620171608,4620171619,11,18780,48431,10
4621050751,4621050747,-4,1295,2336,10
4622603455,4622603457,2,1896,1437,10
4623254941,4623254938,-3,1304,1363,10
4626197893,4626197894,1,1163,1361,10
4627659442,4627659438,-4,1751,2790,10
4628840738,4628840735,-3,968,2019,10
4631846383,4631846382,-1,939,1766,10
4632238694,4632238691,-3,1467,2679,10
4635666033,4635666034,1,2205,1549,10
4638903399,4638903401,2,1365,1295,10
4641540139,4641540136,-3,1087,1821,10
4642588565,4642588563,-2,1291,1504,10
4643035162,4643035161,-1,1433,1693,10
4644015122,4644015121,-1,980,1313,10
4647042003,4647042006,3,2800,2113,10
4647401581,4647401578,-3,1105,2360,10
4648730495,4648730492,-3,1471,2240,10
4649471245,4649471244,-1,8543,14380,10
4649938355,4649938355,0,890,1200,10
4657725917,4657725916,-1,1498,2626,10
4658419363,4658419361,-2,971,1542,10
4660649723,4660649722,-1,1289,1373,10
4660880400,4660880398,-2,1623,2159,10
4661550266,4661550286,20,1139,1555,10
4666614978,4666614978,0,1624,2390,10
4671780394,4671780393,-1,1164,1852,10
4672377640,4672377639,-1,989,1850,10
4675302768,4675302768,0,1487,1729,10
4676940642,4676940642,0,1958,2451,10
4681331643,4681331640,-3,693,1514,10
4683773762,4683773761,-1,1150,1764,10
4687217279,4687217278,-1,691,1686,10
4688963279,4688963270,-9,2418,358,10
4689849629,4689849626,-3,984,2174,10
4691572353,4691572353,0,817,1062,10
4692555084,4692555080,-4,2359,6285,10
4693838977,4693838977,0,1354,1445,10
4696600043,4696600041,-2,1594,1716,10
4700044494,4700044493,-1,909,1616,10
4700566805,4700566803,-2,1503,2083,10
4702437869,4702437869,0,1440,1469,10
4704332954,4704332957,3,1972,1740,10
4706147045,4706147042,-3,959,2210,10
4707469654,4707469653,-1,1305,2109,10
4711972881,4711972878,-3,1094,2410,10
4713579039,4713579038,-1,1624,2462,10
4714430318,4714430318,0,1496,2035,10
4714962078,4714962076,-2,917,1588,10
4718414491,4718414491,0,2215,2547,10
4720099850,4720099847,-3,1450,2476,10
4720194196,4720194178,-18,1211,1268,10
4720957734,4720957730,-4,976,2192,10
4721297778,4721297782,4,81828,56214,10
4723036763,4723036762,-1,1553,2244,10
4725593202,4725593202,0,1283,2494,10
4728023450,4728023447,-3,1213,1793,10
4730518674,4730518666,-8,847,2078,10
4732097079,4732097077,-2,1384,2038,10
4733144647,4733144649,2,1599,1589,10
4733820443,4733820438,-5,1523,2476,10
4735016506,4735016520,14,1283,1734,10
4736504314,4736504312,-2,1216,2471,10
4739425086,4739425086,0,1157,1707,10
4741720583,4741720582,-1,1517,973,10
4742029855,4742029853,-2,1373,2177,10
4743259543,4743259539,-4,1296,2669,10
4743492025,4743492045,20,1113,2178,10
4749102911,4749102911,0,922,1182,10
4750357186,4750357187,1,1227,1875,10
4753415329,4753415330,1,1883,1987,10
4755134666,4755134662,-4,1508,1606,10
4756067578,4756067575,-3,1334,1890,10
4756100540,4756100538,-2,1216,1598,10
4759626742,4759626741,-1,1968,2384,10
4760510286,4760510290,4,2074,1077,10
4761434566,4761434565,-1,1471,2156,10
4762016795,4762016795,0,1019,2293,10
4762521385,4762521382,-3,924,996,10
4769474457,4769474458,1,1059,2043,10
4769791129,4769791130,1,1037,1523,10
4773059865,4773059858,-7,229,850,10
4774790033,4774790033,0,1329,2265,10
4777916182,4777916181,-1,887,3162,10
4779868378,4779868376,-2,2985,3220,10
4782815714,4782815711,-3,1295,1083,10
4784221706,4784221706,0,1284,1826,10
4786809795,4786809793,-2,924,1824,10
4787843302,4787843301,-1,1361,1544,10
4790030683,4790030685,2,1782,1528,10
4790394122,4790394122,0,698,1766,10
4793623806,4793623802,-4,1481,3872,10
4794342592,4794342591,-1,1568,1993,10
4798490738,4798490737,-1,1622,2019,10
4800814123,4800814102,-21,982,2182,10
4801884754,4801884775,21,347,571,10
4803783824,4803783821,-3,1343,1757,10
4804852577,4804852572,-5,1154,2282,10
4807488932,4807488930,-2,928,1785,10
4808862230,4808862227,-3,1550,2395,10
4813122322,4813122319,-3,1254,1914,10
4815400269,4815400269,0,1182,2128,10
4816968046,4816968041,-5,870,1661,10
4824884842,4824884863,21,1037,1156,10
4826264946,4826264946,0,1452,2135,10
4827105930,4827105930,0,1035,1398,10
4828665439,4828665437,-2,930,1452,10
4829117125,4829117120,-5,1630,3863,10
4830115322,4830115321,-1,912,2599,10
4832540775,4832540774,-1,1931,2152,10
4832961154,4832961154,0,1082,1732,10
4835025918,4835025915,-3,1536,1941,10
4837327907,4837327902,-5,1236,3032,10
4837709433,4837709414,-19,1565,1994,10
4838522195,4838522212,17,308,825,10
4838588959,4838588958,-1,1263,1752,10
4845450833,4845450830,-3,1125,1485,10
4849779671,4849779671,0,1170,1517,10
4852919000,4852919000,0,1173,2246,10
4854740216,4854740215,-1,1184,1396,10
4856727734,4856727733,-1,993,1944,10
4862676995,4862676994,-1,1466,1859,10
4863213738,4863213737,-1,1443,2568,10
4864036259,4864036260,1,1517,2314,10
4865592333,4865592329,-4,1144,2922,10
4866814468,4866814469,1,1130,1367,10
4867330885,4867330886,1,1068,1890,10
4868361006,4868361003,-3,1105,1903,10
4871126200,4871126201,1,6075,9114,10
4873136061,4873136064,3,2195,1215,10
4882991474,4882991473,-1,1169,2455,10
4890168251,4890168245,-6,22049,10773,10
4890347739,4890347737,-2,1260,2132,10
4892426794,4892426792,-2,1046,1991,10
4892696817,4892696812,-5,1365,1771,10
4894520307,4894520307,0,696,1588,10
4895235142,4895235141,-1,1355,2018,10
4895315729,4895315732,3,1348,1541,10
4896628003,4896628001,-2,1032,1740,10
4898067403,4898067403,0,1527,2065,10
4899595189,4899595187,-2,1192,2476,10
4900451495,4900451495,0,1528,1406,10
4901935634,4901935633,-1,832,1737,10
4908943429,4908943426,-3,1327,1717,10
4910961998,4910961998,0,1358,1585,10
4911145924,4911145923,-1,752,1265,10
4912710175,4912710175,0,1095,1758,10
4913200507,4913200506,-1,797,1669,10
4915103463,4915103462,-1,1213,2159,10
4916632431,4916632430,-1,1271,2339,10
4920734178,4920734174,-4,2226,10178,10
4921130290,4921130289,-1,1048,1665,10
4923996594,4923996600,6,2202,1277,10
4930963229,4930963228,-1,1427,2086,10
4931360320,4931360317,-3,1198,1692,10
4933598331,4933598332,1,1929,2981,10
4933639962,4933639959,-3,1437,1942,10
4941490834,4941490833,-1,1322,1371,10
4946102657,4946102657,0,1583,2220,10
4946190032,4946190025,-7,946,13135,10
4947143734,4947143734,0,1218,1705,10
4947883909,4947883909,0,1357,1495,10
4947995218,4947995217,-1,980,2346,10
4948458180,4948458177,-3,924,1641,10
4952449519,4952449518,-1,1428,2123,10
4955787521,4955787519,-2,846,1493,10
4957198689,4957198689,0,1270,2035,10
4958503267,4958503272,5,2492,2041,10
4959570242,4959570242,0,872,1857,10
4960477694,4960477693,-1,1332,1960,10
4973172381,4973172381,0,971,1117,10
4975103266,4975103265,-1,1025,1933,10
4975638523,4975638522,-1,1180,1852,10
4976027214,4976027211,-3,1634,2941,10
4977703262,4977703261,-1,1074,1718,10
4983118659,4983118661,2,1367,1406,10
4983207390,4983207389,-1,1256,1769,10
4983708674,4983708672,-2,871,1680,10
4986561451,4986561450,-1,978,1704,10
4988533065,4988533064,-1,1086,1823,10
4988662115,4988662133,18,1018,1821,10
4989983558,4989983558,0,1081,1671,10
4990150811,4990150810,-1,907,2469,10
4992018164,4992018162,-2,953,1458,10
4993490509,4993490506,-3,844,2002,10
4996765327,4996765325,-2,872,2446,10
4997172505,4997172505,0,1276,2235,10
4997515791,4997515790,-1,973,886,10
4997963390,4997963390,0,1202,1878,10
5002906527,5002906526,-1,1280,2260,10
5003732385,5003732383,-2,1488,2197,10
5005105844,5005105841,-3,1190,1586,10
5013350895,5013350890,-5,780,1829,10
5013992155,5013992152,-3,1039,1455,10
5016720347,5016720345,-2,706,1351,10
5018539124,5018539125,1,1117,1796,10
5018817401,5018817402,1,1543,1414,10
5019175630,5019175630,0,1298,1840,10
5020432072,5020432071,-1,1003,2046,10
5024677524,5024677522,-2,1352,1623,10
5025314218,5025314219,1,1609,1755,10
5027275362,5027275361,-1,1272,1808,10
5027954874,5027954874,0,1135,2332,10
5032413274,5032413270,-4,1275,2764,10
5042109822,5042109822,0,1241,1465,10
5043799154,5043799153,-1,1328,2046,10
5047147050,5047147050,0,819,2209,10
5047327186,5047327185,-1,833,1464,10
5049032253,5049032251,-2,1096,1643,10
5055348242,5055348241,-1,1130,2165,10
5055879770,5055879771,1,322,2134,10
5056793500,5056793499,-1,1020,1643,10
5059141881,5059141879,-2,1030,2706,10
5061021780,5061021797,17,903,2822,10
5061509638,5061509637,-1,1478,1650,10
5063916634,5063916620,-14,1490,2349,10
5065465962,5065465959,-3,968,1585,10
5066661692,5066661690,-2,1201,2442,10
5067935206,5067935209,3,1777,1711,10
5071991929,5071991926,-3,1259,1690,10
5072097419,5072097417,-2,756,1131,10
5073674410,5073674414,4,881,1110,10
5079057610,5079057609,-1,1470,1949,10
5080165724,5080165722,-2,1064,2332,10
5080353665,5080353664,-1,1992,2513,10
5082746274,5082746273,-1,1097,2423,10
5085459383,5085459383,0,798,1310,10
5086310694,5086310693,-1,1147,1678,10
5087664539,5087664538,-1,1110,2047,10
5089731831,5089731827,-4,1005,1210,10
5094408670,5094408667,-3,1052,1945,10
5094873960,5094873957,-3,1789,2260,10
5095102238,5095102237,-1,1139,2230,10
5096863819,5096863819,0,1063,1901,10
5104731044,5104731042,-2,1692,2495,10
5104922298,5104922318,20,18,2837,10
5112787890,5112787895,5,2214,1670,10
5115343870,5115343875,5,4709,2685,10
5126306228,5126306228,0,1260,2078,10
5131122767,5131122766,-1,1636,2338,10
5138046786,5138046784,-2,1233,3413,10
5139548658,5139548655,-3,766,1422,10
5139849322,5139849322,0,744,1314,10
5143039506,5143039501,-5,1191,2107,10
5147401122,5147401119,-3,1020,1730,10
5147841806,5147841806,0,1395,2179,10
5148288239,5148288239,0,1028,1678,10
5150109499,5150109497,-2,836,1801,10
5151801264,5151801270,6,3858,1156,10
5152143511,5152143513,2,1286,1301,10
5153304487,5153304466,-21,1177,1960,10
5153377676,5153377673,-3,1612,2402,10
5159169364,5159169367,3,1811,2157,10
5159401055,5159401050,-5,1321,3221,10
5161361073,5161361070,-3,933,2225,10
5164307262,5164307262,0,1036,1925,10
5168875694,5168875695,1,1146,1495,10
5169776340,5169776338,-2,1057,1864,10
5173484486,5173484483,-3,1477,2153,10
5174005062,5174005063,1,1243,1151,10
5176826622,5176826621,-1,1477,1875,10
5177583995,5177583994,-1,1139,1551,10
5188064591,5188064590,-1,1537,2468,10
5188187650,5188187650,0,876,2342,10
5189399567,5189399565,-2,942,1367,10
5191299257,5191299258,1,22780,38030,10
5193578187,5193578189,2,1215,900,10
5195232543,5195232541,-2,873,2292,10
5199113016,5199113011,-5,1204,1969,10
5201206678,5201206677,-1,1156,1408,10
5203016743,5203016743,0,1151,2373,10
5204630290,5204630291,1,1028,2030,10
5207667235,5207667233,-2,1188,1738,10
5213430351,5213430352,1,993,2394,10
5214643662,5214643662,0,873,1794,10
5218656175,5218656173,-2,1501,1860,10
5218853379,5218853381,2,983,1886,10
5219554056,5219554054,-2,1126,1768,10
5220349246,5220349244,-2,916,1552,10
5220433134,5220433133,-1,1223,1997,10
5224903673,5224903670,-3,1374,1577,10
5226672119,5226672118,-1,1044,1891,10
5227848806,5227848805,-1,1341,1811,10
5236106382,5236106379,-3,1496,2041,10
5238800501,5238800499,-2,1127,1414,10
5239235376,5239235396,20,1437,2350,10
5240189398,5240189398,0,1254,2191,10
5241744950,5241744949,-1,1587,1392,10
5242269561,5242269562,1,1805,1523,10
5244396534,5244396533,-1,1264,2101,10
5246033959,5246033962,3,1431,1197,10
5247161638,5247161636,-2,1240,1939,10
5253839315,5253839313,-2,1026,2002,10
5255200472,5255200470,-2,1250,1884,10
5255703729,5255703723,-6,160,698,10
5262337814,5262337811,-3,1686,3966,10
5264345913,5264345920,7,2736,1507,10
5266329266,5266329271,5,3302,2500,10
5266524391,5266524391,0,1302,1803,10
5269838883,5269838881,-2,1132,1346,10
5269992027,5269992024,-3,1232,1710,10
5271648078,5271648078,0,1144,1895,10
5273473262,5273473261,-1,1653,2864,10
5275507565,5275507565,0,1238,1827,10
5281565485,5281565483,-2,1995,3375,10
5284292907,5284292906,-1,1483,1684,10
5287121702,5287121702,0,1511,1978,10
5299673640,5299673639,-1,1112,1945,10
5308865737,5308865734,-3,1331,1807,10
5308955297,5308955299,2,1301,1062,10
5312358774,5312358774,0,1110,2392,10
5314332879,5314332879,0,1336,1793,10
5315021363,5315021362,-1,451,775,10
5318547902,5318547902,0,1287,1942,10
5320910801,5320910801,0,1062,1266,10
5321560176,5321560174,-2,1633,2204,10
5321666643,5321666641,-2,1143,2486,10
5326374770,5326374769,-1,1288,1440,10
5330689801,5330689801,0,1403,2076,10
5332819052,5332819051,-1,1453,1781,10
5342923791,5342923789,-2,852,1432,10
5353440482,5353440482,0,1139,2070,10
5353765638,5353765637,-1,1247,1657,10
5356084599,5356084602,3,1385,1796,10
5356557862,5356557858,-4,900,3095,10
5357445949,5357445948,-1,911,1667,10
5358394427,5358394426,-1,1060,1856,10
5363736461,5363736460,-1,1516,2029,10
5366239543,5366239542,-1,1075,1392,10
5366820735,5366820734,-1,622,836,10
5370035891,5370035884,-7,815,4284,10
5371836865,5371836863,-2,1636,2449,10
5372954050,5372954047,-3,1904,3926,10
5373869640,5373869638,-2,1214,1520,10
5373916791,5373916790,-1,1102,1362,10
5374221178,5374221195,17,1531,4747,10
5375736862,5375736865,3,2001,1106,10
5376002118,5376002114,-4,912,2091,10
5376725305,5376725302,-3,943,3463,10
5378004127,5378004126,-1,1635,2641,10
5378651610,5378651610,0,1048,1961,10
5379135437,5379135432,-5,1034,3437,10
5381646934,5381646932,-2,1428,1753,10
5384310377,5384310374,-3,978,2133,10
5384630130,5384630128,-2,1562,1359,10
5385185531,5385185530,-1,1275,2397,10
5385619447,5385619447,0,1448,1043,10
5388442048,5388442046,-2,1813,1669,10
5391341543,5391341542,-1,1650,1968,10
5392581375,5392581373,-2,1096,1901,10
5393443757,5393443762,5,1954,869,10
5396208771,5396208771,0,1120,1993,10
5397292214,5397292214,0,1604,2004,10
5398372102,5398372102,0,1222,2167,10
5400230055,5400230054,-1,1037,1370,10
5400882047,5400882046,-1,1167,1837,10
5401754999,5401754997,-2,1238,2338,10
5404024238,5404024239,1,1345,1518,10
5405852923,5405852927,4,391,980,10
5407007536,5407007535,-1,1016,1699,10
5410712185,5410712182,-3,1289,2226,10
5411783279,5411783279,0,1274,1740,10
5411867651,5411867648,-3,684,1751,10
5413824355,5413824353,-2,1251,2196,10
5414809555,5414809552,-3,1527,2472,10
5419376854,5419376854,0,863,1232,10
5421214600,5421214604,4,17068,10265,10
5421311750,5421311749,-1,1565,2192,10
5421508142,5421508142,0,953,1080,10
5423185845,5423185843,-2,919,2099,10
5426685804,5426685802,-2,1249,2206,10
5427509715,5427509715,0,1234,1910,10
5434419185,5434419185,0,6133,11598,10
5439116447,5439116447,0,1073,1241,10
5439882309,5439882310,1,1191,1821,10
5446055588,5446055585,-3,1087,2004,10
5446621987,5446621985,-2,1200,1904,10
5447989985,5447989986,1,3796,3440,10
5449373710,5449373706,-4,780,2351,10
5452051551,5452051550,-1,1137,1852,10
5452936755,5452936751,-4,1078,1952,10
5452969424,5452969422,-2,1820,1546,10
5453997194,5453997192,-2,769,1581,10
5455724319,5455724318,-1,1440,2353,10
5456518897,5456518898,1,1486,1646,10
5459499946,5459499945,-1,943,2209,10
5460414885,5460414887,2,1584,1687,10
5464265363,5464265361,-2,969,1636,10
5464462886,5464462884,-2,882,1340,10
5466067905,5466067918,13,1054,1656,10
5472591522,5472591518,-4,998,1991,10
5473475191,5473475188,-3,1011,1684,10
5474232026,5474232025,-1,701,1332,10
5474868625,5474868645,20,850,2072,10
5475095156,5475095157,1,27150,22875,10
5475727949,5475727948,-1,1258,2200,10
5478481423,5478481421,-2,1093,1863,10
5481721694,5481721693,-1,1455,2110,10
5482035605,5482035605,0,1188,2258,10
5484680857,5484680855,-2,1357,1792,10
5485431604,5485431604,0,1415,1284,10
5486099222,5486099222,0,875,1523,10
5486965269,5486965266,-3,1251,2139,10
5493162790,5493162789,-1,866,2050,10
5496652145,5496652146,1,984,2054,10
5500169476,5500169474,-2,1789,2831,10
5502483161,5502483159,-2,1118,1795,10
5505697433,5505697429,-4,1230,2599,10
5506272425,5506272422,-3,1121,2488,10
5511053740,5511053738,-2,985,1687,10
5511198482,5511198478,-4,1149,2220,10
5514861638,5514861637,-1,1077,1675,10
5518313113,5518313113,0,1182,1853,10
5520105338,5520105335,-3,1026,2098,10
5521533297,5521533294,-3,1147,1643,10
5522354550,5522354549,-1,1185,1748,10
5532383210,5532383209,-1,1281,1918,10
5536773935,5536773935,0,930,1432,10
5541028252,5541028251,-1,1858,2194,10
5541383187,5541383184,-3,1686,2173,10
5546950817,5546950817,0,1639,2744,10
5555007635,5555007636,1,1164,2405,10
5559218300,5559218299,-1,1367,1389,10
5565510934,5565510934,0,1359,1309,10
5567149115,5567149115,0,897,1559,10
5569614887,5569614885,-2,1110,1370,10
5572487245,5572487243,-2,1095,2175,10
5572669345,5572669343,-2,1667,2870,10
5573549061,5573549058,-3,1104,1827,10
5573603736,5573603736,0,1335,1500,10
5576988106,5576988105,-1,1880,2382,10
5579728306,5579728298,-8,760,2142,10
5579825312,5579825309,-3,1370,1739,10
5581427705,5581427704,-1,936,1344,10
5584639024,5584639029,5,373,2218,10
5587434724,5587434723,-1,931,1986,10
5590759687,5590759685,-2,1526,2989,10
5590971510,5590971509,-1,1198,2248,10
5591042619,5591042610,-9,763,2189,10
5593410483,5593410482,-1,943,1603,10
5594273885,5594273886,1,1450,1516,10
5597502397,5597502394,-3,1404,2511,10
5601832430,5601832411,-19,1074,1337,10
5607657924,5607657922,-2,905,1217,10
5610117423,5610117425,2,1462,1460,10
5612285106,5612285107,1,1147,1908,10
5612789518,5612789514,-4,1428,2746,10
5613126882,5613126903,21,892,1896,10
5613792006,5613792003,-3,1118,2384,10
5613971603,5613971600,-3,796,1388,10
5617832283,5617832281,-2,635,1065,10
5619114362,5619114361,-1,1424,2072,10
5620410439,5620410436,-3,1629,2839,10
5622833983,5622833983,0,948,1842,10
5624524832,5624524834,2,1603,1659,10
5633416831,5633416822,-9,28559,13424,10
5637667595,5637667598,3,1575,1431,10
5638853749,5638853747,-2,1414,1794,10
5652891964,5652891980,16,632,1952,10
5653692017,5653692039,22,960,2263,10
5656204547,5656204546,-1,1159,1394,10
5658242083,5658242082,-1,1215,1499,10
5660228598,5660228596,-2,1385,2625,10
5666233417,5666233428,11,16667,37513,10
5671530823,5671530822,-1,924,1426,10
5672926659,5672926666,7,2742,1625,10
5674987090,5674987094,4,1698,1603,10
5675723938,5675723938,0,986,1887,10
5679211064,5679211063,-1,1024,1489,10
5679530480,5679530478,-2,1419,2126,10
5680497866,5680497867,1,610,1398,10
5683773870,5683773870,0,1196,2094,10
5684659617,5684659614,-3,1319,1934,10
5685235218,5685235218,0,1260,1849,10
5686301227,5686301227,0,1563,2241,10
5686521752,5686521750,-2,1120,2220,10
5687137054,5687137053,-1,1271,2033,10
5687973630,5687973630,0,1432,2193,10
5689890134,5689890132,-2,1146,2142,10
5690365229,5690365229,0,1324,2255,10
5690613210,5690613205,-5,1197,4874,10
5692959758,5692959758,0,1790,2699,10
5696580076,5696580076,0,1515,2219,10
5697052663,5697052661,-2,1364,1882,10
5701094994,5701094995,1,1279,1376,10
5702672070,5702672069,-1,1127,2634,10
5702928266,5702928282,16,1210,2233,10
5703882242,5703882243,1,1025,1262,10
5706417242,5706417239,-3,1093,1855,10
5709771787,5709771785,-2,1104,2584,10
5715893707,5715893705,-2,1591,3083,10
5719548181,5719548180,-1,968,1550,10
5723244069,5723244065,-4,1118,2116,10
5725075135,5725075133,-2,824,1682,10
5725727755,5725727755,0,1179,1256,10
5726961650,5726961652,2,1274,1741,10
5728559969,5728559968,-1,1532,2176,10
5729218403,5729218408,5,1006,1712,10
5732831035,5732831036,1,1260,1177,10
5734565141,5734565141,0,1122,1454,10
5740324562,5740324561,-1,1157,3006,10
5741984464,5741984462,-2,1345,2216,10
5744465206,5744465196,-10,911,1725,10
5744571071,5744571071,0,1053,1738,10
5745447756,5745447755,-1,1582,1999,10
5746203894,5746203893,-1,1004,1351,10
5747997394,5747997390,-4,1013,1867,10
5752148314,5752148313,-1,1426,1701,10
5759063867,5759063864,-3,946,1650,10
5764094302,5764094298,-4,967,1893,10
5767025171,5767025168,-3,1146,1723,10
5769604897,5769604897,0,1738,2874,10
5769822391,5769822390,-1,1007,1636,10
5773185254,5773185254,0,1243,2549,10
5776021491,5776021489,-2,1251,1755,10
5781166954,5781166950,-4,802,1315,10
5781501838,5781501838,0,925,856,10
5787614911,5787614910,-1,1421,2390,10
5789331635,5789331634,-1,930,1483,10
5793360233,5793360231,-2,851,1654,10
5794121637,5794121639,2,5954,18486,10
5794880139,5794880137,-2,1465,1803,10
5795753641,5795753641,0,1291,2314,10
5796796937,5796796935,-2,1392,2293,10
5808881484,5808881484,0,1219,1668,10
5813041727,5813041724,-3,828,2189,10
5813532921,5813532921,0,882,1394,10
5818762107,5818762104,-3,903,2226,10
5826939678,5826939677,-1,1237,1797,10
5829569589,5829569588,-1,1525,2732,10
5829998906,5829998905,-1,1292,1737,10
5831362207,5831362206,-1,982,1949,10
5832498128,5832498126,-2,1285,1211,10
5835053413,5835053411,-2,1010,2693,10
5839622429,5839622428,-1,1085,1979,10
5842510057,5842510054,-3,1668,2571,10
5843202253,5843202251,-2,1672,2186,10
5844795183,5844795182,-1,1059,1373,10
5848188103,5848188102,-1,875,2592,10
5848455683,5848455683,0,1024,1525,10
5849138131,5849138129,-2,1759,2810,10
5852947414,5852947410,-4,1310,1882,10
5853313966,5853313965,-1,965,1359,10
5856961063,5856961062,-1,1660,2851,10
5864367473,5864367471,-2,919,1381,10
5866551585,5866551585,0,764,884,10
5867642721,5867642718,-3,1227,2272,10
5868019117,5868019115,-2,1409,1874,10
5868753434,5868753434,0,1114,1577,10
5868887677,5868887678,1,1086,2070,10
5870444971,5870444970,-1,1409,2164,10
5873008522,5873008519,-3,995,1668,10
5873679609,5873679613,4,1196,1072,10
5877184548,5877184554,6,9416,19242,10
5877987018,5877987017,-1,1248,2599,10
5878810751,5878810749,-2,1250,2194,10
5883340043,5883340042,-1,1192,1674,10
5884293162,5884293161,-1,1167,1603,10
5884369798,5884369798,0,1015,1454,10
5884971515,5884971530,15,564,1275,10
5885909042,5885909037,-5,1284,3584,10
5886170233,5886170230,-3,1179,2836,10
5892097476,5892097474,-2,1206,1600,10
5893110735,5893110734,-1,1260,2314,10
5894436488,5894436482,-6,2124,7943,10
5895457360,5895457358,-2,1252,2901,10
5898377279,5898377287,8,1681,1046,10
5898840847,5898840846,-1,1270,1717,10
5900356167,5900356166,-1,1060,1910,10
5900520022,5900520021,-1,1413,1913,10
5902516023,5902516020,-3,1567,2762,10
5904953243,5904953243,0,1387,2176,10
5905932462,5905932460,-2,1283,2140,10
5906216776,5906216783,7,2256,1517,10
5909407691,5909407692,1,40033,49589,10
5910152871,5910152871,0,1167,1575,10
5910601212,5910601208,-4,1409,1754,10
5913329627,5913329623,-4,1161,1979,10
5915009387,5915009385,-2,747,1364,10
5917443493,5917443493,0,23145,23398,10
5918635446,5918635445,-1,992,2738,10
5918707274,5918707258,-16,220,1859,10
5922727044,5922727042,-2,1188,1613,10
5922876266,5922876268,2,1418,1678,10
5923940276,5923940275,-1,1169,2220,10
5926528439,5926528437,-2,775,2452,10
5933148780,5933148778,-2,1040,2452,10
5934726786,5934726784,-2,1143,1556,10
5941944195,5941944195,0,1021,1394,10
5945825302,5945825301,-1,1286,1994,10
5954395511,5954395511,0,1136,1956,10
5958055650,5958055650,0,620,1857,10
5959309244,5959309262,18,227,1018,10
5961827173,5961827172,-1,1158,1910,10
5963146992,5963146990,-2,2098,2347,10
5964269190,5964269190,0,1044,2324,10
5964539770,5964539768,-2,1199,1959,10
5965864582,5965864579,-3,1330,2502,10
5967692939,5967692937,-2,750,1361,10
5971114498,5971114497,-1,553,1174,10
5973110690,5973110689,-1,1445,2933,10
5973161750,5973161750,0,1583,2075,10
5973407251,5973407250,-1,1662,2404,10
5975710039,5975710037,-2,1370,2208,10
5976731218,5976731218,0,1406,2593,10
5977328237,5977328238,1,1861,2174,10
5979907144,5979907141,-3,1348,2718,10
5983751353,5983751353,0,1551,2251,10
5984471697,5984471692,-5,1857,12783,10
5986383158,5986383157,-1,1241,2291,10
5987849027,5987849027,0,937,1367,10
5989154726,5989154725,-1,1449,2047,10
5990129665,5990129663,-2,1292,1850,10
5992065854,5992065855,1,1488,2145,10
5992765093,5992765099,6,2027,773,10
5995325767,5995325765,-2,1631,1700,10
5996390707,5996390706,-1,1322,1517,10
5997814090,5997814086,-4,1746,2514,10
5998111891,5998111884,-7,1251,2954,10
5998689807,5998689805,-2,1680,2536,10
6000623317,6000623317,0,767,1858,10
6001035897,6001035876,-21,1682,2251,10
6001917207,6001917207,0,1167,1378,10
6005593629,6005593628,-1,1323,1844,10
6008186117,6008186117,0,1234,1853,10
6010453673,6010453673,0,1163,1803,10
6015557969,6015557969,0,1858,2478,10
6025664591,6025664589,-2,1115,1754,10
6028215827,6028215827,0,639,1628,10
6029500444,6029500443,-1,1195,1871,10
6030031797,6030031793,-4,1236,2003,10
6033116250,6033116249,-1,1546,2293,10
6034069470,6034069466,-4,1292,1776,10
6034610306,6034610308,2,372,490,10
6035583629,6035583627,-2,972,1240,10
6036145876,6036145894,18,965,2090,10
6036647654,6036647654,0,1662,2803,10
6041899075,6041899074,-1,1579,2435,10
6042465733,6042465730,-3,1815,2288,10
6056990585,6056990582,-3,1529,2419,10
6057600986,6057600988,2,2732,1815,10
6058766389,6058766391,2,842,1073,10
6063904127,6063904126,-1,1045,2712,10
6064683638,6064683636,-2,1488,2282,10
6066599549,6066599546,-3,917,1803,10
6067040065,6067040045,-20,1146,1664,10
6068783409,6068783409,0,1957,2363,10
6069090022,6069090020,-2,850,1465,10
6072036321,6072036327,6,1879,1566,10
6074303798,6074303796,-2,1678,2760,10
6076426431,6076426430,-1,1284,1601,10
6077148439,6077148441,2,1185,1971,10
6079731933,6079731930,-3,1483,1998,10
6080861538,6080861520,-18,1250,2688,10
6082243995,6082243993,-2,1200,2232,10
6082425907,6082425907,0,1331,1892,10
6086940027,6086940027,0,1187,2154,10
6091729006,6091729003,-3,1066,1891,10
6095518262,6095518262,0,1666,1823,10
6099625939,6099625935,-4,896,2770,10
6100204699,6100204700,1,1445,1256,10
6102286950,6102286948,-2,862,2136,10
6102391914,6102391913,-1,1496,2800,10
6104251451,6104251451,0,1424,2606,10
6105353871,6105353869,-2,969,1611,10
6107994805,6107994803,-2,924,2052,10
6108389455,6108389453,-2,922,1734,10
6109764391,6109764389,-2,972,2500,10
6109896524,6109896522,-2,1584,2276,10
6111292902,6111292903,1,1358,2332,10
6112875010,6112875006,-4,1221,1928,10
6115613917,6115613914,-3,1054,1762,10
6116717734,6116717735,1,1771,1961,10
6116934220,6116934217,-3,1094,2072,10
6120902621,6120902618,-3,1589,2618,10
6122820782,6122820782,0,1229,1860,10
6124115078,6124115077,-1,1456,2128,10
6125124615,6125124618,3,1693,2102,10
6125744535,6125744534,-1,1174,2336,10
6128814958,6128814958,0,802,920,10
6130572305,6130572310,5,1528,1437,10
6131752794,6131752793,-1,1054,1770,10
6132609471,6132609468,-3,1661,2723,10
6136201277,6136201274,-3,1162,2079,10
6138272923,6138272923,0,1193,1902,10
6138439947,6138439944,-3,946,2025,10
6146200666,6146200662,-4,1121,1947,10
6146742718,6146742718,0,1445,2617,10
6147639289,6147639290,1,1150,1466,10
6148204102,6148204101,-1,1119,1975,10
6149595066,6149595066,0,1371,1126,10
6150264858,6150264859,1,1786,1093,10
6152412514,6152412511,-3,1659,1779,10
6153363795,6153363797,2,1470,1363,10
6155115201,6155115202,1,1012,1205,10
6156168751,6156168747,-4,608,1620,10
6156761472,6156761459,-13,1192,1766,10
6157778029,6157778035,6,2305,950,10
6158707721,6158707718,-3,844,1873,10
6160590509,6160590502,-7,20798,16527,10
6163630982,6163630981,-1,953,1711,10
6163849767,6163849764,-3,1450,1930,10
6165413290,6165413288,-2,1041,2514,10
6168563433,6168563432,-1,873,1443,10
6169154543,6169154543,0,1522,2353,10
6169313601,6169313601,0,1069,1487,10
6171114636,6171114634,-2,1835,1956,10
6172523153,6172523156,3,2319,1721,10
6176681333,6176681334,1,1507,1290,10
6177098401,6177098405,4,2217,1819,10
6178487202,6178487202,0,1283,1576,10
6180123279,6180123278,-1,1749,1637,10
6180519659,6180519658,-1,1379,1152,10
6181306811,6181306812,1,1323,1209,10
6181592425,6181592433,8,1092,1898,10
6182586778,6182586779,1,238,672,10
6188967155,6188967150,-5,797,2026,10
6189586802,6189586801,-1,1412,1885,10
6190858551,6190858549,-2,1133,2136,10
6192178995,6192178992,-3,1227,1670,10
6194213007,6194213005,-2,1160,2162,10
6201161037,6201161036,-1,1497,2341,10
6203073361,6203073361,0,1503,2539,10
6204596005,6204596001,-4,1005,2692,10
6205462285,6205462281,-4,1644,2917,10
6211205174,6211205173,-1,1091,2707,10
6212402487,6212402486,-1,932,1465,10
6213344815,6213344815,0,771,1034,10
6214860014,6214860014,0,1438,1340,10
6218411913,6218411910,-3,1253,1518,10
6219998576,6219998574,-2,955,1481,10
6221528254,6221528250,-4,1241,1576,10
6227690594,6227690594,0,1312,1526,10
6230509456,6230509456,0,1278,2193,10
6231173593,6231173593,0,1145,1933,10
6232569339,6232569338,-1,879,1959,10
6234291462,6234291466,4,2707,1111,10
6235747681,6235747678,-3,1122,1437,10
6243523410,6243523409,-1,814,1590,10
6244582609,6244582609,0,948,1563,10
6246110573,6246110571,-2,781,910,10
6246437476,6246437493,17,1132,2558,10
6247491140,6247491138,-2,1196,1983,10
6247784870,6247784870,0,1004,2422,10
6251123151,6251123150,-1,1178,1367,10
6251886566,6251886565,-1,923,1771,10
6255716027,6255716026,-1,1673,2498,10
6256310505,6256310503,-2,1328,1256,10
6256471990,6256471985,-5,1370,2035,10
6257028951,6257028953,2,1672,1800,10
6257803139,6257803137,-2,837,1184,10
6266041158,6266041157,-1,1139,1935,10
6266153403,6266153394,-9,969,2003,10
6266751553,6266751542,-11,1093,1574,10
6275148319,6275148335,16,631,1458,10
6277551254,6277551253,-1,1592,2145,10
6277858305,6277858303,-2,1378,2753,10
6279406906,6279406902,-4,1037,1930,10
6280663511,6280663509,-2,1137,2000,10
6286556651,6286556650,-1,1753,2865,10
6287697130,6287697130,0,1720,2354,10
6288734286,6288734283,-3,1095,1894,10
6290613311,6290613310,-1,2362,3780,10
6291304414,6291304415,1,1378,1212,10
6292401877,6292401875,-2,1504,3202,10
6295118419,6295118418,-1,1845,2878,10
6297496880,6297496877,-3,1384,2184,10
6298146763,6298146763,0,580,1006,10
6299206030,6299206028,-2,912,1528,10
6305307853,6305307851,-2,1394,2575,10
6308482010,6308482009,-1,928,2259,10
6312426490,6312426488,-2,970,2187,10
6312634689,6312634687,-2,1078,2109,10
6321328133,6321328130,-3,989,1824,10
6323033894,6323033894,0,1207,2199,10
6323443708,6323443708,0,972,1695,10
6324134858,6324134854,-4,863,2007,10
6329078207,6329078206,-1,1044,2186,10
6330260381,6330260379,-2,714,761,10
6331208754,6331208752,-2,954,2342,10
6334698007,6334698006,-1,1336,1445,10
6334871326,6334871324,-2,1393,2082,10
6339125404,6339125405,1,1033,1520,10
6339684409,6339684410,1,1479,2597,10
6339933751,6339933749,-2,5620,11728,10
6342442334,6342442315,-19,33738,29228,10
6343787687,6343787685,-2,1075,1982,10
6354411422,6354411418,-4,1840,5755,10
6355952090,6355952090,0,1341,1912,10
6360382610,6360382609,-1,1378,1825,10
6362410115,6362410115,0,978,1740,10
6363287724,6363287722,-2,1576,2014,10
6363410210,6363410209,-1,1113,1946,10
6363993451,6363993451,0,1552,2452,10
6365366686,6365366685,-1,1758,2607,10
6373627655,6373627653,-2,1069,2078,10
6374761147,6374761147,0,1283,1333,10
6378703001,6378703000,-1,1483,2413,10
6379351225,6379351223,-2,1022,2081,10
6380337054,6380337054,0,1140,2158,10
6386650234,6386650244,10,499,707,10
6387827488,6387827486,-2,1013,1812,10
6389059762,6389059762,0,1440,2892,10
6391565929,6391565927,-2,1444,1939,10
6393600838,6393600837,-1,1320,1758,10
6393697285,6393697282,-3,1359,1734,10
6394147840,6394147842,2,967,1775,10
6396595831,6396595830,-1,1103,1857,10
6403136712,6403136709,-3,1619,3247,10
6403385811,6403385810,-1,1596,1848,10
6404503577,6404503577,0,1130,1678,10
6406089525,6406089523,-2,1262,1931,10
6407095777,6407095778,1,1789,1342,10
6408784554,6408784552,-2,1175,1751,10
6409735055,6409735054,-1,1021,2613,10
6411177825,6411177832,7,3447,1364,10
6411610450,6411610451,1,1060,2076,10
6411669467,6411669482,15,390,867,10
6412154404,6412154404,0,994,1985,10
6413003654,6413003653,-1,768,1583,10
6423757226,6423757226,0,1072,1319,10
6424076514,6424076521,7,2086,1225,10
6426729351,6426729349,-2,816,1712,10
6431025323,6431025322,-1,1145,1651,10
6435736433,6435736432,-1,1152,2719,10
6437128203,6437128200,-3,1237,2235,10
6438374907,6438374907,0,1558,2575,10
6441294434,6441294433,-1,1147,2102,10
6441404441,6441404439,-2,1484,2079,10
6442513080,6442513078,-2,1873,2838,10
6443184545,6443184545,0,1175,1969,10
6447295739,6447295738,-1,1128,1569,10
6450523325,6450523324,-1,1641,1518,10
6451174438,6451174436,-2,504,1558,10
6454867805,6454867806,1,1922,1507,10
6458398402,6458398400,-2,1390,2109,10
6459466246,6459466247,1,905,1274,10
6464446750,6464446750,0,1553,2001,10
6466268862,6466268868,6,14825,6047,10
6471438046,6471438048,2,2031,1755,10
6471946846,6471946846,0,831,1638,10
6475115697,6475115698,1,1165,2186,10
6475380105,6475380104,-1,1167,2001,10
6481129599,6481129598,-1,1025,2134,10
6484587081,6484587079,-2,1161,1582,10
6486199434,6486199438,4,1939,1776,10
6490665974,6490665974,0,1116,2501,10
6491692342,6491692340,-2,1052,2085,10
6494064739,6494064734,-5,1241,2694,10
6499377651,6499377651,0,1500,2499,10
6499855356,6499855355,-1,1102,2635,10
6501079381,6501079381,0,1506,2133,10
6502082405,6502082417,12,13949,48423,10
6505775855,6505775856,1,1206,1956,10
6507501007,6507501006,-1,1248,1907,10
6511367235,6511367250,15,745,9220,10
6516049850,6516049853,3,1620,1317,10
6517539368,6517539366,-2,1142,1681,10
6517651760,6517651742,-18,1575,2227,10
6519225552,6519225552,0,1110,1733,10
6519876378,6519876378,0,913,1626,10
6521570471,6521570470,-1,1389,1869,10
6523945879,6523945878,-1,1751,1957,10
6527330497,6527330494,-3,1283,2169,10
6531374756,6531374755,-1,887,1518,10
6535662852,6535662850,-2,1129,1853,10
6539106210,6539106213,3,2144,1165,10
6541762102,6541762102,0,895,1225,10
6546589943,6546589942,-1,736,1974,10
6547139223,6547139222,-1,1103,1446,10
6548503591,6548503588,-3,1126,1773,10
6549810882,6549810882,0,978,1404,10
6552594201,6552594200,-1,1412,1769,10
6553232759,6553232759,0,782,1169,10
6557658031,6557658029,-2,1271,1131,10
6563436366,6563436364,-2,847,2561,10
6565248966,6565248964,-2,2345,4738,10
6571440955,6571440959,4,1551,1219,10
6572926871,6572926870,-1,1733,2423,10
6575701797,6575701797,0,1138,2355,10
6577779718,6577779718,0,1299,1742,10
6578669674,6578669673,-1,1064,1100,10
6579189089,6579189106,17,1276,1869,10
6579679322,6579679322,0,1053,1571,10
6583654049,6583654048,-1,1668,2476,10
6585773789,6585773787,-2,1217,2027,10
6589556294,6589556290,-4,1085,2049,10
6593493191,6593493190,-1,1175,2001,10
6595064970,6595064970,0,906,1744,10
6603670542,6603670541,-1,1621,1914,10
6605452490,6605452489,-1,1505,1952,10
6607380821,6607380818,-3,918,2049,10
6610416467,6610416465,-2,976,1481,10
6612393247,6612393243,-4,825,1245,10
6613272050,6613272044,-6,1011,2136,10
6617616666,6617616666,0,946,2087,10
6618354575,6618354577,2,1122,1866,10
6618521976,6618521967,-9,1147,1724,10
6625662561,6625662561,0,1012,1101,10
6638793321,6638793321,0,1504,2019,10
6643904999,6643905002,3,1801,2196,10
6645420661,6645420659,-2,1218,1913,10
6645530508,6645530525,17,1177,1044,10
6647154749,6647154745,-4,1478,2534,10
6649573312,6649573296,-16,1107,2403,10
6650305953,6650305950,-3,1201,2946,10
6651697455,6651697454,-1,1166,1496,10
6651916362,6651916361,-1,1639,2931,10
6652933871,6652933871,0,955,1251,10
6654583524,6654583526,2,1243,1362,10
6654635770,6654635750,-20,1395,2628,10
6656588563,6656588561,-2,929,1291,10
6657619354,6657619351,-3,1534,3478,10
6661137298,6661137293,-5,2003,3834,10
6664367578,6664367577,-1,1443,2689,10
6667934395,6667934392,-3,1640,2196,10
6669568187,6669568188,1,1280,1536,10
6670756027,6670756023,-4,1185,2344,10
6672227458,6672227456,-2,1232,1803,10
6674710466,6674710465,-1,1146,2167,10
6676622627,6676622627,0,800,1153,10
6676899879,6676899880,1,1225,1574,10
6680914422,6680914418,-4,857,1722,10
6681546157,6681546154,-3,1238,1099,10
6685454694,6685454691,-3,1114,1901,10
6686968974,6686968972,-2,1455,1814,10
6692547031,6692547029,-2,1672,2412,10
6698659667,6698659663,-4,1040,1424,10
6700581005,6700581002,-3,677,1971,10
6701116705,6701116725,20,766,2691,10
6710042415,6710042414,-1,1153,1916,10
6711076283,6711076282,-1,1286,1865,10
6711144657,6711144654,-3,1382,2597,10
6713570745,6713570746,1,1873,1539,10
6714527834,6714527830,-4,1339,2285,10
6715305360,6715305357,-3,1282,1796,10
6716102251,6716102252,1,969,1260,10
6717386060,6717386059,-1,1365,2139,10
6717453472,6717453471,-1,1343,2276,10
6719585862,6719585863,1,1622,1923,10
6721438926,6721438926,0,1107,1940,10
6721963194,6721963191,-3,1266,1989,10
6722061774,6722061768,-6,721,4087,10
6723860587,6723860587,0,1533,1657,10
6724976822,6724976821,-1,942,1478,10
6727757348,6727757348,0,1178,1733,10
6730131702,6730131701,-1,1491,1389,10
6731624983,6731624980,-3,1543,1977,10
6732425091,6732425090,-1,1542,3125,10
6733791438,6733791437,-1,1076,2137,10
6738372245,6738372238,-7,1022,10344,10
6744273928,6744273929,1,2848,2298,10
6744326248,6744326247,-1,1523,1520,10
6745195686,6745195690,4,2025,1583,10
6745278143,6745278131,-12,1708,905,10
6746196102,6746196099,-3,1648,1602,10
6748460098,6748460095,-3,1446,2198,10
6749836538,6749836537,-1,1198,1471,10
6751886594,6751886591,-3,1730,3347,10
6752335560,6752335549,-11,558,1502,10
6760745055,6760745054,-1,1219,1578,10
6760834918,6760834918,0,1679,2207,10
6762757225,6762757248,23,1375,1052,10
6764918578,6764918578,0,1194,1773,10
6766537282,6766537281,-1,1350,2287,10
6767341277,6767341275,-2,1440,1748,10
6767702442,6767702439,-3,1652,2411,10
6770812786,6770812783,-3,1170,2069,10
6776235711,6776235710,-1,1737,2482,10
6776313098,6776313098,0,808,1433,10
6778102506,6778102510,4,1910,1650,10
6778658054,6778658053,-1,1582,1652,10
6781239947,6781239947,0,1860,2792,10
6782136690,6782136690,0,1257,775,10
6782791278,6782791275,-3,2234,5389,10
6782921045,6782921043,-2,964,1875,10
6785078364,6785078365,1,1020,1164,10
6789069350,6789069350,0,1510,1986,10
6789137863,6789137862,-1,1337,1925,10
6791173018,6791173018,0,815,1947,10
6791623421,6791623418,-3,1380,2803,10
6799122842,6799122842,0,1208,1675,10
6799606886,6799606882,-4,1287,2319,10
6801497048,6801497047,-1,1045,1480,10
6805101793,6805101791,-2,923,1584,10
6808188038,6808188037,-1,1672,1652,10
6811044926,6811044926,0,1211,1984,10
6817602878,6817602877,-1,1225,1735,10
6820266966,6820266964,-2,1449,2765,10
6824009283,6824009282,-1,775,1399,10
6831221399,6831221399,0,1078,1402,10
6833195574,6833195574,0,1767,2236,10
6835932166,6835932164,-2,1385,2149,10
6836568050,6836568055,5,2329,1132,10
6836862160,6836862160,0,929,1990,10
6838946790,6838946790,0,1704,2789,10
6842087601,6842087611,10,16416,21390,10
6842639682,6842639682,0,927,2238,10
6842751834,6842751833,-1,1341,1596,10
6843142315,6843142316,1,772,1394,10
6844743389,6844743390,1,1539,2163,10
6845122743,6845122742,-1,1577,2528,10
6848612146,6848612145,-1,1354,2229,10
6851932298,6851932306,8,2387,1034,10
6852253826,6852253834,8,1103,1169,10
6853890631,6853890632,1,905,2081,10
6857326063,6857326062,-1,1518,2875,10
6860508481,6860508485,4,3503,1882,10
6861422244,6861422245,1,1279,1314,10
6863207627,6863207626,-1,1320,2072,10
6863516794,6863516790,-4,1044,3348,10
6866489635,6866489635,0,962,1794,10
6872100343,6872100345,2,827,1619,10
6873709499,6873709497,-2,1150,1538,10
6874107203,6874107222,19,849,1353,10
6879537493,6879537493,0,1166,1554,10
6880499131,6880499110,-21,1083,1663,10
6885584570,6885584567,-3,1363,1268,10
6885755618,6885755609,-9,1231,1864,10
6885934057,6885934058,1,1273,1250,10
6887325750,6887325751,1,1108,1788,10
6889257070,6889257070,0,1205,2862,10
6894577844,6894577841,-3,1234,2054,10
6900667432,6900667431,-1,2150,2448,10
6903041098,6903041098,0,1236,1748,10
6911789766,6911789765,-1,957,2054,10
6916171578,6916171575,-3,1338,2049,10
6918320987,6918320986,-1,1078,1777,10
6920046546,6920046546,0,1535,2752,10
6921907797,6921907795,-2,1242,1824,10
6922545953,6922545950,-3,1830,2232,10
6922936343,6922936342,-1,1030,2574,10
6924881173,6924881174,1,1023,1267,10
6929317644,6929317647,3,2232,2207,10
6929732782,6929732783,1,815,1894,10
6931617570,6931617571,1,1209,2298,10
6931995387,6931995389,2,1217,751,10
6936497903,6936497900,-3,1095,1649,10
6936532683,6936532682,-1,5043,10046,10
6937773410,6937773408,-2,1462,2328,10
6937863118,6937863115,-3,1317,2515,10
6940004747,6940004745,-2,1292,2542,10
6943900651,6943900654,3,1337,1860,10
6945475662,6945475662,0,702,1999,10
6950480086,6950480085,-1,1530,1876,10
6952143447,6952143443,-4,1305,1597,10
6952199674,6952199672,-2,2097,4971,10
6952504814,6952504814,0,1074,1742,10
6952634003,6952634021,18,678,1773,10
6957385686,6957385686,0,1638,1519,10
6966078495,6966078495,0,1327,1320,10
6967229866,6967229864,-2,1071,1943,10
6972530262,6972530257,-5,1235,2070,10
6972851829,6972851826,-3,1179,1670,10
6974841417,6974841414,-3,216,1063,10
6975386890,6975386906,16,128,596,10
6976586082,6976586082,0,1425,1632,10
6979692001,6979692000,-1,1302,1903,10
6982197798,6982197797,-1,953,1556,10
6983932594,6983932593,-1,1808,2152,10
6985481062,6985481062,0,1113,1444,10
6995344670,6995344667,-3,1164,1629,10
6996419478,6996419480,2,1897,1449,10
7004554816,7004554838,22,881,1520,10
7005335330,7005335329,-1,1015,1279,10
7012242475,7012242474,-1,1712,2756,10
7012603594,7012603590,-4,848,1438,10
7017777442,7017777442,0,1343,1594,10
7020230255,7020230234,-21,1054,1626,10
7020322384,7020322382,-2,63,465,10
7025299502,7025299501,-1,1774,1889,10
7027417636,7027417634,-2,1105,1762,10
7029903074,7029903071,-3,906,1389,10
7030131986,7030131985,-1,1137,1747,10
7038015857,7038015856,-1,1018,2800,10
7040491278,7040491274,-4,1303,2022,10
7041568043,7041568044,1,944,1834,10
7046724773,7046724779,6,2686,1310,10
7047938014,7047938008,-6,1768,5348,10
7049378838,7049378844,6,15156,6062,10
7051988973,7051988975,2,780,2151,10
7052493569,7052493568,-1,1094,2108,10
7054864689,7054864693,4,2064,1082,10
7057368941,7057368938,-3,720,1634,10
7075473893,7075473895,2,1160,1854,10
7079886499,7079886493,-6,700,1102,10
7080196967,7080196970,3,1616,1640,10
7082574146,7082574144,-2,909,1845,10
7083433171,7083433169,-2,1411,1998,10
7083516291,7083516290,-1,796,1976,10
7083949293,7083949289,-4,1282,1919,10
7085892171,7085892169,-2,1075,2211,10
7086014356,7086014373,17,1351,1910,10
7088471506,7088471504,-2,913,1726,10
7089355989,7089355989,0,1313,2070,10
7092324330,7092324330,0,1042,1641,10
7094009553,7094009548,-5,1399,4569,10
7094494472,7094494466,-6,563,2180,10
7096399355,7096399353,-2,891,1342,10
7099054738,7099054736,-2,689,1844,10
7101522670,7101522666,-4,1261,2277,10
7103410790,7103410790,0,1109,1964,10
7104742737,7104742736,-1,1261,2224,10
7106745355,7106745354,-1,1185,1943,10
7107779159,7107779156,-3,1089,2064,10
7108829430,7108829433,3,4433,23681,10
7109094746,7109094744,-2,1047,1591,10
7114588029,7114588016,-13,950,2501,10
7117222563,7117222563,0,1330,1962,10
7119798534,7119798533,-1,1317,2006,10
7125507595,7125507591,-4,1272,1989,10
7125631874,7125631871,-3,1236,1766,10
7127826222,7127826222,0,1116,1553,10
7128310798,7128310794,-4,1201,1985,10
7129140179,7129140178,-1,966,2106,10
7130033667,7130033665,-2,1071,2038,10
7130228142,7130228141,-1,1172,1851,10
7133027449,7133027449,0,1331,1517,10
7136987361,7136987359,-2,785,1005,10
7138450165,7138450162,-3,1124,1621,10
7145864439,7145864437,-2,1181,1284,10
7146069248,7146069246,-2,1644,2422,10
7147754980,7147754971,-9,1158,2097,10
7148230418,7148230422,4,52635,96361,10
7149051415,7149051414,-1,1358,2244,10
7154154539,7154154538,-1,1634,2306,10
7154895906,7154895906,0,1208,1838,10
7155721615,7155721613,-2,1038,1788,10
7158081955,7158081950,-5,1239,2565,10
7158261962,7158261959,-3,1079,1589,10
7158523866,7158523867,1,1328,1938,10
7162579178,7162579182,4,1963,1255,10
7167321495,7167321490,-5,1189,2697,10
7171320789,7171320788,-1,1886,2750,10
7172547646,7172547645,-1,1603,2431,10
7173019988,7173020006,18,962,1636,10
7179729499,7179729499,0,1939,2162,10
7180428866,7180428867,1,1141,1166,10
7183233695,7183233693,-2,1097,2301,10
7187724742,7187724738,-4,899,2011,10
7188815094,7188815095,1,1399,1743,10
7189720347,7189720346,-1,1276,1354,10
7194338825,7194338823,-2,1316,1917,10
7195206437,7195206434,-3,1052,1710,10
7197393243,7197393244,1,1965,2253,10
7197654133,7197654133,0,1402,1838,10
7199508124,7199508122,-2,839,1405,10
7202413946,7202413946,0,1277,1602,10
7203642943,7203642941,-2,912,1949,10
7204347755,7204347751,-4,1246,2328,10
7204397999,7204397999,0,1419,2550,10
7205101202,7205101205,3,2795,2472,10
7213141501,7213141498,-3,1351,1914,10
7222706989,7222706995,6,3377,1662,10
7226714542,7226714545,3,1060,1457,10
7227712222,7227712223,1,1801,1379,10
7231351340,7231351337,-3,1353,2400,10
7231577577,7231577573,-4,1087,2555,10
7244086613,7244086614,1,1096,1674,10
7245009674,7245009675,1,1232,2010,10
7245368781,7245368781,0,1383,2298,10
7248426580,7248426579,-1,915,1622,10
7249032086,7249032082,-4,1120,2721,10
7249087462,7249087459,-3,1143,2106,10
7249176952,7249176948,-4,80,1927,10
7249622537,7249622535,-2,1415,1759,10
7258364778,7258364773,-5,1064,2429,10
7259932034,7259932031,-3,1012,2372,10
7260281220,7260281215,-5,1504,4267,10
7262287041,7262287041,0,2320,2671,10
7263012508,7263012505,-3,1234,1611,10
7268964411,7268964411,0,1224,1350,10
7270868998,7270868997,-1,1153,1960,10
7274164167,7274164166,-1,1069,1895,10
7275696762,7275696762,0,931,1497,10
7275974499,7275974497,-2,992,1406,10
7280931290,7280931288,-2,1129,1961,10
7281337712,7281337718,6,21619,16604,10
7282309367,7282309366,-1,889,1313,10
7284821044,7284821043,-1,869,1841,10
7285357863,7285357862,-1,902,1363,10
7289683207,7289683205,-2,1206,1880,10
7290463410,7290463405,-5,748,1987,10
7291191027,7291191027,0,1027,1608,10
7292446195,7292446194,-1,1388,1344,10
7297778943,7297778944,1,1603,2924,10
7299935525,7299935523,-2,1226,1548,10
7299970666,7299970666,0,970,1443,10
7300704913,7300704906,-7,970,4687,10
7303834332,7303834329,-3,1262,1387,10
7305906066,7305906071,5,2684,1150,10
7307001058,7307001059,1,1080,1236,10
7308357379,7308357377,-2,11366,23786,10
7313329210,7313329221,11,13349,39544,10
7313777647,7313777645,-2,1280,2036,10
7318196766,7318196749,-17,1576,383,10
7320019368,7320019366,-2,1225,2150,10
7322381459,7322381454,-5,1526,2199,10
7323548982,7323548985,3,1183,1562,10
7327472168,7327472166,-2,1082,1674,10
7328561688,7328561687,-1,979,1920,10
7329893142,7329893142,0,1257,1361,10
7331928834,7331928835,1,1580,2654,10
7332691922,7332691927,5,3497,1881,10
7335816158,7335816157,-1,1024,1562,10
7337219490,7337219487,-3,1203,1408,10
7338782067,7338782068,1,1151,1829,10
7340779898,7340779896,-2,1392,1967,10
7341664993,7341665012,19,39,741,10
7343496927,7343496926,-1,1349,1480,10
7344796843,7344796841,-2,1153,2278,10
7347787767,7347787766,-1,1572,1891,10
7347848759,7347848758,-1,1453,2660,10
7348810622,7348810618,-4,1577,2548,10
7349121309,7349121309,0,1342,2519,10
7349690645,7349690643,-2,1095,2122,10
7352904714,7352904713,-1,1095,2875,10
7352990132,7352990130,-2,1415,2589,10
7357519351,7357519354,3,1806,1036,10
7357591047,7357591045,-2,1318,1875,10
7364688737,7364688734,-3,1329,1900,10
7365256805,7365256805,0,918,1332,10
7366023640,7366023637,-3,1076,1647,10
7366611613,7366611609,-4,799,2125,10
7373558694,7373558693,-1,1492,2290,10
7374399865,7374399867,2,1494,1329,10
7378163019,7378163018,-1,506,1253,10
7378973356,7378973355,-1,1273,1569,10
7380030026,7380030025,-1,1143,1776,10
7380211827,7380211847,20,806,1643,10
7380967567,7380967566,-1,1364,1618,10
7382115510,7382115511,1,1641,1967,10
7387912589,7387912588,-1,1560,2179,10
7390602262,7390602258,-4,1443,3044,10
7391481267,7391481266,-1,1175,2636,10
7392143634,7392143634,0,792,1166,10
7393826126,7393826124,-2,1079,1453,10
7395954443,7395954441,-2,752,1522,10
7396621966,7396621966,0,1082,2168,10
7398742340,7398742338,-2,989,1544,10
7401152399,7401152398,-1,985,1491,10
7402706559,7402706555,-4,912,1655,10
7409028500,7409028498,-2,1740,2453,10
7409291815,7409291813,-2,1119,1554,10
7412200169,7412200166,-3,1218,2352,10
7413544831,7413544835,4,1068,1066,10
7419170741,7419170738,-3,1181,2099,10
7419920217,7419920213,-4,1070,2577,10
7422191230,7422191229,-1,1323,2057,10
7423739319,7423739318,-1,1511,2871,10
7427562250,7427562246,-4,1262,1968,10
7429822307,7429822305,-2,925,1427,10
7430869289,7430869288,-1,953,1076,10
7432782410,7432782410,0,1246,1584,10
7434567977,7434567974,-3,1179,1705,10
7437136585,7437136585,0,1411,2234,10
7437456565,7437456561,-4,1272,2310,10
7439655390,7439655390,0,1112,1872,10
7444936866,7444936861,-5,29117,18100,10
7446285944,7446285945,1,1687,1914,10
7448352378,7448352374,-4,931,1402,10
7449725655,7449725653,-2,1160,1953,10
7451721526,7451721526,0,1424,2464,10
7455772090,7455772089,-1,1204,2535,10
7456962079,7456962077,-2,1287,1580,10
7460061071,7460061071,0,1712,2079,10
7460481899,7460481899,0,1142,1634,10
7465185525,7465185525,0,1556,1888,10
7470287539,7470287538,-1,2053,3915,10
7470535063,7470535060,-3,1078,1789,10
7472583198,7472583202,4,2425,1391,10
7473706571,7473706570,-1,1192,1364,10
7477741746,7477741745,-1,1331,1667,10
7480040870,7480040869,-1,688,1028,10
7481592653,7481592653,0,1183,1636,10
7483965675,7483965674,-1,1669,2857,10
7486911611,7486911610,-1,1088,1594,10
7488888713,7488888713,0,1360,1692,10
7494347766,7494347773,7,4320,1568,10
7494567590,7494567597,7,3032,1188,10
7498993454,7498993454,0,1092,1845,10
7500338030,7500338029,-1,973,1628,10
7500926159,7500926158,-1,1318,2209,10
7502989204,7502989204,0,1284,1604,10
7503828272,7503828274,2,1338,948,10
7507272907,7507272901,-6,1078,4208,10
7514067009,7514067009,0,1381,1551,10
7518036502,7518036500,-2,1394,2169,10
7518798716,7518798735,19,1145,1772,10
7527005489,7527005489,0,1211,1504,10
7528604024,7528604029,5,1630,1418,10
7535919425,7535919424,-1,1050,1923,10
7538770098,7538770093,-5,1338,4112,10
7540959179,7540959178,-1,1060,2295,10
7542292819,7542292806,-13,1010,1522,10
7546444063,7546444054,-9,975,4510,10
7547268530,7547268524,-6,817,1351,10
7551244065,7551244065,0,1698,1777,10
7553038234,7553038245,11,204,950,10
7555530097,7555530094,-3,1034,1528,10
7563349562,7563349562,0,1149,2449,10
7563866694,7563866692,-2,1399,1954,10
7565320626,7565320622,-4,1432,1522,10
7579809393,7579809391,-2,550,1481,10
7581199965,7581199965,0,1071,1644,10
7583385409,7583385409,0,1253,1631,10
7586291854,7586291852,-2,1528,2129,10
7588746353,7588746353,0,1360,1263,10
7590718425,7590718425,0,1177,1937,10
7590906898,7590906897,-1,796,1013,10
7593124994,7593124993,-1,1177,1526,10
7599858673,7599858671,-2,1496,2802,10
7600043304,7600043326,22,980,1492,10
7600245881,7600245880,-1,1408,2477,10
7600641869,7600641866,-3,1020,2096,10
7600845381,7600845379,-2,1587,2191,10
7600991080,7600991073,-7,816,1472,10
7603052399,7603052396,-3,1955,2816,10
7605151250,7605151253,3,1237,1617,10
7605888809,7605888807,-2,915,1364,10
7607434062,7607434057,-5,1327,4037,10
7612157362,7612157361,-1,1184,2172,10
7613982850,7613982845,-5,1445,4658,10
7617576237,7617576234,-3,1330,1161,10
7618974265,7618974263,-2,1275,2177,10
7623184581,7623184579,-2,1156,1864,10
7625262942,7625262941,-1,1277,1679,10
7625377943,7625377943,0,1195,1584,10
7628121613,7628121610,-3,904,1343,10
7628618771,7628618760,-11,1023,2051,10
7630900893,7630900890,-3,915,2194,10
7633510942,7633510939,-3,880,1679,10
7634051681,7634051673,-8,1306,2099,10
7635345569,7635345566,-3,935,1975,10
7635867446,7635867444,-2,1252,2196,10
7640887553,7640887552,-1,807,1997,10
7642380962,7642380962,0,1399,2171,10
7643479753,7643479753,0,1345,1818,10
7644747850,7644747847,-3,1196,2007,10
7648098845,7648098846,1,1200,1773,10
7649917429,7649917427,-2,984,1952,10
7651823982,7651823983,1,1220,1611,10
7654819842,7654819841,-1,907,2051,10
7657885985,7657885983,-2,1226,2141,10
7660854670,7660854667,-3,903,1433,10
7666319334,7666319335,1,1338,1719,10
7668222950,7668222949,-1,1069,1679,10
7670783349,7670783347,-2,1306,1665,10
7677580640,7677580638,-2,1556,1916,10
7681024996,7681024997,1,2353,4107,10
7681424866,7681424863,-3,1286,2519,10
7681532525,7681532529,4,3387,1912,10
7683049084,7683049082,-2,1414,2113,10
7684339896,7684339894,-2,1667,2903,10
7686361262,7686361253,-9,1160,1263,10
7697660726,7697660726,0,1459,2730,10
7710907709,7710907707,-2,1475,1886,10
7711163185,7711163205,20,1113,1943,10
7711295369,7711295367,-2,956,2159,10
7714656556,7714656555,-1,1659,2079,10
7721321380,7721321379,-1,1493,1596,10
7723223135,7723223134,-1,747,1131,10
7724415668,7724415665,-3,1421,2593,10
7728941678,7728941675,-3,1163,2914,10
7733632930,7733632911,-19,1150,1647,10
7735051784,7735051783,-1,869,1505,10
7741053158,7741053154,-4,1681,2748,10
7742513391,7742513389,-2,1467,2459,10
7744263513,7744263510,-3,1026,2366,10
7744879578,7744879575,-3,1019,2260,10
7745662985,7745662979,-6,1037,1922,10
7747605566,7747605563,-3,431,2110,10
7748524098,7748524097,-1,1290,2010,10
7750501232,7750501231,-1,1333,995,10
7756485297,7756485296,-1,1672,1286,10
7757294383,7757294381,-2,1127,2089,10
7759452779,7759452777,-2,1065,2638,10
7761514500,7761514513,13,436,2337,10
7762431682,7762431685,3,2550,2196,10
7765477706,7765477706,0,1465,1528,10
7769172727,7769172726,-1,1261,1796,10
7771050981,7771050979,-2,1565,3054,10
7773049639,7773049645,6,4447,2052,10
7773810428,7773810428,0,955,1412,10
7774475684,7774475684,0,1527,1739,10
7776549198,7776549197,-1,884,1307,10
7777641329,7777641326,-3,1718,2236,10
7777910217,7777910213,-4,1555,2071,10
7778186009,7778186005,-4,1296,4571,10
7780490652,7780490656,4,1850,1839,10
7781864326,7781864323,-3,1106,1292,10
7782574372,7782574371,-1,1010,1906,10
7783176991,7783176990,-1,958,2081,10
7786603178,7786603177,-1,787,1551,10
7786783251,7786783234,-17,593,1606,10
7787683083,7787683082,-1,1297,1669,10
7788429182,7788429178,-4,984,2659,10
7792929277,7792929274,-3,1030,2177,10
7794337127,7794337126,-1,988,1987,10
7799362414,7799362413,-1,1120,2063,10
7803068503,7803068501,-2,1257,2460,10
7803264848,7803264849,1,1385,2214,10
7811733106,7811733106,0,870,2214,10
7816763903,7816763896,-7,1151,4948,10
7820233132,7820233131,-1,1699,1685,10
7823149198,7823149197,-1,1364,2493,10
7833198475,7833198474,-1,995,1853,10
7833251683,7833251670,-13,1232,1399,10
7836685782,7836685782,0,1264,2027,10
7837779376,7837779374,-2,1060,1590,10
7838770762,7838770762,0,1082,1209,10
7838865994,7838865994,0,1240,1696,10
7843911599,7843911595,-4,1010,2553,10
7844686542,7844686542,0,1219,2478,10
7845027811,7845027805,-6,959,1497,10
7850477513,7850477515,2,1280,1211,10
7851929417,7851929416,-1,1701,2668,10
7854310318,7854310318,0,1202,2586,10
7856812042,7856812042,0,1023,1896,10
7858682750,7858682746,-4,1252,2319,10
7859897202,7859897202,0,1198,1935,10
7863780695,7863780695,0,981,2142,10
7866854213,7866854213,0,1318,1544,10
7868206519,7868206518,-1,1785,2351,10
7870882003,7870881996,-7,1473,5065,10
7871311613,7871311612,-1,1442,2847,10
7872080178,7872080178,0,1240,1550,10
7880777355,7880777369,14,1901,1661,10
7886144093,7886144095,2,786,932,10
7886853103,7886853102,-1,656,1593,10
7889351945,7889351951,6,59091,53828,10
7892340674,7892340675,1,1764,1226,10
7894972180,7894972182,2,3961,2658,10
7900217568,7900217565,-3,850,1621,10
7902820726,7902820726,0,1770,3034,10
7903131681,7903131674,-7,2207,7311,10
7911133118,7911133114,-4,939,2192,10
7911880280,7911880278,-2,1836,2550,10
7912140744,7912140742,-2,1141,1974,10
7913422655,7913422654,-1,1138,2073,10
7914021577,7914021575,-2,800,1849,10
7914159027,7914159007,-20,1110,1278,10
7918369658,7918369654,-4,1351,2334,10
7921264733,7921264732,-1,1307,2100,10
7922145425,7922145422,-3,1741,2678,10
7923051001,7923051003,2,1421,1891,10
7923135979,7923135977,-2,1015,2244,10
7929411894,7929411898,4,1866,1432,10
7932306002,7932305998,-4,856,1559,10
7933704370,7933704371,1,1361,2717,10
7934259504,7934259502,-2,1454,2371,10
7934825600,7934825598,-2,1232,1792,10
7935477542,7935477541,-1,1773,2096,10
7936116512,7936116510,-2,1121,1962,10
7939128907,7939128906,-1,878,1872,10
7939631684,7939631682,-2,1407,2172,10
7945693631,7945693630,-1,884,2124,10
7948170394,7948170390,-4,2142,4484,10
7953872631,7953872627,-4,1395,1938,10
7954170975,7954170976,1,1592,2300,10
7957767516,7957767512,-4,759,1574,10
7957980584,7957980582,-2,925,2228,10
7961133591,7961133591,0,1026,1996,10
7962049748,7962049746,-2,1195,1950,10
7964106892,7964106893,1,1121,1313,10
7965385367,7965385371,4,3392,3607,10
7967912290,7967912287,-3,1205,2722,10
7971137844,7971137840,-4,2499,6028,10
7971957838,7971957836,-2,1319,1685,10
7972514210,7972514208,-2,942,1420,10
7974636557,7974636556,-1,908,1943,10
7974870545,7974870543,-2,1483,2145,10
7981268984,7981268985,1,1565,1565,10
7984766555,7984766553,-2,2005,2366,10
7985056523,7985056517,-6,39097,14309,10
7988523090,7988523089,-1,1144,1989,10
7988720298,7988720277,-21,809,1137,10
7991242459,7991242456,-3,767,1798,10
7994168875,7994168875,0,1052,1889,10
7996308527,7996308526,-1,1274,2409,10
7997918553,7997918552,-1,1314,2090,10
8004907317,8004907315,-2,1152,1421,10
8019430483,8019430481,-2,651,2138,10
8021139155,8021139153,-2,1818,2608,10
8024713871,8024713878,7,3683,1268,10
8026088090,8026088089,-1,1103,2263,10
8027208694,8027208695,1,1058,2013,10
8032898041,8032898042,1,1091,1118,10
8034530910,8034530911,1,1057,1535,10
8037170631,8037170630,-1,898,1139,10
8044447668,8044447668,0,1122,1613,10
8045100557,8045100554,-3,1252,2122,10
8045819939,8045819938,-1,1100,1415,10
8046689534,8046689534,0,1571,2305,10
8050396130,8050396130,0,1579,1871,10
8051198069,8051198064,-5,1177,2380,10
8051877094,8051877096,2,1529,1289,10
8052195221,8052195218,-3,1087,2961,10
8054964875,8054964873,-2,1029,2429,10
8058040786,8058040793,7,1227,1104,10
8060272403,8060272405,2,1178,1771,10
8061898857,8061898856,-1,1202,2270,10
8064202853,8064202851,-2,1386,1917,10
8066914132,8066914129,-3,1890,2593,10
8069092753,8069092751,-2,937,2097,10
8069794642,8069794641,-1,908,2022,10
8069922752,8069922745,-7,1432,2461,10
8074109151,8074109159,8,985,1571,10
8074866142,8074866140,-2,861,1944,10
8079206230,8079206225,-5,547,2161,10
8081554070,8081554070,0,1134,1924,10
8086434559,8086434558,-1,1375,2675,10
8086881995,8086881991,-4,838,2045,10
8088543884,8088543877,-7,1250,1892,10
8095423066,8095423066,0,911,1538,10
8095812945,8095812942,-3,1245,2397,10
8098827251,8098827246,-5,2078,5268,10
8100587578,8100587598,20,1042,2213,10
8107312758,8107312757,-1,1213,1946,10
8110312489,8110312487,-2,992,1615,10
8118311290,8118311290,0,1865,1936,10
8127973098,8127973094,-4,1029,1446,10
8132279510,8132279508,-2,1401,2751,10
8133442425,8133442426,1,1251,1722,10
8137271184,8137271181,-3,1242,1890,10
8139330814,8139330814,0,1405,1390,10
8139800615,8139800614,-1,932,2099,10
8140864816,8140864814,-2,1295,2799,10
8141152699,8141152691,-8,1178,865,10
8142468213,8142468210,-3,1500,2888,10
8144603734,8144603731,-3,1486,2273,10
8144975547,8144975546,-1,1414,2021,10
8145207014,8145207013,-1,1002,2051,10
8146100409,8146100405,-4,1042,2362,10
8147246362,8147246359,-3,796,1243,10
8151570723,8151570721,-2,867,1251,10
8154219127,8154219126,-1,1048,1594,10
8157066494,8157066495,1,1129,1313,10
8158051827,8158051826,-1,1223,1743,10
8158874666,8158874666,0,589,936,10
8161898681,8161898682,1,3728,3217,10
8162072230,8162072228,-2,776,1260,10
8162710418,8162710417,-1,607,656,10
8163286364,8163286362,-2,905,1514,10
8168600738,8168600736,-2,1442,1737,10
8169219879,8169219879,0,1631,1633,10
8171595808,8171595808,0,1210,1823,10
8171972477,8171972476,-1,1033,2137,10
8172849723,8172849723,0,1283,2387,10
8180775860,8180775859,-1,1359,2133,10
8180922237,8180922236,-1,2083,2081,10
8181358958,8181358955,-3,1083,2575,10
8183511114,8183511113,-1,1334,1116,10
8184339663,8184339661,-2,2212,6052,10
8188456663,8188456665,2,1555,1388,10
8194548371,8194548371,0,1165,1980,10
8200747525,8200747522,-3,971,940,10
8204661275,8204661281,6,2129,1260,10
8212295414,8212295414,0,1101,2170,10
8214101361,8214101358,-3,1050,1553,10
8215251315,8215251314,-1,1305,1549,10
8216200394,8216200394,0,1420,1991,10
8216546195,8216546190,-5,758,1778,10
8220394794,8220394794,0,1391,1881,10
8222762877,8222762875,-2,1223,2799,10
8228649742,8228649742,0,1061,1750,10
8229603094,8229603093,-1,1102,2653,10
8230072883,8230072883,0,1359,1959,10
8234415566,8234415567,1,1570,2125,10
8237192195,8237192194,-1,1094,2497,10
8238366586,8238366582,-4,1336,3336,10
8240978349,8240978347,-2,1006,1820,10
8244316658,8244316658,0,1413,1860,10
8252416057,8252416057,0,1210,2160,10
8257958277,8257958276,-1,2096,2697,10
8259981028,8259981034,6,3972,1082,10
8261761465,8261761462,-3,1685,1571,10
8268988864,8268988866,2,2884,3022,10
8269107074,8269107069,-5,1038,2373,10
8272320333,8272320330,-3,1186,2056,10
8272711494,8272711494,0,1612,1877,10
8274639709,8274639707,-2,1118,1811,10
8275600070,8275600069,-1,809,1147,10
8279198323,8279198319,-4,1037,1341,10
8286451389,8286451388,-1,1474,1529,10
8287398161,8287398153,-8,1140,2345,10
8288407409,8288407410,1,1768,1578,10
8290176189,8290176187,-2,1551,2328,10
8295049417,8295049415,-2,1435,2507,10
8299366030,8299366028,-2,1159,2535,10
8302060261,8302060260,-1,1175,1920,10
8302270267,8302270266,-1,1228,1577,10
8317324477,8317324476,-1,1227,1858,10
8320647470,8320647470,0,1903,2418,10
8322495277,8322495276,-1,1552,2756,10
8323978150,8323978146,-4,1547,2249,10
8330011200,8330011199,-1,1203,2040,10
8331195131,8331195130,-1,1265,2211,10
8331335938,8331335958,20,611,1770,10
8334742517,8334742516,-1,1249,1997,10
8335092139,8335092137,-2,876,2214,10
8336998457,8336998457,0,1402,2173,10
8339329262,8339329259,-3,689,1513,10
8339753601,8339753601,0,697,1151,10
8339911382,8339911381,-1,1781,2313,10
8339957615,8339957614,-1,1403,1779,10
8340496846,8340496842,-4,1229,1630,10
8341282196,8341282194,-2,1027,2174,10
8344370313,8344370320,7,58304,122234,10
8354733442,8354733443,1,1049,1280,10
8365878018,8365878018,0,1557,2331,10
8368091339,8368091338,-1,1192,1915,10
8371128544,8371128541,-3,1108,1463,10
8377941778,8377941775,-3,865,2047,10
8391398794,8391398794,0,1637,2295,10
8392169835,8392169833,-2,1379,1957,10
8395598295,8395598298,3,2841,2490,10
8396434250,8396434246,-4,1526,2310,10
8396673373,8396673372,-1,1761,2145,10
8396992805,8396992803,-2,1376,2012,10
8398917052,8398917050,-2,1191,2170,10
8400354087,8400354086,-1,1461,1632,10
8405219998,8405219998,0,1596,1183,10
8407552722,8407552719,-3,1501,2414,10
8407995162,8407995182,20,351,1364,10
8410128559,8410128556,-3,1358,1567,10
8413456046,8413456043,-3,1039,1691,10
8415449923,8415449922,-1,1180,2258,10
8417937462,8417937460,-2,885,1579,10
8419753274,8419753274,0,1728,2114,10
8422804914,8422804911,-3,827,1600,10
8426828770,8426828768,-2,1983,2227,10
8427513175,8427513177,2,1495,1842,10
8429554210,8429554211,1,1553,1818,10
8429877974,8429877970,-4,1080,2158,10
8430371285,8430371284,-1,1336,1867,10
8438924552,8438924550,-2,1338,2317,10
8441029950,8441029948,-2,1206,2363,10
8447166174,8447166174,0,1238,2320,10
8447915437,8447915435,-2,822,2031,10
8449345738,8449345737,-1,940,1514,10
8450117333,8450117331,-2,809,1626,10
8451994747,8451994742,-5,1293,1985,10
8460127382,8460127382,0,1120,1979,10
8460371923,8460371921,-2,1187,1591,10
8464044015,8464044014,-1,1738,2769,10
8466255053,8466255052,-1,954,18712,10
8468470026,8468470027,1,1355,1730,10
8470884342,8470884342,0,1367,2353,10
8478610817,8478610818,1,1244,1617,10
8479093219,8479093215,-4,807,2313,10
8480976630,8480976628,-2,1356,2091,10
8481175162,8481175166,4,827,1081,10
8482008443,8482008442,-1,987,1385,10
8482098273,8482098278,5,2371,1190,10
8485942106,8485942105,-1,1657,3084,10
8486739259,8486739254,-5,1119,1934,10
8487554740,8487554739,-1,1704,2861,10
8489539486,8489539482,-4,1264,1794,10
8490153529,8490153527,-2,835,1999,10
8496490966,8496490963,-3,646,1188,10
8500116410,8500116409,-1,1263,1932,10
8500283707,8500283706,-1,1279,2200,10
8500925633,8500925630,-3,1198,1918,10
8501669486,8501669483,-3,1196,2222,10
8504991738,8504991737,-1,1292,2357,10
8514277912,8514277910,-2,1296,2201,10
8515340162,8515340167,5,2323,1308,10
8516797192,8516797192,0,1372,2029,10
8518331738,8518331738,0,1482,1993,10
8519000153,8519000150,-3,846,1449,10
8521447951,8521447948,-3,775,1251,10
8522601193,8522601193,0,1429,2701,10
8525081859,8525081857,-2,1363,1678,10
8531165262,8531165262,0,1088,1420,10
8531789311,8531789310,-1,957,2330,10
8534204687,8534204682,-5,1247,2120,10
8534575169,8534575157,-12,1384,1729,10
8538242625,8538242626,1,1034,1923,10
8539831717,8539831716,-1,1859,2775,10
8545806821,8545806820,-1,1409,1490,10
8546013430,8546013429,-1,1052,1410,10
8546255710,8546255709,-1,1133,1177,10
8546975042,8546975041,-1,979,1333,10
8547647322,8547647320,-2,1486,2586,10
8548007601,8548007599,-2,1175,2620,10
8557347315,8557347312,-3,1085,1443,10
8558563308,8558563307,-1,1385,2317,10
8569054598,8569054598,0,1155,1911,10
8574765270,8574765270,0,1665,2381,10
8575073180,8575073179,-1,1525,2457,10
8575849158,8575849155,-3,1012,2316,10
8575970058,8575970055,-3,990,1891,10
8577914498,8577914508,10,10791,41623,10
8579334262,8579334259,-3,1239,2142,10
8581798760,8581798758,-2,1485,2353,10
8587266607,8587266606,-1,1503,2249,10
8590145381,8590145385,4,1419,1069,10
8594664967,8594664966,-1,1689,2111,10
8597777370,8597777370,0,1069,1357,10
8598567921,8598567918,-3,1511,1788,10
8599349817,8599349814,-3,1281,1652,10
8600772271,8600772269,-2,1584,3439,10
8603919022,8603919020,-2,1117,2435,10
8613047609,8613047607,-2,1883,2399,10
8614340418,8614340417,-1,1107,1628,10
8615300318,8615300318,0,1374,2065,10
8622025780,8622025777,-3,1352,1781,10
8625688081,8625688078,-3,897,2349,10
8628559046,8628559044,-2,1085,1619,10
8628987705,8628987705,0,2265,1404,10
8629228068,8629228067,-1,1417,1896,10
8629641411,8629641407,-4,857,1666,10
8633511769,8633511769,0,1381,1798,10
8638333479,8638333480,1,1113,1344,10
8639784266,8639784265,-1,1722,2710,10
8644106791,8644106789,-2,1330,1967,10
8644270211,8644270210,-1,1649,1860,10
8645464070,8645464075,5,2544,1236,10
8647796817,8647796816,-1,1945,2232,10
8648862670,8648862665,-5,2631,7292,10
8648936755,8648936754,-1,1226,2209,10
8649341662,8649341672,10,11750,38691,10
8652642343,8652642342,-1,1293,1962,10
8657099939,8657099940,1,1353,1440,10
8659226205,8659226204,-1,1138,1542,10
8660691350,8660691350,0,729,1724,10
8663701495,8663701489,-6,799,5421,10
8664023660,8664023658,-2,1460,1745,10
8666441674,8666441673,-1,1242,1814,10
8672230925,8672230926,1,3633,15898,10
8674697926,8674697925,-1,1050,2321,10
8674968598,8674968598,0,1072,1527,10
8675700234,8675700233,-1,1138,1801,10
8679089533,8679089534,1,705,1123,10
8679831282,8679831281,-1,1055,2244,10
8684468551,8684468548,-3,892,1418,10
8685710291,8685710291,0,939,1112,10
8687507255,8687507254,-1,1096,1740,10
8690396330,8690396327,-3,1634,2450,10
8694417030,8694417027,-3,1329,1881,10
8697677793,8697677794,1,1712,2463,10
8698030867,8698030865,-2,1329,1670,10
8699414670,8699414669,-1,1349,2414,10
8700684618,8700684618,0,1102,1375,10
8710376491,8710376490,-1,1717,2378,10
8712945187,8712945184,-3,1108,1676,10
8716544926,8716544922,-4,1247,3173,10
8722519869,8722519869,0,989,1783,10
8723730912,8723730911,-1,1240,1022,10
8725689659,8725689670,11,394,1088,10
8728288804,8728288797,-7,1796,5413,10
8728774590,8728774588,-2,1137,2665,10
8730935943,8730935940,-3,957,1225,10
8731729833,8731729831,-2,1364,2999,10
8732151647,8732151646,-1,723,1683,10
8734265629,8734265629,0,760,1176,10
8736063527,8736063526,-1,1201,2380,10
8737084506,8737084498,-8,1155,3596,10
8737596127,8737596126,-1,1059,1115,10
8737854706,8737854707,1,591,952,10
8739859153,8739859150,-3,1467,2173,10
8740449747,8740449747,0,3329,5667,10
8741712806,8741712802,-4,1071,2515,10
8742639446,8742639444,-2,1283,2387,10
8743260709,8743260710,1,1348,2283,10
8744381622,8744381622,0,624,1459,10
8745189976,8745189980,4,21747,20384,10
8747299395,8747299395,0,675,1127,10
8747691875,8747691872,-3,1578,1927,10
8748302716,8748302716,0,1292,1542,10
8749320166,8749320165,-1,1131,2296,10
8749440190,8749440189,-1,881,1605,10
8751734922,8751734922,0,1580,2862,10
8752646909,8752646906,-3,830,2111,10
8752927002,8752927001,-1,1292,2358,10
8754299828,8754299845,17,987,1800,10
8755211406,8755211400,-6,1248,5071,10
8756806055,8756806054,-1,854,1726,10
8758688525,8758688525,0,1536,2465,10
8759894897,8759894897,0,1056,2560,10
8760752503,8760752500,-3,1258,2287,10
8761784615,8761784613,-2,1140,1982,10
8762070938,8762070939,1,1183,1841,10
8763753719,8763753715,-4,899,1535,10
8764410967,8764410966,-1,1435,2879,10
8766030269,8766030265,-4,1365,2108,10
8766688130,8766688126,-4,2867,5804,10
8771616986,8771616985,-1,1403,2967,10
8772997214,8772997213,-1,1318,1921,10
8773487027,8773487025,-2,1037,2582,10
8774744917,8774744924,7,4005,1066,10
8775280917,8775280914,-3,1266,1569,10
8780084705,8780084704,-1,1838,1968,10
8781092282,8781092279,-3,1292,2650,10
8781450147,8781450155,8,85,1045,10
8786806334,8786806341,7,8602,4122,10
8787664506,8787664504,-2,1382,1965,10
8789601794,8789601799,5,2777,1873,10
8793381973,8793381971,-2,1479,1872,10
8801008701,8801008698,-3,1233,2678,10
8804177031,8804177030,-1,1136,1841,10
8804859058,8804859056,-2,1555,2095,10
8805583747,8805583746,-1,1136,1816,10
8807783058,8807783057,-1,532,928,10
8810214446,8810214446,0,1944,2155,10
8810728160,8810728157,-3,1436,1884,10
8810889513,8810889535,22,619,972,10
8814675893,8814675891,-2,1481,2085,10
8818887805,8818887806,1,1850,2265,10
8820531626,8820531625,-1,1067,2440,10
8820603687,8820603686,-1,1063,1988,10
8821297234,8821297233,-1,1161,1630,10
8821964650,8821964633,-17,925,2141,10
8824920587,8824920586,-1,1451,1951,10
8830481647,8830481649,2,709,1373,10
8830903234,8830903220,-14,994,1452,10
8833563058,8833563058,0,1345,1828,10
8836069007,8836069002,-5,1170,1707,10
8838109489,8838109486,-3,1134,1933,10
8840299374,8840299373,-1,1221,2183,10
8847887790,8847887788,-2,1129,2425,10
8847929378,8847929378,0,1396,1783,10
8849695409,8849695406,-3,1565,3278,10
8851082797,8851082796,-1,993,1252,10
8851270135,8851270133,-2,982,2196,10
8855417649,8855417649,0,873,1773,10
8858308043,8858308046,3,31,616,10
8859575878,8859575878,0,1014,1454,10
8861332206,8861332206,0,1469,1928,10
8861876178,8861876178,0,1187,2029,10
8867637186,8867637187,1,803,1940,10
8874565530,8874565529,-1,949,1757,10
8881364549,8881364546,-3,1271,1857,10
8881494554,8881494574,20,1026,1731,10
8881943315,8881943314,-1,819,1427,10
8883234627,8883234625,-2,1193,2462,10
8883520201,8883520199,-2,1122,1544,10
8884537710,8884537707,-3,1027,2550,10
8885895731,8885895730,-1,1487,1951,10
8889306429,8889306427,-2,739,1801,10
8896914955,8896914951,-4,1318,2162,10
8897103856,8897103855,-1,1327,2665,10
8898174857,8898174878,21,351,1496,10
8899471472,8899471470,-2,980,2478,10
8901947451,8901947449,-2,1130,2385,10
8903254588,8903254586,-2,2139,2184,10
8906538961,8906538961,0,1326,1674,10
8908732857,8908732865,8,16681,16985,10
8911071897,8911071895,-2,1324,2353,10
8913315813,8913315810,-3,1068,2682,10
8916563054,8916563053,-1,1214,1840,10
8919489528,8919489526,-2,1273,2495,10
8925123627,8925123627,0,993,2094,10
8929771251,8929771249,-2,1252,2122,10
8935361103,8935361102,-1,1352,2141,10
8939333462,8939333458,-4,1117,4064,10
8939748388,8939748399,11,179,792,10
8942803906,8942803906,0,1251,2149,10
8942888792,8942888777,-15,1229,2544,10
8943091524,8943091538,14,208,778,10
8944415131,8944415129,-2,1048,1566,10
8949409425,8949409425,0,945,1341,10
8949602077,8949602081,4,2696,1567,10
8949633485,8949633482,-3,1442,2164,10
8953093010,8953093010,0,1710,2139,10
8953235997,8953235996,-1,32083,47576,10
8956037472,8956037469,-3,1552,2186,10
8956666397,8956666402,5,2283,1205,10
8971874241,8971874242,1,1712,2264,10
8973693519,8973693519,0,1222,2056,10
8975002095,8975002093,-2,963,2036,10
8977336797,8977336795,-2,1632,1992,10
8979640042,8979640041,-1,1279,1722,10
8981234770,8981234777,7,626,635,10
8981976333,8981976331,-2,1558,1702,10
8982589322,8982589322,0,1106,2300,10
8983277431,8983277429,-2,1288,1971,10
8984021288,8984021288,0,1474,2193,10
8984379558,8984379559,1,1142,1338,10
8985175619,8985175619,0,1254,1606,10
8986195570,8986195569,-1,1218,1683,10
8987171879,8987171881,2,1061,1791,10
8993837832,8993837831,-1,1278,2455,10
8994886120,8994886119,-1,1443,2114,10
8998432549,8998432546,-3,611,1188,10
8999484035,8999484034,-1,1615,2406,10
9001474009,9001474009,0,1692,2062,10
9002613711,9002613713,2,1073,1901,10
9004877234,9004877233,-1,1070,1369,10
9005939358,9005939358,0,1138,2208,10
9008010348,9008010349,1,1514,2271,10
9008114586,9008114585,-1,1087,1488,10
9008860356,9008860356,0,1006,2533,10
9010909324,9010909322,-2,1525,2364,10
9015292654,9015292653,-1,1966,2917,10
9020127602,9020127599,-3,1491,2136,10
9025307323,9025307321,-2,1019,1601,10
9025468148,9025468167,19,1066,2004,10
9027005194,9027005193,-1,1161,1985,10
9027718782,9027718780,-2,1454,2857,10
9027846192,9027846199,7,281,971,10
9028279021,9028279021,0,1034,2215,10
9029260023,9029260022,-1,1045,1561,10
9040096853,9040096851,-2,1346,2566,10
9043321679,9043321677,-2,973,1821,10
9045020121,9045020121,0,846,1338,10
9045830670,9045830667,-3,1214,2617,10
9046201602,9046201601,-1,1221,1775,10
9047198338,9047198337,-1,1294,1770,10
9050439262,9050439260,-2,1161,2242,10
9050530857,9050530855,-2,1305,2499,10
9052565843,9052565834,-9,1266,2281,10
9055259398,9055259397,-1,1274,2316,10
9055666973,9055666974,1,1507,1505,10
9059179325,9059179323,-2,1412,2130,10
9061858153,9061858150,-3,1155,1490,10
9062864671,9062864668,-3,1291,2861,10
9063622922,9063622922,0,1550,1366,10
9063776606,9063776604,-2,1308,1360,10
9067407618,9067407617,-1,1135,2188,10
9076645298,9076645307,9,1636,1211,10
9078450314,9078450311,-3,1306,2397,10
9078554800,9078554801,1,940,1854,10
9079541728,9079541725,-3,1155,2227,10
9080176605,9080176604,-1,1143,2108,10
9080424010,9080424010,0,760,1852,10
9082960241,9082960240,-1,1297,1784,10
9085726066,9085726065,-1,1519,1365,10
9088994715,9088994715,0,815,1513,10
9091454063,9091454062,-1,1137,1886,10
9091844417,9091844415,-2,1455,2694,10
9097140417,9097140414,-3,1111,1567,10
9101142713,9101142710,-3,1540,1742,10
9103371602,9103371598,-4,1074,2167,10
9108814736,9108814732,-4,1684,2748,10
9109990776,9109990775,-1,1721,1244,10
9110354429,9110354426,-3,860,1506,10
9111024038,9111024038,0,1134,1579,10
9114068726,9114068726,0,1988,2379,10
9116379096,9116379094,-2,667,1241,10
9118139640,9118139663,23,841,1770,10
9119356071,9119356073,2,1215,1204,10
9121563043,9121563042,-1,750,1732,10
9123290374,9123290374,0,1384,3399,10
9123520429,9123520428,-1,871,1833,10
9125500810,9125500809,-1,1086,1900,10
9128896571,9128896571,0,1228,1381,10
9129052534,9129052534,0,1125,1806,10
9133333026,9133333022,-4,1943,2624,10
9136774611,9136774613,2,1313,1186,10
9136963334,9136963331,-3,886,1134,10
9137587968,9137587966,-2,1401,2037,10
9138642355,9138642354,-1,987,1412,10
9140156982,9140156983,1,991,1192,10
9142768268,9142768265,-3,806,1423,10
9143231458,9143231457,-1,654,1258,10
9143741781,9143741782,1,795,1365,10
9146526974,9146526973,-1,1306,1752,10
9147898537,9147898533,-4,1433,3234,10
9157040940,9157040938,-2,1346,2555,10
9164003346,9164003342,-4,1164,1967,10
9168475205,9168475204,-1,1223,3196,10
9170610990,9170610987,-3,1485,2773,10
9171772759,9171772757,-2,701,1794,10
9177663726,9177663728,2,1690,985,10
9181834398,9181834394,-4,996,1373,10
9184216958,9184216957,-1,1321,1909,10
9184473631,9184473630,-1,703,997,10
9187381727,9187381726,-1,1355,2577,10
9187584600,9187584598,-2,1110,2165,10
9188574001,9188573997,-4,941,1716,10
9189771046,9189771044,-2,957,1258,10
9190537227,9190537227,0,1124,2175,10
9193910443,9193910443,0,1744,2281,10
9195005467,9195005465,-2,915,1637,10
9197152843,9197152842,-1,1168,1953,10
9200574667,9200574668,1,827,2029,10
9200868064,9200868050,-14,1217,2223,10
9203141774,9203141776,2,1085,1559,10
9208362830,9208362835,5,2061,1775,10
9210328346,9210328348,2,1009,1489,10
9211224854,9211224854,0,938,1644,10
9212390778,9212390774,-4,1191,1279,10
9214848154,9214848153,-1,857,1900,10
9217001012,9217001030,18,1229,1341,10
9217263015,9217262998,-17,33886,17920,10
9221246695,9221246694,-1,1637,2380,10
9222052242,9222052249,7,6482,1742,10
9223557082,9223557079,-3,1126,1462,10
9226071014,9226071013,-1,1542,2339,10
9227845074,9227845070,-4,746,1521,10
9229251311,9229251307,-4,1443,3883,10
9229906498,9229906494,-4,1327,2580,10
9234151755,9234151753,-2,1424,2429,10
9241916394,9241916390,-4,1095,2152,10
9242467225,9242467225,0,1377,1580,10
9244818350,9244818349,-1,1490,1859,10
9247911517,9247911514,-3,1291,1517,10
9251247126,9251247128,2,702,837,10
9255850034,9255850034,0,1327,1694,10
9262041706,9262041713,7,1251,779,10
9266174060,9266174058,-2,1182,2091,10
9270428733,9270428730,-3,1436,2100,10
9270501821,9270501821,0,1500,2479,10
9270772973,9270772971,-2,1233,1814,10
9271895451,9271895450,-1,1099,2598,10
9272728518,9272728517,-1,1204,2099,10
9276729075,9276729071,-4,1556,2504,10
9281743271,9281743266,-5,719,2750,10
9284922050,9284922049,-1,1020,1758,10
9288113723,9288113736,13,16358,25878,10
9289792361,9289792359,-2,1074,2011,10
9292028861,9292028861,0,1597,2358,10
9292221643,9292221649,6,5357,2945,10
9294482828,9294482822,-6,1165,2967,10
9300663099,9300663099,0,1125,2243,10
9301031016,9301031013,-3,1274,1773,10
9302752720,9302752718,-2,1785,3047,10
9303822666,9303822663,-3,1563,3616,10
9306058653,9306058651,-2,1145,1724,10
9307037779,9307037766,-13,1044,1430,10
9309575274,9309575273,-1,814,1502,10
9309671210,9309671207,-3,1390,1706,10
9310952275,9310952274,-1,992,1470,10
9311748621,9311748621,0,1431,1681,10
9312248918,9312248915,-3,1599,2661,10
9313874902,9313874898,-4,1182,3441,10
9316126070,9316126069,-1,1309,1978,10
9329090519,9329090520,1,1847,2208,10
9330740596,9330740592,-4,1406,2595,10
9331971414,9331971398,-16,109,634,10
9334594246,9334594245,-1,1262,1819,10
9336711250,9336711249,-1,884,1227,10
9337116475,9337116480,5,1001,1636,10
9338010078,9338010078,0,988,1853,10
9339000222,9339000223,1,1128,2422,10
9344100850,9344100849,-1,1659,2401,10
9349675378,9349675376,-2,1160,1967,10
9350151679,9350151677,-2,1120,1798,10
9353018570,9353018570,0,1445,2381,10
9353358679,9353358681,2,1004,1857,10
9354548359,9354548358,-1,1442,2479,10
9359187506,9359187506,0,1214,1861,10
9360015617,9360015615,-2,1224,2577,10
9363477476,9363477475,-1,1264,2483,10
9371696032,9371696034,2,2174,1503,10
9373673509,9373673506,-3,1277,2432,10
9373814926,9373814923,-3,1531,2381,10
9374353179,9374353178,-1,1073,2054,10
9375241782,9375241779,-3,1137,2378,10
9376791686,9376791686,0,1124,1801,10
9378610893,9378610893,0,1640,2236,10
9380172816,9380172813,-3,1370,1363,10
9380931614,9380931614,0,1445,2744,10
9383994796,9383994793,-3,1705,1514,10
9386446345,9386446342,-3,1636,2414,10
9387520221,9387520219,-2,832,2061,10
9388086045,9388086047,2,941,938,10
9389750075,9389750077,2,1060,1087,10
9390186449,9390186450,1,2094,2164,10
9394695264,9394695261,-3,1220,1567,10
9395735262,9395735258,-4,1081,2252,10
9397756887,9397756886,-1,1713,2470,10
9398793814,9398793813,-1,1151,1627,10
9399129149,9399129143,-6,940,2027,10
9401281919,9401281919,0,1432,1886,10
9402321439,9402321439,0,1017,1914,10
9402531710,9402531705,-5,1236,1893,10
9405364501,9405364499,-2,1463,1758,10
9407745110,9407745110,0,1229,2316,10
9410236391,9410236392,1,1489,2286,10
9410898629,9410898628,-1,1803,2610,10
9412789971,9412789970,-1,1265,2086,10
9415692384,9415692381,-3,1041,1979,10
9420918090,9420918110,20,1328,1786,10
9421404434,9421404431,-3,1225,2510,10
9422105194,9422105193,-1,892,2128,10
9426088758,9426088754,-4,880,1971,10
9428125398,9428125398,0,1616,1724,10
9431369613,9431369616,3,2325,2070,10
9432343949,9432343947,-2,1116,1870,10
9432791521,9432791538,17,579,1077,10
9435427939,9435427938,-1,1143,1707,10
9441689709,9441689709,0,983,2216,10
9442148901,9442148900,-1,1394,1747,10
9446060796,9446060793,-3,738,1999,10
9446145970,9446145970,0,1105,1833,10
9447320078,9447320087,9,201,780,10
9448254368,9448254367,-1,1612,1732,10
9449258051,9449258048,-3,1520,1712,10
9449475674,9449475673,-1,835,1329,10
9450032450,9450032447,-3,1361,2342,10
9450414126,9450414127,1,1278,1752,10
9453893186,9453893182,-4,1144,2463,10
9455211581,9455211579,-2,1548,2479,10
9455721619,9455721618,-1,893,1230,10
9457716838,9457716838,0,1451,1619,10
9457880545,9457880546,1,1220,1679,10
9461195071,9461195069,-2,1047,2193,10
9468747426,9468747425,-1,1555,2627,10
9469974023,9469974022,-1,557,1072,10
9471582090,9471582089,-1,1401,1242,10
9472062733,9472062732,-1,1290,2517,10
9473194754,9473194753,-1,1771,3068,10
9473668667,9473668665,-2,943,2115,10
9480057239,9480057235,-4,1278,1982,10
9480739511,9480739509,-2,1344,2269,10
9490588828,9490588826,-2,1078,2318,10
9492170326,9492170326,0,1194,1775,10
9493250718,9493250720,2,11050,11295,10
9497783598,9497783596,-2,935,1912,10
9498265842,9498265842,0,1307,2080,10
9499123799,9499123797,-2,1418,2585,10
9500650800,9500650801,1,1180,1800,10
9501353362,9501353362,0,1377,1652,10
9502590863,9502590862,-1,999,1557,10
9506546757,9506546756,-1,1003,1771,10
9506753904,9506753906,2,2525,1665,10
9509050113,9509050110,-3,1291,2395,10
9510456962,9510456959,-3,1168,3102,10
9511651781,9511651779,-2,1125,1533,10
9514149494,9514149497,3,1532,2206,10
9517288678,9517288677,-1,1037,2405,10
9520529686,9520529682,-4,811,2191,10
9521190559,9521190559,0,1447,2123,10
9522156969,9522156968,-1,1038,2287,10
9524571510,9524571508,-2,883,1579,10
9528814167,9528814165,-2,869,1916,10
9529931143,9529931142,-1,888,2555,10
9538396894,9538396893,-1,1166,2523,10
9538714923,9538714922,-1,995,1965,10
9538834456,9538834454,-2,1344,2311,10
9542346913,9542346912,-1,1455,2440,10
9545942959,9545942957,-2,901,1868,10
9552182022,9552182022,0,1222,1575,10
9553105494,9553105493,-1,1169,2478,10
9553649094,9553649097,3,2471,2155,10
9554079382,9554079383,1,1277,1798,10
9554456469,9554456468,-1,625,1949,10
9555510906,9555510911,5,1652,1280,10
9563781705,9563781706,1,2089,2244,10
9564916530,9564916527,-3,1029,2011,10
9565734648,9565734647,-1,1210,1897,10
9565867376,9565867375,-1,1020,2067,10
9566804198,9566804197,-1,1130,1834,10
9566987016,9566987016,0,1247,2019,10
9567658102,9567658101,-1,924,2017,10
9571855743,9571855741,-2,920,1941,10
9573380318,9573380318,0,1015,1209,10
9573650540,9573650542,2,1329,1683,10
9574035211,9574035210,-1,1095,2052,10
9574969273,9574969274,1,1104,1724,10
9578474914,9578474909,-5,1405,3100,10
9580837830,9580837828,-2,817,1971,10
9581735365,9581735361,-4,1383,1862,10
9584291931,9584291929,-2,1396,1885,10
9587395309,9587395314,5,1885,1433,10
9589777814,9589777808,-6,1179,3350,10
9589913339,9589913322,-17,723,1735,10
9602196241,9602196241,0,1276,1783,10
9602446594,9602446592,-2,1265,3096,10
9602700714,9602700713,-1,1609,1479,10
9602985142,9602985141,-1,1811,2648,10
9604402378,9604402377,-1,1184,2652,10
9606950214,9606950213,-1,1821,2762,10
9609991762,9609991763,1,1385,1523,10
9611926001,9611925998,-3,1425,1934,10
9612192811,9612192809,-2,1316,2625,10
9612636977,9612636974,-3,1195,1998,10
9613792074,9613792074,0,1253,2135,10
9618291986,9618291986,0,1443,1440,10
9619202893,9619202893,0,1375,2222,10
9623262319,9623262318,-1,1596,1936,10
9623726602,9623726598,-4,1043,1475,10
9623939648,9623939671,23,1258,1768,10
9626290998,9626290998,0,1212,1756,10
9627384101,9627384102,1,1402,1642,10
9628858238,9628858239,1,975,1723,10
9630950786,9630950791,5,2204,2243,10
9632616285,9632616285,0,1325,1525,10
9635930494,9635930492,-2,1457,3111,10
9638340116,9638340114,-2,1575,2321,10
9645553102,9645553101,-1,1658,2359,10
9648469015,9648469014,-1,1591,2063,10
9649354158,9649354158,0,1572,1823,10
9649833642,9649833622,-20,1428,2655,10
9650768577,9650768576,-1,944,1521,10
9655099492,9655099491,-1,1379,2182,10
9658287063,9658287062,-1,1277,1642,10
9659101021,9659101018,-3,1372,1817,10
9659912678,9659912676,-2,1258,1803,10
9659977701,9659977701,0,728,1171,10
9662002457,9662002454,-3,751,1451,10
9663833110,9663833111,1,1679,1483,10
9665332158,9665332157,-1,1139,2484,10
9666978438,9666978442,4,2713,1549,10
9669397681,9669397679,-2,1094,1877,10
9669502123,9669502121,-2,1330,1641,10
9672737710,9672737707,-3,1141,1910,10
9673558353,9673558353,0,958,1812,10
9675009062,9675009061,-1,895,1278,10
9677926635,9677926634,-1,1119,1899,10
9681300630,9681300629,-1,734,1154,10
9684454274,9684454271,-3,1424,2633,10
9685549511,9685549511,0,905,1917,10
9685920102,9685920092,-10,1855,535,10
9686618675,9686618674,-1,1546,2714,10
9691287584,9691287582,-2,1392,1992,10
9696209082,9696209080,-2,1057,1621,10
9700071215,9700071214,-1,1132,2115,10
9704464042,9704464039,-3,912,1357,10
9705440792,9705440793,1,1370,1895,10
9712524039,9712524037,-2,919,1790,10
9712583160,9712583159,-1,1528,2399,10
9714715054,9714715054,0,928,1583,10
9716297047,9716297048,1,837,825,10
9718277534,9718277533,-1,775,2131,10
9718866863,9718866863,0,1755,2099,10
9721202325,9721202322,-3,1171,2361,10
9721599047,9721599055,8,3006,1777,10
9721973800,9721973799,-1,1616,2047,10
9723324406,9723324406,0,392,1037,10
9725255247,9725255245,-2,1026,2237,10
9726075761,9726075760,-1,1379,2353,10
9735621263,9735621259,-4,913,2112,10
9743122530,9743122531,1,765,1194,10
9743498250,9743498249,-1,1588,1918,10
9747315918,9747315917,-1,1221,2309,10
9748480206,9748480207,1,1605,2268,10
9749783155,9749783152,-3,1195,1885,10
9751064211,9751064230,19,551,746,10
9754895362,9754895359,-3,898,1699,10
9756035063,9756035066,3,12657,9949,10
9756860046,9756860046,0,1575,2724,10
9759444413,9759444412,-1,1206,2397,10
9760412521,9760412518,-3,1188,2370,10
9761933297,9761933302,5,1652,1289,10
9762471178,9762471178,0,1216,1698,10
9765437517,9765437517,0,1654,2103,10
9773857420,9773857421,1,1259,1944,10
9775612824,9775612827,3,2433,1639,10
9779344382,9779344380,-2,1221,1428,10
9783499746,9783499745,-1,1164,1987,10
9784796700,9784796697,-3,1482,2772,10
9789583742,9789583742,0,1381,2454,10
9789756878,9789756877,-1,1379,2275,10
9789872864,9789872861,-3,886,1923,10
9791976526,9791976526,0,1715,2928,10
9794733891,9794733890,-1,960,2345,10
9794994996,9794994994,-2,1036,1921,10
9799253491,9799253490,-1,924,1367,10
9806724191,9806724189,-2,1030,1399,10
9807099009,9807099008,-1,1334,1517,10
9808086279,9808086277,-2,1034,2446,10
9808351218,9808351239,21,1394,1720,10
9814619807,9814619805,-2,1470,2479,10
9815771634,9815771634,0,1256,1803,10
9819258802,9819258802,0,1301,1579,10
9822397918,9822397909,-9,1051,2272,10
9823117505,9823117484,-21,1261,1776,10
9823779101,9823779103,2,1596,1551,10
9824852357,9824852355,-2,1200,2416,10
9830443031,9830443026,-5,1960,4739,10
9831181867,9831181867,0,1211,1759,10
9831871859,9831871857,-2,1799,2211,10
9832797604,9832797602,-2,1441,1809,10
9833820398,9833820394,-4,1169,1452,10
9834406171,9834406172,1,1359,1854,10
9835148498,9835148496,-2,1054,1878,10
9841921630,9841921630,0,761,1449,10
9849669783,9849669782,-1,1038,2380,10
9850405738,9850405736,-2,457,1113,10
9851156086,9851156086,0,1026,2203,10
9852516711,9852516709,-2,1336,2174,10
9855143707,9855143705,-2,1483,1989,10
9856272239,9856272236,-3,727,848,10
9860725458,9860725454,-4,1062,2115,10
9862201062,9862201061,-1,1342,2665,10
9864650315,9864650313,-2,777,1607,10
9866185986,9866185986,0,1697,2261,10
9866376310,9866376310,0,1210,2008,10
9866512741,9866512742,1,1190,1422,10
9867313602,9867313603,1,3050,3664,10
9867778959,9867778959,0,947,1315,10
9867893532,9867893531,-1,879,1478,10
9869687492,9869687495,3,12233,9262,10
9870880315,9870880317,2,878,1120,10
9872676279,9872676275,-4,964,2098,10
9872817897,9872817894,-3,194,1029,10
9876322495,9876322494,-1,1300,2185,10
9880277718,9880277719,1,1418,1760,10
9881096396,9881096392,-4,1206,2497,10
9883661091,9883661091,0,1119,1494,10
9885823698,9885823700,2,1636,1764,10
9887985021,9887985021,0,749,790,10
9888926045,9888926043,-2,1184,1810,10
9892111758,9892111758,0,1053,1551,10
9892470436,9892470436,0,1445,1653,10
9894215281,9894215279,-2,1004,2168,10
9894343608,9894343590,-18,1581,2516,10
9894429074,9894429067,-7,132,863,10
9895286569,9895286568,-1,1089,1630,10
9896122521,9896122522,1,882,1156,10
9903741055,9903741054,-1,1534,1804,10
9904846388,9904846389,1,1507,1987,10
9906230046,9906230046,0,521,1075,10
9908735638,9908735638,0,949,1700,10
9911782586,9911782586,0,911,2033,10
9915072193,9915072193,0,1230,1432,10
9915755034,9915755032,-2,1786,2540,10
9920744835,9920744835,0,719,1401,10
9921446957,9921446955,-2,1358,2402,10
9922435274,9922435274,0,1115,1868,10
9923446980,9923446977,-3,1224,2378,10
9927737174,9927737169,-5,1139,1795,10
9928048350,9928048350,0,1364,1640,10
9928888020,9928888028,8,5277,1744,10
9932139851,9932139847,-4,872,1728,10
9936501638,9936501635,-3,1025,2757,10
9940522019,9940522018,-1,1098,1412,10
9944668291,9944668290,-1,850,1906,10
9945665626,9945665630,4,1597,1519,10
9946147188,9946147187,-1,1354,2037,10
9949632867,9949632865,-2,1290,1434,10
9953425614,9953425614,0,1005,2006,10
9956280165,9956280163,-2,788,2375,10
9958048452,9958048449,-3,1141,1401,10
9962395587,9962395586,-1,944,1307,10
9962757371,9962757369,-2,1357,1426,10
9963391435,9963391432,-3,680,1467,10
9966980799,9966980798,-1,1358,1916,10
9972760672,9972760674,2,1570,1740,10
9973675983,9973675980,-3,1180,3028,10
9973812913,9973812910,-3,833,2279,10
9976979449,9976979446,-3,1210,2042,10
9977095680,9977095665,-15,725,3020,10
9978422887,9978422886,-1,1252,1936,10
9983242018,9983242017,-1,1291,1761,10
9983646781,9983646777,-4,2062,5305,10
9983802885,9983802889,4,1486,1033,10
9984679900,9984679905,5,4861,2065,10
9994858634,9994858633,-1,871,1945,10
9996054663,9996054663,0,1513,1883,10
9996301397,9996301394,-3,4201,8208,10
9996805870,9996805851,-19,5007,3843,10
9999757761,9999757759,-2,1067,1639,10
10000255936,10000255934,-2,1078,1545,10
10001805268,10001805272,4,1320,1214,10
10001852337,10001852357,20,833,1588,10
10008972115,10008972114,-1,1551,2470,10
10009559049,10009559066,17,1093,1263,10
10011111355,10011111357,2,1062,1470,10
10011819975,10011819974,-1,1455,1795,10
10016147510,10016147509,-1,1252,1541,10
10017214891,10017214889,-2,621,2115,10
10017419991,10017419988,-3,915,1632,10
10020383512,10020383510,-2,1230,2199,10
10021354737,10021354738,1,1264,2457,10
10025719226,10025719223,-3,718,1245,10
10026947399,10026947398,-1,1242,1721,10
10027882368,10027882366,-2,693,1651,10
10029173669,10029173666,-3,1273,1629,10
10030196491,10030196489,-2,1177,1539,10
10031147780,10031147778,-2,1023,1494,10
10032245082,10032245080,-2,1072,1730,10
10035998051,10035998048,-3,1336,1806,10
10039954042,10039954038,-4,1097,1561,10
10042776102,10042776098,-4,962,2244,10
10043340610,10043340609,-1,1467,2096,10
10043846812,10043846813,1,1506,1413,10
10046841525,10046841517,-8,799,2142,10
10048112046,10048112046,0,1487,1836,10
10052576463,10052576464,1,1176,1488,10
10053653144,10053653142,-2,1466,2193,10
10054453337,10054453336,-1,943,1442,10
10056979366,10056979366,0,1266,1518,10
10061253647,10061253646,-1,590,1420,10
10061290878,10061290875,-3,1044,1734,10
10061558118,10061558113,-5,1693,3551,10
10067867502,10067867501,-1,1202,1948,10
10068879513,10068879513,0,1580,2873,10
10073114074,10073114074,0,1096,2072,10
10073657040,10073657041,1,1283,2141,10
10081330955,10081330950,-5,1009,1869,10
10086132530,10086132535,5,1860,1319,10
10088864146,10088864146,0,788,1372,10
10095356871,10095356870,-1,1179,1806,10
10096862139,10096862135,-4,1056,1210,10
10097874754,10097874755,1,700,1241,10
10098869067,10098869060,-7,1775,7762,10
10101702953,10101702950,-3,1036,2082,10
10112389075,10112389075,0,890,1245,10
10113725018,10113725020,2,1339,2286,10
10116402205,10116402203,-2,1389,2041,10
10116680304,10116680302,-2,1434,1906,10
10121539878,10121539876,-2,1511,1904,10
10121774763,10121774754,-9,1380,2400,10
10126171579,10126171580,1,1460,1773,10
10126586479,10126586477,-2,1200,2317,10
10129858151,10129858151,0,1758,2533,10
10131075751,10131075746,-5,851,2261,10
10134514593,10134514587,-6,1190,4706,10
10135587174,10135587172,-2,955,1580,10
10136127490,10136127490,0,1639,2570,10
10138537003,10138537002,-1,1466,2246,10
10138801990,10138801990,0,1371,1968,10
10141111186,10141111186,0,806,1548,10
10141484872,10141484875,3,2119,2037,10
10143564301,10143564299,-2,1022,1529,10
10143620931,10143620934,3,2903,2524,10
10144101078,10144101077,-1,858,1365,10
10148457537,10148457537,0,1175,1930,10
10155635331,10155635329,-2,1014,1653,10
10159669915,10159669912,-3,1239,2061,10
10169391262,10169391266,4,24389,23566,10
10169769349,10169769346,-3,1743,3323,10
10170970197,10170970196,-1,1439,2739,10
10172418283,10172418283,0,888,1728,10
10174084462,10174084461,-1,1394,2217,10
10174499489,10174499502,13,261,600,10
10174905709,10174905710,1,2507,1790,10
10175038144,10175038142,-2,1236,1933,10
10175072451,10175072450,-1,1324,2585,10
10175853330,10175853329,-1,1114,2518,10
10180145025,10180145026,1,1129,1738,10
10182385751,10182385770,19,524,1182,10
10187844566,10187844565,-1,1302,1599,10
10188638173,10188638175,2,1331,1420,10
10190016909,10190016906,-3,990,2209,10
10190995243,10190995239,-4,1632,2525,10
10197562926,10197562924,-2,1670,3075,10
10206106396,10206106394,-2,1476,2380,10
10209993545,10209993542,-3,1026,3805,10
10210415066,10210415065,-1,763,2211,10
10212453085,10212453082,-3,818,1698,10
10213854215,10213854214,-1,730,1865,10
10218813366,10218813367,1,1256,1625,10
10220517110,10220517109,-1,1399,1583,10
10223580373,10223580370,-3,1194,2547,10
10224497918,10224497915,-3,1113,1648,10
10226253781,10226253779,-2,2221,2415,10
10229699920,10229699938,18,1235,2290,10
10229879651,10229879651,0,1222,1706,10
10234908446,10234908446,0,533,1645,10
10234990832,10234990831,-1,795,1581,10
10235639075,10235639073,-2,1822,2624,10
10240332270,10240332269,-1,1312,1863,10
10240865260,10240865262,2,1707,1692,10
10243793167,10243793167,0,1008,1806,10
10244356148,10244356148,0,1456,1645,10
10245382321,10245382318,-3,1420,1525,10
10246002864,10246002858,-6,789,1185,10
10247334704,10247334711,7,9812,24564,10
10249210113,10249210121,8,16443,10323,10
10252259961,10252259962,1,1651,2087,10
10252800722,10252800722,0,1255,2363,10
10256282291,10256282290,-1,1170,2367,10
10258000616,10258000613,-3,910,2016,10
10264509665,10264509672,7,5454,2022,10
10275000973,10275000986,13,759,1503,10
10278020209,10278020210,1,1031,1599,10
10284233459,10284233458,-1,1320,1683,10
10284739647,10284739641,-6,2354,7789,10
10287090934,10287090931,-3,1498,3017,10
10291944702,10291944701,-1,1203,2185,10
10293483637,10293483634,-3,1245,1993,10
10306253521,10306253520,-1,1498,1801,10
10306595617,10306595614,-3,1410,2943,10
10309194170,10309194169,-1,1539,1627,10
10312190993,10312190986,-7,746,4179,10
10312989571,10312989573,2,1103,1624,10
10313046335,10313046332,-3,1329,1863,10
10316321993,10316321991,-2,769,1832,10
10318703432,10318703434,2,2972,3439,10
10320434263,10320434259,-4,957,2476,10
10321913383,10321913381,-2,1077,3257,10
10322905303,10322905301,-2,2684,5303,10
10329439859,10329439858,-1,1082,1667,10
10329973160,10329973177,17,812,1821,10
10331610764,10331610763,-1,1489,2130,10
10337328750,10337328749,-1,1597,2454,10
10338589285,10338589285,0,1611,3054,10
10339270186,10339270184,-2,1339,2537,10
10340333152,10340333151,-1,1324,2350,10
10342221880,10342221873,-7,3766,12157,10
10344441457,10344441452,-5,2046,9779,10
10354960155,10354960152,-3,1058,1779,10
10356811341,10356811341,0,1577,2587,10
10358672795,10358672798,3,1397,1693,10
10358933909,10358933907,-2,1539,2159,10
10358979417,10358979415,-2,1588,2706,10
10363838678,10363838674,-4,1068,3751,10
10364036721,10364036718,-3,1163,2872,10
10364541917,10364541917,0,751,2216,10
10364919410,10364919422,12,251,761,10
10365657011,10365657010,-1,967,1389,10
10368745043,10368745043,0,1025,2118,10
10369932131,10369932130,-1,1328,1906,10
10370254370,10370254370,0,793,1445,10
10371978042,10371978041,-1,1392,1631,10
10372262970,10372262981,11,25,742,10
10374978998,10374979000,2,1013,1148,10
10377535459,10377535459,0,1801,1965,10
10379623449,10379623448,-1,1382,2787,10
10381245241,10381245241,0,907,1636,10
10384561310,10384561309,-1,992,1946,10
10386883502,10386883501,-1,1481,2820,10
10387226023,10387226019,-4,938,1640,10
10388669171,10388669169,-2,1096,1599,10
10389100327,10389100326,-1,1196,2607,10
10391650211,10391650206,-5,911,2056,10
10392871175,10392871175,0,1176,1984,10
10393125522,10393125517,-5,922,3105,10
10393815524,10393815526,2,1428,1991,10
10394117526,10394117525,-1,1236,1868,10
10401546680,10401546677,-3,994,2089,10
10402309984,10402309981,-3,636,1531,10
10406251118,10406251122,4,1797,1323,10
10409849246,10409849246,0,1229,1851,10
10412730961,10412730958,-3,1123,1803,10
10415024710,10415024714,4,1320,1258,10
10415568862,10415568859,-3,1259,3639,10
10422166087,10422166085,-2,1262,1994,10
10427386223,10427386221,-2,1542,2753,10
10429065103,10429065098,-5,1917,4506,10
10431270183,10431270182,-1,1316,1649,10
10433512785,10433512785,0,1746,2317,10
10433960034,10433960032,-2,1791,1801,10
10435648723,10435648723,0,1694,2364,10
10436980402,10436980403,1,1067,1864,10
10440145791,10440145785,-6,2104,5849,10
10441423340,10441423335,-5,1398,3168,10
10443107942,10443107939,-3,670,2112,10
10443553899,10443553896,-3,1369,2245,10
10443845159,10443845158,-1,1236,1708,10
10445431798,10445431797,-1,1324,2528,10
10449706175,10449706173,-2,1004,1661,10
10450619454,10450619454,0,1493,2246,10
10451698311,10451698309,-2,1289,1472,10
10456012077,10456012074,-3,1096,2046,10
10458940762,10458940760,-2,1239,2050,10
10459766594,10459766594,0,1448,2368,10
10461402906,10461402912,6,2677,1810,10
10465613494,10465613493,-1,702,1384,10
10468018002,10468018001,-1,1256,1832,10
10472135887,10472135886,-1,1105,1785,10
10472685962,10472685963,1,1238,2123,10
10479533019,10479533017,-2,1446,1713,10
10479721600,10479721598,-2,1497,1728,10
10481601389,10481601387,-2,825,1726,10
10482785386,10482785385,-1,1369,2241,10
10488380238,10488380244,6,4204,2156,10
10488604578,10488604584,6,5077,2512,10
10489609147,10489609146,-1,1168,1826,10
10489936533,10489936533,0,1331,1933,10
10492711958,10492711958,0,1424,1574,10
10494705802,10494705800,-2,1468,3081,10
10504689109,10504689105,-4,2028,4625,10
10505396538,10505396537,-1,1160,1994,10
10507142144,10507142142,-2,1196,2246,10
10508703664,10508703662,-2,1621,2876,10
10510035599,10510035601,2,918,1777,10
10510626294,10510626290,-4,742,1532,10
10510858405,10510858407,2,1327,1410,10
10513116578,10513116579,1,1103,1812,10
10519276509,10519276506,-3,1310,1994,10
10522114128,10522114131,3,1496,1963,10
10524368451,10524368451,0,2390,3473,10
10526822732,10526822751,19,1274,2091,10
10527153057,10527153050,-7,1130,2700,10
10528137903,10528137881,-22,2142,1414,10
10528268828,10528268835,7,1720,861,10
10529143591,10529143590,-1,1239,2675,10
10529455179,10529455198,19,737,1615,10
10533588839,10533588839,0,1853,1654,10
10533667431,10533667428,-3,1086,2276,10
10535481742,10535481738,-4,1734,2764,10
10536024181,10536024178,-3,2378,3632,10
10536818084,10536818082,-2,1264,2065,10
10537125518,10537125517,-1,1939,2547,10
10537727857,10537727854,-3,1205,1763,10
10539358622,10539358620,-2,998,1293,10
10540776650,10540776650,0,1431,2542,10
10549758918,10549758915,-3,1022,2071,10
10550855636,10550855635,-1,1181,2255,10
10552189654,10552189652,-2,1328,2285,10
10553894097,10553894098,1,1579,1563,10
10555635389,10555635393,4,21649,23903,10
10555756148,10555756146,-2,1121,1375,10
10563741334,10563741349,15,1100,1474,10
10567170606,10567170605,-1,851,1723,10
10571022298,10571022306,8,3110,1453,10
10571644472,10571644475,3,16962,1865,10
10573585211,10573585209,-2,1429,1817,10
10574601953,10574601954,1,1226,1516,10
10578244914,10578244912,-2,1266,2046,10
10581929950,10581929951,1,2606,2151,10
10584764851,10584764851,0,1148,1335,10
10588732538,10588732532,-6,32712,11383,10
10592079767,10592079767,0,1337,2001,10
10594552934,10594552936,2,2926,2148,10
10594598222,10594598220,-2,1135,2066,10
10595804714,10595804713,-1,1226,2867,10
10596322173,10596322174,1,1489,2717,10
10599287990,10599287990,0,1480,2876,10
10603077458,10603077452,-6,1530,2551,10
10604064209,10604064206,-3,1158,2500,10
10604123562,10604123542,-20,938,1915,10
10605388829,10605388829,0,811,1393,10
10606576155,10606576153,-2,1013,1521,10
10609527967,10609527963,-4,1083,2366,10
10610173189,10610173186,-3,1011,2248,10
10611998106,10611998103,-3,1558,1814,10
10612084075,10612084074,-1,1379,2157,10
10612236727,10612236729,2,1198,1477,10
10614753363,10614753363,0,943,1365,10
10623137971,10623137970,-1,2342,4003,10
10628151587,10628151585,-2,1185,2049,10
10633750797,10633750797,0,1079,1909,10
10634498971,10634498971,0,1003,1581,10
10637746694,10637746694,0,1201,2065,10
10642124307,10642124305,-2,1565,2747,10
10645349129,10645349126,-3,1414,2592,10
10652812858,10652812857,-1,1180,1460,10
10653236306,10653236306,0,1449,2369,10
10654567331,10654567329,-2,1547,2681,10
10654971801,10654971802,1,1521,1606,10
10655010819,10655010817,-2,1481,1726,10
10657060017,10657060014,-3,925,2288,10
10658127846,10658127839,-7,1705,6150,10
10658213075,10658213074,-1,1395,2354,10
10658813358,10658813356,-2,780,1739,10
10662481541,10662481539,-2,1315,2368,10
10663775175,10663775173,-2,1234,2146,10
10666990646,10666990643,-3,925,2348,10
10671780706,10671780706,0,953,1741,10
10674003981,10674003978,-3,1049,2228,10
10679553565,10679553562,-3,1642,2515,10
10682194841,10682194841,0,1341,2395,10
10683188030,10683188028,-2,1043,1769,10
10684579809,10684579808,-1,914,1896,10
10688588620,10688588621,1,1021,1490,10
10690190510,10690190510,0,1012,1777,10
10692826780,10692826785,5,2706,1351,10
10693388759,10693388759,0,602,1605,10
10702700951,10702700956,5,13266,23990,10
10703121741,10703121740,-1,1523,2367,10
10707950011,10707950002,-9,1140,3460,10
10710111468,10710111466,-2,1386,2680,10
10711193883,10711193882,-1,1539,2580,10
10711998347,10711998344,-3,1210,2058,10
10712905935,10712905934,-1,1423,2097,10
10713886785,10713886785,0,1425,2188,10
10715411667,10715411665,-2,1134,1757,10
10715854575,10715854573,-2,1039,2840,10
10716719122,10716719105,-17,10,1440,10
10721165277,10721165275,-2,1285,1900,10
10721734966,10721734965,-1,1421,2024,10
10725221277,10725221275,-2,1108,2195,10
10726737578,10726737574,-4,869,2654,10
10726945198,10726945197,-1,622,1384,10
10733546303,10733546295,-8,1512,7540,10
10733910934,10733910930,-4,1151,1380,10
10734682756,10734682755,-1,1504,2242,10
10736443463,10736443463,0,1227,1522,10
10737013269,10737013274,5,2294,1383,10
10739185977,10739185982,5,15089,9138,10
10743251938,10743251939,1,1539,2050,10
10747957403,10747957403,0,1614,2042,10
10748480565,10748480550,-15,810,1353,10
10750284857,10750284854,-3,1603,2535,10
10757154633,10757154631,-2,1877,1642,10
10759383025,10759383022,-3,906,1707,10
10760086873,10760086894,21,1026,1519,10
10762759599,10762759598,-1,645,2152,10
10765757014,10765757014,0,1245,2183,10
10766358718,10766358717,-1,1403,1747,10
10768711114,10768711114,0,1308,2401,10
10769951220,10769951218,-2,1192,1875,10
10771981412,10771981410,-2,1211,2172,10
10772592919,10772592917,-2,1634,3135,10
10773304523,10773304524,1,3217,3432,10
10776338579,10776338578,-1,835,2642,10
10776426698,10776426706,8,2747,1336,10
10779436041,10779436046,5,2935,1365,10
10783642554,10783642555,1,1161,2688,10
10787587880,10787587879,-1,1442,3226,10
10788962032,10788962030,-2,977,1611,10
10790115190,10790115195,5,2459,1658,10
10791404609,10791404607,-2,1154,1657,10
10792506566,10792506564,-2,894,2353,10
10793383623,10793383629,6,2462,1108,10
10795354200,10795354198,-2,1490,3044,10
10800289602,10800289597,-5,1015,2928,10
10801693414,10801693413,-1,1075,1443,10
10807766381,10807766382,1,1687,1956,10
10810696433,10810696431,-2,1165,1460,10
10815997358,10815997361,3,1309,1295,10
10818810576,10818810574,-2,1670,2457,10
10822791121,10822791118,-3,1137,2883,10
10823070124,10823070137,13,308,1115,10
10824226890,10824226890,0,1325,1609,10
10827319030,10827319033,3,897,1368,10
10827814005,10827814002,-3,995,1931,10
10834647154,10834647154,0,1459,1925,10
10840000355,10840000351,-4,927,1692,10
10840486646,10840486644,-2,1347,2388,10
10848666838,10848666837,-1,1052,2088,10
10851945751,10851945751,0,1480,2243,10
10852385566,10852385566,0,962,1956,10
10854660098,10854660097,-1,1082,1734,10
10855221673,10855221662,-11,1147,2869,10
10857278214,10857278214,0,874,2196,10
10859056312,10859056312,0,1929,3263,10
10861384734,10861384734,0,1144,1527,10
10863375249,10863375246,-3,1397,2509,10
10865394671,10865394668,-3,1276,1926,10
10866203256,10866203258,2,986,2310,10
10868267102,10868267100,-2,969,2004,10
10868716267,10868716266,-1,1153,2065,10
10869406423,10869406421,-2,986,1718,10
10877027528,10877027526,-2,947,1834,10
10877778122,10877778121,-1,1477,2124,10
10877997231,10877997226,-5,1314,1978,10
10885055098,10885055099,1,1485,2043,10
10885946168,10885946167,-1,1486,1755,10
10886899723,10886899721,-2,1216,3054,10
10888596006,10888596006,0,1667,1780,10
10892940678,10892940677,-1,1381,1765,10
10892979959,10892979957,-2,1238,2161,10
10897269483,10897269480,-3,1063,2412,10
10897576659,10897576646,-13,212,1696,10
10898389834,10898389834,0,1443,1952,10
10908449350,10908449350,0,1303,2011,10
10912635218,10912635216,-2,1046,2762,10
10915420698,10915420695,-3,1390,1961,10
10916722227,10916722225,-2,936,1022,10
10917255942,10917255943,1,950,1527,10
10918997314,10918997314,0,1549,2167,10
10919175925,10919175923,-2,1181,1651,10
10922443255,10922443255,0,970,1989,10
10922774382,10922774379,-3,858,1252,10
10925295250,10925295250,0,979,1271,10
10926719772,10926719778,6,120,890,10
10927503971,10927503967,-4,2531,6487,10
10933523305,10933523303,-2,926,1618,10
10936486452,10936486450,-2,1361,2038,10
10937470106,10937470084,-22,1223,1929,10
10937559765,10937559763,-2,1072,1937,10
10941242066,10941242065,-1,1314,1832,10
10941577583,10941577581,-2,962,1578,10
10941860542,10941860535,-7,1202,4663,10
10942810493,10942810494,1,1943,2465,10
10946285005,10946285002,-3,1399,2104,10
10947336069,10947336068,-1,1586,1467,10
10949194766,10949194765,-1,1393,1949,10
10950518972,10950518970,-2,1081,1876,10
10950690834,10950690835,1,1518,1971,10
10957615654,10957615654,0,1343,1639,10
10963177897,10963177896,-1,1677,2695,10
10965521218,10965521217,-1,1039,2167,10
10967743066,10967743065,-1,1350,1306,10
10969521526,10969521523,-3,881,2189,10
10970713337,10970713335,-2,1170,2155,10
10972235391,10972235389,-2,1194,1991,10
10975895294,10975895293,-1,1602,2216,10
10976658381,10976658379,-2,1632,1892,10
10978097815,10978097813,-2,1612,1619,10
10979491305,10979491303,-2,1042,1610,10
10980784228,10980784222,-6,1255,2537,10
10982604534,10982604530,-4,1304,2073,10
10983361781,10983361780,-1,1632,1571,10
10984818652,10984818651,-1,1342,1450,10
10985103948,10985103948,0,1406,2236,10
10985621111,10985621109,-2,901,2370,10
10991568400,10991568397,-3,1188,2813,10
10993966127,10993966124,-3,1749,2144,10
10996276279,10996276278,-1,1075,1886,10
10999232324,10999232325,1,1215,1957,10
10999283419,10999283418,-1,1326,2712,10
11002276780,11002276791,11,11852,38732,10
11003133587,11003133586,-1,744,1306,10
11003952607,11003952606,-1,1566,2650,10
11005513583,11005513581,-2,916,1909,10
11005811939,11005811938,-1,1344,1309,10
11009172873,11009172873,0,1063,1364,10
11014724718,11014724716,-2,1119,2049,10
11018093926,11018093926,0,1457,2857,10
11033142016,11033142017,1,1349,1889,10
11038189337,11038189334,-3,1653,2507,10
11042746918,11042746917,-1,906,1060,10
11048218791,11048218791,0,1432,2256,10
11048355137,11048355134,-3,1618,1995,10
11050004789,11050004789,0,1010,1021,10
11051453959,11051453959,0,714,1381,10
11056519269,11056519269,0,1051,2257,10
11061526958,11061526962,4,1742,1054,10
11062910867,11062910864,-3,1203,2154,10
11063792122,11063792119,-3,1356,3323,10
11064574436,11064574434,-2,1274,2629,10
11066380238,11066380238,0,1196,1761,10
11072070382,11072070387,5,934,1036,10
11073127853,11073127867,14,2459,1295,10
11074260663,11074260662,-1,1078,2408,10
11074974217,11074974215,-2,1944,2583,10
11075655993,11075655991,-2,998,1707,10
11075698832,11075698827,-5,988,1142,10
11076850367,11076850364,-3,1157,2770,10
11079038027,11079038025,-2,1650,2056,10
11080795200,11080795199,-1,1119,1321,10
11084983914,11084983912,-2,1452,2357,10
11087685669,11087685669,0,1114,1385,10
11087759086,11087759086,0,803,2117,10
11088137361,11088137360,-1,1355,2585,10
11090231469,11090231488,19,725,758,10
11091753735,11091753734,-1,1070,1337,10
11092002910,11092002910,0,1775,2066,10
11092192195,11092192206,11,122,694,10
11096012491,11096012491,0,1423,2400,10
11097432129,11097432128,-1,1811,2096,10
11098675601,11098675586,-15,2903,1366,10
11098758671,11098758670,-1,1335,1637,10
11099092150,11099092150,0,1081,1858,10
11101111907,11101111906,-1,954,1602,10
11103203265,11103203265,0,1288,2121,10
11103739060,11103739058,-2,968,2021,10
11104252845,11104252842,-3,1592,1892,10
11107282955,11107282954,-1,1322,2962,10
11107644193,11107644189,-4,1217,3028,10
11117824307,11117824309,2,1240,1668,10
11118541505,11118541502,-3,1234,1755,10
11120039015,11120039015,0,1053,1806,10
11121964235,11121964234,-1,1067,2095,10
11123075452,11123075450,-2,1034,1904,10
11123635438,11123635433,-5,928,2170,10
11125597348,11125597348,0,1055,1997,10
11128743522,11128743522,0,1444,1604,10
11128976667,11128976666,-1,1091,1060,10
11132672094,11132672095,1,1570,1455,10
11132722142,11132722142,0,563,2226,10
11132849507,11132849501,-6,1547,2199,10
11133205898,11133205876,-22,1236,2856,10
11134462391,11134462386,-5,1224,5189,10
11146280574,11146280574,0,2732,3790,10
11150772851,11150772849,-2,998,1725,10
11153890746,11153890745,-1,588,1545,10
11155450703,11155450706,3,964,921,10
11160620755,11160620753,-2,930,1165,10
11162935530,11162935525,-5,1147,1605,10
11166366582,11166366582,0,1281,2087,10
11168188993,11168188991,-2,1203,2499,10
11169027241,11169027240,-1,1104,1518,10
11170824859,11170824857,-2,1405,2516,10
11173027746,11173027746,0,1084,1734,10
11173542438,11173542437,-1,1333,1738,10
11174458661,11174458659,-2,1332,1122,10
11178595052,11178595047,-5,565,1142,10
11181158324,11181158322,-2,1161,2007,10
11182586622,11182586619,-3,1265,2421,10
11184944557,11184944557,0,1061,1798,10
11186381299,11186381295,-4,1532,2022,10
11186643491,11186643480,-11,637,277,10
11187115208,11187115227,19,1317,1388,10
11188051318,11188051316,-2,984,2052,10
11194680910,11194680905,-5,1185,3787,10
11194967550,11194967549,-1,2130,2345,10
11196226917,11196226915,-2,992,2241,10
11196338487,11196338486,-1,1272,2688,10
11197985843,11197985843,0,1190,1617,10
11200083675,11200083674,-1,1129,1182,10
11200524096,11200524108,12,108,6866,10
11202582965,11202582962,-3,1359,2004,10
11211996990,11211996987,-3,1364,2235,10
11214586624,11214586622,-2,1150,2175,10
11215301523,11215301523,0,1431,2479,10
11217480894,11217480901,7,3630,1583,10
11218538483,11218538478,-5,1364,2779,10
11218606766,11218606766,0,1200,2027,10
11219405242,11219405241,-1,1410,2200,10
11221824975,11221824974,-1,1182,1932,10
11222289367,11222289365,-2,1595,2910,10
11224273832,11224273831,-1,998,1806,10
11226646927,11226646926,-1,1223,2843,10
11228027717,11228027712,-5,1199,3343,10
11231866535,11231866536,1,1102,887,10
11234165154,11234165154,0,953,1514,10
11237105113,11237105124,11,12140,48765,10
11238928487,11238928487,0,1376,1923,10
11239236273,11239236270,-3,1489,2436,10
11240480013,11240480013,0,1171,1325,10
11247819861,11247819859,-2,1427,1659,10
11248809368,11248809368,0,1580,2253,10
11254907758,11254907757,-1,1254,2082,10
11258903075,11258903074,-1,1022,1765,10
11262028141,11262028142,1,1552,926,10
11267834810,11267834828,18,876,1378,10
11268991604,11268991603,-1,1027,1994,10
11269093099,11269093116,17,401,1175,10
11273536723,11273536722,-1,1408,2326,10
11278039347,11278039347,0,1605,2437,10
11280083104,11280083105,1,1146,2718,10
11280792876,11280792875,-1,1430,2397,10
11280998506,11280998506,0,770,1208,10
11282533756,11282533755,-1,1438,1791,10
11283115069,11283115069,0,1514,1916,10
11285803446,11285803448,2,1201,1286,10
11288520240,11288520240,0,984,1164,10
11292308950,11292308948,-2,1270,1927,10
11292851313,11292851311,-2,2049,1556,10
11294356311,11294356310,-1,1276,1792,10
11295340194,11295340194,0,1091,2314,10
11295430093,11295430093,0,1742,1406,10
11297829402,11297829398,-4,1293,2292,10
11298026237,11298026235,-2,1349,1991,10
11298913515,11298913514,-1,1253,1876,10
11300381715,11300381715,0,954,2051,10
11300443513,11300443497,-16,1158,2139,10
11303014101,11303014102,1,1075,1360,10
11304855161,11304855159,-2,1463,2148,10
11305342447,11305342451,4,2179,2186,10
11307332226,11307332226,0,1003,1523,10
11310867453,11310867451,-2,925,1556,10
11311330778,11311330777,-1,1241,2928,10
11311527026,11311527004,-22,1397,2425,10
11314752222,11314752221,-1,1064,2318,10
11319128454,11319128452,-2,960,1526,10
11320814468,11320814470,2,1879,1663,10
11323998242,11323998241,-1,1276,1874,10
11325313270,11325313269,-1,1367,1998,10
11327872162,11327872160,-2,1165,1993,10
11331688181,11331688179,-2,1052,1052,10
11335327766,11335327766,0,1147,1613,10
11337467346,11337467346,0,1388,1325,10
11338248361,11338248357,-4,1202,2533,10
11339573624,11339573623,-1,802,1595,10
11341644881,11341644879,-2,1391,2647,10
11345751554,11345751558,4,3521,1807,10
11346880502,11346880503,1,1495,1628,10
11350129056,11350129053,-3,809,2470,10
11351598679,11351598678,-1,1253,2055,10
11352693659,11352693658,-1,1155,2054,10
11353330853,11353330855,2,1520,1422,10
11353496450,11353496451,1,913,1155,10
11355377702,11355377702,0,1188,1659,10
11365678010,11365678008,-2,1215,2384,10
11367024156,11367024154,-2,1674,2409,10
11367482298,11367482292,-6,1341,3093,10
11369808538,11369808535,-3,1227,2083,10
11370643611,11370643606,-5,827,1535,10
11370981315,11370981313,-2,1061,3175,10
11376065753,11376065754,1,1737,1403,10
11386490154,11386490152,-2,1719,2655,10
11390780793,11390780791,-2,1472,1939,10
11392815314,11392815313,-1,1475,1433,10
11393599811,11393599809,-2,986,1687,10
11394584598,11394584597,-1,1399,2390,10
11400248047,11400248045,-2,1229,2428,10
11401220133,11401220137,4,1702,1149,10
11401630718,11401630716,-2,1363,1556,10
11401915426,11401915426,0,1017,1306,10
11402714562,11402714558,-4,1284,1962,10
11403234843,11403234842,-1,1974,3249,10
11404264566,11404264567,1,1048,2507,10
11406496099,11406496092,-7,1928,7792,10
11407980459,11407980457,-2,699,2199,10
11409090176,11409090173,-3,1399,2279,10
11409482620,11409482618,-2,1354,2081,10
11413636987,11413636989,2,582,895,10
11414673118,11414673117,-1,1615,2685,10
11414711594,11414711592,-2,1115,2032,10
11416324871,11416324870,-1,1301,2047,10
11418171504,11418171504,0,1076,1802,10
11420818920,11420818918,-2,1474,1694,10
11433863926,11433863925,-1,1332,1927,10
11444347587,11444347585,-2,1265,1803,10
11451292930,11451292928,-2,993,2426,10
11452013793,11452013793,0,1306,1357,10
11455347405,11455347403,-2,1068,2201,10
11455781711,11455781711,0,1341,1462,10
11458008137,11458008134,-3,1543,3404,10
11460455025,11460455022,-3,1140,1728,10
11460669303,11460669304,1,1210,1938,10
11462298979,11462298978,-1,1455,2094,10
11462683710,11462683712,2,1109,1744,10
11467431530,11467431529,-1,753,1028,10
11469156294,11469156298,4,7900,5127,10
11470284670,11470284670,0,1054,1552,10
11476292034,11476292029,-5,924,1912,10
11477047154,11477047156,2,1452,1762,10
11477431738,11477431737,-1,907,1666,10
11480022942,11480022941,-1,1285,1942,10
11480407174,11480407174,0,1483,2099,10
11480500566,11480500570,4,1648,1157,10
11480952666,11480952665,-1,1177,1763,10
11486243554,11486243554,0,1278,2062,10
11488292290,11488292287,-3,1391,2354,10
11492495361,11492495361,0,1501,2093,10
11492897298,11492897298,0,1400,2282,10
11493407132,11493407150,18,910,2227,10
11494343962,11494343962,0,1105,2256,10
11495478088,11495478087,-1,1126,1642,10
11497086533,11497086519,-14,897,1760,10
11498438170,11498438170,0,778,1221,10
11498924870,11498924868,-2,1424,2592,10
11501369602,11501369603,1,2178,2583,10
11502169935,11502169933,-2,1223,1718,10
11503834565,11503834563,-2,1093,2357,10
11506980792,11506980790,-2,856,1866,10
11509750891,11509750890,-1,1223,1768,10
11509897910,11509897909,-1,1138,1577,10
11516451226,11516451223,-3,1822,4120,10
11520181384,11520181386,2,952,1162,10
11521273922,11521273919,-3,1452,1703,10
11525654306,11525654305,-1,1099,1461,10
11526399170,11526399158,-12,1143,2310,10
11528491554,11528491554,0,1248,2410,10
11530007054,11530007052,-2,1202,1443,10
11531324393,11531324391,-2,1587,2459,10
11531423107,11531423104,-3,1,819,10
11535386306,11535386306,0,1405,1928,10
11536005849,11536005847,-2,1045,1898,10
11538488346,11538488342,-4,1225,2060,10
11541351251,11541351250,-1,709,2002,10
11544571760,11544571758,-2,1306,2538,10
11546106681,11546106679,-2,1597,2557,10
11546186143,11546186143,0,1208,1247,10
11547524771,11547524775,4,1194,1213,10
11549860237,11549860234,-3,936,1885,10
11551759573,11551759572,-1,1293,2013,10
11553360582,11553360582,0,1598,2206,10
11558617034,11558617034,0,1156,2043,10
11560210986,11560210985,-1,1561,2403,10
11561604498,11561604511,13,123,632,10
11562699587,11562699585,-2,1437,2155,10
11569848351,11569848350,-1,903,1120,10
11579787922,11579787919,-3,1250,1116,10
11580042158,11580042157,-1,917,1420,10
11583935626,11583935627,1,1618,2230,10
11586787473,11586787473,0,1274,1919,10
11590136993,11590136994,1,2023,1339,10
11596853571,11596853563,-8,900,4649,10
11603527854,11603527853,-1,1728,1969,10
11604194759,11604194757,-2,992,1688,10
11609192766,11609192766,0,1436,3390,10
11610534938,11610534938,0,1471,1701,10
11615360615,11615360614,-1,1377,2198,10
11616093686,11616093685,-1,796,1692,10
11618782223,11618782221,-2,1581,2507,10
11626141094,11626141094,0,1626,1623,10
11628981834,11628981841,7,2725,1152,10
11629191247,11629191248,1,1055,1968,10
11633942737,11633942733,-4,1211,1616,10
11639752562,11639752561,-1,1225,1598,10
11640261033,11640261030,-3,1602,2057,10
11640678451,11640678451,0,1043,1469,10
11641741906,11641741905,-1,1663,1469,10
11644407063,11644407057,-6,1251,5866,10
11644619554,11644619554,0,1234,2091,10
11645068706,11645068706,0,956,1965,10
11648461098,11648461097,-1,929,1639,10
11648950628,11648950615,-13,1360,1914,10
11653107626,11653107626,0,1297,1854,10
11653624665,11653624667,2,1874,1897,10
11654870269,11654870266,-3,1315,2367,10
11658854137,11658854134,-3,855,1006,10
11665328771,11665328774,3,1325,1001,10
11671166231,11671166230,-1,1636,2290,10
11678776415,11678776414,-1,1030,1648,10
11680963327,11680963325,-2,762,1020,10
11686731601,11686731599,-2,832,1672,10
11687736169,11687736190,21,345,3698,10
11690487776,11690487775,-1,1723,2585,10
11697756423,11697756422,-1,1748,2391,10
11699253339,11699253337,-2,1037,2241,10
11700677099,11700677098,-1,863,2299,10
11702153891,11702153891,0,1164,1825,10
11702992427,11702992426,-1,1053,1488,10
11703611491,11703611490,-1,764,1513,10
11704372923,11704372922,-1,1543,2243,10
11705640700,11705640690,-10,945,3667,10
11705910587,11705910586,-1,1250,1514,10
11705978995,11705978991,-4,1342,1992,10
11708251434,11708251433,-1,821,2184,10
11712919275,11712919274,-1,1175,2022,10
11713800906,11713800903,-3,1316,1940,10
11714723155,11714723175,20,669,2834,10
11723683383,11723683380,-3,1075,2478,10
11724590488,11724590498,10,255,764,10
11727717374,11727717372,-2,1715,2249,10
11731525918,11731525917,-1,1220,1687,10
11736088411,11736088409,-2,1342,1845,10
11736191825,11736191822,-3,319,2263,10
11737446056,11737446053,-3,1311,1570,10
11741167942,11741167943,1,1182,1318,10
11741547561,11741547558,-3,1089,1905,10
11742829411,11742829416,5,3181,1661,10
11746273426,11746273413,-13,823,1624,10
11749024771,11749024768,-3,1709,2152,10
11750914622,11750914620,-2,1400,2091,10
11751783482,11751783480,-2,1593,2568,10
11757390261,11757390261,0,1250,2083,10
11759261862,11759261864,2,1541,1482,10
11759824851,11759824851,0,1142,1070,10
11760704432,11760704431,-1,1341,1850,10
11763114951,11763114950,-1,1281,2231,10
11774059281,11774059278,-3,963,1712,10
11777589434,11777589433,-1,956,1220,10
11779599632,11779599631,-1,1684,1621,10
11787400490,11787400489,-1,1111,1896,10
11796382020,11796382020,0,1154,1609,10
11797584265,11797584263,-2,1378,1562,10
11798760527,11798760526,-1,1119,1667,10
11801682250,11801682246,-4,946,1096,10
11803681358,11803681356,-2,1320,2542,10
11807972002,11807972001,-1,1106,2517,10
11809834358,11809834358,0,1386,1596,10
11810505332,11810505331,-1,1840,2411,10
11815023325,11815023308,-17,1635,1851,10
11816097171,11816097169,-2,883,2123,10
11822218093,11822218093,0,945,984,10
11823561834,11823561833,-1,991,2117,10
11826359534,11826359531,-3,1431,2213,10
11826519425,11826519422,-3,473,928,10
11827346953,11827346951,-2,1271,1738,10
11828814138,11828814139,1,1093,1761,10
11829085368,11829085366,-2,1109,2048,10
11831952870,11831952869,-1,1360,1835,10
11833614886,11833614886,0,1148,2194,10
11833796021,11833796019,-2,1367,1433,10
11837729971,11837729970,-1,1234,2094,10
11838585490,11838585488,-2,1166,2717,10
11839067482,11839067461,-21,947,1951,10
11840622949,11840622945,-4,1422,3329,10
11842234363,11842234362,-1,1337,2018,10
11842344901,11842344901,0,736,1587,10
11843948554,11843948555,1,2176,2280,10
11848505729,11848505730,1,1773,2352,10
11849096739,11849096738,-1,1049,2227,10
11850728678,11850728676,-2,1417,2433,10
11853392322,11853392322,0,1288,1906,10
11855314493,11855314491,-2,923,1197,10
11857063377,11857063377,0,1247,2154,10
11858394814,11858394814,0,1355,1318,10
11860824995,11860824994,-1,1020,1662,10
11863082423,11863082419,-4,20826,2731,10
11866252163,11866252162,-1,813,1256,10
11868956194,11868956194,0,1065,1768,10
11869592518,11869592517,-1,786,1893,10
11872390825,11872390824,-1,1282,1746,10
11876018963,11876018963,0,1149,1837,10
11878094511,11878094515,4,2169,1136,10
11880160010,11880160009,-1,1416,1780,10
11880243009,11880243025,16,808,1035,10
11886707670,11886707670,0,1271,2272,10
11890207868,11890207869,1,1399,1300,10
11892376273,11892376270,-3,986,1735,10
11893911730,11893911708,-22,1325,1879,10
11894447790,11894447791,1,1672,1837,10
11895978860,11895978857,-3,739,1091,10
11896927685,11896927683,-2,878,1547,10
11900354691,11900354689,-2,963,1991,10
11903772078,11903772078,0,1197,1686,10
11903829106,11903829105,-1,1182,1352,10
11904336078,11904336087,9,1470,916,10
11905467148,11905467147,-1,1296,2360,10
11908940834,11908940833,-1,1224,1922,10
11912863555,11912863554,-1,1305,1363,10
11914252693,11914252691,-2,1522,1973,10
11915219642,11915219641,-1,1081,2255,10
11916296374,11916296370,-4,1625,2991,10
11917291844,11917291847,3,1127,948,10
11918180974,11918180978,4,2651,1664,10
11919787490,11919787490,0,1489,1966,10
11924401224,11924401225,1,1025,1473,10
11927151590,11927151589,-1,1052,1848,10
11929003471,11929003470,-1,1256,2289,10
11929210009,11929210006,-3,985,1471,10
11932661058,11932661057,-1,718,1662,10
11936574174,11936574173,-1,1490,2795,10
11941442210,11941442210,0,874,1316,10
11947731287,11947731287,0,919,1887,10
11948296379,11948296376,-3,1226,1946,10
11951550430,11951550430,0,1329,1577,10
11963190636,11963190633,-3,1172,2751,10
11968427759,11968427758,-1,1181,1903,10
11968866947,11968866946,-1,1347,1591,10
11971134742,11971134741,-1,1254,1803,10
11972837538,11972837538,0,1361,1881,10
11973629426,11973629423,-3,1371,2882,10
11978657670,11978657670,0,779,2025,10
11978963805,11978963809,4,2026,893,10
11979898367,11979898345,-22,1465,1439,10
11986751599,11986751599,0,924,2123,10
11987193291,11987193290,-1,947,1636,10
11987772987,11987772984,-3,586,1789,10
11991856730,11991856735,5,1700,1060,10
11991950462,11991950462,0,1234,2362,10
11994346030,11994346030,0,856,1309,10
11996848490,11996848492,2,1529,1552,10
11998938694,11998938694,0,1067,1590,10
12003362283,12003362282,-1,1466,2599,10
12005371509,12005371508,-1,1033,2206,10
12006787049,12006787048,-1,1363,2442,10
12008296755,12008296754,-1,1560,1916,10
12013837373,12013837372,-1,1607,2061,10
12016448231,12016448229,-2,1115,2184,10
12016918762,12016918761,-1,1151,2294,10
12019431398,12019431397,-1,1072,1342,10
12020741859,12020741858,-1,1799,2994,10
12021785862,12021785865,3,3436,2708,10
12023969426,12023969426,0,1001,1645,10
12031983935,12031983940,5,2867,1915,10
12032099323,12032099321,-2,1319,1547,10
12032487638,12032487638,0,1201,1939,10
12038402892,12038402891,-1,1722,1645,10
12040063867,12040063866,-1,1044,1975,10
12043475223,12043475223,0,1474,1833,10
12045108033,12045108030,-3,1063,2247,10
12047173592,12047173590,-2,1214,2072,10
12049154013,12049154014,1,1601,2508,10
12054224366,12054224366,0,1405,2613,10
12055092553,12055092550,-3,742,1077,10
12060053293,12060053294,1,1045,2058,10
12061144185,12061144184,-1,1203,1840,10
12061475173,12061475171,-2,918,1228,10
12063345163,12063345157,-6,937,3867,10
12066676728,12066676734,6,1015,622,10
12067178850,12067178847,-3,1222,1928,10
12073256610,12073256608,-2,1850,2502,10
12079298551,12079298549,-2,1221,1651,10
12080899251,12080899250,-1,1271,1850,10
12082580294,12082580291,-3,940,2118,10
12085113061,12085113061,0,1076,1443,10
12085855929,12085855946,17,279,987,10
12088739905,12088739902,-3,1214,2574,10
12095182469,12095182469,0,1134,1711,10
12097134687,12097134687,0,626,1482,10
12097283207,12097283206,-1,1532,2521,10
12099018357,12099018356,-1,983,1539,10
12100703585,12100703605,20,774,1865,10
12102114914,12102114913,-1,967,1910,10
12102336746,12102336743,-3,83,1907,10
12102988956,12102988962,6,4969,1930,10
12108483786,12108483786,0,809,1479,10
12109232518,12109232514,-4,459,1415,10
12110547335,12110547330,-5,1172,4166,10
12114764182,12114764181,-1,797,1114,10
12115275163,12115275144,-19,1355,1934,10
12117160125,12117160122,-3,902,1884,10
12117434024,12117434022,-2,1142,2762,10
12117474239,12117474238,-1,1251,1818,10
12121781725,12121781730,5,2477,1801,10
12133924379,12133924381,2,1523,1595,10
12138139004,12138139009,5,1925,1432,10
12140425619,12140425617,-2,985,2087,10
12142336215,12142336214,-1,1176,2793,10
12144164574,12144164574,0,994,1703,10
12146788545,12146788542,-3,889,1321,10
12149973301,12149973300,-1,1411,2519,10
12152499002,12152499000,-2,1101,2184,10
12153106845,12153106845,0,1422,2489,10
12154123063,12154123066,3,234,1775,10
12154321360,12154321358,-2,1456,2018,10
12158900212,12158900210,-2,1556,2286,10
12160219157,12160219155,-2,785,1792,10
12163607908,12163607909,1,1037,2123,10
12164952180,12164952178,-2,1345,2278,10
12166889755,12166889751,-4,1140,1985,10
12173380015,12173380011,-4,928,1908,10
12173914340,12173914347,7,7027,29098,10
12179253605,12179253603,-2,1451,2343,10
12185348414,12185348413,-1,1528,1489,10
12186871949,12186871947,-2,1358,2488,10
12189654144,12189654139,-5,2203,5095,10
12191647153,12191647153,0,1021,1491,10
12194404507,12194404505,-2,971,1898,10
12196915512,12196915512,0,1222,1639,10
12197201041,12197201062,21,1120,2777,10
12200200001,12200200001,0,1268,1771,10
12201463792,12201463775,-17,1022,1797,10
12203875742,12203875741,-1,1067,1459,10
12208954902,12208954900,-2,897,1745,10
12211398580,12211398577,-3,1203,2578,10
12212623987,12212623985,-2,984,1578,10
12213200954,12213200950,-4,936,2043,10
12216117099,12216117092,-7,1039,3206,10
12216643251,12216643237,-14,1479,1553,10
12219382565,12219382565,0,1577,2495,10
12226470101,12226470099,-2,974,1125,10
12226624653,12226624652,-1,1304,2498,10
12228872513,12228872511,-2,847,1665,10
12230085681,12230085679,-2,1226,1584,10
12236145175,12236145176,1,1318,1451,10
12239507413,12239507410,-3,1276,2489,10
12240923745,12240923750,5,6774,4310,10
12244065957,12244065959,2,1339,1157,10
12244289515,12244289510,-5,945,1001,10
12246783250,12246783248,-2,1509,3369,10
12248943178,12248943177,-1,945,1854,10
12249635406,12249635406,0,1390,1765,10
12250356080,12250356078,-2,1029,1979,10
12251497177,12251497177,0,1306,2268,10
12254126233,12254126231,-2,1253,2372,10
12257994058,12257994059,1,1196,1416,10
12258545171,12258545171,0,1380,1406,10
12258982335,12258982330,-5,1080,4480,10
12260484870,12260484870,0,1342,2436,10
12264234852,12264234844,-8,1499,1988,10
12265917705,12265917710,5,2140,1550,10
12272861206,12272861210,4,1882,1715,10
12274981658,12274981657,-1,1077,1835,10
12275660906,12275660899,-7,1082,4772,10
12276351419,12276351417,-2,1058,1368,10
12278116315,12278116322,7,2239,81,10
12281853504,12281853508,4,2084,1580,10
12287244425,12287244424,-1,1229,2482,10
12294307930,12294307930,0,1121,2134,10
12295890346,12295890346,0,2986,3892,10
12298594276,12298594274,-2,1410,1884,10
12299709874,12299709874,0,1064,1519,10
12300912476,12300912477,1,1024,1929,10
12301029185,12301029206,21,844,1277,10
12302919366,12302919364,-2,1569,1929,10
12305458343,12305458345,2,553,861,10
12308144697,12308144698,1,1166,1473,10
12310405083,12310405082,-1,994,2211,10
12311995182,12311995180,-2,752,1832,10
12312477367,12312477366,-1,735,1891,10
12312613944,12312613938,-6,1073,1597,10
12313140881,12313140881,0,1665,2797,10
12316004687,12316004685,-2,1239,1920,10
12316940717,12316940715,-2,1125,1931,10
12320191350,12320191348,-2,1523,2600,10
12325856721,12325856726,5,1480,1724,10
12326512580,12326512581,1,1306,1518,10
12330977015,12330977014,-1,1171,1858,10
12331352853,12331352851,-2,1266,1484,10
12332907613,12332907610,-3,996,2900,10
12333486813,12333486814,1,1604,2074,10
12337027129,12337027127,-2,1238,2054,10
12337161680,12337161681,1,1449,2613,10
12337901702,12337901699,-3,1052,1886,10
12337964988,12337965007,19,1177,2054,10
12338591774,12338591773,-1,647,1117,10
12339629427,12339629424,-3,1317,2732,10
12344766206,12344766208,2,1690,1670,10
12345212250,12345212247,-3,1154,1872,10
12345271171,12345271170,-1,242,590,10
12347921138,12347921137,-1,1216,1983,10
12350067026,12350067023,-3,1172,2640,10
12351877356,12351877341,-15,967,2132,10
12353594337,12353594328,-9,970,2110,10
12360081928,12360081926,-2,1152,1870,10
12360473111,12360473109,-2,1254,2577,10
12361174039,12361174041,2,1237,1937,10
12364456422,12364456420,-2,1614,3475,10
12368137503,12368137501,-2,1019,2628,10
12371300671,12371300669,-2,1259,2575,10
12373167389,12373167386,-3,767,1210,10
12374070119,12374070114,-5,1787,2644,10
12374331106,12374331103,-3,1452,1884,10
12376188141,12376188138,-3,955,993,10
12378098299,12378098281,-18,1367,2241,10
12379617796,12379617794,-2,1292,1553,10
12382065585,12382065584,-1,845,1879,10
12387170843,12387170842,-1,1653,1915,10
12388988088,12388988092,4,3165,1873,10
12391597529,12391597530,1,801,1344,10
12393316882,12393316881,-1,1700,2282,10
12393800564,12393800561,-3,1086,2263,10
12395953177,12395953178,1,2535,2394,10
12398432479,12398432481,2,1668,1087,10
12399718367,12399718367,0,1002,1809,10
12402237777,12402237774,-3,1049,2197,10
12403132341,12403132339,-2,1008,1617,10
12409085637,12409085635,-2,1792,2538,10
12410510686,12410510684,-2,1800,2560,10
12412849155,12412849154,-1,1514,2437,10
12413717946,12413717945,-1,1048,2147,10
12414296353,12414296355,2,5186,3341,10
12422220197,12422220196,-1,1385,1967,10
12424173592,12424173588,-4,493,1274,10
12424569199,12424569201,2,1175,1380,10
12425817348,12425817347,-1,1190,1376,10
12431779119,12431779119,0,1193,1938,10
12434485091,12434485089,-2,1143,1939,10
12436571277,12436571283,6,2774,1212,10
12442634659,12442634660,1,888,1663,10
12445121677,12445121675,-2,1171,1846,10
12445148703,12445148702,-1,1800,3307,10
12445776540,12445776534,-6,2730,9437,10
12452227036,12452227034,-2,1262,1994,10
12455447336,12455447335,-1,1452,1994,10
12457126805,12457126803,-2,1496,2361,10
12459224929,12459224928,-1,1174,2031,10
12459571587,12459571582,-5,1054,1298,10
12467710691,12467710689,-2,1106,2060,10
12469864457,12469864454,-3,1427,2712,10
12470611450,12470611451,1,1349,1508,10
12471990560,12471990558,-2,1026,1550,10
12472718035,12472718034,-1,1248,2089,10
12474207304,12474207308,4,3140,1874,10
12476122457,12476122457,0,786,1828,10
12480503666,12480503666,0,938,1319,10
12485779734,12485779734,0,1287,2369,10
12488591898,12488591894,-4,1626,2968,10
12490323935,12490323931,-4,953,2193,10
12491337527,12491337527,0,774,1715,10
12494855276,12494855272,-4,1577,3419,10
12495292461,12495292463,2,1695,1351,10
12498024782,12498024781,-1,1489,3354,10
12498412898,12498412895,-3,1017,1924,10
12498499418,12498499438,20,420,815,10
12500106852,12500106851,-1,1140,2388,10
12500713623,12500713623,0,1006,951,10
12505923339,12505923337,-2,985,2556,10
12508573257,12508573254,-3,829,2608,10
12509282240,12509282229,-11,1178,2266,10
12509887927,12509887927,0,1222,1572,10
12510648098,12510648098,0,1191,1498,10
12510753578,12510753578,0,1138,1511,10
12513886546,12513886544,-2,1067,2125,10
12513938262,12513938267,5,1880,1327,10
12518569234,12518569234,0,1219,2088,10
12519715386,12519715386,0,1508,1765,10
12530380968,12530380966,-2,1388,2188,10
12530695154,12530695154,0,1014,1518,10
12530831586,12530831589,3,1552,1432,10
12535766807,12535766806,-1,1359,2677,10
12538788665,12538788665,0,923,1894,10
12538972246,12538972246,0,816,2254,10
12539603021,12539603027,6,2519,1730,10
12540342534,12540342533,-1,1496,2133,10
12542194653,12542194653,0,1308,1705,10
12543883287,12543883281,-6,1222,2704,10
12543914794,12543914795,1,1569,1327,10
12549395002,12549395002,0,1533,1424,10
12551810651,12551810647,-4,861,1401,10
12556439306,12556439312,6,1697,706,10
12556714962,12556714962,0,1195,1419,10
12559328166,12559328163,-3,560,912,10
12559830004,12559830003,-1,1225,2020,10
12563930430,12563930429,-1,1406,2014,10
12565991759,12565991757,-2,1665,1512,10
12566457950,12566457954,4,2342,1378,10
12568117102,12568117100,-2,1469,2827,10
12568622948,12568622946,-2,1502,1915,10
12568768552,12568768553,1,308,833,10
12569497862,12569497861,-1,766,1267,10
12578012363,12578012362,-1,1030,2001,10
12578330834,12578330835,1,806,1265,10
12579256198,12579256198,0,1183,1736,10
12581116090,12581116083,-7,150,856,10
12581519545,12581519546,1,1368,1861,10
12582119500,12582119498,-2,1389,1670,10
12583432495,12583432493,-2,1800,2214,10
12584492718,12584492715,-3,1007,1268,10
12590864143,12590864142,-1,1456,2683,10
12592778145,12592778149,4,3555,2223,10
12596907088,12596907083,-5,1078,2575,10
12598136110,12598136110,0,1367,1594,10
12600944967,12600944964,-3,1159,1557,10
12601429835,12601429833,-2,657,2084,10
12605208799,12605208798,-1,986,1881,10
12607305486,12607305486,0,909,1329,10
12607764345,12607764344,-1,1277,2241,10
12609149281,12609149279,-2,1437,1655,10
12609490392,12609490389,-3,990,1763,10
12609844468,12609844450,-18,140,1190,10
12614308452,12614308450,-2,1475,2633,10
12617790229,12617790226,-3,1037,1725,10
12617963443,12617963442,-1,1272,1489,10
12619648058,12619648055,-3,937,1666,10
12621715271,12621715269,-2,1254,1767,10
12623862189,12623862186,-3,1450,1939,10
12631188015,12631188013,-2,927,1853,10
12633042981,12633042979,-2,956,1950,10
12633488203,12633488202,-1,1007,2288,10
12639093636,12639093635,-1,903,2160,10
12640557473,12640557471,-2,585,676,10
12644060617,12644060614,-3,1406,1697,10
12645233186,12645233182,-4,648,2569,10
12645321240,12645321220,-20,951,1518,10
12649678815,12649678815,0,474,812,10
12649977441,12649977439,-2,1247,2281,10
12650794894,12650794893,-1,1268,1826,10
12655320373,12655320370,-3,1451,3322,10
12655658206,12655658206,0,1102,1495,10
12655772863,12655772861,-2,833,1852,10
12659923151,12659923150,-1,1003,1894,10
12661376550,12661376550,0,1367,1877,10
12663854710,12663854711,1,859,2350,10
12666235174,12666235174,0,1242,1994,10
12666428250,12666428246,-4,958,1645,10
12667217701,12667217698,-3,1556,2409,10
12671913653,12671913651,-2,1319,2648,10
12672546162,12672546161,-1,1163,1937,10
12675117505,12675117505,0,1068,2048,10
12676263946,12676263947,1,1360,1284,10
12681633176,12681633173,-3,1534,2639,10
12681822129,12681822117,-12,1053,1509,10
12682523580,12682523597,17,584,1747,10
12686092690,12686092690,0,1041,2289,10
12687685397,12687685396,-1,826,1680,10
12696152111,12696152110,-1,1338,1261,10
12696601670,12696601670,0,606,1328,10
12697727250,12697727250,0,1672,2268,10
12699018810,12699018810,0,1158,1782,10
12700452000,12700451994,-6,2002,8242,10
12701621989,12701621988,-1,1067,1628,10
12702912746,12702912746,0,1611,2105,10
12705969490,12705969492,2,827,1553,10
12707881944,12707881943,-1,1562,2500,10
12709898558,12709898557,-1,911,1291,10
12712087728,12712087726,-2,1494,3149,10
12713391997,12713391996,-1,851,1712,10
12715892028,12715892027,-1,1197,2001,10
12716041200,12716041197,-3,1108,1896,10
12716822383,12716822382,-1,887,1479,10
12720371671,12720371672,1,1040,1737,10
12723835495,12723835490,-5,2226,4607,10
12724335534,12724335533,-1,1566,1946,10
12726194463,12726194460,-3,1351,1818,10
12726553412,12726553411,-1,1437,2131,10
12727804943,12727804941,-2,1880,3448,10
12730590943,12730590944,1,1387,1625,10
12734788676,12734788675,-1,1482,1475,10
12738076576,12738076568,-8,1487,9107,10
12742990171,12742990168,-3,1198,2192,10
12744372604,12744372602,-2,1201,1896,10
12746257217,12746257217,0,1070,1686,10
12751489647,12751489646,-1,1106,2193,10
12754692439,12754692438,-1,1011,2115,10
12755627209,12755627207,-2,1011,1217,10
12758861623,12758861622,-1,1113,2092,10
12760195323,12760195319,-4,1187,1802,10
12765205090,12765205089,-1,940,1638,10
12766899701,12766899701,0,810,1263,10
12768971835,12768971830,-5,1286,2034,10
12773378086,12773378067,-19,1281,1937,10
12775656686,12775656686,0,1233,2473,10
12780731695,12780731696,1,932,1456,10
12783240138,12783240137,-1,1290,2744,10
12787032633,12787032630,-3,998,1938,10
12792583535,12792583534,-1,845,2633,10
12792930278,12792930280,2,777,1402,10
12794008787,12794008786,-1,1104,1581,10
12795473774,12795473775,1,1102,1741,10
12796237530,12796237527,-3,1636,1999,10
12798587565,12798587566,1,1442,1915,10
12799023809,12799023830,21,338,1810,10
12799924562,12799924561,-1,878,1399,10
12803738311,12803738308,-3,1122,1674,10
12804070961,12804070960,-1,490,1308,10
12805789389,12805789388,-1,1204,1956,10
12812705022,12812705021,-1,1434,2342,10
12818276899,12818276899,0,1302,1777,10
12820206301,12820206298,-3,1278,2243,10
12823236201,12823236202,1,1557,1405,10
12823399209,12823399209,0,1479,2299,10
12823749723,12823749725,2,3871,2217,10
12830970288,12830970272,-16,2478,1886,10
12833881073,12833881071,-2,1255,2107,10
12838805748,12838805745,-3,1318,2271,10
12838943778,12838943778,0,1277,1387,10
12839112040,12839112040,0,51802,20423,10
12844288117,12844288120,3,4418,2625,10
12846970986,12846970985,-1,1033,1646,10
12848843830,12848843828,-2,2105,2066,10
12850912409,12850912408,-1,911,1456,10
12853489390,12853489389,-1,1091,1699,10
12853669938,12853669923,-15,1346,2558,10
12855314667,12855314666,-1,1269,2439,10
12856287085,12856287084,-1,1468,2004,10
12857736374,12857736377,3,1799,1649,10
12862951818,12862951819,1,1244,1576,10
12864182993,12864183012,19,809,1448,10
12864370423,12864370422,-1,1092,1756,10
12865331716,12865331733,17,1236,2151,10
12867553686,12867553685,-1,1415,2038,10
12870183270,12870183269,-1,1308,1760,10
12871383771,12871383772,1,926,1255,10
12874129676,12874129683,7,22919,26855,10
12877587882,12877587885,3,864,2082,10
12877942251,12877942253,2,1592,1740,10
12879737691,12879737690,-1,1153,2114,10
12880897330,12880897330,0,1472,2246,10
12880955576,12880955573,-3,1204,2635,10
12882197919,12882197918,-1,1133,1594,10
12882909627,12882909628,1,1259,1661,10
12885266295,12885266293,-2,1166,1948,10
12887470119,12887470117,-2,1291,2022,10
12889289339,12889289336,-3,1262,1459,10
12898235838,12898235838,0,1390,2800,10
12898501657,12898501656,-1,858,1937,10
12899222963,12899222961,-2,1146,1602,10
12900374978,12900374978,0,958,2034,10
12905228230,12905228225,-5,799,2912,10
12905889926,12905889924,-2,974,2353,10
12907943282,12907943262,-20,998,2207,10
12911540261,12911540262,1,1372,1217,10
12911697142,12911697142,0,1339,1613,10
12912419858,12912419856,-2,1846,2429,10
12916671618,12916671618,0,1559,2392,10
12921045761,12921045758,-3,1080,2262,10
12922263977,12922263960,-17,961,2146,10
12922563544,12922563542,-2,1183,1748,10
12922698922,12922698921,-1,786,1815,10
12924074315,12924074313,-2,1392,1416,10
12930100919,12930100916,-3,925,2410,10
12932192113,12932192115,2,1277,1884,10
12932342856,12932342877,21,1282,1776,10
12933801235,12933801237,2,1546,2130,10
12936785143,12936785142,-1,1587,1561,10
12937727833,12937727834,1,1517,1786,10
12941562559,12941562559,0,1112,1995,10
12943515765,12943515763,-2,1226,1771,10
12943620197,12943620197,0,1164,1655,10
12944374056,12944374078,22,884,1518,10
12945815137,12945815143,6,3647,1301,10
12951484415,12951484415,0,1521,2019,10
12952142167,12952142166,-1,1230,1787,10
12952321046,12952321044,-2,1009,2176,10
12957775717,12957775715,-2,1024,2821,10
12959242433,12959242432,-1,1409,1881,10
12959753081,12959753079,-2,1147,1357,10
12961292063,12961292061,-2,1026,1886,10
12962146221,12962146218,-3,1542,4588,10
12965659807,12965659805,-2,1451,2368,10
12968550909,12968550917,8,693,1537,10
12970181414,12970181413,-1,1308,2358,10
12970539411,12970539410,-1,629,1285,10
12971245530,12971245527,-3,1292,1553,10
12971654442,12971654442,0,864,1491,10
12972748488,12972748486,-2,1040,2754,10
12973480206,12973480205,-1,1460,2314,10
12973617025,12973617022,-3,1144,2530,10
12974537831,12974537829,-2,907,1598,10
12979692130,12979692131,1,1570,1310,10
12982478494,12982478491,-3,1593,1972,10
12983965014,12983965016,2,1401,1717,10
12984713626,12984713625,-1,1308,3078,10
12987303033,12987303030,-3,1557,2307,10
12990139044,12990139043,-1,1237,2521,10
12994963094,12994963094,0,492,1703,10
12998382657,12998382659,2,1317,1105,10
13004039438,13004039459,21,555,1050,10
13004419396,13004419395,-1,1272,1948,10
13005181374,13005181369,-5,1586,26613,10
13006932947,13006932946,-1,883,1404,10
13007591815,13007591814,-1,925,1365,10
13009248461,13009248459,-2,1395,2884,10
13009457194,13009457193,-1,735,1748,10
13009525238,13009525237,-1,1049,1922,10
13009909522,13009909542,20,1112,4092,10
13016342872,13016342870,-2,1156,1976,10
13017835693,13017835691,-2,1024,2164,10
13019255677,13019255676,-1,1044,1897,10
13021244254,13021244254,0,1425,1615,10
13023605796,13023605799,3,3868,2485,10
13026290798,13026290798,0,1428,2139,10
13026857407,13026857405,-2,876,1863,10
13029107912,13029107913,1,1212,1702,10
13029604383,13029604379,-4,1038,1602,10
13033278564,13033278563,-1,1852,2362,10
13033467590,13033467589,-1,1375,1963,10
13039285098,13039285097,-1,1384,1691,10
13041172692,13041172690,-2,1262,1962,10
13043949202,13043949202,0,641,1392,10
13044680034,13044680034,0,1350,1250,10
13054430863,13054430861,-2,1201,2339,10
13056383490,13056383490,0,1004,1466,10
13064027270,13064027268,-2,704,1822,10
13064362136,13064362158,22,976,1539,10
13066656590,13066656572,-18,1287,679,10
13070491485,13070491483,-2,1134,1748,10
13072329938,13072329942,4,2027,1346,10
13077260250,13077260249,-1,858,1359,10
13079677550,13079677546,-4,1451,3235,10
13080370550,13080370550,0,986,1337,10
13081504840,13081504841,1,1180,2000,10
13083006932,13083006943,11,30,1105,10
13087691426,13087691424,-2,1037,2057,10
13089493837,13089493834,-3,1628,1982,10
13097705718,13097705719,1,767,939,10
13100703718,13100703715,-3,1054,2263,10
13103485319,13103485311,-8,1072,1579,10
13112567823,13112567820,-3,863,1828,10
13113924512,13113924511,-1,770,1499,10
13114687261,13114687259,-2,1727,2423,10
13122276801,13122276803,2,1811,1294,10
13128001794,13128001793,-1,1252,1817,10
13128940536,13128940531,-5,902,2916,10
13129792559,13129792559,0,1366,2399,10
13129966622,13129966619,-3,597,1901,10
13130015170,13130015155,-15,1227,2322,10
13130468990,13130468987,-3,1213,1813,10
13131226973,13131226973,0,850,1435,10
13131708133,13131708131,-2,1062,1930,10
13136683087,13136683085,-2,907,1979,10
13141386051,13141386046,-5,1187,1461,10
13142614539,13142614537,-2,564,1305,10
13144096258,13144096257,-1,1231,1486,10
13147477446,13147477446,0,837,1142,10
13148937381,13148937380,-1,1319,1214,10
13151318755,13151318749,-6,743,1467,10
13152076890,13152076890,0,932,1405,10
13154619412,13154619411,-1,975,1968,10
13155061760,13155061759,-1,2155,2279,10
13156898678,13156898675,-3,1079,1781,10
13157786482,13157786481,-1,1062,1360,10
13158356170,13158356175,5,2496,1406,10
13158937843,13158937842,-1,1630,2073,10
13158996831,13158996831,0,974,1725,10
13163245922,13163245905,-17,1023,410,10
13170832422,13170832421,-1,1292,1992,10
13171672885,13171672885,0,1295,2016,10
13172355687,13172355682,-5,2535,7618,10
13176071126,13176071120,-6,2296,5247,10
13176707400,13176707403,3,3704,3042,10
13179185659,13179185663,4,1048,1308,10
13181523991,13181523990,-1,772,1090,10
13185516027,13185516025,-2,1070,1518,10
13187566161,13187566167,6,5803,2393,10
13194561110,13194561106,-4,1175,3387,10
13195000826,13195000826,0,1051,1733,10
13195750595,13195750594,-1,1491,2739,10
13197764663,13197764661,-2,969,1601,10
13199654738,13199654737,-1,921,727,10
13200266135,13200266134,-1,1117,2080,10
13200584250,13200584269,19,605,1150,10
13203568626,13203568622,-4,1007,2295,10
13203629948,13203629947,-1,1547,2801,10
13204176939,13204176944,5,2901,1290,10
13204478209,13204478209,0,1194,1724,10
13205083032,13205083025,-7,991,1363,10
13206181838,13206181838,0,895,1407,10
13207522281,13207522280,-1,974,2100,10
13208136439,13208136437,-2,1473,2782,10
13209646490,13209646482,-8,793,1061,10
13210232548,13210232547,-1,855,969,10
13212868578,13212868577,-1,780,2164,10
13215170968,13215170963,-5,1182,2260,10
13216743826,13216743825,-1,1307,1734,10
13221289041,13221289038,-3,1266,2584,10
13224306054,13224306054,0,1086,1782,10
13226841501,13226841498,-3,1162,2402,10
13226928882,13226928875,-7,1177,1763,10
13227333554,13227333553,-1,964,1508,10
13230490441,13230490439,-2,1244,1535,10
13231671946,13231671939,-7,1223,5099,10
13231778193,13231778215,22,1472,2045,10
13232551827,13232551826,-1,1268,1764,10
13233277758,13233277754,-4,1180,2526,10
13233525986,13233525982,-4,980,1709,10
13236103534,13236103532,-2,1022,2338,10
13238321107,13238321106,-1,1204,2321,10
13239627814,13239627813,-1,1124,2315,10
13243990475,13243990473,-2,1021,1126,10
13245134403,13245134391,-12,11037,37164,10
13246599570,13246599570,0,875,1809,10
13246647822,13246647821,-1,845,2447,10
13249031578,13249031578,0,1536,1238,10
13250451613,13250451611,-2,1222,1978,10
13255778166,13255778167,1,1347,1432,10
13261039959,13261039957,-2,1029,1633,10
13262657234,13262657232,-2,1386,1453,10
13268073431,13268073430,-1,1315,1586,10
13268420022,13268420024,2,1511,2429,10
13273019982,13273020003,21,1260,2300,10
13273910162,13273910161,-1,1038,1858,10
13277144933,13277144931,-2,1109,1709,10
13278543006,13278543005,-1,796,1743,10
13279351075,13279351072,-3,1072,2458,10
13281746402,13281746402,0,721,1784,10
13282427167,13282427153,-14,1195,1445,10
13283582580,13283582578,-2,1544,2657,10
13285635008,13285635006,-2,1086,2120,10
13293288220,13293288217,-3,1407,2579,10
13295189491,13295189492,1,1406,1689,10
13295768043,13295768030,-13,958,1557,10
13298119034,13298119033,-1,1325,1889,10
13301556563,13301556575,12,115,1277,10
13303657838,13303657841,3,708,613,10
13307414566,13307414562,-4,794,1743,10
13307934598,13307934610,12,12550,40915,10
13308010727,13308010734,7,3232,1263,10
13309470918,13309470919,1,1782,1607,10
13309647186,13309647186,0,1604,1536,10
13309819983,13309819982,-1,1273,1846,10
13311008689,13311008687,-2,1259,1914,10
13314121382,13314121380,-2,980,2013,10
13316012101,13316012101,0,1087,1948,10
13318132144,13318132144,0,1512,1538,10
13322419073,13322419071,-2,1001,1725,10
13323813646,13323813646,0,1539,2107,10
13325221775,13325221774,-1,987,1941,10
13326864287,13326864286,-1,839,1653,10
13327892851,13327892850,-1,1273,1892,10
13334852252,13334852250,-2,788,1495,10
13335017250,13335017229,-21,1055,1691,10
13337549024,13337549022,-2,1219,2009,10
13338487613,13338487609,-4,1286,1792,10
13341399977,13341399975,-2,1053,2310,10
13346311459,13346311457,-2,1360,1969,10
13346665129,13346665126,-3,917,2035,10
13346954970,13346954969,-1,1692,2596,10
13347828496,13347828501,5,1081,1360,10
13353300345,13353300343,-2,1221,2238,10
13353430882,13353430899,17,737,2388,10
13353541914,13353541913,-1,1668,2613,10
13356173999,13356173997,-2,1328,1448,10
13358454745,13358454740,-5,1188,3387,10
13360753506,13360753505,-1,1327,2224,10
13360831145,13360831141,-4,1049,3912,10
13365317494,13365317493,-1,1001,1771,10
13367037020,13367037018,-2,1028,2499,10
13368446465,13368446463,-2,1062,1933,10
13373938476,13373938474,-2,1403,2198,10
13377176017,13377176017,0,1754,2402,10
13379437725,13379437724,-1,787,1760,10
13381005007,13381005006,-1,1001,1786,10
13384700734,13384700733,-1,1542,1647,10
13388771985,13388771981,-4,28077,13728,10
13394082965,13394082967,2,1246,2340,10
13394653532,13394653529,-3,1622,2152,10
13398650750,13398650750,0,1479,1872,10
13398743034,13398743030,-4,1096,1721,10
13399709343,13399709341,-2,1670,2760,10
13401931698,13401931697,-1,1124,2321,10
13402566406,13402566405,-1,1228,1941,10
13404113866,13404113865,-1,859,1389,10
13407639334,13407639334,0,1194,2087,10
13408063038,13408063037,-1,1261,1545,10
13410454103,13410454101,-2,1138,3397,10
13411787435,13411787434,-1,953,2203,10
13412378553,13412378550,-3,1255,1692,10
13412609891,13412609877,-14,177,1096,10
13415364041,13415364038,-3,1279,2049,10
13417018429,13417018427,-2,1545,2578,10
13417368686,13417368684,-2,1280,1862,10
13419590926,13419590927,1,276,952,10
13420534851,13420534849,-2,1065,2046,10
13422458376,13422458373,-3,744,2622,10
13426657754,13426657755,1,1149,1521,10
13426764822,13426764826,4,1576,1199,10
13428359494,13428359499,5,5687,3027,10
13431700603,13431700604,1,1344,1494,10
13433957235,13433957234,-1,1748,1884,10
13437013653,13437013651,-2,1476,2558,10
13437062401,13437062400,-1,831,1441,10
13438677994,13438677994,0,1708,1936,10
13440139709,13440139706,-3,566,1075,10
13448590510,13448590505,-5,1073,2259,10
13450068530,13450068529,-1,1071,2203,10
13450681994,13450681993,-1,28,1124,10
13452872055,13452872054,-1,848,1450,10
13453773034,13453773021,-13,1132,1592,10
13454317755,13454317757,2,991,1782,10
13456600010,13456600012,2,10431,19957,10
13456754951,13456754948,-3,1097,1824,10
13458038826,13458038826,0,1559,2208,10
13458529229,13458529230,1,1154,1720,10
13459511703,13459511702,-1,806,1888,10
13460822456,13460822440,-16,1200,2015,10
13461557982,13461557979,-3,1338,1973,10
13463536263,13463536259,-4,1595,1640,10
13464230996,13464230995,-1,1132,1816,10
13465290913,13465290912,-1,693,1543,10
13477682061,13477682062,1,1046,1514,10
13478355905,13478355899,-6,1415,1595,10
13480406649,13480406650,1,1566,821,10
13484609620,13484609618,-2,1060,1632,10
13487876195,13487876195,0,984,1677,10
13488791148,13488791147,-1,1025,1650,10
13491392603,13491392601,-2,1195,2107,10
13496861777,13496861777,0,1306,1338,10
13499907389,13499907386,-3,1423,3332,10
13503714106,13503714104,-2,1163,1926,10
13510368067,13510368065,-2,956,2217,10
13511181674,13511181670,-4,1104,2446,10
13516603483,13516603478,-5,1347,2430,10
13519846100,13519846099,-1,1608,2263,10
13522038986,13522038984,-2,878,2182,10
13525632431,13525632439,8,3486,1432,10
13526709294,13526709302,8,5425,1976,10
13526821042,13526821044,2,1174,700,10
13528326894,13528326891,-3,3391,8542,10
13528411809,13528411810,1,1340,2234,10
13528782411,13528782410,-1,1164,1876,10
13530374163,13530374162,-1,1361,1711,10
13530511729,13530511727,-2,1350,2477,10
13534808541,13534808550,9,21728,46122,10
13536111409,13536111409,0,1389,1912,10
13537430232,13537430218,-14,1381,1810,10
13537792825,13537792825,0,1311,1397,10
13538308406,13538308403,-3,1345,2438,10
13542577541,13542577542,1,1457,1291,10
13544222057,13544222055,-2,1258,2193,10
13550959652,13550959653,1,1404,1954,10
13552006819,13552006799,-20,1339,1750,10
13553681452,13553681456,4,1328,1192,10
13557597862,13557597862,0,1096,1825,10
13564312329,13564312328,-1,1508,1931,10
13568826669,13568826667,-2,839,1289,10
13573719019,13573719018,-1,1171,1647,10
13574191371,13574191370,-1,1421,2628,10
13574620020,13574620019,-1,1110,1472,10
13578799698,13578799696,-2,1451,2193,10
13582604282,13582604279,-3,3149,6073,10
13586495368,13586495366,-2,1410,1657,10
13589392186,13589392186,0,546,1048,10
13591095010,13591094998,-12,886,1983,10
13591748447,13591748445,-2,1373,3291,10
13591925489,13591925488,-1,1171,1948,10
13592685410,13592685410,0,1328,2120,10
13596953150,13596953150,0,768,1017,10
13598584862,13598584860,-2,1145,2561,10
13598956895,13598956891,-4,1097,1834,10
13599101779,13599101778,-1,1909,1793,10
13601730911,13601730907,-4,1570,3493,10
13602061315,13602061310,-5,476,1970,10
13604841205,13604841203,-2,1388,3209,10
13605263666,13605263666,0,849,1366,10
13605576902,13605576901,-1,1087,2223,10
13608001466,13608001466,0,1306,1612,10
13608723716,13608723715,-1,979,1199,10
13617989117,13617989116,-1,1687,2290,10
13618503508,13618503501,-7,1003,1726,10
13620256624,13620256622,-2,56034,36636,10
13621844223,13621844223,0,666,1215,10
13623051966,13623051963,-3,1487,1746,10
13625041118,13625041118,0,1473,2587,10
13625603939,13625603938,-1,1236,1571,10
13625864069,13625864066,-3,1026,2006,10
13629251191,13629251191,0,1466,2276,10
13632121955,13632121954,-1,1657,2530,10
13632868555,13632868554,-1,1072,2197,10
13633115754,13633115751,-3,1468,1892,10
13635526623,13635526618,-5,1763,5415,10
13640265529,13640265525,-4,1124,3055,10
13640577368,13640577366,-2,860,1883,10
13644721219,13644721218,-1,1140,2834,10
13647111534,13647111532,-2,1494,2205,10
13649889126,13649889126,0,1324,2237,10
13650448000,13650447999,-1,1738,2000,10
13653172575,13653172573,-2,922,1975,10
13653343521,13653343538,17,393,2675,10
13655217501,13655217500,-1,2012,2464,10
13656552121,13656552120,-1,1250,1305,10
13658107943,13658107921,-22,423,899,10
13665283449,13665283446,-3,916,1439,10
13667078925,13667078923,-2,1550,3531,10
13669749054,13669749051,-3,1122,2168,10
13669872608,13669872609,1,685,1138,10
13677009481,13677009483,2,1545,1235,10
13685567875,13685567874,-1,881,1322,10
13686723835,13686723835,0,1311,3090,10
13688404662,13688404664,2,1165,1658,10
13690011943,13690011944,1,1185,1706,10
13694991170,13694991170,0,1353,904,10
13695305295,13695305297,2,880,1070,10
13695538938,13695538917,-21,1199,2284,10
13699300614,13699300615,1,1181,1967,10
13707418811,13707418810,-1,1267,2098,10
13710674889,13710674885,-4,1313,2129,10
13712836362,13712836362,0,1083,1347,10
13712890866,13712890885,19,948,1853,10
13714611982,13714611979,-3,1240,2435,10
13721518150,13721518148,-2,1247,2218,10
13723622322,13723622322,0,1068,1308,10
13724216095,13724216097,2,706,1866,10
13728729581,13728729580,-1,1519,1965,10
13730676083,13730676081,-2,888,1226,10
13733211567,13733211566,-1,966,1502,10
13734071032,13734071025,-7,1524,5232,10
13734741061,13734741057,-4,1334,2041,10
13735618903,13735618904,1,1102,1517,10
13744179131,13744179131,0,904,1729,10
13747553927,13747553927,0,855,2142,10
13749868790,13749868786,-4,1597,2635,10
13754161940,13754161947,7,4078,1663,10
13756285251,13756285261,10,13276,30927,10
13756556314,13756556314,0,1346,1668,10
13756970345,13756970342,-3,1069,2645,10
13757513419,13757513417,-2,692,1711,10
13762373330,13762373330,0,1450,2383,10
13764551860,13764551862,2,3152,3613,10
13764607659,13764607658,-1,1504,2240,10
13765440602,13765440597,-5,819,1811,10
13765979336,13765979334,-2,634,1440,10
13766271777,13766271769,-8,1340,1610,10
13766728234,13766728234,0,1339,1756,10
13768063506,13768063505,-1,1346,1975,10
13773035446,13773035446,0,1275,1424,10
13786236915,13786236914,-1,1119,1602,10
13790016618,13790016615,-3,1409,1979,10
13790587883,13790587879,-4,1014,2444,10
13790638690,13790638709,19,1649,2680,10
13793099911,13793099917,6,2160,934,10
13794677611,13794677610,-1,993,1731,10
13794841409,13794841406,-3,1148,2187,10
13794982793,13794982800,7,4852,1520,10
13795254873,13795254873,0,1171,2401,10
13796718355,13796718352,-3,761,1907,10
13801062205,13801062201,-4,976,1668,10
13801659780,13801659798,18,1048,1747,10
13802252838,13802252835,-3,986,1403,10
13803074506,13803074504,-2,745,1566,10
13803586187,13803586187,0,1068,1671,10
13805452655,13805452654,-1,1325,1296,10
13807173281,13807173282,1,1152,1629,10
13807665739,13807665737,-2,780,2195,10
13808542838,13808542837,-1,1326,1857,10
13809828767,13809828786,19,940,1216,10
13811625534,13811625520,-14,1062,362,10
13813203454,13813203449,-5,1957,6136,10
13815063838,13815063838,0,1245,2468,10
13815763440,13815763442,2,1434,1164,10
13840269814,13840269813,-1,881,960,10
13854712506,13854712505,-1,1203,1500,10
13857154910,13857154910,0,1201,1871,10
13861700952,13861700951,-1,1411,2014,10
13874635682,13874635684,2,1210,976,10
13876820693,13876820694,1,1322,2539,10
13878248478,13878248483,5,2298,1100,10
13881046958,13881046957,-1,1079,1855,10
13881160514,13881160513,-1,1530,1718,10
13882381588,13882381586,-2,1341,1739,10
13882432152,13882432172,20,1245,1444,10
13883298005,13883298002,-3,1387,2539,10
13885734567,13885734566,-1,1582,2223,10
13886047826,13886047828,2,1185,1793,10
13886653599,13886653598,-1,981,2435,10
13887783407,13887783411,4,3225,2733,10
13889455377,13889455376,-1,1176,2052,10
13892657958,13892657957,-1,1076,2058,10
13894787993,13894787992,-1,991,1668,10
13895373345,13895373347,2,1013,1444,10
13896764638,13896764636,-2,1288,2484,10
13899712706,13899712703,-3,1126,2000,10
13899740053,13899740046,-7,2189,10665,10
13902932910,13902932909,-1,1449,2583,10
13904392312,13904392309,-3,1288,1812,10
13905626841,13905626838,-3,1459,2418,10
13906102653,13906102654,1,1145,1559,10
13907884058,13907884058,0,1145,2749,10
13910663534,13910663534,0,1219,1301,10
13913142841,13913142840,-1,1332,2641,10
13914847769,13914847763,-6,947,3470,10
13914880585,13914880583,-2,1279,2174,10
13915849168,13915849166,-2,1234,2440,10
13916534706,13916534708,2,2032,1880,10
13916865253,13916865251,-2,1422,2489,10
13919932771,13919932772,1,1837,1598,10
13921460057,13921460055,-2,1215,1809,10
13928933031,13928933047,16,15747,24411,10
13930311428,13930311427,-1,1131,1631,10
13932843360,13932843357,-3,1193,2654,10
13933374238,13933374238,0,1277,1881,10
13936168100,13936168097,-3,1329,2032,10
13940119496,13940119493,-3,28666,12609,10
13943864253,13943864252,-1,1313,1691,10
13944585446,13944585446,0,885,1449,10
13945372449,13945372447,-2,1333,2152,10
13954757542,13954757535,-7,2041,7280,10
13960722821,13960722825,4,2075,1765,10
13963995832,13963995831,-1,1188,2341,10
13967583006,13967583003,-3,1147,1382,10
13969877137,13969877133,-4,1252,1784,10
13970182634,13970182619,-15,1721,1994,10
13972622570,13972622569,-1,817,1454,10
13977958235,13977958233,-2,1336,2217,10
13978570315,13978570313,-2,1690,2803,10
13979102012,13979102009,-3,1319,1744,10
13979757331,13979757347,16,559,1593,10
13979876042,13979876039,-3,1080,1872,10
13980788602,13980788602,0,1274,1220,10
13981105018,13981105016,-2,890,1463,10
13982234588,13982234586,-2,2159,2207,10
13983123611,13983123606,-5,1204,2701,10
13986227161,13986227177,16,1013,2067,10
13988958656,13988958654,-2,924,2056,10
13990640377,13990640374,-3,1182,2250,10
13992302614,13992302614,0,1138,1858,10
13993168746,13993168746,0,1185,1584,10
13993748547,13993748543,-4,1175,1732,10
13993948372,13993948371,-1,3152,4042,10
13994454197,13994454195,-2,1916,4196,10
13999327615,13999327613,-2,1477,2112,10
14001877315,14001877314,-1,1293,2483,10
14003865959,14003865952,-7,33316,11984,10
14004688060,14004688057,-3,1202,3044,10
14006474009,14006474014,5,4268,2764,10
14008180634,14008180633,-1,1540,1940,10
14010659566,14010659566,0,1032,1446,10
14011989487,14011989490,3,8430,18033,10
14014027253,14014027251,-2,1672,2510,10
14018279097,14018279096,-1,1080,1781,10
14018984238,14018984234,-4,1261,3286,10
14019932690,14019932687,-3,1286,2024,10
14030009336,14030009334,-2,1389,1517,10
14033235373,14033235370,-3,1246,1665,10
14033500903,14033500901,-2,1085,1554,10
14036622689,14036622684,-5,1256,3469,10
14043219531,14043219530,-1,1407,2075,10
14043391339,14043391323,-16,1036,1210,10
14048187246,14048187242,-4,1246,1467,10
14051339739,14051339738,-1,852,1979,10
14051394866,14051394863,-3,1067,1725,10
14052028918,14052028917,-1,970,2068,10
14055373046,14055373040,-6,1338,6178,10
14058277513,14058277515,2,2692,2057,10
14058403686,14058403682,-4,1016,1159,10
14060136987,14060136987,0,1291,1876,10
14062212976,14062212979,3,4303,4017,10
14063089834,14063089832,-2,1400,2902,10
14064431707,14064431706,-1,1113,1876,10
14069780884,14069780887,3,9761,6862,10
14070207767,14070207762,-5,609,1724,10
14072381912,14072381914,2,1925,1248,10
14074385694,14074385694,0,1334,1563,10
14080418484,14080418480,-4,1750,5068,10
14083254801,14083254799,-2,1360,2141,10
14083566940,14083566938,-2,1202,1798,10
14084101514,14084101514,0,1365,1846,10
14084354931,14084354929,-2,962,1126,10
14086065536,14086065535,-1,979,1420,10
14086643012,14086643012,0,1392,2197,10
14091121359,14091121356,-3,5978,12194,10
14094317651,14094317656,5,2075,1758,10
14099885332,14099885333,1,1415,2065,10
14102250871,14102250869,-2,1241,1846,10
14102429099,14102429095,-4,761,1326,10
14103969623,14103969622,-1,1743,1714,10
14105747313,14105747314,1,1491,2056,10
14106520388,14106520386,-2,1073,2007,10
14109235896,14109235897,1,1188,1625,10
14114718643,14114718641,-2,1466,2242,10
14115209766,14115209766,0,1635,1689,10
14116161127,14116161126,-1,1277,1692,10
14119932106,14119932105,-1,850,1879,10
14124973347,14124973347,0,863,2304,10
14128551287,14128551285,-2,1483,2577,10
14129629803,14129629800,-3,962,1461,10
14129783953,14129783947,-6,2541,8929,10
14130565132,14130565131,-1,1645,1823,10
14131960276,14131960294,18,1048,1719,10
14137614690,14137614688,-2,942,1991,10
14139238489,14139238487,-2,1118,2373,10
14139836667,14139836666,-1,1493,2114,10
14141093162,14141093161,-1,1278,1588,10
14142147935,14142147934,-1,1188,1992,10
14144668969,14144668967,-2,1251,2443,10
14145561717,14145561721,4,1713,1308,10
14148441631,14148441629,-2,1053,2540,10
14148679729,14148679750,21,1149,1222,10
14149960871,14149960870,-1,1069,1819,10
14153232615,14153232614,-1,1273,1993,10
14153642115,14153642114,-1,1579,2395,10
14156746078,14156746081,3,1519,2301,10
14157196860,14157196862,2,2317,2317,10
14157794809,14157794806,-3,1565,2191,10
14159741653,14159741652,-1,1352,2046,10
14161559052,14161559073,21,1271,2197,10
14162056005,14162056006,1,1583,1756,10
14163483375,14163483373,-2,1132,1371,10
14164328594,14164328593,-1,1171,1731,10
14164577649,14164577647,-2,1315,1352,10
14167351118,14167351118,0,1032,1186,10
14168865549,14168865546,-3,1257,2246,10
14173155225,14173155224,-1,941,1589,10
14173243579,14173243578,-1,1353,2203,10
14173582903,14173582899,-4,1173,1696,10
14173613839,14173613839,0,1801,2450,10
14175257093,14175257093,0,924,1671,10
14176660653,14176660652,-1,1238,1971,10
14181973593,14181973591,-2,1219,2288,10
14183986105,14183986105,0,1495,1844,10
14184060637,14184060637,0,2003,2360,10
14184211186,14184211180,-6,1289,1906,10
14184964050,14184964048,-2,1076,2783,10
14187608923,14187608922,-1,1298,2421,10
14189498565,14189498562,-3,1429,2254,10
14191600431,14191600428,-3,1111,2115,10
14192899405,14192899406,1,1833,2200,10
14204205720,14204205717,-3,2094,4232,10
14206429373,14206429373,0,1260,1526,10
14207106649,14207106648,-1,1527,2341,10
14208736129,14208736125,-4,1311,1404,10
14209189663,14209189662,-1,963,1812,10
14211920673,14211920673,0,1797,1823,10
14212247781,14212247779,-2,1030,2223,10
14214140585,14214140589,4,2314,1726,10
14214275970,14214275966,-4,1141,1501,10
14214429072,14214429070,-2,1600,1891,10
14215389198,14215389195,-3,1928,2386,10
14216391176,14216391173,-3,1359,1704,10
14217150758,14217150756,-2,1083,1867,10
14217530427,14217530430,3,1626,1495,10
14221781502,14221781501,-1,1247,1791,10
14226111872,14226111871,-1,1904,2321,10
14229859108,14229859106,-2,967,2019,10
14232180794,14232180793,-1,1361,2011,10
14235967041,14235967041,0,1440,2261,10
14237870464,14237870464,0,1220,1430,10
14240251266,14240251273,7,642,937,10
14246123858,14246123849,-9,36033,12066,10
14246298176,14246298174,-2,1020,1326,10
14247122297,14247122297,0,772,1598,10
14249461728,14249461727,-1,563,1284,10
14254296178,14254296175,-3,1137,1929,10
14257031794,14257031793,-1,1294,1403,10
14260375466,14260375463,-3,1259,1848,10
14261371367,14261371362,-5,851,2314,10
14261646426,14261646446,20,1271,1884,10
14264368289,14264368285,-4,967,1424,10
14266465256,14266465253,-3,1086,1494,10
14268781164,14268781165,1,873,2144,10
14269288126,14269288125,-1,1291,2120,10
14269392789,14269392787,-2,1368,3188,10
14272252694,14272252693,-1,1025,2010,10
14272306450,14272306449,-1,1398,2056,10
14276552784,14276552784,0,972,2193,10
14280072450,14280072448,-2,1409,1694,10
14280642767,14280642765,-2,1181,1863,10
14281229344,14281229343,-1,163,344,10
14281955036,14281955050,14,863,3061,10
14283537471,14283537465,-6,732,6388,10
14287117714,14287117715,1,1842,1791,10
14287328549,14287328547,-2,1475,2780,10
14287878356,14287878358,2,1259,1137,10
14288996624,14288996623,-1,1293,2037,10
14293766306,14293766309,3,2780,2313,10
14297805743,14297805741,-2,1187,2206,10
14299829910,14299829914,4,2167,1677,10
14300444679,14300444677,-2,1153,2122,10
14302199938,14302199938,0,981,1391,10
14307050550,14307050549,-1,1273,2083,10
14313011366,14313011365,-1,1075,1743,10
14314085633,14314085629,-4,1269,2500,10
14315297071,14315297067,-4,687,1591,10
14318968625,14318968625,0,1086,2102,10
14321029467,14321029467,0,2333,3753,10
14321217506,14321217506,0,1349,1537,10
14321491718,14321491718,0,1262,1796,10
14323961305,14323961301,-4,1629,3478,10
14324236447,14324236445,-2,1578,2454,10
14326735513,14326735513,0,1310,2504,10
14327558911,14327558906,-5,47,1220,10
14330517852,14330517850,-2,986,1631,10
14332855917,14332855917,0,1275,2454,10
14336752171,14336752172,1,1325,1684,10
14340870665,14340870665,0,1412,2268,10
14343939430,14343939434,4,4692,3219,10
14345496397,14345496394,-3,1193,2464,10
14346239054,14346239055,1,1238,1539,10
14346540982,14346540983,1,1746,1633,10
14349756006,14349756007,1,955,1974,10
14350547377,14350547378,1,1383,1586,10
14352613511,14352613509,-2,1250,2476,10
14352658459,14352658443,-16,349,660,10
14355404257,14355404256,-1,1262,2523,10
14355775370,14355775391,21,1169,1687,10
14361679295,14361679296,1,1120,2391,10
14361805321,14361805307,-14,1228,1704,10
14366171474,14366171478,4,3039,1187,10
14366788175,14366788174,-1,1223,2131,10
14368264659,14368264658,-1,1299,1660,10
14369793516,14369793515,-1,1154,1031,10
14374134342,14374134344,2,1611,1705,10
14379597954,14379597953,-1,1330,2194,10
14381804607,14381804607,0,1020,2249,10
14385852542,14385852537,-5,687,1988,10
14390040323,14390040323,0,590,575,10
14391161501,14391161502,1,1273,1814,10
14392245514,14392245518,4,1870,1114,10
14393191276,14393191260,-16,1061,1649,10
14393235087,14393235085,-2,1225,1914,10
14396424146,14396424146,0,1392,1823,10
14397672011,14397672010,-1,858,1252,10
14398228945,14398228946,1,1838,2168,10
14398476848,14398476845,-3,1652,2900,10
14399698230,14399698231,1,1384,1139,10
14402407230,14402407231,1,1286,1794,10
14402586049,14402586070,21,701,840,10
14408259361,14408259358,-3,1214,1913,10
14409827050,14409827050,0,1735,2551,10
14411239321,14411239322,1,1899,1921,10
14413679137,14413679136,-1,1031,1459,10
14413946346,14413946347,1,890,2044,10
14414173601,14414173603,2,1482,1485,10
14415561865,14415561867,2,1769,2387,10
14416549259,14416549266,7,2603,1412,10
14418898482,14418898480,-2,801,1622,10
14419050586,14419050584,-2,907,1876,10
14422825502,14422825501,-1,795,1933,10
14424031826,14424031832,6,3081,1575,10
14424720205,14424720213,8,12526,22955,10
14430217186,14430217179,-7,1945,7446,10
14430385138,14430385137,-1,1443,2112,10
14432883215,14432883215,0,1493,2551,10
14435169956,14435169958,2,17959,16645,10
14438184972,14438184970,-2,917,2165,10
14438223827,14438223826,-1,849,1200,10
14442104127,14442104126,-1,1069,1366,10
14442677402,14442677402,0,1163,1582,10
14443638514,14443638513,-1,1347,2231,10
14453052630,14453052633,3,1263,1902,10
14456924373,14456924371,-2,1508,1696,10
14460862899,14460862898,-1,4853,5620,10
14466956727,14466956722,-5,1039,3073,10
14468951671,14468951671,0,1343,2290,10
14469331279,14469331279,0,1327,1928,10
14469765975,14469765974,-1,1431,1421,10
14474396454,14474396454,0,962,2122,10
14483516428,14483516426,-2,1302,2646,10
14486211867,14486211887,20,211,873,10
14488729090,14488729089,-1,1471,2080,10
14498441573,14498441577,4,1382,1324,10
14500156954,14500156953,-1,1147,1990,10
14501473925,14501473925,0,1328,2521,10
14501510842,14501510839,-3,1450,2702,10
14505797829,14505797829,0,1241,1790,10
14506033901,14506033899,-2,1232,1912,10
14506578666,14506578667,1,1107,2251,10
14507039227,14507039226,-1,616,1109,10
14510062219,14510062219,0,1187,1240,10
14511331671,14511331666,-5,975,2566,10
14515232310,14515232310,0,1548,1808,10
14516710141,14516710142,1,1628,2264,10
14520277531,14520277530,-1,618,1351,10
14525208922,14525208921,-1,1644,2444,10
14525779547,14525779546,-1,674,1099,10
14527634446,14527634449,3,42406,3217,10
14528467533,14528467529,-4,1147,2706,10
14533786037,14533786043,6,2739,1032,10
14534075423,14534075421,-2,889,1627,10
14536686345,14536686344,-1,1121,2386,10
14540215851,14540215851,0,886,1579,10
14544211111,14544211111,0,1171,1947,10
14547346362,14547346362,0,1519,1495,10
14547412637,14547412641,4,1686,1390,10
14552151110,14552151110,0,1079,1565,10
14552981893,14552981890,-3,1121,2077,10
14557458671,14557458690,19,1365,2297,10
14561480328,14561480332,4,1464,1877,10
14561628934,14561628933,-1,1375,1937,10
14562825357,14562825354,-3,869,1423,10
14565471859,14565471859,0,946,1580,10
14566268349,14566268349,0,1304,1526,10
14566663563,14566663560,-3,1724,1864,10
14571565932,14571565934,2,1590,1712,10
14572900692,14572900690,-2,925,1109,10
14573299071,14573299069,-2,1289,3285,10
14574538854,14574538853,-1,1048,1105,10
14577241367,14577241369,2,1959,1552,10
14580331939,14580331939,0,1681,1812,10
14589793655,14589793651,-4,1055,2745,10
14591409154,14591409152,-2,1014,1258,10
14591948922,14591948920,-2,1217,2060,10
14592781934,14592781934,0,1146,2521,10
14594451671,14594451672,1,1333,1953,10
14595334985,14595334985,0,1319,1463,10
14599854465,14599854463,-2,1404,2101,10
14600314909,14600314908,-1,1139,2121,10
14605785710,14605785709,-1,1953,2346,10
14609780681,14609780681,0,1141,1206,10
14614796574,14614796573,-1,1399,1869,10
14616014546,14616014545,-1,1135,2200,10
14621946258,14621946259,1,1398,1557,10
14623289767,14623289766,-1,1426,2279,10
14627858194,14627858194,0,1166,1360,10
14631807174,14631807171,-3,1352,2465,10
14636693264,14636693261,-3,1502,1946,10
14637719834,14637719834,0,1073,2084,10
14638785859,14638785858,-1,1223,2085,10
14647933070,14647933069,-1,1134,2485,10
14648205764,14648205762,-2,1443,1785,10
14652620505,14652620510,5,3900,2402,10
14653792409,14653792405,-4,1564,2356,10
14656384973,14656384972,-1,1252,1687,10
14657994170,14657994166,-4,853,2757,10
14659705249,14659705247,-2,946,2282,10
14661187098,14661187098,0,1131,2002,10
14665628754,14665628752,-2,1119,2319,10
14665825832,14665825830,-2,1153,1969,10
14668727546,14668727542,-4,890,2216,10
14671420998,14671420997,-1,725,1288,10
14674670939,14674670938,-1,1300,2294,10
14678680789,14678680789,0,861,1762,10
14679153758,14679153758,0,1585,2135,10
14679912627,14679912633,6,13351,7509,10
14683331926,14683331925,-1,1014,1542,10
14683684227,14683684226,-1,1080,1983,10
14688329341,14688329338,-3,1324,1684,10
14690246795,14690246794,-1,1493,1788,10
14694356442,14694356442,0,1436,1796,10
14697158482,14697158482,0,1220,1585,10
14698219292,14698219290,-2,1021,2042,10
14700230517,14700230516,-1,1164,2269,10
14702769194,14702769195,1,879,2135,10
14703787641,14703787634,-7,1151,5135,10
14705587088,14705587100,12,1437,1542,10
14705777902,14705777901,-1,894,1723,10
14706013074,14706013076,2,1347,1611,10
14706464742,14706464740,-2,1260,1468,10
14706606140,14706606138,-2,1002,1832,10
14708470818,14708470818,0,1049,1783,10
14710357789,14710357790,1,1751,1310,10
14712158601,14712158607,6,2055,1323,10
14714173704,14714173702,-2,1254,2046,10
14714882454,14714882449,-5,1283,4075,10
14715601658,14715601674,16,729,1316,10
14716142246,14716142243,-3,1069,2131,10
14717849042,14717849042,0,973,1790,10
14720911884,14720911881,-3,1167,2390,10
14720969623,14720969621,-2,665,1629,10
14722234687,14722234685,-2,1045,1395,10
14725375206,14725375206,0,1340,1837,10
14726395304,14726395301,-3,1508,2583,10
14728758587,14728758587,0,1096,1473,10
14732893285,14732893282,-3,1048,2125,10
14733449265,14733449264,-1,1157,1868,10
14735858999,14735858996,-3,862,1947,10
14736422294,14736422302,8,3599,1190,10
14739653335,14739653331,-4,1154,2288,10
14744400696,14744400693,-3,1532,1878,10
14744711664,14744711665,1,85,289,10
14752224818,14752224816,-2,1025,2130,10
14752350570,14752350567,-3,1194,1426,10
14754024774,14754024772,-2,1265,1551,10
14759295942,14759295943,1,1417,1098,10
14760826385,14760826383,-2,1268,2576,10
14763098128,14763098119,-9,2778,20076,10
14764380649,14764380647,-2,802,1456,10
14765342759,14765342762,3,2615,1831,10
14766848477,14766848477,0,1756,2467,10
14768292701,14768292699,-2,1167,1680,10
14772658934,14772658933,-1,1328,1626,10
14773312380,14773312398,18,371,738,10
14773994943,14773994941,-2,1399,2228,10
14774037329,14774037326,-3,1121,2292,10
14774141305,14774141301,-4,1368,3627,10
14775880694,14775880693,-1,1695,2511,10
14776676163,14776676164,1,1502,1918,10
14776746136,14776746120,-16,1841,855,10
14780137996,14780137995,-1,1436,2485,10
14780402182,14780402189,7,3946,1179,10
14789544851,14789544856,5,3901,1919,10
14791049496,14791049495,-1,1857,2854,10
14793577518,14793577513,-5,1808,6655,10
14796111909,14796111909,0,1806,2499,10
14801049182,14801049181,-1,1281,2244,10
14801464868,14801464871,3,2708,2353,10
14802147141,14802147142,1,1570,1559,10
14805316476,14805316474,-2,1284,1880,10
14808180171,14808180170,-1,1084,1347,10
14811273690,14811273689,-1,942,1489,10
14811945106,14811945100,-6,1290,4970,10
14814784370,14814784369,-1,872,1123,10
14815748911,14815748918,7,3208,1086,10
14815852817,14815852817,0,922,2558,10
14817824798,14817824798,0,1383,1638,10
14821175896,14821175891,-5,1301,2330,10
14822924411,14822924410,-1,1299,1479,10
14824376341,14824376339,-2,1002,1660,10
14827149194,14827149214,20,574,1014,10
14828222527,14828222525,-2,1511,2814,10
14834680113,14834680113,0,2259,3931,10
14834866743,14834866741,-2,1590,2277,10
14836585910,14836585906,-4,1182,1980,10
14837954567,14837954565,-2,948,2204,10
14839345265,14839345264,-1,1385,2535,10
14840856191,14840856191,0,1179,1785,10
14849780204,14849780202,-2,1035,1209,10
14850662547,14850662545,-2,1541,2738,10
14851812546,14851812546,0,1039,2529,10
14854643301,14854643299,-2,18064,11467,10
14854916023,14854916026,3,1551,1640,10
14856065557,14856065555,-2,712,846,10
14858055493,14858055501,8,15640,26647,10
14861688297,14861688295,-2,1390,1702,10
14867748035,14867748038,3,1419,1289,10
14868383126,14868383127,1,1425,1633,10
14871021014,14871021011,-3,1201,2183,10
14873669539,14873669537,-2,1000,1829,10
14879085869,14879085868,-1,1169,2763,10
14883834214,14883834218,4,2507,1486,10
14888027923,14888027919,-4,1611,2383,10
14889505961,14889505961,0,208,806,10
14890363089,14890363094,5,2904,1660,10
14890636241,14890636238,-3,1235,1981,10
14890670937,14890670937,0,797,1525,10
14892868758,14892868755,-3,1233,2264,10
14893142806,14893142806,0,26153,27496,10
14893758113,14893758110,-3,1462,1840,10
14894461303,14894461302,-1,1275,1577,10
14896008180,14896008177,-3,1022,1763,10
14897549507,14897549509,2,1325,1101,10
14898318806,14898318813,7,5085,2145,10
14899420629,14899420629,0,1439,1466,10
14909606545,14909606543,-2,571,1169,10
14910869079,14910869081,2,1289,1880,10
14912517886,14912517884,-2,1275,1692,10
14916253930,14916253927,-3,1312,2015,10
14918389017,14918389012,-5,1389,2200,10
14920251070,14920251066,-4,2224,6118,10
14920602218,14920602217,-1,1396,1585,10
14920977207,14920977210,3,24535,23875,10
14926300714,14926300714,0,848,1639,10
14931191035,14931191034,-1,1036,2126,10
14934300120,14934300118,-2,1026,1647,10
14939071186,14939071186,0,2128,2402,10
14939528626,14939528625,-1,1187,1671,10
14946387738,14946387743,5,1470,1030,10
14946544983,14946544963,-20,977,1751,10
14948882191,14948882200,9,1355,1828,10
14953599061,14953599064,3,1225,1839,10
14953937879,14953937877,-2,888,1265,10
14954447191,14954447190,-1,1313,2319,10
14956215006,14956215005,-1,2136,2208,10
14957624978,14957624974,-4,1443,2475,10
14958389325,14958389324,-1,1876,2418,10
14960303826,14960303825,-1,1032,1772,10
14965812308,14965812306,-2,1373,1801,10
14968219362,14968219362,0,1192,1235,10
14973529850,14973529850,0,1156,1670,10
14974433825,14974433833,8,11041,37222,10
14974829282,14974829281,-1,1750,2018,10
14976507569,14976507566,-3,980,1553,10
14978127262,14978127261,-1,1206,1831,10
14980481376,14980481374,-2,1180,2240,10
14981636730,14981636726,-4,1258,2224,10
14982425321,14982425319,-2,1588,2308,10
14987886020,14987886018,-2,1145,1770,10
14988722355,14988722353,-2,1701,2732,10
14989746029,14989746027,-2,1013,2474,10
14990832207,14990832205,-2,1109,1945,10
14992846409,14992846414,5,3303,1471,10
15000470327,15000470326,-1,1127,1635,10
15006445917,15006445917,0,1124,2344,10
15010147517,15010147515,-2,808,1124,10
15013025232,15013025227,-5,888,2628,10
15013168602,15013168599,-3,1673,2292,10
15015315031,15015315031,0,1185,1930,10
15016841379,15016841377,-2,1367,1673,10
15018959278,15018959274,-4,1468,2134,10
15019076215,15019076214,-1,1203,1372,10
15019471690,15019471691,1,946,1560,10
15019703879,15019703880,1,1509,2075,10
15023390643,15023390642,-1,1051,1278,10
15028504058,15028504057,-1,865,1627,10
15030404356,15030404357,1,1394,2503,10
15030768413,15030768407,-6,1064,2158,10
15036969075,15036969075,0,693,1277,10
15037818290,15037818290,0,1258,2098,10
15040072592,15040072590,-2,1764,1610,10
15041020558,15041020565,7,2290,1209,10
15041564730,15041564727,-3,1087,1743,10
15043071885,15043071888,3,2047,982,10
15047517598,15047517599,1,839,1000,10
15050928721,15050928719,-2,1239,984,10
15051690652,15051690670,18,654,1318,10
15054961782,15054961781,-1,1466,2169,10
15059852987,15059852982,-5,926,1957,10
15060493478,15060493474,-4,1481,3484,10
15073025425,15073025422,-3,921,2448,10
15073245962,15073245942,-20,176,1399,10
15075357533,15075357532,-1,1841,2543,10
15076283910,15076283909,-1,1036,1696,10
15084070636,15084070634,-2,984,2838,10
15087127847,15087127846,-1,1122,2121,10
15089446595,15089446591,-4,1254,2104,10
15090334149,15090334150,1,1308,2594,10
15091533514,15091533513,-1,1523,2471,10
15093044639,15093044635,-4,1236,2504,10
15096085614,15096085611,-3,1030,2347,10
15108515351,15108515346,-5,1255,2569,10
15112154763,15112154759,-4,1033,1953,10
15115411230,15115411229,-1,1205,2205,10
15117164810,15117164809,-1,1389,2224,10
15120674706,15120674708,2,1253,1826,10
15122647575,15122647570,-5,1065,1809,10
15124008646,15124008648,2,1275,1418,10
15125011190,15125011198,8,1483,730,10
15127802872,15127802870,-2,1607,3077,10
15133394286,15133394282,-4,894,1974,10
15139900521,15139900519,-2,1274,1864,10
15140399038,15140399037,-1,1733,2006,10
15146590047,15146590046,-1,1384,2264,10
15148018307,15148018308,1,704,2484,10
15149154101,15149154099,-2,1307,1911,10
15150761699,15150761697,-2,1363,2203,10
15155589462,15155589463,1,2249,2789,10
15159511819,15159511822,3,1827,1785,10
15160840299,15160840298,-1,1023,1287,10
15162102935,15162102935,0,1274,1721,10
15166071877,15166071877,0,1486,1733,10
15167370974,15167370972,-2,1216,2540,10
15168638410,15168638410,0,1296,1630,10
15171892605,15171892602,-3,1322,2597,10
15172613345,15172613365,20,1693,2155,10
15172945706,15172945707,1,1227,1529,10
15174275726,15174275724,-2,1879,2900,10
15174935572,15174935584,12,397,748,10
15175729426,15175729422,-4,1162,1722,10
15177824183,15177824167,-16,966,2217,10
15180330666,15180330665,-1,1434,2234,10
15181285935,15181285934,-1,857,1787,10
15181791585,15181791583,-2,1600,1644,10
15181868221,15181868218,-3,1768,1642,10
15182163022,15182163020,-2,1211,2027,10
15185326382,15185326385,3,1014,1708,10
15187723960,15187723959,-1,1480,2328,10
15189289001,15189288994,-7,2295,6535,10
15190128223,15190128220,-3,1540,2013,10
15191151929,15191151928,-1,1577,2041,10
15194839943,15194839942,-1,1582,1664,10
15195382748,15195382746,-2,1468,2701,10
15201152904,15201152905,1,1660,2167,10
15204400927,15204400924,-3,1345,1961,10
15207733162,15207733159,-3,1462,1784,10
15216971358,15216971359,1,1662,1482,10
15217197094,15217197093,-1,1022,1463,10
15217323356,15217323366,10,208,691,10
15219010837,15219010834,-3,1038,1990,10
15228703377,15228703374,-3,1624,2319,10
15230614413,15230614411,-2,1561,1966,10
15230649523,15230649522,-1,1490,2361,10
15230807583,15230807582,-1,1158,1935,10
15233454634,15233454631,-3,1385,2034,10
15234385929,15234385929,0,1172,2348,10
15237587314,15237587314,0,891,1262,10
15238432818,15238432817,-1,735,1310,10
15239841951,15239841947,-4,1475,2748,10
15240307960,15240307958,-2,1127,1802,10
15244143995,15244143994,-1,1691,2231,10
15244380945,15244380944,-1,1425,2159,10
15247451035,15247451032,-3,1090,2068,10
15249617122,15249617122,0,1095,1981,10
15253814701,15253814701,0,1160,1424,10
15265793973,15265793971,-2,1190,2105,10
15269100329,15269100328,-1,1463,2614,10
15270491427,15270491427,0,1094,2183,10
15271112787,15271112787,0,1145,1638,10
15271657973,15271657970,-3,1060,2254,10
15275529461,15275529462,1,1334,1682,10
15275910313,15275910309,-4,800,1842,10
15281871378,15281871377,-1,1113,2198,10
15282221378,15282221377,-1,1131,1675,10
15285881898,15285881897,-1,1073,1931,10
15287735155,15287735158,3,759,816,10
15290587114,15290587112,-2,1570,2636,10
15291352879,15291352879,0,1752,2101,10
15291784313,15291784316,3,1281,1658,10
15293970571,15293970571,0,1054,1796,10
15294612877,15294612874,-3,1266,2903,10
15298822919,15298822917,-2,1445,2390,10
15299487625,15299487623,-2,1622,2624,10
15299871729,15299871729,0,870,1600,10
15300919351,15300919349,-2,1480,2608,10
15301789418,15301789419,1,1715,3206,10
15303937115,15303937115,0,1754,2420,10
15311047175,15311047173,-2,1500,2036,10
15319272320,15319272318,-2,1570,1784,10
15326561309,15326561302,-7,1310,5052,10
15327481639,15327481639,0,972,1079,10
15327974841,15327974842,1,1587,1873,10
15330799749,15330799748,-1,1256,2205,10
15330950694,15330950693,-1,1085,1457,10
15330997872,15330997870,-2,1114,2410,10
15338700829,15338700831,2,1153,1508,10
15338742212,15338742210,-2,1251,1934,10
15342387831,15342387829,-2,862,2182,10
15343104621,15343104618,-3,1285,2174,10
15344048719,15344048716,-3,642,881,10
15346612657,15346612654,-3,1237,2182,10
15348848047,15348848046,-1,1037,1792,10
15354599191,15354599190,-1,864,1801,10
15359938663,15359938662,-1,1503,2391,10
15360399665,15360399664,-1,1109,1212,10
15361770886,15361770884,-2,1599,2014,10
15362593993,15362593992,-1,1554,2400,10
15363484767,15363484765,-2,1769,2703,10
15363585158,15363585157,-1,1831,2760,10
15364684638,15364684637,-1,1306,1866,10
15366763909,15366763908,-1,948,2590,10
15370305838,15370305835,-3,1397,1300,10
15372969718,15372969717,-1,1109,2435,10
15373429480,15373429471,-9,1074,1999,10
15375666901,15375666898,-3,1342,1851,10
15380529883,15380529887,4,1291,1310,10
15384902623,15384902623,0,849,1459,10
15386299440,15386299440,0,1186,1612,10
15396125901,15396125894,-7,1087,3493,10
15397083610,15397083609,-1,1498,2144,10
15397481627,15397481625,-2,1471,2505,10
15398580466,15398580466,0,1188,1475,10
15402957538,15402957538,0,1294,2087,10
15404628689,15404628689,0,1515,1705,10
15405333771,15405333774,3,3743,2639,10
15407295478,15407295478,0,1251,2059,10
15407428168,15407428167,-1,1141,1478,10
15409121522,15409121522,0,1469,1435,10
15411514598,15411514597,-1,1212,2018,10
15411558777,15411558799,22,1339,1568,10
15415539602,15415539597,-5,1061,1925,10
15419509801,15419509799,-2,974,1552,10
15423362252,15423362248,-4,1045,2235,10
15424657486,15424657483,-3,791,1489,10
15425691656,15425691653,-3,972,1409,10
15429447974,15429447974,0,1548,1686,10
15429903946,15429903944,-2,894,2674,10
15430417838,15430417836,-2,926,1511,10
15433469952,15433469950,-2,1476,2462,10
15435364145,15435364143,-2,1797,2183,10
15445114369,15445114367,-2,1199,2070,10
15445758661,15445758660,-1,640,1329,10
15452098026,15452098022,-4,1134,2401,10
15454167312,15454167310,-2,805,1023,10
15456125995,15456125998,3,2020,1626,10
15457847762,15457847761,-1,1370,2623,10
15459245662,15459245661,-1,1208,1784,10
15463108375,15463108375,0,1264,1622,10
15464710345,15464710346,1,1602,1723,10
15465602543,15465602542,-1,1281,2034,10
15469464717,15469464714,-3,1491,2147,10
15469720721,15469720705,-16,1275,1710,10
15471215018,15471215013,-5,1081,2568,10
15471475344,15471475342,-2,1252,2011,10
15472606671,15472606670,-1,753,1621,10
15472783525,15472783523,-2,889,1424,10
15473828149,15473828147,-2,1299,2623,10
15475410940,15475410938,-2,1462,2301,10
15477676081,15477676085,4,2954,897,10
15482529807,15482529806,-1,892,1418,10
15483946222,15483946223,1,1154,2078,10
15485849869,15485849866,-3,1157,2549,10
15485896210,15485896194,-16,1055,1241,10
15487164839,15487164838,-1,1381,1880,10
15487314931,15487314931,0,1394,2179,10
15490262659,15490262658,-1,1170,2276,10
15493817486,15493817486,0,1120,1357,10
15495114154,15495114174,20,1056,1908,10
15498567985,15498567985,0,1474,2852,10
15500110601,15500110598,-3,1446,1761,10
15501272501,15501272500,-1,1276,2458,10
15504284216,15504284215,-1,1101,1772,10
15504907761,15504907760,-1,1498,1971,10
15506833330,15506833329,-1,1030,2330,10
15507959757,15507959754,-3,1490,2423,10
15517983846,15517983845,-1,1146,1800,10
15520412588,15520412588,0,1620,2004,10
15520605161,15520605163,2,922,1046,10
15521651982,15521651981,-1,1280,2036,10
15527810535,15527810534,-1,909,2063,10
15529446699,15529446698,-1,2149,2973,10
15530318387,15530318386,-1,1059,852,10
15531057811,15531057808,-3,728,1859,10
15532443030,15532443029,-1,1599,1514,10
15538095245,15538095242,-3,1051,2006,10
15539735197,15539735195,-2,1172,2075,10
15541230538,15541230536,-2,996,2007,10
15541729186,15541729186,0,241,748,10
15542779880,15542779861,-19,1186,2135,10
15546134809,15546134814,5,3197,1187,10
15546932635,15546932634,-1,1319,2434,10
15551180873,15551180870,-3,971,2289,10
15554992972,15554992973,1,1186,1534,10
15555466484,15555466481,-3,1718,2548,10
15562645759,15562645758,-1,1393,2176,10
15564060618,15564060614,-4,1059,1866,10
15565268134,15565268130,-4,794,2617,10
15566543430,15566543430,0,814,1280,10
15567654279,15567654268,-11,2088,1214,10
15568431434,15568431434,0,2149,2617,10
15573280549,15573280547,-2,1173,2215,10
15576232099,15576232099,0,1036,2032,10
15579847882,15579847880,-2,1079,2389,10
15579889301,15579889300,-1,2473,3853,10
15581431731,15581431729,-2,1401,1905,10
15581465974,15581465972,-2,1165,2808,10
15583838128,15583838126,-2,912,1571,10
15583949133,15583949134,1,1284,1835,10
15585992935,15585992938,3,1022,1744,10
15593684496,15593684495,-1,1312,1739,10
15596529390,15596529391,1,1403,1802,10
15597933030,15597933030,0,1345,1485,10
15599436187,15599436186,-1,982,1331,10
15604525301,15604525300,-1,1073,1848,10
15605088388,15605088388,0,1285,1744,10
15609313847,15609313845,-2,1077,2309,10
15609546886,15609546889,3,1757,2385,10
15610412235,15610412231,-4,1255,2873,10
15610797266,15610797283,17,654,1122,10
15615524140,15615524145,5,61739,32492,10
15619037837,15619037838,1,1083,1620,10
15619730727,15619730726,-1,1378,2035,10
15629627727,15629627725,-2,1415,1821,10
15631681204,15631681204,0,1186,2708,10
15637694308,15637694318,10,13222,29153,10
15638536310,15638536307,-3,1686,1876,10
15642429891,15642429891,0,456,850,10
15643082281,15643082281,0,1538,1916,10
15643227064,15643227061,-3,821,1400,10
15643546639,15643546640,1,1417,1257,10
15646453680,15646453677,-3,1822,2443,10
15646955488,15646955481,-7,1223,3409,10
15652621825,15652621822,-3,1260,2795,10
15654953350,15654953348,-2,1045,1771,10
15661522443,15661522442,-1,852,1315,10
15663158379,15663158380,1,1706,1427,10
15667227006,15667227004,-2,1490,2716,10
15672177454,15672177453,-1,1292,2365,10
15673567422,15673567421,-1,1651,2440,10
15673778361,15673778359,-2,830,1687,10
15673901556,15673901573,17,878,1274,10
15674556183,15674556180,-3,1146,2200,10
15680410751,15680410749,-2,1515,2188,10
15682652482,15682652482,0,1151,1843,10
15683097755,15683097774,19,909,2132,10
15684023755,15684023754,-1,1081,1851,10
15687427503,15687427502,-1,1068,2049,10
15688077683,15688077683,0,1025,1453,10
15689549774,15689549776,2,1484,2161,10
15689929659,15689929659,0,1093,1719,10
15690925699,15690925699,0,953,1332,10
15698199890,15698199887,-3,952,1782,10
15699156366,15699156369,3,2279,1661,10
15701535849,15701535855,6,2670,1322,10
15704156719,15704156721,2,722,1871,10
15704882610,15704882607,-3,1248,2745,10
15705890022,15705890021,-1,1678,2092,10
15706167386,15706167386,0,1429,1427,10
15711735790,15711735792,2,803,1315,10
15711994434,15711994433,-1,1737,1922,10
15712627847,15712627846,-1,1290,1494,10
15713915286,15713915282,-4,1547,3018,10
15714105560,15714105558,-2,1281,1912,10
15714751630,15714751629,-1,1115,2484,10
15715113398,15715113397,-1,1425,1854,10
15727913465,15727913465,0,1813,2272,10
15728577511,15728577506,-5,1217,3396,10
15730080951,15730080953,2,2101,1962,10
15732360978,15732360981,3,1691,1430,10
15735417118,15735417117,-1,1190,1876,10
15739009185,15739009184,-1,1787,1982,10
15740178374,15740178374,0,829,2191,10
15750366558,15750366556,-2,1957,2764,10
15752049559,15752049557,-2,810,1423,10
15755848085,15755848082,-3,1104,1853,10
15756514867,15756514865,-2,1138,1827,10
15757392791,15757392790,-1,1038,2352,10
15757935146,15757935143,-3,1536,2626,10
15758975874,15758975869,-5,1015,3502,10
15760783374,15760783368,-6,1022,4094,10
15760894618,15760894618,0,1816,2248,10
15764436110,15764436110,0,1502,2139,10
15764732571,15764732569,-2,1843,2434,10
15765922127,15765922123,-4,774,2442,10
15766218754,15766218755,1,1158,1172,10
15773818508,15773818506,-2,1149,1941,10
15774712150,15774712150,0,808,998,10
15777907244,15777907243,-1,1536,1994,10
15778879364,15778879351,-13,1451,1278,10
15782211566,15782211566,0,900,1091,10
15782976806,15782976808,2,976,1516,10
15783962263,15783962261,-2,1207,1879,10
15784860523,15784860522,-1,940,1310,10
15791266967,15791266966,-1,1614,1410,10
15794403128,15794403127,-1,1529,1984,10
15796624523,15796624524,1,1143,2171,10
15797967266,15797967266,0,1256,1499,10
15801798130,15801798132,2,11978,10411,10
15805154441,15805154440,-1,942,2013,10
15807407834,15807407830,-4,747,1612,10
15808002721,15808002702,-19,1011,2988,10
15815932327,15815932325,-2,1417,2513,10
15820822502,15820822498,-4,1432,1463,10
15821355463,15821355460,-3,420,1387,10
15823732971,15823732978,7,980,1341,10
15826038233,15826038234,1,1274,2297,10
15829047486,15829047485,-1,917,1728,10
15830765086,15830765084,-2,1563,2451,10
15831667979,15831667978,-1,1369,1892,10
15832725758,15832725755,-3,1268,2117,10
15839125438,15839125437,-1,1752,2349,10
15840160139,15840160145,6,932,1458,10
15842664079,15842664078,-1,1235,1723,10
15846493039,15846493037,-2,1179,1614,10
15847944571,15847944569,-2,1049,1598,10
15854031826,15854031826,0,1275,1802,10
15854551505,15854551504,-1,1385,2182,10
15855132313,15855132314,1,882,2272,10
15860278104,15860278103,-1,1340,2133,10
15861107854,15861107853,-1,894,1835,10
15862878199,15862878197,-2,1281,2246,10
15863463815,15863463815,0,851,1824,10
15865729339,15865729338,-1,1584,2059,10
15866591075,15866591075,0,1220,2169,10
15867157678,15867157678,0,1061,1789,10
15876383268,15876383265,-3,1296,2876,10
15877873994,15877873994,0,640,1680,10
15878074438,15878074443,5,1673,1450,10
15880556679,15880556674,-5,1023,5004,10
15881184257,15881184262,5,2476,1272,10
15881798766,15881798765,-1,1217,2114,10
15889007711,15889007710,-1,811,2704,10
15890235055,15890235051,-4,1231,1672,10
15890453356,15890453356,0,1765,2368,10
15892948106,15892948102,-4,1449,2409,10
15895869655,15895869657,2,1300,1800,10
15903534786,15903534785,-1,1099,1122,10
15905490746,15905490741,-5,836,2211,10
15914100804,15914100800,-4,641,1917,10
15914703149,15914703147,-2,1520,2584,10
15915480922,15915480923,1,1280,1932,10
15917513045,15917513042,-3,899,2271,10
15926053223,15926053223,0,803,1865,10
15927210933,15927210927,-6,1650,3924,10
15928081113,15928081112,-1,1992,3012,10
15929903647,15929903647,0,825,2177,10
15930479918,15930479917,-1,1890,2267,10
15931952087,15931952089,2,3431,2090,10
15933858611,15933858608,-3,1373,2541,10
15943315646,15943315655,9,10390,37436,10
15951986318,15951986322,4,1084,1946,10
15957432894,15957432893,-1,1894,3434,10
15958828009,15958828006,-3,1048,2193,10
15958857990,15958857989,-1,1101,1462,10
15960416667,15960416667,0,1988,2267,10
15962053839,15962053838,-1,1017,1844,10
15962810998,15962810995,-3,916,2396,10
15966769146,15966769147,1,1333,1531,10
15967642114,15967642111,-3,1020,1641,10
15968272170,15968272169,-1,1064,1378,10
15968887886,15968887886,0,1421,2377,10
15974374055,15974374054,-1,1008,1767,10
15975604182,15975604181,-1,1349,2507,10
15977273642,15977273641,-1,1353,2097,10
15979036739,15979036739,0,869,1041,10
15980018570,15980018569,-1,1198,1681,10
15983799434,15983799434,0,1429,2413,10
15984651350,15984651349,-1,1367,2032,10
15985824797,15985824797,0,1047,1882,10
15995072372,15995072370,-2,1195,1926,10
15996437847,15996437852,5,2772,2033,10
16003823554,16003823554,0,755,1201,10
16004346389,16004346387,-2,1055,2680,10
16006860882,16006860878,-4,1532,2319,10
16007728521,16007728518,-3,826,1595,10
16008788675,16008788674,-1,990,1992,10
16013189506,16013189509,3,1963,1419,10
16019471831,16019471829,-2,744,1636,10
16020404182,16020404182,0,1289,2767,10
16020520199,16020520199,0,1082,1525,10
16027942050,16027942051,1,1352,1629,10
16028602915,16028602914,-1,1763,3444,10
16032836709,16032836711,2,1502,1349,10
16034932546,16034932542,-4,1391,1858,10
16035913313,16035913318,5,9926,27944,10
16036342347,16036342344,-3,874,2262,10
16038010554,16038010573,19,499,1106,10
16040645558,16040645560,2,1202,1581,10
16041258843,16041258842,-1,1331,2250,10
16044605415,16044605414,-1,1597,1692,10
16044672522,16044672519,-3,944,1803,10
16044960452,16044960470,18,199,994,10
16047141874,16047141873,-1,995,1823,10
16051168566,16051168562,-4,2595,7197,10
16054762915,16054762914,-1,1044,2242,10
16055294706,16055294725,19,773,1159,10
16058866266,16058866266,0,1356,1894,10
16063169476,16063169474,-2,1133,2072,10
16063654854,16063654851,-3,1272,1502,10
16064998095,16064998093,-2,1601,1919,10
16067339929,16067339926,-3,1634,2421,10
16068051163,16068051161,-2,1029,2248,10
16071803130,16071803122,-8,1432,5790,10
16073447395,16073447391,-4,1226,2152,10
16075500621,16075500621,0,1358,2382,10
16079577838,16079577835,-3,779,1460,10
16085193130,16085193129,-1,1009,2147,10
16085958039,16085958034,-5,867,4183,10
16087404993,16087404992,-1,2055,2310,10
16091446438,16091446437,-1,1012,2048,10
16092896207,16092896204,-3,1457,1764,10
16100312287,16100312291,4,1694,1808,10
16100560288,16100560286,-2,1308,3167,10
16104556170,16104556186,16,589,2572,10
16104672290,16104672287,-3,1264,2944,10
16106117828,16106117827,-1,1001,1558,10
16107069749,16107069750,1,1425,2210,10
16107308938,16107308941,3,7807,6894,10
16115046988,16115046985,-3,1454,2029,10
16115254131,16115254121,-10,1525,3211,10
16119186859,16119186854,-5,1666,5761,10
16121086522,16121086519,-3,905,962,10
16122355707,16122355706,-1,1028,1293,10
16123318520,16123318520,0,981,986,10
16127333640,16127333639,-1,575,1238,10
16129405559,16129405559,0,801,1296,10
16136921795,16136921793,-2,1448,2535,10
16138463582,16138463579,-3,918,1895,10
16139179751,16139179750,-1,1948,2517,10
16144170138,16144170146,8,11141,44886,10
16145116378,16145116375,-3,1543,1958,10
16146336873,16146336873,0,831,1593,10
16148175262,16148175262,0,1316,2316,10
16148314912,16148314903,-9,1209,1530,10
16155949461,16155949463,2,24244,23907,10
16159014452,16159014450,-2,1438,2407,10
16159222774,16159222773,-1,1243,2055,10
16167685431,16167685431,0,1036,1345,10
16168454239,16168454236,-3,906,2125,10
16170407070,16170407070,0,968,1982,10
16173114321,16173114318,-3,894,3567,10
16175318451,16175318449,-2,1316,2109,10
16175890703,16175890702,-1,930,1820,10
16177065614,16177065610,-4,578,1323,10
16180126619,16180126619,0,1198,2648,10
16181857246,16181857245,-1,791,2885,10
16183883364,16183883359,-5,813,1576,10
16185669558,16185669557,-1,1130,2446,10
16186031895,16186031893,-2,1217,3196,10
16186070895,16186070896,1,1285,1615,10
16186906205,16186906202,-3,1380,2220,10
16187489410,16187489416,6,2288,930,10
16189774006,16189774013,7,1844,1040,10
16190677337,16190677337,0,948,2634,10
16191314455,16191314454,-1,1738,3286,10
16191940684,16191940702,18,581,1367,10
16192904016,16192904014,-2,1178,2119,10
16195115255,16195115236,-19,1829,1245,10
16195151479,16195151477,-2,1096,1886,10
16196810542,16196810541,-1,939,2754,10
16197497347,16197497367,20,778,939,10
16199959063,16199959059,-4,943,2392,10
16200679290,16200679293,3,1766,2367,10
16201517671,16201517667,-4,1515,2848,10
16206273159,16206273157,-2,1080,1854,10
16209417146,16209417149,3,6254,3642,10
16217110222,16217110218,-4,1236,1304,10
16217696731,16217696730,-1,639,1139,10
16220178671,16220178670,-1,1005,1422,10
16221671030,16221671032,2,1495,1872,10
16226722227,16226722227,0,1481,2619,10
16227900906,16227900904,-2,917,1558,10
16228600960,16228600959,-1,1185,2908,10
16230614417,16230614419,2,35481,39302,10
16235513155,16235513154,-1,1372,1845,10
16235776946,16235776946,0,1045,1622,10
16236139053,16236139050,-3,1194,1429,10
16237974059,16237974058,-1,563,1455,10
16238163059,16238163079,20,335,1141,10
16242915209,16242915207,-2,1495,1573,10
16243274035,16243274033,-2,1206,1665,10
16244141304,16244141303,-1,1229,2488,10
16246473364,16246473363,-1,1214,1827,10
16248184634,16248184634,0,1682,1934,10
16250773794,16250773793,-1,1194,1309,10
16251576610,16251576609,-1,1328,3133,10
16256622941,16256622941,0,1565,2435,10
16257306049,16257306051,2,249,2536,10
16258790330,16258790314,-16,1184,2223,10
16263974983,16263974982,-1,1067,1765,10
16266486331,16266486329,-2,1440,2539,10
16267352431,16267352429,-2,1473,2036,10
16269477142,16269477140,-2,798,1606,10
16272049368,16272049366,-2,993,1734,10
16273828738,16273828738,0,902,1829,10
16277803366,16277803366,0,1074,1343,10
16281103883,16281103882,-1,1217,2124,10
16284095466,16284095463,-3,1077,1759,10
16289115129,16289115128,-1,1471,1603,10
16290343177,16290343174,-3,1008,2188,10
16292297909,16292297906,-3,1550,1788,10
16295889121,16295889118,-3,957,2337,10
16297032865,16297032862,-3,1053,1090,10
16297931627,16297931626,-1,1251,1399,10
16298811491,16298811489,-2,1094,2196,10
16305737759,16305737755,-4,1115,1631,10
16310119714,16310119713,-1,1854,2809,10
16310941146,16310941146,0,1177,1459,10
16311915764,16311915777,13,637,2098,10
16312141427,16312141425,-2,1080,2309,10
16316070890,16316070888,-2,1074,1767,10
16319353215,16319353214,-1,1135,1733,10
16321046043,16321046044,1,1195,2320,10
16321635007,16321635007,0,851,1960,10
16323470903,16323470897,-6,2062,10282,10
16327315549,16327315548,-1,839,1506,10
16328765200,16328765199,-1,1569,1838,10
16329423251,16329423248,-3,681,1686,10
16331044659,16331044657,-2,1193,1890,10
16333476889,16333476886,-3,918,1685,10
16336330754,16336330757,3,36698,25803,10
16337792329,16337792330,1,3746,3478,10
16339729866,16339729865,-1,975,1374,10
16340972676,16340972674,-2,1306,1918,10
16341926165,16341926162,-3,1268,2167,10
16346651474,16346651473,-1,1376,2233,10
16347765451,16347765446,-5,1066,2806,10
16348137079,16348137077,-2,1079,1747,10
16349615258,16349615252,-6,2567,7385,10
16350625257,16350625253,-4,2109,5552,10
16357114394,16357114394,0,1253,1665,10
16358835978,16358835974,-4,1268,1768,10
16368561466,16368561466,0,1747,1854,10
16369491134,16369491133,-1,1164,2636,10
16374117859,16374117874,15,854,1985,10
16379597147,16379597144,-3,1256,1912,10
16382115133,16382115140,7,5693,2287,10
16384674895,16384674909,14,1304,1803,10
16384772897,16384772897,0,1158,2241,10
16385732702,16385732698,-4,960,1704,10
16392062038,16392062038,0,889,1433,10
16392417421,16392417420,-1,1383,2021,10
16392823989,16392823989,0,1691,1922,10
16395081061,16395081059,-2,1239,1628,10
16398665818,16398665818,0,827,1295,10
16401145290,16401145290,0,1524,2120,10
16402511313,16402511311,-2,1287,2030,10
16405428232,16405428230,-2,1029,2274,10
16405902142,16405902140,-2,1263,2222,10
16408159893,16408159896,3,1482,1461,10
16409350518,16409350519,1,1023,822,10
16410921669,16410921670,1,3761,3697,10
16411263278,16411263291,13,18316,32268,10
16412787487,16412787487,0,1409,2354,10
16413769032,16413769030,-2,1133,2552,10
16413925547,16413925545,-2,1440,2114,10
16415215007,16415215012,5,2538,1739,10
16417010615,16417010613,-2,1163,2175,10
16418564206,16418564201,-5,1061,2548,10
16420400910,16420400910,0,1609,2098,10
16424457514,16424457515,1,1332,2226,10
16425028408,16425028409,1,1147,1603,10
16432403966,16432403962,-4,1514,2405,10
16437371975,16437371974,-1,1014,2049,10
16444067230,16444067228,-2,952,2179,10
16446140427,16446140424,-3,1016,1717,10
16447629783,16447629770,-13,10063,39640,10
16447662858,16447662858,0,1795,1440,10
16447711939,16447711937,-2,1531,1626,10
16452618194,16452618191,-3,1296,2110,10
16453705411,16453705409,-2,1185,1555,10
16453815067,16453815066,-1,1272,1732,10
16462649589,16462649590,1,741,1240,10
16465139127,16465139125,-2,799,1161,10
16465166197,16465166195,-2,1221,2187,10
16467109486,16467109486,0,956,1597,10
16467930595,16467930572,-23,1022,1790,10
16470206111,16470206110,-1,1213,1642,10
16472092188,16472092187,-1,1249,1896,10
16472380467,16472380465,-2,2125,4970,10
16475190310,16475190309,-1,703,1426,10
16478922387,16478922385,-2,879,2480,10
16479651107,16479651104,-3,1157,2913,10
16483735397,16483735397,0,1446,2460,10
16489041054,16489041051,-3,1329,2168,10
16489228851,16489228843,-8,1141,2106,10
16491596051,16491596050,-1,1088,1727,10
16492924681,16492924678,-3,984,1170,10
16493226067,16493226067,0,1041,1945,10
16493519042,16493519041,-1,1430,2250,10
16494320070,16494320073,3,1298,820,10
16495851832,16495851831,-1,1161,1285,10
16497775426,16497775423,-3,1350,2220,10
16499820769,16499820774,5,1798,627,10
16500248311,16500248310,-1,1609,2093,10
16503669066,16503669064,-2,945,2273,10
16503710098,16503710098,0,1396,2442,10
16504911653,16504911651,-2,1222,1887,10
16507045644,16507045642,-2,1345,1776,10
16508159669,16508159671,2,2617,3471,10
16509434649,16509434647,-2,791,1682,10
16510378762,16510378762,0,1249,1422,10
16510571125,16510571125,0,1343,2262,10
16512462344,16512462325,-19,701,1817,10
16518274780,16518274778,-2,1487,2075,10
16521857859,16521857859,0,937,1684,10
16522362862,16522362863,1,1301,1542,10
16524107297,16524107295,-2,1421,2038,10
16524642230,16524642231,1,1370,1486,10
16524884845,16524884842,-3,1025,2419,10
16528034886,16528034886,0,742,1063,10
16529576854,16529576854,0,738,1176,10
16529738501,16529738499,-2,959,1958,10
16533080558,16533080557,-1,1499,1727,10
16534015667,16534015667,0,1091,1407,10
16536834085,16536834082,-3,1107,2398,10
16537364264,16537364285,21,1000,2503,10
16545090129,16545090129,0,1151,1704,10
16549307097,16549307095,-2,1267,2337,10
16555554930,16555554930,0,1851,1697,10
16556689471,16556689469,-2,1102,1677,10
16560068497,16560068496,-1,1442,1295,10
16566708351,16566708350,-1,1335,1738,10
16569010989,16569010985,-4,1398,1878,10
16570548548,16570548546,-2,835,1879,10
16574268289,16574268294,5,2868,1663,10
16575640403,16575640401,-2,1126,1392,10
16576394811,16576394813,2,765,1025,10
16576809311,16576809310,-1,1939,2481,10
16578981303,16578981302,-1,1593,2572,10
16580485127,16580485122,-5,1129,2648,10
16582016659,16582016659,0,1176,1677,10
16582891098,16582891098,0,1137,1726,10
16585902090,16585902090,0,876,1294,10
16588897062,16588897063,1,1077,1481,10
16590529230,16590529230,0,1349,1819,10
16590994004,16590994002,-2,1017,1333,10
16596406493,16596406490,-3,1256,2376,10
16606702869,16606702865,-4,58971,31786,10
16607072677,16607072675,-2,1013,2019,10
16612209541,16612209538,-3,809,1366,10
16612602108,16612602127,19,1329,1873,10
16612735347,16612735333,-14,1035,2015,10
16616128508,16616128506,-2,1032,1270,10
16619126786,16619126784,-2,1392,2154,10
16621762142,16621762138,-4,1237,1792,10
16623020586,16623020584,-2,1524,2178,10
16624749456,16624749452,-4,1346,2582,10
16625469223,16625469222,-1,1361,2158,10
16627510973,16627510973,0,1734,1785,10
16627867941,16627867942,1,1301,2207,10
16628098377,16628098378,1,1074,1283,10
16631803792,16631803810,18,1287,1477,10
16632326882,16632326882,0,933,1247,10
16635235176,16635235194,18,301,984,10
16636423425,16636423426,1,1447,2156,10
16636796819,16636796819,0,1260,1844,10
16637483715,16637483713,-2,1365,2197,10
16641169034,16641169034,0,1091,1525,10
16645438529,16645438526,-3,1283,2309,10
16652240934,16652240932,-2,1391,1963,10
16652558379,16652558380,1,1632,1815,10
16653321694,16653321694,0,833,1511,10
16653934049,16653934046,-3,1336,2933,10
16654328878,16654328876,-2,801,2116,10
16657755465,16657755464,-1,1682,1782,10
16665728102,16665728100,-2,1219,2254,10
16669523987,16669523986,-1,1190,1406,10
16673692715,16673692712,-3,1384,2197,10
16680649787,16680649786,-1,1356,1856,10
16680919639,16680919623,-16,1067,1202,10
16683520243,16683520240,-3,953,2140,10
16688096795,16688096793,-2,1656,1631,10
16689814665,16689814670,5,1832,671,10
16689900941,16689900942,1,924,1558,10
16690590263,16690590262,-1,2062,2403,10
16692760523,16692760522,-1,1533,1574,10
16699531254,16699531253,-1,1200,1690,10
16701531907,16701531906,-1,1085,1857,10
16704595779,16704595778,-1,1609,2242,10
16706198861,16706198861,0,1690,2528,10
16707541370,16707541369,-1,1552,2650,10
16715250286,16715250286,0,1104,2130,10
16720513810,16720513807,-3,1426,3115,10
16721349466,16721349465,-1,974,2504,10
16721976463,16721976461,-2,960,1981,10
16722475836,16722475835,-1,18523,10981,10
16722954548,16722954550,2,3293,4162,10
16724156613,16724156618,5,19082,46143,10
16726149039,16726149039,0,1639,2576,10
16730743717,16730743715,-2,1272,2621,10
16736192310,16736192310,0,1276,1174,10
16739015609,16739015607,-2,1363,2145,10
16740385217,16740385217,0,1972,2405,10
16742121741,16742121738,-3,1435,1778,10
16743088175,16743088173,-2,1132,2263,10
16744300199,16744300194,-5,692,2217,10
16750321420,16750321418,-2,1318,2269,10
16755484690,16755484690,0,967,1335,10
16755524173,16755524173,0,1168,2762,10
16756802118,16756802118,0,952,2023,10
16757215900,16757215917,17,276,1299,10
16758581127,16758581125,-2,1534,2314,10
16761421262,16761421262,0,883,1497,10
16762129536,16762129539,3,1744,1595,10
16762183119,16762183126,7,4036,2493,10
16771558480,16771558480,0,947,1581,10
16775043391,16775043389,-2,1292,1691,10
16781728894,16781728899,5,4242,2904,10
16783006372,16783006371,-1,1139,1708,10
16787803662,16787803661,-1,1064,2174,10
16789443022,16789443028,6,1934,1702,10
16793090791,16793090789,-2,1405,2186,10
16794565820,16794565818,-2,1121,2146,10
16797208887,16797208869,-18,277,792,10
16799273777,16799273774,-3,945,2284,10
16800273346,16800273345,-1,1203,2334,10
16804469192,16804469191,-1,1247,1535,10
16805477617,16805477615,-2,1135,2359,10
16806461786,16806461782,-4,1525,2332,10
16809039637,16809039637,0,1147,2080,10
16809798860,16809798858,-2,1248,2671,10
16810214897,16810214886,-11,901,1774,10
16812200399,16812200397,-2,1418,2211,10
16813314057,16813314054,-3,1172,1546,10
16815148546,16815148542,-4,605,1811,10
16822602518,16822602517,-1,999,1905,10
16824462627,16824462623,-4,1006,2229,10
16824987146,16824987138,-8,1119,1669,10
16827952642,16827952641,-1,1332,1751,10
16828350441,16828350461,20,1419,1969,10
16831939680,16831939684,4,25088,22675,10
16832191178,16832191175,-3,1459,2595,10
16839375571,16839375570,-1,1104,2568,10
16842620359,16842620355,-4,895,1140,10
16846952174,16846952174,0,1235,2331,10
16849131546,16849131546,0,1151,1632,10
16849798615,16849798615,0,889,1557,10
16850168842,16850168842,0,1533,2727,10
16850227258,16850227254,-4,1064,2470,10
16850644689,16850644711,22,816,1657,10
16862207007,16862207007,0,1146,1581,10
16862553764,16862553771,7,5294,1085,10
16863701749,16863701749,0,905,1113,10
16866381970,16866381970,0,1158,1967,10
16871163751,16871163751,0,958,1708,10
16871268398,16871268411,13,14909,35722,10
16872959761,16872959762,1,1336,2149,10
16876545034,16876545034,0,997,2243,10
16877532075,16877532074,-1,1319,2434,10
16877859110,16877859110,0,1169,1737,10
16879465244,16879465241,-3,1035,1285,10
16882793953,16882793975,22,4190,1907,10
16886503771,16886503770,-1,1342,2305,10
16888093170,16888093170,0,1208,1569,10
16889726450,16889726451,1,1277,1261,10
16894532003,16894532003,0,1233,2300,10
16903313308,16903313306,-2,1393,1827,10
16904168086,16904168087,1,492,5,10
16908035215,16908035213,-2,1218,1943,10
16910973591,16910973589,-2,951,2196,10
16911810538,16911810540,2,1144,1836,10
16912349547,16912349546,-1,1256,2653,10
16912634301,16912634298,-3,1045,2439,10
16913113841,16913113839,-2,1339,2078,10
16914902650,16914902650,0,1562,2553,10
16916894509,16916894505,-4,976,2494,10
16918653067,16918653066,-1,1031,1540,10
16919043102,16919043099,-3,930,1024,10
16919391051,16919391051,0,1122,2351,10
16922249222,16922249222,0,1344,2144,10
16924501773,16924501771,-2,1134,2121,10
16927331903,16927331900,-3,1401,2524,10
16928675195,16928675196,1,1452,1967,10
16928775194,16928775203,9,1361,1706,10
16929764372,16929764378,6,4690,2563,10
16930187782,16930187780,-2,1574,2462,10
16935874521,16935874517,-4,1310,2383,10
16937098978,16937098977,-1,1465,2415,10
16937906289,16937906285,-4,1570,2182,10
16939575629,16939575630,1,34015,34294,10
16941501265,16941501265,0,1127,1411,10
16948728175,16948728182,7,1711,1401,10
16949542230,16949542229,-1,1295,2446,10
16950623985,16950623982,-3,1216,2120,10
16954250350,16954250348,-2,1334,1840,10
16954325242,16954325239,-3,1227,1989,10
16954773297,16954773297,0,1042,2114,10
16956481243,16956481241,-2,1119,1569,10
16956823993,16956823992,-1,1359,2098,10
16956997991,16956997994,3,1194,1370,10
16957537539,16957537554,15,262,1049,10
16957805966,16957805948,-18,1217,2267,10
16957978703,16957978702,-1,1416,2663,10
16958052342,16958052338,-4,1118,1494,10
16958706755,16958706758,3,1397,1312,10
16962157230,16962157226,-4,1181,1922,10
16962764554,16962764551,-3,1229,2158,10
16963022781,16963022787,6,1917,1039,10
16965755231,16965755227,-4,949,1622,10
16970658111,16970658111,0,1196,1580,10
16975069872,16975069869,-3,1281,2211,10
16978614242,16978614246,4,677,643,10
16979840473,16979840471,-2,1329,2804,10
16981287882,16981287878,-4,996,2267,10
16981326555,16981326554,-1,1093,1919,10
16985084217,16985084215,-2,2354,3074,10
16986021249,16986021249,0,990,1670,10
16986441796,16986441802,6,3599,1844,10
16986546846,16986546846,0,1491,2198,10
16987613756,16987613754,-2,1198,2272,10
16989713346,16989713346,0,1647,1692,10
16989776362,16989776361,-1,1198,1388,10
16992263475,16992263473,-2,1192,1561,10
16996024912,16996024913,1,1416,2141,10
16999089411,16999089409,-2,1376,1363,10
17001161361,17001161361,0,1404,1077,10
17005136189,17005136187,-2,1478,1615,10
17008001518,17008001517,-1,735,1252,10
17011807521,17011807518,-3,1391,2861,10
17012084859,17012084859,0,1673,3308,10
17012518431,17012518431,0,957,930,10
17014585166,17014585163,-3,1111,2140,10
17015816225,17015816225,0,1265,1787,10
17016808201,17016808198,-3,1378,2199,10
17018109950,17018109951,1,1110,1437,10
17018438918,17018438916,-2,2183,2962,10
17018481037,17018481034,-3,1042,1976,10
17021189335,17021189335,0,687,1786,10
17025998274,17025998273,-1,1600,2078,10
17027866815,17027866819,4,535,977,10
17029358663,17029358662,-1,1526,2047,10
17029843438,17029843438,0,1219,1770,10
17030068061,17030068060,-1,1624,1523,10
17032537397,17032537394,-3,1213,2093,10
17033532977,17033532975,-2,1039,1494,10
17034977683,17034977679,-4,924,1798,10
17036697447,17036697444,-3,1319,2386,10
17037010488,17037010486,-2,1477,2788,10
17040226562,17040226558,-4,1080,2223,10
17040885561,17040885561,0,1459,2032,10
17043255195,17043255194,-1,4680,7881,10
17044027091,17044027090,-1,1267,1760,10
17046680963,17046680962,-1,1189,2036,10
17049103847,17049103845,-2,1046,1504,10
17049796473,17049796472,-1,1358,2885,10
17051805487,17051805486,-1,923,1746,10
17054314905,17054314903,-2,1220,1844,10
17058087211,17058087210,-1,802,1117,10
17060856814,17060856813,-1,1775,2306,10
17062098118,17062098118,0,1917,2149,10
17063866207,17063866206,-1,1348,1726,10
17064120984,17064120982,-2,1199,2107,10
17064841089,17064841089,0,1280,1574,10
17066319177,17066319178,1,1463,1494,10
17066388690,17066388690,0,1041,1530,10
17066626041,17066626040,-1,1943,1480,10
17068839378,17068839377,-1,1728,1915,10
17069989658,17069989655,-3,1461,2375,10
17070644897,17070644895,-2,1237,2274,10
17077646799,17077646799,0,893,1433,10
17078452795,17078452799,4,4839,2453,10
17083572850,17083572846,-4,1329,2057,10
17083605997,17083605999,2,3132,1849,10
17086605491,17086605488,-3,1342,2066,10
17088167050,17088167067,17,15058,23561,10
17088298669,17088298671,2,1833,1867,10
17091087450,17091087449,-1,1323,2362,10
17091972607,17091972607,0,965,2081,10
17101867302,17101867301,-1,1133,1823,10
17101966674,17101966672,-2,1207,2168,10
17103549555,17103549554,-1,1120,2209,10
17105217707,17105217705,-2,2507,4147,10
17106899893,17106899892,-1,1424,2162,10
17112554604,17112554602,-2,1136,1108,10
17112832823,17112832823,0,1430,2145,10
17113010517,17113010517,0,1782,2104,10
17114338477,17114338475,-2,1318,1786,10
17118532386,17118532385,-1,1137,2033,10
17126281707,17126281705,-2,1359,2152,10
17128195217,17128195214,-3,1375,2213,10
17128964426,17128964424,-2,1240,2193,10
17130463455,17130463454,-1,1485,2125,10
17133934595,17133934595,0,928,1969,10
17134212106,17134212089,-17,1429,2211,10
17134792262,17134792261,-1,888,2718,10
17136910866,17136910866,0,1547,2528,10
17140945786,17140945785,-1,961,1263,10
17141581308,17141581325,17,915,1936,10
17142638866,17142638864,-2,1189,2341,10
17145395233,17145395232,-1,921,1983,10
17159541773,17159541773,0,1398,1680,10
17160067552,17160067554,2,864,814,10
17161220443,17161220445,2,1775,2054,10
17163144685,17163144682,-3,1196,2140,10
17166781541,17166781546,5,4180,2349,10
17169775604,17169775602,-2,857,1790,10
17172293710,17172293709,-1,1288,2243,10
17173170007,17173170006,-1,1335,2063,10
17173374502,17173374502,0,1547,2029,10
17177153431,17177153428,-3,588,2406,10
17179049041,17179049039,-2,979,2211,10
17179338127,17179338130,3,1357,1663,10
17179372099,17179372098,-1,1276,2334,10
17179857058,17179857055,-3,1207,2208,10
17183566998,17183566994,-4,1672,1552,10
17189644385,17189644387,2,3698,3050,10
17190914126,17190914123,-3,1020,2441,10
17191878671,17191878671,0,1347,1927,10
17193166718,17193166717,-1,1280,2218,10
17198126297,17198126297,0,1829,3239,10
17199992494,17199992492,-2,1332,1261,10
17201579490,17201579490,0,1142,1996,10
17204551843,17204551842,-1,1073,2037,10
17205589082,17205589101,19,611,1548,10
17206287134,17206287133,-1,1232,2894,10
17206333284,17206333303,19,486,1036,10
17209504630,17209504626,-4,1089,2183,10
17210346592,17210346590,-2,1561,2641,10
17211727674,17211727675,1,1674,1758,10
17212169042,17212169042,0,1111,1256,10
17213047286,17213047286,0,959,1756,10
17214314330,17214314330,0,1207,1931,10
17214498276,17214498289,13,1320,1730,10
17216412390,17216412390,0,1387,2120,10
17219060247,17219060250,3,3599,3087,10
17223852774,17223852770,-4,1915,3282,10
17224897494,17224897494,0,1294,1717,10
17225517551,17225517550,-1,1129,1358,10
17226405691,17226405690,-1,1100,1241,10
17231208750,17231208749,-1,922,2099,10
17231325759,17231325757,-2,1320,1594,10
17231432939,17231432939,0,738,1328,10
17234432099,17234432098,-1,824,1141,10
17242889431,17242889427,-4,1240,2084,10
17243588089,17243588087,-2,1174,1784,10
17248404961,17248404962,1,1516,1867,10
17258782227,17258782229,2,1693,1428,10
17265800447,17265800441,-6,1079,7245,10
17266742005,17266742011,6,3236,2030,10
17269176605,17269176608,3,1324,1570,10
17269266747,17269266746,-1,1348,2725,10
17271384348,17271384347,-1,1787,3796,10
17272614359,17272614358,-1,1171,2343,10
17273502842,17273502840,-2,1260,2340,10
17274948785,17274948784,-1,889,1532,10
17286216020,17286216018,-2,1100,2752,10
17289562694,17289562696,2,1198,2332,10
17290019758,17290019762,4,2171,942,10
17290784966,17290784966,0,1912,2153,10
17291815530,17291815529,-1,1752,2354,10
17294478681,17294478679,-2,1280,2024,10
17294602589,17294602588,-1,1697,2023,10
17296992689,17296992687,-2,1372,2302,10
17297325275,17297325278,3,1609,1649,10
17297651369,17297651367,-2,1242,2465,10
17299399336,17299399335,-1,1373,2136,10
17302396418,17302396415,-3,942,2699,10
17302766621,17302766626,5,2723,1469,10
17308299878,17308299877,-1,1389,1481,10
17313772449,17313772447,-2,1174,2117,10
17318026052,17318026053,1,1459,1836,10
17318660055,17318660054,-1,1038,1713,10
17319771011,17319771006,-5,1042,1686,10
17320475982,17320475982,0,1554,2163,10
17320859731,17320859731,0,990,1545,10
17323988036,17323988033,-3,2015,2690,10
17327238173,17327238172,-1,1196,1610,10
17330406516,17330406515,-1,1044,1891,10
17332740796,17332740801,5,1162,1082,10
17335207963,17335207961,-2,1381,2151,10
17340770842,17340770842,0,1480,1783,10
17343994591,17343994598,7,877,666,10
17344267339,17344267339,0,1136,1909,10
17344436958,17344436959,1,1042,2105,10
17347596162,17347596162,0,700,1493,10
17347708217,17347708215,-2,691,1588,10
17348937978,17348937978,0,1059,2097,10
17349798258,17349798257,-1,1038,1749,10
17350182201,17350182200,-1,1634,2106,10
17351521233,17351521231,-2,1567,1966,10
17357367350,17357367349,-1,1505,1931,10
17358608106,17358608104,-2,1160,1958,10
17362793082,17362793082,0,1249,1779,10
17365558749,17365558746,-3,1316,1351,10
17366988634,17366988632,-2,1084,2875,10
17373453539,17373453538,-1,1531,2401,10
17380688646,17380688646,0,1298,2025,10
17382770080,17382770081,1,1121,1434,10
17388263581,17388263578,-3,1880,2627,10
17394865878,17394865879,1,1147,1578,10
17403254280,17403254278,-2,1005,1239,10
17404696560,17404696561,1,1279,2096,10
17408275671,17408275670,-1,1183,1988,10
17414305467,17414305467,0,1248,1024,10
17414356688,17414356680,-8,14826,19310,10
17418476956,17418476955,-1,1030,1864,10
17421669397,17421669397,0,1265,2083,10
17427926889,17427926888,-1,1836,1686,10
17428179410,17428179406,-4,1596,2899,10
17429059222,17429059222,0,1622,1662,10
17435154239,17435154237,-2,1013,2016,10
17439621673,17439621672,-1,927,1607,10
17440771273,17440771270,-3,957,1976,10
17441016913,17441016907,-6,784,1537,10
17442373713,17442373712,-1,1543,2211,10
17443470298,17443470314,16,787,1332,10
17443693763,17443693761,-2,1377,1667,10
17444553634,17444553633,-1,1105,1759,10
17444872187,17444872186,-1,1299,2151,10
17447338383,17447338381,-2,1077,1444,10
17450305422,17450305421,-1,2179,2429,10
17453727472,17453727471,-1,840,1826,10
17453835739,17453835740,1,1144,1562,10
17454930824,17454930821,-3,1558,2670,10
17455758750,17455758750,0,921,1396,10
17461773916,17461773914,-2,1614,2131,10
17462214443,17462214442,-1,679,997,10
17463758199,17463758193,-6,2406,6853,10
17464257549,17464257551,2,737,1286,10
17465326849,17465326847,-2,1477,2002,10
17465673659,17465673658,-1,1336,2589,10
17468112833,17468112830,-3,1596,2065,10
17471353648,17471353646,-2,1716,2120,10
17480466598,17480466599,1,1198,2584,10
17482323221,17482323220,-1,897,1763,10
17485352586,17485352596,10,12988,38273,10
17485908532,17485908531,-1,1195,1773,10
17487269362,17487269361,-1,2309,2223,10
17488995626,17488995622,-4,900,1952,10
17491193775,17491193779,4,795,1662,10
17492009047,17492009042,-5,1248,2112,10
17492336422,17492336421,-1,1656,1653,10
17492449153,17492449149,-4,869,2008,10
17494335811,17494335809,-2,724,1570,10
17494930791,17494930789,-2,1435,1441,10
17498772689,17498772685,-4,1134,3205,10
17499568773,17499568770,-3,1389,1672,10
17500651195,17500651213,18,874,1417,10
17503530030,17503530028,-2,763,1129,10
17504619589,17504619586,-3,1202,1669,10
17510508645,17510508646,1,1256,1663,10
17511315455,17511315454,-1,1062,1272,10
17512005178,17512005177,-1,1909,2365,10
17513888015,17513888014,-1,1014,2322,10
17516669086,17516669086,0,1223,2271,10
17518684320,17518684318,-2,1194,2701,10
17523629383,17523629381,-2,1229,1972,10
17523790252,17523790269,17,812,1699,10
17524556525,17524556526,1,1090,1730,10
17531035397,17531035395,-2,1082,2046,10
17532169751,17532169749,-2,980,1154,10
17534581277,17534581277,0,900,1985,10
17535056603,17535056600,-3,956,2782,10
17537514388,17537514386,-2,1413,2176,10
17539417996,17539417993,-3,1131,1090,10
17546282910,17546282910,0,1235,2008,10
17548034405,17548034402,-3,1440,2053,10
17550058230,17550058229,-1,818,1417,10
17552000888,17552000886,-2,1271,2218,10
17553236733,17553236730,-3,874,1547,10
17553815094,17553815092,-2,859,2578,10
17554871758,17554871758,0,1387,2501,10
17555008421,17555008425,4,4547,3249,10
17555129731,17555129734,3,1018,1461,10
17555587482,17555587481,-1,1178,1735,10
17556121537,17556121535,-2,1078,2745,10
17557381465,17557381453,-12,749,2080,10
17558899665,17558899666,1,863,1179,10
17564661085,17564661084,-1,975,2224,10
17570337941,17570337936,-5,1688,2945,10
17571809890,17571809887,-3,1718,3160,10
17573372342,17573372340,-2,858,1431,10
17574260136,17574260137,1,1931,1802,10
17575577418,17575577417,-1,721,1509,10
17576363742,17576363742,0,1320,2240,10
17580772786,17580772785,-1,1106,1813,10
17582289179,17582289178,-1,884,1853,10
17587426098,17587426098,0,1389,1838,10
17590204772,17590204779,7,3165,1052,10
17597843286,17597843283,-3,1096,1777,10
17598335533,17598335532,-1,1297,1747,10
17602544071,17602544069,-2,1206,1769,10
17605693638,17605693638,0,1139,1626,10
17615409688,17615409689,1,1571,1748,10
17618726986,17618726985,-1,1015,1769,10
17622712445,17622712443,-2,1485,2136,10
17623092718,17623092716,-2,817,1216,10
17624770438,17624770438,0,1579,1867,10
17624893827,17624893827,0,984,1332,10
17625437802,17625437800,-2,1372,1765,10
17627872155,17627872154,-1,969,2297,10
17628149074,17628149073,-1,1911,2295,10
17628641926,17628641923,-3,1295,2068,10
17628780618,17628780618,0,1616,1939,10
17630867135,17630867134,-1,1191,2201,10
17632710410,17632710410,0,1470,1909,10
17632941194,17632941190,-4,707,1214,10
17635981962,17635981961,-1,1263,2525,10
17636398414,17636398411,-3,1015,2301,10
17636702374,17636702375,1,1612,1657,10
17639433064,17639433064,0,1187,1705,10
17643063490,17643063489,-1,1518,2323,10
17648432041,17648432039,-2,1149,2010,10
17659412330,17659412327,-3,1404,1997,10
17662186641,17662186642,1,1557,2401,10
17663340017,17663340015,-2,1317,1890,10
17666135698,17666135697,-1,782,1633,10
17669770830,17669770830,0,1096,1452,10
17671766682,17671766683,1,875,1033,10
17675620148,17675620143,-5,1369,2373,10
17675771899,17675771898,-1,1643,2715,10
17676894516,17676894522,6,4544,1855,10
17679532354,17679532353,-1,1120,2250,10
17680521138,17680521136,-2,1066,2474,10
17680846291,17680846290,-1,1117,1582,10
17683446705,17683446703,-2,1200,1903,10
17683761787,17683761785,-2,1446,2335,10
17692023359,17692023357,-2,1287,2144,10
17697475479,17697475479,0,1238,2110,10
17698719480,17698719478,-2,1009,2120,10
17702146193,17702146192,-1,1487,2592,10
17703745810,17703745809,-1,1341,1626,10
17704333739,17704333726,-13,1301,2283,10
17706946558,17706946557,-1,1724,2246,10
17707614347,17707614346,-1,1068,2048,10
17708999899,17708999896,-3,736,1626,10
17710376652,17710376650,-2,1406,2366,10
17712138598,17712138597,-1,1729,2740,10
17719376979,17719376978,-1,1234,2176,10
17722075313,17722075320,7,3397,1221,10
17724372078,17724372078,0,1197,2039,10
17724739654,17724739652,-2,1335,2135,10
17731877482,17731877478,-4,1335,1954,10
17732220421,17732220427,6,3176,958,10
17732448919,17732448918,-1,1331,1944,10
17734962094,17734962096,2,1226,2250,10
17736713391,17736713390,-1,1506,2297,10
17737485070,17737485069,-1,1475,1310,10
17737785914,17737785913,-1,1317,2287,10
17741651839,17741651836,-3,732,1410,10
17743030371,17743030371,0,1006,1629,10
17743132836,17743132836,0,1435,2068,10
17746803799,17746803797,-2,861,2223,10
17749613035,17749613034,-1,1260,2868,10
17751432784,17751432783,-1,1416,2085,10
17752498938,17752498938,0,1602,2796,10
17754108291,17754108290,-1,1676,2310,10
17754983222,17754983222,0,786,1859,10
17755829822,17755829821,-1,844,1680,10
17756918800,17756918798,-2,1093,1543,10
17758514764,17758514761,-3,2408,5055,10
17761570474,17761570473,-1,1740,2079,10
17762917481,17762917482,1,844,1481,10
17769130463,17769130463,0,879,1469,10
17769544227,17769544227,0,1178,1636,10
17770933048,17770933046,-2,1355,2324,10
17773822154,17773822153,-1,1079,1830,10
17774303521,17774303520,-1,1053,1868,10
17777661530,17777661529,-1,1149,2282,10
17777989387,17777989386,-1,1233,1914,10
17778418867,17778418885,18,1251,2503,10
17783746618,17783746618,0,1277,1733,10
17784434077,17784434074,-3,1624,2462,10
17786541873,17786541872,-1,1186,1640,10
17788016605,17788016602,-3,1074,1642,10
17789976983,17789976981,-2,1544,1606,10
17792727451,17792727450,-1,989,1055,10
17792757908,17792757890,-18,203,784,10
17795560328,17795560327,-1,1344,2444,10
17798850077,17798850074,-3,1414,2252,10
17801665534,17801665535,1,1419,1868,10
17802009902,17802009900,-2,1306,2509,10
17802907782,17802907780,-2,509,1199,10
17807036585,17807036583,-2,1304,1755,10
17816055587,17816055584,-3,1225,2415,10
17817380426,17817380426,0,1070,2048,10
17818034218,17818034217,-1,759,1918,10
17822368391,17822368391,0,1130,1930,10
17822776847,17822776850,3,560,1466,10
17824878703,17824878702,-1,962,1302,10
17825350042,17825350038,-4,936,1593,10
17827196667,17827196666,-1,819,2270,10
17828763107,17828763106,-1,1298,2105,10
17829419861,17829419861,0,1081,1897,10
17829453346,17829453353,7,15182,30234,10
17834682222,17834682221,-1,1377,2223,10
17835283142,17835283138,-4,1146,2742,10
17841762275,17841762270,-5,1190,5898,10
17843745492,17843745493,1,986,1890,10
17848467466,17848467463,-3,916,3002,10
17853926354,17853926354,0,1181,1219,10
17855427945,17855427943,-2,1446,2757,10
17856029285,17856029285,0,889,1199,10
17859781761,17859781760,-1,1757,2681,10
17861777593,17861777589,-4,57605,26625,10
17863305054,17863305058,4,2884,1994,10
17865008159,17865008159,0,1060,3025,10
17867883370,17867883369,-1,1545,1987,10
17872867147,17872867146,-1,747,1774,10
17876782826,17876782823,-3,1135,1514,10
17883476433,17883476436,3,1821,1438,10
17889078979,17889078978,-1,1678,1855,10
17892473906,17892473907,1,1620,1408,10
17893379128,17893379125,-3,1761,3456,10
17895679733,17895679730,-3,1166,2430,10
17896453748,17896453746,-2,1010,1702,10
17897418762,17897418751,-11,182,922,10
17897894352,17897894353,1,1741,1500,10
17902354695,17902354695,0,1101,1036,10
17904510747,17904510753,6,2941,1836,10
17905948986,17905948986,0,1160,1525,10
17906628291,17906628293,2,1076,1782,10
17909592002,17909591997,-5,936,2004,10
17914654700,17914654699,-1,1060,1304,10
17915859383,17915859383,0,642,865,10
17916510741,17916510740,-1,1301,2250,10
17916940154,17916940155,1,1201,1763,10
17920023957,17920023956,-1,1067,2080,10
17922897453,17922897449,-4,744,2179,10
17926816034,17926816032,-2,1574,2198,10
17931105787,17931105787,0,1197,1452,10
17935347766,17935347772,6,4487,2706,10
17940995336,17940995335,-1,1217,1729,10
17944585022,17944585017,-5,1395,2359,10
17945689497,17945689499,2,2518,1983,10
17946340778,17946340776,-2,1308,1870,10
17946988341,17946988338,-3,1841,4994,10
17948175706,17948175705,-1,1402,2190,10
17949953201,17949953199,-2,1076,1605,10
17950830484,17950830484,0,600,1488,10
17951212152,17951212150,-2,1654,1811,10
17951312266,17951312263,-3,1251,1684,10
17953575899,17953575895,-4,1130,2189,10
17957183680,17957183678,-2,1412,2106,10
17957260973,17957260979,6,1202,514,10
17958272325,17958272323,-2,1173,1420,10
17958605687,17958605686,-1,1918,2075,10
17959784518,17959784517,-1,1262,2003,10
17963127455,17963127454,-1,1233,1541,10
17965060628,17965060626,-2,1028,1725,10
17967692834,17967692832,-2,1231,1239,10
17973995124,17973995111,-13,284,665,10
17974093018,17974093038,20,1557,4952,10
17975363433,17975363434,1,1358,1363,10
17975815155,17975815154,-1,1271,1940,10
17984611505,17984611501,-4,1099,1629,10
17987867124,17987867122,-2,1024,1626,10
17990366697,17990366693,-4,1201,2718,10
17990935967,17990935963,-4,1298,1993,10
17992063846,17992063845,-1,1218,1902,10
17992481119,17992481119,0,1118,1983,10
17995517009,17995517009,0,583,1246,10
17998392216,17998392215,-1,1113,1970,10
17998980721,17998980726,5,2554,1065,10
18002220736,18002220734,-2,648,1433,10
18002657297,18002657296,-1,1486,2051,10
18003694829,18003694840,11,990,1280,10
18006482786,18006482786,0,1370,1357,10
18008207930,18008207917,-13,1094,1686,10
18019307559,18019307558,-1,1203,2017,10
18021615406,18021615405,-1,821,1539,10
18022396488,18022396485,-3,1392,1723,10
18028752446,18028752444,-2,1362,2236,10
18032121823,18032121820,-3,693,1377,10
18032314657,18032314638,-19,974,1840,10
18035631375,18035631374,-1,812,1225,10
18042365130,18042365128,-2,1291,2522,10
18043446288,18043446287,-1,1204,1906,10
18045409104,18045409104,0,1501,1722,10
18046345048,18046345046,-2,1316,1779,10
18049105867,18049105866,-1,852,992,10
18053894973,18053894971,-2,2101,3984,10
18054554229,18054554227,-2,1026,2054,10
18055589937,18055589939,2,42535,31246,10
18058713534,18058713534,0,1086,1628,10
18062288994,18062288994,0,732,1320,10
18066155721,18066155721,0,1157,1988,10
18066211958,18066211962,4,1307,1152,10
18067643455,18067643454,-1,1011,2061,10
18068687310,18068687310,0,1074,2347,10
18069054174,18069054173,-1,638,1797,10
18074363673,18074363671,-2,1345,1552,10
18075266434,18075266429,-5,1197,3359,10
18077780842,18077780848,6,3283,1975,10
18078905923,18078905919,-4,1182,1618,10
18081125227,18081125227,0,1151,2004,10
18084578141,18084578138,-3,840,1735,10
18085386643,18085386649,6,1135,1037,10
18085730546,18085730543,-3,968,2087,10
18088075434,18088075430,-4,1707,2851,10
18088305495,18088305494,-1,787,1846,10
18088491710,18088491709,-1,545,1426,10
18090062992,18090062990,-2,1336,2409,10
18091331554,18091331556,2,1545,1557,10
18093550450,18093550449,-1,1373,2571,10
18097291775,18097291773,-2,1079,2267,10
18097407333,18097407329,-4,1317,2505,10
18098140046,18098140043,-3,1217,1888,10
18099435623,18099435619,-4,1513,2785,10
18102996538,18102996542,4,8612,28468,10
18104717907,18104717903,-4,823,2438,10
18107205334,18107205335,1,1229,1782,10
18107536310,18107536309,-1,1136,2306,10
18107642357,18107642354,-3,1145,1745,10
18108800100,18108800098,-2,1148,1860,10
18110453690,18110453694,4,2331,2137,10
18111733794,18111733796,2,5112,20485,10
18113409273,18113409274,1,21451,18203,10
18113711317,18113711316,-1,1179,1928,10
18115217702,18115217702,0,1274,1641,10
18118769586,18118769585,-1,1025,1635,10
18122268670,18122268671,1,1370,1492,10
18125603963,18125603961,-2,1403,2584,10
18126133046,18126133044,-2,1420,2151,10
18128186267,18128186264,-3,1076,1845,10
18128664074,18128664074,0,1572,1961,10
18129981574,18129981573,-1,1324,2627,10
18139774858,18139774858,0,690,1676,10
18143650561,18143650561,0,683,1629,10
18145180406,18145180394,-12,2164,12277,10
18148329683,18148329682,-1,1381,2109,10
18151816844,18151816843,-1,1418,1965,10
18155750989,18155750988,-1,1099,1796,10
18159293480,18159293478,-2,1145,2247,10
18163308935,18163308934,-1,919,2146,10
18171159870,18171159868,-2,1489,2275,10
18172383158,18172383162,4,2206,520,10
18175370384,18175370384,0,1149,2242,10
18180162251,18180162247,-4,1382,1948,10
18181731743,18181731743,0,1369,2254,10
18181819950,18181819953,3,2328,962,10
18187202994,18187202993,-1,1427,1862,10
18191442647,18191442647,0,1479,1797,10
18193174898,18193174897,-1,1244,1703,10
18194183509,18194183505,-4,28645,11338,10
18203536341,18203536338,-3,1324,2090,10
18206377825,18206377824,-1,1812,2230,10
18209299389,18209299390,1,1901,1698,10
18210891855,18210891853,-2,1247,2357,10
18214020451,18214020449,-2,784,937,10
18216342984,18216342982,-2,1247,1577,10
18217786790,18217786788,-2,942,1645,10
18220389013,18220389012,-1,1540,2354,10
18221771224,18221771225,1,1088,1655,10
18222389906,18222389905,-1,957,2479,10
18227037514,18227037510,-4,1270,2269,10
18227062681,18227062685,4,2284,1181,10
18228355809,18228355809,0,2157,3340,10
18228397040,18228397036,-4,1180,2636,10
18230080971,18230080968,-3,1072,2053,10
18231845191,18231845191,0,1762,2129,10
18234944886,18234944884,-2,1218,2234,10
18237379086,18237379084,-2,1126,2066,10
18238816480,18238816478,-2,1447,1621,10
18238997982,18238997983,1,30254,29738,10
18242842859,18242842858,-1,1392,2028,10
18245904835,18245904831,-4,2070,8271,10
18246950419,18246950417,-2,1219,1983,10
18250255572,18250255571,-1,1334,1864,10
18250348700,18250348698,-2,974,1444,10
18260828523,18260828522,-1,1220,1932,10
18269442332,18269442330,-2,1325,2544,10
18271952433,18271952432,-1,978,2292,10
18272312185,18272312186,1,1586,1656,10
18275516901,18275516899,-2,1474,2055,10
18276136895,18276136896,1,1211,1967,10
18276515216,18276515213,-3,2004,4541,10
18276630043,18276630041,-2,1255,1649,10
18276926517,18276926518,1,34633,54293,10
18279400943,18279400942,-1,1223,2686,10
18280412178,18280412162,-16,1110,1740,10
18284737167,18284737165,-2,939,2885,10
18286321553,18286321560,7,4486,1415,10
18289637457,18289637457,0,1353,2048,10
18291218622,18291218621,-1,1011,1213,10
18291793583,18291793582,-1,1076,2516,10
18298987669,18298987670,1,1278,1031,10
18301065626,18301065626,0,1700,2044,10
18301238529,18301238526,-3,882,1220,10
18301443036,18301443054,18,603,1291,10
18303871965,18303871964,-1,1148,2700,10
18303949733,18303949731,-2,1198,1850,10
18304100532,18304100530,-2,1097,1543,10
18311999495,18311999491,-4,985,1855,10
18314280911,18314280913,2,1830,1513,10
18315042190,18315042190,0,1060,1457,10
18320040802,18320040799,-3,967,2324,10
18320360266,18320360266,0,1572,2720,10
18321792842,18321792840,-2,1398,1993,10
18323309787,18323309783,-4,1087,2003,10
18323346722,18323346728,6,3402,1401,10
18323584729,18323584736,7,1392,1983,10
18338635747,18338635745,-2,1003,2155,10
18341808913,18341808912,-1,1145,2029,10
18343179478,18343179477,-1,1409,2735,10
18343423387,18343423384,-3,1390,2168,10
18344291386,18344291384,-2,972,1616,10
18350476290,18350476289,-1,1008,2192,10
18353277566,18353277570,4,1991,1044,10
18355902402,18355902405,3,1276,1221,10
18356781751,18356781745,-6,979,2124,10
18357290799,18357290799,0,1811,2261,10
18363774794,18363774794,0,3977,5670,10
18364058366,18364058364,-2,1134,1987,10
18364514245,18364514242,-3,873,1864,10
18366599425,18366599423,-2,1487,2061,10
18368903249,18368903250,1,3798,3444,10
18371854158,18371854165,7,2850,1101,10
18373573714,18373573734,20,1509,2019,10
18373987870,18373987867,-3,792,1866,10
18375759554,18375759550,-4,1139,2218,10
18381993154,18381993152,-2,1779,2622,10
18382179289,18382179290,1,1119,1282,10
18384859741,18384859738,-3,863,1509,10
18385909759,18385909762,3,2732,2450,10
18386844746,18386844746,0,950,1617,10
18387821174,18387821172,-2,757,1595,10
18390565271,18390565266,-5,1319,4362,10
18391597549,18391597548,-1,1471,2194,10
18394844866,18394844863,-3,1280,3975,10
18395587474,18395587474,0,1405,1938,10
18396734359,18396734357,-2,1354,3137,10
18411267468,18411267473,5,3413,1810,10
18417280074,18417280072,-2,1009,2370,10
18421189177,18421189177,0,1246,2350,10
18424149246,18424149244,-2,1424,1623,10
18425615991,18425615990,-1,927,1246,10
18429139491,18429139490,-1,1118,1679,10
18430861529,18430861530,1,1168,1327,10
18431846907,18431846905,-2,1047,1916,10
18435210574,18435210566,-8,952,3479,10
18436761355,18436761350,-5,344,1956,10
18439153531,18439153531,0,2068,1693,10
18442829223,18442829221,-2,1289,1438,10
18444629607,18444629605,-2,1015,1495,10
18448371001,18448370998,-3,989,1434,10
18448547337,18448547337,0,2371,2280,10
18450289723,18450289722,-1,1423,1717,10
18451446649,18451446649,0,1141,1592,10
18456168443,18456168443,0,1035,1817,10
18461453616,18461453627,11,187,916,10
18461740255,18461740248,-7,1799,7328,10
18471208291,18471208291,0,940,1382,10
18471451435,18471451451,16,359,825,10
18471604019,18471604017,-2,1214,1218,10
18472603890,18472603891,1,1182,2622,10
18473895852,18473895863,11,13194,35665,10
18474980381,18474980379,-2,725,1364,10
18484788793,18484788794,1,1582,2267,10
18485801167,18485801174,7,8448,2241,10
18486525317,18486525317,0,1130,1313,10
18489473599,18489473594,-5,1111,3456,10
18495475451,18495475454,3,1445,1295,10
18506815918,18506815916,-2,1244,1876,10
18507791659,18507791659,0,1266,1167,10
18509137907,18509137906,-1,1234,2010,10
18510650478,18510650476,-2,1084,2033,10
18519114843,18519114842,-1,1061,1639,10
18519987739,18519987738,-1,1927,3557,10
18520267385,18520267382,-3,967,1852,10
18520472266,18520472265,-1,1140,1955,10
18521666385,18521666386,1,1034,1309,10
18526081773,18526081780,7,3184,1206,10
18527975978,18527975978,0,957,2025,10
18529229786,18529229785,-1,923,2339,10
18530927378,18530927378,0,1144,1461,10
18535298953,18535298942,-11,560,2436,10
18537261951,18537261948,-3,1388,2622,10
18538713442,18538713438,-4,797,1437,10
18539366001,18539366022,21,506,822,10
18539603360,18539603361,1,1872,2689,10
18542457064,18542457061,-3,863,2274,10
18542621218,18542621215,-3,750,1428,10
18544802749,18544802750,1,1452,1755,10
18545378296,18545378294,-2,1496,2150,10
18545808340,18545808339,-1,1169,2108,10
18546050258,18546050255,-3,681,1341,10
18548991406,18548991404,-2,1053,2166,10
18549055601,18549055587,-14,189,436,10
18554051662,18554051662,0,1495,1813,10
18554623451,18554623448,-3,914,1653,10
18555722589,18555722586,-3,1032,1887,10
18557034868,18557034868,0,1375,1917,10
18558691203,18558691201,-2,1172,2249,10
18559384109,18559384106,-3,1646,2197,10
18560811713,18560811720,7,3933,1640,10
18560969054,18560969055,1,1463,1327,10
18562960489,18562960485,-4,1043,1543,10
18563521699,18563521698,-1,1129,1972,10
18564536271,18564536269,-2,1440,1679,10
18565585845,18565585842,-3,1201,2621,10
18567808045,18567808046,1,1293,2008,10
18569187712,18569187710,-2,1186,1710,10
18570184140,18570184136,-4,2827,8326,10
18570540620,18570540619,-1,1350,2192,10
18571802671,18571802666,-5,1307,2058,10
18573822750,18573822750,0,1030,1328,10
18575050781,18575050786,5,2418,1294,10
18577534819,18577534817,-2,1293,2260,10
18578715985,18578715983,-2,680,1237,10
18583501933,18583501932,-1,956,2190,10
18586470727,18586470725,-2,753,1267,10
18586950374,18586950374,0,1660,2697,10
18587007875,18587007874,-1,1097,1852,10
18587802306,18587802305,-1,1403,2772,10
18588683045,18588683043,-2,1464,1725,10
18589764388,18589764386,-2,974,2089,10
18592401254,18592401253,-1,1165,2151,10
18592426906,18592426889,-17,1488,2209,10
18592506706,18592506697,-9,1309,1926,10
18592587905,18592587905,0,1111,2021,10
18593843895,18593843900,5,11124,26513,10
18596947183,18596947186,3,2409,1930,10
18599346853,18599346851,-2,1122,1481,10
18599987488,18599987493,5,5377,21530,10
18600766517,18600766514,-3,1525,2848,10
18601502155,18601502154,-1,2111,1426,10
18602725186,18602725185,-1,703,1266,10
18605093994,18605093993,-1,1576,2094,10
18607513507,18607513507,0,884,1298,10
18608027265,18608027265,0,1779,2122,10
18611784880,18611784877,-3,1269,1976,10
18616338158,18616338157,-1,1086,1356,10
18617133729,18617133729,0,282,1160,10
18618699488,18618699489,1,476,1391,10
18619740209,18619740208,-1,719,1238,10
18627998482,18627998481,-1,1109,1626,10
18628752267,18628752266,-1,1475,2006,10
18632778795,18632778790,-5,733,1203,10
18634251839,18634251838,-1,1353,1760,10
18637357470,18637357470,0,1383,1485,10
18639492761,18639492758,-3,1338,2172,10
18640045266,18640045266,0,1078,1802,10
18644628678,18644628677,-1,902,2109,10
18654884770,18654884770,0,1921,2465,10
18656666848,18656666845,-3,1459,2518,10
18656796523,18656796502,-21,1375,8843,10
18657152561,18657152542,-19,1346,2397,10
18658042994,18658042996,2,1057,1835,10
18661483286,18661483283,-3,1344,1781,10
18664920417,18664920414,-3,1115,3607,10
18665895579,18665895596,17,1287,3400,10
18665964887,18665964885,-2,1718,2437,10
18666337862,18666337862,0,1337,1548,10
18667007070,18667007068,-2,908,1777,10
18667249489,18667249472,-17,1287,1650,10
18668445354,18668445353,-1,986,1372,10
18670665573,18670665574,1,1395,2405,10
18671957683,18671957681,-2,907,1591,10
18672258329,18672258350,21,1404,1978,10
18673033521,18673033519,-2,9,538,10
18675384365,18675384365,0,1630,2148,10
18676367246,18676367244,-2,1657,2161,10
18676458382,18676458379,-3,1015,2188,10
18677095245,18677095244,-1,1456,2106,10
18682708208,18682708206,-2,1553,2780,10
18684771159,18684771158,-1,1187,2629,10
18685981942,18685981941,-1,1822,3143,10
18688951043,18688951042,-1,1607,1827,10
18691382390,18691382389,-1,1394,1898,10
18692450422,18692450422,0,1464,1653,10
18694732007,18694732005,-2,798,2147,10
18695242654,18695242655,1,1165,1619,10
18697399200,18697399200,0,1649,2019,10
18702550965,18702550963,-2,1247,1609,10
18704594835,18704594833,-2,1067,1290,10
18704927876,18704927873,-3,1226,2431,10
18710519502,18710519500,-2,1572,2036,10
18710585934,18710585953,19,1950,1164,10
18712288431,18712288432,1,1499,2379,10
18719208022,18719208021,-1,1466,1602,10
18719356290,18719356289,-1,966,2287,10
18719586622,18719586618,-4,1134,1926,10
18721156150,18721156148,-2,827,1180,10
18722223235,18722223234,-1,1413,2429,10
18724460984,18724460984,0,1126,1796,10
18724723721,18724723718,-3,1357,2815,10
18728715152,18728715155,3,3815,3199,10
18731353851,18731353851,0,532,1507,10
18733670775,18733670774,-1,1425,2448,10
18733871853,18733871852,-1,1728,2822,10
18740511447,18740511445,-2,991,1601,10
18741647894,18741647893,-1,1203,2407,10
18746902821,18746902819,-2,1315,2371,10
18748566594,18748566593,-1,943,1878,10
18750408542,18750408540,-2,1385,1934,10
18753919401,18753919402,1,23158,24559,10
18753987239,18753987238,-1,1163,1631,10
18756658710,18756658708,-2,1498,1659,10
18757736949,18757736948,-1,1001,1451,10
18759466237,18759466235,-2,1220,1779,10
18762412676,18762412675,-1,1544,1833,10
18765779498,18765779495,-3,1254,2294,10
18768684230,18768684228,-2,1449,1703,10
18771449867,18771449868,1,1527,2027,10
18771831389,18771831389,0,1667,2253,10
18775316359,18775316359,0,1260,1317,10
18777821734,18777821736,2,1092,1309,10
18778162490,18778162489,-1,1213,1727,10
18778749769,18778749768,-1,1168,954,10
18783428445,18783428443,-2,1351,2147,10
18789671885,18789671886,1,1269,1749,10
18791257747,18791257746,-1,903,1485,10
18794010476,18794010474,-2,1502,2368,10
18795593962,18795593963,1,1545,1865,10
18804985506,18804985505,-1,1162,1981,10
18806127131,18806127134,3,2400,1574,10
18806377278,18806377277,-1,1560,2717,10
18810467280,18810467280,0,1083,1982,10
18810787313,18810787313,0,1123,1919,10
18812030505,18812030502,-3,1529,2380,10
18813179906,18813179904,-2,1557,1801,10
18814152979,18814152978,-1,1205,2222,10
18815117098,18815117094,-4,1375,2933,10
18816044818,18816044799,-19,34407,29195,10
18818019440,18818019438,-2,1050,1910,10
18819191122,18819191121,-1,1729,2268,10
18824756769,18824756769,0,1001,2220,10
18825684075,18825684073,-2,1140,2188,10
18827596946,18827596945,-1,1373,1360,10
18829735247,18829735266,19,24446,24417,10
18838142442,18838142437,-5,1069,2504,10
18842016487,18842016486,-1,859,1988,10
18843853491,18843853491,0,788,1771,10
18848227842,18848227842,0,1522,2268,10
18850125405,18850125405,0,1279,1759,10
18853206955,18853206954,-1,1365,2016,10
18857771194,18857771192,-2,23559,9578,10
18864332142,18864332145,3,2047,976,10
18865214860,18865214862,2,1073,1304,10
18867249662,18867249660,-2,945,1936,10
18868055770,18868055775,5,1701,1196,10
18872922375,18872922375,0,1224,1902,10
18876788458,18876788457,-1,1141,1084,10
18882277835,18882277835,0,1551,1947,10
18882809398,18882809398,0,693,1443,10
18890584074,18890584067,-7,732,3039,10
18891474301,18891474302,1,1272,1326,10
18892921534,18892921531,-3,1262,2660,10
18894180355,18894180349,-6,1215,2695,10
18904596594,18904596594,0,1473,2082,10
18904986713,18904986694,-19,1009,2027,10
18908423286,18908423287,1,1402,2131,10
18910150586,18910150584,-2,1034,2119,10
18910327026,18910327026,0,1287,2233,10
18910696523,18910696522,-1,1084,1501,10
18912433362,18912433362,0,966,1479,10
18913424371,18913424369,-2,1061,1708,10
18914809227,18914809227,0,1111,1157,10
18915962816,18915962815,-1,1096,1906,10
18917427576,18917427572,-4,1458,3749,10
18919339015,18919339014,-1,1312,2181,10
18921474036,18921474036,0,1053,2549,10
18921685073,18921685071,-2,1166,1090,10
18922063659,18922063659,0,979,1762,10
18922606667,18922606666,-1,1057,1532,10
18925564986,18925564983,-3,610,1407,10
18925655541,18925655539,-2,1215,1531,10
18925962559,18925962555,-4,31270,18787,10
18926487736,18926487730,-6,1254,1983,10
18927794623,18927794622,-1,1508,2612,10
18928337801,18928337800,-1,1485,1803,10
18928867960,18928867946,-14,1009,1885,10
18929251698,18929251691,-7,1067,1688,10
18930119135,18930119133,-2,1391,2424,10
18930204083,18930204083,0,832,1109,10
18935106326,18935106325,-1,1007,1580,10
18935796640,18935796638,-2,1820,2729,10
18936730483,18936730483,0,1271,1371,10
18936921498,18936921498,0,1181,2265,10
18937130466,18937130457,-9,934,2075,10
18937767082,18937767082,0,926,1900,10
18951681497,18951681494,-3,1505,2249,10
18953287452,18953287449,-3,1734,2825,10
18954436519,18954436518,-1,1168,2128,10
18955207287,18955207282,-5,697,1964,10
18963239033,18963239034,1,1301,2462,10
18964322784,18964322783,-1,1005,1855,10
18964668179,18964668177,-2,1048,2475,10
18964712922,18964712922,0,1913,1698,10
18968369640,18968369638,-2,1336,1733,10
18970426346,18970426346,0,645,1313,10
18971853610,18971853606,-4,710,2190,10
18977582644,18977582642,-2,566,756,10
18978345658,18978345657,-1,1826,2395,10
18983157054,18983157054,0,1234,1596,10
18988525195,18988525194,-1,1490,2235,10
18988719798,18988719798,0,1683,2025,10
18989407353,18989407354,1,1627,2148,10
18990519826,18990519825,-1,1239,2235,10
19000092532,19000092530,-2,1122,1904,10
19002933340,19002933338,-2,1227,3117,10
19003601098,19003601102,4,2131,1866,10
19004414667,19004414665,-2,1336,2192,10
19004523607,19004523606,-1,1066,1846,10
19015288659,19015288655,-4,1008,1990,10
19015998030,19015998029,-1,1236,1595,10
19018041742,19018041742,0,1659,2267,10
19019444766,19019444765,-1,1310,2460,10
19019813541,19019813540,-1,1488,2212,10
19020641153,19020641153,0,1150,1827,10
19022753346,19022753342,-4,1157,2498,10
19024573562,19024573562,0,1332,2983,10
19025290942,19025290944,2,979,1739,10
19026508374,19026508373,-1,1662,2062,10
19028981835,19028981834,-1,1294,1930,10
19029855170,19029855173,3,1665,1443,10
19032528947,19032528947,0,1184,2501,10
19034387545,19034387546,1,1540,2187,10
19035030279,19035030277,-2,1295,3034,10
19035593173,19035593173,0,1858,1904,10
19035790125,19035790122,-3,1311,2718,10
19037920099,19037920097,-2,1490,1752,10
19038397428,19038397427,-1,2617,3454,10
19039646473,19039646472,-1,1267,2061,10
19042925494,19042925491,-3,1506,2395,10
19043106399,19043106397,-2,1186,2052,10
19043755355,19043755352,-3,1325,2357,10
19044186580,19044186578,-2,887,2023,10
19046808719,19046808716,-3,1033,2359,10
19053394576,19053394581,5,4827,2031,10
19054837619,19054837617,-2,728,2430,10
19058401075,19058401073,-2,1147,1499,10
19060680262,19060680261,-1,1396,2110,10
19068024237,19068024235,-2,934,1925,10
19072117635,19072117634,-1,1160,1985,10
19072327498,19072327494,-4,889,2058,10
19073614426,19073614420,-6,1360,3480,10
19075581263,19075581263,0,955,2118,10
19077876534,19077876533,-1,1207,2393,10
19083102719,19083102719,0,1133,1393,10
19084123275,19084123275,0,1382,1906,10
19089208419,19089208417,-2,1072,1712,10
19092867529,19092867527,-2,1063,2415,10
19096939415,19096939415,0,1481,2072,10
19097793296,19097793295,-1,1502,1435,10
19100514635,19100514634,-1,1222,2120,10
19102822415,19102822411,-4,881,2222,10
19102989330,19102989314,-16,1372,2659,10
19105043206,19105043203,-3,1335,1976,10
19105955377,19105955371,-6,677,2085,10
19106944589,19106944584,-5,1095,2893,10
19108871823,19108871823,0,1062,2428,10
19110829744,19110829742,-2,1333,1619,10
19115002878,19115002878,0,1033,1657,10
19115213178,19115213176,-2,1766,2115,10
19115823879,19115823857,-22,2307,1611,10
19116414173,19116414170,-3,1234,1489,10
19118398765,19118398764,-1,1268,1773,10
19120704302,19120704301,-1,1094,1959,10
19121227364,19121227364,0,1461,1944,10
19123089105,19123089103,-2,1336,1854,10
19127597529,19127597527,-2,1225,2711,10
19132052646,19132052642,-4,1601,2615,10
19140588459,19140588458,-1,1297,1888,10
19141065662,19141065661,-1,867,1392,10
19148119765,19148119762,-3,746,2197,10
19148745267,19148745267,0,1302,1669,10
19148913841,19148913838,-3,944,1799,10
19154339267,19154339266,-1,22199,23951,10
19160563997,19160563996,-1,1302,1637,10
19162505823,19162505825,2,1467,1529,10
19165039370,19165039369,-1,1301,1842,10
19168884541,19168884538,-3,1218,1650,10
19184726011,19184726010,-1,1190,2385,10
19192379415,19192379414,-1,988,1461,10
19192599851,19192599871,20,1007,1741,10
19196799493,19196799490,-3,1331,1967,10
19201674448,19201674448,0,1346,1860,10
19202019878,19202019878,0,1534,2202,10
19202285440,19202285441,1,1115,1890,10
19205015467,19205015466,-1,1003,1974,10
19206045890,19206045890,0,1186,1834,10
19206788865,19206788869,4,5487,2883,10
19211007387,19211007382,-5,1152,1561,10
19213981535,19213981534,-1,1052,2508,10
19215205795,19215205812,17,1021,2861,10
19215605069,19215605068,-1,1001,1628,10
19217009702,19217009701,-1,1324,1803,10
19221435546,19221435545,-1,1116,2617,10
19222370050,19222370065,15,940,221,10
19225811490,19225811488,-2,861,1647,10
19234434388,19234434384,-4,1047,1334,10
19235705113,19235705113,0,721,1793,10
19238198110,19238198108,-2,1658,2832,10
19240649697,19240649696,-1,1011,2142,10
19240999308,19240999327,19,644,859,10
19243407198,19243407198,0,1399,1530,10
19248631563,19248631561,-2,1391,1764,10
19249064835,19249064820,-15,1403,2858,10
19250481781,19250481781,0,1372,2289,10
19252173742,19252173742,0,878,1441,10
19253576258,19253576257,-1,1345,2840,10
19253677522,19253677521,-1,1433,2106,10
19255924153,19255924154,1,1754,2281,10
19256795683,19256795681,-2,794,1409,10
19257769817,19257769815,-2,1145,2420,10
19258701196,19258701194,-2,929,1468,10
19261497069,19261497074,5,2700,1466,10
19261707723,19261707723,0,1519,2107,10
19262307608,19262307607,-1,1509,2272,10
19262678087,19262678083,-4,880,2368,10
19264019991,19264019988,-3,1265,2119,10
19265104431,19265104429,-2,1208,2059,10
19266936070,19266936069,-1,933,2759,10
19267978878,19267978878,0,1516,1554,10
19268140086,19268140086,0,1227,1324,10
19279999986,19279999995,9,1438,1364,10
19280965371,19280965369,-2,1459,2311,10
19284973313,19284973312,-1,1990,3053,10
19285766157,19285766152,-5,1255,5624,10
19287132859,19287132855,-4,1600,2917,10
19290208080,19290208078,-2,1646,2418,10
19292868589,19292868587,-2,1945,2849,10
19295737150,19295737149,-1,1152,1001,10
19296990150,19296990150,0,1050,2164,10
19301698828,19301698827,-1,1284,2446,10
19311218295,19311218302,7,3017,1197,10
19311750522,19311750520,-2,1066,2752,10
19313370275,19313370274,-1,1244,1620,10
19319109178,19319109175,-3,785,1299,10
19319163730,19319163731,1,934,1213,10
19321276226,19321276226,0,1066,1448,10
19321794201,19321794199,-2,1170,1928,10
19326621385,19326621384,-1,1296,2141,10
19332053279,19332053279,0,927,1966,10
19333238410,19333238409,-1,1239,2371,10
19340395593,19340395589,-4,1282,2194,10
19341285242,19341285240,-2,1381,2014,10
19341496227,19341496247,20,760,1346,10
19343219530,19343219526,-4,1288,2589,10
19343418561,19343418579,18,771,1598,10
19344431350,19344431348,-2,1195,1980,10
19350955591,19350955589,-2,1349,3179,10
19358995537,19358995542,5,1600,1355,10
19359325337,19359325336,-1,1242,2172,10
19361148006,19361148001,-5,897,2811,10
19361698585,19361698607,22,909,1889,10
19362041062,19362041063,1,1040,1875,10
19362092406,19362092402,-4,1058,2426,10
19363058709,19363058707,-2,1174,1752,10
19364170390,19364170390,0,1174,1663,10
19367418328,19367418325,-3,1225,2236,10
19368942867,19368942866,-1,1999,2738,10
19372079238,19372079244,6,12413,28615,10
19374057970,19374057970,0,1239,1695,10
19375161697,19375161716,19,1234,2223,10
19375845654,19375845654,0,1252,2595,10
19376521351,19376521350,-1,1667,1811,10
19380631746,19380631751,5,1881,1223,10
19382714777,19382714777,0,953,1520,10
19384756138,19384756131,-7,1778,7482,10
19385888302,19385888300,-2,933,1605,10
19386155615,19386155613,-2,771,1297,10
19388993125,19388993125,0,1027,1602,10
19389343458,19389343456,-2,1022,2232,10
19393835277,19393835276,-1,1158,1954,10
19393999080,19393999077,-3,1194,1692,10
19395862047,19395862046,-1,928,1739,10
19398524450,19398524458,8,971,870,10
19402786202,19402786198,-4,887,1409,10
19404480826,19404480826,0,1394,2719,10
19407205794,19407205793,-1,1620,2024,10
19407469506,19407469505,-1,1371,2122,10
19409325942,19409325940,-2,1443,2035,10
19411708512,19411708510,-2,1492,2556,10
19413219335,19413219333,-2,652,1296,10
19414196202,19414196201,-1,870,2026,10
19418652218,19418652215,-3,701,1521,10
19420817106,19420817106,0,1252,1754,10
19423765981,19423765982,1,972,1383,10
19425115115,19425115114,-1,1125,1593,10
19429619550,19429619549,-1,664,1055,10
19434242929,19434242926,-3,1103,1596,10
19435538831,19435538832,1,1429,1403,10
19436352430,19436352432,2,1260,1414,10
19436943881,19436943881,0,1711,2344,10
19437989317,19437989318,1,1302,1434,10
19439409981,19439409979,-2,1445,1437,10
19439874934,19439874934,0,2185,1958,10
19440253338,19440253335,-3,1260,3095,10
19440411514,19440411512,-2,1031,1691,10
19442679166,19442679165,-1,1780,2131,10
19447664558,19447664566,8,698,1588,10
19450742934,19450742933,-1,1251,1370,10
19453259821,19453259818,-3,1328,3225,10
19453440581,19453440579,-2,1672,2405,10
19454257510,19454257511,1,701,1345,10
19455961100,19455961098,-2,1511,2175,10
19460499706,19460499706,0,1300,1990,10
19466381456,19466381462,6,144,1034,10
19467364726,19467364725,-1,883,1837,10
19468660590,19468660588,-2,918,1489,10
19469288330,19469288329,-1,1342,1976,10
19472526054,19472526051,-3,1127,2155,10
19476148033,19476148033,0,1638,1354,10
19476970116,19476970115,-1,1066,1882,10
19481340053,19481340052,-1,1313,1668,10
19482004046,19482004049,3,1779,1012,10
19484765170,19484765169,-1,1566,2090,10
19486722998,19486722997,-1,1314,2431,10
19487830767,19487830762,-5,1773,3168,10
19491083749,19491083746,-3,1459,2429,10
19496058115,19496058114,-1,1217,2010,10
19500616284,19500616286,2,1204,1066,10
19500909469,19500909470,1,1037,1087,10
19502215827,19502215825,-2,1408,2279,10
19505467886,19505467882,-4,1712,2479,10
19508513331,19508513321,-10,656,133,10
19509344768,19509344766,-2,1186,1929,10
19510031745,19510031742,-3,1675,2778,10
19513492141,19513492139,-2,1485,1892,10
19517379474,19517379470,-4,1358,1664,10
19517719669,19517719665,-4,825,1994,10
19519098010,19519098008,-2,1423,2296,10
19521358610,19521358606,-4,1533,2460,10
19522131553,19522131550,-3,1267,2337,10
19525443452,19525443451,-1,1006,1209,10
19527952540,19527952542,2,2025,1744,10
19529985854,19529985853,-1,1119,1537,10
19530348163,19530348162,-1,918,2075,10
19533548993,19533548990,-3,1569,2456,10
19533867697,19533867698,1,1367,1844,10
19534016475,19534016493,18,1414,1519,10
19534866767,19534866766,-1,752,2192,10
19534990987,19534990984,-3,1101,1817,10
19542808537,19542808535,-2,1006,1793,10
19545203126,19545203126,0,1220,1612,10
19546213899,19546213898,-1,1050,1634,10
19546895234,19546895231,-3,1029,1479,10
19547074438,19547074436,-2,1160,2570,10
19547858362,19547858359,-3,1005,1974,10
19549037206,19549037205,-1,815,2520,10
19550183169,19550183167,-2,1523,2587,10
19552167161,19552167159,-2,1377,1954,10
19553480685,19553480689,4,2029,2309,10
19555101820,19555101818,-2,1317,1671,10
19555420992,19555420986,-6,743,1274,10
19558584799,19558584797,-2,1376,2118,10
19562705771,19562705772,1,1237,2250,10
19567677676,19567677677,1,1145,1232,10
19573556463,19573556441,-22,1364,1477,10
19575313037,19575313034,-3,1118,1684,10
19576015008,19576015008,0,1113,1614,10
19579790552,19579790556,4,2460,1787,10
19580465649,19580465646,-3,1299,1830,10
19581969183,19581969186,3,1225,1392,10
19584578998,19584578999,1,2014,1981,10
19585316159,19585316157,-2,987,1817,10
19587587896,19587587898,2,1970,1102,10
19594219690,19594219689,-1,1217,2033,10
19596887536,19596887541,5,2270,1522,10
19599303686,19599303686,0,985,1865,10
19601170638,19601170637,-1,1127,1715,10
19604374823,19604374821,-2,1135,2106,10
19610709630,19610709626,-4,6215,12198,10
19612375411,19612375411,0,1377,2163,10
19613038605,19613038605,0,1073,994,10
19616807767,19616807766,-1,1266,2615,10
19618593490,19618593490,0,1093,1713,10
19618696532,19618696530,-2,1333,1602,10
19621097562,19621097561,-1,1139,2217,10
19623419256,19623419254,-2,876,1920,10
19623781207,19623781202,-5,1366,4218,10
19625909914,19625909910,-4,1387,2253,10
19627216275,19627216270,-5,1507,2210,10
19630295830,19630295829,-1,1105,2047,10
19630474772,19630474771,-1,1621,2534,10
19633107586,19633107586,0,1346,2711,10
19633846081,19633846081,0,992,2090,10
19635956811,19635956809,-2,1552,1953,10
19637540046,19637540049,3,1846,1407,10
19639429962,19639429961,-1,1270,2403,10
19642152818,19642152815,-3,1331,2315,10
19642663427,19642663423,-4,901,1076,10
19653352587,19653352595,8,1217,1766,10
19654158881,19654158882,1,1392,2041,10
19656123583,19656123600,17,918,1237,10
19659757974,19659757973,-1,1416,1497,10
19661205109,19661205106,-3,2386,5812,10
19661697360,19661697359,-1,1301,2186,10
19663825894,19663825893,-1,1315,2268,10
19670435883,19670435883,0,1371,1529,10
19672677058,19672677055,-3,911,1427,10
19680113085,19680113083,-2,1557,2253,10
19683384271,19683384278,7,6423,2416,10
19684066091,19684066089,-2,1490,1710,10
19684740258,19684740257,-1,1349,1829,10
19692311025,19692311023,-2,1400,1902,10
19695827540,19695827538,-2,980,2458,10
19700145268,19700145266,-2,1611,1955,10
19704537527,19704537534,7,4201,2577,10
19705974427,19705974427,0,2208,1908,10
19706186062,19706186062,0,3143,3374,10
19710221374,19710221379,5,1131,1390,10
19710405419,19710405434,15,1143,2272,10
19713562630,19713562628,-2,1773,2994,10
19715140834,19715140830,-4,873,1687,10
19721179222,19721179221,-1,1328,2231,10
19722151676,19722151674,-2,1415,1551,10
19726453380,19726453378,-2,932,1474,10
19727075242,19727075239,-3,1283,2685,10
19727831923,19727831926,3,3125,2522,10
19729755165,19729755165,0,1222,1331,10
19730584591,19730584591,0,1185,1710,10
19735321207,19735321206,-1,1585,1958,10
19741234354,19741234357,3,1293,1352,10
19741360185,19741360187,2,1180,1484,10
19744411972,19744411970,-2,903,2370,10
19747678527,19747678544,17,838,13175,10
19749169131,19749169127,-4,1013,1471,10
19757294302,19757294301,-1,801,1894,10
19760659242,19760659246,4,1161,2080,10
19761189329,19761189326,-3,865,1357,10
19765001939,19765001945,6,2379,1255,10
19766360579,19766360577,-2,1067,2042,10
19766477863,19766477863,0,966,1415,10
19774806794,19774806793,-1,1628,1795,10
19775686926,19775686925,-1,1277,1953,10
19775867491,19775867489,-2,1657,3217,10
19778057986,19778057985,-1,1181,2150,10
19778854262,19778854258,-4,1296,2111,10
19786090913,19786090906,-7,2836,7234,10
19790433028,19790433025,-3,1204,2348,10
19790853879,19790853878,-1,949,1649,10
19791730214,19791730211,-3,956,1711,10
19792074861,19792074859,-2,1232,1336,10
19792134166,19792134164,-2,1232,1573,10
19792225388,19792225392,4,2331,1854,10
19800990525,19800990526,1,1084,2285,10
19801266458,19801266457,-1,1364,2293,10
19803267440,19803267439,-1,1440,1902,10
19804145037,19804145042,5,1456,965,10
19804330453,19804330451,-2,760,1842,10
19804401864,19804401863,-1,1640,1613,10
19806736602,19806736601,-1,1608,1571,10
19809366819,19809366818,-1,829,1370,10
19816138726,19816138727,1,1322,1369,10
19817086211,19817086213,2,1402,1795,10
19819765875,19819765872,-3,904,2306,10
19822277147,19822277153,6,2496,1520,10
19823610566,19823610566,0,1040,1402,10
19824278955,19824278953,-2,1587,2675,10
19827517266,19827517265,-1,22307,34256,10
19828322826,19828322825,-1,3212,5133,10
19831689876,19831689876,0,1595,1876,10
19841065586,19841065585,-1,1013,1606,10
19841917551,19841917549,-2,1038,2072,10
19844071008,19844071006,-2,1520,2736,10
19845175980,19845175985,5,2502,1326,10
19847259151,19847259150,-1,1050,2080,10
19850644043,19850644041,-2,716,1604,10
19850845473,19850845465,-8,612,1201,10
19851149964,19851149974,10,317,760,10
19854838082,19854838078,-4,940,1651,10
19856660082,19856660082,0,1017,1980,10
19857302762,19857302759,-3,725,1184,10
19858508394,19858508393,-1,1156,1953,10
19860773425,19860773424,-1,1674,2386,10
19867941114,19867941092,-22,2675,884,10
19869376711,19869376709,-2,1095,2148,10
19875629311,19875629312,1,1527,2577,10
19877039859,19877039859,0,1220,1252,10
19878293641,19878293652,11,1088,297,10
19878446939,19878446938,-1,1079,2062,10
19881124512,19881124511,-1,795,1768,10
19883433438,19883433437,-1,1152,2212,10
19886222898,19886222899,1,1269,1882,10
19887215167,19887215168,1,1316,1492,10
19887430267,19887430265,-2,1004,1873,10
19890301506,19890301504,-2,1229,2443,10
19892537260,19892537259,-1,1372,2266,10
19894643243,19894643241,-2,1137,2187,10
19901097460,19901097460,0,1896,2356,10
19903631797,19903631800,3,1107,1388,10
19904131963,19904131962,-1,1093,1393,10
19904577858,19904577857,-1,1325,1645,10
19912225787,19912225785,-2,1211,2901,10
19913828054,19913828054,0,2404,3672,10
19915071741,19915071746,5,11200,4551,10
19918250617,19918250615,-2,1046,1922,10
19921294299,19921294298,-1,864,1637,10
19922172577,19922172575,-2,1470,2709,10
19922953973,19922953973,0,989,1274,10
19923181061,19923181067,6,1858,997,10
19924093899,19924093898,-1,1091,1604,10
19924736075,19924736073,-2,893,1513,10
19925523738,19925523737,-1,861,1343,10
19927036761,19927036760,-1,1067,2301,10
19929810803,19929810803,0,984,1915,10
19941135662,19941135660,-2,1332,1886,10
19942725281,19942725281,0,1095,1962,10
19945123286,19945123285,-1,945,1068,10
19947015256,19947015254,-2,1586,2452,10
19952155982,19952155983,1,1240,1681,10
19957998605,19957998601,-4,1022,4336,10
19958217582,19958217582,0,889,1241,10
19960039606,19960039605,-1,810,1709,10
19961265027,19961265025,-2,1168,1866,10
19964644158,19964644155,-3,1275,2780,10
19967202168,19967202166,-2,1195,2023,10
19970207006,19970207005,-1,1233,2023,10
19974009615,19974009610,-5,1262,1738,10
19974431073,19974431054,-19,223,795,10
19975381610,19975381607,-3,1310,2346,10
19979303790,19979303790,0,1304,1489,10
19981875626,19981875626,0,1019,1600,10
19988956096,19988956102,6,2998,1529,10
19989042811,19989042810,-1,1826,2342,10
19990785231,19990785230,-1,1236,2049,10
19996267180,19996267177,-3,1545,2142,10
19996938504,19996938504,0,1163,1983,10
19998751554,19998751534,-20,1002,653,10
20002609582,20002609583,1,1804,2040,10
20004468371,20004468348,-23,615,685,10
20008045103,20008045106,3,1215,1355,10
20011888065,20011888062,-3,1191,2148,10
20012682694,20012682694,0,1057,1858,10
20014254124,20014254122,-2,1360,2176,10
20019238431,20019238430,-1,944,2157,10
20027138257,20027138257,0,1265,1867,10
20029555551,20029555549,-2,938,2628,10
20031761871,20031761870,-1,1064,1693,10
20032096005,20032096007,2,32885,31785,10
20036710514,20036710513,-1,1000,1550,10
20037990344,20037990338,-6,1681,6667,10
20043104694,20043104693,-1,1282,1817,10
20045826938,20045826938,0,1425,1601,10
20045935454,20045935452,-2,1068,1630,10
20047957781,20047957780,-1,1519,2926,10
20049951930,20049951927,-3,1467,1969,10
20051294543,20051294541,-2,1048,2221,10
20053020343,20053020342,-1,838,1712,10
20053656017,20053656010,-7,1278,4351,10
20057908161,20057908161,0,1322,1211,10
20059108579,20059108574,-5,1141,2589,10
20063671299,20063671289,-10,1250,2604,10
20064462738,20064462735,-3,1154,1600,10
20064729517,20064729517,0,1111,2184,10
20066336811,20066336810,-1,1123,2351,10
20068934107,20068934117,10,18277,51892,10
20069167906,20069167901,-5,1262,3797,10
20070452742,20070452738,-4,1093,2011,10
20070975866,20070975878,12,317,1180,10
20074053407,20074053406,-1,718,1915,10
20077793059,20077793066,7,16139,15518,10
20079006335,20079006335,0,1509,2307,10
20080718560,20080718560,0,1571,1782,10
20081568367,20081568366,-1,1338,2368,10
20084311122,20084311121,-1,1026,1732,10
20086614366,20086614363,-3,1556,1942,10
20089601714,20089601710,-4,1037,2175,10
20090742850,20090742849,-1,1205,2174,10
20091711329,20091711347,18,596,1164,10
20092413433,20092413437,4,1301,1154,10
20098517115,20098517112,-3,1350,2623,10
20100755850,20100755849,-1,1110,1929,10
20102005767,20102005765,-2,1015,2135,10
20102268019,20102268018,-1,881,1291,10
20107251890,20107251888,-2,879,2033,10
20111560694,20111560700,6,3298,915,10
20116004950,20116004951,1,1465,2161,10
20123912830,20123912830,0,1373,1821,10
20128674970,20128674973,3,1093,1489,10
20129918251,20129918250,-1,1104,1482,10
20131648542,20131648546,4,1413,1368,10
20133234238,20133234241,3,1325,1860,10
20141325717,20141325717,0,2002,1750,10
20143923692,20143923692,0,1243,1971,10
20145742713,20145742712,-1,1299,2343,10
20146553780,20146553779,-1,1483,1645,10
20151974402,20151974400,-2,1125,2145,10
20152272685,20152272685,0,2199,2202,10
20152718082,20152718080,-2,1382,2681,10
20155771834,20155771830,-4,903,1656,10
20159766842,20159766846,4,1953,1019,10
20160822371,20160822369,-2,1135,1616,10
20163506314,20163506302,-12,1345,2158,10
20165058122,20165058122,0,2770,4062,10
20165444754,20165444734,-20,1274,1275,10
20165897435,20165897429,-6,1148,1973,10
20167342732,20167342730,-2,1517,2201,10
20169999950,20169999950,0,1204,2621,10
20172074843,20172074842,-1,817,1938,10
20173652585,20173652590,5,1754,1082,10
20175339702,20175339701,-1,1215,2545,10
20176677611,20176677608,-3,930,2026,10
20177153074,20177153074,0,97,624,10
20182734701,20182734699,-2,1099,1855,10
20185557279,20185557276,-3,1201,2506,10
20188407595,20188407597,2,1500,1868,10
20189231779,20189231780,1,1099,1866,10
20190823442,20190823439,-3,1065,2010,10
20191835739,20191835739,0,1295,1425,10
20194589777,20194589777,0,3620,3798,10
20199742805,20199742805,0,958,1526,10
20200003882,20200003881,-1,1602,2171,10
20202107788,20202107786,-2,1319,2545,10
20216692394,20216692399,5,1037,1070,10
20217896823,20217896818,-5,1096,2337,10
20219894071,20219894074,3,1226,1260,10
20225160067,20225160066,-1,1069,2644,10
20226546089,20226546094,5,29701,23393,10
20229301847,20229301847,0,1110,1324,10
20234607508,20234607506,-2,1137,1879,10
20234749046,20234749043,-3,1170,1696,10
20235594793,20235594790,-3,1539,1815,10
20237089884,20237089887,3,1818,1156,10
20237469089,20237469088,-1,1491,3067,10
20240737648,20240737648,0,1824,1516,10
20243296506,20243296506,0,759,1185,10
20248944523,20248944521,-2,1492,2071,10
20255891343,20255891341,-2,1370,1703,10
20257855242,20257855241,-1,1185,2165,10
20261882907,20261882905,-2,1401,2999,10
20262156334,20262156332,-2,916,1843,10
20264959355,20264959354,-1,856,1957,10
20267969063,20267969058,-5,2341,8086,10
20268498071,20268498070,-1,1014,1690,10
20268753172,20268753170,-2,1697,2644,10
20269164090,20269164088,-2,1240,1568,10
20271700857,20271700861,4,2195,1635,10
20275304563,20275304562,-1,1103,2147,10
20276578595,20276578601,6,1508,1014,10
20279186543,20279186543,0,3189,3181,10
20279637085,20279637086,1,1051,1948,10
20281612184,20281612183,-1,1624,1936,10
20282530498,20282530496,-2,1725,2366,10
20283614659,20283614657,-2,907,1423,10
20284345157,20284345157,0,1405,998,10
20288667310,20288667307,-3,1435,2070,10
20290322598,20290322597,-1,1064,2456,10
20292404618,20292404619,1,1071,1356,10
20295386215,20295386210,-5,966,3637,10
20296947825,20296947823,-2,1603,1681,10
20301998354,20301998351,-3,1012,2103,10
20302359483,20302359492,9,79,3995,10
20303935957,20303935953,-4,764,1907,10
20303991931,20303991929,-2,765,1655,10
20305577442,20305577450,8,9763,33473,10
20310461751,20310461750,-1,1659,1515,10
20311021437,20311021436,-1,950,2265,10
20314771179,20314771175,-4,929,2483,10
20317969073,20317969070,-3,1326,2314,10
20323980874,20323980874,0,1470,1810,10
20327542219,20327542219,0,1136,1750,10
20331243185,20331243183,-2,1665,3153,10
20341706125,20341706125,0,1394,1864,10
20342672014,20342672017,3,1242,1366,10
20345008459,20345008458,-1,1071,2022,10
20346798438,20346798438,0,1647,2237,10
20349166362,20349166366,4,2281,1772,10
20349473902,20349473901,-1,1438,2629,10
20351382265,20351382266,1,1293,1832,10
20352440064,20352440062,-2,1067,2184,10
20352795373,20352795370,-3,1103,1910,10
20353021963,20353021963,0,1182,2441,10
20353606967,20353606966,-1,1342,2126,10
20354648166,20354648170,4,2984,1935,10
20358001622,20358001623,1,1192,1549,10
20358811222,20358811218,-4,1021,1978,10
20359520984,20359520982,-2,1249,2103,10
20360196626,20360196624,-2,1266,2736,10
20366969650,20366969649,-1,1306,2406,10
20370840830,20370840830,0,1372,1878,10
20372288974,20372288970,-4,892,1954,10
20372551282,20372551282,0,1159,1870,10
20373789000,20373789001,1,966,911,10
20375965110,20375965109,-1,1003,1718,10
20376544822,20376544822,0,1202,2000,10
20377298274,20377298273,-1,1124,1610,10
20378676305,20378676306,1,824,1203,10
20380195957,20380195950,-7,1847,8965,10
20381497186,20381497191,5,2011,1218,10
20381856158,20381856160,2,1249,1669,10
20388417146,20388417146,0,1528,1959,10
20392244147,20392244145,-2,1019,1603,10
20395918669,20395918666,-3,1360,2076,10
20396992642,20396992642,0,1515,2047,10
20397548809,20397548808,-1,1089,1705,10
20401616290,20401616291,1,1337,1904,10
20403879916,20403879914,-2,1333,2490,10
20410381354,20410381353,-1,1560,2484,10
20410485862,20410485861,-1,1257,2912,10
20413547187,20413547185,-2,1320,1994,10
20424173311,20424173309,-2,1410,2073,10
20425350579,20425350575,-4,872,1615,10
20429273813,20429273813,0,1214,1865,10
20429469073,20429469092,19,1199,1616,10
20429992590,20429992602,12,1120,2320,10
20430311786,20430311786,0,1473,2092,10
20430865679,20430865678,-1,1717,2665,10
20434658774,20434658772,-2,1467,1976,10
20437168838,20437168838,0,1172,1769,10
20438374448,20438374446,-2,1562,3067,10
20441608369,20441608370,1,1483,1263,10
20442120080,20442120078,-2,1185,1975,10
20442564826,20442564816,-10,1080,1855,10
20443232650,20443232647,-3,1448,2780,10
20445626098,20445626105,7,4179,1692,10
20454890991,20454890996,5,8181,31098,10
20456049842,20456049841,-1,1076,2134,10
20457980707,20457980708,1,2434,2438,10
20460241528,20460241523,-5,55099,20590,10
20460561488,20460561487,-1,1246,2528,10
20463541723,20463541722,-1,997,1770,10
20465548946,20465548944,-2,1388,2245,10
20467356077,20467356074,-3,1548,2244,10
20467708012,20467708010,-2,1402,2279,10
20469233223,20469233223,0,735,1933,10
20469926982,20469926981,-1,1026,2432,10
20474415578,20474415571,-7,1981,7271,10
20476475638,20476475637,-1,1183,1606,10
20477748263,20477748258,-5,982,2210,10
20478149662,20478149662,0,1673,2066,10
20478677588,20478677605,17,1329,1970,10
20479614791,20479614789,-2,1112,1855,10
20480925333,20480925330,-3,1153,1829,10
20485266938,20485266936,-2,727,1493,10
20490703490,20490703487,-3,950,2157,10
20492008470,20492008472,2,2059,1787,10
20492266615,20492266614,-1,1323,2492,10
20494129859,20494129858,-1,1720,2984,10
20497501027,20497501026,-1,1106,2130,10
20497895840,20497895837,-3,1449,2217,10
20498796887,20498796886,-1,1078,1586,10
20499290962,20499290966,4,1060,871,10
20505653207,20505653206,-1,1369,1682,10
20507364747,20507364727,-20,844,321,10
20507951549,20507951546,-3,1316,2998,10
20509726812,20509726810,-2,1530,1699,10
20510589598,20510589595,-3,1646,2154,10
20512759775,20512759775,0,952,1852,10
20516806518,20516806518,0,964,1528,10
20519701872,20519701872,0,1802,2132,10
20523452849,20523452848,-1,1167,1796,10
20525445347,20525445345,-2,1561,1990,10
20526792365,20526792362,-3,1415,3094,10
20538717295,20538717294,-1,1309,892,10
20540334108,20540334106,-2,1389,2096,10
20542626630,20542626627,-3,969,2524,10
20543040222,20543040219,-3,1806,1908,10
20544432751,20544432750,-1,1334,2078,10
20545370723,20545370725,2,1036,1545,10
20545884418,20545884419,1,1269,2368,10
20546691145,20546691151,6,1667,1156,10
20548622301,20548622299,-2,717,1176,10
20550807183,20550807181,-2,1214,2490,10
20551294970,20551294965,-5,1947,8425,10
20558682677,20558682675,-2,1289,1697,10
20559157578,20559157585,7,7318,2274,10
20562341847,20562341846,-1,1329,2712,10
20565330886,20565330885,-1,1074,1969,10
20566386125,20566386124,-1,1561,2268,10
20572926074,20572926079,5,1096,1008,10
20574016441,20574016442,1,822,1360,10
20574951485,20574951483,-2,2153,2436,10
20579588371,20579588367,-4,848,1894,10
20580376252,20580376250,-2,1612,2070,10
20580945691,20580945689,-2,997,1623,10
20581512498,20581512503,5,1776,982,10
20584876566,20584876563,-3,1540,2652,10
20586822935,20586822936,1,931,1363,10
20588204164,20588204178,14,418,849,10
20588643435,20588643433,-2,1165,2019,10
20589949756,20589949755,-1,43761,16035,10
20604491471,20604491470,-1,1706,2403,10
20606056115,20606056114,-1,1447,1469,10
20610755266,20610755264,-2,1368,2179,10
20612838231,20612838229,-2,1282,2215,10
20613000437,20613000435,-2,1527,2504,10
20613048686,20613048686,0,1432,1911,10
20615020707,20615020707,0,873,1463,10
20616522531,20616522529,-2,1553,2526,10
20616849470,20616849470,0,1578,1604,10
20617364738,20617364735,-3,1413,2279,10
20622094707,20622094702,-5,928,2886,10
20622588338,20622588338,0,1179,1646,10
20624413749,20624413747,-2,1012,2159,10
20629092159,20629092156,-3,1015,2626,10
20630461284,20630461269,-15,487,2237,10
20635566699,20635566695,-4,1048,2851,10
20636111194,20636111193,-1,706,1361,10
20637735930,20637735929,-1,1263,1732,10
20639880154,20639880154,0,773,1745,10
20641322786,20641322786,0,1131,1839,10
20641624782,20641624781,-1,1561,2929,10
20645834805,20645834804,-1,927,1313,10
20652619379,20652619382,3,1194,1593,10
20655851206,20655851204,-2,1417,3117,10
20657187955,20657187952,-3,1314,2783,10
20661235592,20661235590,-2,1270,2521,10
20665361640,20665361640,0,1107,1668,10
20667754584,20667754590,6,5511,2876,10
20669261847,20669261848,1,1590,2082,10
20670949950,20670949948,-2,927,1640,10
20674669473,20674669471,-2,1205,1601,10
20677817001,20677817001,0,1021,1805,10
20679546460,20679546459,-1,1312,1924,10
20689153798,20689153797,-1,1149,1653,10
20690985781,20690985781,0,1335,2668,10
20694014381,20694014378,-3,1230,2321,10
20694609765,20694609763,-2,1064,2037,10
20695383406,20695383406,0,1393,2139,10
20698084770,20698084770,0,1854,3013,10
20702467442,20702467441,-1,1222,2342,10
20707469489,20707469488,-1,1051,1346,10
20713499274,20713499273,-1,1306,1811,10
20722393173,20722393173,0,1107,1728,10
20727184563,20727184561,-2,876,1869,10
20729107605,20729107605,0,1172,1894,10
20729553594,20729553582,-12,948,1009,10
20729745823,20729745822,-1,804,2481,10
20731137366,20731137363,-3,1593,2370,10
20733393540,20733393538,-2,18971,10784,10
20734090354,20734090354,0,1735,2218,10
20740583431,20740583439,8,3648,1286,10
20742748711,20742748710,-1,1143,2735,10
20747448410,20747448406,-4,1470,4088,10
20753057212,20753057211,-1,1213,1319,10
20756689350,20756689350,0,1104,1813,10
20768121338,20768121337,-1,1344,1435,10
20769556798,20769556799,1,1329,2447,10
20770265754,20770265753,-1,596,1282,10
20770835704,20770835702,-2,1282,1300,10
20772163387,20772163386,-1,1415,2511,10
20772248274,20772248295,21,1281,2255,10
20773567799,20773567794,-5,889,3620,10
20775138418,20775138418,0,1354,2107,10
20775191614,20775191612,-2,1371,2447,10
20775668721,20775668719,-2,1071,2191,10
20777809412,20777809411,-1,1108,1899,10
20781258251,20781258251,0,1237,2252,10
20783128346,20783128345,-1,853,1505,10
20783381602,20783381602,0,1017,1862,10
20784398503,20784398503,0,1120,1349,10
20792222170,20792222168,-2,929,2537,10
20793550171,20793550169,-2,1055,1880,10
20794328502,20794328501,-1,1171,1630,10
20795181505,20795181503,-2,1662,2132,10
20796575310,20796575306,-4,1010,1400,10
20797821583,20797821581,-2,923,1882,10
20798465065,20798465066,1,933,1338,10
20806540496,20806540494,-2,1546,1885,10
20808204595,20808204597,2,1103,1330,10
20811264904,20811264902,-2,1201,2563,10
20813965359,20813965356,-3,1070,2174,10
20814157774,20814157774,0,1746,2116,10
20816461759,20816461757,-2,1649,2192,10
20818180264,20818180265,1,1308,2522,10
20818635467,20818635466,-1,1187,1726,10
20818910422,20818910421,-1,1299,2294,10
20828607867,20828607866,-1,1275,2592,10
20830987297,20830987297,0,1440,2650,10
20836241346,20836241344,-2,557,1316,10
20837303166,20837303171,5,1244,21909,10
20837997890,20837997889,-1,1364,1844,10
20838671701,20838671697,-4,1527,3867,10
20841629851,20841629847,-4,1291,3155,10
20845236231,20845236229,-2,1212,1665,10
20849329135,20849329135,0,1465,2149,10
20850811998,20850811998,0,1880,2144,10
20853424122,20853424121,-1,858,1848,10
20855226853,20855226859,6,2840,1130,10
20856390691,20856390689,-2,369,1072,10
20866684978,20866684974,-4,1194,2720,10
20869282566,20869282564,-2,1089,2237,10
20869650442,20869650441,-1,1366,2364,10
20872771581,20872771578,-3,1271,1932,10
20878235431,20878235430,-1,926,2049,10
20880377860,20880377861,1,1188,1810,10
20884218795,20884218782,-13,1302,1702,10
20890973733,20890973731,-2,1100,1759,10
20898787351,20898787350,-1,1114,1839,10
20900114294,20900114293,-1,1408,1528,10
20903001526,20903001527,1,1240,1518,10
20907479461,20907479461,0,800,1740,10
20908109242,20908109242,0,907,1714,10
20912612031,20912612030,-1,1082,2294,10
20913130009,20913130006,-3,1395,1978,10
20915113500,20915113500,0,1820,2001,10
20917143815,20917143814,-1,1127,1742,10
20920703858,20920703870,12,1052,1555,10
20923469963,20923469961,-2,1706,2212,10
20926871190,20926871189,-1,1010,1062,10
20928004826,20928004829,3,3466,1846,10
20928451197,20928451194,-3,1109,1723,10
20930295331,20930295329,-2,979,2233,10
20933620644,20933620641,-3,1051,3580,10
20937576334,20937576334,0,1366,1871,10
20939005800,20939005797,-3,1102,2813,10
20939937443,20939937441,-2,1393,3674,10
20941221297,20941221296,-1,2154,1773,10
20942452408,20942452402,-6,1208,2996,10
20946631911,20946631909,-2,1108,2262,10
20951839822,20951839820,-2,1868,2452,10
20952859189,20952859187,-2,1503,2029,10
20954510405,20954510398,-7,2702,7776,10
20959752494,20959752491,-3,1507,3089,10
20960246769,20960246763,-6,1360,3075,10
20961001523,20961001522,-1,1269,1458,10
20961417466,20961417461,-5,224,1773,10
20964371819,20964371838,19,1445,2361,10
20965462799,20965462799,0,1147,1695,10
20969294773,20969294772,-1,1571,1764,10
20970790482,20970790478,-4,948,3820,10
20971434235,20971434234,-1,1334,1609,10
20973725695,20973725693,-2,702,1601,10
20974825906,20974825902,-4,961,1757,10
20975433189,20975433188,-1,2333,2366,10
20977228605,20977228605,0,15368,17253,10
20980421946,20980421942,-4,993,2268,10
20984956611,20984956610,-1,1425,2062,10
20986725215,20986725214,-1,1024,1769,10
20989984412,20989984409,-3,766,1630,10
20990786035,20990786033,-2,853,979,10
20992589002,20992588998,-4,1352,2933,10
20998291753,20998291749,-4,2037,4759,10
21001620399,21001620397,-2,1602,2039,10
21004637931,21004637931,0,1183,1408,10
21007879086,21007879085,-1,1505,2487,10
21009680010,21009680009,-1,1283,2317,10
21013055421,21013055418,-3,1208,1513,10
21015734574,21015734575,1,1843,2317,10
21016973507,21016973507,0,1141,1762,10
21022052343,21022052341,-2,897,1620,10
21026233533,21026233530,-3,1453,2563,10
21031468186,21031468185,-1,1222,1855,10
21032045396,21032045398,2,1568,1369,10
21034010970,21034010970,0,1172,1542,10
21035991140,21035991138,-2,1039,1917,10
21039016214,21039016213,-1,1173,2683,10
21043317352,21043317349,-3,1052,3758,10
21046669406,21046669405,-1,1223,1776,10
21051289027,21051289027,0,1151,1219,10
21051901198,21051901197,-1,1070,2051,10
21054269007,21054268997,-10,46294,9532,10
21056375457,21056375453,-4,1456,2536,10
21059740234,21059740235,1,1546,2445,10
21069261201,21069261198,-3,1413,2908,10
21070696202,21070696199,-3,1696,2216,10
21075967450,21075967450,0,1065,1675,10
21081382000,21081381999,-1,1057,1402,10
21082908158,21082908156,-2,1327,1930,10
21084222215,21084222213,-2,1402,1698,10
21085662299,21085662295,-4,880,2176,10
21086997615,21086997614,-1,729,1150,10
21087836634,21087836631,-3,1343,1645,10
21088161682,21088161680,-2,1627,2255,10
21091100843,21091100841,-2,1414,1680,10
21092052331,21092052330,-1,1250,2364,10
21093687598,21093687597,-1,1032,1999,10
21093732641,21093732638,-3,1473,1868,10
21095040758,21095040758,0,1069,1567,10
21095699593,21095699591,-2,1136,2014,10
21096680487,21096680490,3,1020,1007,10
21099739405,21099739405,0,1929,2185,10
21102078426,21102078423,-3,1307,1716,10
21103278266,21103278265,-1,815,1424,10
21103488999,21103488997,-2,1031,1749,10
21107606883,21107606879,-4,771,2162,10
21109955722,21109955718,-4,1162,2023,10
21114320029,21114320028,-1,1297,3283,10
21116734918,21116734918,0,1022,1396,10
21117238538,21117238538,0,1355,1910,10
21119298385,21119298382,-3,1384,2190,10
21120920570,21120920591,21,1462,2081,10
21129825923,21129825922,-1,805,1456,10
21150993952,21150993949,-3,1012,2717,10
21154959911,21154959908,-3,1363,1997,10
21165093917,21165093917,0,2014,1649,10
21167949509,21167949509,0,764,2652,10
21171039938,21171039937,-1,1639,2163,10
21175832441,21175832440,-1,1794,1607,10
21175905524,21175905525,1,1394,2052,10
21177199283,21177199281,-2,1011,2715,10
21180051633,21180051637,4,2424,1651,10
21180826989,21180826978,-11,1091,1639,10
21182750188,21182750190,2,2122,1593,10
21183784668,21183784668,0,40040,25400,10
21184479758,21184479755,-3,973,2123,10
21184902778,21184902775,-3,1341,2292,10
21187646638,21187646637,-1,1567,2022,10
21188000582,21188000581,-1,1457,2125,10
21195235689,21195235689,0,1368,2769,10
21196571962,21196571962,0,1722,1915,10
21196761758,21196761763,5,2760,1333,10
21198367439,21198367438,-1,1215,2089,10
21201729107,21201729106,-1,1750,2799,10
21206371046,21206371045,-1,863,1823,10
21207619132,21207619134,2,18377,29891,10
21209154399,21209154397,-2,1391,2168,10
21209264144,21209264143,-1,1633,2563,10
21210363586,21210363583,-3,1005,1764,10
21210746605,21210746602,-3,799,3074,10
21210942609,21210942594,-15,856,2517,10
21213171362,21213171359,-3,859,1835,10
21214722479,21214722477,-2,1826,2335,10
21225760010,21225760031,21,571,1240,10
21227778251,21227778249,-2,782,2041,10
21228481541,21228481539,-2,1175,1430,10
21232036323,21232036322,-1,1024,2004,10
21239209305,21239209314,9,2093,1065,10
21243162294,21243162291,-3,905,1164,10
21245257154,21245257154,0,378,1851,10
21248169387,21248169385,-2,1060,1275,10
21248956482,21248956481,-1,1281,2415,10
21249362504,21249362503,-1,1154,1531,10
21251261925,21251261925,0,1325,2588,10
21253377005,21253377006,1,1596,2049,10
21253466480,21253466479,-1,1047,1612,10
21257335231,21257335229,-2,1349,2047,10
21257612026,21257612024,-2,1200,1926,10
21258327107,21258327105,-2,1212,2578,10
21259546778,21259546782,4,1198,1648,10
21260964114,21260964113,-1,1772,2176,10
21263279111,21263279110,-1,1326,1746,10
21268116189,21268116194,5,1199,1236,10
21272011995,21272011994,-1,1079,1612,10
21272752051,21272752050,-1,526,1462,10
21277511936,21277511934,-2,1018,1134,10
21279836054,21279836055,1,1134,1844,10
21280426410,21280426409,-1,1336,2100,10
21280650115,21280650133,18,1389,2277,10
21284882746,21284882743,-3,1517,1871,10
21285085769,21285085769,0,1815,2621,10
21286013891,21286013889,-2,1799,2239,10
21286736280,21286736281,1,803,1415,10
21288189127,21288189126,-1,1177,2364,10
21289279706,21289279707,1,1042,1175,10
21289847613,21289847613,0,1292,1810,10
21297977654,21297977653,-1,1629,1793,10
21304622358,21304622358,0,1270,1837,10
21306971967,21306971965,-2,766,1972,10
21309733258,21309733258,0,927,1851,10
21310099673,21310099671,-2,1093,1382,10
21312888401,21312888399,-2,994,1396,10
21316257166,21316257163,-3,2789,5049,10
21320387433,21320387433,0,1062,1385,10
21323851503,21323851500,-3,1335,1708,10
21327187159,21327187159,0,1817,1737,10
21330024718,21330024718,0,1000,2415,10
21331701506,21331701503,-3,1331,2058,10
21332860070,21332860069,-1,1212,2235,10
21336390570,21336390570,0,1578,1123,10
21338541906,21338541905,-1,1627,1607,10
21347558772,21347558778,6,5452,1798,10
21349634117,21349634114,-3,1119,1792,10
21353059251,21353059249,-2,1179,1507,10
21354358158,21354358178,20,199,989,10
21354598557,21354598553,-4,1890,3209,10
21359831952,21359831951,-1,2038,2004,10
21359892009,21359892009,0,1374,1852,10
21360428062,21360428066,4,3559,1629,10
21365623667,21365623665,-2,732,1320,10
21367581818,21367581816,-2,1309,1482,10
21367754430,21367754429,-1,1033,1616,10
21368199182,21368199180,-2,875,1142,10
21376224065,21376224063,-2,1772,2032,10
21376340815,21376340818,3,1463,1446,10
21377878827,21377878826,-1,787,1539,10
21378224846,21378224845,-1,1743,2277,10
21379506354,21379506351,-3,1159,1589,10
21379749401,21379749399,-2,1158,2227,10
21382735632,21382735630,-2,1216,1902,10
21383651202,21383651202,0,1260,1859,10
21385616862,21385616860,-2,1562,2992,10
21399116782,21399116782,0,703,1461,10
21404251678,21404251679,1,1332,1859,10
21407218292,21407218290,-2,1132,1718,10
21409037674,21409037674,0,1150,1856,10
21411290933,21411290931,-2,1536,1575,10
21418847076,21418847074,-2,875,2379,10
21424168290,21424168289,-1,740,1486,10
21428424405,21428424400,-5,1001,3520,10
21428541602,21428541600,-2,921,1284,10
21430355187,21430355181,-6,763,1733,10
21432105770,21432105771,1,1195,1779,10
21436082298,21436082297,-1,1381,2344,10
21436979635,21436979633,-2,1032,1740,10
21437362226,21437362227,1,1624,2528,10
21439944439,21439944436,-3,1266,2138,10
21441397957,21441397955,-2,1283,2512,10
21446240402,21446240403,1,1328,2189,10
21446449706,21446449706,0,1109,1943,10
21448080241,21448080241,0,1322,2184,10
21450439962,21450439961,-1,1239,1639,10
21457800039,21457800037,-2,1044,1629,10
21463417281,21463417283,2,1490,997,10
21471783829,21471783829,0,1076,1108,10
21473865705,21473865705,0,1074,1860,10
21477907667,21477907666,-1,760,1492,10
21478236817,21478236818,1,1418,2397,10
21479010170,21479010171,1,791,1539,10
21480810092,21480810092,0,1195,1773,10
21482788283,21482788279,-4,774,1555,10
21485700303,21485700303,0,1292,1339,10
21491117984,21491117977,-7,1173,3922,10
21492342712,21492342710,-2,1380,2597,10
21494635703,21494635702,-1,1222,2190,10
21496114377,21496114382,5,5682,2455,10
21499587971,21499587972,1,875,1948,10
21501225522,21501225522,0,1032,1984,10
21503246047,21503246046,-1,944,1482,10
21506078268,21506078275,7,2168,986,10
21512268133,21512268130,-3,1210,2072,10
21518862858,21518862859,1,987,1433,10
21522678285,21522678292,7,4703,1859,10
21523944481,21523944480,-1,981,2156,10
21526665626,21526665630,4,7000,21605,10
21528073394,21528073394,0,1012,1779,10
21536916937,21536916936,-1,1344,3078,10
21537220343,21537220339,-4,1174,1667,10
21537259626,21537259628,2,815,2319,10
21539891127,21539891122,-5,971,2921,10
21540159306,21540159306,0,744,993,10
21542387229,21542387226,-3,1454,2113,10
21543617789,21543617789,0,1241,2741,10
21543694182,21543694183,1,1039,1769,10
21545289754,21545289753,-1,1404,1911,10
21547411761,21547411763,2,1082,1354,10
21549688822,21549688818,-4,1332,1430,10
21554824403,21554824401,-2,1362,1689,10
21556210536,21556210535,-1,1135,1715,10
21561099647,21561099649,2,1553,1350,10
21563179986,21563179987,1,1824,2404,10
21564754167,21564754166,-1,985,2184,10
21569140750,21569140749,-1,1389,1743,10
21569352070,21569352069,-1,1914,2562,10
21571449185,21571449186,1,898,1194,10
21580932276,21580932274,-2,1589,2000,10
21582180766,21582180768,2,1558,1440,10
21585227760,21585227762,2,2865,2641,10
21589581504,21589581502,-2,1142,1741,10
21590768250,21590768247,-3,991,2122,10
21595410839,21595410837,-2,832,1604,10
21598726598,21598726597,-1,743,1006,10
21605526099,21605526093,-6,1064,3515,10
21606534902,21606534901,-1,1336,2045,10
21610110805,21610110804,-1,1327,1511,10
21614373794,21614373794,0,895,2066,10
21615688694,21615688694,0,1213,2245,10
21620063743,21620063739,-4,1111,1712,10
21623528127,21623528126,-1,1210,2401,10
21626635578,21626635578,0,1362,1810,10
21633991045,21633991043,-2,1455,1673,10
21638354855,21638354854,-1,1323,1687,10
21655129209,21655129207,-2,1281,2170,10
21658734903,21658734903,0,1012,1719,10
21659056099,21659056098,-1,933,1347,10
21660355143,21660355141,-2,1143,1614,10
21662314618,21662314618,0,1671,870,10
21666604486,21666604486,0,1179,1849,10
21673098595,21673098591,-4,1410,3459,10
21677950187,21677950187,0,1129,1885,10
21679845893,21679845892,-1,1140,2220,10
21680630863,21680630863,0,1166,2177,10
21680744050,21680744050,0,738,1275,10
21681323674,21681323672,-2,1369,1891,10
21689678162,21689678161,-1,1154,2000,10
21696076225,21696076222,-3,1662,2666,10
21699727376,21699727374,-2,1086,1059,10
21700382254,21700382253,-1,1904,2455,10
21700991423,21700991421,-2,1602,2552,10
21701034862,21701034862,0,768,1534,10
21702715352,21702715351,-1,1017,1941,10
21703814104,21703814103,-1,1320,2449,10
21705432667,21705432664,-3,1612,2313,10
21705950224,21705950222,-2,1184,2180,10
21711470070,21711470072,2,2887,2661,10
21713963062,21713963058,-4,1635,1918,10
21715152478,21715152478,0,1133,1567,10
21717800659,21717800654,-5,29940,1252,10
21719238707,21719238705,-2,1185,1751,10
21720049928,21720049926,-2,1937,2616,10
21720314246,21720314246,0,1140,1525,10
21723323326,21723323324,-2,1448,2298,10
21726059547,21726059566,19,1198,1571,10
21728653949,21728653945,-4,1012,1648,10
21729583528,21729583526,-2,943,1423,10
21730855888,21730855871,-17,883,1337,10
21734352910,21734352906,-4,1066,2168,10
21735047939,21735047938,-1,1215,1656,10
21736019818,21736019814,-4,2281,3702,10
21736088081,21736088078,-3,864,2378,10
21736241694,21736241693,-1,1725,2443,10
21737733554,21737733551,-3,1509,1391,10
21738003366,21738003361,-5,1144,2146,10
21739125941,21739125941,0,1037,1770,10
21740083803,21740083814,11,151,918,10
21744873347,21744873344,-3,1320,2378,10
21757214679,21757214676,-3,1103,2231,10
21758620498,21758620497,-1,1320,1871,10
21761220870,21761220867,-3,1322,1702,10
21769663538,21769663535,-3,1357,2063,10
21770702840,21770702837,-3,972,2125,10
21772055273,21772055273,0,1173,2506,10
21777078394,21777078394,0,845,1952,10
21778066942,21778066938,-4,1391,1887,10
21779577670,21779577675,5,3692,1428,10
21779617406,21779617405,-1,1164,1599,10
21781306614,21781306615,1,911,1345,10
21782524014,21782524014,0,1036,1408,10
21782862678,21782862677,-1,1202,2059,10
21783201507,21783201507,0,814,1211,10
21786421602,21786421600,-2,1510,2916,10
21791603246,21791603245,-1,1008,1569,10
21792494635,21792494635,0,1299,1376,10
21793785091,21793785111,20,616,1608,10
21795292871,21795292870,-1,1628,2219,10
21796511381,21796511380,-1,1123,2153,10
21797741970,21797741967,-3,598,1317,10
21799872661,21799872662,1,1182,1840,10
21800350189,21800350187,-2,1098,1757,10
21802888878,21802888878,0,853,1247,10
21806954642,21806954640,-2,1213,2147,10
21813902907,21813902909,2,19832,21253,10
21814505603,21814505600,-3,1196,2457,10
21814710927,21814710925,-2,979,1786,10
21816555842,21816555841,-1,1013,1865,10
21816956107,21816956106,-1,979,1723,10
21819698080,21819698079,-1,1255,1877,10
21825041698,21825041697,-1,1011,1483,10
21827090209,21827090208,-1,880,1333,10
21833037627,21833037626,-1,1393,1398,10
21834800096,21834800094,-2,1289,1869,10
21836402217,21836402218,1,1054,1276,10
21837502164,21837502154,-10,1018,1507,10
21842865434,21842865431,-3,1355,1791,10
21845117391,21845117396,5,3431,2442,10
21847316617,21847316639,22,1328,2245,10
21850193049,21850193048,-1,856,1893,10
21853541665,21853541667,2,1711,2186,10
21860008027,21860008019,-8,1274,4649,10
21860556809,21860556806,-3,903,1561,10
21863301919,21863301918,-1,980,1329,10
21863976418,21863976422,4,1141,1432,10
21866107035,21866107034,-1,1077,1472,10
21866656903,21866656902,-1,1043,2065,10
21866823818,21866823819,1,1500,1604,10
21870386108,21870386107,-1,1421,2196,10
21873806899,21873806897,-2,1074,1952,10
21876432458,21876432456,-2,832,1530,10
21877825667,21877825665,-2,1261,1784,10
21885595610,21885595605,-5,997,2281,10
21886521984,21886522003,19,1212,1745,10
21887988481,21887988478,-3,1152,2228,10
21888093624,21888093616,-8,1219,2292,10
21890950537,21890950534,-3,1041,2604,10
21892134799,21892134798,-1,946,1528,10
21897904839,21897904837,-2,897,1446,10
21900665315,21900665311,-4,1602,2907,10
21903367429,21903367427,-2,750,2635,10
21904616667,21904616665,-2,1442,2249,10
21907727266,21907727264,-2,1370,2295,10
21909106582,21909106587,5,2613,1159,10
21911531978,21911531975,-3,1267,2706,10
21911851843,21911851842,-1,906,1237,10
21917903391,21917903389,-2,1453,2065,10
21918043330,21918043329,-1,1149,1870,10
21918444418,21918444417,-1,1156,1817,10
21919255717,21919255715,-2,1725,1877,10
21920744734,21920744734,0,1829,2766,10
21922893325,21922893323,-2,959,1584,10
21925490101,21925490098,-3,1716,2364,10
21926295770,21926295769,-1,1371,2126,10
21927058258,21927058255,-3,1120,1781,10
21928661650,21928661655,5,2923,1265,10
21929808040,21929808041,1,908,1191,10
21930508696,21930508694,-2,1013,2227,10
21933084671,21933084669,-2,905,2103,10
21935240054,21935240051,-3,956,1857,10
21938559196,21938559193,-3,897,1991,10
21942440311,21942440307,-4,1056,1624,10
21943984282,21943984281,-1,1821,2271,10
21950116542,21950116541,-1,1224,2224,10
21953821894,21953821894,0,823,2268,10
21955573614,21955573608,-6,1336,2967,10
21959224615,21959224614,-1,817,1301,10
21959870756,21959870755,-1,1187,1539,10
21962506299,21962506305,6,2489,1715,10
21970237306,21970237305,-1,791,2253,10
21972385252,21972385249,-3,1350,2676,10
21973370234,21973370253,19,1295,1749,10
21974998060,21974998058,-2,827,1595,10
21978690991,21978690986,-5,1268,2460,10
21983581283,21983581280,-3,1534,2096,10
21987766730,21987766729,-1,1290,1441,10
21999620605,21999620610,5,2237,1187,10
22003223831,22003223830,-1,1610,2774,10
22008407893,22008407894,1,1404,1731,10
22009212303,22009212305,2,2097,1971,10
22010575741,22010575739,-2,1294,1822,10
22011378277,22011378276,-1,1480,2030,10
22017036474,22017036470,-4,987,2405,10
22019744927,22019744922,-5,1163,2935,10
22024212650,22024212649,-1,1182,1956,10
22024864621,22024864619,-2,1467,2964,10
22026141280,22026141278,-2,1446,1673,10
22026882423,22026882419,-4,970,2013,10
22030994639,22030994638,-1,1112,2192,10
22034470582,22034470578,-4,939,2380,10
22035473681,22035473679,-2,1216,2042,10
22037580315,22037580315,0,1057,2237,10
22042966214,22042966212,-2,1122,1698,10
22043161162,22043161141,-21,960,1312,10
22046016735,22046016734,-1,1593,2095,10
22047642114,22047642110,-4,1231,4116,10
22049052277,22049052275,-2,1389,1797,10
22051145310,22051145307,-3,1125,1390,10
22053628756,22053628754,-2,1713,1776,10
22059119495,22059119495,0,922,1737,10
22063608017,22063608016,-1,722,1298,10
22069008991,22069008990,-1,1477,2266,10
22069513142,22069513139,-3,1123,1419,10
22069625571,22069625577,6,3279,1496,10
22073013693,22073013692,-1,2351,2974,10
22080393614,22080393613,-1,1066,2013,10
22082276297,22082276297,0,1057,1249,10
22083230707,22083230705,-2,1413,1720,10
22084329407,22084329411,4,282,778,10
22085918551,22085918555,4,3479,1842,10
22086141346,22086141349,3,2195,1503,10
22086693917,22086693915,-2,1209,1269,10
22086820767,22086820767,0,941,1721,10
22090360746,22090360742,-4,1114,1968,10
22094584542,22094584551,9,180,852,10
22095276940,22095276940,0,1415,1627,10
22098647726,22098647723,-3,1167,2399,10
22100572451,22100572450,-1,1295,2420,10
22101439658,22101439658,0,1176,1814,10
22103637043,22103637047,4,2386,1687,10
22113037510,22113037511,1,1066,2185,10
22113812388,22113812395,7,49840,63315,10
22116672556,22116672568,12,14347,42792,10
22117797446,22117797453,7,3846,1443,10
22118223769,22118223766,-3,1653,2872,10
22118767398,22118767398,0,1293,2284,10
22123004764,22123004765,1,4806,15529,10
22124601973,22124601992,19,1685,1482,10
22126275754,22126275753,-1,1169,1526,10
22128659160,22128659158,-2,1264,2809,10
22129114089,22129114086,-3,1389,3598,10
22131154899,22131154899,0,1465,1652,10
22132037423,22132037420,-3,1408,1898,10
22132257442,22132257442,0,466,1085,10
22133520570,22133520569,-1,1195,1956,10
22135228923,22135228921,-2,1497,2547,10
22136285702,22136285701,-1,1288,2823,10
22136978646,22136978644,-2,1137,1707,10
22137267977,22137267972,-5,920,2446,10
22137445940,22137445957,17,542,1459,10
22139232522,22139232521,-1,959,2037,10
22146059402,22146059403,1,960,2042,10
22147646355,22147646353,-2,1536,1653,10
22148611794,22148611793,-1,1433,2339,10
22149999159,22149999158,-1,1824,1938,10
22153008753,22153008750,-3,595,2123,10
22154710233,22154710231,-2,1435,3550,10
22156732955,22156732954,-1,1085,1324,10
22157643858,22157643855,-3,1026,2379,10
22159731546,22159731544,-2,1192,2159,10
22162728714,22162728711,-3,910,1793,10
22163077984,22163077978,-6,1077,1868,10
22163340041,22163340035,-6,364,681,10
22165078307,22165078307,0,1147,1209,10
22167505673,22167505672,-1,929,2204,10
22169703749,22169703750,1,1350,1944,10
22170853166,22170853166,0,1126,1658,10
22171144165,22171144162,-3,1154,2247,10
22172969911,22172969910,-1,943,1662,10
22173868316,22173868313,-3,911,2009,10
22174136176,22174136199,23,867,1890,10
22174763414,22174763414,0,1136,1541,10
22176376193,22176376191,-2,904,1770,10
22177132495,22177132494,-1,40,1205,10
22177894101,22177894108,7,2358,1355,10
22179318814,22179318814,0,1336,2439,10
22180561641,22180561639,-2,864,2430,10
22184536441,22184536438,-3,826,2786,10
22192570066,22192570066,0,1119,2407,10
22193833003,22193833001,-2,1177,1802,10
22195161089,22195161088,-1,1451,2079,10
22196160038,22196160037,-1,861,1685,10
22202744918,22202744917,-1,534,1240,10
22203055107,22203055105,-2,1068,2088,10
22209008657,22209008655,-2,2035,2793,10
22209877568,22209877566,-2,1728,2398,10
22211819813,22211819811,-2,1296,1222,10
22214532579,22214532578,-1,1172,2292,10
22216346702,22216346701,-1,1588,2602,10
22218897841,22218897841,0,25061,35586,10
22219582442,22219582438,-4,1018,1674,10
22219738286,22219738283,-3,1272,1834,10
22219800519,22219800521,2,2115,1901,10
22220876263,22220876260,-3,1233,2328,10
22221129051,22221129049,-2,1409,2090,10
22221971969,22221971970,1,1884,1963,10
22225782082,22225782081,-1,950,1454,10
22226139145,22226139142,-3,592,1509,10
22226639289,22226639286,-3,883,1356,10
22229182077,22229182076,-1,1056,2294,10
22230881197,22230881195,-2,1209,2506,10
22234351350,22234351349,-1,1572,2535,10
22236477683,22236477681,-2,1358,2644,10
22239443282,22239443283,1,1261,1418,10
22240268624,22240268622,-2,1111,1751,10
22242674780,22242674778,-2,1443,2659,10
22244665231,22244665231,0,1431,3421,10
22245988187,22245988186,-1,1170,2473,10
22246476749,22246476748,-1,1684,1543,10
22248610278,22248610274,-4,1131,1523,10
22252964699,22252964699,0,723,859,10
22253312619,22253312617,-2,1630,2540,10
22253922911,22253922910,-1,769,2132,10
22259647279,22259647277,-2,1258,1517,10
22260419605,22260419604,-1,1112,1762,10
22262871631,22262871630,-1,1011,1768,10
22263464282,22263464262,-20,944,1167,10
22265646434,22265646434,0,1052,2004,10
22266211186,22266211187,1,997,1494,10
22269904958,22269904963,5,1635,1258,10
22270861953,22270861954,1,1336,1303,10
22273454586,22273454585,-1,1816,2337,10
22274395738,22274395737,-1,1512,2853,10
22274921666,22274921665,-1,1263,1960,10
22276924176,22276924179,3,1502,1392,10
22277281135,22277281135,0,1802,1921,10
22281242273,22281242270,-3,783,1695,10
22287382796,22287382794,-2,1162,2385,10
22287988302,22287988300,-2,1076,2167,10
22294411701,22294411701,0,1054,1603,10
22296407041,22296407045,4,2279,1389,10
22297194584,22297194583,-1,993,2199,10
22299775725,22299775727,2,55818,62874,10
22299925602,22299925601,-1,1721,2844,10
22310701929,22310701929,0,1996,3159,10
22311641418,22311641417,-1,796,1860,10
22314320264,22314320262,-2,1234,1528,10
22316472228,22316472226,-2,1243,1677,10
22317704345,22317704344,-1,2118,2610,10
22318892197,22318892197,0,1356,1270,10
22320297642,22320297641,-1,1154,1839,10
22321167890,22321167906,16,510,185,10
22324258238,22324258240,2,2295,2006,10
22326025272,22326025270,-2,725,1496,10
22329512274,22329512271,-3,585,1747,10
22329617320,22329617319,-1,269,734,10
22330006655,22330006654,-1,761,1813,10
22334707960,22334707960,0,855,1355,10
22340063601,22340063600,-1,1303,2273,10
22340404775,22340404778,3,1196,1359,10
22342244202,22342244202,0,1310,1477,10
22342575574,22342575573,-1,1112,1883,10
22343776501,22343776498,-3,1424,1620,10
22352073310,22352073309,-1,1321,2181,10
22355408221,22355408218,-3,1100,2441,10
22355806424,22355806421,-3,1287,2170,10
22356321795,22356321793,-2,1286,2051,10
22358217575,22358217570,-5,1114,1843,10
22359593116,22359593114,-2,564,1323,10
22361045584,22361045587,3,1061,1000,10
22362176863,22362176862,-1,1294,2039,10
22362355131,22362355126,-5,835,1594,10
22364955223,22364955222,-1,1183,1901,10
22366196614,22366196613,-1,1147,2439,10
22368384511,22368384510,-1,1479,2198,10
22371479722,22371479724,2,734,898,10
22375798253,22375798253,0,783,1184,10
22378600325,22378600319,-6,765,2912,10
22379371625,22379371624,-1,1037,1515,10
22380353285,22380353285,0,1212,1170,10
22383273021,22383273020,-1,1377,1755,10
22390077744,22390077751,7,5931,2096,10
22391397787,22391397786,-1,1696,3151,10
22391479138,22391479134,-4,1086,2010,10
22395562375,22395562373,-2,1249,1828,10
22398092233,22398092231,-2,1115,2289,10
22399621326,22399621327,1,1373,2100,10
22406832886,22406832882,-4,1529,2722,10
22407590687,22407590687,0,1280,1617,10
22407635493,22407635490,-3,2799,4579,10
22414585022,22414585022,0,1103,1626,10
22418990840,22418990839,-1,1598,1681,10
22424485479,22424485477,-2,1113,1931,10
22426061011,22426061010,-1,1606,2956,10
22426458588,22426458586,-2,1559,2582,10
22427825530,22427825529,-1,1197,2206,10
22429400246,22429400245,-1,1248,1386,10
22431861286,22431861285,-1,1351,1542,10
22434617794,22434617794,0,1533,2024,10
22436626194,22436626191,-3,1754,2579,10
22437413064,22437413062,-2,1090,1205,10
22441573671,22441573649,-22,1288,1825,10
22446545537,22446545534,-3,1467,2173,10
22446827909,22446827905,-4,1080,1732,10
22454595394,22454595392,-2,997,1750,10
22459813420,22459813431,11,16909,22758,10
22460629339,22460629339,0,1479,2059,10
22461501654,22461501654,0,1107,1476,10
22462046524,22462046518,-6,1974,8959,10
22469686343,22469686345,2,1266,1475,10
22470844362,22470844360,-2,1304,2161,10
22472141883,22472141880,-3,846,1539,10
22473004006,22473004005,-1,1434,1720,10
22483828294,22483828292,-2,1026,2000,10
22485030844,22485030842,-2,557,1532,10
22488069825,22488069828,3,3675,3057,10
22493569653,22493569650,-3,1535,2653,10
22495163824,22495163818,-6,1131,2037,10
22496008217,22496008215,-2,1252,1707,10
22504061740,22504061739,-1,1205,1783,10
22507924371,22507924373,2,1145,1426,10
22513369298,22513369298,0,1268,2622,10
22513587648,22513587645,-3,1131,1400,10
22514215460,22514215457,-3,1398,2565,10
22519773192,22519773190,-2,1371,1870,10
22521739526,22521739527,1,1230,1912,10
22524478459,22524478458,-1,1272,2212,10
22525338307,22525338302,-5,980,2126,10
22526744406,22526744403,-3,1235,1609,10
22529148506,22529148505,-1,1316,2356,10
22530436970,22530436970,0,791,1733,10
22530820801,22530820801,0,1155,1941,10
22533478804,22533478802,-2,1643,2732,10
22535091337,22535091334,-3,820,1464,10
22535423034,22535423031,-3,1628,2530,10
22536974375,22536974370,-5,986,2018,10
22541739057,22541739055,-2,1141,1541,10
22543970015,22543970013,-2,965,1837,10
22548307915,22548307914,-1,613,1465,10
22551043545,22551043544,-1,785,1760,10
22556066385,22556066385,0,1448,1612,10
22556770429,22556770433,4,1427,1219,10
22557882324,22557882326,2,1487,1217,10
22574896371,22574896370,-1,2064,2200,10
22576612090,22576612089,-1,755,1191,10
22577150683,22577150681,-2,1144,1352,10
22578616861,22578616859,-2,940,1747,10
22583093369,22583093369,0,1409,2410,10
22583735800,22583735800,0,1260,2094,10
22591918106,22591918105,-1,1354,1550,10
22593854214,22593854233,19,1107,1374,10
22593959177,22593959177,0,964,1542,10
22596829405,22596829402,-3,1017,1549,10
22599739058,22599739057,-1,1167,2010,10
22601124931,22601124927,-4,914,1604,10
22604738038,22604738039,1,946,1492,10
22605749961,22605749962,1,915,1063,10
22606140459,22606140457,-2,1412,2179,10
22607867448,22607867445,-3,2331,3475,10
22611259161,22611259159,-2,1311,1963,10
22618955637,22618955631,-6,1188,1971,10
22620971925,22620971931,6,2470,1086,10
22625122234,22625122234,0,1051,1435,10
22626172929,22626172933,4,2615,2003,10
22627577591,22627577591,0,965,2377,10
22628755678,22628755677,-1,803,1655,10
22629980626,22629980627,1,1597,1277,10
22631254547,22631254546,-1,1721,2448,10
22631666548,22631666547,-1,990,1054,10
22631797826,22631797823,-3,1426,2259,10
22633781482,22633781482,0,543,1519,10
22637479135,22637479134,-1,948,1659,10
22637560414,22637560413,-1,1138,1411,10
22644719966,22644719967,1,1258,1573,10
22645508627,22645508626,-1,1503,2047,10
22649392559,22649392556,-3,1444,3581,10
22650675294,22650675291,-3,973,1634,10
22650855362,22650855381,19,1922,2461,10
22651622678,22651622682,4,1302,1677,10
22656668141,22656668140,-1,1735,2399,10
22657789330,22657789329,-1,1487,2551,10
22657821918,22657821917,-1,939,1838,10
22659040223,22659040222,-1,1481,1998,10
22660161194,22660161189,-5,1122,2294,10
22668375417,22668375415,-2,1343,2144,10
22670799110,22670799108,-2,1297,1356,10
22671092859,22671092857,-2,1453,2347,10
22672863122,22672863107,-15,10338,33692,10
22673091771,22673091769,-2,1194,2939,10
22676918883,22676918882,-1,1266,1885,10
22679161497,22679161494,-3,1081,2278,10
22686600231,22686600230,-1,1440,1430,10
22688295915,22688295910,-5,935,1619,10
22689142449,22689142453,4,1787,1317,10
22692607207,22692607205,-2,975,1852,10
22693116805,22693116802,-3,2080,4707,10
22696929291,22696929289,-2,1334,2623,10
22702000558,22702000554,-4,1290,2874,10
22703657059,22703657057,-2,1728,2583,10
22703818739,22703818737,-2,1341,2549,10
22708642973,22708642970,-3,1125,2130,10
22714079948,22714079947,-1,969,1341,10
22720532854,22720532853,-1,875,1843,10
22726879148,22726879147,-1,1289,1383,10
22735120544,22735120542,-2,1353,2128,10
22737943407,22737943406,-1,1766,2527,10
22743448519,22743448518,-1,1255,1779,10
22746067583,22746067582,-1,814,1187,10
22753171870,22753171870,0,1451,1427,10
22758294174,22758294171,-3,1714,2697,10
22762666811,22762666812,1,1114,1521,10
22763452142,22763452138,-4,944,1716,10
22764737526,22764737525,-1,928,1237,10
22764961413,22764961409,-4,1144,2142,10
22767531673,22767531669,-4,1268,3003,10
22767937814,22767937811,-3,1247,1413,10
22769329055,22769329054,-1,964,1650,10
22770507629,22770507630,1,1032,1834,10
22771306995,22771306982,-13,1048,1847,10
22772175827,22772175824,-3,1068,2416,10
22775801232,22775801230,-2,1230,1550,10
22775978678,22775978677,-1,1098,2094,10
22777080544,22777080542,-2,956,1663,10
22780273706,22780273705,-1,1155,1626,10
22780828485,22780828487,2,1679,1720,10
22781424903,22781424901,-2,1205,1956,10
22781858611,22781858610,-1,1191,2063,10
22783542125,22783542124,-1,870,1298,10
22783994060,22783994058,-2,1543,1967,10
22785289793,22785289790,-3,544,1001,10
22786666663,22786666661,-2,1388,2481,10
22787405611,22787405612,1,1178,1426,10
22789655048,22789655046,-2,1199,2335,10
22790894702,22790894698,-4,894,3351,10
22792796391,22792796390,-1,1204,909,10
22793641630,22793641630,0,1438,1613,10
22798646548,22798646546,-2,1209,1725,10
22800764097,22800764098,1,1565,2076,10
22802605094,22802605094,0,1178,1709,10
22806705254,22806705253,-1,1355,2246,10
22809741601,22809741598,-3,697,1624,10
22811696087,22811696089,2,1254,2505,10
22815459607,22815459604,-3,804,1588,10
22815523610,22815523608,-2,1152,1801,10
22818894795,22818894794,-1,1616,2156,10
22828495581,22828495581,0,1002,1314,10
22829722854,22829722850,-4,1096,1509,10
22830786165,22830786162,-3,733,1242,10
22831423483,22831423461,-22,282,1743,10
22833680531,22833680528,-3,708,1288,10
22834350966,22834350965,-1,978,1912,10
22841767153,22841767159,6,3302,1917,10
22842490986,22842490983,-3,1283,2616,10
22845890888,22845890887,-1,783,1751,10
22846096917,22846096918,1,926,1151,10
22850207186,22850207182,-4,729,1416,10
22851791722,22851791723,1,1455,1354,10
22853195343,22853195342,-1,1159,1655,10
22855025223,22855025223,0,1383,1662,10
22855897607,22855897604,-3,1731,2319,10
22856542470,22856542467,-3,1003,1910,10
22856966385,22856966384,-1,1125,2094,10
22858216342,22858216342,0,1193,1753,10
22859755677,22859755675,-2,1082,1737,10
22862153209,22862153209,0,1561,2541,10
22863849761,22863849759,-2,1304,1961,10
22869113662,22869113659,-3,1281,1757,10
22870346118,22870346116,-2,891,2214,10
22872522390,22872522390,0,1549,2079,10
22878767623,22878767623,0,1300,1663,10
22885021279,22885021278,-1,834,2077,10
22889790703,22889790702,-1,1415,1778,10
22894243236,22894243236,0,1170,1716,10
22895497841,22895497839,-2,953,1640,10
22895969387,22895969386,-1,1175,1731,10
22899961926,22899961931,5,1958,1052,10
22906463343,22906463341,-2,878,1417,10
22908604228,22908604226,-2,1452,1831,10
22911613369,22911613366,-3,1363,1856,10
22912856276,22912856274,-2,1131,1848,10
22913073163,22913073153,-10,1063,1794,10
22913558850,22913558871,21,1595,1927,10
22918652226,22918652222,-4,1235,1708,10
22919326904,22919326903,-1,1371,1694,10
22920019637,22920019636,-1,1508,2511,10
22920426036,22920426034,-2,1565,2473,10
22924995613,22924995611,-2,1304,2162,10
22935647963,22935647962,-1,1173,1473,10
22936385320,22936385318,-2,1675,1976,10
22938354175,22938354174,-1,1275,1643,10
22939270177,22939270175,-2,1150,2588,10
22939457702,22939457702,0,1584,2273,10
22944433143,22944433142,-1,1035,1802,10
22949633910,22949633923,13,11712,49818,10
22950935101,22950935102,1,1221,1425,10
22953232192,22953232191,-1,973,2157,10
22960816758,22960816757,-1,2804,18291,10
22961392371,22961392389,18,910,1648,10
22963215662,22963215665,3,2663,2518,10
22965938789,22965938786,-3,1496,2472,10
22966823720,22966823723,3,1947,1563,10
22971338052,22971338050,-2,1122,2276,10
22972718674,22972718672,-2,1186,2034,10
22975391895,22975391893,-2,1176,1875,10
22980222875,22980222874,-1,1477,1701,10
22981252345,22981252343,-2,381,836,10
22981590505,22981590493,-12,794,2245,10
22984273387,22984273386,-1,1247,1592,10
22984395287,22984395286,-1,1760,1900,10
22985987027,22985987027,0,1305,1907,10
22987108001,22987108000,-1,2009,3293,10
22987863310,22987863302,-8,1104,6535,10
22990808442,22990808441,-1,1328,3029,10
22992003678,22992003678,0,1475,2388,10
22992655450,22992655451,1,767,1288,10
22997909277,22997909278,1,845,1330,10
22999699618,22999699617,-1,1664,2250,10
23003272325,23003272333,8,2752,841,10
23018544862,23018544860,-2,1096,1919,10
23020971950,23020971947,-3,1099,2234,10
23021404732,23021404738,6,1579,1080,10
23022242150,23022242150,0,853,995,10
23026949830,23026949831,1,1281,1008,10
23028408974,23028408971,-3,1137,1708,10
23028499622,23028499621,-1,1224,1469,10
23029966342,23029966339,-3,1129,2033,10
23031440523,23031440522,-1,1648,1909,10
23031866402,23031866393,-9,933,1626,10
23036458346,23036458344,-2,1106,1552,10
23037505261,23037505281,20,906,2012,10
23040059534,23040059531,-3,865,2026,10
23040154185,23040154185,0,1239,1804,10
23043432508,23043432505,-3,1537,1876,10
23044245058,23044245058,0,1539,1131,10
23050062002,23050061999,-3,814,2067,10
23051463100,23051463098,-2,1183,1768,10
23054384749,23054384743,-6,1105,2575,10
23055286518,23055286516,-2,1683,1588,10
23057151942,23057151941,-1,1585,2005,10
23063153253,23063153259,6,10156,4494,10
23063361139,23063361140,1,1242,2575,10
23065304005,23065304003,-2,1406,1892,10
23065653062,23065653059,-3,973,2373,10
23065681306,23065681301,-5,1285,4022,10
23066097636,23066097655,19,1042,1622,10
23066202131,23066202129,-2,2546,3956,10
23067019639,23067019638,-1,1325,1914,10
23067402552,23067402545,-7,1221,2101,10
23071220238,23071220236,-2,981,2165,10
23072114462,23072114461,-1,1911,2384,10
23075825158,23075825157,-1,1566,2888,10
23076826549,23076826548,-1,32253,19340,10
23076946149,23076946148,-1,1031,1203,10
23079039666,23079039661,-5,1042,3952,10
23079187935,23079187933,-2,1656,1545,10
23083924601,23083924599,-2,1188,2212,10
23084648250,23084648254,4,1815,1270,10
23087091836,23087091836,0,939,1482,10
23088497739,23088497741,2,1400,1523,10
23088904282,23088904282,0,1170,2103,10
23094080262,23094080262,0,1065,1467,10
23095874399,23095874398,-1,1179,2432,10
23097411165,23097411164,-1,1244,1958,10
23098192246,23098192246,0,1316,1495,10
23099282475,23099282473,-2,1680,1869,10
23101112186,23101112185,-1,564,1673,10
23101404091,23101404091,0,1274,1922,10
23104628686,23104628682,-4,1637,1976,10
23107518050,23107518050,0,1867,2106,10
23107586252,23107586251,-1,1340,1409,10
23112552494,23112552495,1,663,1345,10
23114791328,23114791329,1,1570,1669,10
23115596253,23115596251,-2,842,1558,10
23115957243,23115957242,-1,1525,1662,10
23116507125,23116507123,-2,711,1759,10
23116752042,23116752042,0,1549,2046,10
23122470266,23122470265,-1,1287,2071,10
23123316489,23123316486,-3,1403,1657,10
23123485527,23123485527,0,803,1162,10
23126280198,23126280198,0,1071,1907,10
23126787054,23126787054,0,1060,2467,10
23129511967,23129511965,-2,1131,2512,10
23132529469,23132529469,0,1536,2175,10
23136996131,23136996129,-2,810,1323,10
23139466952,23139466947,-5,1475,1701,10
23146081014,23146081014,0,660,1659,10
23147330638,23147330642,4,1293,740,10
23149593676,23149593674,-2,944,2137,10
23151837983,23151837982,-1,1498,2568,10
23152081458,23152081438,-20,1137,2668,10
23153669019,23153669017,-2,1145,1806,10
23155959254,23155959252,-2,1236,2062,10
23157107054,23157107053,-1,1221,2082,10
23157701521,23157701520,-1,1220,1863,10
23161458657,23161458655,-2,1069,2199,10
23161722466,23161722466,0,744,1918,10
23164405117,23164405115,-2,1195,2270,10
23170787166,23170787164,-2,1053,2474,10
23177979311,23177979310,-1,1123,1447,10
23178170816,23178170814,-2,977,1013,10
23179318205,23179318206,1,1269,1996,10
23185528113,23185528112,-1,1033,1941,10
23187128554,23187128552,-2,1772,2136,10
23188577431,23188577430,-1,825,2601,10
23192128360,23192128360,0,1893,1993,10
23195656946,23195656950,4,2069,1176,10
23197778459,23197778458,-1,1161,1922,10
23199730664,23199730662,-2,1733,1980,10
23199909155,23199909133,-22,1089,1457,10
23200624395,23200624395,0,990,2596,10
23200837658,23200837658,0,1474,2056,10
23201759492,23201759489,-3,1778,2220,10
23202260774,23202260772,-2,1474,2092,10
23202978604,23202978602,-2,1637,1361,10
23209483028,23209483027,-1,1355,1990,10
23213445190,23213445190,0,2827,3251,10
23213665755,23213665754,-1,536,824,10
23214790934,23214790939,5,2538,1410,10
23216950533,23216950531,-2,1448,2188,10
23218982723,23218982725,2,1138,1648,10
23220368823,23220368821,-2,1469,2121,10
23223061277,23223061274,-3,1308,2618,10
23225815519,23225815519,0,1545,2449,10
23235188059,23235188058,-1,1168,2529,10
23235986830,23235986829,-1,1664,2343,10
23236156621,23236156618,-3,920,1610,10
23243289552,23243289554,2,983,1302,10
23247616360,23247616361,1,1904,2043,10
23248388334,23248388332,-2,1254,1929,10
23250192857,23250192857,0,985,1529,10
23250427451,23250427450,-1,775,1446,10
23251459438,23251459437,-1,944,1755,10
23252820413,23252820419,6,3656,1981,10
23253480880,23253480878,-2,1308,2474,10
23253613079,23253613079,0,1120,1885,10
23257236480,23257236478,-2,1401,2031,10
23258296386,23258296386,0,1240,1869,10
23258606921,23258606906,-15,875,1120,10
23263573825,23263573825,0,995,2035,10
23265407299,23265407297,-2,984,2042,10
23265753352,23265753349,-3,1374,2096,10
23268377970,23268377970,0,1074,2434,10
23273292153,23273292153,0,1204,1981,10
23273399706,23273399706,0,1278,1673,10
23279073955,23279073954,-1,1059,1293,10
23280094077,23280094076,-1,998,1907,10
23284251757,23284251755,-2,1459,1931,10
23288895146,23288895145,-1,1946,1578,10
23291289365,23291289362,-3,1195,2439,10
23293293923,23293293922,-1,1218,2331,10
23294829330,23294829330,0,850,1613,10
23295578686,23295578678,-8,1285,2286,10
23298558602,23298558599,-3,1319,1767,10
23299184070,23299184067,-3,1388,2156,10
23301136518,23301136516,-2,1444,1680,10
23301196205,23301196202,-3,1328,2311,10
23303541555,23303541553,-2,1032,1659,10
23308905301,23308905302,1,964,1680,10
23309191831,23309191827,-4,788,2367,10
23313358882,23313358880,-2,1281,2457,10
23323813081,23323813081,0,1279,2072,10
23324184954,23324184952,-2,1259,1675,10
23324464773,23324464771,-2,1454,2835,10
23327216798,23327216803,5,2317,1635,10
23331849435,23331849435,0,1412,1320,10
23334205358,23334205340,-18,1311,1402,10
23335018745,23335018743,-2,1335,2592,10
23337150482,23337150482,0,1428,2067,10
23339036857,23339036862,5,2591,1519,10
23339369306,23339369304,-2,1418,2454,10
23339629106,23339629106,0,824,1785,10
23341889246,23341889245,-1,919,2218,10
23343539451,23343539450,-1,1422,2569,10
23344783686,23344783686,0,1520,2537,10
23344853338,23344853338,0,1124,1923,10
23345602019,23345602013,-6,1115,3014,10
23345671730,23345671728,-2,948,1146,10
23346403851,23346403839,-12,1312,2623,10
23348902838,23348902838,0,998,2071,10
23349659714,23349659712,-2,1401,2087,10
23350312194,23350312191,-3,1027,1882,10
23354778699,23354778699,0,1494,2144,10
23361129951,23361129948,-3,1222,2007,10
23362758017,23362758022,5,2977,1099,10
23370195105,23370195104,-1,914,1988,10
23372984786,23372984782,-4,1103,2095,10
23380106685,23380106685,0,1215,1776,10
23382525534,23382525535,1,1336,1676,10
23383017623,23383017621,-2,1190,1586,10
23383392775,23383392770,-5,813,1575,10
23384248455,23384248454,-1,1026,1501,10
23386717287,23386717285,-2,1353,1754,10
23388334145,23388334143,-2,1560,1859,10
23389061435,23389061435,0,1392,2540,10
23389115257,23389115257,0,1157,2147,10
23389596005,23389596002,-3,1406,2209,10
23390637479,23390637479,0,1198,1036,10
23394053572,23394053572,0,1070,1940,10
23396604263,23396604266,3,1622,1274,10
23397027379,23397027378,-1,1024,1557,10
23398509267,23398509265,-2,1183,1780,10
23400654606,23400654604,-2,1218,1842,10
23402617583,23402617583,0,1340,2163,10
23407123400,23407123393,-7,2707,8599,10
23410551229,23410551226,-3,1114,1804,10
23414163574,23414163573,-1,1097,1540,10
23417509263,23417509263,0,1365,2584,10
23418119125,23418119122,-3,1330,1308,10
23418311123,23418311122,-1,1182,1967,10
23419554870,23419554870,0,1964,2905,10
23424270040,23424270038,-2,1663,1957,10
23426630101,23426630097,-4,901,1695,10
23427617025,23427617026,1,1247,1832,10
23431049662,23431049661,-1,1131,2014,10
23431958448,23431958446,-2,1289,2086,10
23432987001,23432987000,-1,1040,1945,10
23435942813,23435942808,-5,697,1443,10
23437660941,23437660942,1,1879,1168,10
23440088135,23440088134,-1,1169,2458,10
23443228934,23443228933,-1,1391,1832,10
23444700581,23444700578,-3,924,902,10
23450347706,23450347702,-4,959,2122,10
23458668563,23458668561,-2,1127,1954,10
23458869987,23458869984,-3,998,1814,10
23458959782,23458959781,-1,1271,1976,10
23463838239,23463838238,-1,1663,2630,10
23464986599,23464986598,-1,982,1766,10
23471940706,23471940704,-2,1480,2149,10
23473306329,23473306329,0,1335,2069,10
23474083700,23474083700,0,1255,2490,10
23479912030,23479912030,0,881,2345,10
23480521730,23480521729,-1,1206,1182,10
23483344658,23483344656,-2,1220,2273,10
23483397855,23483397854,-1,1665,2290,10
23484265455,23484265453,-2,1237,1574,10
23487494003,23487494002,-1,1473,2507,10
23487623895,23487623895,0,1232,2643,10
23489715834,23489715835,1,1084,1641,10
23497722144,23497722142,-2,989,1731,10
23500233167,23500233165,-2,1367,1954,10
23501925993,23501925996,3,1585,1754,10
23503204762,23503204761,-1,698,1743,10
23507463083,23507463082,-1,646,1124,10
23508714362,23508714361,-1,1180,1989,10
23510044653,23510044651,-2,1433,1741,10
23513793371,23513793369,-2,1086,1007,10
23519621666,23519621665,-1,780,1716,10
23521483668,23521483668,0,1222,1904,10
23522236344,23522236345,1,3060,3729,10
23524753662,23524753662,0,1321,1571,10
23525470439,23525470436,-3,1133,2346,10
23526083174,23526083173,-1,1119,1789,10
23527541547,23527541546,-1,1428,1976,10
23533306553,23533306552,-1,1579,2372,10
23534943687,23534943689,2,957,1501,10
23538926249,23538926249,0,870,1373,10
23542751812,23542751809,-3,1222,1905,10
23547890491,23547890486,-5,1485,1770,10
23551498401,23551498400,-1,938,1481,10
23557070675,23557070669,-6,1097,2456,10
23558704575,23558704581,6,2932,1429,10
23560030151,23560030149,-2,900,1425,10
23561167256,23561167255,-1,1217,1613,10
23563774270,23563774270,0,1136,1513,10
23568388689,23568388689,0,1430,1546,10
23568513901,23568513901,0,767,1461,10
23569198581,23569198579,-2,1299,2374,10
23570762123,23570762122,-1,1263,1774,10
23571749237,23571749241,4,13922,11739,10
23574462513,23574462512,-1,1580,2707,10
23575208037,23575208033,-4,882,1986,10
23575265372,23575265373,1,1668,3202,10
23576523750,23576523749,-1,1101,1102,10
23580489738,23580489737,-1,1041,2028,10
23584309801,23584309797,-4,1686,2313,10
23586298035,23586298044,9,654,1504,10
23587262885,23587262885,0,1066,1766,10
23588856710,23588856711,1,1875,1861,10
23590830150,23590830150,0,897,1764,10
23593161624,23593161624,0,1516,2124,10
23593708320,23593708319,-1,931,1728,10
23602521062,23602521063,1,1660,2022,10
23606524498,23606524497,-1,1371,2077,10
23608091531,23608091530,-1,977,1347,10
23608183919,23608183918,-1,1618,1757,10
23608389843,23608389845,2,1465,1590,10
23610013930,23610013929,-1,1213,1626,10
23612078059,23612078057,-2,1317,1992,10
23614428782,23614428781,-1,1578,1866,10
23615370700,23615370699,-1,1125,1426,10
23617592082,23617592081,-1,1218,2601,10
23618945675,23618945674,-1,1755,1825,10
23621471977,23621471975,-2,996,2603,10
23621677682,23621677681,-1,947,1913,10
23621772566,23621772568,2,1481,2294,10
23622182516,23622182517,1,1985,1889,10
23624916325,23624916326,1,1715,1327,10
23630710633,23630710631,-2,2913,4186,10
23632323351,23632323352,1,908,1317,10
23633301850,23633301847,-3,1202,1955,10
23635402014,23635402013,-1,2145,2097,10
23636725841,23636725840,-1,486,1473,10
23637665327,23637665325,-2,1748,2233,10
23638469159,23638469159,0,1372,2134,10
23638985553,23638985553,0,43026,19121,10
23640897777,23640897773,-4,1151,2098,10
23643105608,23643105607,-1,1403,2089,10
23646975106,23646975109,3,840,1755,10
23647924442,23647924439,-3,1032,1918,10
23649542312,23649542310,-2,1390,2270,10
23651294402,23651294399,-3,1793,1903,10
23654516807,23654516806,-1,1144,1599,10
23655365101,23655365101,0,1164,2335,10
23656793779,23656793778,-1,1016,2496,10
23659067361,23659067363,2,2521,1874,10
23661361938,23661361943,5,2763,1474,10
23661972470,23661972469,-1,1112,1170,10
23665496699,23665496697,-2,1560,2229,10
23668409899,23668409898,-1,732,2056,10
23670741986,23670741998,12,11699,41150,10
23672893190,23672893189,-1,1502,2865,10
23673686866,23673686865,-1,1223,2203,10
23675444228,23675444227,-1,1407,2111,10
23675873168,23675873167,-1,1389,1516,10
23676496038,23676496043,5,1952,1606,10
23678975410,23678975409,-1,1869,2723,10
23680821824,23680821826,2,2302,2515,10
23696119982,23696119981,-1,1398,2314,10
23697890938,23697890936,-2,883,2291,10
23699648765,23699648765,0,1332,2053,10
23702802030,23702802031,1,1258,1729,10
23706722946,23706722945,-1,1124,2022,10
23706875564,23706875582,18,735,2157,10
23709139619,23709139618,-1,1255,2144,10
23715197638,23715197638,0,1164,1906,10
23718219629,23718219626,-3,1797,2683,10
23719662899,23719662899,0,1493,1809,10
23721315342,23721315340,-2,1393,2511,10
23721477840,23721477862,22,1164,2321,10
23722039930,23722039929,-1,1080,1917,10
23723789448,23723789462,14,13542,46465,10
23725413707,23725413705,-2,848,1594,10
23728838942,23728838949,7,2516,1346,10
23729995385,23729995385,0,1628,1803,10
23733473587,23733473586,-1,899,1437,10
23735763625,23735763623,-2,1257,2059,10
23738688359,23738688362,3,950,1059,10
23740492106,23740492094,-12,188,957,10
23747080087,23747080086,-1,1239,1876,10
23748346365,23748346363,-2,1283,1576,10
23748510257,23748510253,-4,1101,1571,10
23749698287,23749698285,-2,1238,1762,10
23751145122,23751145119,-3,1635,2529,10
23753008350,23753008350,0,1160,1842,10
23753582226,23753582226,0,1227,1632,10
23754272759,23754272759,0,1276,1558,10
23759325281,23759325279,-2,1499,2422,10
23761245055,23761245053,-2,1272,1953,10
23763309742,23763309741,-1,1081,2670,10
23765146574,23765146578,4,3571,1805,10
23765810222,23765810221,-1,1028,2302,10
23766330310,23766330310,0,990,1405,10
23772888749,23772888748,-1,1236,1896,10
23773658472,23773658463,-9,35297,14111,10
23776189414,23776189413,-1,1519,2065,10
23776813427,23776813427,0,1601,2796,10
23779364666,23779364665,-1,623,1871,10
23782544631,23782544610,-21,995,1717,10
23782632490,23782632511,21,1214,2378,10
23786368970,23786368969,-1,1074,2104,10
23791438230,23791438230,0,1408,2319,10
23793700558,23793700558,0,1487,1895,10
23795018010,23795018010,0,1381,1592,10
23795310323,23795310320,-3,982,1535,10
23799573779,23799573778,-1,1192,1640,10
23799696200,23799696221,21,779,1146,10
23804734709,23804734707,-2,1252,2006,10
23805014814,23805014811,-3,1618,2481,10
23806569772,23806569770,-2,1338,1990,10
23808753767,23808753762,-5,1882,6798,10
23810015512,23810015510,-2,1014,1543,10
23810678012,23810678018,6,24657,44062,10
23811249763,23811249762,-1,1428,1704,10
23811612493,23811612493,0,910,2079,10
23812694248,23812694247,-1,1017,1305,10
23821536058,23821536053,-5,1220,3753,10
23821626047,23821626046,-1,1240,1639,10
23822979080,23822979080,0,1742,1865,10
23823136922,23823136922,0,1280,1980,10
23828850645,23828850646,1,637,1160,10
23831044156,23831044152,-4,1224,2686,10
23832380878,23832380876,-2,865,1740,10
23832965313,23832965310,-3,986,3281,10
23833374590,23833374588,-2,1242,3057,10
23833751933,23833751932,-1,885,1509,10
23836238670,23836238670,0,1386,2197,10
23836882758,23836882755,-3,1100,2175,10
23838417923,23838417915,-8,1378,2319,10
23839880362,23839880379,17,1357,1922,10
23840102680,23840102676,-4,941,1915,10
23840487332,23840487349,17,748,1083,10
23841108037,23841108036,-1,1487,2088,10
23842966419,23842966417,-2,1015,1631,10
23844535612,23844535612,0,1312,1966,10
23848583155,23848583154,-1,1502,2322,10
23848930792,23848930789,-3,941,1210,10
23850722672,23850722670,-2,1349,1984,10
23852881062,23852881048,-14,2420,1497,10
23854244639,23854244638,-1,628,1246,10
23858023050,23858023045,-5,1383,2521,10
23863761089,23863761090,1,1155,1594,10
23864445114,23864445131,17,1012,2374,10
23871052342,23871052339,-3,1289,2684,10
23874526701,23874526701,0,1035,1792,10
23877973294,23877973290,-4,1632,2416,10
23878022758,23878022759,1,970,2263,10
23881634002,23881634001,-1,1180,1487,10
23888105309,23888105308,-1,1194,1685,10
23889753542,23889753542,0,1709,1900,10
23896791788,23896791783,-5,2073,7150,10
23899723696,23899723698,2,14649,15222,10
23901510719,23901510718,-1,1505,1596,10
23904423147,23904423147,0,1016,1383,10
23905021078,23905021077,-1,1544,2515,10
23905311495,23905311494,-1,1080,1516,10
23910896587,23910896587,0,1255,2176,10
23911608134,23911608134,0,1106,2347,10
23914816481,23914816482,1,1246,1371,10
23915278582,23915278578,-4,1184,2270,10
23915870462,23915870463,1,1653,1752,10
23916424594,23916424594,0,963,2134,10
23917880500,23917880498,-2,1342,2460,10
23918993644,23918993662,18,1356,2069,10
23922290584,23922290584,0,1359,1553,10
23930419462,23930419461,-1,2049,1860,10
23930902327,23930902324,-3,544,714,10
23935348306,23935348306,0,1390,2190,10
23935749034,23935749015,-19,1587,1597,10
23936189526,23936189526,0,1153,1748,10
23937003958,23937003955,-3,694,1511,10
23939759025,23939759022,-3,1291,2264,10
23942244459,23942244459,0,1213,1384,10
23942568563,23942568561,-2,1611,1653,10
23943534775,23943534776,1,1199,1399,10
23944313093,23944313094,1,1192,1547,10
23949141654,23949141652,-2,943,1724,10
23949468163,23949468154,-9,1028,4056,10
23952243323,23952243320,-3,1055,2322,10
23965566253,23965566251,-2,1597,2489,10
23965724489,23965724489,0,1315,2137,10
23966066532,23966066533,1,1418,2109,10
23966663720,23966663718,-2,1069,1545,10
23969008310,23969008308,-2,959,1527,10
23971209261,23971209257,-4,1130,5247,10
23972767158,23972767155,-3,780,1048,10
23972888053,23972888052,-1,1273,1781,10
23973402722,23973402728,6,6200,2952,10
23976807609,23976807609,0,687,1321,10
23976871919,23976871917,-2,1778,2791,10
23977746422,23977746418,-4,1289,2221,10
23979485074,23979485070,-4,676,2539,10
23980289208,23980289209,1,1424,1772,10
23989732474,23989732471,-3,823,1743,10
23991096431,23991096429,-2,1137,1379,10
23992223789,23992223790,1,1152,2015,10
23992264026,23992264026,0,1049,2127,10
23992566976,23992566999,23,1324,2588,10
23993995518,23993995517,-1,1537,2054,10
24001926018,24001926015,-3,881,2073,10
24006442989,24006442988,-1,1283,1506,10
24012837517,24012837518,1,1348,2120,10
24021500163,24021500161,-2,1520,1640,10
24021579814,24021579813,-1,1093,2329,10
24026293050,24026293049,-1,1697,2063,10
24027157266,24027157267,1,994,1222,10
24027696097,24027696095,-2,1106,2011,10
24029546691,24029546691,0,1275,2020,10
24030758394,24030758392,-2,1215,2467,10
24030913121,24030913143,22,1246,1625,10
24040068477,24040068477,0,1168,1807,10
24040257890,24040257889,-1,1377,2222,10
24043674291,24043674286,-5,1734,7795,10
24045418885,24045418881,-4,1519,2159,10
24045698179,24045698181,2,1004,2049,10
24049258541,24049258537,-4,4011,10972,10
24049840002,24049840001,-1,884,1804,10
24052638603,24052638601,-2,1028,1971,10
24054457963,24054457961,-2,1064,1751,10
24055317706,24055317710,4,2077,1642,10
24056662145,24056662143,-2,1293,1904,10
24063093288,24063093288,0,1280,2113,10
24063660494,24063660493,-1,1267,1634,10
24072667680,24072667679,-1,1529,1755,10
24078639583,24078639582,-1,1195,1821,10
24082916079,24082916078,-1,915,1757,10
24083695026,24083695025,-1,1656,2032,10
24085871568,24085871573,5,6860,21505,10
24088596818,24088596818,0,1092,1215,10
24092852625,24092852622,-3,1564,1840,10
24093458486,24093458482,-4,957,3271,10
24096060089,24096060087,-2,1181,1771,10
24100238415,24100238414,-1,1351,2324,10
24102216208,24102216230,22,1211,2110,10
24104725530,24104725530,0,775,1617,10
24111353322,24111353320,-2,1573,2635,10
24111761698,24111761695,-3,1385,1536,10
24115500821,24115500823,2,989,1467,10
24121946287,24121946291,4,3652,2004,10
24122466290,24122466283,-7,933,7454,10
24126264121,24126264123,2,1741,1418,10
24126765184,24126765182,-2,1235,2038,10
24130684399,24130684400,1,1132,1144,10
24137637356,24137637355,-1,1339,2421,10
24138113683,24138113701,18,2393,3306,10
24138419785,24138419784,-1,1677,2225,10
24147105761,24147105760,-1,1201,2256,10
24151144427,24151144426,-1,901,1673,10
24153418413,24153418418,5,3777,1054,10
24154287219,24154287218,-1,1322,1702,10
24157624218,24157624218,0,880,1777,10
24162227900,24162227898,-2,1260,2618,10
24167239074,24167239072,-2,1088,2735,10
24168162590,24168162589,-1,1307,2053,10
24175946650,24175946647,-3,908,2128,10
24177727771,24177727771,0,825,953,10
24179445531,24179445534,3,1352,1858,10
24184719971,24184719974,3,1371,999,10
24186213784,24186213784,0,1550,1724,10
24186878277,24186878274,-3,1042,1660,10
24188276258,24188276253,-5,1079,3646,10
24190457715,24190457714,-1,1022,1747,10
24193605589,24193605570,-19,1302,3104,10
24197862650,24197862649,-1,1353,2616,10
24198006146,24198006143,-3,1494,2591,10
24199307161,24199307160,-1,645,1212,10
24200472267,24200472249,-18,852,1605,10
24203738304,24203738307,3,1723,1001,10
24204982106,24204982103,-3,1290,2113,10
24205528213,24205528211,-2,954,1712,10
24208109129,24208109126,-3,1555,2357,10
24208459651,24208459640,-11,1276,1689,10
24211392894,24211392893,-1,949,1166,10
24212886255,24212886263,8,3869,1592,10
24220020546,24220020551,5,1995,1329,10
24220791286,24220791285,-1,870,1660,10
24221544056,24221544066,10,14131,37914,10
24221938874,24221938870,-4,1115,1852,10
24223574814,24223574814,0,1920,1946,10
24223868895,24223868894,-1,1312,1511,10
24224834962,24224834961,-1,1521,1791,10
24225418117,24225418115,-2,1010,1710,10
24226271038,24226271036,-2,1168,3022,10
24227002487,24227002486,-1,1334,1809,10
24231488123,24231488118,-5,967,2853,10
24233156319,24233156318,-1,1494,1771,10
24233684583,24233684583,0,1081,1814,10
24234677917,24234677916,-1,171,6045,10
24235016401,24235016398,-3,1815,2054,10
24235054298,24235054292,-6,702,1039,10
24237105891,24237105889,-2,904,1552,10
24238942498,24238942494,-4,1009,1600,10
24239592898,24239592898,0,812,2485,10
24241821688,24241821686,-2,1730,2095,10
24242746950,24242746944,-6,1101,5260,10
24245155263,24245155262,-1,1010,1585,10
24245815372,24245815370,-2,1443,1372,10
24252460001,24252459999,-2,1376,2814,10
24254031786,24254031786,0,1897,1676,10
24256546894,24256546890,-4,1177,2063,10
24257056096,24257056078,-18,69,810,10
24257588790,24257588790,0,1125,2019,10
24258295999,24258296000,1,1973,2098,10
24260185274,24260185281,7,1557,1085,10
24261920247,24261920226,-21,1268,2624,10
24263019798,24263019798,0,1152,1656,10
24265194548,24265194543,-5,1131,2208,10
24267759866,24267759862,-4,1379,2331,10
24271808047,24271808043,-4,1098,2131,10
24274856723,24274856722,-1,789,1703,10
24277860770,24277860767,-3,696,1636,10
24278897381,24278897379,-2,1890,2676,10
24279453394,24279453395,1,1073,2085,10
24281316472,24281316470,-2,10576,15819,10
24286047280,24286047279,-1,1086,1798,10
24288019291,24288019291,0,1223,1992,10
24288312014,24288312014,0,1519,2047,10
24288920206,24288920210,4,1320,1085,10
24292369582,24292369585,3,1678,1940,10
24296439662,24296439658,-4,1562,1563,10
24306874518,24306874517,-1,1281,1881,10
24307429814,24307429811,-3,1597,2136,10
24308266815,24308266814,-1,1126,1807,10
24309023342,24309023341,-1,1123,1374,10
24309972706,24309972705,-1,1576,1505,10
24310648387,24310648386,-1,1048,2894,10
24317417782,24317417782,0,1313,1323,10
24320390599,24320390597,-2,1593,2492,10
24320968922,24320968922,0,1452,1955,10
24323807517,24323807515,-2,850,1896,10
24324414010,24324414009,-1,1157,2597,10
24324815570,24324815568,-2,886,2189,10
24326251379,24326251376,-3,947,1939,10
24329351289,24329351288,-1,1267,1238,10
24332244358,24332244358,0,1548,2519,10
24333458711,24333458714,3,1222,975,10
24334019073,24334019078,5,1914,1040,10
24335623515,24335623513,-2,1247,2162,10
24337492684,24337492682,-2,1783,2154,10
24340469059,24340469054,-5,1146,2000,10
24340864711,24340864710,-1,721,1338,10
24343219844,24343219840,-4,1531,1960,10
24343277861,24343277861,0,1232,1265,10
24345898974,24345898972,-2,1080,1675,10
24347570662,24347570660,-2,1277,1990,10
24350807487,24350807483,-4,1093,2122,10
24352015954,24352015952,-2,1152,1646,10
24352271859,24352271865,6,12657,7113,10
24354124353,24354124347,-6,512,1531,10
24357280697,24357280695,-2,1075,1585,10
24357380350,24357380350,0,1369,2369,10
24360784278,24360784270,-8,1201,4303,10
24366914470,24366914475,5,2065,1489,10
24367645449,24367645449,0,621,1566,10
24368941358,24368941357,-1,933,2630,10
24377346495,24377346495,0,2102,2295,10
24380565359,24380565358,-1,1355,1958,10
24381250524,24381250537,13,146,988,10
24381306582,24381306581,-1,1346,1750,10
24382552270,24382552265,-5,941,2225,10
24385266186,24385266186,0,1111,2146,10
24386981566,24386981564,-2,1583,2287,10
24387419854,24387419851,-3,1771,2723,10
24387891026,24387891025,-1,1700,3254,10
24392569499,24392569494,-5,1212,4852,10
24398337517,24398337517,0,1765,1448,10
24399452737,24399452737,0,917,1580,10
24400169162,24400169158,-4,1330,2387,10
24400821058,24400821058,0,1097,1697,10
24405245869,24405245870,1,1343,1228,10
24405813509,24405813507,-2,1382,2200,10
24406340461,24406340461,0,1160,2068,10
24410899199,24410899198,-1,770,1689,10
24414743910,24414743909,-1,1146,1104,10
24415957682,24415957677,-5,856,2774,10
24419536949,24419536948,-1,1457,2038,10
24421213305,24421213303,-2,922,1848,10
24423626998,24423626997,-1,1151,2205,10
24425235402,24425235401,-1,691,1758,10
24426299155,24426299154,-1,1524,1932,10
24430900903,24430900902,-1,2349,4822,10
24432259145,24432259146,1,1075,1572,10
24435137213,24435137209,-4,1437,15169,10
24435816243,24435816261,18,987,1905,10
24437064704,24437064702,-2,1393,1817,10
24439150119,24439150118,-1,1052,1794,10
24440999005,24440998999,-6,1684,5812,10
24445664135,24445664135,0,933,1573,10
24446330791,24446330776,-15,2644,1445,10
24448246955,24448246954,-1,1261,1646,10
24450982459,24450982457,-2,1166,1810,10
24451102814,24451102813,-1,1354,2021,10
24452989410,24452989417,7,5202,1939,10
24454726898,24454726898,0,914,1404,10
24455983871,24455983869,-2,487,890,10
24464521975,24464521975,0,2219,1924,10
24467609259,24467609261,2,792,1405,10
24468080465,24468080459,-6,787,3283,10
24469464764,24469464763,-1,1716,3152,10
24469821597,24469821589,-8,1139,1989,10
24476755807,24476755803,-4,1172,1894,10
24478984911,24478984911,0,1448,1901,10
24480032078,24480032076,-2,1136,1827,10
24480231501,24480231497,-4,1481,2086,10
24481342227,24481342227,0,933,1746,10
24481862382,24481862380,-2,1424,2106,10
24488635152,24488635150,-2,732,1699,10
24488694630,24488694628,-2,1075,1707,10
24489371847,24489371846,-1,1475,2552,10
24491740865,24491740886,21,1114,1736,10
24492800666,24492800666,0,1908,2201,10
24497167311,24497167311,0,976,2010,10
24498782672,24498782669,-3,1190,2163,10
24499626948,24499626946,-2,1074,1598,10
24501315082,24501315078,-4,1000,2099,10
24503272800,24503272793,-7,2010,5572,10
24505179143,24505179136,-7,848,3736,10
24509388888,24509388888,0,1482,1477,10
24511839574,24511839570,-4,461,1860,10
24511993099,24511993116,17,1180,2073,10
24514548398,24514548398,0,1202,2327,10
24517946813,24517946815,2,1120,945,10
24521360616,24521360614,-2,1475,1678,10
24526159189,24526159185,-4,1980,1651,10
24529183558,24529183555,-3,788,1387,10
24530054493,24530054498,5,8041,3004,10
24533784187,24533784186,-1,1325,2064,10
24533936089,24533936087,-2,1361,1906,10
24536803223,24536803222,-1,864,1840,10
24540598656,24540598654,-2,1155,1461,10
24540769826,24540769823,-3,1029,1931,10
24541214922,24541214922,0,1552,2381,10
24543827915,24543827918,3,4420,2848,10
24552859988,24552859986,-2,1512,2250,10
24554337539,24554337539,0,1177,1658,10
24557613958,24557613956,-2,1070,1981,10
24560914225,24560914222,-3,963,1472,10
24562273635,24562273634,-1,940,1126,10
24563475905,24563475904,-1,949,1463,10
24565526836,24565526833,-3,1432,2302,10
24565809921,24565809918,-3,878,1723,10
24566779671,24566779673,2,1171,926,10
24568145480,24568145478,-2,993,2161,10
24568411858,24568411879,21,980,1900,10
24568760567,24568760567,0,1472,1589,10
24572471126,24572471126,0,1122,2792,10
24575428298,24575428298,0,1515,2646,10
24575533463,24575533462,-1,996,1942,10
24576734036,24576734034,-2,1172,2017,10
24578909299,24578909297,-2,1222,2151,10
24579561849,24579561852,3,10528,7910,10
24584418278,24584418274,-4,1544,3217,10
24584728157,24584728157,0,1134,1325,10
24584981019,24584981018,-1,668,1338,10
24586961122,24586961119,-3,1069,1938,10
24591285598,24591285599,1,778,1012,10
24594333542,24594333541,-1,1114,1535,10
24599085043,24599085041,-2,1416,1868,10
24601742712,24601742711,-1,1335,1269,10
24601789056,24601789049,-7,1420,2192,10
24603169523,24603169521,-2,926,1873,10
24606839815,24606839812,-3,1090,2588,10
24607279162,24607279163,1,1477,1494,10
24608229915,24608229914,-1,1310,1813,10
24609740674,24609740673,-1,921,2546,10
24610095118,24610095118,0,1162,1410,10
24610211398,24610211399,1,1245,1581,10
24611000056,24611000054,-2,1257,1691,10
24614087942,24614087941,-1,1755,1782,10
24614498130,24614498130,0,977,1675,10
24616742754,24616742753,-1,2127,2008,10
24617359382,24617359382,0,1464,2224,10
24620017041,24620017040,-1,1903,2285,10
24620093670,24620093648,-22,1709,1624,10
24623343703,24623343701,-2,976,2158,10
24625762744,24625762751,7,1774,859,10
24627471511,24627471507,-4,1718,2204,10
24634299799,24634299798,-1,1083,1573,10
24636100882,24636100882,0,1469,1787,10
24636330957,24636330954,-3,1142,2416,10
24637082130,24637082129,-1,1073,2457,10
24638137602,24638137599,-3,1055,1877,10
24640541110,24640541108,-2,1630,1926,10
24641040251,24641040250,-1,1502,2187,10
24641383989,24641383986,-3,1129,2229,10
24642788021,24642788021,0,1534,1469,10
24646634065,24646634067,2,978,1374,10
24647151569,24647151562,-7,2992,7763,10
24652287999,24652287998,-1,1007,1859,10
24653387038,24653387036,-2,814,1915,10
24654569404,24654569403,-1,1195,1105,10
24656105956,24656105959,3,3526,1922,10
24657920824,24657920820,-4,1050,1940,10
24659447262,24659447262,0,1107,2035,10
24660395927,24660395933,6,11337,5695,10
24660936075,24660936074,-1,1310,1408,10
24661448723,24661448722,-1,1180,1592,10
24665313681,24665313678,-3,1035,2095,10
24669200506,24669200504,-2,1641,1997,10
24669862142,24669862139,-3,1151,1684,10
24670429427,24670429427,0,1317,2073,10
24671675559,24671675564,5,3289,1503,10
24672390517,24672390517,0,1212,2010,10
24676914846,24676914845,-1,1110,1841,10
24679145806,24679145805,-1,1469,1586,10
24686003141,24686003141,0,1466,2157,10
24688147182,24688147181,-1,1466,3690,10
24691687538,24691687538,0,1379,2202,10
24698829970,24698829969,-1,1529,1962,10
24699744828,24699744826,-2,955,1527,10
24706387277,24706387275,-2,1251,2117,10
24707009003,24707008999,-4,780,2138,10
24708157607,24708157606,-1,940,1386,10
24710210777,24710210776,-1,7241,13180,10
24717405437,24717405434,-3,1429,1786,10
24717797698,24717797697,-1,1880,1744,10
24725638769,24725638764,-5,1513,5755,10
24725996790,24725996786,-4,1067,1892,10
24726258169,24726258170,1,1485,1475,10
24727285467,24727285466,-1,1218,2044,10
24730801362,24730801361,-1,840,1515,10
24731805791,24731805796,5,2425,1487,10
24732102133,24732102131,-2,1540,2301,10
24732699641,24732699642,1,2266,2730,10
24732897399,24732897398,-1,1172,1712,10
24735612603,24735612599,-4,1297,2460,10
24741110970,24741110971,1,918,1642,10
24742324659,24742324656,-3,919,1620,10
24743814652,24743814651,-1,1368,1461,10
24745760039,24745760038,-1,758,2291,10
24745887930,24745887919,-11,73,926,10
24746789778,24746789774,-4,899,1458,10
24746930359,24746930357,-2,851,1674,10
24748528605,24748528602,-3,1125,1807,10
24748990579,24748990573,-6,915,3770,10
24753316438,24753316437,-1,1075,2111,10
24754358714,24754358711,-3,1778,3326,10
24757130942,24757130940,-2,1089,1579,10
24757466097,24757466118,21,582,1189,10
24760130004,24760130004,0,1551,2358,10
24761524770,24761524769,-1,1247,1778,10
24762627149,24762627148,-1,785,1742,10
24765741913,24765741911,-2,618,1512,10
24766492550,24766492550,0,902,1946,10
24766947265,24766947264,-1,776,2129,10
24768090265,24768090264,-1,1385,2038,10
24768512300,24768512298,-2,1397,2105,10
24769773410,24769773410,0,1358,1516,10
24769961110,24769961111,1,744,1216,10
24772079969,24772079967,-2,1158,2189,10
24772175290,24772175291,1,2146,2100,10
24772686978,24772686977,-1,1405,2252,10
24774922899,24774922897,-2,1221,2148,10
24775970268,24775970267,-1,1297,1739,10
24777425086,24777425086,0,1162,1899,10
24784006801,24784006803,2,1524,1472,10
24784713270,24784713270,0,980,1600,10
24785714143,24785714142,-1,1047,1832,10
24788225405,24788225402,-3,1056,2020,10
24788590178,24788590182,4,201,673,10
24796061606,24796061608,2,1815,2798,10
24797640378,24797640376,-2,1049,1595,10
24798593877,24798593879,2,987,770,10
24801801920,24801801910,-10,1605,716,10
24804897942,24804897940,-2,952,2017,10
24811199448,24811199446,-2,1709,1684,10
24814110385,24814110385,0,839,1878,10
24814675640,24814675654,14,519,747,10
24816422887,24816422887,0,942,1027,10
24817143142,24817143139,-3,1029,2367,10
24817377832,24817377830,-2,1452,2521,10
24818275668,24818275670,2,1845,1879,10
24822991693,24822991693,0,1455,2552,10
24823698223,24823698218,-5,989,1916,10
24826601177,24826601174,-3,1178,1501,10
24837888166,24837888166,0,1139,1515,10
24839823062,24839823061,-1,1450,1765,10
24842527249,24842527245,-4,1109,2379,10
24842933209,24842933206,-3,1346,2737,10
24848440918,24848440917,-1,1453,2137,10
24852951037,24852951035,-2,1633,1535,10
24853160426,24853160425,-1,1185,2190,10
24855728002,24855727999,-3,1043,1693,10
24860781771,24860781773,2,1414,1338,10
24860819222,24860819234,12,1457,1362,10
24869035995,24869035993,-2,1073,2043,10
24871794291,24871794298,7,9024,3669,10
24872240318,24872240317,-1,1021,1722,10
24878880002,24878880001,-1,1539,1901,10
24883811902,24883811903,1,1328,1592,10
24883866093,24883866090,-3,1066,2225,10
24885808423,24885808422,-1,1350,1477,10
24890869752,24890869734,-18,1673,919,10
24892083573,24892083571,-2,863,2026,10
24892128737,24892128736,-1,1492,1911,10
24895417987,24895417986,-1,1526,2085,10
24896533429,24896533430,1,1677,2049,10
24897354726,24897354725,-1,1351,1684,10
24899785333,24899785333,0,833,1757,10
24900889518,24900889517,-1,1271,1452,10
24901962200,24901962199,-1,1524,2163,10
24902276678,24902276675,-3,1546,2278,10
24903022743,24903022741,-2,925,1568,10
24907381129,24907381128,-1,1374,2271,10
24908984255,24908984258,3,1442,1406,10
24914770310,24914770310,0,1418,2376,10
24915547323,24915547318,-5,1391,4777,10
24916693122,24916693119,-3,998,2140,10
24922742872,24922742873,1,1191,1615,10
24941600818,24941600799,-19,493,954,10
24943293987,24943293986,-1,1020,2424,10
24946142886,24946142882,-4,924,1751,10
24946833830,24946833830,0,1085,1829,10
24947460711,24947460712,1,882,1122,10
24949345298,24949345294,-4,1390,2246,10
24953399560,24953399559,-1,1097,1922,10
24953531103,24953531107,4,2031,2256,10
24956253222,24956253219,-3,1090,2409,10
24957434533,24957434516,-17,1370,1181,10
24960942424,24960942423,-1,774,2199,10
24961819586,24961819586,0,998,1965,10
24964171123,24964171122,-1,955,1952,10
24964369371,24964369370,-1,1651,1915,10
24970439210,24970439209,-1,1077,1960,10
24980881665,24980881666,1,1487,1054,10
24984388042,24984388040,-2,1295,1860,10
24984633056,24984633047,-9,1370,1803,10
24985412714,24985412713,-1,1175,1936,10
24989097199,24989097199,0,1129,1757,10
24990321227,24990321206,-21,937,2282,10
24992390676,24992390670,-6,852,2184,10
24994007353,24994007351,-2,1732,2054,10
24995076625,24995076625,0,1375,1824,10
25001008951,25001008949,-2,1099,2047,10
25003434891,25003434890,-1,1120,1609,10
25004950992,25004950986,-6,457,8972,10
25006105366,25006105361,-5,687,1534,10
25007003743,25007003742,-1,1571,2059,10
25012678075,25012678074,-1,1214,2232,10
25017153475,25017153474,-1,1384,2126,10
25018639942,25018639941,-1,1207,1409,10
25024128435,25024128434,-1,850,1549,10
25026621287,25026621286,-1,711,1298,10
25026868889,25026868882,-7,893,1320,10
25026915809,25026915794,-15,673,1605,10
25028400917,25028400913,-4,1205,2410,10
25029088658,25029088678,20,1055,1932,10
25029217951,25029217957,6,1431,928,10
25030454331,25030454331,0,981,1704,10
25031224291,25031224289,-2,596,1450,10
25031263978,25031263975,-3,893,1448,10
25035318246,25035318252,6,1210,1740,10
25041196758,25041196754,-4,1341,2371,10
25045152326,25045152327,1,1289,1278,10
25045893378,25045893375,-3,1230,2291,10
25048745491,25048745490,-1,1295,1622,10
25055225298,25055225296,-2,1170,1901,10
25057161171,25057161166,-5,1789,5790,10
25057637654,25057637653,-1,1373,2002,10
25060129562,25060129562,0,637,1558,10
25069634054,25069634051,-3,807,1574,10
25076680579,25076680578,-1,1633,1957,10
25083889442,25083889441,-1,1094,1400,10
25085026614,25085026611,-3,1231,1648,10
25085423259,25085423259,0,926,1574,10
25087159695,25087159694,-1,1095,2277,10
25088871058,25088871057,-1,1372,2300,10
25089671662,25089671660,-2,1367,1698,10
25089797526,25089797528,2,1548,1840,10
25090326882,25090326877,-5,1963,6318,10
25090856283,25090856283,0,782,1510,10
25091790578,25091790576,-2,1785,2359,10
25105679982,25105679978,-4,848,2025,10
25108800462,25108800461,-1,834,1379,10
25112710907,25112710907,0,1148,1356,10
25116826053,25116826051,-2,1587,1996,10
25117096471,25117096470,-1,1440,2957,10
25118316982,25118316978,-4,945,1748,10
25119726163,25119726161,-2,1753,2835,10
25121816939,25121816939,0,1136,1627,10
25124189051,25124189050,-1,1223,1373,10
25128304585,25128304582,-3,1099,1547,10
25132662522,25132662520,-2,1067,1813,10
25135128364,25135128349,-15,775,1537,10
25136421339,25136421338,-1,812,1137,10
25137506046,25137506046,0,930,1992,10
25141701579,25141701579,0,1089,1486,10
25141975634,25141975612,-22,1614,2004,10
25144467957,25144467956,-1,1105,1278,10
25148433357,25148433356,-1,1076,1210,10
25148705670,25148705683,13,2913,1046,10
25153083467,25153083465,-2,1053,2084,10
25165168076,25165168074,-2,1420,2809,10
25167975117,25167975113,-4,1223,1697,10
25170833282,25170833278,-4,1192,1954,10
25178309035,25178309039,4,3221,2093,10
25178834561,25178834559,-2,1348,1247,10
25180361190,25180361188,-2,811,1502,10
25182475092,25182475090,-2,1233,2453,10
25182892196,25182892193,-3,617,1801,10
25186716678,25186716677,-1,1086,1340,10
25189492706,25189492706,0,1140,2603,10
25189719854,25189719850,-4,1151,2993,10
25191195213,25191195216,3,1850,1365,10
25192169228,25192169227,-1,1105,1769,10
25192424831,25192424830,-1,1153,2406,10
25194141165,25194141164,-1,1728,2905,10
25196635298,25196635296,-2,1473,2256,10
25199749878,25199749878,0,1389,1755,10
25200337555,25200337554,-1,1621,2463,10
25200481477,25200481472,-5,1482,2629,10
25200530654,25200530650,-4,1439,2540,10
25205723339,25205723334,-5,1246,2588,10
25211386890,25211386887,-3,988,2037,10
25214215081,25214215078,-3,1439,2117,10
25218790802,25218790800,-2,1017,1570,10
25218892051,25218892049,-2,981,1623,10
25224064199,25224064179,-20,29297,27779,10
25226502677,25226502676,-1,1661,2503,10
25229594020,25229594018,-2,1317,2036,10
25230348118,25230348118,0,1406,1323,10
25235194731,25235194730,-1,2185,3612,10
25235220466,25235220463,-3,768,2293,10
25235632492,25235632490,-2,1299,1343,10
25237433110,25237433107,-3,1257,1501,10
25239403903,25239403901,-2,1098,2266,10
25240274409,25240274409,0,954,1293,10
25242487505,25242487502,-3,1417,2308,10
25243947839,25243947838,-1,1128,2425,10
25245310566,25245310564,-2,1275,1778,10
25246462155,25246462154,-1,887,1844,10
25248028780,25248028767,-13,1040,1769,10
25248271165,25248271164,-1,1098,1420,10
25249505346,25249505362,16,1125,1083,10
25250402374,25250402373,-1,1286,1909,10
25252216078,25252216077,-1,1321,1827,10
25253280970,25253280968,-2,2001,2978,10
25255977121,25255977117,-4,837,2049,10
25257456763,25257456762,-1,2079,1983,10
25261287614,25261287613,-1,1661,2036,10
25261334180,25261334179,-1,1714,2060,10
25261806486,25261806487,1,1253,1539,10
25264442225,25264442225,0,1022,1332,10
25269056076,25269056074,-2,1390,1923,10
25271832659,25271832657,-2,1291,2601,10
25275757006,25275757004,-2,1169,2517,10
25276814699,25276814697,-2,1777,2984,10
25280099786,25280099788,2,1170,1297,10
25280231122,25280231123,1,1749,2463,10
25282009753,25282009753,0,861,1564,10
25282409673,25282409668,-5,978,2337,10
25284868482,25284868479,-3,1378,1688,10
25287323862,25287323860,-2,1270,1806,10
25293879215,25293879214,-1,1669,2440,10
25297496921,25297496923,2,1937,1292,10
25298017237,25298017237,0,2051,2010,10
25301484019,25301484018,-1,1331,1601,10
25303939897,25303939894,-3,953,2372,10
25306233839,25306233847,8,4292,937,10
25307076686,25307076682,-4,1659,1840,10
25307832822,25307832821,-1,1354,2023,10
25309303135,25309303135,0,1063,1878,10
25312343739,25312343739,0,1229,1919,10
25318832031,25318832030,-1,1255,2054,10
25319870707,25319870704,-3,957,2204,10
25320380585,25320380604,19,859,1159,10
25321101310,25321101309,-1,1080,1841,10
25323119390,25323119386,-4,1600,2610,10
25325721215,25325721215,0,1335,3197,10
25327466221,25327466216,-5,1186,2254,10
25328369179,25328369179,0,960,1750,10
25328401758,25328401757,-1,2599,3519,10
25332794115,25332794113,-2,1160,2208,10
25334072380,25334072397,17,1320,2721,10
25336131996,25336131994,-2,1462,2394,10
25342038621,25342038618,-3,1417,2086,10
25343032093,25343032090,-3,1815,2814,10
25344819869,25344819867,-2,1764,1904,10
25348354741,25348354729,-12,1592,1957,10
25348771698,25348771697,-1,1306,2732,10
25354200878,25354200878,0,1661,2072,10
25356295074,25356295074,0,988,2242,10
25358403554,25358403563,9,7211,35420,10
25360796332,25360796331,-1,1281,2084,10
25370236757,25370236752,-5,1268,3142,10
25370480290,25370480290,0,1344,1854,10
25372531563,25372531562,-1,829,1652,10
25373471520,25373471519,-1,1145,1854,10
25376200165,25376200162,-3,1343,2772,10
25377530539,25377530539,0,691,997,10
25380973685,25380973690,5,1399,1433,10
25383763545,25383763533,-12,1278,2141,10
25384170931,25384170930,-1,1719,1485,10
25397307362,25397307362,0,1407,2427,10
25398272411,25398272410,-1,1028,1456,10
25398345547,25398345545,-2,1319,1632,10
25400338763,25400338762,-1,35657,63075,10
25403963893,25403963892,-1,1306,2056,10
25404950542,25404950541,-1,1394,1921,10
25405241352,25405241350,-2,1407,1565,10
25406093942,25406093938,-4,1149,2822,10
25406704459,25406704458,-1,1131,1769,10
25411557393,25411557393,0,1723,2230,10
25411621465,25411621464,-1,1136,1430,10
25415582914,25415582913,-1,1621,2534,10
25415922257,25415922256,-1,1617,1746,10
25421775583,25421775582,-1,621,962,10
25424221173,25424221173,0,877,1655,10
25428717717,25428717716,-1,1487,2401,10
25429273422,25429273421,-1,1351,1759,10
25429505455,25429505454,-1,1156,1714,10
25439603442,25439603442,0,1134,1581,10
25439937559,25439937558,-1,1397,1670,10
25443284445,25443284447,2,1406,1667,10
25446980363,25446980361,-2,923,2328,10
25447533558,25447533555,-3,1136,1784,10
25448625127,25448625123,-4,1565,2627,10
25451912686,25451912686,0,1419,2054,10
25454031361,25454031360,-1,1493,1888,10
25455816530,25455816525,-5,808,2114,10
25464157582,25464157581,-1,1199,2042,10
25467255520,25467255520,0,982,2085,10
25472195292,25472195288,-4,1101,1683,10
25472233905,25472233885,-20,750,1364,10
25472279339,25472279331,-8,1365,1758,10
25473560028,25473560028,0,1199,1956,10
25473656001,25473655985,-16,1406,1606,10
25475891841,25475891838,-3,1200,1727,10
25475958314,25475958313,-1,1127,1978,10
25478646809,25478646810,1,1675,1817,10
25482928006,25482928005,-1,945,1657,10
25485078254,25485078253,-1,1022,1490,10
25487582643,25487582642,-1,1264,1080,10
25489027659,25489027636,-23,907,1673,10
25492644023,25492644023,0,1218,1621,10
25494648873,25494648873,0,1355,2047,10
25496186478,25496186474,-4,1524,2179,10
25496238643,25496238641,-2,1355,2087,10
25498306014,25498306011,-3,1117,1559,10
25502125261,25502125263,2,1192,981,10
25503428975,25503428980,5,2316,1521,10
25504326161,25504326161,0,930,1548,10
25505444354,25505444353,-1,1019,2261,10
25505878962,25505878960,-2,1584,2674,10
25509888007,25509888004,-3,2228,4227,10
25510149066,25510149067,1,1092,1462,10
25510417555,25510417548,-7,234,4961,10
25511377242,25511377225,-17,1146,1908,10
25512410790,25512410787,-3,979,1698,10
25515681061,25515681059,-2,1679,2360,10
25521528613,25521528611,-2,1276,2581,10
25522130610,25522130610,0,745,1048,10
25523270896,25523270879,-17,221,932,10
25525389010,25525389008,-2,949,2003,10
25526759767,25526759765,-2,1066,2213,10
25526961662,25526961640,-22,1219,1619,10
25528324395,25528324391,-4,1623,2327,10
25530004477,25530004477,0,1101,1686,10
25530676085,25530676081,-4,732,2127,10
25531412536,25531412533,-3,5223,14442,10
25531819153,25531819155,2,1469,1392,10
25533137003,25533137001,-2,1038,1983,10
25534055363,25534055361,-2,975,1680,10
25534213498,25534213518,20,1059,5576,10
25540042928,25540042921,-7,1954,8601,10
25542925390,25542925370,-20,1415,1574,10
25544976199,25544976198,-1,1456,1835,10
25551037047,25551037050,3,1920,2147,10
25553494384,25553494382,-2,1271,1888,10
25553681199,25553681197,-2,1515,2244,10
25555779794,25555779791,-3,1534,2128,10
25565105815,25565105813,-2,878,1794,10
25568509163,25568509163,0,1409,2768,10
25569561815,25569561795,-20,982,815,10
25571265427,25571265426,-1,1448,2207,10
25572327053,25572327054,1,1220,1870,10
25574689377,25574689375,-2,974,1819,10
25577988232,25577988230,-2,1425,2027,10
25578784522,25578784522,0,1188,2204,10
25579028641,25579028640,-1,1526,2220,10
25580771436,25580771435,-1,914,1530,10
25581932683,25581932681,-2,1384,1798,10
25582050021,25582050020,-1,2915,3494,10
25584586264,25584586263,-1,1547,2293,10
25585461477,25585461475,-2,1009,2069,10
25586562739,25586562735,-4,943,2681,10
25586710790,25586710790,0,1360,2308,10
25588009497,25588009497,0,884,1596,10
25588633797,25588633796,-1,967,1578,10
25589225939,25589225936,-3,1116,1816,10
25589682595,25589682593,-2,934,1351,10
25593032280,25593032280,0,1308,1790,10
25594522794,25594522794,0,1360,2538,10
25595016213,25595016211,-2,687,1506,10
25598549394,25598549392,-2,1011,1510,10
25600727904,25600727902,-2,956,1955,10
25601406587,25601406584,-3,1336,2506,10
25602313951,25602313950,-1,1401,2029,10
25604437668,25604437662,-6,1280,2117,10
25605011107,25605011105,-2,1096,2151,10
25606506534,25606506534,0,1048,1948,10
25610322099,25610322097,-2,1203,2236,10
25610563319,25610563318,-1,209,401,10
25614085104,25614085104,0,1020,1385,10
25615109575,25615109574,-1,1461,2416,10
25618848366,25618848373,7,2081,933,10
25619049102,25619049101,-1,1478,1767,10
25626226730,25626226729,-1,1575,2253,10
25626656363,25626656361,-2,2047,2391,10
25630364551,25630364550,-1,1332,1553,10
25632503270,25632503269,-1,1365,2291,10
25633071307,25633071306,-1,1035,1547,10
25633521255,25633521252,-3,582,1270,10
25640789537,25640789531,-6,704,1957,10
25643153682,25643153680,-2,1392,2206,10
25643202585,25643202584,-1,1294,1375,10
25646645049,25646645049,0,1137,2147,10
25648340287,25648340290,3,1384,973,10
25649032966,25649032964,-2,1091,1711,10
25651590113,25651590113,0,1234,1591,10
25655862885,25655862882,-3,1160,2790,10
25662328735,25662328734,-1,984,1749,10
25663373799,25663373797,-2,1271,1770,10
25668726902,25668726901,-1,1050,2984,10
25669602042,25669602037,-5,888,5210,10
25670712604,25670712603,-1,1092,1671,10
25674000995,25674000993,-2,1570,2345,10
25678227829,25678227832,3,1389,1633,10
25681757210,25681757210,0,1450,1722,10
25681807301,25681807301,0,916,2130,10
25682532826,25682532829,3,1828,1282,10
25685347374,25685347373,-1,1311,2364,10
25687161478,25687161475,-3,1267,2715,10
25687370542,25687370542,0,623,1199,10
25693067657,25693067657,0,1187,2267,10
25695940370,25695940373,3,1058,849,10
25697939369,25697939366,-3,1930,2649,10
25699501458,25699501456,-2,1741,2645,10
25699533819,25699533817,-2,1294,1508,10
25701527530,25701527531,1,1272,1706,10
25702318347,25702318346,-1,1344,1983,10
25702732147,25702732145,-2,865,1378,10
25704027491,25704027490,-1,1608,1897,10
25705680002,25705680000,-2,1077,1553,10
25707348830,25707348830,0,2171,1804,10
25707514602,25707514605,3,1214,1491,10
25711078203,25711078201,-2,977,1449,10
25717534727,25717534725,-2,564,1329,10
25721201115,25721201118,3,1390,1506,10
25722107634,25722107632,-2,1476,2065,10
25722504851,25722504854,3,1201,1580,10
25722947890,25722947890,0,920,1430,10
25727693125,25727693125,0,1463,2828,10
25730010338,25730010339,1,1353,1455,10
25736456443,25736456440,-3,1710,2843,10
25737125535,25737125534,-1,1430,2063,10
25739304093,25739304095,2,52483,25294,10
25739874999,25739874996,-3,770,1694,10
25740181832,25740181852,20,1091,1633,10
25744361782,25744361780,-2,852,1852,10
25748111382,25748111380,-2,1330,1863,10
25753704310,25753704308,-2,976,1727,10
25754446362,25754446383,21,502,1269,10
25755574673,25755574674,1,1291,1491,10
25756091454,25756091450,-4,953,2116,10
25756240275,25756240275,0,969,1324,10
25758204041,25758204036,-5,1225,1766,10
25766156368,25766156366,-2,1247,2678,10
25776493149,25776493148,-1,1038,1700,10
25778488726,25778488725,-1,1224,2017,10
25780879290,25780879288,-2,776,1664,10
25782656306,25782656306,0,854,2009,10
25783074287,25783074285,-2,1768,2637,10
25783979939,25783979939,0,1157,1896,10
25784122486,25784122485,-1,944,2407,10
25793277354,25793277350,-4,1885,2467,10
25795020531,25795020530,-1,1733,2273,10
25801054607,25801054603,-4,1408,3590,10
25804303003,25804302998,-5,325,542,10
25812206928,25812206928,0,1523,2547,10
25821882942,25821882942,0,1042,2663,10
25823945368,25823945367,-1,1176,1943,10
25825538226,25825538225,-1,1127,1030,10
25827729063,25827729062,-1,1634,1566,10
25829411567,25829411566,-1,1253,1139,10
25835289073,25835289072,-1,1364,1969,10
25837581287,25837581284,-3,761,2708,10
25837672273,25837672269,-4,1575,2227,10
25840599185,25840599185,0,1869,1639,10
25841979083,25841979083,0,584,1042,10
25843250499,25843250494,-5,818,1696,10
25844530628,25844530626,-2,1429,2874,10
25849105587,25849105586,-1,1326,2534,10
25849641405,25849641408,3,2094,1151,10
25850777826,25850777826,0,1125,2424,10
25851198188,25851198202,14,173,500,10
25851776913,25851776911,-2,861,2168,10
25852663872,25852663870,-2,1559,1807,10
25853189308,25853189307,-1,876,2157,10
25854016728,25854016726,-2,1558,3034,10
25862740112,25862740111,-1,967,1525,10
25864017695,25864017693,-2,1654,2632,10
25864918437,25864918434,-3,861,1687,10
25865868354,25865868351,-3,1406,1603,10
25869609758,25869609760,2,2166,1171,10
25869655787,25869655786,-1,1364,1853,10
25870372910,25870372913,3,817,1693,10
25871790951,25871790949,-2,1316,3164,10
25872303649,25872303643,-6,1930,7020,10
25873728186,25873728185,-1,1489,1395,10
25876824573,25876824571,-2,1131,2666,10
25878404038,25878404033,-5,5048,19699,10
25879475246,25879475245,-1,940,2089,10
25880017527,25880017526,-1,1999,2918,10
25881650278,25881650275,-3,1050,2023,10
25883150138,25883150136,-2,1124,1649,10
25884949274,25884949272,-2,1147,1747,10
25885463575,25885463574,-1,1177,1849,10
25885688357,25885688354,-3,1316,2270,10
25887173493,25887173490,-3,1171,1678,10
25888348291,25888348290,-1,865,1388,10
25890305663,25890305662,-1,1137,1710,10
25893696763,25893696762,-1,1341,2289,10
25898973923,25898973912,-11,34757,14179,10
25899346904,25899346902,-2,1096,2033,10
25901875086,25901875085,-1,1212,2357,10
25902328278,25902328277,-1,1024,2509,10
25902547808,25902547808,0,2308,3403,10
25902849746,25902849742,-4,1139,2252,10
25907377334,25907377335,1,2316,2672,10
25909346764,25909346783,19,663,1124,10
25913122383,25913122382,-1,1734,2344,10
25917472999,25917472995,-4,1760,2082,10
25917692692,25917692690,-2,1390,2434,10
25921670579,25921670578,-1,1188,1780,10
25922222024,25922222017,-7,1027,1491,10
25925460077,25925460080,3,1001,1399,10
25929116989,25929116986,-3,1553,2278,10
25932208887,25932208886,-1,1009,2530,10
25932391732,25932391731,-1,1320,1819,10
25932502742,25932502741,-1,1459,1917,10
25932895061,25932895059,-2,1162,1892,10
25932984696,25932984678,-18,275,2400,10
25940754459,25940754458,-1,44586,15929,10
25940954210,25940954214,4,1443,1307,10
25944633580,25944633578,-2,1660,2426,10
25944872714,25944872719,5,1519,1227,10
25947885471,25947885451,-20,826,1569,10
25953216552,25953216549,-3,1576,2218,10
25957901281,25957901287,6,4790,1832,10
25960091130,25960091131,1,1078,1890,10
25962900475,25962900473,-2,1333,3178,10
25963666023,25963666021,-2,1598,1569,10
25964391163,25964391161,-2,1400,2088,10
25966365703,25966365707,4,4166,23139,10
25971016301,25971016300,-1,1267,1932,10
25972803259,25972803258,-1,1518,2213,10
25975163494,25975163491,-3,1094,2211,10
25975989782,25975989780,-2,1347,2494,10
25979569750,25979569750,0,786,1196,10
25980968426,25980968425,-1,956,2140,10
25981787653,25981787651,-2,1242,2138,10
25982918411,25982918410,-1,1317,3361,10
25983112129,25983112124,-5,540,1893,10
25991896043,25991896041,-2,1321,2513,10
25993209279,25993209278,-1,1153,1497,10
25998557941,25998557940,-1,1500,2119,10
26003365873,26003365871,-2,833,1945,10
26005917882,26005917881,-1,1869,2739,10
26009976095,26009976093,-2,941,1608,10
26010045764,26010045781,17,1342,1917,10
26010836991,26010836990,-1,920,1540,10
26013267889,26013267888,-1,1012,2552,10
26013536573,26013536574,1,1258,1701,10
26017599460,26017599466,6,3011,1483,10
26020425974,26020425973,-1,1759,2406,10
26021384398,26021384396,-2,2070,3549,10
26023858205,26023858203,-2,1409,2673,10
26025926575,26025926581,6,2702,1356,10
26027080949,26027080949,0,516,1385,10
26029320272,26029320273,1,1287,1469,10
26031058062,26031058068,6,6514,2708,10
26034090039,26034090037,-2,1025,2250,10
26034763173,26034763171,-2,365,675,10
26037659130,26037659130,0,912,1665,10
26038215330,26038215316,-14,224,1521,10
26039263677,26039263674,-3,1532,1727,10
26041249771,26041249768,-3,1132,1586,10
26041633066,26041633067,1,954,1895,10
26045267195,26045267195,0,1431,2075,10
26057254394,26057254372,-22,3821,1318,10
26058734754,26058734754,0,1937,2040,10
26060121054,26060121034,-20,991,1269,10
26060671304,26060671301,-3,1107,2832,10
26061667455,26061667452,-3,711,1277,10
26069937049,26069937054,5,2377,1110,10
26073294050,26073294047,-3,1042,1878,10
26078676587,26078676586,-1,979,1324,10
26079374137,26079374136,-1,1188,1638,10
26083030407,26083030407,0,955,1528,10
26083412086,26083412088,2,2056,1488,10
26084028960,26084028962,2,1748,1325,10
26086123539,26086123539,0,973,2265,10
26089793225,26089793222,-3,1137,1974,10
26091014075,26091014073,-2,939,2115,10
26091459056,26091459071,15,1539,5372,10
26094686946,26094686946,0,1121,2283,10
26096080013,26096080012,-1,17641,30213,10
26096444411,26096444411,0,1358,1902,10
26096950002,26096950001,-1,1231,1822,10
26100272321,26100272320,-1,1201,1705,10
26100964930,26100964929,-1,824,2244,10
26103395411,26103395416,5,11314,24490,10
26105673901,26105673901,0,2324,2212,10
26107314138,26107314138,0,1035,1332,10
26109777080,26109777082,2,1535,1192,10
26113312690,26113312690,0,1148,1432,10
26114628953,26114628954,1,1789,2292,10
26114841466,26114841465,-1,1256,2251,10
26118586443,26118586443,0,1325,1309,10
26122858615,26122858614,-1,1109,2750,10
26123619439,26123619437,-2,1178,2253,10
26124374407,26124374403,-4,17747,41932,10
26125264215,26125264214,-1,939,2064,10
26127146846,26127146843,-3,1741,3055,10
26132616069,26132616067,-2,820,1699,10
26133915382,26133915382,0,1107,2372,10
26138876741,26138876739,-2,840,1881,10
26143099364,26143099365,1,893,2087,10
26145873467,26145873466,-1,1805,1989,10
26149567259,26149567258,-1,1466,1555,10
26150993114,26150993112,-2,1502,1954,10
26153049905,26153049905,0,977,2323,10
26153321770,26153321777,7,2467,1130,10
26155082571,26155082569,-2,1614,1774,10
26155265937,26155265920,-17,1069,1984,10
26155744294,26155744293,-1,1522,2488,10
26161156661,26161156661,0,1554,1253,10
26161321222,26161321219,-3,1208,1993,10
26166099249,26166099248,-1,1366,1578,10
26166911178,26166911177,-1,1262,2120,10
26168053471,26168053465,-6,1366,2666,10
26171305258,26171305255,-3,1030,2666,10
26176451161,26176451159,-2,867,2090,10
26176485506,26176485505,-1,15586,28815,10
26178344630,26178344629,-1,915,2161,10
26179375271,26179375269,-2,1194,3109,10
26179876857,26179876854,-3,1544,2128,10
26187205505,26187205505,0,1347,1941,10
26188029956,26188029954,-2,1974,2442,10
26190062434,26190062435,1,1770,3022,10
26190407813,26190407815,2,4043,3157,10
26191241794,26191241794,0,1515,2642,10
26193986778,26193986782,4,19381,16527,10
26199943358,26199943357,-1,977,1783,10
26200051275,26200051272,-3,802,2203,10
26201641702,26201641704,2,1091,1568,10
26202793950,26202793948,-2,1248,2266,10
26206080740,26206080734,-6,1009,2000,10
26206288659,26206288658,-1,1483,2112,10
26206760431,26206760430,-1,1139,2328,10
26209526453,26209526456,3,940,1215,10
26209815842,26209815848,6,2021,1285,10
26212884071,26212884072,1,1408,3092,10
26220300366,26220300359,-7,995,5489,10
26221432752,26221432775,23,731,1584,10
26224317799,26224317793,-6,911,3308,10
26224633019,26224633018,-1,1171,2123,10
26224962370,26224962370,0,1472,2467,10
26227060274,26227060273,-1,1334,1622,10
26228159354,26228159374,20,823,1345,10
26229092829,26229092830,1,1178,1646,10
26230906303,26230906300,-3,1226,1969,10
26232936994,26232936993,-1,893,2266,10
26233351930,26233351931,1,1920,2451,10
26236462002,26236461999,-3,1309,1372,10
26237022835,26237022830,-5,1574,3236,10
26242655794,26242655793,-1,1513,2046,10
26248647911,26248647910,-1,1340,2082,10
26250535931,26250535929,-2,850,1296,10
26251943821,26251943820,-1,1409,2318,10
26253769856,26253769845,-11,1657,2412,10
26254089227,26254089206,-21,657,1644,10
26257691044,26257691042,-2,1107,2641,10
26261852895,26261852894,-1,941,1810,10
26265852043,26265852044,1,2514,1720,10
26270760983,26270760985,2,785,1356,10
26271073068,26271073060,-8,1094,1345,10
26272819284,26272819302,18,578,3001,10
26273825417,26273825418,1,1049,2373,10
26275063252,26275063252,0,1174,1810,10
26278180079,26278180078,-1,1397,2019,10
26278966590,26278966587,-3,1379,2775,10
26280308417,26280308416,-1,1099,1582,10
26280492186,26280492185,-1,14969,20889,10
26281039399,26281039397,-2,1306,1993,10
26282599438,26282599435,-3,1220,1869,10
26283938363,26283938363,0,1568,2033,10
26290411131,26290411129,-2,1084,2237,10
26294697250,26294697247,-3,1318,2265,10
26297600864,26297600847,-17,1432,750,10
26300388907,26300388906,-1,1402,2053,10
26302833061,26302833060,-1,1681,1819,10
26303354315,26303354313,-2,885,1805,10
26307086751,26307086732,-19,5326,2749,10
26312105618,26312105617,-1,1407,2349,10
26312216857,26312216878,21,676,1775,10
26315200415,26315200410,-5,1695,2544,10
26315842234,26315842230,-4,1573,2999,10
26317182095,26317182094,-1,1044,1636,10
26319286496,26319286491,-5,1067,1673,10
26319541455,26319541454,-1,1037,1671,10
26321450794,26321450790,-4,659,1731,10
26322839323,26322839321,-2,760,1761,10
26327593971,26327593966,-5,1136,2051,10
26331070975,26331070976,1,1586,1609,10
26334208437,26334208435,-2,1168,1897,10
26334772841,26334772848,7,97,1108,10
26338254713,26338254714,1,2826,1398,10
26341098959,26341098960,1,1446,2157,10
26344884736,26344884735,-1,1601,2326,10
26355640044,26355640038,-6,2075,9346,10
26357443144,26357443138,-6,1233,3791,10
26359202027,26359202026,-1,1366,1607,10
26359543973,26359543972,-1,200,1613,10
26360196171,26360196171,0,1146,1704,10
26363024617,26363024615,-2,1148,2774,10
26363239743,26363239749,6,1661,813,10
26365746743,26365746742,-1,1165,1531,10
26365983421,26365983418,-3,1222,1656,10
26373138466,26373138468,2,1259,2046,10
26383614221,26383614218,-3,1603,2450,10
26395638906,26395638906,0,1168,1883,10
26395901780,26395901791,11,214,746,10
26400133101,26400133101,0,811,1231,10
26400276409,26400276411,2,2940,2284,10
26406130182,26406130181,-1,581,1232,10
26406441578,26406441577,-1,678,1212,10
26406650612,26406650610,-2,846,1641,10
26408119537,26408119537,0,922,1492,10
26408625893,26408625893,0,1591,2455,10
26408687579,26408687577,-2,1398,2260,10
26409991171,26409991170,-1,1029,1821,10
26411806483,26411806483,0,1730,1990,10
26414093182,26414093178,-4,1126,2432,10
26414516948,26414516967,19,1548,2478,10
26417567189,26417567190,1,939,1298,10
26421804080,26421804078,-2,978,2060,10
26422977726,26422977725,-1,1013,2360,10
26423213186,26423213184,-2,1231,1494,10
26425128573,26425128570,-3,1224,2405,10
26426593666,26426593664,-2,1263,2038,10
26428780371,26428780371,0,1304,2071,10
26429817986,26429817983,-3,984,1313,10
26436282800,26436282799,-1,927,1693,10
26437027394,26437027394,0,1084,1439,10
26443152569,26443152566,-3,1379,2546,10
26443235267,26443235265,-2,1080,1434,10
26446532216,26446532216,0,1656,1968,10
26448637240,26448637238,-2,606,1399,10
26451379915,26451379913,-2,960,1800,10
26452044898,26452044896,-2,813,1372,10
26454512539,26454512542,3,1285,1492,10
26454614726,26454614725,-1,1153,1710,10
26457731240,26457731239,-1,1472,2102,10
26458099219,26458099219,0,818,1849,10
26460783205,26460783206,1,1137,1616,10
26461111233,26461111234,1,1758,1277,10
26463330270,26463330271,1,1650,1487,10
26472136398,26472136395,-3,1658,1871,10
26473469590,26473469590,0,975,1857,10
26474621608,26474621630,22,318,655,10
26475725770,26475725769,-1,1563,2292,10
26476515785,26476515788,3,3861,3271,10
26477172486,26477172486,0,1485,2195,10
26477394171,26477394157,-14,857,1611,10
26477706494,26477706493,-1,1098,1705,10
26479680350,26479680368,18,1093,1861,10
26483016637,26483016633,-4,802,1595,10
26484474054,26484474054,0,2534,3647,10
26486553946,26486553945,-1,1225,2150,10
26487059331,26487059330,-1,1744,2826,10
26487406214,26487406215,1,1325,1804,10
26490225486,26490225486,0,822,2620,10
26493790847,26493790846,-1,687,1192,10
26497242737,26497242733,-4,1247,1567,10
26498089481,26498089477,-4,1303,1564,10
26506328211,26506328210,-1,814,1836,10
26507128980,26507128961,-19,1030,1892,10
26508645574,26508645573,-1,1266,2003,10
26513334729,26513334727,-2,1363,3129,10
26513654099,26513654095,-4,890,1619,10
26514541506,26514541509,3,1308,1869,10
26516496118,26516496118,0,1240,1617,10
26519608743,26519608742,-1,969,1769,10
26520074155,26520074153,-2,1342,2575,10
26520849949,26520849946,-3,1337,1951,10
26520885408,26520885407,-1,1208,2163,10
26521775115,26521775113,-2,1000,2181,10
26522681123,26522681122,-1,780,1547,10
26523736099,26523736096,-3,747,1414,10
26525196273,26525196270,-3,1465,2123,10
26525753038,26525753038,0,726,1370,10
26526084789,26526084788,-1,1077,1990,10
26527401906,26527401905,-1,1354,1842,10
26528236058,26528236055,-3,1257,2925,10
26530596586,26530596588,2,1319,1570,10
26536537261,26536537260,-1,1320,2719,10
26540996989,26540996986,-3,1212,1293,10
26548643346,26548643345,-1,1043,2173,10
26549737022,26549737021,-1,822,2661,10
26552718932,26552718933,1,2060,2082,10
26553523614,26553523610,-4,1454,2057,10
26554720273,26554720272,-1,1303,2340,10
26555832617,26555832616,-1,1583,2282,10
26558395869,26558395869,0,848,1594,10
26560056380,26560056377,-3,649,1199,10
26562736623,26562736622,-1,1145,1855,10
26565054177,26565054174,-3,1259,2004,10
26568259597,26568259594,-3,791,2595,10
26571118930,26571118928,-2,1114,2031,10
26574395094,26574395094,0,1252,2112,10
26575870626,26575870624,-2,1760,3000,10
26576575047,26576575047,0,854,909,10
26579938188,26579938186,-2,674,1401,10
26583063732,26583063731,-1,1179,1598,10
26586444646,26586444645,-1,1092,1634,10
26588492678,26588492676,-2,1463,2182,10
26590250699,26590250681,-18,1095,1870,10
26593579682,26593579681,-1,1393,2176,10
26595454447,26595454446,-1,1079,1673,10
26596833903,26596833902,-1,1255,1934,10
26597130199,26597130195,-4,1015,3099,10
26604468114,26604468122,8,3226,1430,10
26607766520,26607766516,-4,1050,1664,10
26608838681,26608838680,-1,1121,1203,10
26609836318,26609836316,-2,1364,1921,10
26610845395,26610845375,-20,87,233,10
26611113387,26611113385,-2,1547,3285,10
26623336342,26623336340,-2,1275,1485,10
26623502540,26623502555,15,225,1291,10
26627558163,26627558162,-1,1217,2168,10
26628108859,26628108857,-2,1178,2213,10
26628221360,26628221357,-3,1118,2120,10
26636081214,26636081214,0,1468,1654,10
26639527386,26639527383,-3,1152,1798,10
26641643277,26641643276,-1,1563,2621,10
26648137390,26648137390,0,1383,1393,10
26649613676,26649613674,-2,1739,1673,10
26650314782,26650314781,-1,1648,2281,10
26652556555,26652556550,-5,1153,2164,10
26654298742,26654298740,-2,1189,2257,10
26656071535,26656071534,-1,1289,2316,10
26660123511,26660123511,0,949,2083,10
26660633857,26660633857,0,1093,1442,10
26666241609,26666241609,0,1406,2572,10
26672533341,26672533345,4,2532,1116,10
26672954387,26672954386,-1,1300,2260,10
26674121462,26674121461,-1,1275,2380,10
26675066174,26675066174,0,1062,1504,10
26678293626,26678293625,-1,791,1582,10
26681490350,26681490351,1,1187,1726,10
26682051971,26682051978,7,249,751,10
26682672849,26682672848,-1,1329,2091,10
26684029269,26684029266,-3,1793,1755,10
26684891656,26684891652,-4,4109,11468,10
26689598029,26689598029,0,986,1366,10
26690292294,26690292292,-2,1521,2056,10
26692533855,26692533853,-2,1077,1733,10
26693480272,26693480270,-2,1522,2186,10
26695321300,26695321305,5,2749,1026,10
26695351958,26695351958,0,951,2181,10
26696152381,26696152380,-1,1010,1578,10
26696932358,26696932358,0,1450,2034,10
26700652150,26700652149,-1,1185,1990,10
26703229586,26703229584,-2,895,1629,10
26703349176,26703349171,-5,1605,1977,10
26707708498,26707708498,0,1614,2460,10
26708142606,26708142606,0,835,1273,10
26716899530,26716899527,-3,1036,1495,10
26716987219,26716987218,-1,2062,1682,10
26717047686,26717047686,0,1155,1819,10
26721023977,26721023977,0,1040,1647,10
26721262065,26721262065,0,1067,2704,10
26724914125,26724914124,-1,1409,1778,10
26730571270,26730571269,-1,981,1922,10
26732942051,26732942047,-4,826,1592,10
26738552913,26738552910,-3,1951,1899,10
26738880718,26738880716,-2,1154,2864,10
26740440546,26740440545,-1,1299,2229,10
26741228057,26741228057,0,1182,1753,10
26742440682,26742440679,-3,979,2366,10
26746380212,26746380208,-4,1417,2045,10
26747696273,26747696274,1,2234,2504,10
26748185855,26748185853,-2,1364,1701,10
26750564938,26750564937,-1,1254,1179,10
26758644594,26758644592,-2,1745,1985,10
26762568715,26762568715,0,1035,1540,10
26764716902,26764716901,-1,1019,1895,10
26766183530,26766183529,-1,1229,2100,10
26766631643,26766631647,4,2545,1234,10
26769986067,26769986065,-2,1485,2022,10
26770091675,26770091675,0,1115,1599,10
26775552009,26775552010,1,1226,2267,10
26782580908,26782580907,-1,2083,2658,10
26783037907,26783037906,-1,1058,1455,10
26790553385,26790553383,-2,725,1908,10
26791143083,26791143081,-2,1678,2557,10
26791961078,26791961078,0,1337,2134,10
26795332675,26795332674,-1,1232,1939,10
26800063458,26800063458,0,1140,2083,10
26801337154,26801337152,-2,1805,1822,10
26806351625,26806351626,1,1725,1699,10
26807262666,26807262667,1,599,1000,10
26808455723,26808455722,-1,886,1263,10
26810723313,26810723331,18,400,1334,10
26810997042,26810997040,-2,769,1695,10
26812684350,26812684348,-2,1128,2803,10
26817768390,26817768388,-2,1530,2598,10
26818652137,26818652126,-11,238,3560,10
26824033913,26824033911,-2,818,1595,10
26824721009,26824720995,-14,1221,1853,10
26827733930,26827733929,-1,1170,1265,10
26830463383,26830463382,-1,1257,1933,10
26840064546,26840064548,2,626,1660,10
26843299014,26843299013,-1,1445,2665,10
26843486539,26843486537,-2,1008,2324,10
26844873126,26844873126,0,1594,1589,10
26847023534,26847023531,-3,1242,2017,10
26847156904,26847156902,-2,1672,2574,10
26847469636,26847469635,-1,1511,1775,10
26849923376,26849923370,-6,936,1791,10
26850426950,26850426949,-1,1927,1841,10
26857880394,26857880393,-1,1274,2949,10
26862420603,26862420600,-3,1013,2063,10
26864411220,26864411218,-2,989,1234,10
26866506023,26866506021,-2,1303,2019,10
26876227595,26876227593,-2,766,1484,10
26877622297,26877622294,-3,635,1482,10
26878593419,26878593417,-2,1572,1895,10
26882363636,26882363634,-2,1460,1366,10
26882859297,26882859295,-2,1158,2229,10
26887323403,26887323401,-2,1036,1796,10
26887372963,26887372961,-2,1229,2388,10
26887531926,26887531923,-3,1605,2035,10
26890955442,26890955441,-1,1396,2618,10
26895233478,26895233477,-1,1204,1162,10
26896674933,26896674930,-3,1170,2164,10
26897299789,26897299787,-2,1328,1289,10
26900692441,26900692439,-2,1389,2219,10
26901356751,26901356751,0,1277,1749,10
26903955403,26903955401,-2,1634,2581,10
26904295483,26904295482,-1,1187,2073,10
26906299282,26906299282,0,1237,2119,10
26906873634,26906873630,-4,1009,1545,10
26907403531,26907403518,-13,1157,1313,10
26910513551,26910513550,-1,1038,1655,10
26912625264,26912625281,17,1168,1273,10
26916000454,26916000472,18,751,1821,10
26916056355,26916056354,-1,1423,1722,10
26917001934,26917001935,1,1089,1765,10
26919260315,26919260311,-4,1056,1963,10
26931117116,26931117114,-2,1093,1582,10
26932730530,26932730529,-1,1091,2486,10
26933399134,26933399134,0,1084,1643,10
26933629928,26933629927,-1,888,1061,10
26934461697,26934461691,-6,1287,1715,10
26942893631,26942893632,1,1214,1936,10
26946231903,26946231902,-1,1476,2303,10
26947467614,26947467612,-2,1212,2498,10
26956462275,26956462274,-1,1371,2230,10
26957721339,26957721336,-3,1517,2155,10
26960221907,26960221907,0,785,1369,10
26961418961,26961418960,-1,1060,1761,10
26962691274,26962691273,-1,1448,2783,10
26963730406,26963730406,0,1148,1706,10
26966966638,26966966638,0,1307,1402,10
26968502955,26968502952,-3,1005,1584,10
26969980699,26969980698,-1,982,1637,10
26972450797,26972450803,6,3646,1556,10
26974209590,26974209591,1,1093,1559,10
26974574118,26974574117,-1,1523,2303,10
26983571770,26983571769,-1,1287,1447,10
26987101477,26987101476,-1,1057,1459,10
26998612172,26998612168,-4,1235,1631,10
27000560738,27000560736,-2,1135,2109,10
27001866757,27001866755,-2,1076,1188,10
27009392814,27009392813,-1,1198,1350,10
27013539651,27013539651,0,1905,2344,10
27016508834,27016508830,-4,873,1533,10
27023244366,27023244366,0,1315,990,10
27023770914,27023770910,-4,1216,2577,10
27025808460,27025808458,-2,1211,2114,10
27030371957,27030371957,0,771,1328,10
27030819355,27030819352,-3,451,1728,10
27032311131,27032311130,-1,1002,1342,10
27036759305,27036759302,-3,1463,2070,10
27037474001,27037474023,22,1154,1964,10
27049637634,27049637633,-1,1525,2170,10
27052140891,27052140890,-1,1048,1897,10
27055015923,27055015925,2,1158,1517,10
27055574045,27055574041,-4,1584,3441,10
27056060992,27056060991,-1,1471,2584,10
27064078837,27064078836,-1,991,1651,10
27067593209,27067593206,-3,1834,3257,10
27072890210,27072890208,-2,1357,2328,10
27075935364,27075935363,-1,1157,1804,10
27077349079,27077349086,7,2089,1043,10
27081602939,27081602941,2,1166,1695,10
27082669023,27082669022,-1,1153,2280,10
27083787543,27083787544,1,1171,2325,10
27084246161,27084246182,21,1303,1889,10
27085948034,27085948034,0,1034,1400,10
27088300739,27088300737,-2,1567,2265,10
27091788653,27091788652,-1,1124,1184,10
27102930439,27102930438,-1,761,1400,10
27103097986,27103097985,-1,1134,1859,10
27103724461,27103724458,-3,795,1830,10
27110758219,27110758218,-1,809,2424,10
27113630314,27113630312,-2,1200,2295,10
27113914883,27113914867,-16,1144,1846,10
27118881361,27118881358,-3,1429,1942,10
27119299276,27119299275,-1,1353,1774,10
27119376062,27119376058,-4,709,1354,10
27121426134,27121426136,2,1032,2021,10
27121758254,27121758254,0,995,1810,10
27122183415,27122183415,0,989,1514,10
27124353162,27124353161,-1,751,2206,10
27127575548,27127575541,-7,2255,6949,10
27129363693,27129363691,-2,1684,2674,10
27131764002,27131764001,-1,924,1438,10
27132145226,27132145223,-3,1203,1934,10
27132476679,27132476678,-1,19061,86276,10
27133491035,27133491030,-5,1218,1609,10
27136486783,27136486780,-3,874,2509,10
27137701704,27137701699,-5,1320,1187,10
27138409989,27138409993,4,2125,1152,10
27141322273,27141322272,-1,968,1942,10
27141766862,27141766859,-3,1106,1749,10
27142942243,27142942245,2,1448,1789,10
27143762914,27143762922,8,11644,30609,10
27144775321,27144775317,-4,1033,1867,10
27144997154,27144997145,-9,1495,2136,10
27145211423,27145211422,-1,1436,1621,10
27150012757,27150012760,3,1318,2145,10
27153768895,27153768895,0,931,1426,10
27156471978,27156471978,0,890,1838,10
27159778677,27159778674,-3,776,1693,10
27161097206,27161097205,-1,1095,1642,10
27167397882,27167397881,-1,854,1569,10
27167751676,27167751674,-2,1547,1994,10
27168736098,27168736094,-4,1349,4690,10
27170012800,27170012799,-1,1506,1824,10
27170484414,27170484411,-3,1401,2293,10
27171900927,27171900927,0,1828,2859,10
27173129522,27173129522,0,1766,1668,10
27173581413,27173581413,0,816,1835,10
27176470735,27176470734,-1,788,1509,10
27176884656,27176884639,-17,1403,2064,10
27178695093,27178695092,-1,1001,1914,10
27183792200,27183792198,-2,842,1807,10
27186346102,27186346101,-1,1566,2227,10
27187403541,27187403562,21,1195,1651,10
27189447994,27189447987,-7,499,2864,10
27191105633,27191105633,0,1385,1481,10
27193257836,27193257834,-2,1416,1781,10
27193406054,27193406053,-1,1228,1538,10
27198287286,27198287285,-1,1018,2048,10
27198414938,27198414938,0,1321,1736,10
27202330262,27202330262,0,853,1535,10
27202722322,27202722302,-20,1148,1789,10
27203989563,27203989563,0,1242,2197,10
27205485826,27205485826,0,846,1588,10
27209946302,27209946301,-1,1048,1758,10
27211529367,27211529366,-1,1064,1915,10
27217456522,27217456522,0,1421,1997,10
27218336451,27218336451,0,1318,2109,10
27218627211,27218627209,-2,972,2437,10
27222162609,27222162602,-7,458,3483,10
27227934901,27227934900,-1,1099,2151,10
27228786249,27228786247,-2,1055,2754,10
27230104645,27230104642,-3,1261,1761,10
27230244826,27230244825,-1,1310,1522,10
27230922592,27230922590,-2,1436,1580,10
27232658191,27232658182,-9,1042,1658,10
27233944523,27233944521,-2,1732,2718,10
27238185890,27238185887,-3,1005,2271,10
27238864458,27238864455,-3,1811,3053,10
27242595441,27242595438,-3,1296,2945,10
27244054099,27244054097,-2,1366,2818,10
27244532135,27244532133,-2,962,1684,10
27246736529,27246736523,-6,1262,4623,10
27251555519,27251555517,-2,1118,2241,10
27252515527,27252515525,-2,1506,2024,10
27255280351,27255280350,-1,1141,1837,10
27255925558,27255925538,-20,1385,1207,10
27257436463,27257436454,-9,1097,1160,10
27258548821,27258548819,-2,851,1371,10
27260592224,27260592222,-2,1225,2304,10
27263425921,27263425921,0,1490,2081,10
27264688470,27264688468,-2,5835,10112,10
27265684566,27265684565,-1,1918,2201,10
27266609531,27266609531,0,993,1971,10
27269071406,27269071406,0,1362,1139,10
27269878605,27269878601,-4,977,2287,10
27272788826,27272788823,-3,1658,2123,10
27273384839,27273384840,1,906,1661,10
27280148015,27280148013,-2,958,1887,10
27280868110,27280868110,0,1591,1832,10
27283314459,27283314454,-5,1351,2185,10
27283870851,27283870837,-14,935,1691,10
27289639143,27289639142,-1,1200,1643,10
27289800259,27289800257,-2,1225,1885,10
27295205005,27295205004,-1,1179,1972,10
27295859142,27295859141,-1,1247,2074,10
27296582867,27296582865,-2,895,1571,10
27298202251,27298202249,-2,1271,2019,10
27301730298,27301730297,-1,1099,1528,10
27302219318,27302219317,-1,1360,2280,10
27308960125,27308960122,-3,1071,2126,10
27309775030,27309775027,-3,1121,1843,10
27310221113,27310221123,10,220,701,10
27310948513,27310948499,-14,1595,2733,10
27315519397,27315519400,3,718,811,10
27317523056,27317523054,-2,715,1242,10
27317961101,27317961099,-2,1199,2041,10
27320144721,27320144718,-3,942,3497,10
27321951193,27321951191,-2,1681,3222,10
27325820574,27325820571,-3,1228,2342,10
27326426465,27326426465,0,1140,2404,10
27327142822,27327142819,-3,1011,1513,10
27327193242,27327193230,-12,1311,1584,10
27328864191,27328864189,-2,920,1831,10
27330214599,27330214595,-4,1279,2313,10
27333368545,27333368541,-4,1053,3257,10
27335984431,27335984425,-6,1039,3151,10
27336762873,27336762871,-2,1635,2156,10
27337007936,27337007957,21,1536,2263,10
27340183954,27340183951,-3,1419,2252,10
27343854211,27343854207,-4,891,2532,10
27346111710,27346111708,-2,1390,2518,10
27348043730,27348043730,0,1064,1803,10
27353270258,27353270258,0,1132,1717,10
27355265011,27355265008,-3,1116,2256,10
27358938065,27358938064,-1,1192,1759,10
27359749725,27359749724,-1,848,1355,10
27361836049,27361836048,-1,1311,2176,10
27363245370,27363245368,-2,1379,2642,10
27366080219,27366080217,-2,991,1598,10
27369423881,27369423882,1,1442,1460,10
27371472999,27371472998,-1,1286,1815,10
27371879131,27371879129,-2,981,1703,10
27373427866,27373427864,-2,769,1057,10
27373758737,27373758735,-2,1148,1437,10
27374129658,27374129657,-1,1365,1913,10
27376722726,27376722738,12,719,1785,10
27377954152,27377954151,-1,1445,2025,10
27378139550,27378139549,-1,666,1491,10
27378452783,27378452781,-2,882,1445,10
27378577987,27378577984,-3,1106,2427,10
27379407014,27379407020,6,3033,1127,10
27381628041,27381628025,-16,1011,333,10
27385872313,27385872312,-1,806,1107,10
27387897885,27387897883,-2,1297,1430,10
27391905057,27391905053,-4,1627,2019,10
27393251693,27393251690,-3,1323,2311,10
27396366170,27396366164,-6,1137,5066,10
27397352829,27397352827,-2,1098,1271,10
27397715631,27397715632,1,1348,1265,10
27398082932,27398082932,0,921,1475,10
27401532109,27401532107,-2,1130,1782,10
27402454180,27402454179,-1,1490,1439,10
27406353617,27406353618,1,1573,1566,10
27408700042,27408700039,-3,959,1206,10
27410424679,27410424679,0,1305,2477,10
27410957264,27410957263,-1,1290,2586,10
27414528009,27414528007,-2,1475,2002,10
27414901856,27414901843,-13,1243,1479,10
27422934739,27422934737,-2,1036,2811,10
27425276847,27425276845,-2,865,2206,10
27425697121,27425697120,-1,1177,1814,10
27425839385,27425839386,1,1251,2316,10
27426394625,27426394647,22,1184,1658,10
27427561217,27427561221,4,2383,1835,10
27430421323,27430421321,-2,926,1871,10
27434025120,27434025119,-1,901,1314,10
27434094449,27434094450,1,1295,1772,10
27437737240,27437737261,21,773,1003,10
27439475910,27439475907,-3,1506,2444,10
27440574638,27440574647,9,12775,33883,10
27441035181,27441035181,0,1131,1577,10
27445217353,27445217353,0,1352,2303,10
27452342258,27452342257,-1,1477,2154,10
27455991767,27455991766,-1,1348,1772,10
27458225770,27458225768,-2,872,2533,10
27458975317,27458975308,-9,1058,1872,10
27459153851,27459153834,-17,1212,1999,10
27462807407,27462807411,4,1785,682,10
27463484022,27463484026,4,1553,1228,10
27469533779,27469533778,-1,1043,2287,10
27472275839,27472275839,0,861,2298,10
27483804278,27483804276,-2,1552,2903,10
27485409153,27485409151,-2,922,2177,10
27487175643,27487175641,-2,1129,1972,10
27490701635,27490701634,-1,1231,1978,10
27495082729,27495082727,-2,1548,1625,10
27496172215,27496172213,-2,1904,2627,10
27500460541,27500460539,-2,1697,2719,10
27506036163,27506036162,-1,1298,1706,10
27507100942,27507100940,-2,1184,1949,10
27509415774,27509415775,1,925,1973,10
27511821707,27511821707,0,1247,2628,10
27520863390,27520863389,-1,1587,2228,10
27525746434,27525746434,0,1092,2332,10
27527693995,27527693992,-3,1395,2257,10
27530898235,27530898234,-1,1427,1943,10
27532169377,27532169377,0,768,1377,10
27533758682,27533758681,-1,1341,1305,10
27534578813,27534578813,0,1007,2138,10
27537982234,27537982232,-2,842,2364,10
27539314315,27539314317,2,1211,2468,10
27541337426,27541337423,-3,1044,1872,10
27541814887,27541814886,-1,1387,978,10
27546738097,27546738091,-6,1100,2896,10
27548395740,27548395741,1,2100,1663,10
27550452196,27550452201,5,2307,1327,10
27556656333,27556656338,5,5916,2654,10
27559173249,27559173250,1,1092,1658,10
27559548012,27559548018,6,74,524,10
27561706126,27561706125,-1,1366,1830,10
27562244511,27562244509,-2,1398,2073,10
27562795370,27562795368,-2,1401,2272,10
27563711394,27563711394,0,1520,2209,10
27564976722,27564976727,5,4091,1282,10
27566579813,27566579812,-1,1933,2061,10
27567311428,27567311430,2,1785,1203,10
27567551589,27567551594,5,3524,1198,10
27572022983,27572022983,0,1224,1656,10
27574923087,27574923082,-5,1630,6717,10
27578741122,27578741122,0,1700,2595,10
27584281646,27584281642,-4,1206,2450,10
27586283386,27586283386,0,1241,1439,10
27587450750,27587450752,2,1308,1326,10
27588763641,27588763641,0,1544,1952,10
27592086970,27592086967,-3,718,1642,10
27593300379,27593300378,-1,1742,2361,10
27594972716,27594972734,18,20168,51710,10
27595508863,27595508858,-5,1000,3285,10
27595810657,27595810678,21,958,1317,10
27595975909,27595975911,2,906,1207,10
27598412667,27598412665,-2,857,1493,10
27602099347,27602099346,-1,1332,2037,10
27607367293,27607367290,-3,1493,2010,10
27609565877,27609565874,-3,1971,2701,10
27609779997,27609779998,1,919,1325,10
27610785201,27610785202,1,945,1568,10
27610998363,27610998362,-1,1430,2371,10
27614848938,27614848938,0,1536,2063,10
27620138064,27620138062,-2,1100,1722,10
27620682705,27620682703,-2,1656,2133,10
27621576763,27621576764,1,908,2110,10
27621954068,27621954081,13,161,338,10
27622460399,27622460399,0,1047,1576,10
27631771727,27631771726,-1,1320,2042,10
27634232612,27634232610,-2,1581,2408,10
27634316729,27634316713,-16,1202,1853,10
27634700758,27634700758,0,1166,1790,10
27641925686,27641925681,-5,638,1401,10
27644611804,27644611823,19,975,1393,10
27646173358,27646173378,20,1494,1693,10
27649546341,27649546338,-3,1072,1991,10
27650759994,27650759994,0,1242,1639,10
27650963634,27650963646,12,378,2001,10
27651319851,27651319850,-1,1147,1601,10
27651638650,27651638649,-1,1334,2082,10
27656435378,27656435377,-1,1287,2394,10
27657821171,27657821170,-1,1291,1864,10
27657920049,27657920047,-2,1526,2430,10
27658038521,27658038522,1,904,1539,10
27659141430,27659141434,4,15754,9620,10
27660128674,27660128672,-2,1454,2366,10
27661037141,27661037138,-3,1024,1843,10
27665589670,27665589670,0,1188,1757,10
27666590502,27666590499,-3,1049,2173,10
27667303489,27667303487,-2,1175,1699,10
27670462630,27670462629,-1,1054,1560,10
27671043407,27671043410,3,2562,1777,10
27675129735,27675129734,-1,709,1679,10
27679634279,27679634278,-1,1435,2511,10
27679664663,27679664660,-3,888,1536,10
27680715131,27680715130,-1,1729,2598,10
27683690962,27683690961,-1,1325,2902,10
27694211007,27694211004,-3,1341,2252,10
27703683226,27703683221,-5,954,2092,10
27705506127,27705506125,-2,1258,2079,10
27708649743,27708649742,-1,1540,3011,10
27710768151,27710768150,-1,1037,1505,10
27711937403,27711937383,-20,281,996,10
27714850231,27714850228,-3,1790,2619,10
27715411054,27715411051,-3,1627,2097,10
27715547131,27715547131,0,1367,2163,10
27715800926,27715800922,-4,1359,1808,10
27717873638,27717873657,19,975,1124,10
27719353282,27719353301,19,559,425,10
27723452018,27723452018,0,1340,1934,10
27725917040,27725917042,2,3207,2508,10
27728862605,27728862603,-2,1207,1817,10
27729649226,27729649226,0,1167,1829,10
27732523897,27732523894,-3,756,1120,10
27735556675,27735556673,-2,1125,2008,10
27745414279,27745414297,18,712,1406,10
27747659687,27747659686,-1,1117,1433,10
27748754458,27748754457,-1,2101,2784,10
27750652598,27750652617,19,1208,1600,10
27756418438,27756418437,-1,1938,1979,10
27759709966,27759709966,0,1361,1974,10
27760780161,27760780158,-3,1171,1497,10
27761826078,27761826076,-2,568,1533,10
27765159161,27765159159,-2,1001,1884,10
27765349538,27765349536,-2,1106,1590,10
27766935866,27766935863,-3,928,2111,10
27767636716,27767636716,0,1615,2193,10
27774773260,27774773256,-4,1285,3137,10
27775885333,27775885332,-1,1481,2341,10
27776025014,27776025013,-1,1040,1825,10
27778808623,27778808621,-2,835,1328,10
27780780936,27780780934,-2,1004,1631,10
27781036742,27781036737,-5,911,1910,10
27782118398,27782118398,0,1187,2146,10
27783347939,27783347942,3,2098,2241,10
27783991717,27783991715,-2,1205,2196,10
27784723988,27784723984,-4,582,1394,10
27789844735,27789844734,-1,1594,3037,10
27790462090,27790462089,-1,1176,1698,10
27793263011,27793263014,3,1873,2004,10
27799282166,27799282167,1,1106,2076,10
27806130862,27806130862,0,905,1102,10
27807851320,27807851318,-2,1239,2001,10
27810123813,27810123812,-1,926,1255,10
27821909173,27821909172,-1,1424,1697,10
27824301856,27824301861,5,1826,1067,10
27826673427,27826673426,-1,1408,2070,10
27827030935,27827030934,-1,931,1512,10
27827829309,27827829307,-2,984,1968,10
27835376602,27835376602,0,1304,1717,10
27840155121,27840155119,-2,1028,1731,10
27840958801,27840958798,-3,1076,1700,10
27843911915,27843911914,-1,984,1117,10
27845878411,27845878406,-5,1366,1909,10
27845944720,27845944704,-16,964,1581,10
27852199191,27852199189,-2,1358,2213,10
27852745378,27852745375,-3,1330,3367,10
27857599040,27857599038,-2,803,1335,10
27861471102,27861471107,5,2302,1429,10
27864196822,27864196819,-3,1254,1456,10
27864870351,27864870345,-6,1236,2293,10
27869455533,27869455533,0,1079,1453,10
27872373565,27872373562,-3,1191,2762,10
27879755150,27879755153,3,19475,23792,10
27886332394,27886332390,-4,966,2177,10
27893288903,27893288898,-5,1532,6143,10
27899599477,27899599475,-2,1057,2093,10
27900772688,27900772684,-4,1331,3160,10
27903812601,27903812599,-2,1319,2073,10
27905935970,27905935967,-3,1373,2376,10
27907423098,27907423098,0,1246,1750,10
27915858209,27915858206,-3,1521,2378,10
27916663395,27916663382,-13,956,1983,10
27916878255,27916878251,-4,1271,2526,10
27917583506,27917583510,4,1661,1506,10
27918060247,27918060245,-2,1000,1972,10
27918478418,27918478417,-1,1019,1847,10
27923797171,27923797171,0,1204,2134,10
27924782875,27924782871,-4,1551,1963,10
27928286358,27928286356,-2,1904,2178,10
27939745010,27939745018,8,3210,1408,10
27940183574,27940183573,-1,940,1848,10
27941887457,27941887474,17,859,1419,10
27945792251,27945792249,-2,863,983,10
27950184326,27950184330,4,2752,1471,10
27951250477,27951250486,9,5765,1532,10
27954214253,27954214248,-5,1433,4002,10
27956100065,27956100062,-3,1372,2322,10
27957292398,27957292400,2,1324,2439,10
27958777203,27958777201,-2,1485,1862,10
27961195599,27961195597,-2,942,1400,10
27961723578,27961723577,-1,1196,2369,10
27962209130,27962209129,-1,886,1356,10
27963911098,27963911093,-5,983,1166,10
27970268061,27970268060,-1,1272,1714,10
27971827282,27971827278,-4,1423,2561,10
27973347283,27973347281,-2,1007,1752,10
27976293220,27976293217,-3,1174,1552,10
27977952783,27977952782,-1,1283,1771,10
27978437793,27978437798,5,1542,893,10
27981164562,27981164562,0,1519,2009,10
27981822942,27981822942,0,991,2337,10
27982638619,27982638617,-2,895,1996,10
27983678326,27983678325,-1,1225,2345,10
27984218665,27984218668,3,916,1514,10
27984549310,27984549327,17,1013,704,10
27989020274,27989020273,-1,1006,2444,10
27989229929,27989229929,0,1250,1805,10
27994896479,27994896477,-2,1344,1616,10
27999223884,27999223873,-11,1159,5303,10
28000235791,28000235787,-4,979,1969,10
28001044473,28001044472,-1,1464,2842,10
28006215073,28006215070,-3,1377,2090,10
28007078665,28007078662,-3,1417,1364,10
28009498343,28009498341,-2,1579,2246,10
28010607347,28010607347,0,1398,1553,10
28010789463,28010789462,-1,1318,2706,10
28011068120,28011068108,-12,189,438,10
28012572789,28012572787,-2,2533,4340,10
28014915237,28014915246,9,1974,2181,10
28017266225,28017266224,-1,1000,1942,10
28017737990,28017737988,-2,1665,2219,10
28020005807,28020005806,-1,564,1209,10
28022101024,28022101042,18,1142,1300,10
28022782258,28022782255,-3,990,2837,10
28026397708,28026397706,-2,1118,1807,10
28028684506,28028684512,6,1632,1750,10
28029538337,28029538345,8,15809,8022,10
28032958982,28032958982,0,944,1600,10
28034902277,28034902276,-1,1385,2828,10
28037571284,28037571283,-1,1075,1751,10
28040302197,28040302196,-1,1142,1390,10
28040432778,28040432756,-22,1295,2344,10
28046694515,28046694514,-1,1395,1331,10
28049022715,28049022714,-1,1052,2360,10
28049476242,28049476229,-13,817,1642,10
28054461298,28054461296,-2,1536,2203,10
28054786033,28054786028,-5,1322,1471,10
28061025259,28061025257,-2,1078,1612,10
28061225782,28061225779,-3,1302,1368,10
28063497603,28063497601,-2,1307,1734,10
28064724164,28064724163,-1,904,2436,10
28064790283,28064790287,4,293,1931,10
28064916691,28064916690,-1,980,1665,10
28066673779,28066673778,-1,2043,3375,10
28066716513,28066716510,-3,1877,2371,10
28069043802,28069043801,-1,719,872,10
28071919964,28071919962,-2,1395,2290,10
28072588387,28072588367,-20,1032,1879,10
28074591134,28074591131,-3,1207,1429,10
28079580128,28079580129,1,818,1279,10
28080345978,28080345986,8,5879,2110,10
28080769755,28080769756,1,1052,2157,10
28089893679,28089893678,-1,986,1409,10
28093933311,28093933310,-1,939,2190,10
28094459359,28094459358,-1,935,1242,10
28095508163,28095508158,-5,785,1317,10
28096540047,28096540043,-4,1529,2253,10
28101352695,28101352694,-1,1312,2475,10
28104182620,28104182618,-2,1127,1747,10
28105774185,28105774183,-2,1637,1470,10
28109986878,28109986877,-1,1244,2187,10
28110484418,28110484415,-3,1224,1802,10
28115156782,28115156788,6,1827,1096,10
28116976367,28116976365,-2,1436,2002,10
28117106609,28117106609,0,1465,1830,10
28122166970,28122166970,0,1438,1676,10
28123320535,28123320537,2,2261,1910,10
28127798618,28127798617,-1,1076,1387,10
28132472763,28132472762,-1,1562,1598,10
28136082227,28136082225,-2,1574,2268,10
28137126426,28137126427,1,2628,3767,10
28138030877,28138030875,-2,979,1458,10
28141555951,28141555949,-2,1296,1940,10
28141961715,28141961713,-2,964,1686,10
28144152247,28144152245,-2,1388,2047,10
28147059374,28147059376,2,1904,2102,10
28148904225,28148904231,6,4790,1717,10
28149205576,28149205575,-1,1222,1887,10
28150819307,28150819305,-2,1103,2019,10
28156024066,28156024066,0,827,1335,10
28158607690,28158607687,-3,1074,1823,10
28159256051,28159256038,-13,324,601,10
28169660623,28169660615,-8,3929,21619,10
28170113179,28170113176,-3,1305,2749,10
28171311419,28171311417,-2,1254,1947,10
28173427369,28173427366,-3,1511,2013,10
28177686352,28177686350,-2,1549,1847,10
28177782446,28177782446,0,1551,1245,10
28179177770,28179177770,0,862,1838,10
28180181792,28180181790,-2,948,1425,10
28183104022,28183104028,6,5171,2670,10
28183386127,28183386126,-1,1215,1260,10
28184332574,28184332571,-3,1117,2769,10
28189183922,28189183921,-1,1116,1725,10
28189265975,28189265973,-2,780,1491,10
28192775638,28192775638,0,1407,1516,10
28195189953,28195189951,-2,1341,2094,10
28195833969,28195833962,-7,679,1435,10
28198849265,28198849261,-4,1023,1445,10
28201852876,28201852874,-2,1219,2084,10
28202060678,28202060678,0,1172,1761,10
28203414874,28203414874,0,1257,2069,10
28206605968,28206605970,2,1187,1668,10
28208345666,28208345664,-2,1049,2268,10
28209933030,28209933029,-1,1835,2621,10
28210098750,28210098751,1,1130,1938,10
28210944695,28210944695,0,832,1635,10
28211621117,28211621117,0,1470,2308,10
28215577059,28215577059,0,845,1950,10
28222290033,28222290030,-3,1036,2565,10
28222370103,28222370102,-1,1095,2664,10
28227561599,28227561599,0,1355,2256,10
28228163860,28228163858,-2,1232,2115,10
28228514142,28228514141,-1,1301,1874,10
28230674022,28230674020,-2,778,2425,10
28231394341,28231394341,0,1113,1191,10
28231622414,28231622415,1,1225,1808,10
28232949510,28232949510,0,1345,1915,10
28233340641,28233340643,2,1170,1258,10
28234414809,28234414801,-8,928,1689,10
28235170975,28235170973,-2,1071,1521,10
28241896218,28241896214,-4,1877,3649,10
28242385622,28242385622,0,1172,2245,10
28242612587,28242612566,-21,277,680,10
28253765718,28253765715,-3,1196,2103,10
28255691829,28255691826,-3,1458,1908,10
28259744786,28259744786,0,810,1490,10
28261446597,28261446603,6,4425,1600,10
28262487740,28262487740,0,1183,1609,10
28270829651,28270829650,-1,1430,1772,10
28272473142,28272473138,-4,1250,2229,10
28273599791,28273599790,-1,1240,1616,10
28276538546,28276538543,-3,1033,2050,10
28277459951,28277459950,-1,1476,2361,10
28284080027,28284080027,0,1267,2318,10
28284850650,28284850650,0,954,1612,10
28286110803,28286110802,-1,1524,2358,10
28287596755,28287596756,1,1511,2008,10
28287927599,28287927598,-1,1006,1120,10
28289028498,28289028498,0,2685,4584,10
28289231717,28289231719,2,1381,1271,10
28292016977,28292016978,1,1166,1651,10
28292607938,28292607937,-1,1216,2417,10
28293608806,28293608802,-4,1321,2246,10
28303839770,28303839770,0,1051,1868,10
28306889158,28306889157,-1,1110,2670,10
28308445070,28308445077,7,3208,1518,10
28312452604,28312452603,-1,1167,2286,10
28312571494,28312571493,-1,1289,1820,10
28315685781,28315685781,0,1964,1776,10
28319891550,28319891547,-3,1602,2709,10
28320355757,28320355756,-1,1372,1676,10
28320725290,28320725290,0,1328,2328,10
28321423185,28321423182,-3,1139,2159,10
28321453822,28321453821,-1,1042,1902,10
28328048187,28328048185,-2,959,2083,10
28332625392,28332625391,-1,1356,1643,10
28334998867,28334998865,-2,1243,1591,10
28341078099,28341078098,-1,723,1192,10
28347655786,28347655782,-4,1050,1283,10
28355160434,28355160431,-3,648,1398,10
28357084094,28357084093,-1,896,1647,10
28358984134,28358984131,-3,1065,2122,10
28364744935,28364744933,-2,1022,1804,10
28365932122,28365932119,-3,1191,2120,10
28367044433,28367044437,4,2001,1287,10
28368156150,28368156148,-2,943,1836,10
28369433257,28369433255,-2,1264,2747,10
28369748580,28369748579,-1,1867,2760,10
28371508234,28371508236,2,1806,3835,10
28371952965,28371952962,-3,2676,4013,10
28374555449,28374555445,-4,947,2644,10
28375236378,28375236378,0,835,2091,10
28377100198,28377100195,-3,1230,1942,10
28380405691,28380405689,-2,1030,2096,10
28385208846,28385208842,-4,1612,4070,10
28385844111,28385844110,-1,1478,2035,10
28394990311,28394990309,-2,1806,1926,10
28395082082,28395082081,-1,1066,1542,10
28398920446,28398920444,-2,1799,2644,10
28400538673,28400538673,0,1739,1693,10
28402381311,28402381311,0,1692,2281,10
28404866539,28404866536,-3,1051,1697,10
28405400465,28405400487,22,550,898,10
28406546551,28406546542,-9,1372,7418,10
28406773859,28406773858,-1,1153,1656,10
28408290393,28408290389,-4,1596,2457,10
28409291955,28409291955,0,719,1393,10
28410834707,28410834707,0,1137,1200,10
28416068831,28416068849,18,964,1446,10
28419331872,28419331873,1,1636,2020,10
28421437194,28421437193,-1,935,2220,10
28422556343,28422556342,-1,836,1580,10
28422700766,28422700761,-5,1337,2701,10
28427152256,28427152254,-2,1341,2433,10
28429703613,28429703610,-3,1377,3318,10
28430748619,28430748616,-3,1550,1812,10
28430869045,28430869040,-5,1044,2191,10
28432964766,28432964765,-1,1263,1782,10
28436352454,28436352434,-20,934,1790,10
28437051071,28437051070,-1,1496,2146,10
28437249747,28437249745,-2,1320,1499,10
28437361011,28437361010,-1,994,2505,10
28437962090,28437962089,-1,1628,1830,10
28438817270,28438817267,-3,1400,1707,10
28439726735,28439726734,-1,1709,1977,10
28440355851,28440355851,0,1272,2425,10
28442860141,28442860139,-2,1200,1814,10
28445622492,28445622489,-3,1291,1707,10
28447534958,28447534957,-1,1217,2010,10
28449877086,28449877086,0,1294,2855,10
28450685418,28450685416,-2,2866,4407,10
28452584570,28452584570,0,1589,3262,10
28452905071,28452905066,-5,835,3608,10
28455289219,28455289217,-2,1025,2368,10
28455746540,28455746519,-21,194,644,10
28456772003,28456772001,-2,1343,2060,10
28462486687,28462486685,-2,1254,2485,10
28466684252,28466684250,-2,1309,2116,10
28474131366,28474131364,-2,1128,2738,10
28475640327,28475640319,-8,1099,2688,10
28476605915,28476605917,2,982,2455,10
28486737534,28486737534,0,875,1439,10
28487985609,28487985608,-1,1157,1857,10
28489927644,28489927641,-3,1241,2172,10
28490738990,28490738992,2,1312,1832,10
28492767425,28492767419,-6,1144,2903,10
28493877525,28493877523,-2,1069,2034,10
28501335886,28501335886,0,710,1326,10
28501674250,28501674248,-2,1001,1676,10
28502575163,28502575182,19,1647,2433,10
28507797094,28507797100,6,2234,1286,10
28508629214,28508629213,-1,1386,2595,10
28512177613,28512177613,0,1712,2232,10
28513107272,28513107283,11,9486,45845,10
28516519229,28516519227,-2,683,1590,10
28518048546,28518048545,-1,857,2364,10
28521040107,28521040106,-1,1188,2421,10
28522469866,28522469863,-3,2340,4692,10
28527531059,28527531058,-1,1084,1916,10
28529370585,28529370583,-2,1182,2898,10
28529429797,28529429797,0,1680,2197,10
28530325175,28530325173,-2,1138,1857,10
28531917147,28531917146,-1,1700,2592,10
28532015733,28532015731,-2,937,1118,10
28532703778,28532703777,-1,1122,1878,10
28534739912,28534739912,0,1453,2367,10
28538811285,28538811285,0,1267,2061,10
28539141261,28539141259,-2,1389,2305,10
28539329883,28539329879,-4,875,1600,10
28545489661,28545489659,-2,907,1805,10
28546371689,28546371686,-3,1033,1957,10
28547225721,28547225725,4,2582,1080,10
28549485447,28549485444,-3,3912,14011,10
28555756527,28555756526,-1,1322,2089,10
28556887271,28556887270,-1,1541,1408,10
28559974510,28559974515,5,3190,1546,10
28562123311,28562123312,1,1310,2007,10
28562992707,28562992701,-6,589,2517,10
28566870370,28566870365,-5,1398,1571,10
28570324885,28570324881,-4,1078,2073,10
28573205402,28573205401,-1,1376,3337,10
28574630060,28574630057,-3,1163,2616,10
28575210899,28575210897,-2,1597,1694,10
28575654355,28575654353,-2,842,1834,10
28580047578,28580047573,-5,44824,16174,10
28580819703,28580819701,-2,1297,1725,10
28582424264,28582424261,-3,1187,2445,10
28583287735,28583287733,-2,1486,1580,10
28584886891,28584886890,-1,733,1436,10
28586417629,28586417629,0,1261,1186,10
28588426983,28588426981,-2,1443,2228,10
28591495218,28591495215,-3,1114,1699,10
28592286336,28592286332,-4,1045,1276,10
28592601200,28592601199,-1,1154,1850,10
28598007239,28598007238,-1,1140,1742,10
28598642271,28598642269,-2,637,1881,10
28602130018,28602130003,-15,1017,2296,10
28602604939,28602604937,-2,27198,21930,10
28603574085,28603574086,1,1012,1436,10
28605591817,28605591814,-3,1201,2425,10
28606457925,28606457924,-1,1078,1792,10
28607935222,28607935215,-7,925,3874,10
28613768598,28613768592,-6,1938,308,10
28616081178,28616081178,0,1432,1889,10
28619341850,28619341853,3,2067,907,10
28620833823,28620833826,3,1207,1142,10
28623553295,28623553294,-1,1445,1925,10
28624399580,28624399580,0,1580,1801,10
28624992148,28624992146,-2,1537,2204,10
28626446870,28626446870,0,1266,1618,10
28627693134,28627693130,-4,826,2008,10
28635748146,28635748144,-2,1470,2007,10
28636222739,28636222739,0,1438,1565,10
28637511623,28637511621,-2,1711,2239,10
28640055959,28640055958,-1,856,1597,10
28640803292,28640803302,10,325,737,10
28642359543,28642359541,-2,1236,2294,10
28644053963,28644053962,-1,1600,2070,10
28646401495,28646401493,-2,1370,2910,10
28646644368,28646644366,-2,1375,1863,10
28648009052,28648009054,2,1749,1529,10
28649383390,28649383389,-1,1195,1966,10
28649990866,28649990865,-1,966,2078,10
28652536783,28652536778,-5,956,1344,10
28653425666,28653425665,-1,1122,2126,10
28656171775,28656171774,-1,1077,2159,10
28658404889,28658404889,0,1194,2070,10
28658714917,28658714914,-3,795,1575,10
28662635717,28662635716,-1,1236,1550,10
28668566069,28668566067,-2,1084,1876,10
28670488676,28670488687,11,14988,17970,10
28672038819,28672038817,-2,1197,1813,10
28672832964,28672832963,-1,1263,1798,10
28675354445,28675354445,0,1320,1712,10
28676558278,28676558281,3,1124,1626,10
28679163701,28679163709,8,5904,2027,10
28681808871,28681808870,-1,1174,2156,10
28681988535,28681988539,4,1526,1010,10
28684720338,28684720335,-3,1172,2105,10
28684768954,28684768954,0,1234,1032,10
28685424054,28685424054,0,1293,1495,10
28685494248,28685494237,-11,728,1799,10
28686391399,28686391396,-3,876,1406,10
28686852186,28686852185,-1,1016,1508,10
28688283706,28688283701,-5,1120,2608,10
28688621810,28688621807,-3,1067,1647,10
28689175234,28689175230,-4,1098,2208,10
28695361233,28695361229,-4,1318,2779,10
28701468006,28701468005,-1,1376,1770,10
28701781202,28701781202,0,1231,1996,10
28705936893,28705936893,0,1478,1585,10
28707213491,28707213496,5,7359,30810,10
28708285230,28708285227,-3,1455,3200,10
28708870851,28708870847,-4,1177,1672,10
28710744594,28710744595,1,1783,2263,10
28712604627,28712604626,-1,1393,2005,10
28715267878,28715267877,-1,943,2286,10
28720665327,28720665323,-4,1144,1399,10
28722944498,28722944494,-4,1355,2082,10
28726315205,28726315204,-1,1213,1561,10
28730781224,28730781224,0,1429,2274,10
28731712518,28731712517,-1,1073,2883,10
28734757813,28734757813,0,948,2827,10
28739480533,28739480531,-2,1037,1755,10
28739914194,28739914194,0,1161,1702,10
28740015046,28740015047,1,1102,1514,10
28741732158,28741732156,-2,1540,1890,10
28746891836,28746891837,1,1550,1561,10
28748076784,28748076782,-2,1108,1821,10
28753738378,28753738378,0,1331,1985,10
28754111390,28754111390,0,1409,1612,10
28755446703,28755446711,8,5881,1624,10
28755949124,28755949122,-2,941,1906,10
28759097921,28759097918,-3,1288,1778,10
28761671697,28761671696,-1,778,1282,10
28765318408,28765318406,-2,1060,1638,10
28771318386,28771318384,-2,1222,1796,10
28772567659,28772567659,0,1282,1520,10
28775833484,28775833483,-1,993,1656,10
28776365620,28776365619,-1,1636,1956,10
28778595319,28778595318,-1,857,2233,10
28778760561,28778760561,0,1235,1703,10
28779210525,28779210526,1,1479,2756,10
28784364077,28784364076,-1,1795,2028,10
28784739721,28784739719,-2,951,1778,10
28787340790,28787340790,0,1438,2231,10
28788913879,28788913877,-2,1322,2316,10
28789294249,28789294248,-1,1459,2492,10
28789452003,28789451985,-18,1162,2524,10
28797991731,28797991730,-1,880,1549,10
28798204874,28798204859,-15,780,1598,10
28798348804,28798348821,17,971,1810,10
28800135615,28800135614,-1,1175,1753,10
28802220427,28802220423,-4,1197,1784,10
28804109730,28804109730,0,880,1300,10
28804602392,28804602390,-2,1842,2261,10
28805672554,28805672554,0,1429,1904,10
28806885470,28806885466,-4,939,1624,10
28809299329,28809299321,-8,977,2370,10
28810889670,28810889670,0,1120,1398,10
28812733383,28812733380,-3,1266,2202,10
28816238531,28816238530,-1,1607,2377,10
28819105854,28819105850,-4,1052,2366,10
28821682936,28821682937,1,1342,1531,10
28823096051,28823096050,-1,1012,2122,10
28823329309,28823329309,0,1201,1987,10
28823355371,28823355366,-5,1193,4931,10
28823623725,28823623722,-3,1204,1800,10
28824912753,28824912752,-1,892,1349,10
28828732418,28828732418,0,1617,2221,10
28836316982,28836316983,1,1827,2135,10
28840706503,28840706503,0,894,1253,10
28848104153,28848104155,2,2060,1887,10
28848268160,28848268157,-3,904,1904,10
28848677154,28848677152,-2,1261,1945,10
28853816027,28853816026,-1,1022,1594,10
28862668425,28862668425,0,1345,1763,10
28865751062,28865751062,0,1695,2416,10
28866034493,28866034491,-2,1140,1964,10
28866395715,28866395706,-9,1130,2377,10
28866992579,28866992581,2,1224,1456,10
28869800054,28869800054,0,1265,1334,10
28870603550,28870603550,0,1216,1477,10
28871183279,28871183274,-5,1360,4180,10
28872600069,28872600068,-1,1308,1807,10
28880529174,28880529181,7,3989,1340,10
28884325047,28884325045,-2,1342,2540,10
28886156167,28886156164,-3,1130,1693,10
28889279253,28889279251,-2,1321,1864,10
28893334807,28893334806,-1,863,2126,10
28896774022,28896774018,-4,1279,2008,10
28897472123,28897472118,-5,1326,3414,10
28898387791,28898387789,-2,2011,4483,10
28900444017,28900444015,-2,1242,2840,10
28901637682,28901637681,-1,696,1430,10
28903398994,28903398990,-4,1232,2737,10
28905917551,28905917550,-1,1398,2033,10
28907065181,28907065181,0,1781,2655,10
28908353803,28908353802,-1,1551,1541,10
28909342703,28909342703,0,358,577,10
28910251731,28910251729,-2,1152,1501,10
28910795978,28910795974,-4,1341,1061,10
28916507218,28916507220,2,1747,1924,10
28916635568,28916635558,-10,86,914,10
28918418288,28918418286,-2,1212,2462,10
28928190409,28928190409,0,668,1204,10
28930445639,28930445638,-1,843,1331,10
28932481743,28932481742,-1,1119,1649,10
28933248169,28933248169,0,1023,2007,10
28936224016,28936224014,-2,1187,1752,10
28948918006,28948918022,16,454,1236,10
28949287742,28949287737,-5,1274,4570,10
28949951689,28949951686,-3,872,1901,10
28950862114,28950862114,0,921,2093,10
28951106570,28951106566,-4,1305,2878,10
28957700981,28957700980,-1,1934,2188,10
28959995637,28959995634,-3,1469,2964,10
28960347307,28960347294,-13,1360,1743,10
28964974110,28964974109,-1,1104,1812,10
28966572717,28966572721,4,2325,1366,10
28971297052,28971297050,-2,1195,2108,10
28971720730,28971720729,-1,1355,1920,10
28973054858,28973054860,2,1463,1790,10
28977469970,28977469967,-3,1102,1787,10
28980086598,28980086605,7,3975,1377,10
28983780440,28983780440,0,1118,1040,10
28987024902,28987024902,0,909,2157,10
28987616145,28987616151,6,19415,42306,10
28990423926,28990423927,1,1376,2336,10
28991296875,28991296869,-6,993,1953,10
28993821355,28993821356,1,1280,2031,10
28996334597,28996334596,-1,1277,1706,10
28997625963,28997625961,-2,1189,2062,10
29000023246,29000023246,0,1207,2244,10
29000785878,29000785877,-1,707,1847,10
29002833397,29002833398,1,1380,1961,10
29015813678,29015813675,-3,826,1974,10
29017790268,29017790265,-3,659,1614,10
29018966195,29018966198,3,1225,1560,10
29022293477,29022293479,2,781,735,10
29024493698,29024493697,-1,992,1838,10
29025583371,29025583369,-2,1399,2933,10
29025692083,29025692083,0,992,1269,10
29027614604,29027614601,-3,1533,2401,10
29032135142,29032135143,1,1161,1667,10
29036453882,29036453899,17,158,1084,10
29038256668,29038256666,-2,1023,1909,10
29041277709,29041277703,-6,2434,7659,10
29042190427,29042190426,-1,1415,2517,10
29042449581,29042449582,1,1232,2078,10
29043809062,29043809062,0,1210,1736,10
29046424450,29046424451,1,1328,1701,10
29049662500,29049662502,2,812,1062,10
29052187243,29052187241,-2,939,1772,10
29055306167,29055306167,0,1226,2112,10
29055794173,29055794174,1,1661,1456,10
29057014938,29057014937,-1,1427,2081,10
29057335170,29057335187,17,276,892,10
29063731726,29063731726,0,1617,1521,10
29064992362,29064992361,-1,1308,2004,10
29068574019,29068574019,0,1104,1952,10
29073679277,29073679274,-3,839,2100,10
29076453645,29076453644,-1,1719,2598,10
29080495110,29080495108,-2,890,1693,10
29081888254,29081888249,-5,1522,6400,10
29084807376,29084807374,-2,1437,1962,10
29085315216,29085315214,-2,1449,2138,10
29087862399,29087862397,-2,1143,1803,10
29088532930,29088532928,-2,1733,2184,10
29091902690,29091902686,-4,1115,1777,10
29092717173,29092717172,-1,1261,2515,10
29096200689,29096200689,0,1207,1426,10
29098088354,29098088351,-3,1483,1597,10
29099523605,29099523607,2,1000,1248,10
29101277059,29101277058,-1,1053,2234,10
29106131926,29106131924,-2,1618,2137,10
29108410334,29108410334,0,1136,1688,10
29109698892,29109698889,-3,1547,2558,10
29109781351,29109781349,-2,705,1362,10
29118906801,29118906801,0,1192,1589,10
29121890387,29121890387,0,1366,1870,10
29123589747,29123589745,-2,1194,2800,10
29125823712,29125823711,-1,1424,2901,10
29128996154,29128996159,5,5045,3072,10
29135688632,29135688630,-2,1258,2196,10
29142065610,29142065604,-6,752,2106,10
29143024437,29143024436,-1,1137,2165,10
29152091266,29152091266,0,807,958,10
29156678072,29156678071,-1,1499,2303,10
29160900158,29160900157,-1,1349,2504,10
29166159344,29166159345,1,1135,2202,10
29168990716,29168990713,-3,1782,2412,10
29172792661,29172792660,-1,1416,2228,10
29174691426,29174691422,-4,1083,2190,10
29175594930,29175594927,-3,1740,3341,10
29176109554,29176109558,4,4776,2762,10
29176897190,29176897187,-3,1138,1546,10
29177084026,29177084019,-7,1107,734,10
29182136846,29182136853,7,2199,1212,10
29187843162,29187843159,-3,1331,1963,10
29191155734,29191155736,2,1622,1115,10
29192363761,29192363759,-2,1477,2617,10
29192467661,29192467661,0,1365,1965,10
29192531645,29192531642,-3,1377,2064,10
29193469658,29193469657,-1,1564,1707,10
29195397834,29195397834,0,738,1040,10
29198186225,29198186224,-1,1556,1654,10
29198516451,29198516446,-5,908,1806,10
29198937695,29198937693,-2,1260,1872,10
29199180563,29199180562,-1,1530,1950,10
29201595569,29201595569,0,1732,3193,10
29202681030,29202681029,-1,1214,2048,10
29205107490,29205107490,0,1288,1852,10
29205169268,29205169266,-2,1592,2513,10
29206535886,29206535868,-18,1146,1239,10
29206840052,29206840053,1,1511,2313,10
29207195142,29207195144,2,1433,1533,10
29217647792,29217647792,0,1373,2321,10
29220287166,29220287160,-6,981,3800,10
29221018271,29221018270,-1,1572,2135,10
29224397495,29224397502,7,6440,2435,10
29231257923,29231257922,-1,1070,1260,10
29231720153,29231720154,1,1412,1718,10
29233341423,29233341423,0,1082,1464,10
29235595648,29235595649,1,1489,1298,10
29241893597,29241893602,5,1011,1155,10
29242816139,29242816137,-2,1194,2310,10
29246304428,29246304428,0,1482,2557,10
29246681854,29246681852,-2,1390,2502,10
29248353025,29248353025,0,1139,1630,10
29250019264,29250019262,-2,1105,1346,10
29250325746,29250325730,-16,1098,1824,10
29254777156,29254777153,-3,1101,1627,10
29257549688,29257549686,-2,1373,2671,10
29257890450,29257890445,-5,1373,2325,10
29258242313,29258242312,-1,1211,1605,10
29258984325,29258984320,-5,1400,2518,10
29264106167,29264106165,-2,1055,1487,10
29265337185,29265337184,-1,859,1671,10
29269709986,29269709990,4,2414,1689,10
29269837126,29269837126,0,810,1807,10
29270960303,29270960301,-2,1182,1476,10
29274087371,29274087370,-1,2124,3268,10
29274221218,29274221218,0,922,1832,10
29274750181,29274750181,0,1501,2057,10
29276599575,29276599572,-3,1068,1458,10
29277386019,29277386018,-1,928,1702,10
29278421387,29278421387,0,1009,1651,10
29279715415,29279715414,-1,1138,1540,10
29280207580,29280207599,19,1073,2148,10
29284038587,29284038585,-2,1135,1642,10
29284138418,29284138415,-3,946,1558,10
29284412727,29284412723,-4,890,1390,10
29285442098,29285442095,-3,957,1480,10
29286331961,29286331958,-3,735,1275,10
29291211678,29291211677,-1,1041,2521,10
29291515874,29291515894,20,604,1068,10
29292281832,29292281832,0,1270,1414,10
29294139209,29294139209,0,924,1262,10
29299927206,29299927205,-1,707,2563,10
29301431942,29301431940,-2,1342,2948,10
29303237869,29303237867,-2,1295,2094,10
29309825979,29309825979,0,1321,2212,10
29310941966,29310941971,5,2703,1770,10
29315331509,29315331513,4,1947,1389,10
29321571210,29321571210,0,1299,2765,10
29321638458,29321638454,-4,1520,2090,10
29327468950,29327468949,-1,1363,1639,10
29328430059,29328430054,-5,1231,2459,10
29328757329,29328757327,-2,1141,1874,10
29328787018,29328787002,-16,1058,1851,10
29331011926,29331011922,-4,1129,1233,10
29332229324,29332229324,0,1094,2084,10
29333206206,29333206206,0,1617,2310,10
29333453039,29333453037,-2,1384,1861,10
29341506604,29341506605,1,1389,1283,10
29343646602,29343646602,0,1160,1475,10
29347501131,29347501123,-8,1441,2400,10
29349617174,29349617172,-2,1565,2418,10
29350608882,29350608865,-17,1135,1951,10
29352528160,29352528161,1,1197,2161,10
29355181151,29355181149,-2,1251,2337,10
29355368726,29355368729,3,691,1748,10
29363984405,29363984405,0,1197,1435,10
29368703869,29368703867,-2,1588,2337,10
29369557419,29369557419,0,1551,1568,10
29370238520,29370238519,-1,884,1660,10
29371076405,29371076402,-3,1667,2687,10
29371527870,29371527869,-1,925,2327,10
29372894821,29372894815,-6,1668,2898,10
29375310685,29375310684,-1,1754,1872,10
29375552323,29375552322,-1,1180,1964,10
29377326236,29377326235,-1,1148,2038,10
29380538533,29380538534,1,1333,1712,10
29383463038,29383463034,-4,1055,1207,10
29385858155,29385858159,4,2605,1621,10
29388239981,29388239979,-2,1804,2294,10
29388856458,29388856458,0,1502,1878,10
29392930930,29392930928,-2,1706,1816,10
29393407627,29393407626,-1,1281,1964,10
29393686682,29393686679,-3,1498,2236,10
29396025475,29396025475,0,1208,2067,10
29400689158,29400689159,1,1185,2380,10
29401759734,29401759734,0,1252,2419,10
29401988535,29401988534,-1,1228,1574,10
29402689592,29402689591,-1,23347,3575,10
29403757481,29403757480,-1,1119,1886,10
29406468257,29406468254,-3,646,953,10
29407144825,29407144823,-2,962,1652,10
29408089120,29408089123,3,1861,1117,10
29410657547,29410657544,-3,1265,2658,10
29415303662,29415303659,-3,1635,2244,10
29415959154,29415959154,0,1618,1409,10
29415990107,29415990103,-4,1159,2600,10
29418596501,29418596500,-1,1077,1864,10
29425307998,29425307998,0,1137,1707,10
29429540038,29429540035,-3,1321,2006,10
29433894678,29433894675,-3,888,2295,10
29436730729,29436730730,1,1257,1794,10
29439689358,29439689358,0,1519,2655,10
29441770345,29441770345,0,1215,1320,10
29444406097,29444406096,-1,962,1872,10
29445096238,29445096237,-1,1539,2788,10
29445710527,29445710526,-1,1597,2115,10
29446395573,29446395573,0,849,1732,10
29448193932,29448193930,-2,1179,2144,10
29450314036,29450314038,2,1253,1170,10
29458091382,29458091381,-1,938,2032,10
29458984311,29458984310,-1,1384,2589,10
29462761099,29462761100,1,1372,1643,10
29463231862,29463231866,4,1178,411,10
29464643785,29464643783,-2,1709,2401,10
29469746152,29469746152,0,1429,2046,10
29474816587,29474816586,-1,1180,1972,10
29474855009,29474855008,-1,1449,1739,10
29475764711,29475764710,-1,1689,2776,10
29476218988,29476218989,1,1445,1589,10
29478691986,29478691985,-1,930,1265,10
29479076496,29479076494,-2,1189,2270,10
29480107425,29480107422,-3,1450,2390,10
29484958470,29484958466,-4,970,2185,10
29485266774,29485266773,-1,1382,2133,10
29486537043,29486537050,7,5358,2926,10
29495030100,29495030098,-2,1255,1611,10
29495588318,29495588317,-1,841,1483,10
29498856619,29498856618,-1,1142,1561,10
29498901848,29498901847,-1,1529,1854,10
29502132436,29502132449,13,1271,1255,10
29503465089,29503465087,-2,1640,1903,10
29507905574,29507905572,-2,1171,2074,10
29508145529,29508145529,0,1581,1888,10
29513155503,29513155500,-3,1059,1936,10
29515286299,29515286293,-6,1445,3287,10
29515719958,29515719957,-1,1160,2291,10
29517781870,29517781869,-1,1561,2033,10
29519951732,29519951730,-2,1837,3322,10
29523417666,29523417665,-1,1994,2013,10
29523959450,29523959453,3,2915,2068,10
29524911774,29524911782,8,6806,1414,10
29526025670,29526025669,-1,1191,2087,10
29529234162,29529234160,-2,974,2191,10
29534235422,29534235420,-2,1301,1638,10
29537173114,29537173111,-3,1249,2596,10
29542553710,29542553711,1,1446,1940,10
29546815042,29546815041,-1,1191,2123,10
29548002440,29548002438,-2,1260,2089,10
29548269592,29548269590,-2,961,1262,10
29548651827,29548651826,-1,1039,1777,10
29549879335,29549879340,5,4641,2788,10
29551013518,29551013519,1,1920,1218,10
29551132097,29551132095,-2,1178,1631,10
29561784835,29561784834,-1,1086,2049,10
29566405206,29566405206,0,1285,2063,10
29571326391,29571326388,-3,1459,1542,10
29583923659,29583923657,-2,883,1552,10
29585343242,29585343242,0,1149,1248,10
29587200348,29587200354,6,4518,1543,10
29597003809,29597003809,0,1243,1487,10
29597747984,29597747980,-4,1279,2063,10
29598423126,29598423125,-1,1131,2041,10
29606242282,29606242282,0,1096,1672,10
29609445003,29609445001,-2,815,2096,10
29610560482,29610560488,6,2828,1263,10
29611952186,29611952186,0,1106,1988,10
29615537105,29615537104,-1,1127,1710,10
29618231246,29618231245,-1,1296,1879,10
29619161130,29619161129,-1,722,1223,10
29622551196,29622551194,-2,1490,2031,10
29634365753,29634365752,-1,1718,2161,10
29638714226,29638714223,-3,1147,2119,10
29641391923,29641391923,0,1054,2134,10
29646633421,29646633426,5,2072,1211,10
29647065023,29647065024,1,1210,1826,10
29650853352,29650853354,2,1550,1226,10
29652750220,29652750218,-2,1380,1506,10
29657128082,29657128085,3,1695,855,10
29660723442,29660723442,0,910,1298,10
29661969249,29661969247,-2,1055,2297,10
29668472443,29668472443,0,1352,1697,10
29671218830,29671218826,-4,948,2505,10
29672974762,29672974760,-2,923,1862,10
29674098282,29674098284,2,3239,2982,10
29674404274,29674404275,1,1434,1825,10
29674815413,29674815410,-3,1475,2560,10
29675531480,29675531479,-1,1373,1732,10
29677285069,29677285068,-1,1211,1869,10
29678738662,29678738660,-2,1578,2203,10
29678930002,29678929999,-3,1423,3621,10
29683919933,29683919933,0,1454,1672,10
29687328072,29687328072,0,1410,1460,10
29688233079,29688233079,0,1503,2089,10
29689787904,29689787914,10,24876,52302,10
29695024411,29695024408,-3,1218,2195,10
29695533766,29695533765,-1,1113,2182,10
29696527149,29696527149,0,1431,1981,10
29697675670,29697675674,4,1314,843,10
29699092152,29699092150,-2,1309,2688,10
29699381178,29699381178,0,795,1034,10
29703720305,29703720306,1,1103,1488,10
29712810255,29712810258,3,1720,979,10
29716690589,29716690590,1,2752,2995,10
29718830151,29718830148,-3,997,1470,10
29725041712,29725041706,-6,906,1757,10
29727330646,29727330645,-1,1784,2982,10
29728258309,29728258312,3,15648,12301,10
29728785120,29728785120,0,1209,2231,10
29730207434,29730207438,4,1693,1695,10
29733188973,29733188978,5,3925,1507,10
29737763448,29737763446,-2,1148,1414,10
29740400339,29740400338,-1,1685,2360,10
29742066386,29742066386,0,1912,2021,10
29742375559,29742375559,0,1912,2444,10
29743886345,29743886342,-3,1324,1791,10
29745064253,29745064258,5,6498,29463,10
29751937747,29751937746,-1,1541,2527,10
29752653769,29752653767,-2,1101,2052,10
29753583329,29753583326,-3,1765,2283,10
29753863429,29753863429,0,1068,2027,10
29756882911,29756882915,4,1083,954,10
29758854029,29758854026,-3,1235,1421,10
29762878543,29762878545,2,4551,22243,10
29766694515,29766694515,0,2474,2924,10
29768619079,29768619078,-1,1139,2191,10
29771396322,29771396320,-2,773,2187,10
29774364065,29774364061,-4,1221,2805,10
29774906814,29774906819,5,7118,3579,10
29778096353,29778096350,-3,1393,2018,10
29778920326,29778920325,-1,1920,2622,10
29779674094,29779674091,-3,1484,2435,10
29780807430,29780807427,-3,1433,1983,10
29782056511,29782056507,-4,955,1874,10
29783050315,29783050314,-1,1366,2855,10
29792775182,29792775181,-1,1164,2833,10
29794707709,29794707710,1,1358,1478,10
29801602722,29801602728,6,3528,1888,10
29801652130,29801652125,-5,1102,3461,10
29815687708,29815687706,-2,1019,2157,10
29815900996,29815900985,-11,714,1421,10
29819929911,29819929913,2,899,1060,10
29820702258,29820702257,-1,1160,1720,10
29821820131,29821820130,-1,1345,2369,10
29823710155,29823710154,-1,935,1474,10
29823768500,29823768518,18,282,581,10
29825070153,29825070153,0,1343,2874,10
29827756181,29827756181,0,1529,1962,10
29830251507,29830251507,0,1303,1716,10
29833301505,29833301505,0,1312,1780,10
29836927079,29836927077,-2,1386,2072,10
29841806495,29841806493,-2,974,1409,10
29842751263,29842751260,-3,743,1613,10
29845943758,29845943762,4,1613,1269,10
29846231269,29846231267,-2,1843,2419,10
29850511119,29850511117,-2,1870,2434,10
29851795568,29851795589,21,1182,1819,10
29853940719,29853940714,-5,770,2163,10
29854028514,29854028514,0,1292,1945,10
29856342342,29856342340,-2,962,1744,10
29857011417,29857011425,8,3618,1277,10
29859961937,29859961934,-3,993,1976,10
29866445350,29866445348,-2,1443,1645,10
29866905701,29866905701,0,842,1699,10
29869025594,29869025590,-4,1496,2327,10
29869554769,29869554768,-1,1189,1926,10
29874295943,29874295942,-1,1389,1653,10
29875151390,29875151385,-5,1990,8421,10
29875218461,29875218461,0,1092,1631,10
29875357487,29875357490,3,1554,1384,10
29876420379,29876420373,-6,969,4292,10
29876908847,29876908845,-2,903,1762,10
29878334170,29878334170,0,1167,1983,10
29879806689,29879806688,-1,1188,2843,10
29881497427,29881497425,-2,1162,1818,10
29881885436,29881885446,10,267,806,10
29886762071,29886762073,2,1008,2047,10
29894060136,29894060137,1,1208,919,10
29897835792,29897835790,-2,1018,2006,10
29898946891,29898946890,-1,1610,1986,10
29899329580,29899329578,-2,735,2414,10
29899880014,29899880007,-7,2851,9182,10
29902615107,29902615105,-2,837,1943,10
29903868807,29903868791,-16,132,861,10
29904265298,29904265298,0,1911,2018,10
29909052660,29909052658,-2,1087,2452,10
29911802235,29911802234,-1,1194,2093,10
29914218536,29914218535,-1,1340,1864,10
29923839801,29923839799,-2,1336,2731,10
29925392359,29925392359,0,774,1668,10
29929443692,29929443691,-1,1581,1534,10
29940481025,29940481023,-2,1481,1877,10
29941909286,29941909297,11,1109,1297,10
29944254366,29944254369,3,1140,1802,10
29946534875,29946534873,-2,1215,1604,10
29946946779,29946946777,-2,1623,2365,10
29949000535,29949000532,-3,911,2009,10
29949690003,29949690000,-3,1148,1553,10
29949826132,29949826132,0,1319,1967,10
29953298523,29953298522,-1,938,2159,10
29954933109,29954933111,2,1245,1783,10
29959920351,29959920349,-2,1056,1721,10
29963256938,29963256940,2,1060,1912,10
29963853025,29963853017,-8,837,1398,10
29966379171,29966379171,0,1131,1553,10
29967816878,29967816875,-3,1102,1958,10
29971377547,29971377544,-3,698,1544,10
29975164914,29975164912,-2,1262,1790,10
29975606973,29975606970,-3,874,1951,10
29977532772,29977532774,2,1774,1870,10
29981282807,29981282809,2,5213,5299,10
29982393650,29982393650,0,1156,1325,10
29983083912,29983083930,18,989,2027,10
29983371529,29983371530,1,1283,1265,10
29983681681,29983681703,22,545,1081,10
29984177982,29984177983,1,1647,1629,10
29985659786,29985659786,0,1030,2152,10
29989774031,29989774029,-2,1014,1875,10
29994215706,29994215706,0,1406,2516,10
30000507489,30000507486,-3,2047,5969,10
30001583392,30001583389,-3,1312,2215,10
30002726011,30002726011,0,1335,2303,10
30002784791,30002784790,-1,745,1033,10
30008249273,30008249273,0,1240,1454,10
30009216835,30009216832,-3,1018,2396,10
30010723923,30010723921,-2,1575,2300,10
30012108722,30012108722,0,1555,1947,10
30012469454,30012469459,5,1463,1169,10
30012760074,30012760074,0,1169,1480,10
30015720608,30015720606,-2,1247,2384,10
30018502853,30018502853,0,1485,1808,10
30019072314,30019072293,-21,1326,869,10
30020379871,30020379869,-2,1320,1592,10
30021800635,30021800635,0,938,1454,10
30025061971,30025061967,-4,1139,3041,10
30031098049,30031098048,-1,1396,2100,10
30035953134,30035953133,-1,1145,1817,10
30037708813,30037708811,-2,1877,2660,10
30048263505,30048263500,-5,1460,2674,10
30048990867,30048990866,-1,1129,1819,10
30049277690,30049277705,15,838,2014,10
30050672434,30050672433,-1,1207,2003,10
30051131051,30051131049,-2,970,2582,10
30056274042,30056274042,0,764,1433,10
30057896230,30057896227,-3,1377,2083,10
30059134214,30059134214,0,2585,3391,10
30062900159,30062900158,-1,1207,1770,10
30072897905,30072897904,-1,1390,1944,10
30079007169,30079007168,-1,1835,1670,10
30089256856,30089256854,-2,2844,4467,10
30089831766,30089831765,-1,1112,2433,10
30091013654,30091013655,1,1023,1753,10
30094439958,30094439958,0,997,1796,10
30095633593,30095633589,-4,1539,2727,10
30096337666,30096337666,0,1236,2140,10
30101981679,30101981679,0,1371,1720,10
30102726141,30102726139,-2,1204,2694,10
30106008662,30106008662,0,1056,2123,10
30108902907,30108902904,-3,862,1617,10
30109087927,30109087925,-2,1371,2461,10
30109185710,30109185710,0,1156,1325,10
30111979338,30111979337,-1,1616,1572,10
30113763010,30113763010,0,2299,2777,10
30114703226,30114703204,-22,1183,1976,10
30115477925,30115477925,0,1385,2043,10
30117648602,30117648618,16,681,1533,10
30117947006,30117947009,3,1483,698,10
30118471730,30118471726,-4,1134,2015,10
30119819093,30119819091,-2,1254,1976,10
30126227127,30126227126,-1,1685,2173,10
30133349287,30133349289,2,1221,1811,10
30135026070,30135026069,-1,993,2111,10
30136108698,30136108696,-2,1160,1542,10
30142418513,30142418509,-4,1202,2111,10
30142718961,30142718960,-1,1026,1744,10
30143499586,30143499585,-1,1249,1914,10
30146112289,30146112289,0,956,1262,10
30149792033,30149792031,-2,927,1969,10
30152405390,30152405396,6,1190,1752,10
30153676995,30153676992,-3,1538,2892,10
30163603779,30163603778,-1,972,1831,10
30166576521,30166576519,-2,1258,2032,10
30166631172,30166631184,12,369,1055,10
30171150582,30171150582,0,1340,1931,10
30174682163,30174682161,-2,865,2584,10
30176037953,30176037959,6,4888,2419,10
30178937473,30178937474,1,1253,1256,10
30179716502,30179716501,-1,1091,1831,10
30182541518,30182541516,-2,908,1681,10
30185189247,30185189246,-1,854,1387,10
30188715058,30188715056,-2,1262,1671,10
30189331353,30189331351,-2,1303,1518,10
30191019247,30191019254,7,2547,882,10
30192259744,30192259741,-3,1102,957,10
30193627077,30193627075,-2,1056,1863,10
30194447430,30194447426,-4,1105,1909,10
30198058516,30198058521,5,1871,1506,10
30199284457,30199284455,-2,728,1290,10
30200270051,30200270050,-1,1076,2176,10
30200453522,30200453521,-1,1340,1682,10
30201891294,30201891289,-5,1819,5560,10
30203299994,30203299993,-1,1756,1425,10
30203611175,30203611155,-20,2183,1030,10
30206108468,30206108466,-2,1287,2227,10
30209273842,30209273841,-1,757,1267,10
30211280228,30211280226,-2,1243,2342,10
30215706775,30215706771,-4,2244,6072,10
30216637886,30216637886,0,1461,1615,10
30216902057,30216902056,-1,1065,2562,10
30219120023,30219120022,-1,1587,2908,10
30220435582,30220435580,-2,1277,2011,10
30221164956,30221164955,-1,1534,2081,10
30222256380,30222256380,0,1517,2249,10
30225389428,30225389428,0,2074,3042,10
30234650351,30234650347,-4,1112,2112,10
30242093473,30242093483,10,10909,35163,10
30242871334,30242871336,2,988,1644,10
30247663503,30247663520,17,1184,1579,10
30249813662,30249813660,-2,1338,1788,10
30251201992,30251201998,6,24317,26679,10
30252782931,30252782930,-1,1035,2042,10
30252999870,30252999870,0,1711,2239,10
30253603203,30253603201,-2,978,1858,10
30254620199,30254620196,-3,946,1976,10
30257778266,30257778272,6,2271,972,10
30257895335,30257895335,0,1245,2341,10
30261946626,30261946623,-3,1176,2008,10
30263765018,30263765012,-6,1317,3460,10
30265383215,30265383213,-2,1607,2396,10
30267392222,30267392219,-3,1119,1333,10
30271954191,30271954194,3,2044,1626,10
30272092732,30272092730,-2,1282,1736,10
30278231378,30278231393,15,1089,1282,10
30290247114,30290247112,-2,863,1661,10
30292297388,30292297386,-2,1165,2033,10
30293197304,30293197302,-2,1307,2189,10
30295328357,30295328354,-3,1347,2674,10
30295783224,30295783225,1,1840,1851,10
30296123607,30296123601,-6,901,3051,10
30298716485,30298716486,1,986,2002,10
30311175582,30311175582,0,1243,1553,10
30315384827,30315384826,-1,967,2418,10
30315733565,30315733566,1,1329,1448,10
30316717455,30316717454,-1,851,1590,10
30319552309,30319552306,-3,1100,1585,10
30327408893,30327408890,-3,1184,1378,10
30328543739,30328543735,-4,1433,1831,10
30328642798,30328642798,0,1165,2189,10
30330127462,30330127460,-2,1032,1933,10
30330556942,30330556941,-1,691,2048,10
30331739204,30331739202,-2,1392,2035,10
30333667708,30333667707,-1,1249,1924,10
30343392494,30343392493,-1,818,1418,10
30348993838,30348993841,3,5306,21961,10
30349177519,30349177518,-1,1219,1876,10
30356613830,30356613830,0,1342,2014,10
30359495160,30359495158,-2,1022,2216,10
30364123358,30364123359,1,1218,2226,10
30369532360,30369532361,1,1194,1287,10
30370312994,30370312992,-2,886,1491,10
30373065256,30373065254,-2,1483,2232,10
30374490926,30374490924,-2,1395,1632,10
30386669982,30386669981,-1,1581,2594,10
30386830674,30386830673,-1,1595,1729,10
30393342312,30393342309,-3,1245,2044,10
30393927259,30393927258,-1,1219,2536,10
30397436257,30397436256,-1,1230,1986,10
30398010699,30398010697,-2,1176,2221,10
30403454687,30403454683,-4,783,1889,10
30405734815,30405734816,1,1637,2202,10
30407502399,30407502398,-1,1054,1340,10
30410696682,30410696685,3,23148,27371,10
30414536456,30414536454,-2,1328,2202,10
30415375163,30415375157,-6,850,3264,10
30416114299,30416114298,-1,1078,1347,10
30416256977,30416256997,20,742,1333,10
30420356421,30420356420,-1,1105,1993,10
30420961563,30420961562,-1,1796,3055,10
30422825159,30422825157,-2,1074,2119,10
30427172495,30427172492,-3,1483,2231,10
30427511414,30427511415,1,1679,2109,10
30428427134,30428427132,-2,1393,1976,10
30430379822,30430379836,14,2014,1438,10
30431764507,30431764507,0,1422,1835,10
30434243238,30434243240,2,2304,1734,10
30435651366,30435651361,-5,745,1147,10
30436642823,30436642822,-1,1863,2679,10
30443600562,30443600558,-4,1294,3028,10
30447036289,30447036287,-2,954,1808,10
30447178136,30447178134,-2,1551,2013,10
30448072323,30448072323,0,1364,2290,10
30449903858,30449903857,-1,1248,2401,10
30451119146,30451119166,20,355,829,10
30454995806,30454995804,-2,1257,2026,10
30458398026,30458398030,4,1163,1496,10
30460041758,30460041756,-2,1568,2329,10
30461381467,30461381466,-1,997,1914,10
30462257694,30462257690,-4,1459,2553,10
30466226642,30466226639,-3,1000,2090,10
30468302094,30468302093,-1,1610,2726,10
30473076894,30473076893,-1,1500,2549,10
30475500511,30475500510,-1,1481,2150,10
30479177664,30479177663,-1,1435,2588,10
30482379111,30482379110,-1,1060,2006,10
30485930198,30485930197,-1,1169,1610,10
30486267085,30486267086,1,1332,1379,10
30489444642,30489444640,-2,1394,2996,10
30490784286,30490784287,1,1131,1823,10
30491975573,30491975575,2,1095,1354,10
30493912246,30493912247,1,1359,1725,10
30495388775,30495388774,-1,1237,2010,10
30495784954,30495784959,5,1767,980,10
30496900040,30496900041,1,1353,2243,10
30500287069,30500287067,-2,1629,2373,10
30502476957,30502476955,-2,1694,3078,10
30508140049,30508140048,-1,1543,2861,10
30508422586,30508422583,-3,978,2137,10
30513843366,30513843365,-1,654,2147,10
30515742257,30515742254,-3,732,2880,10
30523778645,30523778645,0,1217,1025,10
30525557761,30525557758,-3,1383,1763,10
30526816439,30526816437,-2,1328,2030,10
30530244453,30530244450,-3,1118,2102,10
30535058934,30535058934,0,1199,2187,10
30535752414,30535752413,-1,1394,2091,10
30537280118,30537280115,-3,901,1953,10
30540742631,30540742630,-1,1228,1451,10
30541658611,30541658606,-5,943,2729,10
30541748710,30541748714,4,25893,33758,10
30543680110,30543680129,19,851,1875,10
30545597003,30545597002,-1,1215,1541,10
30545980340,30545980339,-1,1375,2218,10
30549565198,30549565198,0,1061,1261,10
30553903482,30553903480,-2,816,1636,10
30556102989,30556102989,0,1135,1330,10
30556368058,30556368058,0,1104,1947,10
30556430867,30556430853,-14,262,911,10
30560231566,30560231565,-1,1420,1717,10
30560724303,30560724302,-1,1102,1503,10
30562343722,30562343722,0,1258,2135,10
30563439427,30563439426,-1,1322,1601,10
30564122567,30564122566,-1,985,1713,10
30566109075,30566109078,3,1717,1796,10
30570277493,30570277490,-3,1226,1686,10
30572184566,30572184561,-5,1029,3528,10
30575263777,30575263778,1,1058,2205,10
30578731054,30578731051,-3,862,1234,10
30579633672,30579633669,-3,891,2293,10
30583749707,30583749715,8,2374,1044,10
30587935187,30587935185,-2,2185,4734,10
30590025635,30590025633,-2,1034,1144,10
30594529143,30594529144,1,1615,2745,10
30594795473,30594795464,-9,1376,1665,10
30599182592,30599182593,1,1249,1626,10
30600905586,30600905586,0,1241,1939,10
30603661051,30603661050,-1,850,1452,10
30604986569,30604986568,-1,681,1447,10
30608599323,30608599322,-1,1604,1962,10
30611496827,30611496826,-1,1543,2235,10
30612695922,30612695918,-4,1143,2595,10
30614133438,30614133433,-5,2056,6834,10
30616648742,30616648738,-4,1336,1851,10
30618853755,30618853752,-3,2003,4503,10
30620288904,30620288898,-6,1221,4828,10
30620953474,30620953473,-1,1190,1508,10
30622107061,30622107059,-2,1499,1694,10
30626203710,30626203711,1,1301,1685,10
30628336186,30628336185,-1,1636,1325,10
30629428706,30629428704,-2,1270,1949,10
30631690159,30631690158,-1,1153,2656,10
30632677797,30632677797,0,1052,2221,10
30634366226,30634366229,3,1691,1570,10
30635935954,30635935951,-3,1037,2586,10
30643234532,30643234530,-2,1545,2565,10
30644113314,30644113314,0,1648,2684,10
30647598816,30647598819,3,961,1245,10
30649214289,30649214289,0,1723,2177,10
30655154963,30655154962,-1,1120,2046,10
30660196526,30660196526,0,989,2185,10
30662342161,30662342175,14,12819,46614,10
30662747748,30662747730,-18,898,496,10
30664805469,30664805467,-2,1357,2419,10
30667682752,30667682749,-3,1020,1688,10
30675758794,30675758813,19,381,1181,10
30680339259,30680339258,-1,1373,1784,10
30687626406,30687626407,1,2890,3472,10
30691479111,30691479113,2,720,1184,10
30692716504,30692716490,-14,311,598,10
30701997850,30701997849,-1,1154,1600,10
30702544378,30702544378,0,1467,2079,10
30705433291,30705433290,-1,1370,2582,10
30711495143,30711495143,0,583,1692,10
30712440538,30712440537,-1,1340,2024,10
30712664474,30712664471,-3,1150,2179,10
30713381104,30713381103,-1,1028,1806,10
30714945783,30714945782,-1,1050,2469,10
30717185694,30717185694,0,1089,1796,10
30717428643,30717428643,0,1555,2551,10
30718477715,30718477709,-6,1051,5489,10
30721549501,30721549500,-1,1194,1545,10
30725203622,30725203621,-1,1409,1853,10
30726778595,30726778595,0,1338,1287,10
30727336095,30727336093,-2,811,1647,10
30730769781,30730769779,-2,1588,2258,10
30731452557,30731452556,-1,1458,2318,10
30734764393,30734764391,-2,1539,1641,10
30738348671,30738348670,-1,1422,1831,10
30740067757,30740067754,-3,1223,2033,10
30741485931,30741485931,0,1503,2021,10
30743240430,30743240430,0,940,1200,10
30745709262,30745709261,-1,1324,1651,10
30747337184,30747337183,-1,899,1764,10
30747888395,30747888379,-16,1056,2255,10
30748320554,30748320553,-1,1451,1996,10
30757341194,30757341192,-2,1256,2039,10
30758604486,30758604487,1,870,967,10
30765230883,30765230881,-2,1251,1665,10
30765591103,30765591100,-3,1056,1300,10
30766011146,30766011147,1,831,1510,10
30766086642,30766086640,-2,897,2242,10
30768034628,30768034625,-3,912,1707,10
30769027660,30769027659,-1,1341,2358,10
30772525417,30772525416,-1,1080,2139,10
30773018015,30773018012,-3,1624,2921,10
30774614550,30774614547,-3,1890,2720,10
30779283035,30779283030,-5,1185,2408,10
30779655466,30779655468,2,1508,903,10
30784156070,30784156069,-1,1346,2743,10
30786058820,30786058819,-1,1920,2693,10
30787692251,30787692250,-1,884,1346,10
30798653419,30798653418,-1,1257,1972,10
30801181106,30801181105,-1,1457,2232,10
30809915518,30809915514,-4,1298,2809,10
30811593057,30811593055,-2,954,1484,10
30813050181,30813050188,7,6699,2159,10
30814683202,30814683200,-2,1063,2129,10
30820473810,30820473810,0,1343,1731,10
30820736567,30820736565,-2,867,1918,10
30822386905,30822386906,1,765,1732,10
30822562561,30822562582,21,996,1450,10
30823952064,30823952061,-3,1773,2426,10
30824840347,30824840345,-2,1397,1802,10
30829007266,30829007263,-3,1542,3019,10
30834469159,30834469158,-1,1090,1452,10
30835319002,30835319001,-1,1100,1598,10
30836707393,30836707390,-3,1571,2922,10
30839954386,30839954385,-1,954,1351,10
30842245610,30842245609,-1,1171,1827,10
30852553376,30852553374,-2,1448,2472,10
30852587220,30852587222,2,1028,659,10
30858876010,30858876014,4,1748,1831,10
30860606210,30860606209,-1,876,2325,10
30861095799,30861095799,0,1227,1635,10
30861499397,30861499397,0,1423,1625,10
30863289998,30863289996,-2,1172,1889,10
30864647225,30864647226,1,1760,2068,10
30869154444,30869154441,-3,1173,1449,10
30869730968,30869730965,-3,1289,1585,10
30871716048,30871716047,-1,2766,3350,10
30873296362,30873296359,-3,988,1552,10
30874128827,30874128826,-1,1755,2926,10
30877638723,30877638729,6,2051,1228,10
30879059674,30879059670,-4,1241,4005,10
30880966886,30880966883,-3,1249,2202,10
30883143006,30883143005,-1,1682,2465,10
30889516304,30889516301,-3,1676,2374,10
30891613407,30891613406,-1,831,864,10
30893032838,30893032837,-1,1209,2046,10
30894379253,30894379253,0,1378,1881,10
30896417166,30896417166,0,1351,1929,10
30897976787,30897976787,0,1363,2345,10
30898635080,30898635101,21,1208,2338,10
30898782103,30898782101,-2,1378,2421,10
30901813653,30901813648,-5,967,2767,10
30902855849,30902855843,-6,1426,5230,10
30905346543,30905346542,-1,1267,2037,10
30906445645,30906445643,-2,1359,2692,10
30906493475,30906493473,-2,1231,1935,10
30907906805,30907906803,-2,990,1397,10
30908001453,30908001450,-3,1013,1941,10
30913550591,30913550590,-1,1668,2390,10
30917721142,30917721143,1,1008,2254,10
30921282621,30921282619,-2,869,1091,10
30922703910,30922703909,-1,1104,2143,10
30923054764,30923054749,-15,863,2001,10
30926408513,30926408511,-2,982,1899,10
30927425903,30927425901,-2,933,1705,10
30929271875,30929271872,-3,1096,2379,10
30935712204,30935712207,3,4134,17358,10
30943994915,30943994913,-2,1358,2426,10
30944310120,30944310119,-1,880,1288,10
30951919451,30951919449,-2,1149,1753,10
30956022643,30956022641,-2,1526,1594,10
30956522736,30956522734,-2,1532,2043,10
30956764264,30956764263,-1,1113,1565,10
30958379426,30958379428,2,1396,1491,10
30962021331,30962021333,2,2295,1324,10
30964438524,30964438526,2,1642,1498,10
30966201828,30966201826,-2,1469,2015,10
30968718061,30968718061,0,1164,1870,10
30978733429,30978733427,-2,1600,2834,10
30984675953,30984675952,-1,1061,1764,10
30985360955,30985360954,-1,636,651,10
30988399155,30988399153,-2,963,2391,10
30989478202,30989478202,0,1492,2100,10
30989994299,30989994297,-2,1216,2080,10
30990556642,30990556642,0,1075,1556,10
30993361175,30993361173,-2,1027,2260,10
30995700644,30995700642,-2,1804,2039,10
30997802566,30997802566,0,833,1333,10
30998819581,30998819578,-3,1742,2590,10
31001207137,31001207137,0,946,1391,10
31002088766,31002088766,0,1008,2408,10
31003887975,31003887974,-1,504,1540,10
31007171547,31007171545,-2,1194,1797,10
31008077299,31008077298,-1,1279,2329,10
31008257226,31008257225,-1,1498,2310,10
31010355744,31010355742,-2,1264,1992,10
31011319188,31011319182,-6,406,650,10
31013208191,31013208190,-1,1710,2702,10
31016917661,31016917659,-2,1424,2020,10
31017854632,31017854638,6,1986,814,10
31018205514,31018205506,-8,332,1065,10
31019164490,31019164490,0,1177,1539,10
31020587074,31020587077,3,2905,1878,10
31020797192,31020797199,7,3450,1089,10
31021942660,31021942663,3,2753,1737,10
31022450577,31022450578,1,1410,2310,10
31023083657,31023083653,-4,1870,5800,10
31026447219,31026447212,-7,1807,8809,10
31028139667,31028139659,-8,1372,6070,10
31031322479,31031322477,-2,1490,1696,10
31036606334,31036606333,-1,1331,1944,10
31036663213,31036663211,-2,1555,1709,10
31037326654,31037326650,-4,1557,2690,10
31043037394,31043037398,4,1425,1225,10
31044208346,31044208345,-1,1269,1941,10
31051108129,31051108129,0,1622,2567,10
31059358444,31059358455,11,11117,34877,10
31060519700,31060519697,-3,971,1865,10
31064356581,31064356580,-1,1652,2805,10
31066559388,31066559382,-6,968,2255,10
31068701941,31068701938,-3,1417,2151,10
31071160102,31071160100,-2,1107,1886,10
31072984664,31072984680,16,335,669,10
31073827229,31073827229,0,1112,1533,10
31074481097,31074481095,-2,1409,2605,10
31076552159,31076552158,-1,1528,1525,10
31081873545,31081873543,-2,1370,3155,10
31093615633,31093615633,0,2156,3273,10
31096459734,31096459732,-2,1090,1556,10
31097190422,31097190421,-1,1179,1844,10
31099649309,31099649306,-3,1166,2274,10
31104394636,31104394634,-2,1119,2013,10
31106958175,31106958174,-1,1392,1837,10
31109621432,31109621430,-2,1323,2161,10
31111470479,31111470485,6,4371,2576,10
31119527772,31119527770,-2,651,1235,10
31120738273,31120738270,-3,1406,1983,10
31121861104,31121861102,-2,1518,2240,10
31124378325,31124378325,0,1632,2226,10
31127448883,31127448879,-4,1657,2470,10
31128893455,31128893454,-1,1115,1986,10
31130517123,31130517104,-19,2261,1824,10
31132572003,31132572003,0,985,1406,10
31133496449,31133496450,1,893,946,10
31133670073,31133670072,-1,686,1982,10
31135167073,31135167065,-8,1150,1673,10
31138019842,31138019838,-4,1233,2437,10
31142017769,31142017750,-19,1243,1818,10
31149513406,31149513405,-1,1158,2232,10
31150346923,31150346922,-1,1245,1954,10
31159373793,31159373794,1,1040,2061,10
31159559646,31159559646,0,1246,1116,10
31160607008,31160607014,6,17453,18004,10
31161257975,31161257974,-1,1442,2046,10
31164660315,31164660317,2,1282,909,10
31165013474,31165013470,-4,967,3104,10
31165097643,31165097640,-3,139,3991,10
31167143130,31167143125,-5,719,2364,10
31169053450,31169053459,9,897,1412,10
31171921400,31171921398,-2,1147,2067,10
31175198469,31175198468,-1,1366,1874,10
31178332341,31178332337,-4,1121,3000,10
31181629020,31181629026,6,2899,782,10
31181831216,31181831234,18,1316,1800,10
31183869415,31183869412,-3,1544,2371,10
31184918449,31184918448,-1,801,1767,10
31185418977,31185418977,0,1261,1906,10
31185860984,31185860982,-2,1403,1807,10
31186186738,31186186736,-2,1152,2187,10
31186324478,31186324476,-2,1093,1743,10
31187581852,31187581846,-6,1741,5548,10
31190840317,31190840310,-7,4645,371,10
31191792900,31191792897,-3,1668,4047,10
31192484767,31192484761,-6,2360,7557,10
31193440235,31193440232,-3,1490,2323,10
31193837892,31193837906,14,451,1111,10
31197776358,31197776355,-3,1114,1544,10
31200559952,31200559956,4,849,1517,10
31210834802,31210834799,-3,1470,1637,10
31211526151,31211526151,0,1285,1627,10
31211596655,31211596653,-2,1019,1152,10
31211912676,31211912658,-18,1098,92,10
31212569679,31212569678,-1,1035,1518,10
31213433135,31213433135,0,822,1402,10
31221738777,31221738777,0,1164,1800,10
31222438121,31222438118,-3,1197,2115,10
31227569006,31227569004,-2,1075,1914,10
31231940447,31231940445,-2,1219,1816,10
31237125537,31237125535,-2,959,1716,10
31241493571,31241493569,-2,1337,1462,10
31243097115,31243097115,0,1713,1927,10
31243814083,31243814083,0,1124,1881,10
31244012061,31244012060,-1,1701,1920,10
31254192410,31254192414,4,1760,882,10
31254807681,31254807680,-1,1415,1982,10
31260664318,31260664318,0,1145,1396,10
31260978230,31260978229,-1,883,1600,10
31263305602,31263305600,-2,1006,1967,10
31267069005,31267069001,-4,573,1847,10
31271163333,31271163332,-1,1286,1733,10
31273730198,31273730196,-2,1123,2063,10
31274541282,31274541284,2,2249,1372,10
31278266154,31278266158,4,1594,1021,10
31279670143,31279670142,-1,961,1457,10
31282235007,31282235006,-1,1351,1646,10
31282393773,31282393772,-1,802,1914,10
31290272067,31290272063,-4,757,2001,10
31294234862,31294234864,2,8623,9519,10
31295818696,31295818718,22,1184,1519,10
31301443647,31301443646,-1,843,1468,10
31301581377,31301581370,-7,1092,1517,10
31305944354,31305944351,-3,1024,1708,10
31308472879,31308472876,-3,1736,2221,10
31309832991,31309832987,-4,885,1728,10
31311740389,31311740389,0,1168,2287,10
31315775909,31315775907,-2,1696,2019,10
31316369528,31316369528,0,964,1990,10
31322031431,31322031429,-2,951,2374,10
31327183613,31327183611,-2,1041,1309,10
31331736154,31331736157,3,2641,2524,10
31331959421,31331959419,-2,1359,2467,10
31332491643,31332491641,-2,1538,2241,10
31333514139,31333514137,-2,984,1726,10
31337440529,31337440528,-1,2033,2806,10
31337862671,31337862670,-1,1231,1486,10
31340286899,31340286897,-2,1273,2112,10
31340474169,31340474168,-1,1019,2087,10
31340597566,31340597565,-1,1047,1849,10
31343149663,31343149660,-3,1253,1847,10
31343310787,31343310786,-1,1471,2584,10
31345815664,31345815661,-3,715,1581,10
31347767459,31347767459,0,2627,2190,10
31350578926,31350578930,4,1846,1068,10
31350722662,31350722665,3,1182,1743,10
31356711421,31356711418,-3,1456,2221,10
31358679899,31358679893,-6,975,2599,10
31358871235,31358871234,-1,955,1967,10
31359694266,31359694260,-6,1698,1510,10
31365450975,31365450973,-2,751,1323,10
31367797983,31367797982,-1,1303,2133,10
31368600956,31368600953,-3,1080,2602,10
31369308554,31369308549,-5,1402,4221,10
31375442206,31375442204,-2,1035,2191,10
31381198833,31381198834,1,2070,1788,10
31382786246,31382786243,-3,1299,2807,10
31383794874,31383794874,0,1100,1518,10
31385044468,31385044467,-1,1176,1525,10
31391978098,31391978098,0,1177,1368,10
31393453645,31393453642,-3,1038,1585,10
31400310086,31400310086,0,1300,2085,10
31404389348,31404389342,-6,1098,3734,10
31407610978,31407610977,-1,1012,1874,10
31409634561,31409634559,-2,1319,1716,10
31416759899,31416759898,-1,1195,1416,10
31423741420,31423741416,-4,2446,8016,10
31423773799,31423773798,-1,874,1249,10
31426961386,31426961385,-1,1661,1687,10
31431836918,31431836916,-2,1323,1906,10
31432707474,31432707474,0,1144,2323,10
31439967029,31439967026,-3,1070,2072,10
31442005261,31442005260,-1,887,1895,10
31451206055,31451206051,-4,1147,2296,10
31452962227,31452962225,-2,911,1098,10
31458145301,31458145301,0,1089,1162,10
31459630582,31459630581,-1,1192,1329,10
31459977483,31459977496,13,706,1556,10
31461055942,31461055938,-4,1436,2758,10
31465404169,31465404168,-1,1312,1635,10
31467128636,31467128626,-10,760,1909,10
31467891906,31467891904,-2,1172,1875,10
31471787618,31471787617,-1,1585,2622,10
31472279378,31472279385,7,3383,1421,10
31473483770,31473483774,4,28846,115119,10
31473642623,31473642617,-6,1385,4264,10
31475933291,31475933290,-1,1075,1803,10
31479215456,31479215457,1,1079,1212,10
31479798259,31479798257,-2,1274,2235,10
31481619123,31481619122,-1,1584,2102,10
31485455091,31485455082,-9,641,2117,10
31485792315,31485792307,-8,267,888,10
31486777379,31486777378,-1,1364,2703,10
31487737019,31487737020,1,1123,1659,10
31492001931,31492001929,-2,1232,2063,10
31493201831,31493201827,-4,1209,2032,10
31494558962,31494558961,-1,690,1494,10
31497762835,31497762834,-1,915,1671,10
31498714953,31498714950,-3,1213,1927,10
31499237240,31499237234,-6,674,1818,10
31499911948,31499911945,-3,1284,2007,10
31505790053,31505790052,-1,1406,2648,10
31508685613,31508685611,-2,907,1857,10
31510858459,31510858459,0,741,1427,10
31513091923,31513091924,1,1326,974,10
31513530587,31513530582,-5,1182,2278,10
31513778769,31513778758,-11,1664,2677,10
31517268519,31517268519,0,942,2086,10
31518925970,31518925970,0,1368,1861,10
31519691346,31519691345,-1,965,1904,10
31523408497,31523408503,6,8239,33595,10
31523531355,31523531374,19,1689,2216,10
31524538762,31524538764,2,2110,2289,10
31527942488,31527942486,-2,1078,1464,10
31530081710,31530081709,-1,1520,2579,10
31532875933,31532875929,-4,2312,4306,10
31533271671,31533271669,-2,1035,1622,10
31536605750,31536605749,-1,1293,1688,10
31541864034,31541864033,-1,981,1494,10
31543524250,31543524248,-2,1284,2260,10
31548854403,31548854402,-1,832,1492,10
31550861126,31550861131,5,1783,754,10
31557732825,31557732823,-2,1343,1964,10
31557765163,31557765163,0,847,955,10
31560071155,31560071154,-1,1182,1827,10
31564755572,31564755574,2,1280,1549,10
31565305731,31565305729,-2,919,1641,10
31567561287,31567561286,-1,1053,2185,10
31569631393,31569631390,-3,1008,1442,10
31570070441,31570070437,-4,1025,2616,10
31571474420,31571474420,0,1964,1770,10
31575093142,31575093141,-1,1394,1120,10
31575695047,31575695055,8,749,1719,10
31579312937,31579312951,14,395,1034,10
31580082463,31580082462,-1,1126,2135,10
31587197974,31587197973,-1,1305,1494,10
31596402564,31596402561,-3,1221,2021,10
31597699714,31597699708,-6,1441,3461,10
31598430347,31598430342,-5,771,1916,10
31600411320,31600411319,-1,1372,2302,10
31601686370,31601686388,18,957,1424,10
31605781285,31605781285,0,1296,1992,10
31612643477,31612643474,-3,1889,2163,10
31618379450,31618379448,-2,1118,2189,10
31618926096,31618926104,8,11909,21912,10
31619672829,31619672823,-6,1490,2655,10
31621287854,31621287852,-2,1568,2101,10
31621646816,31621646811,-5,1488,2358,10
31622144484,31622144484,0,1055,1327,10
31623744078,31623744077,-1,281,812,10
31625507110,31625507108,-2,704,1919,10
31627675753,31627675751,-2,1119,2021,10
31628131297,31628131288,-9,1007,1927,10
31628500591,31628500589,-2,1628,1511,10
31628908731,31628908730,-1,1593,3410,10
31629508893,31629508890,-3,917,1958,10
31630804078,31630804079,1,590,1449,10
31631861525,31631861523,-2,1264,2374,10
31636359233,31636359234,1,1282,1895,10
31637964594,31637964602,8,4317,1487,10
31641262214,31641262211,-3,986,1321,10
31646066529,31646066525,-4,1255,1757,10
31654568781,31654568779,-2,1116,2247,10
31663841043,31663841043,0,825,1520,10
31665270717,31665270714,-3,1315,2796,10
31674038119,31674038139,20,777,783,10
31674394427,31674394422,-5,959,1674,10
31674589825,31674589824,-1,1474,1960,10
31675814521,31675814538,17,761,1669,10
31677173817,31677173800,-17,1281,1881,10
31677966179,31677966178,-1,952,2176,10
31679492446,31679492443,-3,1335,1998,10
31688314166,31688314167,1,924,1772,10
31693441985,31693441988,3,1771,1393,10
31693677544,31693677546,2,1125,1097,10
31703470405,31703470417,12,1249,1732,10
31705970906,31705970904,-2,1129,2244,10
31709407186,31709407185,-1,821,1941,10
31709540310,31709540309,-1,1178,1426,10
31718095469,31718095470,1,1503,2165,10
31722415731,31722415729,-2,1362,2161,10
31724185230,31724185229,-1,1563,2190,10
31728698636,31728698634,-2,1686,2332,10
31729091365,31729091362,-3,1273,1813,10
31731724974,31731724975,1,1276,1771,10
31732569402,31732569401,-1,1422,1953,10
31733105056,31733105045,-11,1167,1987,10
31735374626,31735374625,-1,1285,1386,10
31736706192,31736706186,-6,1249,1415,10
31739774709,31739774706,-3,1153,1740,10
31740005467,31740005475,8,68,1278,10
31742804463,31742804466,3,1284,1721,10
31743309634,31743309633,-1,814,1370,10
31744052644,31744052641,-3,1463,2098,10
31744408682,31744408702,20,1309,1727,10
31745583362,31745583361,-1,1296,1592,10
31747709414,31747709414,0,1533,2329,10
31749555293,31749555293,0,924,2075,10
31750085476,31750085474,-2,1111,1938,10
31751716450,31751716450,0,856,1183,10
31757921354,31757921355,1,1559,2190,10
31760517594,31760517595,1,1282,1484,10
31761715122,31761715127,5,2564,946,10
31762486516,31762486513,-3,1135,2166,10
31764074330,31764074329,-1,1061,1767,10
31765061201,31765061202,1,988,1592,10
31771075699,31771075697,-2,1007,2119,10
31771203794,31771203791,-3,931,1548,10
31772037519,31772037525,6,2267,1319,10
31773482174,31773482171,-3,1817,3265,10
31773588427,31773588426,-1,803,1236,10
31774361721,31774361719,-2,1181,2593,10
31776029068,31776029064,-4,1485,2663,10
31781231619,31781231617,-2,1385,1597,10
31781952592,31781952587,-5,1290,2655,10
31782610857,31782610851,-6,1718,5701,10
31784014709,31784014709,0,1005,1090,10
31787738370,31787738370,0,1406,1893,10
31788625808,31788625806,-2,548,1180,10
31796936755,31796936736,-19,818,1482,10
31797983695,31797983695,0,1032,2207,10
31801341183,31801341180,-3,948,1364,10
31803197476,31803197474,-2,1584,2524,10
31805366519,31805366519,0,1601,2023,10
31810651155,31810651148,-7,1854,10367,10
31814071910,31814071906,-4,1267,2304,10
31821989301,31821989298,-3,1265,2957,10
31824064846,31824064844,-2,1184,1725,10
31824328786,31824328786,0,1269,2041,10
31824774771,31824774771,0,967,1657,10
31833295822,31833295821,-1,1334,2157,10
31834561563,31834561562,-1,1635,3109,10
31841083057,31841083054,-3,1059,1409,10
31842263887,31842263887,0,1460,2570,10
31845333606,31845333605,-1,1047,1705,10
31846530476,31846530482,6,7093,2141,10
31855324439,31855324438,-1,750,1365,10
31856433212,31856433209,-3,1313,2929,10
31857407187,31857407189,2,1826,2105,10
31870325025,31870325024,-1,879,1478,10
31871009023,31871009023,0,1319,1866,10
31873134111,31873134107,-4,1042,2233,10
31876836420,31876836423,3,2498,2036,10
31877071850,31877071849,-1,1028,1664,10
31880237014,31880237017,3,2175,1896,10
31882517137,31882517134,-3,1412,2064,10
31885774905,31885774904,-1,989,1396,10
31887839024,31887839011,-13,2376,1043,10
31888587906,31888587905,-1,1571,2060,10
31893720895,31893720895,0,1081,1434,10
31898800950,31898800949,-1,1201,1453,10
31899317118,31899317117,-1,1576,2572,10
31900775112,31900775110,-2,1508,1966,10
31900889990,31900889989,-1,1259,1659,10
31901972747,31901972752,5,3415,2240,10
31906972031,31906972029,-2,1346,2219,10
31908296024,31908296026,2,1791,1594,10
31911513011,31911513010,-1,970,2378,10
31922075965,31922075963,-2,1742,2916,10
31923504195,31923504192,-3,1103,1773,10
31923799489,31923799490,1,1716,1666,10
31926689802,31926689801,-1,1073,1904,10
31933108933,31933108931,-2,1311,1688,10
31934033831,31934033830,-1,1055,1638,10
31936887121,31936887118,-3,1303,1940,10
31936972826,31936972846,20,703,1186,10
31937137476,31937137476,0,1817,1984,10
31937292393,31937292390,-3,1293,2015,10
31937906713,31937906718,5,16084,9078,10
31938444635,31938444630,-5,1009,5261,10
31943455178,31943455177,-1,1679,2483,10
31945774608,31945774589,-19,39,1343,10
31949365106,31949365104,-2,1451,2496,10
31957092038,31957092034,-4,1236,3353,10
31962703720,31962703720,0,1370,2490,10
31965800093,31965800093,0,618,1233,10
31966303307,31966303306,-1,1303,2976,10
31966571502,31966571503,1,1024,2088,10
31967588644,31967588641,-3,1007,1650,10
31971418117,31971418115,-2,1117,1784,10
31973044415,31973044405,-10,39682,8558,10
31973562726,31973562722,-4,1363,1220,10
31974317025,31974317024,-1,1397,2239,10
31974360419,31974360418,-1,1154,1601,10
31974976322,31974976319,-3,1440,2544,10
31975812559,31975812559,0,1160,978,10
31976238073,31976238071,-2,1653,2148,10
31976504431,31976504431,0,1045,1976,10
31979488805,31979488803,-2,1572,2297,10
31979785272,31979785252,-20,957,1269,10
31983410486,31983410486,0,1454,2360,10
31986252660,31986252658,-2,1389,1364,10
31988756615,31988756611,-4,691,1570,10
31991013042,31991013041,-1,1264,2059,10
31993239089,31993239089,0,1369,1561,10
31994621041,31994621041,0,1794,2369,10
31996383822,31996383821,-1,911,1805,10
31998301938,31998301939,1,974,1329,10
32004612002,32004611999,-3,1481,2019,10
32009243386,32009243384,-2,1305,2581,10
32010599511,32010599509,-2,1844,2975,10
32013978671,32013978671,0,1973,2071,10
32016059498,32016059495,-3,1026,2214,10
32016945552,32016945537,-15,254,953,10
32021163683,32021163681,-2,1223,2051,10
32021335700,32021335687,-13,1314,1454,10
32022678535,32022678533,-2,1267,2495,10
32025175747,32025175746,-1,1166,1606,10
32030610670,32030610669,-1,1266,1657,10
32031241926,32031241926,0,1675,2069,10
32032375703,32032375701,-2,986,2101,10
32038504137,32038504143,6,1325,591,10
32039603683,32039603682,-1,1301,1573,10
32040946894,32040946894,0,1137,1536,10
32045287222,32045287224,2,1425,1919,10
32049701944,32049701947,3,1063,1858,10
32051060192,32051060191,-1,923,1551,10
32051847822,32051847821,-1,1158,1727,10
32052851711,32052851710,-1,1651,1754,10
32055194121,32055194121,0,2451,1769,10
32060750165,32060750162,-3,985,2034,10
32061154077,32061154075,-2,1145,1697,10
32062759550,32062759550,0,1034,1547,10
32063821950,32063821950,0,929,2479,10
32065691219,32065691217,-2,1295,2259,10
32070871888,32070871887,-1,973,1824,10
32073198698,32073198699,1,1444,2005,10
32073773551,32073773550,-1,1452,1746,10
32079831231,32079831229,-2,1638,3438,10
32082938630,32082938629,-1,1699,1741,10
32083076233,32083076231,-2,1073,1954,10
32087880209,32087880206,-3,1174,1932,10
32091036807,32091036806,-1,756,1438,10
32091175354,32091175373,19,470,971,10
32091651050,32091651047,-3,1001,1757,10
32093102251,32093102250,-1,1208,1528,10
32096585559,32096585558,-1,1080,2180,10
32098178063,32098178061,-2,893,1359,10
32099344767,32099344774,7,2089,1049,10
32103984894,32103984894,0,1475,2080,10
32113603163,32113603165,2,1077,1708,10
32116078658,32116078657,-1,1317,2921,10
32119682847,32119682848,1,1100,1764,10
32120498511,32120498517,6,5004,2804,10
32122605234,32122605234,0,1587,1453,10
32123449446,32123449446,0,1198,2120,10
32128695583,32128695582,-1,887,1457,10
32132760460,32132760459,-1,1230,1985,10
32133359678,32133359678,0,1442,2337,10
32133779795,32133779796,1,970,1628,10
32139729469,32139729467,-2,1215,2021,10
32139805186,32139805190,4,3228,2976,10
32144051409,32144051405,-4,1201,1825,10
32144126022,32144126026,4,9279,4139,10
32147680186,32147680185,-1,1647,2314,10
32153002576,32153002573,-3,1299,1827,10
32157800320,32157800314,-6,787,3805,10
32163388433,32163388433,0,1180,1580,10
32167652339,32167652336,-3,1116,2219,10
32169042529,32169042528,-1,1056,1626,10
32171511218,32171511219,1,740,1763,10
32174997190,32174997192,2,1094,1256,10
32180002994,32180002994,0,1067,2275,10
32186929990,32186929989,-1,1375,2140,10
32189169747,32189169745,-2,948,1720,10
32195624846,32195624844,-2,1494,1916,10
32197222084,32197222085,1,2299,2923,10
32198547053,32198547054,1,1764,1648,10
32205270764,32205270763,-1,1260,1188,10
32207821154,32207821153,-1,1101,1626,10
32211199211,32211199215,4,4509,3356,10
32213356552,32213356550,-2,1412,2472,10
32213789393,32213789398,5,4021,2668,10
32217035197,32217035197,0,1549,2640,10
32217535834,32217535838,4,2344,1298,10
32221219945,32221219946,1,1395,2205,10
32222386450,32222386447,-3,1683,4188,10
32223916903,32223916902,-1,1026,1554,10
32225268582,32225268578,-4,696,2348,10
32227948826,32227948829,3,1654,1019,10
32229192822,32229192822,0,1589,2227,10
32230162447,32230162445,-2,1309,1643,10
32233917613,32233917611,-2,1266,2166,10
32234215917,32234215914,-3,1467,2650,10
32234910806,32234910803,-3,1161,2245,10
32238082814,32238082812,-2,1074,2660,10
32243457299,32243457297,-2,1096,2204,10
32245998522,32245998517,-5,2046,6353,10
32248164255,32248164234,-21,1049,1925,10
32249605534,32249605533,-1,1339,1934,10
32250785110,32250785110,0,832,1856,10
32252105650,32252105648,-2,1484,1877,10
32255368834,32255368838,4,2124,1307,10
32256169318,32256169316,-2,884,1655,10
32260027227,32260027225,-2,1730,2963,10
32263303306,32263303306,0,1110,1675,10
32268729378,32268729380,2,1086,1910,10
32274175871,32274175873,2,1574,1727,10
32276400523,32276400522,-1,838,1831,10
32276914662,32276914662,0,541,941,10
32279175868,32279175867,-1,1774,2452,10
32282128325,32282128323,-2,1095,1812,10
32285396670,32285396668,-2,1433,2715,10
32288013566,32288013566,0,1783,1669,10
32289248235,32289248233,-2,1029,2233,10
32290687335,32290687335,0,985,1744,10
32291349123,32291349123,0,977,1449,10
32292018064,32292018060,-4,972,1754,10
32293474058,32293474058,0,779,1527,10
32296521934,32296521934,0,1269,1394,10
32296777939,32296777939,0,1023,2161,10
32297417058,32297417058,0,2099,1777,10
32302598841,32302598847,6,2799,817,10
32302907480,32302907481,1,1638,2362,10
32304212764,32304212763,-1,1128,2077,10
32304263051,32304263049,-2,1441,2500,10
32304473810,32304473809,-1,1161,2127,10
32306298300,32306298307,7,53026,21316,10
32307218365,32307218364,-1,1254,2168,10
32308016298,32308016303,5,2119,1889,10
32309578347,32309578346,-1,1306,2067,10
32314484670,32314484671,1,1032,1652,10
32314704838,32314704838,0,1873,2411,10
32315651167,32315651166,-1,889,1908,10
32324537432,32324537437,5,1574,1206,10
32328832609,32328832606,-3,1170,2193,10
32330479261,32330479260,-1,1010,1420,10
32331728552,32331728550,-2,1091,1798,10
32332971034,32332971031,-3,1258,3036,10
32338399882,32338399882,0,767,1301,10
32338746703,32338746703,0,1128,2002,10
32341236943,32341236951,8,1367,703,10
32343623998,32343623999,1,1261,945,10
32345081330,32345081331,1,1137,1197,10
32347208187,32347208184,-3,1005,1923,10
32351195294,32351195292,-2,1800,2462,10
32351480905,32351480910,5,2379,1172,10
32353711201,32353711197,-4,1320,1384,10
32353786767,32353786766,-1,1127,2210,10
32356590898,32356590896,-2,1673,2545,10
32359264466,32359264466,0,1387,2267,10
32362565010,32362565009,-1,1367,2135,10
32367989610,32367989609,-1,1156,1811,10
32370454655,32370454654,-1,1128,1833,10
32371571578,32371571577,-1,1205,1981,10
32375449426,32375449425,-1,1558,2345,10
32375864908,32375864905,-3,1872,1638,10
32376349883,32376349882,-1,1201,2824,10
32377331270,32377331271,1,904,976,10
32379970903,32379970900,-3,1431,2052,10
32384010762,32384010770,8,11928,28230,10
32385433674,32385433675,1,1193,1429,10
32385926094,32385926094,0,1467,2155,10
32387448807,32387448805,-2,1558,2475,10
32387990303,32387990302,-1,980,1052,10
32388423256,32388423279,23,1022,1546,10
32391681359,32391681359,0,886,1199,10
32395161401,32395161400,-1,1133,1724,10
32401319985,32401319985,0,1087,1756,10
32402010157,32402010158,1,1630,1583,10
32406017374,32406017375,1,1022,1814,10
32407853105,32407853102,-3,775,1719,10
32410655803,32410655811,8,10188,36610,10
32411173349,32411173369,20,1548,2417,10
32412787847,32412787845,-2,1059,2145,10
32413883646,32413883642,-4,1385,2317,10
32416940059,32416940058,-1,898,934,10
32419977989,32419977990,1,1529,1359,10
32423695972,32423695991,19,502,1414,10
32429894603,32429894618,15,731,1588,10
32439564059,32439564058,-1,1008,1416,10
32440510785,32440510785,0,1144,2015,10
32441497137,32441497126,-11,685,1840,10
32442352839,32442352834,-5,880,2539,10
32444808040,32444808038,-2,1233,1571,10
32446142700,32446142694,-6,1058,2186,10
32450490190,32450490188,-2,1648,1998,10
32450758382,32450758382,0,1471,2071,10
32453515393,32453515391,-2,1857,1737,10
32453959943,32453959942,-1,1306,2300,10
32456106749,32456106749,0,1638,1763,10
32457669206,32457669205,-1,946,2140,10
32460315715,32460315714,-1,947,1568,10
32460511175,32460511173,-2,1677,2469,10
32460874431,32460874430,-1,1615,2374,10
32462762706,32462762708,2,889,1532,10
32463117978,32463117959,-19,1551,1780,10
32465485738,32465485737,-1,1142,1430,10
32471957534,32471957530,-4,1362,1934,10
32472700347,32472700347,0,33055,33727,10
32473124997,32473124986,-11,876,2543,10
32475366525,32475366522,-3,1474,1679,10
32476078787,32476078781,-6,3296,11590,10
32482755797,32482755794,-3,1199,2909,10
32482949994,32482949993,-1,1548,1911,10
32488166896,32488166894,-2,1534,2210,10
32494550674,32494550672,-2,1491,2359,10
32495432408,32495432406,-2,1565,2185,10
32499963419,32499963418,-1,1492,2109,10
32500885931,32500885932,1,1603,2581,10
32503801802,32503801802,0,1340,1813,10
32508740944,32508740941,-3,1491,2741,10
32509020663,32509020665,2,1261,1851,10
32515022427,32515022427,0,1314,2066,10
32524220119,32524220118,-1,697,1166,10
32524724241,32524724240,-1,855,1617,10
32525408552,32525408542,-10,1216,1636,10
32532198741,32532198738,-3,992,2975,10
32534642742,32534642739,-3,1252,2167,10
32535429769,32535429768,-1,1169,1589,10
32535709654,32535709655,1,1829,1624,10
32543678874,32543678856,-18,1523,1836,10
32543903474,32543903489,15,943,1267,10
32545853155,32545853155,0,788,1620,10
32546804776,32546804769,-7,48,744,10
32546944333,32546944333,0,1404,1922,10
32547244617,32547244612,-5,1443,2620,10
32553437277,32553437273,-4,1706,4122,10
32555281265,32555281262,-3,1269,2042,10
32558546318,32558546319,1,1249,2160,10
32562361067,32562361067,0,1444,2076,10
32565864726,32565864726,0,1124,2073,10
32565990507,32565990486,-21,1262,1486,10
32567608099,32567608097,-2,1026,2323,10
32572228626,32572228625,-1,1390,2170,10
32576531531,32576531537,6,2661,1906,10
32585130467,32585130466,-1,1390,2362,10
32589892740,32589892734,-6,23896,16461,10
32590400867,32590400867,0,945,1522,10
32593057965,32593057963,-2,1470,2998,10
32597288899,32597288898,-1,1634,2009,10
32598071174,32598071171,-3,1287,2167,10
32598241260,32598241277,17,1037,1348,10
32600494723,32600494725,2,2242,1630,10
32603422775,32603422774,-1,1605,2326,10
32604984081,32604984078,-3,966,1666,10
32607409102,32607409101,-1,1351,1643,10
32608379982,32608379982,0,1123,2164,10
32608948088,32608948110,22,484,640,10
32610453014,32610453015,1,678,1113,10
32611645416,32611645417,1,1331,2574,10
32613409082,32613409085,3,2516,1744,10
32615186189,32615186186,-3,2566,5615,10
32615899823,32615899823,0,1428,1985,10
32618234263,32618234263,0,979,1082,10
32618696622,32618696623,1,1283,1726,10
32620030023,32620030021,-2,1370,3174,10
32624186359,32624186367,8,2538,815,10
32626757925,32626757924,-1,1194,2024,10
32628386035,32628386034,-1,845,1265,10
32628523384,32628523382,-2,1259,2332,10
32631365007,32631365006,-1,1254,2419,10
32631778105,32631778104,-1,858,1707,10
32634602643,32634602644,1,1688,2460,10
32635093197,32635093194,-3,1019,1594,10
32639011249,32639011250,1,1220,1957,10
32639544657,32639544656,-1,1223,1392,10
32640429485,32640429484,-1,1111,1369,10
32641503915,32641503914,-1,1438,1609,10
32641654513,32641654518,5,333,1246,10
32642968934,32642968936,2,1955,1833,10
32647087688,32647087687,-1,990,2178,10
32656254737,32656254734,-3,1773,5525,10
32657389405,32657389403,-2,1371,1660,10
32658254067,32658254065,-2,892,1280,10
32660472590,32660472584,-6,1707,7081,10
32660954583,32660954581,-2,1224,2977,10
32661978994,32661978993,-1,966,1421,10
32665341947,32665341946,-1,1259,2140,10
32668199027,32668199025,-2,677,1600,10
32670407971,32670407951,-20,1703,725,10
32673075706,32673075711,5,3293,2732,10
32677257091,32677257089,-2,1042,2203,10
32678747018,32678747019,1,1292,1630,10
32679933168,32679933162,-6,1648,1962,10
32680035192,32680035185,-7,240,729,10
32684644945,32684644951,6,2616,1338,10
32686778630,32686778627,-3,841,1470,10
32691024991,32691024990,-1,1578,1976,10
32691297367,32691297364,-3,1303,1969,10
32696703902,32696703902,0,1649,2159,10
32697111166,32697111164,-2,1536,2019,10
32700918940,32700918938,-2,1161,1936,10
32700979057,32700979071,14,126,813,10
32703494913,32703494913,0,876,1981,10
32706587843,32706587841,-2,754,1549,10
32707990299,32707990298,-1,1136,2218,10
32713315624,32713315624,0,2224,2286,10
32714065947,32714065945,-2,938,1358,10
32715005692,32715005690,-2,1179,1666,10
32716415859,32716415859,0,230,1129,10
32718615405,32718615406,1,1634,2140,10
32718823319,32718823316,-3,1256,2290,10
32720712999,32720712991,-8,1279,3510,10
32726014783,32726014782,-1,1239,1378,10
32730896738,32730896737,-1,1053,1514,10
32732621399,32732621398,-1,1425,2328,10
32737082214,32737082212,-2,1504,2780,10
32739555158,32739555156,-2,997,1616,10
32742349763,32742349763,0,1042,1503,10
32743847580,32743847574,-6,1073,2036,10
32745206914,32745206909,-5,22934,17401,10
32746871338,32746871338,0,1707,1556,10
32747455426,32747455425,-1,1053,1816,10
32750376241,32750376239,-2,1242,2040,10
32751704751,32751704753,2,1460,1579,10
32752961495,32752961494,-1,1143,2019,10
32755832589,32755832585,-4,889,1542,10
32761027222,32761027218,-4,1132,2252,10
32765991489,32765991486,-3,2092,2091,10
32766149642,32766149641,-1,1064,1706,10
32767202534,32767202534,0,1158,1111,10
32768699938,32768699938,0,1475,1449,10
32774882727,32774882725,-2,842,2039,10
32775861187,32775861186,-1,1821,1901,10
32778715659,32778715657,-2,879,1804,10
32781062894,32781062893,-1,1591,1833,10
32786338447,32786338455,8,1416,719,10
32789653203,32789653206,3,1959,1179,10
32797282991,32797282990,-1,1083,1648,10
32801532571,32801532569,-2,1021,1358,10
32807081750,32807081747,-3,1465,2015,10
32809910122,32809910119,-3,1547,2182,10
32812710939,32812710940,1,871,1174,10
32814902649,32814902646,-3,1212,2372,10
32818289894,32818289893,-1,1298,1954,10
32818675834,32818675834,0,1088,2496,10
32820637964,32820637960,-4,1235,2555,10
32823174314,32823174313,-1,1525,2868,10
32824526333,32824526340,7,13019,36465,10
32826059523,32826059522,-1,1430,1626,10
32826953593,32826953591,-2,1253,1960,10
32828016589,32828016588,-1,1254,2462,10
32840042030,32840042029,-1,769,1645,10
32845341589,32845341585,-4,1904,2158,10
32846549298,32846549295,-3,1252,2152,10
32849301331,32849301330,-1,1266,2220,10
32850412562,32850412559,-3,660,1799,10
32851022070,32851022070,0,1583,2191,10
32854089558,32854089558,0,1093,2142,10
32854746027,32854746027,0,2046,2474,10
32856973574,32856973561,-13,1090,1600,10
32857261165,32857261170,5,1310,793,10
32862468245,32862468246,1,1014,1090,10
32869312228,32869312229,1,1891,2194,10
32869396711,32869396709,-2,1417,2114,10
32877599888,32877599886,-2,1511,2142,10
32877750077,32877750075,-2,1182,2221,10
32877866062,32877866062,0,1157,1784,10
32879534449,32879534442,-7,2207,5819,10
32897782647,32897782655,8,3614,1339,10
32897929422,32897929422,0,1409,1681,10
32902724116,32902724113,-3,1086,1633,10
32907781845,32907781843,-2,987,1632,10
32909179198,32909179202,4,2002,1437,10
32912429186,32912429185,-1,489,2334,10
32913128419,32913128418,-1,1311,1800,10
32914161065,32914161062,-3,1476,1969,10
32915030016,32915030027,11,14822,22710,10
32915989890,32915989890,0,1122,2217,10
32916138954,32916138951,-3,1219,1645,10
32924701899,32924701898,-1,494,1088,10
32926335123,32926335120,-3,1120,1595,10
32927227034,32927227033,-1,1768,2063,10
32929976630,32929976628,-2,1439,2372,10
32933847769,32933847769,0,1032,1912,10
32934903431,32934903429,-2,1174,3359,10
32936087371,32936087373,2,1661,1203,10
32937006799,32937006793,-6,1012,5638,10
32938151674,32938151671,-3,964,1607,10
32950741709,32950741709,0,1166,2173,10
32952758072,32952758070,-2,831,1791,10
32954158011,32954158008,-3,1218,2594,10
32963848626,32963848626,0,1520,1808,10
32964972930,32964972929,-1,1252,2123,10
32968312222,32968312220,-2,964,2088,10
32968590115,32968590110,-5,888,1713,10
32969754426,32969754424,-2,1197,2738,10
32969974480,32969974467,-13,908,1365,10
32975826287,32975826289,2,1977,1551,10
32977199551,32977199551,0,859,1095,10
32980514453,32980514450,-3,1694,3798,10
32986106731,32986106730,-1,894,1641,10
32994677230,32994677233,3,2268,1586,10
32996077075,32996077072,-3,882,1656,10
32996544768,32996544766,-2,1328,1840,10
32996608490,32996608510,20,893,1698,10
32996856999,32996857000,1,1447,1720,10
33002952283,33002952282,-1,1349,1731,10
33003679132,33003679130,-2,1779,2420,10
33007837739,33007837737,-2,1219,1755,10
33011486441,33011486440,-1,1919,2179,10
33012961097,33012961095,-2,1312,2201,10
33013100547,33013100545,-2,748,2036,10
33014620866,33014620865,-1,1230,2211,10
33015770486,33015770485,-1,1297,2786,10
33016524264,33016524259,-5,643,1863,10
33017417444,33017417450,6,1066,317,10
33017829760,33017829759,-1,1083,1965,10
33019570471,33019570470,-1,821,1390,10
33019848527,33019848526,-1,1296,1936,10
33023867729,33023867726,-3,1160,1977,10
33025736709,33025736708,-1,1280,2341,10
33029938589,33029938586,-3,1827,2433,10
33031990324,33031990323,-1,1730,2309,10
33032343785,33032343783,-2,1096,1738,10
33035456729,33035456726,-3,368,35,10
33040093180,33040093179,-1,1122,1731,10
33041047985,33041047982,-3,942,2627,10
33041621225,33041621247,22,590,809,10
33045840498,33045840495,-3,1678,2889,10
33047308102,33047308102,0,1442,2075,10
33053688406,33053688406,0,2332,3051,10
33054993514,33054993511,-3,1381,1917,10
33056161521,33056161522,1,1652,2392,10
33056921881,33056921878,-3,1398,1609,10
33057191438,33057191435,-3,1206,1810,10
33057604257,33057604258,1,1282,1735,10
33058963640,33058963654,14,515,914,10
33059615561,33059615557,-4,1524,2645,10
33061401193,33061401194,1,766,1441,10
33070224851,33070224849,-2,1176,2114,10
33073178680,33073178678,-2,1522,1839,10
33075086678,33075086678,0,1610,2426,10
33076957093,33076957090,-3,1304,2607,10
33078156269,33078156275,6,31433,30440,10
33082882196,33082882194,-2,1105,1755,10
33083878569,33083878567,-2,1378,1688,10
33084837733,33084837733,0,1259,2106,10
33085354800,33085354798,-2,1113,2133,10
33088339919,33088339918,-1,1239,1835,10
33088393840,33088393856,16,546,2009,10
33088531977,33088531978,1,1460,1864,10
33090842077,33090842075,-2,1230,2092,10
33098227914,33098227910,-4,2229,2595,10
33099542765,33099542765,0,1045,1450,10
33100555274,33100555274,0,1309,2186,10
33102777965,33102777963,-2,1051,1037,10
33103444646,33103444645,-1,1723,1921,10
33103648678,33103648677,-1,1106,1551,10
33106326825,33106326825,0,1316,1785,10
33107363022,33107363023,1,859,1496,10
33108579797,33108579798,1,1895,1978,10
33109878057,33109878058,1,1084,2164,10
33116006764,33116006761,-3,863,1945,10
33117391917,33117391915,-2,936,1317,10
33120327250,33120327250,0,1290,1931,10
33120486256,33120486254,-2,1841,2317,10
33123115525,33123115522,-3,1231,2344,10
33127880490,33127880488,-2,866,1445,10
33129398226,33129398242,16,635,1881,10
33132500059,33132500055,-4,1043,2207,10
33133204910,33133204907,-3,1182,1863,10
33139418191,33139418189,-2,1134,1998,10
33140163032,33140163029,-3,1080,2309,10
33146055914,33146055911,-3,845,2429,10
33146202499,33146202499,0,1741,1837,10
33152949840,33152949839,-1,1038,1955,10
33153867400,33153867406,6,3153,1612,10
33154889978,33154889979,1,3632,4792,10
33158651666,33158651672,6,4037,2307,10
33163419597,33163419600,3,1154,1104,10
33167785387,33167785386,-1,1169,2008,10
33168098843,33168098841,-2,1183,2295,10
33170048524,33170048523,-1,1511,1936,10
33170644482,33170644490,8,2200,970,10
33179220070,33179220069,-1,1326,1913,10
33184520842,33184520843,1,1155,1137,10
33185124577,33185124576,-1,1283,2506,10
33186660411,33186660418,7,2969,948,10
33186730915,33186730913,-2,1470,1972,10
33191125426,33191125423,-3,1375,1868,10
33195975431,33195975430,-1,1211,2126,10
33203145723,33203145720,-3,1710,2748,10
33203849670,33203849670,0,1280,1673,10
33205256414,33205256415,1,1655,1913,10
33210838795,33210838795,0,1743,2143,10
33213026717,33213026717,0,1161,1636,10
33213900685,33213900683,-2,1446,2021,10
33215803172,33215803170,-2,1310,2279,10
33216445912,33216445913,1,1193,1848,10
33216803491,33216803469,-22,1256,1995,10
33219391274,33219391271,-3,971,1680,10
33221252135,33221252134,-1,1235,1827,10
33223137634,33223137633,-1,1420,2230,10
33224356133,33224356131,-2,1059,1884,10
33226857118,33226857117,-1,1346,1957,10
33227239645,33227239642,-3,1141,2230,10
33228725738,33228725736,-2,1421,1987,10
33229766053,33229766051,-2,1161,2922,10
33230420290,33230420286,-4,1165,1860,10
33231644545,33231644545,0,1446,1561,10
33232207518,33232207516,-2,1067,1731,10
33232712705,33232712706,1,1273,1546,10
33236479961,33236479958,-3,1175,2403,10
33238415059,33238415057,-2,1134,2124,10
33242961259,33242961259,0,1441,2953,10
33243941741,33243941739,-2,1852,2665,10
33250847138,33250847138,0,1610,2336,10
33252394303,33252394303,0,1225,1207,10
33255376519,33255376516,-3,1208,3027,10
33259762971,33259762969,-2,1341,2269,10
33259834515,33259834514,-1,1037,2216,10
33260554010,33260554006,-4,1131,2461,10
33263558581,33263558579,-2,1314,1593,10
33265087313,33265087311,-2,1718,2105,10
33267211503,33267211502,-1,1804,2917,10
33270816635,33270816631,-4,1024,2638,10
33274601629,33274601630,1,1276,1380,10
33274824401,33274824399,-2,728,1191,10
33276253415,33276253414,-1,1166,2490,10
33280388041,33280388039,-2,1244,1725,10
33281452065,33281452066,1,1463,1621,10
33284434585,33284434584,-1,1484,1706,10
33284903683,33284903684,1,959,2049,10
33285147883,33285147881,-2,933,1994,10
33289332513,33289332510,-3,1059,2084,10
33290982308,33290982305,-3,1044,2062,10
33291408262,33291408260,-2,785,2013,10
33291953080,33291953079,-1,1064,1620,10
33294380014,33294380012,-2,796,1932,10
33298380723,33298380719,-4,1288,3107,10
33300073190,33300073190,0,1009,2094,10
33301121530,33301121534,4,2169,1333,10
33302443723,33302443726,3,2495,2032,10
33303511709,33303511710,1,951,1826,10
33303573937,33303573957,20,1470,1706,10
33307503707,33307503704,-3,2488,5948,10
33307588301,33307588299,-2,1184,1807,10
33310148946,33310148943,-3,852,1136,10
33311246059,33311246058,-1,539,1991,10
33315322804,33315322800,-4,829,2703,10
33315606601,33315606598,-3,1035,2052,10
33321553594,33321553594,0,1425,1533,10
33325329875,33325329876,1,1069,1414,10
33325982385,33325982383,-2,888,2183,10
33326145656,33326145679,23,813,1252,10
33326763117,33326763116,-1,982,1779,10
33327723898,33327723898,0,1613,1994,10
33329890209,33329890206,-3,924,1682,10
33330658081,33330658078,-3,1092,1911,10
33330879193,33330879214,21,1577,2402,10
33331049718,33331049717,-1,1183,2069,10
33333642850,33333642849,-1,1019,1856,10
33334591078,33334591073,-5,1352,1731,10
33336543117,33336543117,0,1104,1855,10
33339615595,33339615593,-2,1239,1988,10
33340572877,33340572874,-3,770,2795,10
33343892302,33343892301,-1,994,1887,10
33344117877,33344117877,0,1396,1315,10
33346109707,33346109706,-1,1119,1795,10
33346822494,33346822497,3,1105,884,10
33349581673,33349581673,0,1205,2349,10
33354217734,33354217732,-2,1505,2207,10
33362523757,33362523762,5,5964,2351,10
33365230634,33365230629,-5,1557,2964,10
33365542195,33365542203,8,5972,1063,10
33366142823,33366142822,-1,1009,1530,10
33376170398,33376170395,-3,732,1577,10
33384445606,33384445607,1,1021,1265,10
33386441415,33386441416,1,1221,1302,10
33389610995,33389610991,-4,869,1996,10
33390584778,33390584779,1,1358,1331,10
33390750972,33390750962,-10,1266,1542,10
33390874680,33390874679,-1,989,1476,10
33392396593,33392396592,-1,1103,1947,10
33392509305,33392509321,16,3402,1067,10
33395419231,33395419232,1,1659,2143,10
33395525276,33395525275,-1,1102,2300,10
33395701509,33395701510,1,1598,1791,10
33400563620,33400563622,2,1908,1495,10
33405008635,33405008633,-2,1013,1003,10
33405908978,33405908975,-3,1430,2350,10
33406946156,33406946157,1,1450,1623,10
33408457665,33408457674,9,12563,35120,10
33415899235,33415899233,-2,1410,2566,10
33421173746,33421173746,0,1133,1706,10
33424448626,33424448623,-3,1588,2366,10
33425128904,33425128902,-2,1470,2105,10
33427127999,33427127988,-11,1713,1444,10
33434675950,33434675949,-1,1575,2208,10
33435359013,33435359012,-1,913,2087,10
33435738226,33435738225,-1,1740,2654,10
33438373562,33438373562,0,1125,1780,10
33441716156,33441716149,-7,34108,13034,10
33441902229,33441902226,-3,1235,1270,10
33443787926,33443787925,-1,1236,1741,10
33444138923,33444138922,-1,919,1353,10
33444663701,33444663701,0,885,1415,10
33449106883,33449106880,-3,1547,2285,10
33452661951,33452661952,1,823,1452,10
33456609384,33456609387,3,1507,1556,10
33457031793,33457031792,-1,1014,1844,10
33457859130,33457859130,0,1549,2202,10
33460289022,33460289022,0,714,1728,10
33463391679,33463391678,-1,842,1379,10
33464228295,33464228294,-1,1240,2214,10
33470786677,33470786676,-1,1246,1967,10
33474567278,33474567275,-3,1291,2011,10
33475210104,33475210102,-2,1077,2159,10
33477059392,33477059389,-3,1610,2278,10
33479785600,33479785595,-5,955,3140,10
33490011281,33490011281,0,1302,2378,10
33491417948,33491417963,15,1088,1874,10
33491686861,33491686859,-2,1950,2477,10
33492226458,33492226457,-1,1211,1828,10
33492709419,33492709414,-5,1397,2064,10
33496105715,33496105713,-2,1141,1994,10
33496641422,33496641421,-1,1256,2395,10
33496817027,33496817046,19,843,1586,10
33496915790,33496915791,1,988,1703,10
33500081390,33500081385,-5,1366,4643,10
33500955222,33500955221,-1,1112,2462,10
33501837282,33501837281,-1,1668,3090,10
33502145943,33502145942,-1,996,1722,10
33503918339,33503918336,-3,1003,2438,10
33517614458,33517614457,-1,1144,2080,10
33518641303,33518641301,-2,891,2582,10
33522610584,33522610586,2,953,2049,10
33525287546,33525287545,-1,882,1423,10
33530466426,33530466425,-1,1522,2034,10
33532705706,33532705704,-2,1303,2120,10
33533162435,33533162434,-1,1703,2262,10
33535200153,33535200153,0,1170,1851,10
33537818418,33537818417,-1,829,1552,10
33541417259,33541417259,0,1824,2175,10
33541982574,33541982574,0,1116,2065,10
33544326025,33544326030,5,1651,735,10
33544885171,33544885170,-1,1104,1939,10
33546740802,33546740807,5,3096,1315,10
33546849554,33546849554,0,1031,1917,10
33560935954,33560935953,-1,1181,2015,10
33561451458,33561451458,0,918,1354,10
33564525810,33564525809,-1,817,1217,10
33569094379,33569094377,-2,796,1657,10
33570214582,33570214579,-3,640,1489,10
33573083087,33573083086,-1,1004,1718,10
33573848190,33573848190,0,1384,2408,10
33575369122,33575369122,0,1190,2144,10
33576528586,33576528586,0,1436,2439,10
33581298292,33581298290,-2,1404,2429,10
33587002121,33587002119,-2,1753,2710,10
33587363026,33587363025,-1,1193,2501,10
33591869219,33591869215,-4,907,2631,10
33592486363,33592486365,2,703,1357,10
33598607334,33598607334,0,1195,1923,10
33599824206,33599824206,0,1319,1925,10
33600981958,33600981957,-1,1080,2085,10
33607298765,33607298766,1,1441,2509,10
33607443905,33607443901,-4,1174,5528,10
33608584561,33608584557,-4,1046,1565,10
33608851638,33608851637,-1,1510,2632,10
33609413445,33609413442,-3,1274,2231,10
33611585585,33611585579,-6,1039,2825,10
33616635746,33616635745,-1,1506,2453,10
33621488986,33621488985,-1,981,1915,10
33624286105,33624286102,-3,932,2903,10
33625486828,33625486827,-1,1273,1904,10
33626313869,33626313869,0,1539,2189,10
33630325078,33630325075,-3,1048,1938,10
33633949346,33633949345,-1,933,1464,10
33634782354,33634782353,-1,30302,65113,10
33636409583,33636409582,-1,1075,1211,10
33647019901,33647019900,-1,1497,2113,10
33652505890,33652505889,-1,1108,2243,10
33654290005,33654290006,1,1072,1723,10
33663446447,33663446445,-2,748,2417,10
33665526917,33665526921,4,2607,1300,10
33666925448,33666925450,2,1339,1657,10
33673332866,33673332865,-1,1241,1420,10
33674118825,33674118844,19,1216,2714,10
33676888323,33676888322,-1,980,1336,10
33677042294,33677042294,0,834,1525,10
33683027202,33683027202,0,1422,1553,10
33683469909,33683469908,-1,1400,2386,10
33685327907,33685327912,5,11062,30157,10
33686181171,33686181169,-2,1062,2153,10
33686830649,33686830648,-1,1764,2126,10
33694234513,33694234514,1,1318,1235,10
33695573778,33695573782,4,30114,116130,10
33697049261,33697049262,1,1235,1413,10
33698980838,33698980837,-1,1589,1883,10
33699727351,33699727347,-4,613,1683,10
33702242446,33702242466,20,1558,2085,10
33704918066,33704918064,-2,1474,2439,10
33713329562,33713329562,0,1446,1961,10
33715691940,33715691938,-2,1207,1652,10
33717668032,33717668030,-2,1282,1701,10
33719154969,33719154967,-2,1152,2146,10
33723766887,33723766886,-1,1421,2381,10
33726112949,33726112945,-4,1205,4392,10
33726573606,33726573606,0,1159,2024,10
33727677977,33727677974,-3,1558,1965,10
33728552665,33728552663,-2,893,2391,10
33735992882,33735992880,-2,1703,2941,10
33736876147,33736876145,-2,1446,2959,10
33737659050,33737659049,-1,1468,1888,10
33739304286,33739304283,-3,1476,2823,10
33746851704,33746851700,-4,1343,3188,10
33756691485,33756691482,-3,1329,2573,10
33758236047,33758236047,0,942,1400,10
33758653163,33758653162,-1,1085,1117,10
33760045426,33760045424,-2,1751,2995,10
33761289101,33761289098,-3,1001,1841,10
33764269830,33764269825,-5,3429,10711,10
33765375506,33765375506,0,962,1357,10
33765985514,33765985513,-1,1801,2297,10
33767529807,33767529806,-1,1021,2290,10
33767785617,33767785618,1,1405,1741,10
33776587524,33776587525,1,1762,1546,10
33780204507,33780204506,-1,1203,2612,10
33783292184,33783292182,-2,992,1503,10
33791616062,33791616060,-2,982,1477,10
33793735900,33793735898,-2,1374,1542,10
33795590610,33795590609,-1,1557,1594,10
33796829033,33796829030,-3,1635,3012,10
33797671202,33797671197,-5,1228,2050,10
33804759703,33804759706,3,4341,4987,10
33806024138,33806024137,-1,1201,3418,10
33807270605,33807270601,-4,1357,3230,10
33809780434,33809780436,2,1373,2032,10
33814210191,33814210189,-2,1035,1679,10
33818026055,33818026054,-1,1374,2444,10
33819054103,33819054101,-2,1032,2090,10
33824493065,33824493066,1,1225,1783,10
33825839553,33825839553,0,1457,2347,10
33826790402,33826790398,-4,936,1951,10
33827635977,33827635974,-3,21159,14826,10
33831588243,33831588243,0,1170,1834,10
33836555219,33836555237,18,1334,1591,10
33838066594,33838066593,-1,1515,2201,10
33840830030,33840830046,16,1330,1932,10
33841006350,33841006350,0,27672,44200,10
33844434869,33844434868,-1,1294,2116,10
33847480305,33847480301,-4,1566,2055,10
33848043270,33848043272,2,1827,2764,10
33848351591,33848351590,-1,1142,1863,10
33848750934,33848750934,0,1057,2454,10
33849323543,33849323541,-2,953,1929,10
33850672339,33850672337,-2,1369,1784,10
33858115698,33858115697,-1,926,1652,10
33858937209,33858937210,1,1390,2732,10
33859814929,33859814929,0,1165,1664,10
33860334511,33860334510,-1,805,2026,10
33862529885,33862529885,0,1099,1677,10
33862761949,33862761950,1,47631,44095,10
33865180081,33865180083,2,3852,3255,10
33865904679,33865904678,-1,1256,1764,10
33865939155,33865939154,-1,1735,1845,10
33870191448,33870191447,-1,1063,1671,10
33870995278,33870995283,5,1174,689,10
33874104482,33874104481,-1,1409,2735,10
33875575708,33875575707,-1,1045,2201,10
33875811505,33875811497,-8,17,1976,10
33876985522,33876985521,-1,1163,1509,10
33877132055,33877132050,-5,1301,2757,10
33878712763,33878712761,-2,841,1976,10
33878858813,33878858812,-1,1342,2358,10
33879148457,33879148459,2,1175,1873,10
33882917459,33882917457,-2,1326,2400,10
33884124295,33884124294,-1,1422,2513,10
33884294259,33884294258,-1,1800,1667,10
33886909438,33886909437,-1,1104,2785,10
33889041575,33889041576,1,979,1567,10
33894972584,33894972586,2,1731,1991,10
33895060460,33895060456,-4,1331,1858,10
33895791087,33895791096,9,11065,33010,10
33896640879,33896640878,-1,1386,1897,10
33897082836,33897082854,18,1599,2620,10
33899162927,33899162927,0,685,849,10
33902717683,33902717678,-5,1732,4337,10
33902878475,33902878474,-1,1517,1785,10
33903041822,33903041819,-3,1077,1841,10
33903850838,33903850833,-5,1150,2848,10
33904549090,33904549089,-1,850,2008,10
33906152531,33906152530,-1,1088,1996,10
33911372758,33911372758,0,1187,1930,10
33921387508,33921387506,-2,2277,2750,10
33927437656,33927437660,4,22654,20437,10
33928248593,33928248598,5,11448,55303,10
33932200052,33932200050,-2,1008,2110,10
33932728409,33932728431,22,1586,2215,10
33933060335,33933060334,-1,1412,1652,10
33933637219,33933637218,-1,1590,2686,10
33934110847,33934110843,-4,1527,2143,10
33937058461,33937058473,12,7254,47334,10
33942716885,33942716882,-3,1312,2148,10
33943625332,33943625331,-1,790,2226,10
33948658532,33948658531,-1,1042,1783,10
33948996042,33948996043,1,306,721,10
33950634295,33950634294,-1,1432,1670,10
33951154198,33951154197,-1,1123,1830,10
33951279739,33951279739,0,1202,1786,10
33954651482,33954651499,17,1545,1994,10
33955994730,33955994730,0,766,1708,10
33957901748,33957901749,1,1150,1808,10
33960893147,33960893145,-2,1517,2448,10
33962056366,33962056366,0,1271,1608,10
33962818343,33962818342,-1,1109,1801,10
33963062863,33963062860,-3,659,2327,10
33963554209,33963554198,-11,834,1864,10
33964786464,33964786464,0,1183,2108,10
33967273331,33967273331,0,1631,1666,10
33968638734,33968638733,-1,579,1370,10
33969870631,33969870631,0,1176,1960,10
33970155482,33970155501,19,1070,1947,10
33971679302,33971679301,-1,1233,2452,10
33975884491,33975884490,-1,1007,2339,10
33978836870,33978836869,-1,1162,2142,10
33986858059,33986858059,0,1178,1989,10
33990508708,33990508706,-2,1321,1674,10
33992842315,33992842315,0,798,1436,10
33993141481,33993141481,0,1685,2413,10
33993563294,33993563294,0,1333,2508,10
33994923777,33994923778,1,519,736,10
33996888407,33996888406,-1,953,2017,10
34001113474,34001113473,-1,1911,2218,10
34001441498,34001441499,1,1194,1630,10
34001965258,34001965257,-1,1141,1852,10
34006459374,34006459374,0,1617,1270,10
34010677149,34010677151,2,1211,1985,10
34011851929,34011851935,6,933,1189,10
34018548507,34018548506,-1,974,2460,10
34019189761,34019189761,0,786,1386,10
34019625629,34019625634,5,1268,1259,10
34026649123,34026649121,-2,1069,1414,10
34028276155,34028276157,2,1379,1151,10
34031542786,34031542782,-4,1244,2237,10
34035367347,34035367344,-3,1113,2304,10
34035595721,34035595716,-5,2186,7909,10
34036269765,34036269762,-3,978,1512,10
34037928757,34037928773,16,970,1432,10
34040870899,34040870899,0,1279,2050,10
34043934457,34043934459,2,1712,1233,10
34047682076,34047682075,-1,1482,2737,10
34050105069,34050105066,-3,1397,2509,10
34055436382,34055436381,-1,1732,2837,10
34056277229,34056277227,-2,1357,1875,10
34060218261,34060218267,6,2642,1222,10
34062733162,34062733160,-2,1392,2078,10
34063051762,34063051781,19,618,4005,10
34069956350,34069956348,-2,811,1734,10
34071455386,34071455386,0,1685,1943,10
34071968065,34071968064,-1,1079,1737,10
34073808225,34073808224,-1,1338,1883,10
34078226111,34078226108,-3,1230,1547,10
34079396907,34079396905,-2,1182,2149,10
34079941450,34079941450,0,2094,2861,10
34080066835,34080066835,0,1135,1114,10
34094927194,34094927194,0,1404,2079,10
34097937071,34097937070,-1,1381,1715,10
34105322919,34105322917,-2,813,1685,10
34107268669,34107268669,0,1327,1544,10
34107965317,34107965319,2,6116,19894,10
34108564461,34108564479,18,669,831,10
34110638479,34110638477,-2,1271,2366,10
34112921660,34112921667,7,5152,2221,10
34114424041,34114424034,-7,1536,4414,10
34117744235,34117744235,0,1488,2218,10
34119675871,34119675870,-1,1763,2505,10
34125657738,34125657738,0,1110,1934,10
34130136082,34130136082,0,1281,1953,10
34131169177,34131169171,-6,1232,2580,10
34132497022,34132497022,0,1069,1765,10
34139366442,34139366441,-1,1125,1596,10
34142865041,34142865041,0,874,1954,10
34144171309,34144171309,0,1154,2225,10
34146426067,34146426067,0,1269,1826,10
34147736722,34147736719,-3,1018,2227,10
34149505132,34149505130,-2,1318,2390,10
34150705586,34150705589,3,4247,3208,10
34155525528,34155525530,2,1676,1488,10
34158892197,34158892198,1,1862,1255,10
34160166269,34160166266,-3,1204,2841,10
34162569746,34162569745,-1,1150,2023,10
34163797851,34163797836,-15,1382,2150,10
34166836386,34166836383,-3,1251,1943,10
34168454152,34168454150,-2,1622,3068,10
34171328346,34171328343,-3,1302,1905,10
34175226143,34175226141,-2,727,1613,10
34178548851,34178548850,-1,1194,1772,10
34179560765,34179560762,-3,1417,2221,10
34186585878,34186585877,-1,1258,2416,10
34187446360,34187446362,2,1127,1934,10
34192742423,34192742421,-2,1447,1939,10
34192967501,34192967500,-1,1161,2093,10
34195248486,34195248488,2,1198,1929,10
34195752227,34195752226,-1,1354,1561,10
34199783806,34199783806,0,1806,2260,10
34206393149,34206393148,-1,1258,2393,10
34206420781,34206420777,-4,1049,1806,10
34207675429,34207675427,-2,1313,1730,10
34209563586,34209563584,-2,1553,2610,10
34213517131,34213517135,4,2149,1324,10
34216492374,34216492371,-3,1367,2291,10
34218999930,34218999930,0,968,2250,10
34222982114,34222982118,4,1518,1750,10
34223099214,34223099212,-2,899,2037,10
34223729862,34223729862,0,965,1353,10
34230705411,34230705411,0,1540,2018,10
34238589123,34238589122,-1,1792,2063,10
34240037769,34240037769,0,1589,2017,10
34240274275,34240274273,-2,1311,2354,10
34240493082,34240493102,20,1270,1593,10
34241717734,34241717735,1,1076,2247,10
34246362122,34246362122,0,1459,1613,10
34251484788,34251484772,-16,922,1844,10
34252944365,34252944366,1,990,1422,10
34259632736,34259632734,-2,1206,2551,10
34260218996,34260218994,-2,1305,2181,10
34264025218,34264025215,-3,1043,1277,10
34274734499,34274734498,-1,1413,2772,10
34275065674,34275065670,-4,989,3269,10
34287374711,34287374712,1,1800,1521,10
34292066971,34292066969,-2,909,1909,10
34293495185,34293495182,-3,1068,2027,10
34297416577,34297416585,8,3295,1192,10
34302835841,34302835841,0,2325,4476,10
34305203874,34305203873,-1,583,1131,10
34307412886,34307412883,-3,1284,2604,10
34307509243,34307509259,16,562,1453,10
34308025748,34308025747,-1,1194,1653,10
34309094515,34309094514,-1,911,2048,10
34310729862,34310729862,0,1260,2907,10
34312149323,34312149322,-1,833,1323,10
34315266215,34315266212,-3,1119,1998,10
34319175550,34319175549,-1,1442,1301,10
34322768378,34322768384,6,5069,2451,10
34328784214,34328784216,2,1861,2358,10
34329139707,34329139707,0,1151,2067,10
34332076583,34332076580,-3,1250,2383,10
34334341257,34334341254,-3,1324,2117,10
34348659270,34348659269,-1,1675,2460,10
34351170470,34351170469,-1,1501,1903,10
34354853883,34354853882,-1,1713,2378,10
34359276678,34359276674,-4,1220,1872,10
34360553462,34360553461,-1,1292,1991,10
34363053341,34363053354,13,5114,192,10
34364867458,34364867457,-1,1036,2611,10
34366346018,34366346016,-2,1149,1705,10
34367447085,34367447088,3,10940,23256,10
34376871373,34376871371,-2,1294,1972,10
34377326637,34377326637,0,1225,1774,10
34380741158,34380741157,-1,1180,2033,10
34381189755,34381189754,-1,1567,1637,10
34381306572,34381306568,-4,1269,1630,10
34382677023,34382677023,0,1327,2631,10
34385428954,34385428953,-1,1676,2516,10
34386728982,34386728980,-2,1538,2571,10
34388339902,34388339900,-2,1519,2069,10
34391254450,34391254449,-1,1033,1367,10
34397155509,34397155509,0,1050,1372,10
34399018975,34399018974,-1,734,1211,10
34399817155,34399817152,-3,1220,2105,10
34399988209,34399988210,1,1044,876,10
34402481090,34402481090,0,1066,1588,10
34407622686,34407622687,1,836,1528,10
34409610738,34409610744,6,1429,1036,10
34414374402,34414374400,-2,1542,2096,10
34415454124,34415454122,-2,1442,2840,10
34416598307,34416598305,-2,1069,2333,10
34424229761,34424229759,-2,1536,2900,10
34424736197,34424736197,0,1295,2078,10
34428370784,34428370781,-3,1479,1981,10
34430693311,34430693310,-1,1282,2018,10
34432571562,34432571562,0,761,1259,10
34434027101,34434027101,0,2991,3148,10
34434484698,34434484697,-1,973,1843,10
34435910742,34435910741,-1,876,1220,10
34436171947,34436171948,1,1503,1510,10
34436464107,34436464107,0,1211,2486,10
34439855282,34439855282,0,876,1178,10
34442113724,34442113724,0,1098,2069,10
34450583111,34450583111,0,1882,2902,10
34453807522,34453807526,4,4142,3150,10
34456719973,34456719972,-1,1673,2685,10
34460023551,34460023547,-4,845,1494,10
34463972732,34463972729,-3,1076,2067,10
34465082930,34465082931,1,1389,1576,10
34466987049,34466987046,-3,1283,2492,10
34471208658,34471208657,-1,959,1295,10
34472667858,34472667857,-1,944,1124,10
34478141082,34478141079,-3,1476,2539,10
34483301870,34483301867,-3,1054,3434,10
34484116761,34484116756,-5,1177,2560,10
34485144331,34485144329,-2,1137,1959,10
34487290094,34487290109,15,9655,51837,10
34492374346,34492374345,-1,1398,1980,10
34495207139,34495207139,0,1343,2150,10
34496113313,34496113312,-1,1539,2055,10
34498085310,34498085308,-2,963,1783,10
34498846763,34498846766,3,1661,1625,10
34500804072,34500804067,-5,1090,1694,10
34502911934,34502911932,-2,801,1981,10
34503763040,34503763040,0,1312,1641,10
34506256253,34506256250,-3,1215,2221,10
34507014993,34507014990,-3,1135,2006,10
34509598252,34509598249,-3,1071,1967,10
34521307580,34521307579,-1,1124,1558,10
34533184934,34533184932,-2,1269,1515,10
34534739755,34534739751,-4,1288,2432,10
34537169727,34537169721,-6,984,1481,10
34537485970,34537485966,-4,1108,2741,10
34539865967,34539865966,-1,1153,1914,10
34544760585,34544760582,-3,1436,2654,10
34548051465,34548051463,-2,960,1935,10
34548808039,34548808035,-4,1280,2026,10
34549261809,34549261809,0,1008,1322,10
34551418809,34551418807,-2,1344,2524,10
34558002438,34558002437,-1,1353,2316,10
34561519707,34561519706,-1,877,1301,10
34562277973,34562277970,-3,1105,1817,10
34565662256,34565662257,1,849,1581,10
34571660170,34571660170,0,1121,1795,10
34577197245,34577197246,1,1663,1521,10
34578458986,34578458986,0,1093,1900,10
34581316634,34581316634,0,1550,2553,10
34583100257,34583100256,-1,1383,2039,10
34586430853,34586430854,1,1608,1960,10
34596310399,34596310396,-3,1613,1749,10
34598589987,34598589984,-3,987,1824,10
34600820511,34600820511,0,1784,2908,10
34601568595,34601568593,-2,1411,2400,10
34603106730,34603106729,-1,1050,2426,10
34606958746,34606958743,-3,1156,1879,10
34610857504,34610857503,-1,1586,2368,10
34614391847,34614391846,-1,721,1072,10
34614937173,34614937193,20,1263,1432,10
34615791903,34615791903,0,1411,2061,10
34619411336,34619411333,-3,1331,2007,10
34619694323,34619694301,-22,358,649,10
34623604142,34623604138,-4,955,1741,10
34624539034,34624539030,-4,828,1413,10
34629888507,34629888503,-4,970,1985,10
34631379504,34631379502,-2,1206,1687,10
34633197790,34633197790,0,1605,1470,10
34643445072,34643445084,12,68,661,10
34644961122,34644961121,-1,1536,2528,10
34645080157,34645080153,-4,1314,2566,10
34649507859,34649507858,-1,2169,3380,10
34654110809,34654110810,1,1177,1631,10
34657206595,34657206594,-1,1179,2167,10
34658239859,34658239859,0,620,1144,10
34664346594,34664346594,0,1728,2419,10
34668221458,34668221457,-1,1234,2399,10
34669845634,34669845632,-2,1826,2239,10
34670456975,34670456973,-2,1205,2691,10
34671043302,34671043298,-4,1149,1179,10
34676980074,34676980069,-5,1604,3241,10
34678468374,34678468373,-1,1134,1677,10
34679189350,34679189349,-1,1148,1650,10
34680523973,34680523971,-2,1200,2326,10
34681190176,34681190174,-2,1230,1690,10
34681573926,34681573927,1,1305,1685,10
34681935136,34681935133,-3,940,1479,10
34683134825,34683134825,0,1471,2363,10
34683984538,34683984538,0,1489,1981,10
34687600875,34687600874,-1,942,1627,10
34689742570,34689742566,-4,927,1891,10
34695438421,34695438423,2,1181,1689,10
34703203716,34703203710,-6,101,1096,10
34706284378,34706284377,-1,1147,2056,10
34708116134,34708116133,-1,1450,2195,10
34710428590,34710428589,-1,1621,2771,10
34711294014,34711294021,7,3175,1301,10
34716992966,34716992965,-1,1758,2937,10
34717109166,34717109165,-1,1056,1867,10
34718852478,34718852481,3,2381,1621,10
34724039933,34724039931,-2,1093,1203,10
34727512452,34727512450,-2,1548,2188,10
34735281863,34735281868,5,3420,2553,10
34741430125,34741430123,-2,1452,1741,10
34747830858,34747830859,1,1162,1492,10
34749186375,34749186373,-2,915,2182,10
34749887457,34749887453,-4,1496,1791,10
34751177330,34751177331,1,617,891,10
34752969170,34752969165,-5,1148,5229,10
34755205804,34755205809,5,4492,2192,10
34755505994,34755505991,-3,1398,1574,10
34756132515,34756132514,-1,1169,2094,10
34764461206,34764461205,-1,982,1365,10
34768820326,34768820333,7,5844,2352,10
34770062758,34770062761,3,2655,1345,10
34779334855,34779334856,1,1200,1608,10
34781924642,34781924640,-2,1489,2185,10
34784305368,34784305367,-1,1543,2129,10
34788226733,34788226732,-1,1246,1602,10
34801543735,34801543733,-2,1586,2909,10
34802845287,34802845285,-2,1270,1634,10
34803792593,34803792591,-2,1425,2466,10
34804416561,34804416559,-2,1449,2134,10
34804701846,34804701846,0,1070,1241,10
34805038616,34805038616,0,1557,1864,10
34809720784,34809720785,1,1669,2299,10
34811314121,34811314122,1,1130,1196,10
34824033089,34824033083,-6,1151,2699,10
34825077943,34825077942,-1,1211,1561,10
34825787062,34825787061,-1,1145,1853,10
34826013909,34826013907,-2,874,1858,10
34827738887,34827738886,-1,1686,2529,10
34828371250,34828371249,-1,1386,1494,10
34830688431,34830688435,4,1126,916,10
34831433067,34831433062,-5,1096,1752,10
34834899440,34834899439,-1,1472,1747,10
34838640335,34838640335,0,962,1854,10
34841471908,34841471906,-2,1676,3243,10
34844880207,34844880206,-1,1189,2014,10
34847257785,34847257784,-1,758,1242,10
34847844450,34847844449,-1,1355,2078,10
34855968981,34855968982,1,1481,1676,10
34858353027,34858353026,-1,1421,2214,10
34858740053,34858740052,-1,1071,1998,10
34859716643,34859716642,-1,1318,1621,10
34859982926,34859982926,0,1262,1248,10
34862638126,34862638124,-2,2437,3499,10
34869134633,34869134630,-3,816,1680,10
34870065520,34870065511,-9,905,1794,10
34872820700,34872820697,-3,2610,5201,10
34874055438,34874055435,-3,1110,2301,10
34877593883,34877593882,-1,1532,2759,10
34879417983,34879417982,-1,1012,1035,10
34892269581,34892269579,-2,856,1241,10
34893327607,34893327606,-1,1482,2156,10
34895686409,34895686407,-2,1363,1263,10
34896073084,34896073082,-2,1214,1717,10
34899569738,34899569737,-1,1736,2686,10
34901222961,34901222959,-2,1070,2411,10
34901439914,34901439913,-1,1723,2488,10
34902938106,34902938105,-1,983,1466,10
34903121871,34903121870,-1,1477,2845,10
34904468386,34904468388,2,1335,1656,10
34906464626,34906464626,0,1533,1809,10
34912286629,34912286625,-4,18828,16986,10
34914798432,34914798431,-1,1380,1977,10
34916216638,34916216638,0,1294,2195,10
34917500718,34917500720,2,1816,1561,10
34920991533,34920991531,-2,1573,2884,10
34922365531,34922365535,4,1592,1480,10
34922968012,34922968009,-3,1587,2143,10
34929817026,34929817033,7,9778,4506,10
34930040515,34930040514,-1,1414,1939,10
34936203143,34936203142,-1,1095,1904,10
34936763046,34936763046,0,1121,1941,10
34941202480,34941202477,-3,1371,2315,10
34942213067,34942213065,-2,1389,1708,10
34944204838,34944204838,0,899,1650,10
34945485695,34945485695,0,706,1991,10
34947093855,34947093855,0,1615,2182,10
34961631613,34961631611,-2,1025,1620,10
34962214861,34962214857,-4,1037,2183,10
34965007935,34965007930,-5,1041,4756,10
34965561432,34965561430,-2,1444,2140,10
34976245005,34976245001,-4,1729,3635,10
34981085478,34981085482,4,1485,1437,10
34981649298,34981649299,1,1354,2149,10
34983713656,34983713657,1,950,1909,10
34985597082,34985597082,0,910,1418,10
34990490626,34990490624,-2,1170,1783,10
34990725661,34990725660,-1,939,1880,10
34992170839,34992170840,1,1409,1748,10
34993317571,34993317568,-3,990,2030,10
34995376872,34995376872,0,2042,1956,10
34995986558,34995986558,0,1403,2155,10
34998729171,34998729174,3,2575,2212,10
35001265914,35001265911,-3,1165,1651,10
35003990122,35003990122,0,1207,2243,10
35004351171,35004351171,0,609,837,10
35004704842,35004704838,-4,888,2048,10
35009383303,35009383302,-1,1255,2359,10
35011189532,35011189530,-2,1466,2570,10
35011425874,35011425867,-7,2563,9887,10
35014547587,35014547583,-4,1095,2157,10
35018464828,35018464826,-2,1390,1616,10
35024867211,35024867212,1,1611,1784,10
35025063670,35025063669,-1,1818,2009,10
35026913099,35026913099,0,1109,1924,10
35030831001,35030831000,-1,1459,2917,10
35030964840,35030964840,0,1339,2078,10
35031198034,35031198032,-2,538,1783,10
35031839206,35031839206,0,1727,3220,10
35033666802,35033666802,0,1545,1347,10
35034616949,35034616949,0,1237,2251,10
35037668385,35037668383,-2,967,1459,10
35038287818,35038287819,1,1300,1713,10
35039481662,35039481659,-3,905,2041,10
35043081401,35043081394,-7,1244,3087,10
35043228873,35043228879,6,1093,1352,10
35045604143,35045604137,-6,1088,2541,10
35047092450,35047092450,0,14338,16082,10
35054387067,35054387079,12,11597,34182,10
35058861287,35058861281,-6,848,1935,10
35066519435,35066519433,-2,895,1326,10
35071986539,35071986537,-2,1325,2121,10
35072583403,35072583405,2,967,1591,10
35073203455,35073203451,-4,1318,1779,10
35073521257,35073521260,3,1165,1935,10
35087693486,35087693485,-1,660,1191,10
35089196001,35089196000,-1,1579,2294,10
35089342235,35089342230,-5,829,1951,10
35094288691,35094288691,0,1133,1592,10
35095309482,35095309498,16,4961,1334,10
35097364393,35097364393,0,1216,1923,10
35099480859,35099480861,2,1412,1496,10
35100457722,35100457739,17,179,602,10
35101930973,35101930972,-1,1270,2429,10
35102508303,35102508302,-1,866,1678,10
35109554058,35109554059,1,1476,1351,10
35111606782,35111606795,13,800,1331,10
35115735281,35115735279,-2,772,1395,10
35116228411,35116228406,-5,829,2116,10
35118630541,35118630541,0,1218,1785,10
35118863075,35118863074,-1,1695,1779,10
35119573033,35119573034,1,1114,1715,10
35121100315,35121100314,-1,1258,1920,10
35121706403,35121706403,0,969,1753,10
35121761000,35121760999,-1,939,901,10
35123079355,35123079353,-2,929,2034,10
35125476044,35125476042,-2,1487,3021,10
35128430721,35128430719,-2,1200,1753,10
35129799857,35129799855,-2,1291,1955,10
35129883051,35129883040,-11,5550,17137,10
35133727042,35133727044,2,1631,1488,10
35135473555,35135473555,0,944,2036,10
35137234485,35137234485,0,1249,1964,10
35138323010,35138323008,-2,1507,2229,10
35139219656,35139219653,-3,973,1423,10
35139399731,35139399745,14,421,1986,10
35141227515,35141227513,-2,1354,2008,10
35144565703,35144565700,-3,1405,2418,10
35147499860,35147499862,2,1965,1385,10
35153328063,35153328063,0,1165,1882,10
35159208714,35159208713,-1,1078,1907,10
35162419985,35162419985,0,1011,1430,10
35167832595,35167832595,0,1306,1406,10
35170492694,35170492690,-4,1031,1522,10
35172711015,35172711014,-1,1021,1627,10
35174041275,35174041276,1,1675,1775,10
35174793102,35174793100,-2,1027,1799,10
35175033747,35175033747,0,1491,2034,10
35177516675,35177516674,-1,1716,2042,10
35177939056,35177939058,2,1720,1727,10
35178184507,35178184505,-2,1228,2469,10
35178216006,35178216005,-1,1135,1890,10
35178637167,35178637163,-4,1334,1763,10
35179239347,35179239343,-4,1179,2000,10
35179309454,35179309451,-3,1312,2164,10
35180334978,35180334976,-2,975,2208,10
35188143242,35188143245,3,2939,1965,10
35195024522,35195024520,-2,1257,1793,10
35196046019,35196046017,-2,1188,1974,10
35196129710,35196129709,-1,1469,2491,10
35196469266,35196469262,-4,1193,1688,10
35198951523,35198951523,0,813,1681,10
35200633337,35200633335,-2,1307,1980,10
35208369569,35208369569,0,1384,1943,10
35209604466,35209604469,3,2060,1709,10
35213336806,35213336805,-1,1202,1555,10
35216997888,35216997885,-3,1202,2210,10
35221389994,35221389994,0,1011,2303,10
35221857692,35221857694,2,1435,1362,10
35225676934,35225676934,0,1233,1849,10
35226744193,35226744192,-1,1632,2714,10
35231951911,35231951909,-2,1494,2017,10
35234450727,35234450725,-2,1088,1490,10
35240784228,35240784228,0,1313,1907,10
35241125338,35241125317,-21,1171,2641,10
35250461151,35250461150,-1,1292,2046,10
35254830471,35254830469,-2,1135,1330,10
35261295763,35261295764,1,1628,3005,10
35261650728,35261650727,-1,998,1311,10
35262018674,35262018686,12,429,1199,10
35264772297,35264772297,0,1434,1494,10
35264808003,35264808001,-2,1475,1604,10
35264904362,35264904342,-20,1175,2150,10
35265702055,35265702052,-3,1024,1807,10
35268027240,35268027242,2,1334,1490,10
35273481757,35273481757,0,1283,1798,10
35274567442,35274567438,-4,676,1688,10
35285307323,35285307319,-4,1376,2393,10
35286214838,35286214837,-1,1278,1919,10
35286534280,35286534278,-2,1409,1664,10
35290622387,35290622381,-6,742,5996,10
35291649655,35291649654,-1,1185,2195,10
35295925002,35295925002,0,986,2380,10
35297690870,35297690875,5,1289,1223,10
35312310482,35312310482,0,944,1832,10
35314827483,35314827482,-1,993,2027,10
35316363805,35316363804,-1,1411,2774,10
35317288994,35317288992,-2,662,1222,10
35319728969,35319728966,-3,1422,2978,10
35321829921,35321829917,-4,1865,5765,10
35322072068,35322072064,-4,1125,2312,10
35324877525,35324877524,-1,1542,2242,10
35326062534,35326062534,0,1649,2392,10
35327981922,35327981921,-1,1179,1761,10
35328391730,35328391730,0,1422,1725,10
35329451962,35329451959,-3,999,1582,10
35332193976,35332193976,0,1419,3081,10
35333578281,35333578280,-1,1625,3624,10
35336621135,35336621134,-1,1595,3066,10
35336672386,35336672383,-3,1089,2200,10
35337977492,35337977489,-3,961,1600,10
35338830194,35338830193,-1,1528,2383,10
35339650922,35339650922,0,814,1698,10
35345980293,35345980299,6,4585,2140,10
35346510329,35346510327,-2,1783,2741,10
35348186602,35348186599,-3,1038,1655,10
35348562179,35348562181,2,133,861,10
35350270095,35350270094,-1,1234,1509,10
35350885603,35350885602,-1,1176,2204,10
35353617702,35353617700,-2,1313,2019,10
35354908480,35354908479,-1,1394,1619,10
35360435678,35360435678,0,1223,1500,10
35365502442,35365502442,0,882,1515,10
35365973830,35365973829,-1,1191,1539,10
35366606346,35366606325,-21,1322,1912,10
35367486288,35367486290,2,3235,3804,10
35368976861,35368976861,0,1056,1516,10
35376026661,35376026660,-1,1528,1686,10
35376068921,35376068914,-7,1332,1398,10
35377292611,35377292629,18,804,1458,10
35379573230,35379573228,-2,891,1520,10
35385036089,35385036089,0,1607,2180,10
35385128656,35385128655,-1,1799,1486,10
35385544198,35385544197,-1,1539,1544,10
35388828118,35388828117,-1,1159,1563,10
35390980433,35390980431,-2,1243,1668,10
35391388807,35391388806,-1,1732,1650,10
35398659130,35398659130,0,1779,1563,10
35399293787,35399293788,1,1368,1412,10
35400392929,35400392916,-13,2710,681,10
35401057250,35401057256,6,1435,640,10
35409810815,35409810814,-1,1423,1633,10
35414759009,35414759008,-1,1529,1952,10
35420669014,35420669014,0,789,1391,10
35426037478,35426037478,0,1021,1768,10
35427583769,35427583752,-17,1350,2271,10
35432404557,35432404556,-1,1269,1540,10
35433585131,35433585129,-2,1297,3243,10
35434872746,35434872745,-1,1364,3181,10
35438290770,35438290769,-1,1259,1500,10
35438593625,35438593627,2,2773,2229,10
35439411623,35439411619,-4,1304,2812,10
35440101793,35440101789,-4,1558,3228,10
35440290093,35440290098,5,2473,1327,10
35441935946,35441935945,-1,1853,2861,10
35443147219,35443147218,-1,1603,2866,10
35445150662,35445150679,17,1589,1266,10
35447751366,35447751369,3,1685,945,10
35449344171,35449344169,-2,1480,2331,10
35452600019,35452600018,-1,1358,1383,10
35452969715,35452969707,-8,934,1648,10
35454594799,35454594798,-1,1491,1856,10
35460979107,35460979106,-1,1069,2345,10
35461791864,35461791866,2,1269,1276,10
35467076643,35467076642,-1,1191,1893,10
35475344726,35475344726,0,1166,2224,10
35480895188,35480895187,-1,1126,1944,10
35481790988,35481791006,18,168,523,10
35482591358,35482591358,0,929,928,10
35492683011,35492683006,-5,2223,6193,10
35494472941,35494472938,-3,1292,1803,10
35504931344,35504931341,-3,1384,2551,10
35509326474,35509326472,-2,1192,1407,10
35509623473,35509623474,1,1073,1125,10
35513354263,35513354262,-1,755,1229,10
35515885796,35515885795,-1,1743,3190,10
35527556879,35527556878,-1,1266,1858,10
35529108598,35529108597,-1,1176,2171,10
35529523678,35529523678,0,1531,2162,10
35532532881,35532532880,-1,1367,2867,10
35534386048,35534386046,-2,1610,2017,10
35541766077,35541766077,0,1184,1809,10
35545042840,35545042839,-1,1413,2179,10
35546469826,35546469824,-2,1478,3725,10
35546588729,35546588727,-2,2658,3855,10
35551767709,35551767708,-1,1319,1990,10
35554579331,35554579335,4,4054,3539,10
35555080857,35555080855,-2,1410,2217,10
35555496411,35555496410,-1,1501,2564,10
35559444742,35559444741,-1,1808,2378,10
35562595182,35562595181,-1,1497,1673,10
35563721114,35563721114,0,1906,2549,10
35564493535,35564493533,-2,1510,2337,10
35566383885,35566383884,-1,1402,2065,10
35569351506,35569351505,-1,1157,2022,10
35570242079,35570242079,0,1382,1525,10
35570738274,35570738271,-3,1383,2584,10
35572354826,35572354825,-1,1360,2151,10
35574551758,35574551757,-1,1280,2411,10
35582776191,35582776190,-1,1136,1811,10
35582940273,35582940255,-18,1486,2432,10
35585148370,35585148372,2,2483,2264,10
35585398583,35585398582,-1,955,1799,10
35586783478,35586783478,0,817,1390,10
35589644831,35589644829,-2,1259,2642,10
35590862285,35590862288,3,1196,1489,10
35591255962,35591255955,-7,1131,6411,10
35591932111,35591932109,-2,1440,2204,10
35592920307,35592920304,-3,1199,2185,10
35599294614,35599294613,-1,1426,2152,10
35601022082,35601022082,0,1342,2107,10
35601477655,35601477655,0,778,1642,10
35601622009,35601622014,5,2681,1491,10
35603737610,35603737606,-4,1132,1529,10
35606682687,35606682685,-2,1218,2412,10
35610938101,35610938100,-1,1296,2187,10
35612897441,35612897447,6,3739,1496,10
35614147687,35614147682,-5,1133,1695,10
35616153826,35616153823,-3,1235,2037,10
35616223418,35616223418,0,1570,2640,10
35617087203,35617087219,16,23,1237,10
35617970550,35617970555,5,2661,1647,10
35618483495,35618483494,-1,1513,2360,10
35619074566,35619074563,-3,1371,2167,10
35619987870,35619987869,-1,1782,2440,10
35622895091,35622895090,-1,1007,1284,10
35624773162,35624773161,-1,1458,1774,10
35626390683,35626390682,-1,1063,1767,10
35631777222,35631777221,-1,1208,2686,10
35632213205,35632213201,-4,1267,1985,10
35634471193,35634471191,-2,1025,2137,10
35638345439,35638345434,-5,1091,3135,10
35638384628,35638384645,17,974,1636,10
35640189740,35640189738,-2,1306,2504,10
35642303777,35642303775,-2,1219,2708,10
35642468104,35642468091,-13,429,1072,10
35644210795,35644210794,-1,903,2533,10
35645724061,35645724061,0,1776,3038,10
35647911426,35647911423,-3,1245,1610,10
35651878721,35651878720,-1,1199,1974,10
35653935606,35653935608,2,2033,1794,10
35654016078,35654016082,4,883,1600,10
35655876203,35655876201,-2,971,1383,10
35657460552,35657460553,1,1082,2081,10
35658242043,35658242041,-2,1374,2061,10
35658839438,35658839436,-2,1066,1410,10
35662292103,35662292083,-20,1041,1632,10
35666937563,35666937563,0,1144,1758,10
35668592637,35668592635,-2,1046,1727,10
35671460515,35671460513,-2,995,2812,10
35675028226,35675028224,-2,984,1328,10
35675663146,35675663125,-21,1147,1843,10
35676646107,35676646106,-1,2064,2099,10
35677808266,35677808265,-1,1316,2414,10
35678819651,35678819668,17,1499,2088,10
35686650130,35686650135,5,3639,2036,10
35691469905,35691469902,-3,929,2118,10
35696711206,35696711204,-2,1008,1850,10
35697929673,35697929672,-1,1335,1951,10
35702786185,35702786185,0,1435,1491,10
35704964038,35704964036,-2,1378,1745,10
35712494810,35712494809,-1,1728,2900,10
35715060315,35715060313,-2,1010,1856,10
35716639153,35716639154,1,1456,1959,10
35720953941,35720953940,-1,1676,2028,10
35722243557,35722243555,-2,1116,2154,10
35722825182,35722825191,9,3236,1036,10
35726986409,35726986417,8,3328,1344,10
35731300422,35731300422,0,1759,2088,10
35732691701,35732691697,-4,1219,1964,10
35734783150,35734783147,-3,1297,1855,10
35736082695,35736082696,1,1029,2419,10
35739144582,35739144581,-1,549,1125,10
35742277767,35742277765,-2,1391,1791,10
35743583730,35743583727,-3,1210,2061,10
35743657373,35743657379,6,1616,704,10
35744837019,35744837018,-1,831,1712,10
35745389730,35745389731,1,984,1041,10
35745570934,35745570930,-4,1011,1172,10
35751187739,35751187739,0,1786,2743,10
35753716911,35753716909,-2,954,2278,10
35754013761,35754013758,-3,1412,3180,10
35757759509,35757759508,-1,1643,2138,10
35758201314,35758201314,0,789,1137,10
35759028669,35759028669,0,682,2012,10
35760503849,35760503849,0,1084,2651,10
35760907573,35760907571,-2,1190,1338,10
35761471722,35761471721,-1,1221,1695,10
35762081514,35762081513,-1,954,2136,10
35762747124,35762747124,0,1329,1949,10
35766852590,35766852588,-2,1012,1456,10
35767462574,35767462571,-3,1112,1692,10
35768151669,35768151669,0,1305,1645,10
35768818250,35768818248,-2,1586,1841,10
35774618023,35774618022,-1,1088,1944,10
35774960703,35774960702,-1,1596,3069,10
35776194681,35776194687,6,2808,1102,10
35781079628,35781079628,0,1576,2064,10
35787318118,35787318117,-1,1122,2047,10
35788132230,35788132227,-3,1558,2516,10
35789079954,35789079952,-2,1050,1847,10
35795181941,35795181934,-7,879,4359,10
35797739879,35797739879,0,1594,2134,10
35797838291,35797838297,6,2340,1105,10
35798747366,35798747366,0,787,2379,10
35799368471,35799368471,0,730,1169,10
35799952482,35799952479,-3,1131,1970,10
35800554826,35800554824,-2,1373,1731,10
35801793957,35801793955,-2,999,1600,10
35803564326,35803564324,-2,1520,2768,10
35806524495,35806524494,-1,1135,2164,10
35807168050,35807168050,0,1739,1951,10
35809149343,35809149340,-3,1227,1491,10
35810941622,35810941618,-4,1414,2712,10
35814552817,35814552815,-2,992,2264,10
35816167554,35816167558,4,2133,789,10
35823286922,35823286919,-3,1211,2092,10
35823676474,35823676474,0,1225,2644,10
35826506005,35826506002,-3,1157,2065,10
35828176809,35828176806,-3,1272,2346,10
35828745542,35828745541,-1,1342,1950,10
35832150197,35832150197,0,1022,1502,10
35838487054,35838487055,1,1410,1885,10
35844121958,35844121967,9,976,1168,10
35848691685,35848691683,-2,1422,2302,10
35852935835,35852935834,-1,1141,2296,10
35853125030,35853125036,6,1596,1389,10
35854623528,35854623525,-3,1681,2142,10
35855921791,35855921788,-3,25328,19797,10
35857065694,35857065692,-2,1060,1931,10
35863420442,35863420441,-1,817,1659,10
35864834275,35864834272,-3,1526,3181,10
35865481399,35865481396,-3,986,1861,10
35867304771,35867304771,0,629,1839,10
35870073739,35870073717,-22,946,2479,10
35873455493,35873455492,-1,842,1202,10
35874224208,35874224207,-1,1944,2511,10
35879032398,35879032396,-2,1376,2233,10
35880625818,35880625818,0,1570,1695,10
35884904970,35884904966,-4,871,1617,10
35888273523,35888273521,-2,1170,1239,10
35896794321,35896794319,-2,869,1908,10
35899663825,35899663824,-1,1219,2315,10
35901990784,35901990782,-2,1349,2334,10
35902456567,35902456565,-2,1351,1714,10
35902768514,35902768519,5,3785,1581,10
35903992009,35903992008,-1,1212,1882,10
35904396701,35904396700,-1,1237,1937,10
35905134466,35905134467,1,1282,1874,10
35908635805,35908635805,0,1399,2338,10
35911002111,35911002115,4,25795,22974,10
35912078025,35912078023,-2,1186,2192,10
35913972246,35913972243,-3,1032,2736,10
35918312956,35918312958,2,1015,1380,10
35919673337,35919673340,3,913,1406,10
35921884489,35921884490,1,1242,2088,10
35922988438,35922988437,-1,1052,2237,10
35923402507,35923402526,19,653,1549,10
35926446791,35926446787,-4,1026,1557,10
35930741360,35930741358,-2,1089,2071,10
35931568242,35931568241,-1,1149,2820,10
35935758074,35935758077,3,3478,2477,10
35935882261,35935882257,-4,1421,2277,10
35939924208,35939924210,2,2069,2275,10
35943555588,35943555586,-2,1764,2688,10
35946798779,35946798778,-1,939,1917,10
35950358566,35950358566,0,1062,2089,10
35951882750,35951882747,-3,924,1854,10
35953205091,35953205093,2,1422,1576,10
35953344197,35953344199,2,1236,2181,10
35953633608,35953633630,22,124,705,10
35954968881,35954968879,-2,1096,2415,10
35957241079,35957241079,0,841,1667,10
35959977418,35959977418,0,651,1402,10
35962082373,35962082378,5,1651,967,10
35962473625,35962473622,-3,1715,2489,10
35962819332,35962819350,18,1597,2246,10
35963164318,35963164322,4,2056,1628,10
35969281381,35969281379,-2,1148,2017,10
35969420654,35969420656,2,3035,3199,10
35973260285,35973260285,0,1435,1996,10
35975838433,35975838430,-3,1194,1708,10
35976068414,35976068409,-5,947,3689,10
35981085759,35981085758,-1,964,1770,10
35981353092,35981353111,19,1185,1921,10
35984987681,35984987681,0,1320,1556,10
35986180354,35986180352,-2,1207,1984,10
35986433614,35986433611,-3,1758,2611,10
35986715109,35986715110,1,623,677,10
35987477095,35987477093,-2,1160,2106,10
35994437425,35994437425,0,1862,2242,10
35995523923,35995523922,-1,966,1800,10
35998380726,35998380725,-1,2345,2043,10
36002284561,36002284560,-1,1198,1966,10
36003603288,36003603277,-11,1086,1849,10
36005368131,36005368130,-1,908,1670,10
36006318925,36006318905,-20,1313,1671,10
36011054117,36011054117,0,1259,1802,10
36011226315,36011226313,-2,850,1490,10
36011767780,36011767798,18,1452,2389,10
36016280314,36016280311,-3,1230,2242,10
36018879445,36018879445,0,1299,1948,10
36022583946,36022583950,4,556,1000,10
36024017842,36024017840,-2,1230,1780,10
36029183523,36029183520,-3,1026,1942,10
36039155645,36039155645,0,956,2181,10
36039286992,36039286974,-18,936,1746,10
36039683842,36039683840,-2,1575,2234,10
36040109761,36040109757,-4,1551,3819,10
36041956593,36041956589,-4,1179,1855,10
36043948021,36043948019,-2,1603,2736,10
36047203141,36047203137,-4,1111,1404,10
36048480610,36048480598,-12,1024,1848,10
36056025446,36056025444,-2,657,1656,10
36057385346,36057385346,0,1113,2612,10
36057592690,36057592690,0,1101,1744,10
36058117590,36058117599,9,1934,901,10
36060441372,36060441371,-1,1304,1468,10
36063315638,36063315634,-4,2359,5186,10
36069266868,36069266866,-2,1629,2667,10
36074854339,36074854338,-1,958,2167,10
36075395839,36075395818,-21,999,2052,10
36076752014,36076752010,-4,1120,1892,10
36079075399,36079075401,2,1559,2335,10
36082676538,36082676534,-4,876,2643,10
36083810171,36083810171,0,973,1500,10
36084835919,36084835915,-4,1251,2104,10
36087591064,36087591064,0,1396,2007,10
36088938387,36088938385,-2,1179,2137,10
36091938011,36091938010,-1,1008,1827,10
36092989535,36092989534,-1,995,1556,10
36093571379,36093571380,1,1406,2247,10
36097137517,36097137514,-3,1233,1912,10
36098043119,36098043125,6,1671,1289,10
36098284245,36098284244,-1,1196,1989,10
36099547109,36099547110,1,828,1470,10
36107422630,36107422629,-1,1446,2365,10
36109986653,36109986651,-2,1615,1983,10
36110270110,36110270110,0,1049,1342,10
36110614629,36110614627,-2,1322,1658,10
36111388343,36111388341,-2,1012,1527,10
36111653169,36111653170,1,1439,1590,10
36113909365,36113909362,-3,1186,1508,10
36114076766,36114076765,-1,1739,2267,10
36116206245,36116206243,-2,1054,1700,10
36118271527,36118271526,-1,1207,1953,10
36118669869,36118669867,-2,1033,1648,10
36118733445,36118733445,0,747,1883,10
36121421550,36121421559,9,17707,25519,10
36121515010,36121515007,-3,1072,2239,10
36123600231,36123600230,-1,1522,1250,10
36123756319,36123756317,-2,625,1279,10
36126841669,36126841667,-2,1471,2585,10
36126878642,36126878641,-1,1323,2005,10
36129802661,36129802659,-2,1248,2064,10
36135299878,36135299878,0,1409,1596,10
36135673985,36135673987,2,1152,1066,10
36139093062,36139093061,-1,1446,2251,10
36141245219,36141245216,-3,1202,2023,10
36143805206,36143805204,-2,827,1668,10
36144761925,36144761923,-2,1875,2754,10
36144816551,36144816549,-2,1007,2130,10
36145678355,36145678353,-2,778,1564,10
36148184165,36148184170,5,6897,25409,10
36148862864,36148862851,-13,1116,1435,10
36150601569,36150601567,-2,1572,1692,10
36152490786,36152490785,-1,1686,3065,10
36154080623,36154080621,-2,1015,1966,10
36160630059,36160630060,1,1071,1240,10
36169702043,36169702042,-1,1469,2345,10
36181493027,36181493025,-2,777,1734,10
36182383718,36182383718,0,1594,2523,10
36185103633,36185103632,-1,1635,1842,10
36186071165,36186071162,-3,497,1037,10
36188803030,36188803029,-1,977,1842,10
36197563725,36197563724,-1,1601,2546,10
36200976663,36200976661,-2,1060,1882,10
36212243281,36212243277,-4,1223,2319,10
36213111285,36213111284,-1,2081,2751,10
36219004384,36219004383,-1,991,1608,10
36220445481,36220445481,0,1290,2335,10
36220564570,36220564569,-1,738,1299,10
36226940099,36226940099,0,995,1059,10
36229189682,36229189681,-1,1236,1330,10
36236524711,36236524709,-2,884,1385,10
36238400378,36238400377,-1,3487,13444,10
36238679117,36238679116,-1,1182,2298,10
36243617999,36243618000,1,1883,1891,10
36244226677,36244226677,0,1355,1565,10
36245149979,36245149978,-1,60,2623,10
36246407792,36246407789,-3,876,1570,10
36247105306,36247105325,19,956,1959,10
36248526233,36248526233,0,1301,1902,10
36250664209,36250664207,-2,937,1973,10
36252170886,36252170891,5,1757,1434,10
36252908087,36252908086,-1,2191,2855,10
36257786668,36257786667,-1,698,1371,10
36259137136,36259137133,-3,1077,2666,10
36260070674,36260070673,-1,948,2308,10
36264770011,36264770011,0,1226,2308,10
36264974563,36264974546,-17,1063,1344,10
36266285291,36266285290,-1,1632,2485,10
36268721202,36268721202,0,1244,1781,10
36269144555,36269144552,-3,906,1382,10
36271927341,36271927340,-1,1588,2369,10
36273416203,36273416202,-1,1271,2442,10
36274876037,36274876035,-2,1078,2679,10
36277452159,36277452158,-1,1045,2321,10
36280710064,36280710062,-2,1749,2586,10
36285133162,36285133162,0,1146,1919,10
36291008554,36291008556,2,943,1205,10
36295148781,36295148781,0,1692,1977,10
36295986118,36295986112,-6,1008,1863,10
36296144374,36296144373,-1,1434,2469,10
36297530146,36297530145,-1,1091,1427,10
36301073259,36301073259,0,864,1283,10
36301457998,36301457996,-2,1023,2224,10
36301958960,36301958958,-2,484,833,10
36305205613,36305205614,1,1248,1423,10
36313597886,36313597886,0,1271,1590,10
36314394629,36314394630,1,981,1213,10
36315801934,36315801932,-2,1561,2234,10
36327085162,36327085160,-2,1571,2412,10
36331679675,36331679673,-2,1354,1985,10
36334355229,36334355227,-2,1090,2263,10
36336490507,36336490502,-5,1078,2515,10
36342280962,36342280961,-1,1216,1907,10
36344333023,36344333025,2,22816,24737,10
36344874256,36344874255,-1,1579,2264,10
36345694666,36345694664,-2,1301,2918,10
36346190802,36346190801,-1,1791,2589,10
36346946242,36346946242,0,965,1597,10
36347666639,36347666638,-1,1546,1736,10
36348687376,36348687374,-2,1053,1524,10
36349004204,36349004215,11,276,921,10
36353972416,36353972414,-2,1736,1562,10
36355530643,36355530642,-1,933,1387,10
36357354606,36357354604,-2,845,1487,10
36357967334,36357967332,-2,1378,2021,10
36359250267,36359250266,-1,952,1303,10
36359504449,36359504444,-5,1207,3193,10
36362856191,36362856190,-1,1160,2075,10
36365513226,36365513224,-2,1821,1913,10
36368116702,36368116702,0,1635,2105,10
36371596930,36371596927,-3,1069,2103,10
36372049769,36372049773,4,998,1809,10
36373065454,36373065454,0,1124,1522,10
36376150937,36376150935,-2,840,2038,10
36377865203,36377865201,-2,952,2414,10
36378657370,36378657353,-17,1434,2518,10
36381723026,36381723026,0,1082,1731,10
36384814053,36384814053,0,887,1321,10
36385018506,36385018506,0,173,795,10
36390155009,36390155007,-2,1385,1814,10
36390230650,36390230649,-1,1701,1781,10
36390769813,36390769811,-2,1022,1629,10
36391592893,36391592891,-2,1411,2863,10
36393627196,36393627194,-2,1333,2135,10
36397948015,36397948015,0,1587,2100,10
36398313737,36398313738,1,1811,2083,10
36399510866,36399510864,-2,1310,1412,10
36402446661,36402446659,-2,1628,1538,10
36402664842,36402664861,19,1332,2143,10
36403248644,36403248642,-2,1269,1859,10
36403427322,36403427311,-11,972,1958,10
36410690537,36410690538,1,1088,1527,10
36412473844,36412473847,3,1885,1569,10
36413531654,36413531656,2,1609,1582,10
36414516010,36414516006,-4,1465,1560,10
36415096411,36415096411,0,1167,2203,10
36426732047,36426732048,1,1129,1544,10
36428749949,36428749949,0,1682,2231,10
36431309261,36431309258,-3,3274,4243,10
36437550313,36437550313,0,1082,1822,10
36439026304,36439026305,1,1520,1834,10
36441794755,36441794753,-2,1282,2353,10
36443491542,36443491541,-1,1113,2508,10
36445790449,36445790446,-3,1291,2482,10
36447597431,36447597429,-2,1013,1929,10
36448429675,36448429673,-2,1186,1650,10
36454061302,36454061301,-1,1001,2015,10
36454166770,36454166773,3,2172,2417,10
36457278938,36457278938,0,1460,1540,10
36468969030,36468969027,-3,662,1936,10
36472668362,36472668360,-2,913,2309,10
36472855114,36472855109,-5,919,1912,10
36473627216,36473627234,18,285,1355,10
36475219077,36475219075,-2,1086,1965,10
36476104235,36476104234,-1,929,1105,10
36476896586,36476896585,-1,1708,2207,10
36481130854,36481130851,-3,1475,3056,10
36481507069,36481507080,11,19084,31459,10
36481672018,36481672014,-4,1807,4699,10
36484054602,36484054601,-1,1608,2468,10
36486380045,36486380045,0,1276,2569,10
36489361518,36489361531,13,962,1689,10
36491890366,36491890366,0,1250,1690,10
36493570540,36493570533,-7,31533,84438,10
36493717050,36493717049,-1,1443,1845,10
36499650033,36499650032,-1,1382,1740,10
36500851026,36500851026,0,1403,1351,10
36504083179,36504083177,-2,1280,1888,10
36509103084,36509103087,3,1829,917,10
36516815349,36516815347,-2,1067,2663,10
36519702413,36519702411,-2,1363,1894,10
36522689789,36522689795,6,4959,1257,10
36526606417,36526606413,-4,1062,2259,10
36527385619,36527385618,-1,1356,2614,10
36528231883,36528231902,19,1175,1866,10
36528289281,36528289303,22,1325,1867,10
36530133505,36530133503,-2,1235,1575,10
36530992481,36530992473,-8,29953,14802,10
36533704285,36533704285,0,28583,44201,10
36534436247,36534436243,-4,838,1990,10
36535686856,36535686849,-7,1038,1886,10
36537745286,36537745286,0,1927,2163,10
36539563784,36539563781,-3,1391,1893,10
36541487043,36541487045,2,1126,1388,10
36543115970,36543115970,0,1090,1702,10
36549691151,36549691152,1,1242,1629,10
36562257783,36562257780,-3,1082,1829,10
36565209905,36565209903,-2,1297,2417,10
36570977858,36570977858,0,1263,1430,10
36573403563,36573403561,-2,1442,1666,10
36574333398,36574333394,-4,1435,1877,10
36576075265,36576075266,1,584,989,10
36576554272,36576554271,-1,993,1743,10
36580352797,36580352796,-1,1216,2241,10
36582905189,36582905188,-1,1865,2319,10
36583048671,36583048669,-2,962,2282,10
36588817066,36588817062,-4,1296,1610,10
36592142871,36592142874,3,2411,1503,10
36592305112,36592305120,8,11195,34089,10
36596551394,36596551394,0,1194,1725,10
36597209910,36597209907,-3,1433,1961,10
36598643998,36598643998,0,1057,1891,10
36602026826,36602026825,-1,1070,1846,10
36602824923,36602824925,2,1877,1314,10
36603934676,36603934679,3,55102,25138,10
36606790282,36606790282,0,1595,1163,10
36609070501,36609070494,-7,1073,5146,10
36611021102,36611021099,-3,729,1640,10
36611462864,36611462862,-2,1908,2963,10
36612654194,36612654193,-1,1393,2133,10
36619793571,36619793570,-1,2024,2048,10
36622050994,36622050993,-1,912,1813,10
36622200418,36622200415,-3,1016,2608,10
36622258199,36622258195,-4,1074,2337,10
36630751374,36630751375,1,572,1058,10
36630926691,36630926674,-17,1246,1462,10
36636936098,36636936097,-1,1535,2613,10
36637536068,36637536067,-1,1245,1634,10
36638331176,36638331173,-3,1633,2110,10
36638696816,36638696818,2,132,866,10
36639501275,36639501291,16,1306,2681,10
36640048241,36640048238,-3,1389,1526,10
36640492420,36640492421,1,1916,2868,10
36643125383,36643125383,0,644,1546,10
36644254269,36644254266,-3,1333,1727,10
36645071642,36645071642,0,3675,3919,10
36645194330,36645194328,-2,1150,1603,10
36651272638,36651272636,-2,1842,2013,10
36652972625,36652972623,-2,1330,2516,10
36655281978,36655281998,20,598,2542,10
36657785449,36657785450,1,32265,90487,10
36658250632,36658250631,-1,1275,2906,10
36659965616,36659965617,1,1799,1937,10
36661312331,36661312330,-1,1097,1827,10
36663013965,36663013965,0,1619,2112,10
36669516043,36669516041,-2,1106,1733,10
36669932875,36669932875,0,1257,2409,10
36675044845,36675044847,2,1747,1632,10
36675474648,36675474645,-3,885,1668,10
36677213559,36677213557,-2,1358,1673,10
36684102651,36684102649,-2,1454,2099,10
36684809615,36684809613,-2,1222,1810,10
36686657687,36686657686,-1,1147,1794,10
36689645011,36689645011,0,1573,2968,10
36691071687,36691071683,-4,1652,2522,10
36692446806,36692446806,0,888,1297,10
36693792344,36693792339,-5,1254,1770,10
36693972996,36693973007,11,440,974,10
36694740218,36694740214,-4,1195,2962,10
36695601182,36695601181,-1,943,1678,10
36703433053,36703433052,-1,954,1704,10
36718004046,36718004043,-3,833,1499,10
36719182214,36719182212,-2,905,1637,10
36719532490,36719532493,3,1236,877,10
36725508314,36725508313,-1,1124,1759,10
36726330346,36726330346,0,1089,2092,10
36728961347,36728961346,-1,1686,2259,10
36729725219,36729725218,-1,1175,2340,10
36730886606,36730886603,-3,1097,2540,10
36734605473,36734605473,0,936,2079,10
36735376249,36735376249,0,844,2163,10
36737447897,36737447899,2,1121,1599,10
36739842311,36739842309,-2,1467,2362,10
36741150176,36741150174,-2,1140,3055,10
36742395822,36742395818,-4,1805,2743,10
36746008769,36746008767,-2,1760,2627,10
36749274709,36749274707,-2,868,1577,10
36756602044,36756602041,-3,1624,2988,10
36759020002,36759020001,-1,1109,2110,10
36765786791,36765786791,0,1105,2342,10
36769856341,36769856338,-3,1231,1785,10
36770229302,36770229302,0,1500,1693,10
36775696659,36775696658,-1,1366,2199,10
36776903611,36776903608,-3,1417,2243,10
36782199866,36782199863,-3,1241,1783,10
36785765711,36785765709,-2,1016,2156,10
36788667613,36788667611,-2,1223,1995,10
36792491129,36792491128,-1,1665,1868,10
36793976002,36793976000,-2,1106,1424,10
36797536437,36797536436,-1,1559,2211,10
36798521790,36798521789,-1,1395,2393,10
36798591147,36798591146,-1,1221,1522,10
36799372995,36799372994,-1,1346,2128,10
36800126378,36800126374,-4,1377,1920,10
36801153609,36801153606,-3,1157,1312,10
36801975818,36801975817,-1,1207,2855,10
36804070042,36804070040,-2,1448,2294,10
36810409807,36810409806,-1,1372,2262,10
36815496018,36815496017,-1,1510,2125,10
36815974921,36815974917,-4,935,1385,10
36817441535,36817441533,-2,1229,2569,10
36817828003,36817828001,-2,1266,1821,10
36820141070,36820141072,2,1233,1839,10
36823823134,36823823131,-3,1099,1734,10
36825289219,36825289220,1,1320,2293,10
36828093814,36828093815,1,825,2110,10
36832847302,36832847299,-3,1429,2818,10
36839857819,36839857818,-1,1533,2101,10
36842537549,36842537547,-2,1743,3420,10
36845859187,36845859187,0,1155,1824,10
36849145962,36849145961,-1,1007,2449,10
36849830528,36849830525,-3,874,1922,10
36849884604,36849884621,17,513,1016,10
36852311869,36852311866,-3,1533,2250,10
36862001220,36862001216,-4,1339,2378,10
36862508603,36862508601,-2,1131,1723,10
36865075659,36865075659,0,935,1101,10
36866454939,36866454937,-2,1076,1481,10
36867092109,36867092109,0,1322,1423,10
36870939390,36870939388,-2,1004,2028,10
36875761249,36875761251,2,989,1870,10
36876962146,36876962142,-4,2019,2615,10
36877142138,36877142136,-2,1081,1440,10
36883881297,36883881298,1,1208,2095,10
36884134134,36884134133,-1,959,1651,10
36890175307,36890175305,-2,1261,1669,10
36893315231,36893315230,-1,1402,2146,10
36895472554,36895472554,0,1136,2138,10
36895936928,36895936927,-1,1005,1622,10
36896856006,36896856000,-6,1197,4865,10
36897393866,36897393887,21,237,793,10
36898559382,36898559381,-1,1248,2201,10
36898825239,36898825240,1,1127,1958,10
36901138643,36901138642,-1,1106,1862,10
36901882874,36901882874,0,1050,1384,10
36908228967,36908228966,-1,860,1487,10
36910636858,36910636858,0,1776,3052,10
36916563490,36916563490,0,1611,1835,10
36917505664,36917505662,-2,1544,1924,10
36919441602,36919441602,0,1274,2016,10
36920574665,36920574666,1,1857,2064,10
36923942250,36923942249,-1,1561,2119,10
36927886230,36927886229,-1,1020,1685,10
36931155850,36931155850,0,1396,2340,10
36931414178,36931414177,-1,1628,1895,10
36934154017,36934154015,-2,1600,2610,10
36937040482,36937040481,-1,746,1734,10
36938401061,36938401062,1,1077,1571,10
36940746561,36940746560,-1,1085,1783,10
36941237207,36941237206,-1,1592,2779,10
36942240171,36942240170,-1,1505,2051,10
36945118901,36945118903,2,1433,1308,10
36946093017,36946093016,-1,995,1711,10
36950102167,36950102166,-1,1603,2551,10
36951837622,36951837621,-1,1033,1618,10
36954653315,36954653315,0,1591,1838,10
36957709446,36957709446,0,1200,2509,10
36958040563,36958040543,-20,1336,1289,10
36958129533,36958129533,0,1413,2081,10
36964337202,36964337201,-1,1285,1992,10
36964964947,36964964946,-1,798,1249,10
36966379044,36966379051,7,16555,30200,10
36966913951,36966913950,-1,761,985,10
36967620609,36967620607,-2,997,1588,10
36968169683,36968169680,-3,1039,2362,10
36970689298,36970689295,-3,1094,1956,10
36971230808,36971230806,-2,1223,1754,10
36971631396,36971631412,16,667,1168,10
36972391138,36972391138,0,942,1637,10
36972949271,36972949271,0,962,1713,10
36973074379,36973074394,15,360,1499,10
36982724591,36982724590,-1,580,1222,10
36985162679,36985162678,-1,1157,2097,10
36985883232,36985883230,-2,1412,2203,10
36992383805,36992383802,-3,1342,1198,10
36993980554,36993980554,0,1260,1946,10
36996736389,36996736410,21,783,1396,10
36997953914,36997953911,-3,1513,2434,10
37002235002,37002235001,-1,1244,2458,10
37009181907,37009181906,-1,1062,1796,10
37011169032,37011169035,3,37446,28438,10
37011832614,37011832611,-3,973,1267,10
37014891442,37014891438,-4,1090,1686,10
37015728088,37015728086,-2,761,1522,10
37017359077,37017359074,-3,1411,2788,10
37019182977,37019182974,-3,837,2265,10
37020722842,37020722851,9,14501,24985,10
37023222983,37023222982,-1,971,1328,10
37023341695,37023341695,0,614,1724,10
37029613959,37029613960,1,2165,1745,10
37041646809,37041646805,-4,1395,1379,10
37047983154,37047983155,1,805,1650,10
37049174232,37049174229,-3,1290,2144,10
37049872958,37049872955,-3,1347,1494,10
37053471786,37053471785,-1,1367,2224,10
37053564873,37053564869,-4,705,2647,10
37054612990,37054612990,0,1593,1881,10
37055352516,37055352514,-2,64,582,10
37056153174,37056153172,-2,1142,1905,10
37057313218,37057313218,0,1217,1609,10
37059321819,37059321818,-1,1631,2632,10
37071368906,37071368905,-1,944,2401,10
37076666414,37076666411,-3,1070,2121,10
37078527214,37078527221,7,10690,4632,10
37081518657,37081518658,1,1778,1197,10
37085506812,37085506809,-3,1249,2568,10
37087281575,37087281573,-2,1093,1531,10
37088766267,37088766262,-5,518,1879,10
37089901246,37089901246,0,1253,2215,10
37093259328,37093259317,-11,1385,1869,10
37098414067,37098414065,-2,1062,2075,10
37104827896,37104827893,-3,1387,2502,10
37107374026,37107374026,0,1496,2635,10
37109103149,37109103147,-2,2140,2930,10
37111542315,37111542314,-1,1390,2142,10
37113361599,37113361597,-2,1503,2222,10
37114640729,37114640734,5,3576,1319,10
37116578414,37116578411,-3,931,2509,10
37120223661,37120223660,-1,1397,1787,10
37120920973,37120920970,-3,1659,1942,10
37121649939,37121649940,1,1543,1940,10
37121740118,37121740119,1,926,1381,10
37122049322,37122049321,-1,859,1724,10
37123114948,37123114965,17,607,843,10
37132090336,37132090334,-2,1176,2037,10
37133748818,37133748817,-1,1327,2018,10
37140447255,37140447257,2,7441,8240,10
37141015622,37141015622,0,1277,1635,10
37151986828,37151986832,4,2298,1490,10
37158643799,37158643798,-1,1452,2302,10
37160293403,37160293403,0,1631,1923,10
37161778642,37161778643,1,625,735,10
37162824578,37162824577,-1,1668,1478,10
37163379365,37163379366,1,1234,1359,10
37168433201,37168433199,-2,1321,2149,10
37169375525,37169375525,0,612,1335,10
37173343707,37173343703,-4,907,2500,10
37176326446,37176326445,-1,872,1087,10
37178386882,37178386882,0,1056,2523,10
37180843074,37180843073,-1,1660,2373,10
37182879403,37182879403,0,1260,2003,10
37185903274,37185903274,0,1316,2252,10
37186453851,37186453849,-2,871,2060,10
37188417159,37188417158,-1,1700,1697,10
37188834962,37188834959,-3,1425,2807,10
37190833568,37190833566,-2,1122,1874,10
37196437362,37196437362,0,1679,1973,10
37203520466,37203520465,-1,1022,1917,10
37206520635,37206520635,0,1454,2441,10
37207729758,37207729757,-1,1230,1758,10
37216634579,37216634576,-3,1085,1749,10
37218271027,37218271027,0,1399,1742,10
37218454118,37218454117,-1,848,2055,10
37219393063,37219393063,0,1578,2303,10
37219565925,37219565922,-3,996,2079,10
37221756694,37221756695,1,1896,1403,10
37224428055,37224428054,-1,1092,1917,10
37226903974,37226903973,-1,1211,2002,10
37229490862,37229490864,2,1429,1781,10
37229645726,37229645724,-2,1559,2000,10
37230361115,37230361115,0,1135,2014,10
37230691826,37230691826,0,1178,2074,10
37231557058,37231557058,0,1294,1678,10
37234504774,37234504771,-3,1021,2040,10
37235570017,37235570017,0,2088,2281,10
37238522290,37238522290,0,1151,1874,10
37239148376,37239148388,12,196,1076,10
37241818195,37241818195,0,1045,1896,10
37246447051,37246447048,-3,1177,2865,10
37250439310,37250439307,-3,636,1030,10
37251454662,37251454659,-3,1159,2223,10
37252380748,37252380746,-2,1391,2412,10
37252891155,37252891154,-1,1311,2564,10
37253027932,37253027930,-2,1142,1852,10
37254857423,37254857420,-3,783,1254,10
37258986026,37258986024,-2,980,2160,10
37266528209,37266528206,-3,1488,3128,10
37271154073,37271154072,-1,1117,2183,10
37277223245,37277223242,-3,1362,2089,10
37284499752,37284499749,-3,1033,2276,10
37284525602,37284525622,20,1380,1622,10
37287380401,37287380401,0,996,2003,10
37288932626,37288932625,-1,1398,1891,10
37289985038,37289985036,-2,685,1709,10
37295843641,37295843641,0,1083,1994,10
37296596835,37296596831,-4,1022,1819,10
37297144027,37297144023,-4,738,2021,10
37297749046,37297749044,-2,1158,2428,10
37302643233,37302643230,-3,1160,2135,10
37304293866,37304293870,4,2187,1763,10
37307169498,37307169497,-1,758,1281,10
37310516834,37310516835,1,1129,1605,10
37311678066,37311678064,-2,1638,1784,10
37312909875,37312909873,-2,978,1988,10
37312991028,37312991029,1,36955,20479,10
37314717328,37314717326,-2,1119,1956,10
37317957686,37317957682,-4,1000,2175,10
37318369466,37318369474,8,2596,1147,10
37324494697,37324494695,-2,1430,2127,10
37325273921,37325273918,-3,1360,2590,10
37325777394,37325777395,1,1193,2021,10
37335053551,37335053551,0,1146,1677,10
37335390351,37335390349,-2,1428,2211,10
37336110161,37336110169,8,2405,1119,10
37342459781,37342459782,1,1083,1013,10
37345785118,37345785115,-3,1283,2530,10
37346290465,37346290464,-1,1132,1554,10
37347533251,37347533255,4,3573,1816,10
37351185716,37351185713,-3,1431,1991,10
37351267439,37351267433,-6,1142,5803,10
37352029218,37352029218,0,1310,1537,10
37355363228,37355363222,-6,987,2725,10
37356762887,37356762887,0,1052,1661,10
37362128677,37362128666,-11,1088,2037,10
37364177023,37364177023,0,1027,2103,10
37365219164,37365219161,-3,2395,5306,10
37366450693,37366450689,-4,1175,2174,10
37369335415,37369335418,3,1296,1814,10
37369463573,37369463573,0,1118,2490,10
37371333328,37371333347,19,853,4401,10
37374768779,37374768778,-1,1314,1947,10
37383454548,37383454548,0,1241,1803,10
37386335845,37386335847,2,2297,1647,10
37388635705,37388635710,5,2618,1667,10
37394298401,37394298396,-5,928,1660,10
37397712629,37397712628,-1,951,1703,10
37397949411,37397949410,-1,1280,1437,10
37402663085,37402663081,-4,1586,2117,10
37406528540,37406528541,1,1327,1610,10
37408531987,37408531985,-2,1126,1834,10
37412497879,37412497876,-3,1317,2076,10
37417067667,37417067666,-1,1654,2173,10
37418464377,37418464377,0,1126,2457,10
37418867615,37418867613,-2,1731,2157,10
37419133990,37419133990,0,1251,1499,10
37421619436,37421619434,-2,973,1668,10
37422756387,37422756374,-13,493,1035,10
37423368555,37423368555,0,979,1545,10
37424142135,37424142132,-3,1025,2712,10
37427082849,37427082846,-3,1031,2343,10
37429402190,37429402190,0,870,1325,10
37434630714,37434630711,-3,950,1638,10
37436343652,37436343650,-2,1373,2356,10
37437680301,37437680299,-2,1118,1566,10
37437980276,37437980295,19,1484,2119,10
37438120734,37438120731,-3,1174,2134,10
37438308768,37438308750,-18,1515,1806,10
37438927989,37438927988,-1,880,1059,10
37439802822,37439802821,-1,873,1696,10
37445585027,37445585028,1,899,1916,10
37445950634,37445950631,-3,1296,2412,10
37453496925,37453496924,-1,1156,1518,10
37454257038,37454257037,-1,1234,2273,10
37460306711,37460306708,-3,1526,1936,10
37462523476,37462523479,3,1792,1467,10
37464597822,37464597821,-1,1838,2102,10
37465020985,37465020982,-3,1045,3114,10
37467056446,37467056443,-3,1007,2061,10
37468081448,37468081447,-1,1259,1928,10
37468886859,37468886857,-2,1643,2414,10
37470387418,37470387413,-5,1084,2310,10
37470578160,37470578153,-7,3598,8316,10
37472862160,37472862155,-5,686,1297,10
37473682769,37473682750,-19,865,1400,10
37475039453,37475039454,1,1754,1793,10
37480002878,37480002876,-2,857,1986,10
37480959630,37480959626,-4,1318,1970,10
37486371269,37486371269,0,1066,1672,10
37488416710,37488416710,0,1178,1938,10
37498217140,37498217138,-2,1050,2080,10
37498858872,37498858865,-7,1095,1178,10
37503398586,37503398583,-3,1197,1736,10
37503695187,37503695186,-1,1000,2057,10
37504113583,37504113584,1,1849,1343,10
37507335569,37507335567,-2,1627,1384,10
37507424891,37507424888,-3,1422,2270,10
37511750023,37511750022,-1,870,1893,10
37512658390,37512658390,0,1381,1688,10
37513512687,37513512686,-1,912,1416,10
37515531235,37515531233,-2,1375,2477,10
37516385747,37516385751,4,1064,926,10
37516783210,37516783204,-6,1464,5448,10
37517109592,37517109591,-1,819,2244,10
37519713686,37519713681,-5,1072,3719,10
37523035129,37523035129,0,979,2091,10
37526584618,37526584617,-1,755,1657,10
37533782354,37533782353,-1,1204,1924,10
37538913736,37538913736,0,1258,1480,10
37543876497,37543876494,-3,1275,2521,10
37544990657,37544990654,-3,1317,1871,10
37545761547,37545761543,-4,1231,2811,10
37546527905,37546527903,-2,1370,1369,10
37548746213,37548746208,-5,1176,2108,10
37548818139,37548818116,-23,1257,1984,10
37548982875,37548982894,19,747,1417,10
37550349042,37550349041,-1,1647,2317,10
37553016355,37553016353,-2,1208,1841,10
37554009601,37554009598,-3,1344,1659,10
37557074997,37557074996,-1,1600,2079,10
37560319729,37560319726,-3,1408,1988,10
37560453166,37560453174,8,13028,26132,10
37560958112,37560958108,-4,27412,13775,10
37563828622,37563828621,-1,1493,2153,10
37569178874,37569178870,-4,1167,2335,10
37570155022,37570155019,-3,756,1490,10
37573997338,37573997337,-1,1123,2391,10
37575378811,37575378809,-2,963,1991,10
37576313467,37576313487,20,838,1449,10
37576567015,37576567016,1,1295,2240,10
37576632555,37576632551,-4,1157,2229,10
37579332151,37579332150,-1,1193,1692,10
37579388039,37579388038,-1,1510,2504,10
37583932580,37583932578,-2,1047,2275,10
37585937813,37585937814,1,1570,1450,10
37586926297,37586926299,2,1226,1527,10
37588114847,37588114846,-1,999,1731,10
37588495754,37588495754,0,1261,1769,10
37594928669,37594928673,4,2015,970,10
37596945139,37596945137,-2,923,1883,10
37597638683,37597638681,-2,1749,2608,10
37610198131,37610198130,-1,2319,5300,10
37612569327,37612569327,0,1076,1173,10
37613196434,37613196432,-2,792,1553,10
37617617588,37617617583,-5,1089,2067,10
37620263408,37620263398,-10,43909,11798,10
37623890565,37623890571,6,2148,1008,10
37625291027,37625291026,-1,1051,2508,10
37627008203,37627008201,-2,1185,2068,10
37635691037,37635691037,0,1362,1955,10
37637769128,37637769127,-1,1385,1699,10
37643513910,37643513909,-1,1323,2521,10
37643910110,37643910109,-1,1103,1556,10
37645460274,37645460273,-1,1952,2360,10
37646524250,37646524254,4,1115,1789,10
37648434643,37648434639,-4,950,4102,10
37652137447,37652137446,-1,906,1929,10
37655732482,37655732482,0,1663,1813,10
37658575897,37658575897,0,1364,1434,10
37665678094,37665678093,-1,1596,2175,10
37665903998,37665903998,0,798,1054,10
37666818332,37666818330,-2,934,1414,10
37667444086,37667444086,0,1152,1283,10
37667538325,37667538323,-2,1055,1600,10
37670784912,37670784910,-2,1019,2223,10
37671286974,37671286972,-2,1136,1717,10
37671711602,37671711621,19,1520,2539,10
37676390623,37676390624,1,1553,1408,10
37677625324,37677625320,-4,1009,1278,10
37680025013,37680025018,5,986,1204,10
37682932462,37682932458,-4,1154,2198,10
37682965025,37682965012,-13,1083,2009,10
37683647433,37683647431,-2,2047,1714,10
37684805976,37684805974,-2,1117,2333,10
37684846516,37684846532,16,134,1761,10
37686656631,37686656629,-2,1271,1478,10
37690254435,37690254435,0,1211,2346,10
37690832242,37690832241,-1,1652,1890,10
37691259476,37691259474,-2,1676,3344,10
37691548131,37691548128,-3,1114,2427,10
37692569310,37692569310,0,1499,2705,10
37693976903,37693976903,0,1342,2252,10
37694364283,37694364272,-11,1433,2294,10
37694734081,37694734081,0,1422,2631,10
37695553091,37695553088,-3,1309,2355,10
37695739306,37695739306,0,1156,1137,10
37698889790,37698889789,-1,1338,1472,10
37705292992,37705292990,-2,1546,1711,10
37708227767,37708227766,-1,1167,1034,10
37711028098,37711028095,-3,986,2625,10
37711262370,37711262369,-1,1273,1865,10
37713173018,37713173018,0,1202,2031,10
37717315306,37717315309,3,2300,1186,10
37720776091,37720776090,-1,748,1874,10
37723327726,37723327726,0,858,2603,10
37727309611,37727309610,-1,1542,2753,10
37728655267,37728655267,0,1419,2031,10
37728995618,37728995615,-3,1028,2242,10
37731217786,37731217783,-3,839,1795,10
37732100094,37732100099,5,1982,1414,10
37733677940,37733677941,1,2031,2190,10
37735718658,37735718657,-1,1487,2377,10
37736219308,37736219307,-1,1574,2026,10
37736262841,37736262838,-3,1603,2051,10
37737669787,37737669786,-1,827,1988,10
37739047796,37739047782,-14,86,1172,10
37741607354,37741607355,1,1674,2099,10
37744967037,37744967037,0,931,1489,10
37745552278,37745552277,-1,781,1189,10
37745881053,37745881053,0,1042,1810,10
37746131448,37746131446,-2,1206,1770,10
37746178608,37746178589,-19,904,1680,10
37746985564,37746985582,18,713,1311,10
37748582845,37748582844,-1,1174,2236,10
37749874249,37749874245,-4,1022,1699,10
37751219025,37751219022,-3,1091,1458,10
37757177545,37757177548,3,1042,1570,10
37760430081,37760430079,-2,918,1589,10
37764327929,37764327928,-1,1414,2689,10
37766508482,37766508482,0,925,1512,10
37767990623,37767990623,0,1815,2310,10
37768029897,37768029897,0,1189,1629,10
37768187080,37768187074,-6,887,1802,10
37774558507,37774558504,-3,966,1782,10
37779624226,37779624225,-1,1373,2018,10
37780412621,37780412619,-2,1373,2683,10
37785552715,37785552710,-5,1230,2268,10
37786284527,37786284524,-3,1425,2174,10
37789402106,37789402108,2,1247,1390,10
37792490891,37792490889,-2,1140,2429,10
37796182071,37796182069,-2,1288,1692,10
37797641726,37797641722,-4,1686,3462,10
37801856335,37801856333,-2,1727,2918,10
37804273436,37804273434,-2,1509,1599,10
37810776838,37810776835,-3,1059,1507,10
37810830293,37810830291,-2,1120,2134,10
37814278229,37814278226,-3,871,3042,10
37814314681,37814314668,-13,1172,2290,10
37815499073,37815499071,-2,1344,1450,10
37820783865,37820783865,0,3039,3576,10
37821558782,37821558780,-2,1049,2351,10
37824318495,37824318494,-1,1938,2945,10
37827655619,37827655617,-2,1279,1904,10
37829790198,37829790197,-1,1221,1615,10
37830945145,37830945139,-6,1050,1867,10
37836899629,37836899627,-2,1487,1813,10
37840587647,37840587646,-1,1263,1878,10
37850108556,37850108555,-1,901,1281,10
37850743531,37850743529,-2,1052,1972,10
37855832063,37855832066,3,864,896,10
37861359159,37861359158,-1,990,2239,10
37861587179,37861587163,-16,1067,2385,10
37862264856,37862264858,2,1826,1188,10
37862444543,37862444539,-4,1732,2308,10
37863914963,37863914968,5,3084,1465,10
37867532090,37867532089,-1,1310,2347,10
37868006402,37868006399,-3,1278,1983,10
37870196161,37870196159,-2,1667,1884,10
37870662993,37870662993,0,1525,1980,10
37871848267,37871848263,-4,1241,2707,10
37873198379,37873198376,-3,1089,1878,10
37875265734,37875265741,7,13788,21595,10
37876629670,37876629666,-4,1024,2240,10
37877938854,37877938854,0,1217,1710,10
37878631898,37878631897,-1,1320,1837,10
37879654046,37879654040,-6,844,2814,10
37879940480,37879940495,15,321,1265,10
37882723631,37882723631,0,957,1041,10
37884052840,37884052845,5,2145,1456,10
37884779418,37884779418,0,1213,1230,10
37886787602,37886787601,-1,1481,2482,10
37889499268,37889499268,0,1053,1911,10
37894582946,37894582947,1,1227,1765,10
37895489642,37895489642,0,1160,2353,10
37900344918,37900344918,0,1275,1867,10
37900819081,37900819079,-2,870,1376,10
37910332031,37910332034,3,785,1311,10
37911163068,37911163067,-1,1252,1833,10
37912466086,37912466082,-4,1166,2882,10
37913539558,37913539558,0,1357,1959,10
37914197534,37914197526,-8,1866,5292,10
37916000861,37916000866,5,3945,1983,10
37918696753,37918696752,-1,1017,1384,10
37919842320,37919842317,-3,1445,1704,10
37921638178,37921638178,0,1535,2924,10
37922568083,37922568078,-5,1114,1791,10
37923258737,37923258735,-2,1407,2084,10
37924153553,37924153553,0,1022,1744,10
37927843738,37927843736,-2,1954,2113,10
37928385631,37928385629,-2,969,2249,10
37932978187,37932978186,-1,959,1190,10
37934385859,37934385859,0,1204,2180,10
37937723064,37937723062,-2,622,1601,10
37938149970,37938149969,-1,1401,2309,10
37939403554,37939403553,-1,999,1702,10
37944201157,37944201155,-2,1227,2199,10
37947485151,37947485150,-1,1145,2024,10
37948490279,37948490276,-3,1133,1626,10
37949509733,37949509725,-8,1553,7572,10
37949969848,37949969846,-2,1464,2710,10
37954579241,37954579240,-1,1163,2124,10
37955633131,37955633130,-1,1264,2575,10
37958742787,37958742786,-1,1279,1692,10
37959541204,37959541202,-2,1123,2187,10
37962121170,37962121179,9,7112,3236,10
37967163866,37967163865,-1,1427,1962,10
37969479368,37969479362,-6,1156,2587,10
37972832581,37972832581,0,1125,1466,10
37975650323,37975650322,-1,1419,2344,10
37975751138,37975751138,0,1248,2025,10
37979612482,37979612481,-1,1517,1458,10
37980446502,37980446501,-1,921,1600,10
37983187461,37983187459,-2,890,1777,10
37986871694,37986871690,-4,1324,2817,10
37987442742,37987442739,-3,879,2014,10
37990275531,37990275530,-1,1522,2272,10
37990590059,37990590058,-1,1054,2100,10
37992879141,37992879139,-2,883,1919,10
37993644458,37993644459,1,1157,1784,10
37997215613,37997215610,-3,1151,2236,10
37997649470,37997649470,0,1238,2020,10
37998637993,37998637977,-16,1101,1757,10
38000924469,38000924469,0,1191,1842,10
38001813442,38001813439,-3,1214,1884,10
38003453133,38003453133,0,883,1524,10
38004685100,38004685096,-4,892,1125,10
38012622370,38012622371,1,938,1493,10
38012660938,38012660936,-2,1075,1889,10
38018417474,38018417469,-5,1622,3579,10
38023284558,38023284562,4,1657,1196,10
38024745402,38024745398,-4,1105,1614,10
38025269130,38025269128,-2,1135,2277,10
38027611169,38027611166,-3,1518,2213,10
38030993967,38030993966,-1,1303,2125,10
38037945890,38037945890,0,1209,1837,10
38039454177,38039454175,-2,1072,1261,10
38043398417,38043398417,0,2100,2724,10
38044758138,38044758139,1,1463,2013,10
38044919750,38044919750,0,1228,1757,10
38054140038,38054140035,-3,802,1029,10
38054597609,38054597610,1,1096,2361,10
38056382154,38056382154,0,1270,2199,10
38056954479,38056954477,-2,1400,2628,10
38058576110,38058576110,0,974,1448,10
38062480129,38062480133,4,3928,1698,10
38062826731,38062826729,-2,929,1998,10
38062980334,38062980334,0,1755,2256,10
38063919086,38063919084,-2,1281,1828,10
38064839230,38064839226,-4,775,4284,10
38067297863,38067297859,-4,1075,1291,10
38067761914,38067761914,0,1253,1693,10
38071195085,38071195084,-1,1426,2072,10
38073771433,38073771433,0,1297,1629,10
38074781358,38074781353,-5,1928,2475,10
38074868585,38074868586,1,1491,1440,10
38076630154,38076630153,-1,950,1696,10
38079196397,38079196381,-16,528,462,10
38088434650,38088434655,5,3426,1186,10
38092440470,38092440466,-4,1062,1840,10
38096861333,38096861332,-1,1281,1706,10
38098740443,38098740439,-4,1231,1739,10
38101716174,38101716175,1,1386,1519,10
38104678326,38104678326,0,1332,1660,10
38108942742,38108942739,-3,1591,2632,10
38110249897,38110249905,8,1773,1089,10
38110885875,38110885882,7,3124,1052,10
38117029008,38117029006,-2,1469,2268,10
38119043049,38119043049,0,963,1017,10
38120195638,38120195633,-5,1273,3975,10
38128347883,38128347882,-1,1369,2267,10
38129272606,38129272602,-4,1137,4678,10
38129724227,38129724225,-2,831,2116,10
38130715730,38130715729,-1,1111,1775,10
38133830090,38133830089,-1,1110,1631,10
38136929278,38136929278,0,1394,1616,10
38140513434,38140513434,0,1191,1976,10
38140650496,38140650487,-9,1097,2605,10
38140889048,38140889045,-3,1416,2376,10
38142588624,38142588621,-3,784,1386,10
38142794007,38142794007,0,1443,2130,10
38143113851,38143113838,-13,1449,1750,10
38145122194,38145122194,0,1096,2096,10
38145365021,38145365022,1,897,1194,10
38146695087,38146695082,-5,1088,3367,10
38147891542,38147891540,-2,752,2084,10
38148986561,38148986560,-1,1741,2560,10
38152412638,38152412637,-1,979,2140,10
38155084774,38155084786,12,15619,25504,10
38155386033,38155386032,-1,1411,2484,10
38156028653,38156028649,-4,1373,2741,10
38160018152,38160018151,-1,1175,1617,10
38162519942,38162519942,0,1348,1647,10
38164793417,38164793413,-4,1432,2685,10
38165972786,38165972786,0,880,1216,10
38171898442,38171898442,0,1315,1703,10
38173902570,38173902570,0,1237,1444,10
38174064171,38174064169,-2,839,1698,10
38175855174,38175855177,3,4625,22113,10
38178279337,38178279335,-2,1413,2144,10
38180406049,38180406047,-2,1745,2134,10
38184087658,38184087653,-5,933,1691,10
38184306905,38184306905,0,1247,2390,10
38186265292,38186265290,-2,1462,2076,10
38191334411,38191334409,-2,673,1498,10
38192933042,38192933041,-1,1189,2169,10
38203683390,38203683380,-10,31783,15154,10
38207155236,38207155234,-2,1005,2026,10
38209904003,38209904009,6,1625,1334,10
38214652863,38214652861,-2,877,2151,10
38214733905,38214733899,-6,1576,2996,10
38217976078,38217976079,1,575,1327,10
38219631906,38219631900,-6,754,3178,10
38221386437,38221386437,0,1504,1544,10
38222741583,38222741578,-5,1969,4072,10
38224696414,38224696413,-1,823,1778,10
38231042814,38231042815,1,1534,2299,10
38231169422,38231169422,0,1362,2179,10
38232191778,38232191784,6,4724,1870,10
38234169997,38234169995,-2,1447,2471,10
38236949875,38236949874,-1,1837,1978,10
38237593022,38237593042,20,40874,17129,10
38238030575,38238030573,-2,1014,2187,10
38240075290,38240075291,1,1309,1285,10
38241355222,38241355222,0,1621,1483,10
38242084887,38242084890,3,1223,1410,10
38242821651,38242821650,-1,1772,2763,10
38246959790,38246959789,-1,926,1588,10
38248942178,38248942176,-2,1302,2619,10
38249278978,38249278981,3,1968,1398,10
38250966467,38250966466,-1,1061,1831,10
38254267908,38254267906,-2,1403,2081,10
38255669085,38255669082,-3,1468,2520,10
38258905178,38258905178,0,2640,3513,10
38264328194,38264328191,-3,956,1905,10
38268708878,38268708894,16,1013,1147,10
38270105782,38270105797,15,1454,4877,10
38270685843,38270685842,-1,1551,2401,10
38274387918,38274387918,0,894,1827,10
38280146317,38280146314,-3,911,1792,10
38282021686,38282021665,-21,1181,976,10
38285564697,38285564696,-1,1127,1499,10
38286753491,38286753489,-2,733,1625,10
38288654514,38288654514,0,1335,2160,10
38288902389,38288902388,-1,561,1339,10
38289599462,38289599470,8,10339,29560,10
38292055452,38292055446,-6,1037,4735,10
38299749202,38299749203,1,1867,2664,10
38300686343,38300686340,-3,1239,2176,10
38302325188,38302325187,-1,830,1914,10
38303692583,38303692582,-1,1273,1633,10
38304071755,38304071755,0,1132,2128,10
38305936825,38305936825,0,1266,1975,10
38306402318,38306402317,-1,1517,2301,10
38312808948,38312808947,-1,941,1366,10
38319272833,38319272834,1,2034,1517,10
38321177413,38321177398,-15,1193,1369,10
38322766499,38322766499,0,1234,1992,10
38326396161,38326396162,1,1067,1745,10
38332975629,38332975627,-2,1662,2479,10
38335630238,38335630237,-1,907,1582,10
38337425017,38337425017,0,1054,2013,10
38340973054,38340973052,-2,1452,2462,10
38343190034,38343190033,-1,1149,1713,10
38344188233,38344188237,4,3454,1486,10
38344969553,38344969550,-3,1120,1451,10
38348057465,38348057465,0,737,1611,10
38349389716,38349389719,3,45844,17618,10
38349966156,38349966156,0,942,1820,10
38350277603,38350277590,-13,1317,1720,10
38352354318,38352354315,-3,1323,2461,10
38354155190,38354155197,7,15828,22338,10
38354594666,38354594665,-1,1122,1190,10
38356310345,38356310343,-2,1100,1457,10
38358766305,38358766304,-1,1159,1538,10
38362373615,38362373614,-1,1001,1458,10
38363293050,38363293050,0,1373,2154,10
38369339861,38369339858,-3,962,1728,10
38370156142,38370156144,2,1917,1410,10
38375122473,38375122470,-3,1687,2160,10
38382523225,38382523225,0,1051,1663,10
38384735715,38384735714,-1,1797,2159,10
38385656510,38385656512,2,1207,1166,10
38386726551,38386726549,-2,821,2308,10
38387764187,38387764175,-12,988,2256,10
38388476998,38388476996,-2,1032,1706,10
38388541834,38388541833,-1,1149,1302,10
38390956403,38390956400,-3,1479,3203,10
38391113628,38391113643,15,585,871,10
38392199674,38392199673,-1,1319,1663,10
38393759312,38393759310,-2,1260,2379,10
38395841394,38395841388,-6,2108,11238,10
38402124932,38402124952,20,566,477,10
38407226459,38407226458,-1,1103,1747,10
38410391419,38410391417,-2,1754,2270,10
38411168039,38411168038,-1,666,1271,10
38421965527,38421965523,-4,1164,2113,10
38427589005,38427589002,-3,1339,2187,10
38430702342,38430702341,-1,1730,2961,10
38431622218,38431622217,-1,1423,2509,10
38439309435,38439309432,-3,1171,2305,10
38443050907,38443050907,0,1405,1730,10
38444584370,38444584369,-1,1363,2881,10
38447887063,38447887062,-1,1210,1801,10
38463473067,38463473065,-2,1131,2100,10
38469909454,38469909453,-1,1309,1941,10
38470407584,38470407582,-2,1338,2213,10
38476522798,38476522798,0,836,2181,10
38478228990,38478228988,-2,1376,1898,10
38483913011,38483913010,-1,1322,1307,10
38484480304,38484480303,-1,1580,2196,10
38487258162,38487258164,2,1194,1984,10
38488550733,38488550733,0,1672,1967,10
38493571297,38493571303,6,2792,1338,10
38497068671,38497068671,0,1009,1868,10
38497536462,38497536463,1,1098,2003,10
38498531234,38498531227,-7,1004,1541,10
38502549606,38502549602,-4,1415,2474,10
38505040066,38505040066,0,1327,1890,10
38515289959,38515289956,-3,997,1693,10
38519094138,38519094136,-2,1035,1999,10
38522559090,38522559086,-4,1174,2966,10
38523881282,38523881280,-2,1539,2264,10
38524510490,38524510474,-16,1151,1869,10
38526542158,38526542156,-2,1259,1686,10
38527039150,38527039149,-1,1813,2511,10
38528165309,38528165298,-11,1345,1819,10
38531042833,38531042830,-3,949,1981,10
38532881862,38532881858,-4,1036,1381,10
38536095775,38536095774,-1,1055,968,10
38538781491,38538781489,-2,1044,2301,10
38545508022,38545508024,2,1004,2329,10
38546739233,38546739234,1,838,1955,10
38550551794,38550551794,0,1105,2015,10
38551545499,38551545498,-1,969,2142,10
38553047952,38553047949,-3,1162,2081,10
38558531315,38558531314,-1,1378,1684,10
38562014363,38562014365,2,1250,2333,10
38564861946,38564861945,-1,1358,1985,10
38571420353,38571420350,-3,1252,1360,10
38573112395,38573112391,-4,1716,2461,10
38574119634,38574119633,-1,1095,1310,10
38574936540,38574936534,-6,1223,1193,10
38581978444,38581978441,-3,1358,1546,10
38582184339,38582184358,19,1023,1904,10
38584454701,38584454700,-1,1064,1932,10
38586220710,38586220713,3,2546,951,10
38588180189,38588180190,1,924,1714,10
38589078228,38589078227,-1,1193,1802,10
38590540181,38590540183,2,3836,3650,10
38594755182,38594755181,-1,1462,1894,10
38595160918,38595160916,-2,1149,1852,10
38596604863,38596604862,-1,2854,3736,10
38601924286,38601924286,0,1077,1403,10
38606931681,38606931678,-3,880,1279,10
38609751694,38609751692,-2,1250,3091,10
38615838064,38615838061,-3,1228,2186,10
38617678639,38617678638,-1,1450,2014,10
38619052854,38619052860,6,1608,1014,10
38619237208,38619237206,-2,1155,1645,10
38622960015,38622960013,-2,1175,2196,10
38623331223,38623331221,-2,1081,2304,10
38625959445,38625959442,-3,1331,2673,10
38626075963,38626075982,19,998,1795,10
38628000001,38628000000,-1,2042,1924,10
38631585177,38631585175,-2,1044,1845,10
38632165251,38632165250,-1,1081,1914,10
38633661308,38633661305,-3,1681,2079,10
38636217347,38636217346,-1,1179,2221,10
38638329083,38638329081,-2,783,1793,10
38644158591,38644158589,-2,1250,1777,10
38649333299,38649333298,-1,1343,2397,10
38649543667,38649543669,2,1597,1598,10
38652407921,38652407919,-2,1292,1921,10
38652574273,38652574271,-2,1035,1879,10
38652657052,38652657070,18,488,855,10
38653780677,38653780674,-3,1247,1657,10
38655152995,38655152994,-1,1148,2520,10
38655493247,38655493246,-1,1860,3330,10
38656124859,38656124860,1,1438,1386,10
38656470405,38656470402,-3,1018,2409,10
38657948255,38657948252,-3,874,1445,10
38662129161,38662129159,-2,1188,1945,10
38662211501,38662211498,-3,1427,2406,10
38670288238,38670288235,-3,1335,2389,10
38671493162,38671493167,5,1599,406,10
38672120746,38672120747,1,1008,1686,10
38675150759,38675150758,-1,1241,2426,10
38675466093,38675466093,0,1192,2207,10
38682176790,38682176789,-1,1067,1669,10
38682909161,38682909161,0,1291,1253,10
38684340451,38684340449,-2,1575,2333,10
38684582214,38684582214,0,1224,1946,10
38686984705,38686984704,-1,1520,2085,10
38688779579,38688779577,-2,657,2397,10
38689043330,38689043323,-7,877,1858,10
38695805215,38695805213,-2,1091,1077,10
38697621597,38697621594,-3,1196,1795,10
38700895490,38700895489,-1,1133,1976,10
38701746029,38701746026,-3,933,1605,10
38702621957,38702621968,11,38682,12300,10
38703340187,38703340186,-1,1229,2750,10
38704595815,38704595813,-2,1328,2003,10
38708143751,38708143749,-2,1036,1727,10
38713612208,38713612207,-1,825,1400,10
38713994322,38713994321,-1,1863,2331,10
38720755434,38720755434,0,1151,1305,10
38729211862,38729211859,-3,1144,2428,10
38732478976,38732478974,-2,1605,3039,10
38733317431,38733317430,-1,968,2028,10
38734978535,38734978531,-4,1338,1792,10
38746365517,38746365518,1,3595,3052,10
38749590023,38749590001,-22,981,1148,10
38750987117,38750987117,0,1318,1588,10
38756034569,38756034568,-1,1761,2616,10
38757341163,38757341175,12,8992,42909,10
38760588834,38760588834,0,821,1223,10
38764958922,38764958921,-1,1464,2038,10
38768887590,38768887587,-3,682,1686,10
38771577890,38771577891,1,1256,1226,10
38772001075,38772001074,-1,1264,1589,10
38773389929,38773389926,-3,1619,2397,10
38777200037,38777200036,-1,18798,14510,10
38777761534,38777761535,1,1012,1514,10
38780113582,38780113581,-1,1324,1637,10
38783794893,38783794890,-3,1242,2597,10
38784612021,38784612019,-2,1094,1838,10
38786332263,38786332261,-2,984,2136,10
38788560216,38788560214,-2,1171,1635,10
38791987828,38791987826,-2,1253,2096,10
38792560227,38792560225,-2,1085,2392,10
38793833385,38793833384,-1,1161,2374,10
38794507937,38794507936,-1,805,2131,10
38795033370,38795033370,0,1136,1091,10
38796858381,38796858382,1,1240,1621,10
38797089054,38797089052,-2,1100,2056,10
38797734510,38797734511,1,1853,2525,10
38800133110,38800133108,-2,992,1389,10
38805124827,38805124825,-2,1301,2059,10
38806310094,38806310093,-1,1793,2549,10
38821813442,38821813443,1,1199,1333,10
38826570129,38826570126,-3,1312,2105,10
38831109666,38831109666,0,1096,1021,10
38831396350,38831396350,0,761,2030,10
38833607276,38833607274,-2,1529,2682,10
38836040826,38836040824,-2,1099,2257,10
38842690782,38842690780,-2,1182,1688,10
38844857631,38844857633,2,881,1485,10
38850629626,38850629626,0,1674,2360,10
38850949454,38850949451,-3,1297,2659,10
38854786478,38854786476,-2,1964,2033,10
38855825166,38855825174,8,2492,1174,10
38858893765,38858893764,-1,1132,1874,10
38859397666,38859397665,-1,990,2102,10
38861767386,38861767384,-2,1016,208,10
38867255309,38867255307,-2,949,1685,10
38876995129,38876995128,-1,1664,2687,10
38879659014,38879659013,-1,1096,1372,10
38882398085,38882398082,-3,1525,1664,10
38883226555,38883226554,-1,925,1484,10
38883881875,38883881875,0,1755,1669,10
38891598070,38891598075,5,3785,1920,10
38895564770,38895564765,-5,1015,2803,10
38896505254,38896505252,-2,1517,2218,10
38897803367,38897803364,-3,1329,1741,10
38898209774,38898209771,-3,1164,2409,10
38901458218,38901458217,-1,1658,2259,10
38905793026,38905793025,-1,996,1414,10
38911533772,38911533775,3,2921,3231,10
38914713887,38914713885,-2,1032,2361,10
38915198094,38915198076,-18,2895,1969,10
38919877115,38919877113,-2,1187,1670,10
38925283267,38925283266,-1,1459,2293,10
38926142383,38926142375,-8,826,5447,10
38927066326,38927066326,0,609,2418,10
38928820343,38928820342,-1,1270,2169,10
38932967024,38932967024,0,1294,2092,10
38939184280,38939184277,-3,1304,2339,10
38939256596,38939256614,18,1452,1925,10
38941045023,38941045022,-1,1409,2690,10
38942779914,38942779913,-1,1771,2180,10
38943094874,38943094873,-1,1586,1854,10
38948017326,38948017324,-2,1741,2286,10
38948633103,38948633101,-2,1173,2122,10
38953316178,38953316178,0,1200,1529,10
38955698154,38955698154,0,1004,2311,10
38956687819,38956687819,0,1039,1289,10
38963131713,38963131711,-2,870,1979,10
38963544554,38963544553,-1,1352,2807,10
38964016812,38964016810,-2,1147,1751,10
38964941866,38964941867,1,631,1712,10
38965097858,38965097855,-3,1254,1781,10
38966560213,38966560213,0,970,1653,10
38967190018,38967190018,0,1256,1308,10
38968131611,38968131607,-4,1031,2229,10
38969552415,38969552422,7,12452,5455,10
38971028054,38971028055,1,962,1487,10
38974082510,38974082518,8,2261,1069,10
38979898757,38979898754,-3,1333,1760,10
38985189819,38985189814,-5,931,2818,10
38988858429,38988858427,-2,912,1834,10
38990255005,38990255003,-2,1031,1402,10
38992184842,38992184841,-1,1137,2094,10
38998577203,38998577202,-1,1310,2403,10
38998860906,38998860906,0,1853,2692,10
38999201807,38999201806,-1,848,1684,10
39004103545,39004103538,-7,1233,7697,10
39005195487,39005195487,0,1522,1795,10
39007384802,39007384798,-4,1084,1443,10
39009499350,39009499348,-2,1255,2196,10
39011050865,39011050861,-4,1303,2088,10
39011994167,39011994166,-1,945,1271,10
39016551841,39016551854,13,1185,1437,10
39018395017,39018395015,-2,1266,1854,10
39018693314,39018693335,21,1027,2066,10
39019726809,39019726810,1,1701,1717,10
39025699199,39025699219,20,598,1073,10
39026168367,39026168366,-1,851,1125,10
39029669772,39029669770,-2,1403,2075,10
39035334408,39035334406,-2,1189,2324,10
39042386881,39042386878,-3,1223,2809,10
39045072843,39045072839,-4,1193,2258,10
39045607200,39045607186,-14,1293,1762,10
39049401618,39049401615,-3,1488,2652,10
39049480755,39049480755,0,1144,1169,10
39050855619,39050855617,-2,1639,2653,10
39052980530,39052980527,-3,1292,2250,10
39053191241,39053191239,-2,877,2204,10
39054267423,39054267423,0,1731,1729,10
39054759681,39054759683,2,1434,1330,10
39056787503,39056787502,-1,1316,2029,10
39057076958,39057076955,-3,912,2388,10
39058397091,39058397089,-2,1138,2513,10
39059773838,39059773837,-1,1102,1453,10
39060549474,39060549479,5,2851,1753,10
39060935658,39060935654,-4,1254,1921,10
39061102657,39061102656,-1,973,1909,10
39064370504,39064370502,-2,1459,1478,10
39064546110,39064546113,3,1337,1710,10
39065847339,39065847337,-2,1208,2201,10
39067067485,39067067489,4,2129,1033,10
39068113901,39068113898,-3,1215,2275,10
39069721470,39069721479,9,1176,1574,10
39078509499,39078509493,-6,923,2350,10
39082146754,39082146753,-1,1084,1375,10
39084123362,39084123362,0,944,1375,10
39084710341,39084710341,0,1339,1680,10
39084929001,39084928998,-3,516,1144,10
39087361582,39087361581,-1,1065,2286,10
39088401499,39088401493,-6,3492,12847,10
39088848638,39088848635,-3,924,2261,10
39089398547,39089398547,0,1477,2141,10
39089497196,39089497207,11,14102,26328,10
39089696593,39089696594,1,1138,786,10
39092241715,39092241713,-2,1439,2533,10
39094969938,39094969943,5,1163,1102,10
39096483070,39096483068,-2,956,1855,10
39097090963,39097090979,16,1096,1886,10
39099585604,39099585601,-3,1227,3430,10
39100931787,39100931786,-1,1668,1597,10
39101970482,39101970489,7,4321,889,10
39103950242,39103950243,1,1607,1960,10
39107887948,39107887945,-3,1294,2053,10
39108497944,39108497945,1,1425,1009,10
39109852905,39109852902,-3,603,1226,10
39110482886,39110482887,1,1171,1536,10
39112089087,39112089086,-1,1966,2435,10
39115648605,39115648607,2,1692,1729,10
39116472675,39116472674,-1,1257,2394,10
39122224004,39122224002,-2,1284,2200,10
39122760811,39122760809,-2,1186,1800,10
39123309174,39123309173,-1,1470,2541,10
39123496566,39123496569,3,1474,1792,10
39133269895,39133269895,0,1870,2532,10
39136679470,39136679470,0,1247,1465,10
39138198977,39138198998,21,281,1098,10
39139799810,39139799807,-3,1309,2454,10
39140183394,39140183393,-1,1326,1920,10
39141112524,39141112525,1,1432,1645,10
39141377410,39141377410,0,59,536,10
39142028682,39142028686,4,1432,929,10
39142255091,39142255091,0,1413,1387,10
39142383406,39142383403,-3,1467,2640,10
39148292050,39148292048,-2,826,1158,10
39149336743,39149336739,-4,989,1817,10
39150207318,39150207317,-1,1273,1383,10
39151874015,39151874013,-2,2425,3872,10
39152769891,39152769889,-2,1481,2376,10
39158865934,39158865932,-2,1410,2147,10
39159133386,39159133386,0,1431,1512,10
39161255894,39161255893,-1,1734,2307,10
39162284214,39162284209,-5,3094,12656,10
39162985223,39162985219,-4,1562,1775,10
39163208297,39163208311,14,425,1309,10
39163618733,39163618732,-1,1613,1868,10
39164753839,39164753839,0,1161,2361,10
39170444731,39170444728,-3,999,1986,10
39171195930,39171195926,-4,3918,9156,10
39172068799,39172068802,3,5357,20532,10
39174575102,39174575106,4,2044,1709,10
39181456097,39181456096,-1,854,1813,10
39183288808,39183288831,23,1182,1764,10
39185811365,39185811365,0,993,1935,10
39187585803,39187585802,-1,1335,2611,10
39192396037,39192396034,-3,1157,2060,10
39197002887,39197002885,-2,1399,2442,10
39197847946,39197847953,7,1546,576,10
39198962716,39198962731,15,2002,1380,10
39200898223,39200898227,4,3068,1456,10
39204491562,39204491564,2,1454,1629,10
39205988671,39205988671,0,1217,1243,10
39212327443,39212327442,-1,723,1337,10
39214443127,39214443126,-1,1532,1939,10
39214734514,39214734510,-4,1106,4603,10
39214971431,39214971431,0,1111,2014,10
39216187146,39216187126,-20,1406,1949,10
39216365685,39216365684,-1,1206,1449,10
39216876075,39216876076,1,1221,1811,10
39219104695,39219104693,-2,1324,1995,10
39220490734,39220490731,-3,754,1533,10
39222427411,39222427410,-1,1151,1441,10
39223705079,39223705078,-1,873,2105,10
39224096968,39224096966,-2,1010,2570,10
39225602797,39225602796,-1,1096,1984,10
39227612357,39227612358,1,1542,2365,10
39232034238,39232034240,2,1163,1721,10
39234123794,39234123793,-1,952,1194,10
39235197229,39235197222,-7,3572,13537,10
39235566636,39235566634,-2,1300,1764,10
39236426138,39236426137,-1,1062,2127,10
39242895931,39242895929,-2,785,1540,10
39245471925,39245471922,-3,1183,1579,10
39248840861,39248840859,-2,1272,1884,10
39250430444,39250430442,-2,1156,1652,10
39251368202,39251368202,0,824,1588,10
39252085941,39252085942,1,775,1697,10
39253202751,39253202751,0,773,1802,10
39255087857,39255087855,-2,1346,2825,10
39258752451,39258752449,-2,1193,1871,10
39258859302,39258859300,-2,1009,2160,10
39260401242,39260401240,-2,1549,2581,10
39264695713,39264695710,-3,1312,1887,10
39267076257,39267076254,-3,1386,2782,10
39268114137,39268114135,-2,1940,1964,10
39269007898,39269007898,0,1011,1155,10
39272998174,39272998168,-6,983,2030,10
39273555919,39273555917,-2,1441,2334,10
39274251041,39274251042,1,1071,1562,10
39276048110,39276048110,0,1256,2283,10
39276305362,39276305383,21,1154,1468,10
39284578499,39284578498,-1,1310,2205,10
39291944228,39291944226,-2,1142,1575,10
39293084663,39293084661,-2,929,1720,10
39299263202,39299263201,-1,1137,1816,10
39301553270,39301553269,-1,883,2302,10
39304859735,39304859735,0,1119,1413,10
39305830326,39305830324,-2,1095,2361,10
39310101357,39310101353,-4,899,1858,10
39314213474,39314213473,-1,1205,2107,10
39317890925,39317890925,0,1634,2339,10
39320422336,39320422336,0,1728,2249,10
39322174332,39322174333,1,1539,1374,10
39324168967,39324168965,-2,1222,1828,10
39325628333,39325628331,-2,1781,2719,10
39330511169,39330511173,4,24787,22434,10
39331967626,39331967622,-4,1100,1610,10
39335368075,39335368074,-1,1845,2904,10
39336125697,39336125695,-2,1277,1671,10
39336952923,39336952924,1,951,1268,10
39340355490,39340355488,-2,1174,2312,10
39341956931,39341956929,-2,699,1404,10
39342664001,39342664001,0,1467,1958,10
39344608367,39344608366,-1,1525,1834,10
39350178355,39350178333,-22,1099,1292,10
39350826761,39350826763,2,260,806,10
39352259209,39352259209,0,707,819,10
39352737559,39352737559,0,757,1367,10
39353430188,39353430188,0,1000,1582,10
39357286110,39357286109,-1,1001,1614,10
39358538704,39358538702,-2,1618,1376,10
39363085668,39363085665,-3,1285,2360,10
39363447565,39363447563,-2,1385,1603,10
39364931503,39364931501,-2,1220,2528,10
39368236839,39368236837,-2,850,1781,10
39371477290,39371477298,8,16555,33717,10
39374482117,39374482123,6,4223,2554,10
39375961408,39375961406,-2,1369,2018,10
39376051027,39376051029,2,1633,1606,10
39379023302,39379023298,-4,1099,2190,10
39381361785,39381361791,6,1911,839,10
39386270438,39386270440,2,2166,1627,10
39387116037,39387116034,-3,1187,1369,10
39387389611,39387389597,-14,46,491,10
39395063046,39395063045,-1,1294,2131,10
39396601443,39396601447,4,2705,1179,10
39400003473,39400003485,12,14265,7685,10
39401414124,39401414124,0,861,2091,10
39401488070,39401488067,-3,1001,1566,10
39403904042,39403904041,-1,1164,1698,10
39406043606,39406043606,0,1595,2406,10
39406243662,39406243662,0,1499,1811,10
39409071754,39409071753,-1,896,1899,10
39412333183,39412333182,-1,881,1500,10
39413046612,39413046611,-1,1265,1692,10
39414807018,39414807016,-2,1294,2536,10
39416026239,39416026239,0,1064,1929,10
39416611753,39416611753,0,1007,2212,10
39418822159,39418822156,-3,1191,2598,10
39420624725,39420624723,-2,1302,2301,10
39421495703,39421495702,-1,2069,2311,10
39423179406,39423179426,20,1080,1173,10
39426476066,39426476066,0,923,1571,10
39426825373,39426825370,-3,1363,2553,10
39429545146,39429545143,-3,1562,2389,10
39429588610,39429588626,16,93,1539,10
39434893565,39434893567,2,1100,2395,10
39435302091,39435302089,-2,1165,2371,10
39443829559,39443829554,-5,1048,1941,10
39445931712,39445931713,1,943,1233,10
39446652030,39446652029,-1,1067,1756,10
39447942455,39447942454,-1,1064,1929,10
39448501150,39448501149,-1,1063,1793,10
39450056461,39450056460,-1,1000,1890,10
39451452939,39451452937,-2,938,1199,10
39452548808,39452548814,6,2564,1384,10
39457441978,39457441975,-3,1118,2046,10
39460631790,39460631786,-4,867,1621,10
39462232544,39462232545,1,1384,2134,10
39465885372,39465885370,-2,1222,2239,10
39466653277,39466653278,1,1786,1973,10
39467823794,39467823793,-1,1291,1865,10
39470475962,39470475962,0,1099,1795,10
39470977269,39470977268,-1,1322,2572,10
39474399429,39474399428,-1,1521,1914,10
39474838123,39474838110,-13,1757,1621,10
39474905930,39474905930,0,1395,1909,10
39476843195,39476843193,-2,1103,1786,10
39477024147,39477024146,-1,1524,2688,10
39478947070,39478947069,-1,1581,2168,10
39482229090,39482229087,-3,981,1861,10
39484201230,39484201229,-1,977,1527,10
39484636559,39484636557,-2,1448,3118,10
39489462730,39489462727,-3,1363,1735,10
39492550831,39492550827,-4,931,1225,10
39496229619,39496229617,-2,1340,1571,10
39497138306,39497138305,-1,1132,1781,10
39497624869,39497624870,1,1053,1682,10
39497955826,39497955824,-2,1232,2110,10
39500643522,39500643520,-2,1109,1749,10
39502791444,39502791442,-2,1196,1781,10
39503900842,39503900837,-5,1229,2024,10
39504274486,39504274484,-2,1625,2540,10
39504681754,39504681753,-1,900,1612,10
39508256058,39508256061,3,1317,1679,10
39509595457,39509595455,-2,1075,1699,10
39515555254,39515555254,0,1437,2769,10
39518220350,39518220350,0,1436,1552,10
39518905483,39518905482,-1,1002,2046,10
39523125474,39523125472,-2,884,1710,10
39529246204,39529246204,0,1521,1775,10
39536783489,39536783488,-1,1786,2033,10
39538286430,39538286428,-2,2275,2728,10
39538813661,39538813659,-2,1222,1929,10
39542582246,39542582247,1,1484,1403,10
39542917789,39542917790,1,1416,1943,10
39543500440,39543500437,-3,1478,1663,10
39544196460,39544196456,-4,921,1371,10
39545049026,39545049025,-1,553,1462,10
39546354463,39546354458,-5,1213,2372,10
39546426480,39546426501,21,540,1732,10
39551081082,39551081082,0,1078,1966,10
39552032128,39552032124,-4,1131,1689,10
39555605723,39555605715,-8,1319,1702,10
39559292833,39559292833,0,15454,19762,10
39559337042,39559337041,-1,1591,1980,10
39559612217,39559612221,4,2195,1716,10
39564915294,39564915294,0,942,1645,10
39565661910,39565661909,-1,1211,1213,10
39568075066,39568075064,-2,1472,2264,10
39568490436,39568490434,-2,1502,2702,10
39568977603,39568977602,-1,1103,1739,10
39570002365,39570002362,-3,1465,2681,10
39573490577,39573490575,-2,1720,2691,10
39580118417,39580118408,-9,1831,32662,10
39582538441,39582538438,-3,1347,1511,10
39584119441,39584119442,1,1636,1191,10
39584897634,39584897653,19,1014,1293,10
39589340132,39589340133,1,1232,1909,10
39590305878,39590305873,-5,795,1083,10
39591014873,39591014873,0,1258,2142,10
39591364498,39591364495,-3,797,1306,10
39593333230,39593333229,-1,1417,2391,10
39597114303,39597114301,-2,1099,1442,10
39598004426,39598004426,0,1331,1623,10
39601190371,39601190369,-2,1131,1892,10
39601428703,39601428703,0,1596,1880,10
39602183367,39602183365,-2,1316,2431,10
39602994546,39602994547,1,1039,1055,10
39604316605,39604316607,2,1407,1465,10
39605916371,39605916370,-1,1415,2310,10
39614456648,39614456647,-1,1197,1090,10
39616877407,39616877404,-3,1140,1948,10
39618194812,39618194810,-2,1176,1806,10
39622647368,39622647373,5,1432,1083,10
39625486277,39625486276,-1,1809,2960,10
39627274836,39627274838,2,1520,1433,10
39627517908,39627517923,15,734,1393,10
39629599427,39629599424,-3,1232,2801,10
39631510777,39631510778,1,1121,1973,10
39633712610,39633712608,-2,926,2132,10
39644716358,39644716357,-1,1109,1806,10
39646525369,39646525367,-2,1383,2308,10
39647626946,39647626945,-1,1150,1646,10
39648838131,39648838130,-1,1659,2682,10
39651180718,39651180718,0,865,1388,10
39655729429,39655729430,1,1163,1657,10
39656683209,39656683206,-3,1350,2257,10
39656773810,39656773826,16,872,8668,10
39659520854,39659520851,-3,933,1412,10
39663440443,39663440442,-1,803,2825,10
39663811202,39663811201,-1,1435,1962,10
39664751198,39664751197,-1,1167,1310,10
39665843998,39665843999,1,1269,1635,10
39666880215,39666880210,-5,1355,1773,10
39679753291,39679753287,-4,1416,3442,10
39684172842,39684172842,0,1430,2102,10
39685137390,39685137393,3,4489,2865,10
39688862022,39688862020,-2,836,1345,10
39693937639,39693937638,-1,952,2056,10
39700676676,39700676673,-3,2081,3021,10
39706898822,39706898822,0,963,1561,10
39707061036,39707061033,-3,1010,1813,10
39708262259,39708262257,-2,992,2346,10
39711172114,39711172113,-1,1223,1678,10
39711637502,39711637501,-1,1456,2033,10
39714657953,39714657950,-3,1635,1712,10
39718728494,39718728491,-3,1359,2215,10
39718905922,39718905918,-4,1369,1956,10
39721024690,39721024686,-4,959,1538,10
39728165786,39728165784,-2,1182,1420,10
39730037321,39730037318,-3,1113,1902,10
39732440324,39732440322,-2,1066,2092,10
39734227113,39734227112,-1,1535,2073,10
39734470319,39734470317,-2,1373,2087,10
39735606271,39735606270,-1,1099,1463,10
39738980839,39738980838,-1,1469,2380,10
39739233566,39739233566,0,2096,2983,10
39740588589,39740588594,5,3475,2191,10
39742787477,39742787478,1,2267,2075,10
39743320235,39743320235,0,1232,2217,10
39747199959,39747199958,-1,1379,1907,10
39748327585,39748327585,0,1424,1972,10
39753819265,39753819262,-3,1068,1903,10
39754280812,39754280830,18,1043,1813,10
39754430701,39754430699,-2,1193,1443,10
39754972087,39754972086,-1,835,1656,10
39760809843,39760809842,-1,976,1980,10
39762860217,39762860214,-3,1104,2563,10
39763659757,39763659755,-2,1093,1789,10
39764613624,39764613622,-2,1184,1534,10
39764988521,39764988521,0,1280,2634,10
39765427205,39765427203,-2,1232,1300,10
39765606419,39765606418,-1,1517,1786,10
39767195914,39767195914,0,824,1854,10
39767638402,39767638393,-9,1278,1509,10
39772027667,39772027667,0,1137,2022,10
39772936949,39772936950,1,3210,2408,10
39778160325,39778160322,-3,1492,2731,10
39778231290,39778231300,10,231,2026,10
39781091679,39781091677,-2,1349,2849,10
39782137382,39782137377,-5,1334,2198,10
39782247467,39782247444,-23,1364,2178,10
39783444491,39783444492,1,876,1424,10
39784108198,39784108198,0,1679,2277,10
39784444917,39784444914,-3,1370,3132,10
39785877999,39785877999,0,1350,1583,10
39786726721,39786726734,13,929,1475,10
39789916235,39789916234,-1,1363,1807,10
39795251213,39795251218,5,2067,1161,10
39800996830,39800996831,1,1486,1390,10
39802547338,39802547335,-3,1015,1765,10
39804762128,39804762127,-1,1408,2782,10
39805221810,39805221808,-2,1581,2285,10
39805436143,39805436141,-2,1278,1841,10
39812578410,39812578408,-2,995,1875,10
39814073777,39814073786,9,357,1104,10
39820664618,39820664617,-1,2376,5491,10
39820898067,39820898067,0,1529,2148,10
39823061126,39823061133,7,2776,1474,10
39823182953,39823182954,1,1865,3064,10
39824767357,39824767360,3,1740,1578,10
39825011059,39825011061,2,1865,1459,10
39830241239,39830241233,-6,2676,10785,10
39842053023,39842053022,-1,1278,1610,10
39843570554,39843570559,5,2644,1007,10
39848430182,39848430173,-9,1510,6213,10
39858905507,39858905506,-1,1150,2534,10
39860219235,39860219234,-1,1289,1534,10
39861682534,39861682530,-4,926,2963,10
39862725110,39862725110,0,1772,2603,10
39862757602,39862757601,-1,1301,1930,10
39866346801,39866346799,-2,1352,1568,10
39867309126,39867309126,0,526,1815,10
39868863849,39868863844,-5,1129,4093,10
39874962612,39874962612,0,1277,1717,10
39876176209,39876176207,-2,1275,1759,10
39878636994,39878636992,-2,1016,1861,10
39887551742,39887551740,-2,1573,2490,10
39887774810,39887774809,-1,1249,1788,10
39889307338,39889307337,-1,933,1074,10
39890682619,39890682618,-1,902,1943,10
39891655431,39891655429,-2,1045,1981,10
39891948298,39891948297,-1,1244,2081,10
39892759432,39892759432,0,1503,3107,10
39898406063,39898406066,3,1066,1409,10
39903896053,39903896051,-2,1494,1582,10
39909987943,39909987943,0,1403,2312,10
39910839400,39910839399,-1,1212,2129,10
39913271058,39913271058,0,1393,1946,10
39916207727,39916207727,0,1391,2205,10
39916955214,39916955212,-2,1396,2585,10
39921873078,39921873075,-3,919,1794,10
39922377982,39922377984,2,1625,2164,10
39927486821,39927486822,1,1698,2197,10
39927676867,39927676866,-1,1153,1373,10
39929677411,39929677410,-1,1262,1539,10
39939911413,39939911413,0,1549,1844,10
39940798929,39940798929,0,2439,3444,10
39941466991,39941466988,-3,821,1775,10
39944459040,39944459038,-2,1544,1935,10
39945159706,39945159703,-3,1012,2652,10
39957797101,39957797100,-1,1221,3407,10
39963994933,39963994931,-2,1439,3026,10
39966261119,39966261119,0,790,1241,10
39968851737,39968851737,0,3155,3149,10
39969274929,39969274927,-2,1090,1596,10
39975580331,39975580329,-2,825,2145,10
39975882812,39975882811,-1,1330,2164,10
39977511002,39977511001,-1,1070,1316,10
39979919464,39979919483,19,1026,2375,10
39980536938,39980536938,0,1273,2536,10
39980587025,39980587022,-3,1196,1647,10
39985191374,39985191371,-3,1568,1806,10
39988078517,39988078515,-2,1106,1707,10
39989597202,39989597201,-1,945,2605,10
39992875821,39992875818,-3,1330,2708,10
39994375247,39994375249,2,1842,2336,10
39998322254,39998322253,-1,1086,1706,10
40003571195,40003571195,0,2491,15176,10
40003773909,40003773907,-2,1133,1918,10
40009344518,40009344517,-1,1603,2040,10
40012334134,40012334132,-2,1285,1742,10
40015338332,40015338331,-1,888,1656,10
40016047414,40016047411,-3,765,1524,10
40017323202,40017323202,0,1146,1423,10
40019803279,40019803278,-1,1180,1845,10
40019856055,40019856054,-1,610,1099,10
40023669031,40023669034,3,1864,1464,10
40027168745,40027168741,-4,1184,1490,10
40029875346,40029875348,2,1334,1546,10
40030445279,40030445276,-3,1100,1826,10
40031773954,40031773952,-2,1511,1816,10
40031899020,40031899003,-17,24,245,10
40033234635,40033234630,-5,1158,2040,10
40037849452,40037849447,-5,1126,2328,10
40039196643,40039196641,-2,1227,1876,10
40041262611,40041262609,-2,1250,1782,10
40041778698,40041778694,-4,1028,1920,10
40041967792,40041967792,0,1293,1497,10
40044114626,40044114627,1,1622,1782,10
40045125931,40045125925,-6,2150,6003,10
40046933709,40046933710,1,1040,1240,10
40047063434,40047063433,-1,968,2702,10
40063643970,40063643978,8,3727,1893,10
40064407571,40064407570,-1,866,1297,10
40067398215,40067398214,-1,1375,1695,10
40067955562,40067955581,19,1694,2391,10
40069845226,40069845227,1,986,1501,10
40069962138,40069962138,0,1411,1830,10
40079871376,40079871375,-1,605,1325,10
40081250298,40081250317,19,473,1632,10
40082279130,40082279128,-2,1390,2566,10
40084056142,40084056142,0,1454,2362,10
40090541736,40090541731,-5,1154,3302,10
40093059234,40093059233,-1,1164,2665,10
40094868254,40094868255,1,1895,2603,10
40094893506,40094893503,-3,1422,2178,10
40098452833,40098452831,-2,1447,2276,10
40103792625,40103792630,5,3959,2121,10
40104701687,40104701686,-1,1368,1422,10
40104771752,40104771753,1,1603,2295,10
40109407855,40109407855,0,1475,2087,10
40111758437,40111758436,-1,1256,1733,10
40115546835,40115546832,-3,876,1897,10
40124224746,40124224754,8,12624,26626,10
40124912403,40124912402,-1,1077,2726,10
40127751167,40127751163,-4,1261,1720,10
40128012654,40128012650,-4,1273,2734,10
40128272542,40128272542,0,925,990,10
40131380030,40131380029,-1,964,1994,10
40139772783,40139772777,-6,1423,3698,10
40139928495,40139928492,-3,887,1592,10
40142271702,40142271699,-3,1590,2924,10
40143330198,40143330180,-18,1182,1932,10
40146136626,40146136621,-5,1678,4653,10
40150510898,40150510898,0,866,1518,10
40150712952,40150712953,1,1309,1333,10
40151692694,40151692694,0,1633,1545,10
40155572485,40155572483,-2,1571,2272,10
40158449726,40158449726,0,1546,2170,10
40159387001,40159386985,-16,1109,4878,10
40162934227,40162934205,-22,1124,1589,10
40166858106,40166858104,-2,946,1634,10
40167139230,40167139227,-3,1507,3493,10
40168579746,40168579745,-1,1557,2251,10
40168950424,40168950425,1,1135,1971,10
40169375559,40169375570,11,14468,32607,10
40171693264,40171693263,-1,885,1533,10
40171733086,40171733085,-1,1306,2166,10
40173347863,40173347862,-1,1173,1807,10
40179195450,40179195447,-3,1076,2224,10
40179438930,40179438910,-20,1454,2210,10
40180969846,40180969846,0,1075,1425,10
40181926246,40181926246,0,1195,1720,10
40185568898,40185568898,0,1530,1939,10
40188143793,40188143791,-2,1012,1439,10
40197760863,40197760862,-1,1525,2040,10
40198444490,40198444486,-4,896,1520,10
40202673136,40202673134,-2,1642,2861,10
40203127294,40203127294,0,1497,1615,10
40207780634,40207780633,-1,1286,1845,10
40211972187,40211972181,-6,1853,6168,10
40212594898,40212594897,-1,1252,2282,10
40213291895,40213291894,-1,1061,2339,10
40213973705,40213973706,1,1932,2379,10
40215295454,40215295454,0,1510,2084,10
40221452695,40221452693,-2,1446,1993,10
40223742219,40223742220,1,1141,1790,10
40224176101,40224176099,-2,1209,2304,10
40224702915,40224702913,-2,1403,1940,10
40224794930,40224794929,-1,1188,1983,10
40233431129,40233431126,-3,1313,2165,10
40237473290,40237473290,0,1266,2107,10
40240846970,40240846969,-1,1278,2074,10
40244891255,40244891255,0,1224,1255,10
40247517738,40247517736,-2,1179,2156,10
40251464171,40251464165,-6,1220,4237,10
40252168517,40252168517,0,1672,1743,10
40253747702,40253747698,-4,1157,2105,10
40254238266,40254238264,-2,1136,2464,10
40254582079,40254582078,-1,931,1862,10
40255347867,40255347866,-1,1078,1427,10
40257018066,40257018065,-1,1135,2096,10
40257683550,40257683550,0,17235,87849,10
40261596786,40261596773,-13,1162,1812,10
40268312055,40268312053,-2,1202,2357,10
40270309047,40270309043,-4,1056,2028,10
40272520760,40272520759,-1,1890,2263,10
40277833594,40277833595,1,1293,2092,10
40278594816,40278594814,-2,1241,1978,10
40278920097,40278920095,-2,833,1703,10
40279184471,40279184468,-3,1033,1978,10
40283269059,40283269058,-1,1068,1775,10
40286699549,40286699547,-2,1301,1431,10
40286889263,40286889263,0,1427,1893,10
40287603218,40287603216,-2,1199,2184,10
40287737402,40287737423,21,507,795,10
40287780149,40287780152,3,1048,1818,10
40288367898,40288367897,-1,913,1695,10
40288647520,40288647518,-2,297,576,10
40289814625,40289814627,2,2170,1848,10
40290942654,40290942653,-1,953,1915,10
40301885190,40301885189,-1,1621,2476,10
40304943058,40304943054,-4,1203,1730,10
40310716984,40310716982,-2,1508,2751,10
40314054498,40314054497,-1,1277,2433,10
40314384086,40314384085,-1,723,1064,10
40314787402,40314787403,1,266,443,10
40316242079,40316242080,1,1396,1700,10
40317791815,40317791813,-2,822,1709,10
40319689582,40319689583,1,1185,1447,10
40321847771,40321847772,1,1348,1770,10
40322200030,40322200030,0,1380,1667,10
40323102613,40323102614,1,1073,1727,10
40323416892,40323416911,19,1319,2156,10
40326517309,40326517307,-2,1198,1866,10
40330347414,40330347413,-1,1213,2177,10
40330674312,40330674306,-6,2370,11097,10
40333442312,40333442311,-1,917,1847,10
40340127231,40340127230,-1,1638,2155,10
40342531682,40342531682,0,1020,1404,10
40347015862,40347015861,-1,1550,2278,10
40347131726,40347131726,0,1321,2389,10
40356058202,40356058201,-1,810,1599,10
40356806136,40356806135,-1,1210,1976,10
40362450589,40362450591,2,1162,1715,10
40370161041,40370161041,0,1515,1914,10
40376762059,40376762053,-6,974,1916,10
40378825806,40378825803,-3,942,1554,10
40382231542,40382231541,-1,1099,2252,10
40383377706,40383377706,0,1038,1042,10
40386520359,40386520355,-4,1142,1806,10
40386770362,40386770362,0,1028,1780,10
40390928731,40390928732,1,1063,1263,10
40398235836,40398235842,6,3988,1748,10
40401371090,40401371088,-2,818,1419,10
40404442989,40404442987,-2,1512,2318,10
40406626921,40406626919,-2,1150,1847,10
40408823931,40408823930,-1,1125,1923,10
40409711750,40409711753,3,1092,1248,10
40410632037,40410632034,-3,1055,2115,10
40411369298,40411369298,0,1101,1693,10
40414574890,40414574887,-3,1010,2155,10
40424653630,40424653628,-2,1389,1867,10
40424944387,40424944385,-2,1096,1810,10
40426016748,40426016745,-3,1430,2919,10
40428868973,40428868970,-3,895,1646,10
40430655482,40430655499,17,1144,1441,10
40433539865,40433539865,0,1382,2138,10
40436123057,40436123057,0,1758,1482,10
40440787146,40440787145,-1,1552,1196,10
40441610894,40441610892,-2,1274,2864,10
40441863275,40441863274,-1,1292,2171,10
40442774227,40442774226,-1,1008,1711,10
40445695491,40445695491,0,1375,1972,10
40450373875,40450373875,0,1019,1861,10
40451884634,40451884633,-1,1035,1464,10
40452240110,40452240110,0,1406,2355,10
40454220311,40454220310,-1,1273,1685,10
40454610579,40454610577,-2,1349,2881,10
40459764122,40459764125,3,3586,2995,10
40461254413,40461254410,-3,1153,2524,10
40461860994,40461860995,1,1478,1848,10
40464479365,40464479364,-1,1011,1585,10
40467895667,40467895666,-1,1150,1767,10
40478590734,40478590731,-3,1169,2003,10
40479865941,40479865939,-2,863,1768,10
40482594969,40482594967,-2,1186,2150,10
40487326942,40487326941,-1,896,1812,10
40488262184,40488262182,-2,1474,1980,10
40490194996,40490194998,2,1363,1528,10
40492423007,40492423005,-2,540,946,10
40496727982,40496727980,-2,1368,2289,10
40497764811,40497764808,-3,1218,1907,10
40501646102,40501646101,-1,1321,2753,10
40503803625,40503803624,-1,1645,2274,10
40516376911,40516376911,0,1107,1570,10
40518670429,40518670427,-2,823,1622,10
40518776721,40518776709,-12,1350,1907,10
40519665081,40519665066,-15,1666,2433,10
40521185446,40521185443,-3,1337,1517,10
40525742871,40525742870,-1,1265,2008,10
40526822958,40526822955,-3,942,1353,10
40528693537,40528693537,0,1205,1195,10
40529220170,40529220167,-3,111,681,10
40530118629,40530118625,-4,1011,2254,10
40532183552,40532183553,1,1157,1114,10
40534498019,40534498018,-1,899,1680,10
40536042170,40536042166,-4,1311,2197,10
40536674305,40536674295,-10,1587,5452,10
40540673607,40540673608,1,1417,1688,10
40540840558,40540840556,-2,1021,1226,10
40541786714,40541786712,-2,1076,1990,10
40545757127,40545757107,-20,2356,1150,10
40547522857,40547522858,1,713,1365,10
40553644330,40553644327,-3,1468,3261,10
40559509435,40559509433,-2,707,1934,10
40562889950,40562889945,-5,787,3108,10
40562915175,40562915174,-1,1171,2121,10
40567746251,40567746248,-3,1007,1164,10
40569072846,40569072846,0,535,704,10
40569672257,40569672254,-3,1113,2329,10
40575315276,40575315274,-2,1878,2171,10
40578724539,40578724538,-1,588,1010,10
40578830693,40578830690,-3,1492,2078,10
40580716460,40580716457,-3,1260,1932,10
40583949326,40583949325,-1,1356,2187,10
40586824965,40586824962,-3,2059,2830,10
40589750107,40589750084,-23,2349,3559,10
40591820986,40591820984,-2,2693,5483,10
40591926624,40591926629,5,1363,837,10
40592154877,40592154871,-6,33187,10707,10
40595251270,40595251270,0,1206,1666,10
40597287718,40597287717,-1,1152,2040,10
40597547874,40597547874,0,1173,1361,10
40597779738,40597779757,19,806,1489,10
40604574147,40604574146,-1,1542,1957,10
40605652979,40605652977,-2,1566,2041,10
40607623851,40607623845,-6,816,2036,10
40608083606,40608083607,1,1832,1511,10
40609396394,40609396391,-3,1216,2137,10
40610155018,40610155022,4,1445,1285,10
40611009012,40611009029,17,1738,2489,10
40613865230,40613865229,-1,1269,2105,10
40614517285,40614517282,-3,872,1315,10
40617034139,40617034138,-1,1181,1860,10
40620972471,40620972469,-2,1041,1504,10
40625625702,40625625702,0,997,1916,10
40633894135,40633894134,-1,1644,2078,10
40634086967,40634086966,-1,1459,1427,10
40635525130,40635525130,0,2081,1686,10
40638058237,40638058236,-1,1130,1796,10
40639056022,40639056021,-1,866,2542,10
40640319155,40640319150,-5,1567,2632,10
40647071363,40647071362,-1,1057,2576,10
40650176838,40650176837,-1,1163,1607,10
40650354841,40650354859,18,785,1545,10
40650919550,40650919549,-1,1084,2074,10
40655195580,40655195580,0,1380,1182,10
40657153226,40657153226,0,996,1591,10
40657492970,40657492967,-3,1370,1747,10
40658995827,40658995825,-2,1005,2017,10
40661657230,40661657248,18,1017,1512,10
40663381956,40663381954,-2,1465,2033,10
40665367603,40665367600,-3,1420,2757,10
40665439192,40665439186,-6,931,1547,10
40679211038,40679211036,-2,1321,2299,10
40679430719,40679430717,-2,760,1575,10
40681736489,40681736493,4,2761,2229,10
40685046144,40685046141,-3,968,2506,10
40686711391,40686711392,1,1394,1410,10
40688800871,40688800869,-2,998,2427,10
40695300802,40695300800,-2,1290,1578,10
40697039045,40697039042,-3,1162,1756,10
40699797617,40699797617,0,1149,1950,10
40700180274,40700180272,-2,1047,2009,10
40700468989,40700468986,-3,640,1691,10
40701372254,40701372258,4,2421,1670,10
40702453878,40702453872,-6,2663,4213,10
40706080378,40706080375,-3,1607,2054,10
40708048255,40708048251,-4,975,2150,10
40708856087,40708856083,-4,1008,1510,10
40709369160,40709369158,-2,969,1029,10
40714353605,40714353602,-3,1366,2778,10
40717612980,40717612979,-1,1988,2390,10
40719746973,40719746975,2,1232,1634,10
40719985599,40719985598,-1,1599,2394,10
40722779162,40722779162,0,1329,2145,10
40723434402,40723434397,-5,957,2167,10
40723532406,40723532403,-3,911,1573,10
40728011759,40728011758,-1,912,1476,10
40728094258,40728094258,0,858,1996,10
40732451978,40732451976,-2,912,1193,10
40732637323,40732637321,-2,1098,2431,10
40738476761,40738476759,-2,1190,1553,10
40738506118,40738506116,-2,2066,2501,10
40738535348,40738535347,-1,1014,2922,10
40740282193,40740282190,-3,1613,3163,10
40742537638,40742537637,-1,1070,1901,10
40745723734,40745723733,-1,2106,2269,10
40745825558,40745825557,-1,1352,2235,10
40750852098,40750852097,-1,1163,2001,10
40752669267,40752669266,-1,1136,1889,10
40753228394,40753228393,-1,104,1389,10
40753794033,40753794030,-3,960,1277,10
40757176575,40757176576,1,1524,1679,10
40762031578,40762031578,0,1547,2001,10
40764452547,40764452546,-1,1233,2072,10
40765756150,40765756149,-1,1289,2565,10
40775582397,40775582396,-1,3889,19101,10
40776705187,40776705189,2,1184,1296,10
40779423683,40779423685,2,895,2017,10
40782553150,40782553149,-1,1376,2363,10
40783234147,40783234145,-2,1257,2331,10
40783619736,40783619736,0,1203,1853,10
40786253258,40786253258,0,1368,1968,10
40786941713,40786941709,-4,1108,1489,10
40788686563,40788686562,-1,1135,1769,10
40788743611,40788743603,-8,1194,1973,10
40791561358,40791561356,-2,1021,1622,10
40794689109,40794689108,-1,821,1327,10
40800048034,40800048034,0,2094,3060,10
40802116710,40802116710,0,1410,2307,10
40806633585,40806633583,-2,847,2070,10
40806746986,40806746986,0,1324,1980,10
40807284465,40807284460,-5,964,2610,10
40809244949,40809244946,-3,1116,2205,10
40809962765,40809962762,-3,1210,2180,10
40810088210,40810088195,-15,1096,1930,10
40812148353,40812148353,0,1069,1661,10
40814325826,40814325825,-1,1651,2117,10
40818375713,40818375713,0,1068,2257,10
40819362472,40819362494,22,812,1458,10
40820910723,40820910721,-2,1186,1625,10
40821210507,40821210492,-15,1207,1918,10
40821677146,40821677143,-3,1795,2466,10
40824323687,40824323686,-1,1162,2023,10
40824536214,40824536210,-4,928,3822,10
40825001322,40825001318,-4,1021,1710,10
40832260511,40832260510,-1,1157,1714,10
40843167970,40843167970,0,1499,1691,10
40844699742,40844699742,0,1061,2793,10
40853561485,40853561483,-2,1232,1937,10
40853797377,40853797396,19,625,1215,10
40855545408,40855545406,-2,1352,2029,10
40857788859,40857788858,-1,1623,1797,10
40859722421,40859722406,-15,41,775,10
40861268654,40861268653,-1,1484,2645,10
40865491931,40865491926,-5,1494,3336,10
40875967240,40875967238,-2,1115,1805,10
40877015875,40877015857,-18,1137,1560,10
40878034982,40878034986,4,1022,1313,10
40879274365,40879274365,0,1732,2336,10
40883370717,40883370715,-2,1334,1940,10
40884132351,40884132352,1,1047,1984,10
40885095635,40885095635,0,1179,1753,10
40888462542,40888462542,0,958,1366,10
40888731639,40888731637,-2,1238,2000,10
40891582253,40891582255,2,1255,1950,10
40892252228,40892252226,-2,738,875,10
40896238633,40896238631,-2,1401,2164,10
40896811146,40896811142,-4,1495,2293,10
40898289982,40898289981,-1,1517,1945,10
40898350334,40898350333,-1,1204,2267,10
40901133953,40901133949,-4,602,929,10
40901342872,40901342891,19,375,751,10
40905316681,40905316687,6,19615,45302,10
40909404766,40909404757,-9,1040,1511,10
40912277138,40912277137,-1,1405,2012,10
40914877265,40914877265,0,1386,1780,10
40915884230,40915884229,-1,470,1355,10
40918223542,40918223542,0,1655,2034,10
40921016674,40921016671,-3,4800,9813,10
40922841399,40922841393,-6,4667,12966,10
40929718550,40929718549,-1,1056,2588,10
40933509157,40933509154,-3,1086,1639,10
40934338398,40934338402,4,3728,2516,10
40935776685,40935776682,-3,1334,1814,10
40937668466,40937668462,-4,1303,1712,10
40938915101,40938915101,0,1173,1645,10
40939177775,40939177771,-4,970,2958,10
40940127754,40940127753,-1,1179,2304,10
40940219726,40940219724,-2,828,1440,10
40941519816,40941519815,-1,1157,1877,10
40942703774,40942703774,0,1044,1662,10
40948628416,40948628409,-7,332,409,10
40949977519,40949977518,-1,1038,2102,10
40952050917,40952050918,1,1245,2198,10
40952486680,40952486681,1,1404,1422,10
40955135662,40955135663,1,1083,1320,10
40955802341,40955802341,0,1393,2529,10
40959012570,40959012570,0,1083,1427,10
40960091010,40960090996,-14,1212,2384,10
40960343320,40960343317,-3,970,1439,10
40969495022,40969495018,-4,1438,1680,10
40973491931,40973491930,-1,997,1894,10
40981062616,40981062614,-2,1100,1694,10
40981582098,40981582097,-1,1461,2257,10
40995407758,40995407758,0,1172,1991,10
40996626351,40996626349,-2,691,1338,10
41000113529,41000113529,0,1337,1824,10
41002466037,41002466046,9,7310,33103,10
41004452931,41004452933,2,24777,21160,10
41008437834,41008437833,-1,1713,2675,10
41010784212,41010784213,1,1393,1039,10
41012097318,41012097318,0,1454,2179,10
41012808661,41012808657,-4,1527,1756,10
41018513842,41018513840,-2,770,1707,10
41021737411,41021737410,-1,1189,2777,10
41024520521,41024520519,-2,1770,2775,10
41026557875,41026557878,3,1051,1868,10
41027141843,41027141841,-2,1244,2011,10
41029269155,41029269153,-2,1147,1465,10
41031401793,41031401791,-2,1400,2308,10
41034621195,41034621194,-1,981,1376,10
41044008307,41044008310,3,2157,1041,10
41046647577,41046647582,5,2984,1861,10
41050472825,41050472823,-2,1351,2244,10
41050730418,41050730438,20,577,1417,10
41057849894,41057849894,0,1242,1960,10
41061096061,41061096059,-2,943,1354,10
41062071522,41062071522,0,1250,2001,10
41063458857,41063458857,0,1343,2030,10
41064276954,41064276951,-3,1605,2805,10
41066195452,41066195450,-2,907,1643,10
41066428523,41066428528,5,868,1069,10
41066531640,41066531638,-2,1143,1698,10
41066790485,41066790490,5,1874,1680,10
41070389771,41070389770,-1,1739,2046,10
41070964822,41070964821,-1,690,2103,10
41071952378,41071952377,-1,1413,1623,10
41075398871,41075398871,0,1446,2863,10
41077182822,41077182822,0,907,1503,10
41080693782,41080693782,0,1131,2095,10
41080908105,41080908101,-4,1394,2537,10
41081182245,41081182250,5,1928,1232,10
41082569691,41082569687,-4,1089,2399,10
41087785463,41087785458,-5,1301,2279,10
41088446618,41088446616,-2,1029,2155,10
41090435669,41090435668,-1,1015,2052,10
41091869503,41091869502,-1,1539,2843,10
41102027595,41102027594,-1,1289,1828,10
41102948233,41102948233,0,977,1757,10
41104119706,41104119703,-3,1185,2068,10
41104872218,41104872216,-2,465,2072,10
41108703313,41108703310,-3,975,2990,10
41108766314,41108766331,17,1253,2215,10
41109113642,41109113641,-1,1785,2440,10
41109302619,41109302613,-6,1106,2667,10
41112084722,41112084722,0,1690,1842,10
41112735246,41112735245,-1,1098,1717,10
41113677497,41113677495,-2,1223,2166,10
41117481213,41117481213,0,1291,1252,10
41118501033,41118501032,-1,1021,2076,10
41119445239,41119445237,-2,1057,2290,10
41120737611,41120737612,1,1413,2335,10
41125045774,41125045790,16,333,949,10
41126392858,41126392856,-2,1505,1557,10
41126614418,41126614414,-4,1533,3568,10
41126701183,41126701182,-1,1209,1624,10
41132272092,41132272093,1,3859,2782,10
41133790355,41133790358,3,1209,1015,10
41138349340,41138349338,-2,1326,1592,10
41142518318,41142518306,-12,45752,52618,10
41145096546,41145096547,1,1053,1430,10
41147247229,41147247230,1,1386,1688,10
41148001934,41148001933,-1,1168,2175,10
41155928641,41155928638,-3,895,1638,10
41158103746,41158103745,-1,1108,1429,10
41159847205,41159847201,-4,1293,1964,10
41160853338,41160853338,0,1470,1313,10
41163531904,41163531901,-3,1540,2095,10
41166450188,41166450207,19,1087,2151,10
41169618222,41169618227,5,4569,2201,10
41171545689,41171545685,-4,1572,2307,10
41171979683,41171979672,-11,1029,2306,10
41181092145,41181092146,1,981,1662,10
41181879065,41181879064,-1,1900,3280,10
41185532918,41185532917,-1,1392,1992,10
41186566141,41186566138,-3,1281,2139,10
41189603541,41189603539,-2,1349,2395,10
41189833162,41189833161,-1,1121,1991,10
41194537076,41194537073,-3,1254,2730,10
41196371118,41196371115,-3,1208,1550,10
41203622365,41203622363,-2,1199,1373,10
41204126288,41204126287,-1,1437,1915,10
41214540654,41214540651,-3,961,2681,10
41215553302,41215553303,1,1858,1732,10
41218283754,41218283753,-1,1047,1766,10
41218333653,41218333654,1,1028,2230,10
41220800607,41220800604,-3,651,1553,10
41223763971,41223763967,-4,984,2629,10
41227787182,41227787181,-1,1741,2407,10
41235646555,41235646554,-1,35636,20653,10
41236725974,41236725973,-1,764,1924,10
41246451971,41246451970,-1,1204,1641,10
41246670203,41246670201,-2,1483,2000,10
41249247355,41249247353,-2,1102,1597,10
41250429031,41250429028,-3,1606,1873,10
41250457513,41250457518,5,1290,755,10
41250967602,41250967590,-12,43023,18243,10
41251628281,41251628279,-2,1090,1478,10
41251841476,41251841475,-1,1202,1991,10
41254658272,41254658271,-1,1514,1848,10
41255655575,41255655574,-1,1264,1765,10
41257842396,41257842396,0,1782,1817,10
41260132943,41260132942,-1,1121,1879,10
41260817107,41260817125,18,767,1457,10
41265708737,41265708742,5,2533,1885,10
41265779378,41265779374,-4,1520,1999,10
41266725206,41266725206,0,1715,2533,10
41272168430,41272168426,-4,2685,7234,10
41272622412,41272622405,-7,2041,6151,10
41279814154,41279814151,-3,2223,3323,10
41281701613,41281701613,0,755,1754,10
41287901983,41287901981,-2,1198,1843,10
41288715426,41288715423,-3,23783,11174,10
41292114074,41292114075,1,1546,2019,10
41292342290,41292342278,-12,804,1461,10
41293786118,41293786114,-4,1472,4568,10
41294417769,41294417769,0,1159,1538,10
41295794607,41295794606,-1,1130,2017,10
41296913888,41296913887,-1,1001,1456,10
41297553020,41297553018,-2,916,1456,10
41300851256,41300851254,-2,1082,1847,10
41301853834,41301853833,-1,1423,2100,10
41303587366,41303587361,-5,2026,8197,10
41304855277,41304855289,12,17809,6990,10
41309981097,41309981092,-5,1335,2440,10
41311753326,41311753324,-2,1624,1887,10
41312802647,41312802645,-2,926,2101,10
41319822483,41319822481,-2,848,1382,10
41327229743,41327229754,11,789,1064,10
41328579911,41328579907,-4,1181,1275,10
41329045525,41329045532,7,10718,26564,10
41329558151,41329558150,-1,1368,2829,10
41331789136,41331789134,-2,989,1354,10
41333018271,41333018248,-23,1206,1855,10
41337326789,41337326787,-2,1224,1766,10
41338970822,41338970819,-3,1382,1619,10
41339291355,41339291353,-2,1233,2706,10
41339545062,41339545061,-1,1540,1694,10
41340513136,41340513134,-2,1155,2082,10
41341303721,41341303742,21,811,2253,10
41341437465,41341437459,-6,1194,2877,10
41342511113,41342511111,-2,1840,2618,10
41343201620,41343201617,-3,739,2477,10
41343693323,41343693323,0,1154,1879,10
41343767686,41343767686,0,1323,1760,10
41350541530,41350541529,-1,1061,2336,10
41356589714,41356589713,-1,1143,2180,10
41356775356,41356775359,3,1302,1311,10
41357132061,41357132068,7,3247,1142,10
41363499275,41363499272,-3,993,1225,10
41365162173,41365162173,0,1128,2380,10
41366073045,41366073042,-3,1550,2259,10
41369466505,41369466503,-2,1332,1602,10
41372429786,41372429786,0,1285,2288,10
41375822949,41375822946,-3,1607,1719,10
41378785082,41378785079,-3,771,2299,10
41381502672,41381502671,-1,1178,2303,10
41382574792,41382574789,-3,1187,2452,10
41384854762,41384854762,0,897,1565,10
41385393231,41385393230,-1,1659,2020,10
41386355538,41386355531,-7,1458,7313,10
41391457679,41391457677,-2,1329,2039,10
41396319030,41396319029,-1,877,1518,10
41397060445,41397060447,2,1423,1660,10
41398642937,41398642936,-1,1101,2140,10
41401549927,41401549925,-2,1191,2382,10
41402488266,41402488265,-1,1362,1774,10
41403871038,41403871040,2,1564,2170,10
41405505349,41405505349,0,905,1151,10
41405988418,41405988415,-3,1283,1499,10
41406775110,41406775116,6,13425,5676,10
41407233093,41407233092,-1,1184,1780,10
41409487031,41409487034,3,1143,1179,10
41411521773,41411521771,-2,986,2080,10
41420581695,41420581694,-1,1683,2514,10
41423032013,41423032011,-2,1481,2658,10
41428045791,41428045789,-2,1025,1604,10
41429967618,41429967619,1,949,1219,10
41431263457,41431263455,-2,1367,1598,10
41433535115,41433535114,-1,17779,10335,10
41437280405,41437280401,-4,1422,3265,10
41439603438,41439603439,1,2426,4051,10
41442390756,41442390753,-3,1047,2228,10
41443631355,41443631354,-1,1301,1709,10
41444032067,41444032066,-1,1884,1927,10
41445186461,41445186460,-1,1134,1677,10
41448216591,41448216592,1,1161,2124,10
41448667624,41448667606,-18,897,1796,10
41451375094,41451375095,1,1432,1977,10
41452797410,41452797409,-1,1149,2047,10
41456419185,41456419183,-2,1702,2671,10
41460109296,41460109294,-2,1049,1750,10
41463734893,41463734887,-6,991,2709,10
41466370145,41466370145,0,1046,1422,10
41466664077,41466664077,0,811,1679,10
41468024926,41468024923,-3,908,1833,10
41470779591,41470779590,-1,1076,1766,10
41474441957,41474441956,-1,1305,2071,10
41480200998,41480200995,-3,1290,1433,10
41482674510,41482674505,-5,712,1143,10
41482959364,41482959378,14,528,1259,10
41484934302,41484934295,-7,1493,7934,10
41487787734,41487787734,0,1673,2259,10
41491207111,41491207110,-1,892,1617,10
41493899794,41493899798,4,1981,1207,10
41494129306,41494129304,-2,1050,1777,10
41494420882,41494420878,-4,1218,1801,10
41494762668,41494762685,17,1076,1922,10
41495738426,41495738430,4,2040,1519,10
41499233638,41499233639,1,884,800,10
41503404030,41503404030,0,1504,1483,10
41512936229,41512936227,-2,1591,3198,10
41515521024,41515521022,-2,1521,1911,10
41520176551,41520176551,0,1218,1552,10
41520306315,41520306314,-1,1204,1463,10
41520609278,41520609274,-4,1540,3755,10
41521559237,41521559237,0,1057,2444,10
41522660169,41522660166,-3,1035,1958,10
41526593895,41526593894,-1,1082,1583,10
41535085766,41535085761,-5,1185,1466,10
41536078201,41536078200,-1,1093,2014,10
41539126767,41539126765,-2,1095,2093,10
41540704332,41540704331,-1,1390,1449,10
41543189388,41543189405,17,594,1781,10
41544095133,41544095131,-2,1006,2180,10
41546990958,41546990954,-4,1040,2381,10
41548686193,41548686193,0,1274,1729,10
41550223121,41550223121,0,1804,2456,10
41557011315,41557011314,-1,1203,1593,10
41557658865,41557658861,-4,492,2178,10
41561225966,41561225962,-4,1122,2308,10
41563541838,41563541836,-2,1585,2197,10
41568743070,41568743070,0,1298,1500,10
41570140110,41570140108,-2,962,1503,10
41571013603,41571013600,-3,1328,2201,10
41573119747,41573119745,-2,1267,1774,10
41573803901,41573803892,-9,10927,17826,10
41575798143,41575798141,-2,1163,2097,10
41581022643,41581022642,-1,1296,1720,10
41587365118,41587365117,-1,1028,1896,10
41589106539,41589106537,-2,1446,3146,10
41590830597,41590830596,-1,1223,1730,10
41592358178,41592358178,0,1267,2076,10
41592641345,41592641344,-1,1187,1722,10
41594531790,41594531788,-2,1054,2041,10
41599918135,41599918114,-21,1062,1655,10
41603077639,41603077636,-3,30802,31736,10
41611439356,41611439350,-6,985,1614,10
41613431629,41613431625,-4,1361,2577,10
41616497320,41616497318,-2,1521,3281,10
41620213139,41620213134,-5,1880,2687,10
41621410390,41621410389,-1,1548,1915,10
41621703126,41621703125,-1,1318,1397,10
41622783426,41622783422,-4,1729,2197,10
41623302951,41623302950,-1,1160,1703,10
41624637779,41624637779,0,995,1702,10
41627629794,41627629794,0,780,1353,10
41630142735,41630142733,-2,1685,2397,10
41634908937,41634908935,-2,1441,2530,10
41636033399,41636033398,-1,1080,1779,10
41636654652,41636654660,8,1203,492,10
41638234699,41638234698,-1,1305,1777,10
41638841463,41638841461,-2,1010,1838,10
41640521327,41640521326,-1,1405,2000,10
41642832214,41642832215,1,1267,2290,10
41644552950,41644552947,-3,1335,1808,10
41646700009,41646700006,-3,1288,1782,10
41649359413,41649359410,-3,1453,1632,10
41653486484,41653486482,-2,1177,1227,10
41662239213,41662239213,0,1111,1415,10
41664324947,41664324945,-2,1527,1704,10
41664686612,41664686611,-1,937,1963,10
41672292596,41672292598,2,1238,1358,10
41677937790,41677937789,-1,1405,3274,10
41678772746,41678772747,1,926,1474,10
41681854746,41681854743,-3,1448,3053,10
41682426722,41682426722,0,1439,2168,10
41684435042,41684435040,-2,1097,1675,10
41684929329,41684929326,-3,1152,1813,10
41687999610,41687999610,0,1167,1355,10
41691268474,41691268471,-3,1257,1986,10
41700914198,41700914200,2,2113,1953,10
41704817529,41704817530,1,1689,1713,10
41705529670,41705529667,-3,1134,2711,10
41707883486,41707883484,-2,1430,2245,10
41708782450,41708782457,7,5306,2413,10
41712016159,41712016163,4,633,953,10
41714121281,41714121278,-3,1453,2337,10
41714254697,41714254694,-3,1504,1966,10
41715638927,41715638923,-4,1053,1532,10
41718223998,41718223995,-3,973,2095,10
41719528781,41719528781,0,1506,2425,10
41724540842,41724540841,-1,1511,2511,10
41726897263,41726897261,-2,1095,2298,10
41731064570,41731064571,1,1412,1581,10
41733036235,41733036233,-2,980,1654,10
41733613102,41733613109,7,5506,2449,10
41741908943,41741908941,-2,1121,1913,10
41750370570,41750370569,-1,1760,2579,10
41753887443,41753887459,16,1778,2409,10
41754712235,41754712235,0,1075,1614,10
41757411987,41757411985,-2,1384,2270,10
41760498136,41760498133,-3,1143,2162,10
41762420698,41762420697,-1,1515,2429,10
41763861470,41763861470,0,1283,1529,10
41764239731,41764239738,7,412,1085,10
41772009190,41772009190,0,1224,2186,10
41774280806,41774280806,0,1252,2635,10
41783045182,41783045182,0,2057,1891,10
41783560594,41783560593,-1,1100,1786,10
41784171773,41784171770,-3,2680,4223,10
41785622114,41785622113,-1,1337,2011,10
41787706139,41787706143,4,35325,31166,10
41789142859,41789142857,-2,1255,1536,10
41790616935,41790616931,-4,1122,1458,10
41791306575,41791306574,-1,954,2705,10
41792243978,41792243978,0,1130,1676,10
41794254147,41794254146,-1,1358,2187,10
41797696234,41797696232,-2,1136,1466,10
41802164231,41802164231,0,875,1610,10
41802864626,41802864625,-1,1591,1714,10
41802988596,41802988597,1,3726,3740,10
41806580537,41806580538,1,1212,1980,10
41808647146,41808647146,0,1365,1579,10
41812694694,41812694693,-1,1387,1374,10
41812851343,41812851342,-1,808,1420,10
41823130069,41823130068,-1,995,1975,10
41823176877,41823176875,-2,1297,2252,10
41830699370,41830699367,-3,1384,2250,10
41834425829,41834425829,0,1216,2277,10
41841235619,41841235618,-1,1154,1947,10
41844322623,41844322622,-1,948,1609,10
41846430889,41846430882,-7,1948,6442,10
41852814893,41852814887,-6,1499,2258,10
41858924474,41858924473,-1,623,1266,10
41865159958,41865159954,-4,1364,1799,10
41865186699,41865186694,-5,1203,2132,10
41871923215,41871923211,-4,1217,2182,10
41873228900,41873228898,-2,1560,2248,10
41875855718,41875855717,-1,1476,1815,10
41881878035,41881878035,0,1221,2032,10
41887210082,41887210082,0,1476,1980,10
41892232015,41892232014,-1,1222,2075,10
41893237553,41893237551,-2,997,2278,10
41898013097,41898013094,-3,1069,1852,10
41902614254,41902614253,-1,1655,1645,10
41904531941,41904531940,-1,1201,1852,10
41904948890,41904948902,12,575,1742,10
41905844814,41905844812,-2,1335,1850,10
41906599375,41906599378,3,1205,1297,10
41907493972,41907493971,-1,1197,2415,10
41909419420,41909419419,-1,1882,2598,10
41910936149,41910936150,1,999,2218,10
41912431130,41912431133,3,1256,1725,10
41912762799,41912762798,-1,1091,2311,10
41915870726,41915870727,1,1526,1738,10
41924688586,41924688585,-1,889,1517,10
41930819670,41930819668,-2,938,1679,10
41931225336,41931225319,-17,1059,2078,10
41934079655,41934079655,0,969,1532,10
41935806623,41935806622,-1,1147,2090,10
41937442738,41937442737,-1,1291,2340,10
41938325385,41938325406,21,1102,1779,10
41945382008,41945382007,-1,1126,2286,10
41946382304,41946382302,-2,1071,2286,10
41947160171,41947160169,-2,1022,1245,10
41949056602,41949056623,21,928,1495,10
41954544287,41954544287,0,874,1906,10
41959067950,41959067949,-1,1439,2413,10
41959195820,41959195818,-2,1246,2119,10
41960065628,41960065632,4,3947,2916,10
41962671945,41962671957,12,10159,37090,10
41963961757,41963961757,0,1395,2129,10
41969848315,41969848315,0,1234,2259,10
41973121399,41973121398,-1,1780,2222,10
41973482529,41973482526,-3,1114,2177,10
41973576527,41973576534,7,36143,14704,10
41974275534,41974275534,0,1879,2477,10
41982597266,41982597266,0,837,1949,10
41983726922,41983726922,0,1215,2413,10
41987663847,41987663854,7,5590,2021,10
41990954569,41990954571,2,2077,1491,10
41991007179,41991007178,-1,1626,2066,10
41995411677,41995411675,-2,1014,2071,10
42000912726,42000912727,1,1015,1311,10
42002675184,42002675182,-2,1713,3161,10
42010803610,42010803609,-1,1043,1933,10
42012608214,42012608208,-6,1157,2414,10
42013838906,42013838906,0,1067,1328,10
42014661374,42014661372,-2,663,1721,10
42017954650,42017954650,0,875,1285,10
42020751093,42020751092,-1,1075,2094,10
42022091790,42022091797,7,2119,1172,10
42023659982,42023659983,1,1447,1105,10
42024521409,42024521409,0,1260,1531,10
42026686699,42026686698,-1,1289,1610,10
42029891822,42029891821,-1,926,2220,10
42031657582,42031657581,-1,1099,1330,10
42032280806,42032280803,-3,1296,2555,10
42035874675,42035874676,1,1110,1681,10
42038679778,42038679779,1,994,1664,10
42041743861,42041743858,-3,1142,2353,10
42048226606,42048226606,0,1592,2452,10
42050227397,42050227394,-3,1412,1626,10
42051292251,42051292269,18,512,1056,10
42058443318,42058443315,-3,1214,1755,10
42058675674,42058675674,0,795,1368,10
42061959327,42061959325,-2,1134,2403,10
42066537679,42066537680,1,985,1576,10
42070073906,42070073907,1,1432,2063,10
42070163363,42070163366,3,1709,1690,10
42072122917,42072122918,1,1390,1410,10
42072599332,42072599329,-3,1305,2550,10
42074924558,42074924556,-2,1470,1927,10
42075147498,42075147499,1,1271,1687,10
42078197847,42078197845,-2,1388,1757,10
42080167602,42080167601,-1,1326,2590,10
42083376343,42083376346,3,1341,1548,10
42085829737,42085829736,-1,1188,2297,10
42087969647,42087969646,-1,1125,1215,10
42088530934,42088530934,0,1263,2564,10
42092798730,42092798725,-5,1238,2293,10
42095214234,42095214234,0,1167,2004,10
42096836443,42096836442,-1,816,1305,10
42097203536,42097203535,-1,1267,1276,10
42099990394,42099990396,2,1092,1786,10
42105117934,42105117931,-3,1079,2159,10
42105254272,42105254263,-9,34,523,10
42108451833,42108451833,0,1239,1608,10
42109925763,42109925764,1,1282,1704,10
42111067470,42111067469,-1,1710,2201,10
42112201857,42112201855,-2,1092,2032,10
42113493621,42113493618,-3,1611,2095,10
42115728829,42115728827,-2,1295,2801,10
42119191504,42119191503,-1,1052,1675,10
42119445603,42119445602,-1,2274,3705,10
42134259242,42134259244,2,1818,1480,10
42137325092,42137325091,-1,1689,2989,10
42141822334,42141822335,1,1442,1732,10
42142861522,42142861522,0,1543,2331,10
42145121473,42145121471,-2,1889,2619,10
42146723306,42146723307,1,888,2000,10
42150483490,42150483489,-1,794,1565,10
42151242047,42151242042,-5,1067,1605,10
42152197195,42152197193,-2,1056,2002,10
42155043999,42155043997,-2,1671,2397,10
42155947658,42155947656,-2,1120,1281,10
42157305452,42157305471,19,985,1883,10
42158081906,42158081907,1,1667,1561,10
42162822637,42162822638,1,801,1563,10
42166474448,42166474446,-2,1101,1383,10
42170216610,42170216609,-1,1298,1578,10
42170673308,42170673310,2,1844,1366,10
42173012961,42173012962,1,1091,1289,10
42177708325,42177708325,0,1255,2269,10
42181872202,42181872198,-4,1017,3541,10
42194862419,42194862415,-4,1350,2097,10
42195969790,42195969788,-2,1323,2446,10
42196428878,42196428877,-1,3163,3916,10
42197467313,42197467322,9,3737,1154,10
42198743476,42198743475,-1,1492,1712,10
42199427637,42199427641,4,2502,1975,10
42200366429,42200366427,-2,1118,2549,10
42202151429,42202151430,1,1170,2198,10
42203589797,42203589797,0,1426,1998,10
42207933335,42207933334,-1,1232,1798,10
42209265578,42209265575,-3,880,1931,10
42209706381,42209706381,0,1109,1944,10
42210309346,42210309346,0,1384,2393,10
42212953246,42212953244,-2,1169,2311,10
42213268145,42213268139,-6,1021,1342,10
42213660250,42213660250,0,1346,1853,10
42214616054,42214616050,-4,1875,3910,10
42215171563,42215171562,-1,1291,2314,10
42220556715,42220556709,-6,1029,3862,10
42221382962,42221382962,0,1200,1888,10
42222397315,42222397314,-1,1223,2041,10
42225837321,42225837319,-2,1494,1735,10
42228062477,42228062477,0,1896,2648,10
42230425043,42230425039,-4,923,1486,10
42233502393,42233502390,-3,1365,2162,10
42234781470,42234781468,-2,1100,2610,10
42237763112,42237763111,-1,1223,1941,10
42238859616,42238859614,-2,1115,1724,10
42240936167,42240936174,7,2334,28205,10
42241695058,42241695057,-1,1390,2110,10
42245430037,42245430034,-3,1055,4118,10
42248616912,42248616912,0,918,1260,10
42249478455,42249478458,3,8672,7952,10
42252409103,42252409098,-5,1148,4549,10
42255219239,42255219237,-2,1200,1742,10
42261035054,42261035051,-3,835,1803,10
42262925515,42262925513,-2,1396,2798,10
42267183726,42267183723,-3,1841,2364,10
42268516426,42268516422,-4,1131,1880,10
42268862172,42268862171,-1,1162,1893,10
42270660895,42270660893,-2,1383,1932,10
42276617106,42276617105,-1,1233,1818,10
42277669227,42277669226,-1,872,1795,10
42283061730,42283061731,1,814,1276,10
42284600556,42284600537,-19,1257,1671,10
42289118509,42289118506,-3,2041,5865,10
42290389018,42290389016,-2,2001,2812,10
42293132791,42293132789,-2,1017,1398,10
42302028038,42302028038,0,1536,1895,10
42304008194,42304008194,0,1201,1467,10
42306219238,42306219235,-3,579,1186,10
42306538795,42306538814,19,402,949,10
42306617425,42306617423,-2,1700,2509,10
42308653052,42308653053,1,1206,1685,10
42309996899,42309996897,-2,864,1863,10
42313255690,42313255686,-4,1447,2919,10
42315764636,42315764634,-2,944,2053,10
42317071798,42317071794,-4,1177,1783,10
42317877642,42317877641,-1,849,1512,10
42319548439,42319548435,-4,1101,1406,10
42320727194,42320727191,-3,1107,2892,10
42322404198,42322404199,1,1107,1818,10
42328209342,42328209342,0,1606,2549,10
42328601553,42328601551,-2,1219,2032,10
42332396564,42332396566,2,1747,1443,10
42337774276,42337774299,23,766,1756,10
42341324883,42341324880,-3,868,1369,10
42342502270,42342502270,0,804,2057,10
42343349262,42343349259,-3,1081,2234,10
42347042638,42347042639,1,1176,1118,10
42350201152,42350201150,-2,1473,1991,10
42350667448,42350667443,-5,1079,1156,10
42353689459,42353689459,0,807,1211,10
42354637678,42354637679,1,1071,1852,10
42357294198,42357294196,-2,1226,1917,10
42358416899,42358416898,-1,968,1736,10
42361189634,42361189634,0,1297,1432,10
42363103671,42363103668,-3,878,1442,10
42366669258,42366669258,0,1116,1246,10
42366978810,42366978830,20,1270,1771,10
42367876804,42367876803,-1,1395,1666,10
42368744458,42368744457,-1,1104,1763,10
42370331323,42370331331,8,4155,1751,10
42370549402,42370549404,2,1335,1891,10
42375973197,42375973204,7,3380,1736,10
42377836448,42377836448,0,1647,2017,10
42377886353,42377886352,-1,1333,1507,10
42379721529,42379721534,5,1832,1164,10
42382674739,42382674738,-1,1238,1868,10
42386050600,42386050598,-2,1057,1533,10
42386319579,42386319574,-5,1114,2214,10
42387578238,42387578236,-2,1197,2026,10
42388882529,42388882528,-1,1024,1861,10
42391294386,42391294386,0,844,1324,10
42395596049,42395596070,21,1710,2535,10
42396900935,42396900942,7,5243,2018,10
42397310170,42397310170,0,1038,1315,10
42397411986,42397411985,-1,1261,1665,10
42404460045,42404460042,-3,1179,1831,10
42405811133,42405811130,-3,1034,1703,10
42408513145,42408513145,0,1028,2028,10
42408971987,42408971986,-1,1117,1872,10
42412362891,42412362891,0,1607,2460,10
42412755972,42412755973,1,1387,1616,10
42414086238,42414086238,0,16644,10387,10
42414489590,42414489589,-1,1092,2215,10
42415287292,42415287290,-2,1589,2378,10
42415854499,42415854506,7,1145,1699,10
42420792340,42420792340,0,1349,1653,10
42424916322,42424916319,-3,1242,2392,10
42426395689,42426395688,-1,1107,1512,10
42434624287,42434624287,0,1250,1210,10
42437271975,42437271974,-1,759,1581,10
42438331505,42438331502,-3,1626,2579,10
42438723641,42438723630,-11,224,1070,10
42440603761,42440603762,1,1383,1794,10
42440636764,42440636782,18,1548,1784,10
42441035766,42441035765,-1,776,1620,10
42441158386,42441158385,-1,1087,2307,10
42441477574,42441477574,0,906,2297,10
42441528184,42441528203,19,961,868,10
42442283651,42442283649,-2,1028,2407,10
42448312341,42448312339,-2,1563,1139,10
42451955443,42451955453,10,9005,43958,10
42453937190,42453937192,2,914,1353,10
42458264787,42458264789,2,1952,1740,10
42459199394,42459199392,-2,945,2102,10
42462381477,42462381473,-4,1069,1981,10
42463192507,42463192505,-2,955,1243,10
42465144598,42465144597,-1,1444,2300,10
42470768706,42470768699,-7,1678,4247,10
42471246778,42471246777,-1,1025,2224,10
42477059047,42477059046,-1,1513,2010,10
42483483684,42483483688,4,23385,20541,10
42485186571,42485186568,-3,1059,2621,10
42485339966,42485339985,19,952,1532,10
42486079647,42486079646,-1,1339,1963,10
42486806043,42486806043,0,1554,1624,10
42490822962,42490822962,0,310,696,10
42491588389,42491588383,-6,1248,2101,10
42494771957,42494771955,-2,632,1429,10
42495192034,42495192039,5,2254,1287,10
42495945011,42495945010,-1,948,1927,10
42497505502,42497505500,-2,1015,2025,10
42498684427,42498684427,0,910,1930,10
42502362185,42502362182,-3,1239,2085,10
42506075913,42506075911,-2,1551,2074,10
42506450355,42506450353,-2,1075,1220,10
42507211341,42507211339,-2,1554,2044,10
42508562970,42508562975,5,1252,893,10
42508720409,42508720408,-1,1505,2903,10
42510029962,42510029962,0,1751,2003,10
42511078788,42511078787,-1,1410,1720,10
42518241445,42518241444,-1,1552,2425,10
42530754902,42530754901,-1,1148,2341,10
42531210011,42531210011,0,950,1561,10
42531400270,42531400270,0,718,1282,10
42532516269,42532516268,-1,1133,2014,10
42534540774,42534540773,-1,1427,2029,10
42534807155,42534807154,-1,993,1916,10
42534960211,42534960210,-1,1590,2612,10
42548174945,42548174944,-1,1217,2330,10
42549034076,42549034095,19,1159,2244,10
42552906882,42552906882,0,1117,1783,10
42558827010,42558827008,-2,1026,2090,10
42559204698,42559204690,-8,937,5348,10
42559343921,42559343942,21,788,1453,10
42562374330,42562374329,-1,1052,2917,10
42571022687,42571022687,0,1039,1720,10
42574662166,42574662165,-1,1193,1397,10
42575129686,42575129686,0,986,1716,10
42575258302,42575258299,-3,1245,2004,10
42578716686,42578716683,-3,1020,1868,10
42579925719,42579925717,-2,2459,4590,10
42584396030,42584396029,-1,721,1539,10
42592298694,42592298693,-1,933,1759,10
42593156490,42593156491,1,652,680,10
42600480634,42600480635,1,1192,2153,10
42601797120,42601797119,-1,1000,1301,10
42606903046,42606903042,-4,1160,3103,10
42608773666,42608773665,-1,1061,1866,10
42612020914,42612020913,-1,967,1873,10
42612327787,42612327787,0,697,1181,10
42612955791,42612955791,0,949,1438,10
42614555742,42614555744,2,1050,1669,10
42614979748,42614979747,-1,1256,1761,10
42615579787,42615579785,-2,1295,2299,10
42616416279,42616416276,-3,1419,2186,10
42618507278,42618507275,-3,1021,1760,10
42619943061,42619943061,0,690,1215,10
42621534486,42621534482,-4,961,2034,10
42621588318,42621588317,-1,1251,2789,10
42621992854,42621992854,0,1406,1992,10
42626588682,42626588677,-5,1015,2581,10
42627614478,42627614477,-1,1139,2665,10
42631854262,42631854263,1,920,1592,10
42633862750,42633862750,0,827,1562,10
42636940281,42636940282,1,1659,1986,10
42639698930,42639698928,-2,1504,1937,10
42642938634,42642938633,-1,949,1883,10
42644516376,42644516379,3,1744,1372,10
42647217632,42647217633,1,1720,1534,10
42648273947,42648273966,19,1019,2275,10
42654741075,42654741073,-2,1140,1756,10
42658510667,42658510667,0,1166,1682,10
42660212942,42660212941,-1,1570,2254,10
42661381986,42661381982,-4,1614,4778,10
42664651899,42664651898,-1,1280,1910,10
42667134213,42667134211,-2,1160,2255,10
42668433314,42668433317,3,1088,1399,10
42668487598,42668487594,-4,1125,1803,10
42669742601,42669742598,-3,1192,1945,10
42676893809,42676893809,0,1210,1853,10
42677479175,42677479175,0,877,1131,10
42678347929,42678347929,0,1078,1377,10
42681253143,42681253142,-1,1156,2271,10
42683598511,42683598509,-2,1374,1777,10
42697153842,42697153841,-1,1212,2191,10
42697363049,42697363049,0,1734,2003,10
42703223066,42703223065,-1,1454,1506,10
42703657198,42703657205,7,7363,2752,10
42707697247,42707697245,-2,945,1813,10
42707763027,42707763047,20,1088,1578,10
42708402925,42708402924,-1,1334,2077,10
42710981667,42710981666,-1,1462,1695,10
42721040215,42721040213,-2,1689,1392,10
42721113940,42721113938,-2,1379,1923,10
42723604679,42723604680,1,1021,2333,10
42724351134,42724351134,0,1146,1840,10
42726377221,42726377218,-3,802,1551,10
42728291646,42728291625,-21,847,2334,10
42729491767,42729491761,-6,721,3793,10
42733153686,42733153684,-2,1491,1597,10
42736814775,42736814774,-1,1038,1518,10
42737351622,42737351622,0,779,1686,10
42737764700,42737764699,-1,1162,2505,10
42740692243,42740692241,-2,1530,2741,10
42742365265,42742365262,-3,668,1095,10
42743341712,42743341710,-2,1285,2080,10
42748628985,42748628986,1,1938,2100,10
42751681746,42751681743,-3,989,2045,10
42754631266,42754631263,-3,1494,2285,10
42762162738,42762162740,2,4091,3904,10
42771244935,42771244934,-1,1407,1598,10
42771657110,42771657108,-2,1227,1734,10
42776097537,42776097536,-1,1653,1857,10
42777099857,42777099855,-2,1518,1817,10
42777903623,42777903621,-2,1332,2289,10
42782495790,42782495790,0,938,1600,10
42786477142,42786477141,-1,933,1646,10
42787203799,42787203798,-1,746,1648,10
42787623240,42787623262,22,1280,2510,10
42788653170,42788653170,0,225,3997,10
42789555116,42789555135,19,1239,1885,10
42792976023,42792976023,0,2025,1641,10
42793544070,42793544069,-1,1040,1987,10
42794316306,42794316306,0,1293,1286,10
42795123082,42795123082,0,1357,1766,10
42795761145,42795761142,-3,1677,2936,10
42796522637,42796522634,-3,1358,2348,10
42796837981,42796837979,-2,1427,2016,10
42806411053,42806411050,-3,793,819,10
42807214772,42807214770,-2,1526,2721,10
42809006866,42809006865,-1,921,1284,10
42812443321,42812443327,6,2069,1800,10
42814758934,42814758939,5,24770,32543,10
42823483012,42823483010,-2,1110,1750,10
42825422487,42825422485,-2,722,1734,10
42827012597,42827012594,-3,1009,2372,10
42828294686,42828294664,-22,1144,1918,10
42838639099,42838639098,-1,1338,1500,10
42840422049,42840422048,-1,1575,2424,10
42842265934,42842265933,-1,1617,2036,10
42842574243,42842574239,-4,1369,2232,10
42844329562,42844329557,-5,867,1802,10
42849170558,42849170557,-1,1016,1999,10
42858473421,42858473416,-5,2123,5286,10
42859403333,42859403335,2,12534,10277,10
42863783449,42863783446,-3,1490,2047,10
42867140370,42867140369,-1,1281,2972,10
42868719259,42868719258,-1,1294,2038,10
42869611105,42869611105,0,1098,1991,10
42872277750,42872277746,-4,697,1401,10
42875516606,42875516611,5,1845,1680,10
42876520144,42876520142,-2,1661,2474,10
42879619743,42879619741,-2,956,1786,10
42884269228,42884269225,-3,1238,1956,10
42887994752,42887994746,-6,1301,2568,10
42894724702,42894724701,-1,1225,1728,10
42895534475,42895534474,-1,940,1636,10
42896210286,42896210284,-2,1020,1568,10
42897164890,42897164886,-4,1052,2508,10
42899428010,42899428009,-1,1076,2061,10
42900485254,42900485251,-3,1314,3494,10
42900727337,42900727322,-15,1329,1931,10
42907213190,42907213189,-1,6287,10280,10
42907444020,42907444018,-2,1238,1330,10
42908369342,42908369341,-1,1085,1553,10
42912621042,42912621041,-1,1074,1725,10
42912980596,42912980599,3,1713,1095,10
42915754705,42915754711,6,2631,1449,10
42917170102,42917170101,-1,945,2240,10
42917863575,42917863573,-2,823,1278,10
42920754669,42920754667,-2,939,1798,10
42922555404,42922555404,0,1316,1824,10
42938244588,42938244586,-2,617,1215,10
42938489554,42938489537,-17,302,655,10
42940196057,42940196053,-4,1061,1831,10
42940418031,42940418029,-2,1279,1752,10
42946878806,42946878805,-1,1129,2050,10
42952112914,42952112912,-2,999,1892,10
42954927930,42954927929,-1,937,1842,10
42955805895,42955805894,-1,1800,2204,10
42958772147,42958772145,-2,789,1627,10
42959323174,42959323175,1,2091,2111,10
42961050734,42961050735,1,1269,2153,10
42962337670,42962337655,-15,1930,14464,10
42967509288,42967509290,2,2431,1914,10
42967797049,42967797047,-2,1100,1605,10
42975985275,42975985282,7,4765,1273,10
42980972039,42980972038,-1,1239,1823,10
42981695921,42981695919,-2,1626,1910,10
42981955975,42981955975,0,775,885,10
42983299359,42983299357,-2,1530,1818,10
42984684627,42984684627,0,1818,2352,10
42985366950,42985366951,1,1256,1371,10
42986472331,42986472326,-5,1207,2398,10
42990330661,42990330659,-2,1409,2192,10
42990632951,42990632953,2,1194,1262,10
42991369610,42991369607,-3,1872,2724,10
42996809794,42996809793,-1,1118,1863,10
42998330139,42998330137,-2,1351,2118,10
42998948706,42998948707,1,1653,1948,10
43003458429,43003458431,2,734,1150,10
43005433082,43005433078,-4,1516,1984,10
43008609074,43008609074,0,1157,2104,10
43013352189,43013352197,8,19824,51516,10
43014174013,43014174013,0,1800,2970,10
43014653537,43014653537,0,1092,1745,10
43015674870,43015674869,-1,1406,2017,10
43016067630,43016067630,0,1916,2762,10
43018188439,43018188438,-1,821,1273,10
43022049238,43022049255,17,693,1330,10
43024097325,43024097323,-2,1505,1576,10
43026081569,43026081568,-1,969,1606,10
43028728357,43028728359,2,4538,3471,10
43031646414,43031646410,-4,614,1355,10
43032246853,43032246851,-2,627,1295,10
43032292150,43032292150,0,1117,1763,10
43032485454,43032485457,3,819,1398,10
43042733342,43042733340,-2,1139,2413,10
43043465663,43043465660,-3,1286,2130,10
43044176910,43044176908,-2,1137,1745,10
43051762259,43051762258,-1,956,1875,10
43054642067,43054642066,-1,1161,1953,10
43058520157,43058520156,-1,1414,2230,10
43068245974,43068245976,2,1694,1974,10
43071447745,43071447750,5,2087,1189,10
43072838369,43072838369,0,1254,2489,10
43075307714,43075307714,0,1026,1088,10
43078912906,43078912912,6,7576,2642,10
43081825515,43081825511,-4,1278,1928,10
43082086272,43082086254,-18,273,585,10
43085767625,43085767622,-3,1133,1562,10
43090403787,43090403786,-1,1537,2237,10
43091053490,43091053488,-2,1623,2725,10
43093725691,43093725685,-6,1344,6493,10
43098094243,43098094243,0,946,1107,10
43098640766,43098640766,0,1587,2007,10
43099731461,43099731457,-4,1204,2020,10
43101286479,43101286481,2,1462,1341,10
43104796305,43104796303,-2,1511,3285,10
43106382514,43106382514,0,1852,3423,10
43107602499,43107602498,-1,1043,2379,10
43109024035,43109024033,-2,1443,2752,10
43109625251,43109625255,4,2006,1531,10
43116380381,43116380380,-1,1426,2005,10
43117777160,43117777159,-1,1300,1813,10
43118952584,43118952581,-3,773,1791,10
43123792172,43123792171,-1,1603,2052,10
43124745545,43124745542,-3,1194,2149,10
43132429173,43132429180,7,2414,1405,10
43133223007,43133223012,5,1901,1229,10
43133418234,43133418232,-2,854,1836,10
43133611121,43133611142,21,841,2604,10
43133833156,43133833153,-3,1154,1890,10
43136851593,43136851591,-2,873,1239,10
43140566845,43140566845,0,1756,1673,10
43141083395,43141083394,-1,1322,2122,10
43141432001,43141431999,-2,1265,1771,10
43142841916,43142841914,-2,716,2175,10
43147669838,43147669841,3,1250,2021,10
43152688223,43152688222,-1,1052,1654,10
43161211658,43161211656,-2,1412,2249,10
43161268658,43161268639,-19,55,603,10
43167137003,43167137002,-1,1835,3097,10
43168866925,43168866926,1,1154,1957,10
43170867671,43170867668,-3,1585,2527,10
43170990270,43170990269,-1,1345,1763,10
43172143875,43172143872,-3,1351,2682,10
43173291698,43173291697,-1,1610,2324,10
43178219071,43178219074,3,2860,1913,10
43178911136,43178911136,0,1036,1849,10
43179835877,43179835876,-1,1311,1903,10
43180189475,43180189473,-2,811,1338,10
43182495802,43182495800,-2,1354,1611,10
43187490994,43187490991,-3,798,1719,10
43188198776,43188198773,-3,1331,2825,10
43190583339,43190583338,-1,1347,1584,10
43192703314,43192703313,-1,1503,2424,10
43192953874,43192953876,2,1163,1081,10
43204582094,43204582094,0,2304,2802,10
43207982338,43207982335,-3,995,1074,10
43209120225,43209120241,16,609,1525,10
43209560682,43209560681,-1,1036,2071,10
43212714657,43212714657,0,1310,2310,10
43212979251,43212979249,-2,1230,2152,10
43214394553,43214394552,-1,1465,2567,10
43215457239,43215457237,-2,999,1358,10
43217979191,43217979189,-2,977,2475,10
43222017521,43222017519,-2,1518,1912,10
43222129162,43222129159,-3,1065,2049,10
43224948729,43224948731,2,1303,1259,10
43226475204,43226475207,3,4488,15204,10
43227744950,43227744949,-1,1372,1911,10
43234621042,43234621039,-3,847,1181,10
43238904741,43238904741,0,786,2144,10
43239592892,43239592911,19,1067,3116,10
43242483635,43242483634,-1,597,859,10
43242921975,43242921991,16,682,895,10
43246348813,43246348813,0,1062,1248,10
43251026279,43251026278,-1,1045,1572,10
43255346718,43255346710,-8,1399,4467,10
43255982950,43255982949,-1,1188,1974,10
43258096766,43258096764,-2,1287,2045,10
43258900251,43258900249,-2,1174,1783,10
43259128283,43259128282,-1,1104,1222,10
43259706793,43259706791,-2,1111,1102,10
43262221802,43262221801,-1,1398,1712,10
43262402880,43262402877,-3,9,742,10
43262795859,43262795858,-1,1076,2217,10
43264745555,43264745554,-1,1170,2041,10
43267712645,43267712643,-2,1391,1685,10
43269866598,43269866597,-1,1720,2616,10
43275180771,43275180770,-1,1303,1929,10
43275891240,43275891239,-1,1481,1814,10
43276575193,43276575192,-1,2249,2895,10
43276718686,43276718687,1,928,1796,10
43279174199,43279174199,0,1143,2289,10
43282223983,43282223982,-1,1528,2526,10
43283578969,43283578968,-1,697,1104,10
43287841915,43287841913,-2,1017,1738,10
43288119003,43288119001,-2,1119,1615,10
43288792789,43288792787,-2,1411,3117,10
43290740662,43290740663,1,1592,1809,10
43293184489,43293184488,-1,1156,2272,10
43299906927,43299906929,2,1218,1560,10
43299974535,43299974535,0,1457,2049,10
43304506462,43304506459,-3,1484,2647,10
43307796030,43307796031,1,1186,1622,10
43307942594,43307942594,0,1554,2511,10
43308596386,43308596369,-17,1272,1825,10
43314887969,43314887972,3,2428,1829,10
43318336539,43318336537,-2,1229,1835,10
43319738743,43319738742,-1,1391,1918,10
43322477574,43322477572,-2,982,2138,10
43326010663,43326010664,1,1200,2429,10
43327276048,43327276047,-1,1210,1587,10
43327586190,43327586187,-3,1277,1717,10
43331143241,43331143240,-1,1402,1434,10
43332392510,43332392508,-2,1057,1838,10
43334372210,43334372210,0,794,781,10
43335743938,43335743937,-1,1277,1977,10
43338451063,43338451061,-2,1509,1780,10
43342043237,43342043238,1,1476,1047,10
43349320167,43349320166,-1,1541,1965,10
43356460466,43356460466,0,1863,1799,10
43358427278,43358427277,-1,1530,2135,10
43362293295,43362293294,-1,1183,1863,10
43365006916,43365006915,-1,1525,2496,10
43366763051,43366763050,-1,1026,2700,10
43367930146,43367930145,-1,1716,1964,10
43368815634,43368815640,6,1709,1026,10
43369563351,43369563350,-1,1486,2818,10
43374695953,43374695950,-3,1117,1643,10
43379882883,43379882881,-2,1601,2460,10
43380678422,43380678422,0,1615,2220,10
43386376451,43386376449,-2,1138,2245,10
43388658414,43388658413,-1,858,1531,10
43400347946,43400347945,-1,1063,1715,10
43400674392,43400674390,-2,1796,1882,10
43404161364,43404161358,-6,476,1857,10
43406226394,43406226390,-4,742,1299,10
43407380630,43407380629,-1,1296,1520,10
43409613818,43409613817,-1,1077,1487,10
43417053522,43417053520,-2,1010,1941,10
43418191188,43418191190,2,1057,1628,10
43422340634,43422340633,-1,1052,2135,10
43428385505,43428385504,-1,1266,1292,10
43430548794,43430548791,-3,1146,3482,10
43432389638,43432389637,-1,1460,1886,10
43433034303,43433034302,-1,1800,2980,10
43437803183,43437803186,3,2724,2597,10
43438256765,43438256763,-2,1181,1675,10
43439996538,43439996537,-1,1609,2148,10
43440656618,43440656616,-2,862,2120,10
43444488212,43444488211,-1,1340,2045,10
43444688523,43444688519,-4,1445,2278,10
43445259239,43445259239,0,1010,1848,10
43446223393,43446223402,9,13151,25036,10
43448667277,43448667278,1,906,1201,10
43449978247,43449978247,0,1264,1482,10
43455877008,43455877006,-2,1569,2494,10
43456852683,43456852679,-4,980,2163,10
43460272366,43460272367,1,2037,2690,10
43462478470,43462478471,1,1122,1994,10
43471626881,43471626878,-3,938,2497,10
43477846687,43477846686,-1,2279,3436,10
43488902508,43488902508,0,1375,2323,10
43491650619,43491650618,-1,753,1169,10
43493216194,43493216192,-2,957,1240,10
43497939750,43497939751,1,1268,1900,10
43499377650,43499377645,-5,1172,2076,10
43504295825,43504295825,0,1248,2298,10
43505994563,43505994563,0,1518,2316,10
43510807906,43510807905,-1,1676,2592,10
43511252225,43511252225,0,1247,1502,10
43511528539,43511528537,-2,1326,1485,10
43513534432,43513534421,-11,1519,1431,10
43514375883,43514375881,-2,963,2006,10
43521315699,43521315698,-1,1476,3065,10
43527502394,43527502391,-3,1222,1823,10
43534351525,43534351525,0,1285,2232,10
43534548778,43534548796,18,502,880,10
43536816483,43536816482,-1,1131,2314,10
43545380102,43545380101,-1,2162,3845,10
43549032898,43549032894,-4,1491,1810,10
43549495494,43549495491,-3,860,1567,10
43554019746,43554019744,-2,1482,2534,10
43556836559,43556836555,-4,1321,2571,10
43558376243,43558376242,-1,1254,1902,10
43567538930,43567538933,3,1398,1319,10
43573018211,43573018210,-1,795,1726,10
43573938680,43573938703,23,677,1972,10
43577241769,43577241763,-6,1084,4222,10
43577721449,43577721449,0,1665,2448,10
43579140815,43579140814,-1,1070,1885,10
43583750148,43583750147,-1,1428,1470,10
43588768341,43588768338,-3,1562,2255,10
43593396746,43593396745,-1,1421,2225,10
43593460426,43593460423,-3,1523,3154,10
43599555481,43599555477,-4,815,3227,10
43602783860,43602783859,-1,1558,2322,10
43605927903,43605927901,-2,617,1661,10
43614006928,43614006910,-18,1927,885,10
43616763889,43616763891,2,1827,1005,10
43616953626,43616953622,-4,1052,1515,10
43620120723,43620120722,-1,1084,1522,10
43620745065,43620745062,-3,1628,2434,10
43623059245,43623059241,-4,1279,2372,10
43624921870,43624921870,0,1267,1651,10
43627858733,43627858731,-2,1318,2261,10
43629386474,43629386473,-1,1210,1450,10
43630377555,43630377574,19,1192,1793,10
43630738595,43630738592,-3,1578,1951,10
43634913030,43634913030,0,816,1251,10
43642499528,43642499526,-2,1521,1630,10
43644850123,43644850105,-18,1423,1782,10
43646203693,43646203693,0,1084,1806,10
43646829725,43646829733,8,4640,1783,10
43646868974,43646868974,0,1561,1670,10
43647116147,43647116147,0,1953,1716,10
43649210869,43649210867,-2,992,2166,10
43651939670,43651939670,0,1247,2124,10
43653974150,43653974149,-1,798,1357,10
43658353338,43658353344,6,3608,1461,10
43659782586,43659782583,-3,1055,1943,10
43664150453,43664150457,4,1068,1182,10
43664394587,43664394587,0,892,1782,10
43669024114,43669024114,0,1404,2467,10
43670743108,43670743108,0,1282,1687,10
43673656899,43673656897,-2,1352,1923,10
43675024314,43675024312,-2,1887,1983,10
43675608679,43675608676,-3,1414,2253,10
43676903518,43676903517,-1,1721,2623,10
43678641190,43678641190,0,1040,1578,10
43680482979,43680482977,-2,1220,1491,10
43680755869,43680755866,-3,1263,1821,10
43681626129,43681626150,21,691,2520,10
43681660286,43681660278,-8,1948,9841,10
43683444927,43683444925,-2,898,1624,10
43683541970,43683541970,0,855,2303,10
43689011984,43689011982,-2,1302,1218,10
43691806825,43691806823,-2,1867,2894,10
43693147582,43693147581,-1,1400,2443,10
43697909168,43697909171,3,4109,2949,10
43699686845,43699686843,-2,1399,1983,10
43700438736,43700438756,20,1489,2244,10
43700618746,43700618744,-2,1438,1974,10
43701429676,43701429673,-3,1023,1791,10
43702798182,43702798182,0,947,1214,10
43706244275,43706244271,-4,1094,1603,10
43712135299,43712135297,-2,1065,1815,10
43726175066,43726175065,-1,1542,1543,10
43728224690,43728224688,-2,804,1456,10
43733135881,43733135878,-3,1050,1369,10
43741743698,43741743698,0,906,1800,10
43745370153,43745370153,0,1625,2593,10
43751663019,43751663018,-1,1041,1611,10
43754212206,43754212203,-3,1681,2842,10
43757188993,43757188993,0,1128,1407,10
43760437258,43760437257,-1,581,854,10
43761750604,43761750607,3,872,1006,10
43764617961,43764617959,-2,1169,1689,10
43764994859,43764994859,0,989,1962,10
43765075095,43765075094,-1,1291,1611,10
43766739806,43766739805,-1,1098,2009,10
43767365961,43767365959,-2,841,2231,10
43767769139,43767769157,18,690,1548,10
43768033302,43768033302,0,852,1000,10
43771325952,43771325952,0,1459,2150,10
43774229469,43774229465,-4,1246,2062,10
43776322346,43776322344,-2,686,1616,10
43777363971,43777363969,-2,2090,1965,10
43779832687,43779832686,-1,1322,1366,10
43783189337,43783189335,-2,1591,2023,10
43783297042,43783297043,1,1324,1143,10
43784411171,43784411170,-1,1012,1824,10
43787210457,43787210447,-10,8,1746,10
43787899159,43787899158,-1,1573,2299,10
43788367921,43788367918,-3,1097,2435,10
43793379163,43793379163,0,1239,2074,10
43794601739,43794601739,0,1393,1647,10
43794932543,43794932542,-1,741,1538,10
43800130266,43800130265,-1,1224,1450,10
43800412459,43800412458,-1,1193,1882,10
43801016582,43801016592,10,11782,43861,10
43801901282,43801901281,-1,1017,1884,10
43802835326,43802835329,3,2037,1667,10
43804025457,43804025457,0,1163,2388,10
43813845409,43813845410,1,2255,2399,10
43815240961,43815240960,-1,1570,2017,10
43816142753,43816142749,-4,1297,2305,10
43817329555,43817329554,-1,764,1393,10
43819530810,43819530807,-3,1169,1923,10
43821923767,43821923766,-1,1248,1678,10
43823012754,43823012755,1,1454,1709,10
43825450022,43825450020,-2,767,1724,10
43829106706,43829106705,-1,1546,1789,10
43833709235,43833709238,3,1526,1089,10
43835020031,43835020027,-4,800,1641,10
43835843759,43835843756,-3,1098,1710,10
43836589698,43836589682,-16,1233,2446,10
43836671769,43836671766,-3,1376,1870,10
43841126495,43841126496,1,826,1436,10
43842810315,43842810333,18,479,1741,10
43846508142,43846508142,0,1664,1392,10
43847626227,43847626227,0,956,1018,10
43850354174,43850354171,-3,1284,1980,10
43850466893,43850466890,-3,1344,1700,10
43853560353,43853560354,1,1760,2086,10
43854649910,43854649909,-1,1131,1747,10
43860302102,43860302106,4,39719,2349,10
43866426897,43866426895,-2,1345,2590,10
43869294348,43869294347,-1,1920,2502,10
43869763250,43869763247,-3,34935,19339,10
43870999190,43870999185,-5,1258,2354,10
43871427531,43871427532,1,1321,1598,10
43874188502,43874188500,-2,1384,2105,10
43875330126,43875330125,-1,1591,1779,10
43880008126,43880008124,-2,1564,1666,10
43880754354,43880754355,1,2938,1981,10
43881503862,43881503860,-2,1227,2245,10
43883323106,43883323103,-3,1283,2249,10
43883929573,43883929573,0,2095,2602,10
43889465209,43889465209,0,706,1262,10
43896067841,43896067839,-2,1027,1855,10
43897414735,43897414733,-2,940,1527,10
43898128210,43898128212,2,1650,1887,10
43899111178,43899111178,0,1146,1785,10
43899577091,43899577091,0,1774,2742,10
43899767047,43899767045,-2,1467,3111,10
43900086285,43900086282,-3,1138,1954,10
43900142270,43900142269,-1,825,1479,10
43901790866,43901790867,1,1199,1726,10
43903643858,43903643857,-1,1189,2005,10
43907783064,43907783064,0,1731,1560,10
43910798330,43910798330,0,811,1501,10
43916549966,43916549966,0,836,1366,10
43918636210,43918636211,1,1649,2754,10
43919452131,43919452129,-2,925,1332,10
43920816846,43920816842,-4,1620,2070,10
43921864671,43921864670,-1,2030,2092,10
43922639670,43922639669,-1,1260,2108,10
43923496151,43923496159,8,4757,1291,10
43924272999,43924272998,-1,907,1492,10
43926305185,43926305184,-1,816,1973,10
43927853247,43927853246,-1,911,2182,10
43928849622,43928849622,0,1305,2146,10
43932229654,43932229653,-1,2136,2716,10
43937266813,43937266809,-4,1068,2115,10
43938532047,43938532047,0,1444,1969,10
43941747670,43941747669,-1,1162,3032,10
43941938407,43941938402,-5,710,2383,10
43942488121,43942488119,-2,127,511,10
43943626955,43943626955,0,1432,1477,10
43944899881,43944899882,1,1431,2068,10
43944997922,43944997922,0,719,1554,10
43946562170,43946562172,2,878,1490,10
43948322085,43948322086,1,1436,1418,10
43950128303,43950128300,-3,1203,2102,10
43951917054,43951917049,-5,954,1859,10
43955123822,43955123818,-4,928,1912,10
43956091679,43956091676,-3,1436,1812,10
43957699279,43957699281,2,795,1590,10
43958219282,43958219282,0,823,1872,10
43963063186,43963063183,-3,745,1340,10
43963187048,43963187040,-8,1543,1898,10
43966059877,43966059876,-1,819,2230,10
43970538885,43970538890,5,2436,1165,10
43972528163,43972528162,-1,1167,2428,10
43973959226,43973959224,-2,1234,2081,10
43975662012,43975662006,-6,1214,3979,10
43978125415,43978125421,6,3041,1461,10
43978859515,43978859513,-2,1168,1578,10
43981461993,43981462002,9,3820,1435,10
43982131919,43982131919,0,972,1647,10
43984805284,43984805282,-2,1499,1854,10
43986285301,43986285302,1,2504,2200,10
43987530199,43987530197,-2,1239,1463,10
43987609099,43987609098,-1,774,1676,10
43993513597,43993513597,0,1223,1683,10
43994640930,43994640929,-1,2114,2508,10
43998449203,43998449202,-1,1580,2719,10
43999803788,43999803789,1,1112,2098,10
44000719499,44000719498,-1,568,1522,10
44002947167,44002947168,1,1647,2268,10
44007052708,44007052711,3,1423,1670,10
44014686324,44014686323,-1,1062,1537,10
44016518365,44016518361,-4,831,1316,10
44017482747,44017482748,1,1604,1675,10
44018008282,44018008278,-4,1031,2662,10
44021972343,44021972341,-2,1018,2254,10
44023230878,44023230878,0,1381,1708,10
44023390206,44023390207,1,1073,2046,10
44023417652,44023417654,2,1698,1340,10
44024578885,44024578884,-1,994,2490,10
44028600054,44028600058,4,1053,1405,10
44031931512,44031931511,-1,1476,2617,10
44032677026,44032677029,3,1287,1570,10
44039704323,44039704321,-2,1561,2753,10
44041104835,44041104834,-1,874,1955,10
44043349664,44043349661,-3,1213,2936,10
44043890672,44043890673,1,1368,1471,10
44045012390,44045012390,0,1421,1870,10
44047725611,44047725609,-2,1180,1680,10
44048354627,44048354627,0,1124,2088,10
44056062514,44056062512,-2,1385,2923,10
44056399577,44056399573,-4,920,1330,10
44058908330,44058908337,7,6633,1516,10
44060251076,44060251075,-1,1307,2910,10
44060442265,44060442261,-4,1308,2202,10
44060706721,44060706713,-8,886,1796,10
44064084303,44064084302,-1,1244,2186,10
44068303119,44068303118,-1,1245,1939,10
44070940652,44070940650,-2,1063,1357,10
44071248199,44071248195,-4,1035,2677,10
44072386594,44072386591,-3,998,1391,10
44077782979,44077782973,-6,1169,4140,10
44078910045,44078910042,-3,1113,2002,10
44081358406,44081358406,0,1038,1455,10
44082682250,44082682248,-2,1344,1562,10
44082816406,44082816406,0,1618,2484,10
44083632862,44083632861,-1,1229,1604,10
44094285926,44094285923,-3,2148,4842,10
44094342963,44094342962,-1,620,1674,10
44095182426,44095182425,-1,1933,2413,10
44096963306,44096963305,-1,1148,1434,10
44104144051,44104144048,-3,1238,2139,10
44108885450,44108885451,1,1531,1541,10
44109897630,44109897630,0,1080,1368,10
44110567022,44110567021,-1,929,1385,10
44114018836,44114018834,-2,1360,1517,10
44117375549,44117375548,-1,1311,2102,10
44117664187,44117664186,-1,1048,1785,10
44122914930,44122914925,-5,1591,3216,10
44125886374,44125886374,0,1641,2636,10
44126455627,44126455645,18,938,1884,10
44127148882,44127148882,0,2519,3781,10
44127323924,44127323923,-1,1251,2408,10
44127454673,44127454673,0,2053,2669,10
44129144442,44129144438,-4,1264,2249,10
44134717550,44134717546,-4,1349,2635,10
44135091495,44135091495,0,1654,2464,10
44135265542,44135265535,-7,1691,5432,10
44137163958,44137163958,0,935,1776,10
44138209799,44138209799,0,1521,1278,10
44140513009,44140513010,1,2109,1889,10
44140879314,44140879313,-1,1087,1518,10
44144335790,44144335790,0,1275,1397,10
44144542367,44144542366,-1,1083,1340,10
44145858822,44145858823,1,1038,1719,10
44145886783,44145886779,-4,1115,1941,10
44146041364,44146041363,-1,1131,1919,10
44150604626,44150604636,10,868,1316,10
44151791519,44151791517,-2,1178,2366,10
44154554025,44154554022,-3,1552,2080,10
44155608748,44155608742,-6,1232,3335,10
44163507158,44163507155,-3,1107,2473,10
44170433405,44170433404,-1,1646,2406,10
44171465185,44171465184,-1,1013,1771,10
44174022516,44174022516,0,1484,2434,10
44174769846,44174769851,5,2418,973,10
44174987660,44174987658,-2,1919,2283,10
44175256374,44175256373,-1,770,1920,10
44176470861,44176470861,0,1036,1824,10
44179451603,44179451599,-4,1659,3195,10
44180271075,44180271074,-1,1306,2554,10
44182900495,44182900492,-3,1528,1982,10
44183734444,44183734442,-2,2007,2669,10
44185036329,44185036329,0,1286,1378,10
44185078319,44185078317,-2,1404,2122,10
44186174649,44186174648,-1,1370,2465,10
44193647152,44193647151,-1,1544,2569,10
44198030295,44198030293,-2,1352,1637,10
44199037239,44199037238,-1,1062,1975,10
44199768214,44199768214,0,1809,2225,10
44201682191,44201682191,0,1065,1190,10
44203205059,44203205057,-2,1024,1945,10
44203242281,44203242278,-3,1359,1948,10
44207303015,44207303013,-2,877,2131,10
44207439158,44207439157,-1,1571,1544,10
44208702888,44208702887,-1,1746,2374,10
44210310958,44210310958,0,1150,1841,10
44214037120,44214037119,-1,1210,2104,10
44216590778,44216590776,-2,1110,2244,10
44221925491,44221925489,-2,1132,1918,10
44229807858,44229807856,-2,1029,2051,10
44235157408,44235157420,12,22,373,10
44237278524,44237278520,-4,795,2555,10
44239001141,44239001139,-2,1236,1728,10
44240454938,44240454943,5,2990,1719,10
44245377017,44245377015,-2,1317,1152,10
44249119834,44249119833,-1,1428,1659,10
44255051526,44255051524,-2,2021,2704,10
44258665918,44258665918,0,1540,2157,10
44260046518,44260046515,-3,957,2783,10
44260348652,44260348651,-1,1303,2129,10
44261856477,44261856478,1,1298,2240,10
44262507950,44262507949,-1,1259,1435,10
44265115308,44265115306,-2,1180,1602,10
44270514871,44270514871,0,904,1359,10
44274655371,44274655368,-3,1337,2183,10
44274739299,44274739303,4,1682,1329,10
44275980961,44275980958,-3,1419,2447,10
44278422236,44278422241,5,2242,2033,10
44283855874,44283855871,-3,820,2120,10
44284528179,44284528178,-1,1239,2071,10
44284971185,44284971187,2,1337,1504,10
44285408247,44285408246,-1,1460,2233,10
44285655996,44285656015,19,1380,2315,10
44285728678,44285728678,0,1352,1688,10
44285838165,44285838162,-3,1248,1772,10
44289645706,44289645712,6,1230,945,10
44294680654,44294680655,1,1708,1371,10
44295857202,44295857197,-5,951,3068,10
44297739569,44297739567,-2,1193,2327,10
44299765633,44299765632,-1,1706,2331,10
44301129146,44301129143,-3,1676,2730,10
44304196613,44304196613,0,1569,2196,10
44305858187,44305858184,-3,1161,1840,10
44306205009,44306205019,10,234,864,10
44309167935,44309167934,-1,850,1237,10
44314610786,44314610786,0,1655,2158,10
44322920270,44322920269,-1,1474,1714,10
44326357110,44326357106,-4,1258,1588,10
44330245874,44330245871,-3,727,1778,10
44331658506,44331658505,-1,1226,2312,10
44333789014,44333789014,0,888,1240,10
44335971744,44335971743,-1,1578,2923,10
44336510199,44336510205,6,2156,1430,10
44336747186,44336747186,0,1017,2007,10
44337714695,44337714707,12,807,1262,10
44338472054,44338472051,-3,1244,2608,10
44341546512,44341546512,0,1741,1880,10
44343394115,44343394113,-2,1602,2163,10
44350004024,44350004023,-1,1049,2075,10
44351522014,44351522013,-1,1344,2218,10
44358917487,44358917483,-4,1151,2722,10
44359653445,44359653444,-1,1106,1658,10
44365486165,44365486165,0,1602,2032,10
44366658091,44366658091,0,1175,1744,10
44367660173,44367660170,-3,1026,1667,10
44368654718,44368654717,-1,936,1673,10
44368680417,44368680414,-3,94,841,10
44369517714,44369517713,-1,1630,2175,10
44372678915,44372678913,-2,1050,1930,10
44374371900,44374371902,2,1277,1774,10
44377966630,44377966631,1,1624,1542,10
44383237002,44383237002,0,1330,1809,10
44389417260,44389417257,-3,1008,1408,10
44390452158,44390452154,-4,1498,3012,10
44397514044,44397514041,-3,2594,5734,10
44397615855,44397615854,-1,1057,1994,10
44398475198,44398475198,0,1625,2058,10
44398922354,44398922353,-1,1175,2570,10
44399138511,44399138510,-1,1163,1437,10
44400709811,44400709810,-1,977,978,10
44403850012,44403850012,0,2029,2662,10
44407628462,44407628462,0,1098,2013,10
44408366914,44408366894,-20,780,1632,10
44409606649,44409606647,-2,978,1556,10
44411585586,44411585585,-1,1107,2149,10
44412261535,44412261542,7,10712,35463,10
44416355911,44416355912,1,1233,1660,10
44418522343,44418522346,3,2082,2374,10
44421497252,44421497251,-1,1040,1435,10
44422640339,44422640336,-3,1127,2039,10
44431342511,44431342506,-5,506,3536,10
44432060678,44432060674,-4,1468,2923,10
44433244261,44433244258,-3,1703,2370,10
44435001845,44435001843,-2,1325,2481,10
44444423304,44444423303,-1,1323,1869,10
44444524660,44444524679,19,416,820,10
44450018543,44450018541,-2,922,1680,10
44458188933,44458188933,0,1281,2465,10
44459101043,44459101042,-1,1636,1896,10
44464861505,44464861501,-4,23440,70783,10
44465805192,44465805190,-2,1870,2220,10
44466121807,44466121804,-3,1249,1355,10
44468691591,44468691589,-2,1191,1841,10
44470302297,44470302297,0,1139,2258,10
44475685587,44475685589,2,1163,958,10
44483551330,44483551327,-3,978,2721,10
44486069428,44486069424,-4,1419,2666,10
44486572822,44486572821,-1,952,1362,10
44487324907,44487324907,0,1188,2309,10
44495959932,44495959930,-2,1202,1497,10
44499753998,44499753994,-4,1194,2273,10
44500866591,44500866591,0,854,1097,10
44502675270,44502675273,3,1817,1235,10
44503109937,44503109937,0,1107,1685,10
44503573165,44503573167,2,2766,2871,10
44503611362,44503611362,0,1193,1369,10
44503653728,44503653725,-3,1852,3340,10
44508239503,44508239500,-3,1067,2360,10
44518413849,44518413843,-6,1242,3020,10
44518485036,44518485035,-1,1334,2184,10
44519630327,44519630327,0,986,1894,10
44519710909,44519710908,-1,998,1409,10
44528422296,44528422295,-1,1309,1484,10
44534247282,44534247277,-5,2190,5740,10
44534445422,44534445421,-1,938,2064,10
44534848730,44534848734,4,32408,29275,10
44538801823,44538801820,-3,1230,2078,10
44541671591,44541671590,-1,978,2339,10
44541708019,44541708018,-1,957,2275,10
44551077106,44551077105,-1,1249,1719,10
44554732104,44554732102,-2,1494,2724,10
44564003369,44564003371,2,1575,1118,10
44567837375,44567837374,-1,1266,1803,10
44567984867,44567984865,-2,1235,2312,10
44571184583,44571184582,-1,1025,2602,10
44571510426,44571510423,-3,1463,2871,10
44571827492,44571827510,18,1265,2037,10
44572022986,44572022983,-3,1792,2961,10
44576539793,44576539792,-1,1275,1673,10
44583013863,44583013862,-1,837,1799,10
44585203189,44585203189,0,1295,1850,10
44585853597,44585853597,0,1452,1875,10
44586020473,44586020474,1,622,1127,10
44589621964,44589621961,-3,1540,2019,10
44593098774,44593098774,0,1259,2391,10
44594368931,44594368931,0,972,1974,10
44594994124,44594994122,-2,940,1537,10
44597885131,44597885131,0,1514,1877,10
44603114058,44603114059,1,10928,8965,10
44605597462,44605597462,0,1099,1752,10
44613081338,44613081334,-4,1195,2136,10
44614266944,44614266944,0,1050,2371,10
44614897246,44614897250,4,4711,3336,10
44615524396,44615524395,-1,1073,2198,10
44616310944,44616310933,-11,804,2229,10
44623330765,44623330762,-3,1033,1796,10
44624962258,44624962258,0,1297,1918,10
44631067605,44631067601,-4,1228,2443,10
44639639870,44639639872,2,1536,1361,10
44644015677,44644015676,-1,1112,1814,10
44644392829,44644392827,-2,1283,2231,10
44644898671,44644898669,-2,1144,1932,10
44645233873,44645233874,1,249,559,10
44646077085,44646077091,6,1727,733,10
44655622343,44655622337,-6,1753,8515,10
44656480711,44656480712,1,1496,1786,10
44661316709,44661316708,-1,1346,2137,10
44663689222,44663689223,1,1257,1771,10
44664013091,44664013094,3,3175,2352,10
44664964215,44664964209,-6,1411,5206,10
44673587881,44673587878,-3,1115,1546,10
44676389798,44676389805,7,1150,701,10
44677031930,44677031929,-1,1081,1446,10
44677910946,44677910946,0,1098,2462,10
44679203608,44679203608,0,1692,1958,10
44683663231,44683663229,-2,823,1372,10
44686864133,44686864132,-1,831,1776,10
44697261749,44697261749,0,997,1966,10
44697928368,44697928354,-14,1053,1574,10
44699672083,44699672081,-2,788,1345,10
44705011509,44705011510,1,1000,1613,10
44706734331,44706734329,-2,1023,2428,10
44708000217,44708000214,-3,1069,1476,10
44708153937,44708153917,-20,122,933,10
44710879730,44710879737,7,2453,1365,10
44712261766,44712261763,-3,1717,2225,10
44712508537,44712508519,-18,1327,1973,10
44714107413,44714107411,-2,1109,1803,10
44715824906,44715824905,-1,978,1983,10
44717166719,44717166701,-18,197,481,10
44719345304,44719345307,3,1627,1118,10
44720941070,44720941069,-1,1850,1857,10
44722516791,44722516798,7,31340,42145,10
44723709200,44723709198,-2,1306,1930,10
44724389066,44724389066,0,1242,1754,10
44724612817,44724612821,4,157,682,10
44726929935,44726929933,-2,1795,2626,10
44728166926,44728166925,-1,1566,2143,10
44728640164,44728640163,-1,1172,1986,10
44730796289,44730796291,2,1134,1359,10
44731891462,44731891460,-2,944,2336,10
44735824690,44735824690,0,1221,1317,10
44739489918,44739489916,-2,1388,1464,10
44740761763,44740761762,-1,944,1702,10
44743467382,44743467383,1,1382,1011,10
44747406759,44747406759,0,1649,2522,10
44755220425,44755220425,0,1913,2477,10
44755371811,44755371810,-1,862,1652,10
44761915991,44761915989,-2,874,1977,10
44766036946,44766036946,0,989,1737,10
44772169129,44772169126,-3,977,2245,10
44772557786,44772557786,0,986,1887,10
44775368209,44775368207,-2,1314,2728,10
44777651048,44777651045,-3,1286,1760,10
44780891094,44780891107,13,1130,2068,10
44781319338,44781319359,21,431,707,10
44782435946,44782435949,3,1947,2542,10
44784019786,44784019784,-2,962,1711,10
44784385150,44784385168,18,1234,1825,10
44785949329,44785949328,-1,1204,1892,10
44788601051,44788601050,-1,1227,1791,10
44794676054,44794676051,-3,1052,2397,10
44795116572,44795116591,19,1174,2471,10
44795216355,44795216353,-2,1208,2401,10
44798753325,44798753346,21,1129,1638,10
44799730022,44799730022,0,1097,2006,10
44800456854,44800456852,-2,1444,1865,10
44805397376,44805397374,-2,1636,2441,10
44806292872,44806292873,1,1093,2107,10
44809471035,44809471033,-2,1734,2698,10
44810860827,44810860825,-2,1278,2322,10
44812114850,44812114842,-8,69,3063,10
44813124571,44813124571,0,1069,1819,10
44813716734,44813716734,0,1264,1831,10
44819457849,44819457847,-2,1274,2475,10
44822355378,44822355375,-3,1685,1747,10
44824490887,44824490886,-1,754,1910,10
44824966344,44824966325,-19,1254,1308,10
44828429307,44828429305,-2,1496,1930,10
44835085479,44835085479,0,1096,2555,10
44835596461,44835596459,-2,1678,2992,10
44837076087,44837076085,-2,1513,2541,10
44839630217,44839630214,-3,855,1449,10
44840460523,44840460521,-2,1033,2430,10
44842349763,44842349764,1,1355,2449,10
44844873450,44844873449,-1,1258,2148,10
44847687991,44847687991,0,621,1130,10
44849659114,44849659114,0,1003,1898,10
44851701507,44851701513,6,2377,1189,10
44859385943,44859385943,0,917,1304,10
44863578397,44863578396,-1,609,1325,10
44871038625,44871038627,2,3132,2013,10
44871907810,44871907810,0,1550,1523,10
44875738971,44875738969,-2,1311,1354,10
44876194807,44876194806,-1,1083,2215,10
44876451083,44876451081,-2,1063,1953,10
44879927859,44879927857,-2,996,2154,10
44882892371,44882892368,-3,1170,1932,10
44884016335,44884016340,5,3347,1578,10
44889828045,44889828046,1,900,1380,10
44890101110,44890101108,-2,1450,2118,10
44892703108,44892703129,21,1274,1834,10
44893621922,44893621922,0,1856,2672,10
44896176122,44896176119,-3,1516,2791,10
44896283676,44896283675,-1,2139,2049,10
44896498092,44896498092,0,1396,1342,10
44896663833,44896663833,0,1398,1861,10
44896824680,44896824680,0,903,1592,10
44901412667,44901412671,4,984,1197,10
44904438950,44904438948,-2,1113,1601,10
44904968601,44904968600,-1,1254,1603,10
44911309638,44911309637,-1,1463,1593,10
44916058309,44916058306,-3,1584,2537,10
44918099775,44918099774,-1,1452,2692,10
44918613259,44918613258,-1,1373,2852,10
44922949630,44922949627,-3,1399,2035,10
44923525170,44923525190,20,1199,1705,10
44928470118,44928470120,2,1175,1345,10
44932886623,44932886622,-1,1544,1867,10
44935172246,44935172246,0,1957,1870,10
44938380366,44938380366,0,1166,1967,10
44941186220,44941186221,1,919,1475,10
44941921790,44941921789,-1,1195,1971,10
44942613283,44942613282,-1,1249,2398,10
44945086290,44945086288,-2,974,1411,10
44945879330,44945879330,0,1221,1601,10
44947402917,44947402906,-11,1291,1721,10
44951425645,44951425642,-3,1358,2361,10
44956090764,44956090762,-2,1376,2133,10
44959310521,44959310526,5,3659,1764,10
44961027843,44961027842,-1,1476,1482,10
44961637264,44961637263,-1,1098,978,10
44965523800,44965523821,21,1462,2819,10
44966735065,44966735065,0,1036,1562,10
44967629602,44967629602,0,1725,2564,10
44968357688,44968357686,-2,1245,2219,10
44968484282,44968484280,-2,1460,2269,10
44968976544,44968976565,21,840,1698,10
44970130533,44970130534,1,1201,1717,10
44971032490,44971032489,-1,1158,2208,10
44976281757,44976281754,-3,1382,2678,10
44976567249,44976567246,-3,1267,2178,10
44978463193,44978463191,-2,1211,1862,10
44979596493,44979596494,1,1499,2706,10
44987861710,44987861711,1,1089,1386,10
44988445867,44988445866,-1,1224,1665,10
44990575774,44990575772,-2,1067,1897,10
44997150990,44997150989,-1,863,1819,10
44998898306,44998898301,-5,1378,2528,10
45000805293,45000805290,-3,1151,2377,10
45003180130,45003180130,0,1248,1348,10
45007567383,45007567387,4,2568,1625,10
45012116595,45012116603,8,5417,1683,10
45012891851,45012891851,0,1226,1962,10
45021000013,45021000012,-1,1248,1829,10
45021629602,45021629622,20,718,1888,10
45023014771,45023014771,0,906,2063,10
45024718038,45024718038,0,1468,2259,10
45026411490,45026411489,-1,1091,2080,10
45028906595,45028906595,0,1408,1411,10
45032041530,45032041528,-2,1005,1617,10
45034191503,45034191501,-2,1376,1790,10
45035423619,45035423620,1,922,1586,10
45036164489,45036164486,-3,1796,3287,10
45037520894,45037520896,2,1569,1881,10
45044717777,45044717782,5,2251,1796,10
45045649015,45045649013,-2,1188,1903,10
45048516277,45048516275,-2,2004,2443,10
45048879057,45048879055,-2,856,1557,10
45051602390,45051602386,-4,1087,2183,10
45063595784,45063595783,-1,1258,1928,10
45064909141,45064909134,-7,2462,6986,10
45069135126,45069135123,-3,986,1417,10
45069467650,45069467648,-2,1482,1654,10
45070947420,45070947438,18,717,1212,10
45072634290,45072634290,0,1941,2433,10
45073732597,45073732590,-7,2611,11206,10
45077603394,45077603401,7,4923,2394,10
45080126589,45080126587,-2,1016,1821,10
45086578283,45086578282,-1,1506,2443,10
45091705470,45091705465,-5,713,1867,10
45099292778,45099292778,0,503,649,10
45100806358,45100806358,0,1293,1835,10
45103389867,45103389866,-1,1237,1678,10
45106220707,45106220706,-1,1024,1575,10
45106491314,45106491312,-2,949,1715,10
45107268477,45107268478,1,1129,1832,10
45109324507,45109324502,-5,973,3010,10
45111023526,45111023526,0,1452,2553,10
45117042005,45117042005,0,1538,2463,10
45118677656,45118677651,-5,1696,4396,10
45118795343,45118795342,-1,1431,2537,10
45120872249,45120872250,1,1308,2001,10
45125398994,45125398987,-7,1806,9844,10
45128405174,45128405173,-1,1406,2165,10
45130390113,45130390111,-2,1318,1817,10
45131872438,45131872437,-1,595,1220,10
45135902022,45135902022,0,951,1720,10
45136232778,45136232777,-1,1335,2126,10
45136854397,45136854405,8,4466,1734,10
45138514650,45138514649,-1,1172,2205,10
45139282011,45139282018,7,3313,876,10
45140098238,45140098238,0,983,1726,10
45142753909,45142753907,-2,1411,2331,10
45143895349,45143895347,-2,1362,2178,10
45145171605,45145171612,7,4123,1519,10
45149445169,45149445166,-3,982,1979,10
45149812635,45149812620,-15,1136,1776,10
45150151310,45150151307,-3,1189,1866,10
45155890841,45155890839,-2,1963,3106,10
45156971340,45156971340,0,1068,1572,10
45158836750,45158836746,-4,689,2475,10
45159425122,45159425122,0,1131,2123,10
45161442186,45161442199,13,11854,32357,10
45162285450,45162285452,2,1172,1272,10
45163069027,45163069025,-2,1717,2131,10
45163927294,45163927293,-1,1667,1957,10
45167801822,45167801822,0,1370,2056,10
45168318548,45168318546,-2,1516,2177,10
45171245949,45171245946,-3,1599,2645,10
45174282145,45174282147,2,1129,1380,10
45175779352,45175779350,-2,1041,1470,10
45178670514,45178670514,0,1389,2449,10
45178815243,45178815240,-3,969,1904,10
45183359858,45183359860,2,1466,1678,10
45183627222,45183627221,-1,1309,2518,10
45184281399,45184281395,-4,1239,1626,10
45185565082,45185565080,-2,1082,1938,10
45186378405,45186378401,-4,1422,2897,10
45192039493,45192039492,-1,1251,1988,10
45197328473,45197328471,-2,1437,2513,10
45205575894,45205575894,0,2707,3168,10
45206931568,45206931566,-2,1334,1999,10
45208690197,45208690198,1,1935,2959,10
45208735570,45208735570,0,1013,2100,10
45212881923,45212881922,-1,1239,2109,10
45214180283,45214180282,-1,1169,2099,10
45216606041,45216606038,-3,862,1491,10
45217121826,45217121807,-19,1136,2187,10
45218277074,45218277089,15,949,1221,10
45226358712,45226358710,-2,1047,1401,10
45231578182,45231578181,-1,1468,2139,10
45231650777,45231650797,20,1647,1991,10
45232387846,45232387846,0,1319,1607,10
45233378278,45233378277,-1,1264,1536,10
45234596866,45234596866,0,683,1034,10
45235025959,45235025958,-1,1310,2218,10
45235118791,45235118791,0,1610,1901,10
45237151312,45237151309,-3,1048,1788,10
45238434407,45238434406,-1,1264,2065,10
45238834801,45238834801,0,1586,1828,10
45249033553,45249033550,-3,1213,2216,10
45249529826,45249529825,-1,959,1551,10
45256304810,45256304816,6,3002,1364,10
45259983796,45259983801,5,55062,25110,10
45260672853,45260672859,6,1840,1053,10
45263830771,45263830771,0,1375,2296,10
45267152719,45267152715,-4,791,1385,10
45269226996,45269226994,-2,1190,1846,10
45272253035,45272253032,-3,888,1977,10
45273260423,45273260422,-1,1024,1423,10
45277106653,45277106649,-4,987,2142,10
45278935163,45278935150,-13,1158,2232,10
45281150008,45281150004,-4,1026,2505,10
45282017934,45282017932,-2,1057,1189,10
45286735434,45286735432,-2,1340,2467,10
45287348635,45287348632,-3,1037,2894,10
45294106060,45294106060,0,857,1478,10
45294807874,45294807873,-1,1273,2634,10
45295517352,45295517350,-2,1058,1660,10
45299776574,45299776572,-2,1198,2704,10
45302747163,45302747162,-1,1162,1390,10
45305594616,45305594614,-2,1210,1703,10
45309739399,45309739398,-1,1346,2129,10
45316604570,45316604584,14,1086,920,10
45317740206,45317740205,-1,1152,1563,10
45317858293,45317858297,4,5350,2326,10
45320065197,45320065196,-1,1136,2659,10
45324759310,45324759309,-1,1784,2806,10
45325287794,45325287795,1,735,931,10
45325494411,45325494409,-2,781,1517,10
45326425715,45326425712,-3,1145,2279,10
45327770123,45327770141,18,433,723,10
45330648747,45330648746,-1,1508,1549,10
45334237565,45334237562,-3,1328,2480,10
45337074693,45337074695,2,1693,1275,10
45339811839,45339811839,0,1262,1731,10
45340815471,45340815470,-1,978,1782,10
45342260720,45342260741,21,899,1858,10
45342950640,45342950638,-2,1323,1831,10
45343845526,45343845525,-1,1551,1987,10
45345118337,45345118339,2,1327,1312,10
45346774852,45346774851,-1,1399,2521,10
45348534999,45348534997,-2,986,1966,10
45351133136,45351133134,-2,1031,2199,10
45353263009,45353263006,-3,1418,1928,10
45356543078,45356543074,-4,1143,2041,10
45359193574,45359193575,1,798,587,10
45362435702,45362435702,0,1677,1869,10
45362715237,45362715235,-2,1179,2071,10
45365987011,45365987023,12,852,1281,10
45367117413,45367117411,-2,1217,2542,10
45368253946,45368253947,1,836,1403,10
45368631437,45368631437,0,1177,1365,10
45369771193,45369771194,1,1385,1822,10
45370955798,45370955794,-4,1017,2801,10
45375652862,45375652865,3,4109,3124,10
45376918459,45376918456,-3,1801,1865,10
45378365615,45378365610,-5,1329,2139,10
45379341293,45379341292,-1,1846,2420,10
45380962648,45380962646,-2,984,1600,10
45385620741,45385620740,-1,1395,1862,10
45385822892,45385822907,15,485,1273,10
45389358761,45389358760,-1,1319,2643,10
45389468837,45389468837,0,1090,2253,10
45391413987,45391413984,-3,1219,2998,10
45396525698,45396525694,-4,1391,2265,10
45396854910,45396854908,-2,1385,2241,10
45398519999,45398519999,0,945,2018,10
45400712797,45400712795,-2,1164,1980,10
45400793337,45400793335,-2,1083,1488,10
45401662547,45401662547,0,1540,2507,10
45402546182,45402546185,3,1775,1563,10
45403965387,45403965382,-5,968,3575,10
45407060229,45407060229,0,1209,1747,10
45408302346,45408302330,-16,916,566,10
45415025593,45415025594,1,1496,1320,10
45418065737,45418065735,-2,1323,2900,10
45419270033,45419270026,-7,1110,3292,10
45422594038,45422594019,-19,1466,1955,10
45423126242,45423126246,4,1750,1375,10
45424431946,45424431943,-3,665,928,10
45427464086,45427464084,-2,1457,1724,10
45429785615,45429785615,0,1063,1766,10
45434414330,45434414329,-1,1213,1947,10
45436867445,45436867445,0,912,1436,10
45439027551,45439027570,19,748,1004,10
45440918471,45440918471,0,901,1227,10
45445162472,45445162469,-3,1092,2127,10
45448190027,45448190026,-1,1049,1918,10
45449061094,45449061091,-3,1280,2334,10
45454200655,45454200656,1,1198,1749,10
45454381669,45454381669,0,993,1748,10
45455085730,45455085751,21,1061,1647,10
45456032479,45456032477,-2,1046,2287,10
45456283497,45456283494,-3,1276,3100,10
45456504749,45456504747,-2,991,1860,10
45459153775,45459153776,1,1253,2047,10
45463931824,45463931823,-1,1314,1702,10
45464099527,45464099526,-1,755,1805,10
45465443882,45465443881,-1,1081,1786,10
45473054333,45473054331,-2,1143,1883,10
45475279631,45475279631,0,996,1933,10
45478661270,45478661269,-1,1066,1708,10
45481570107,45481570101,-6,810,1373,10
45486301822,45486301824,2,2268,1274,10
45486392678,45486392677,-1,1249,1402,10
45488464693,45488464694,1,1532,1706,10
45490298681,45490298679,-2,1282,2177,10
45492666997,45492666998,1,1483,2135,10
45493172134,45493172131,-3,1116,2237,10
45494505143,45494505143,0,1231,2139,10
45495932550,45495932550,0,1119,1197,10
45497510190,45497510189,-1,1497,1943,10
45498695319,45498695309,-10,36149,15024,10
45498940874,45498940872,-2,1749,2281,10
45499747587,45499747585,-2,1280,2458,10
45503775387,45503775387,0,34068,24125,10
45504899793,45504899794,1,1699,1762,10
45505517854,45505517853,-1,1308,1592,10
45507688866,45507688866,0,1555,2165,10
45513446335,45513446333,-2,1038,2104,10
45515539678,45515539677,-1,1484,1794,10
45522616120,45522616115,-5,1698,2787,10
45524554942,45524554941,-1,895,1840,10
45528261949,45528261946,-3,1204,1747,10
45528745226,45528745225,-1,1171,2084,10
45529076899,45529076898,-1,1709,1989,10
45530607778,45530607777,-1,1370,1893,10
45532049230,45532049248,18,1763,2403,10
45532396570,45532396570,0,1404,1839,10
45533169410,45533169410,0,699,1315,10
45533221034,45533221052,18,734,1706,10
45533286655,45533286653,-2,1466,2476,10
45539643235,45539643232,-3,1430,1785,10
45541528798,45541528798,0,1266,1194,10
45541951682,45541951682,0,979,1489,10
45543654864,45543654862,-2,1276,2004,10
45544011243,45544011242,-1,891,1516,10
45545552885,45545552883,-2,1346,1554,10
45545922793,45545922815,22,1790,1919,10
45548528457,45548528458,1,1371,1687,10
45548597658,45548597654,-4,1070,1810,10
45549765019,45549765017,-2,1065,2956,10
45550470236,45550470239,3,1574,1039,10
45555400773,45555400765,-8,897,11137,10
45557303505,45557303503,-2,974,1423,10
45558434505,45558434518,13,359,1516,10
45560703718,45560703716,-2,984,1520,10
45569441322,45569441318,-4,1436,3776,10
45570559204,45570559202,-2,1350,2079,10
45576842558,45576842557,-1,1814,3082,10
45578767354,45578767352,-2,1673,2828,10
45580437224,45580437223,-1,1606,2748,10
45583027172,45583027170,-2,1193,2716,10
45589678736,45589678736,0,1347,1478,10
45591090495,45591090494,-1,1177,1456,10
45593861208,45593861207,-1,887,1934,10
45599418937,45599418926,-11,316,689,10
45603813094,45603813090,-4,2132,2402,10
45603890766,45603890766,0,1154,2039,10
45604832991,45604832990,-1,1310,2993,10
45608478655,45608478654,-1,1150,1264,10
45609536326,45609536324,-2,1180,1433,10
45611395650,45611395651,1,5588,5981,10
45615778982,45615778979,-3,1275,2128,10
45619604774,45619604773,-1,820,1744,10
45624451503,45624451503,0,1309,1683,10
45625503106,45625503122,16,525,1664,10
45627546362,45627546361,-1,1005,1905,10
45628131888,45628131871,-17,1303,2559,10
45628500362,45628500382,20,942,1391,10
45632163764,45632163763,-1,954,1977,10
45637371827,45637371822,-5,1512,6658,10
45638013887,45638013885,-2,1068,1547,10
45640292052,45640292049,-3,1187,1538,10
45640539650,45640539648,-2,1000,1317,10
45640988250,45640988247,-3,1051,2074,10
45644247392,45644247401,9,3113,1342,10
45645719402,45645719399,-3,908,1779,10
45650902341,45650902342,1,1870,1510,10
45656018807,45656018806,-1,1356,2275,10
45660981982,45660981979,-3,1051,1786,10
45661010634,45661010634,0,1023,1516,10
45661938506,45661938503,-3,247,2308,10
45662876755,45662876757,2,1124,2026,10
45667015118,45667015114,-4,1369,1823,10
45668917522,45668917524,2,1857,1527,10
45670322439,45670322455,16,898,1212,10
45670892043,45670892036,-7,1048,5648,10
45673664767,45673664770,3,1546,20467,10
45673784815,45673784815,0,834,2122,10
45674244338,45674244338,0,860,937,10
45675668745,45675668751,6,4479,1304,10
45685119805,45685119803,-2,1220,1848,10
45687965830,45687965830,0,1294,1738,10
45691565238,45691565239,1,1704,1960,10
45692022350,45692022349,-1,1084,1483,10
45692848643,45692848630,-13,862,1662,10
45695051810,45695051809,-1,956,1406,10
45696216422,45696216419,-3,1129,1786,10
45697077426,45697077422,-4,794,1802,10
45698415202,45698415201,-1,864,2063,10
45708287431,45708287418,-13,1270,1777,10
45715154048,45715154049,1,28141,22399,10
45715413774,45715413770,-4,1259,1602,10
45723765070,45723765067,-3,2288,3059,10
45724616735,45724616735,0,1231,1517,10
45725849026,45725849027,1,1625,2547,10
45730842682,45730842677,-5,1337,1473,10
45738556064,45738556062,-2,959,2266,10
45739483698,45739483697,-1,5641,8761,10
45740449109,45740449114,5,1609,863,10
45745786945,45745786943,-2,1198,1836,10
45747754586,45747754583,-3,619,2116,10
45750447169,45750447169,0,1248,2471,10
45750853599,45750853599,0,1417,1850,10
45751700290,45751700294,4,2447,1722,10
45755036229,45755036226,-3,1556,2217,10
45755430258,45755430255,-3,1747,2118,10
45757340247,45757340242,-5,911,2365,10
45759529719,45759529718,-1,1149,2070,10
45759661797,45759661795,-2,1733,2302,10
45762970074,45762970071,-3,1685,2008,10
45763885050,45763885050,0,1514,2212,10
45763978237,45763978236,-1,1298,2628,10
45765230283,45765230279,-4,847,1788,10
45765325683,45765325678,-5,208,331,10
45768757451,45768757450,-1,1311,2040,10
45769240324,45769240325,1,1235,2176,10
45769986530,45769986529,-1,876,1530,10
45771101643,45771101641,-2,1913,2872,10
45771357576,45771357574,-2,1031,1663,10
45772762618,45772762614,-4,890,2008,10
45777377503,45777377505,2,1115,1676,10
45781244613,45781244610,-3,1474,2034,10
45782410898,45782410898,0,1132,1632,10
45784486047,45784486028,-19,698,1483,10
45788491107,45788491107,0,788,1739,10
45790006606,45790006606,0,1522,2388,10
45794521175,45794521172,-3,984,1580,10
45795548623,45795548622,-1,1142,1419,10
45796758617,45796758617,0,1509,2470,10
45798553827,45798553827,0,1217,1625,10
45800502102,45800502099,-3,1080,3019,10
45811942391,45811942390,-1,1102,2301,10
45817419436,45817419435,-1,1448,1815,10
45817544185,45817544181,-4,1113,2043,10
45818115843,45818115862,19,642,1174,10
45818208277,45818208280,3,1053,1276,10
45826665451,45826665449,-2,1146,1334,10
45828345019,45828345018,-1,1465,1904,10
45829135059,45829135056,-3,1277,1721,10
45837490786,45837490786,0,1612,2103,10
45841221226,45841221226,0,727,1099,10
45843084602,45843084600,-2,970,2080,10
45843206171,45843206168,-3,823,1269,10
45844664482,45844664474,-8,972,4414,10
45845817763,45845817758,-5,1299,1693,10
45845872674,45845872673,-1,1351,1837,10
45849643311,45849643309,-2,966,1885,10
45851771811,45851771813,2,1079,1255,10
45851913177,45851913176,-1,1498,1511,10
45855521619,45855521617,-2,993,3646,10
45856617297,45856617298,1,1154,1619,10
45857802567,45857802566,-1,1075,1526,10
45859709448,45859709447,-1,1815,2025,10
45865986018,45865986015,-3,1282,2089,10
45866695223,45866695230,7,12823,33702,10
45866958874,45866958873,-1,1800,2288,10
45867066879,45867066879,0,1089,1544,10
45867506831,45867506830,-1,1344,2387,10
45869978563,45869978558,-5,987,1610,10
45877815655,45877815654,-1,1663,1556,10
45880440382,45880440380,-2,1196,1699,10
45881812090,45881812086,-4,1623,3289,10
45888442570,45888442569,-1,2248,3533,10
45890652047,45890652044,-3,1363,1794,10
45891553503,45891553500,-3,1359,1874,10
45893418555,45893418553,-2,862,2284,10
45897433127,45897433124,-3,1330,2790,10
45898083491,45898083498,7,2461,1369,10
45898577651,45898577651,0,1071,2178,10
45904652515,45904652511,-4,1004,2379,10
45904957174,45904957172,-2,1250,2842,10
45905204341,45905204340,-1,1366,2343,10
45908617809,45908617810,1,1033,810,10
45909930779,45909930778,-1,1338,1842,10
45912035957,45912035956,-1,1335,1578,10
45912785723,45912785722,-1,820,1288,10
45914503631,45914503630,-1,703,1642,10
45916607051,45916607050,-1,1206,2216,10
45918225329,45918225326,-3,1117,2365,10
45918664981,45918664978,-3,1182,1723,10
45919099023,45919099022,-1,1171,1518,10
45920745795,45920745789,-6,1544,5851,10
45924309243,45924309242,-1,1044,1794,10
45930173541,45930173541,0,1244,1952,10
45932173350,45932173346,-4,816,1332,10
45934726877,45934726877,0,1312,2366,10
45935410226,45935410224,-2,1057,1797,10
45936810457,45936810454,-3,1429,2142,10
45937974694,45937974692,-2,1063,1664,10
45939120151,45939120149,-2,985,1798,10
45940211007,45940211005,-2,1061,2313,10
45941006935,45941006933,-2,950,1240,10
45942187299,45942187303,4,2619,1915,10
45943874806,45943874806,0,1538,1905,10
45947762703,45947762697,-6,1206,3464,10
45954573081,45954573080,-1,1283,1891,10
45957225613,45957225611,-2,983,1109,10
45958310839,45958310837,-2,1454,1387,10
45959680909,45959680907,-2,1438,2517,10
45964110906,45964110905,-1,1192,1516,10
45966044202,45966044201,-1,1474,2337,10
45966178163,45966178161,-2,1387,1932,10
45970538974,45970538975,1,778,1916,10
45972603571,45972603549,-22,1290,2268,10
45973301649,45973301647,-2,2162,2594,10
45974525243,45974525241,-2,1237,1985,10
45975936129,45975936127,-2,1199,2037,10
45980268176,45980268175,-1,1145,2969,10
45981999768,45981999766,-2,1391,1769,10
45986167256,45986167263,7,4911,1584,10
45990678873,45990678874,1,1607,1689,10
45995422050,45995422052,2,1675,1494,10
45995924561,45995924558,-3,1824,2299,10
46002301574,46002301579,5,2463,1782,10
46006002929,46006002928,-1,1167,1565,10
46008084380,46008084378,-2,1094,1765,10
46008486403,46008486419,16,521,823,10
46011011602,46011011603,1,1533,1690,10
46012611539,46012611537,-2,1084,2291,10
46017917282,46017917278,-4,1191,2178,10
46021156678,46021156678,0,1275,2173,10
46022674455,46022674453,-2,733,1084,10
46024805064,46024805061,-3,822,1663,10
46025235362,46025235359,-3,1481,2559,10
46026130626,46026130626,0,1089,1688,10
46026325207,46026325206,-1,1247,1405,10
46027293479,46027293477,-2,987,1683,10
46029340881,46029340879,-2,1289,2166,10
46029983965,46029983963,-2,1435,2799,10
46032219134,46032219130,-4,2248,5750,10
46032413391,46032413390,-1,1106,1851,10
46036045729,46036045729,0,1319,1834,10
46037157439,46037157439,0,2837,3848,10
46037944465,46037944462,-3,1190,1624,10
46038425550,46038425549,-1,1580,1823,10
46044835971,46044835967,-4,812,2000,10
46045946878,46045946877,-1,1115,1980,10
46047356221,46047356221,0,1325,1797,10
46048487827,46048487826,-1,2036,3042,10
46054737025,46054737022,-3,1471,1910,10
46059074659,46059074658,-1,1346,2168,10
46060474526,46060474523,-3,1495,1934,10
46062997743,46062997743,0,682,1751,10
46064979835,46064979833,-2,1073,1683,10
46068606034,46068606030,-4,1209,1912,10
46074471930,46074471929,-1,1034,1063,10
46079410319,46079410318,-1,1253,2095,10
46088100654,46088100658,4,1424,1420,10
46088617715,46088617714,-1,1306,1809,10
46089034593,46089034593,0,1552,2519,10
46090504242,46090504241,-1,1408,2029,10
46093215776,46093215769,-7,2265,7030,10
46093470835,46093470835,0,1800,1885,10
46097944989,46097944988,-1,970,1804,10
46098374362,46098374360,-2,1393,2443,10
46098554696,46098554693,-3,1403,1510,10
46100396805,46100396803,-2,814,1917,10
46100875912,46100875902,-10,1510,2348,10
46102754611,46102754609,-2,1345,1580,10
46106522243,46106522242,-1,1148,1698,10
46106940847,46106940845,-2,1252,1428,10
46124703686,46124703682,-4,1102,2281,10
46127845078,46127845078,0,1301,1883,10
46131695640,46131695637,-3,1492,2218,10
46133152097,46133152098,1,1564,1777,10
46133246766,46133246778,12,1139,1479,10
46136390094,46136390092,-2,1072,2266,10
46137213939,46137213941,2,880,876,10
46142898634,46142898613,-21,1129,136,10
46153387347,46153387345,-2,1208,1924,10
46154680002,46154679996,-6,25003,14309,10
46157388027,46157388026,-1,1121,1615,10
46164964380,46164964378,-2,1517,2481,10
46167902494,46167902491,-3,833,1973,10
46168804269,46168804269,0,1694,1620,10
46172753357,46172753357,0,1453,1961,10
46173827894,46173827894,0,1666,2006,10
46174050320,46174050318,-2,1517,2453,10
46182169026,46182169022,-4,1136,2941,10
46187090047,46187090034,-13,461,1054,10
46188848875,46188848873,-2,882,2086,10
46195679459,46195679453,-6,1167,2593,10
46196207528,46196207549,21,1165,3535,10
46198783361,46198783358,-3,1646,2809,10
46198952107,46198952106,-1,1024,1903,10
46209289537,46209289538,1,1134,1789,10
46209790969,46209790969,0,838,1606,10
46214795223,46214795222,-1,1272,2385,10
46216013131,46216013129,-2,967,1561,10
46217772746,46217772746,0,1014,1593,10
46226036657,46226036656,-1,1899,2159,10
46226326658,46226326657,-1,1031,2160,10
46229091723,46229091721,-2,1935,2402,10
46232516210,46232516211,1,1390,1405,10
46237401197,46237401194,-3,1173,1642,10
46239719480,46239719478,-2,1888,1585,10
46253969323,46253969322,-1,1260,1814,10
46254096510,46254096525,15,1954,1100,10
46259524870,46259524868,-2,1102,1508,10
46262219443,46262219438,-5,1193,2611,10
46266152420,46266152414,-6,1535,4522,10
46268293359,46268293360,1,1193,1374,10
46270428619,46270428614,-5,1214,2113,10
46274630575,46274630570,-5,1368,2162,10
46275444441,46275444439,-2,863,1458,10
46277993251,46277993251,0,1118,994,10
46278217161,46278217157,-4,897,1903,10
46280150749,46280150749,0,1226,2552,10
46289335715,46289335718,3,2452,1624,10
46291579450,46291579450,0,1308,2127,10
46292281489,46292281487,-2,719,1063,10
46293964817,46293964818,1,872,1431,10
46295022559,46295022561,2,1112,2300,10
46295626790,46295626788,-2,1908,2164,10
46296742118,46296742122,4,2890,1692,10
46297206748,46297206766,18,1205,2009,10
46302901934,46302901932,-2,1089,2173,10
46305243939,46305243937,-2,1197,2079,10
46306187082,46306187080,-2,893,1685,10
46306987986,46306987985,-1,904,2056,10
46308510205,46308510210,5,2333,1273,10
46310764335,46310764334,-1,1267,2115,10
46314978754,46314978751,-3,1555,2383,10
46317510846,46317510850,4,1887,1299,10
46322734865,46322734866,1,1364,2442,10
46323742254,46323742252,-2,920,1689,10
46325670645,46325670646,1,1917,1950,10
46328320379,46328320377,-2,1088,2323,10
46328551099,46328551096,-3,1241,1898,10
46330608731,46330608729,-2,686,1153,10
46334270003,46334270001,-2,1696,2513,10
46337957353,46337957353,0,1309,1799,10
46341224578,46341224580,2,3161,3258,10
46343308510,46343308510,0,733,1382,10
46349309761,46349309757,-4,1107,2197,10
46350315049,46350315047,-2,1198,2169,10
46351351070,46351351066,-4,1619,2674,10
46351613817,46351613814,-3,1067,2707,10
46357980515,46357980516,1,1765,1811,10
46360323555,46360323554,-1,1303,1894,10
46360774538,46360774529,-9,1277,1615,10
46360983758,46360983754,-4,1048,1795,10
46362864597,46362864600,3,15762,12390,10
46363537674,46363537674,0,1261,1586,10
46363909622,46363909602,-20,966,716,10
46366087101,46366087100,-1,1357,1944,10
46368760314,46368760309,-5,1156,3603,10
46369021270,46369021266,-4,1116,2079,10
46369396459,46369396457,-2,1899,1949,10
46370403257,46370403255,-2,1250,2363,10
46372774149,46372774149,0,1311,1767,10
46375448275,46375448274,-1,1110,2860,10
46375614095,46375614093,-2,945,2089,10
46379217095,46379217093,-2,971,1983,10
46379492104,46379492084,-20,986,2270,10
46382364736,46382364739,3,1797,1767,10
46382699163,46382699165,2,958,1314,10
46388104222,46388104220,-2,925,1660,10
46390555241,46390555247,6,2195,1312,10
46390680222,46390680208,-14,1562,561,10
46396438263,46396438261,-2,1119,2283,10
46398616224,46398616217,-7,4015,11449,10
46400508963,46400508963,0,1308,1873,10
46401254090,46401254088,-2,1214,2298,10
46402082710,46402082707,-3,1500,2424,10
46411911754,46411911753,-1,1308,1555,10
46412909494,46412909491,-3,1230,2609,10
46415214508,46415214530,22,884,3412,10
46416404754,46416404752,-2,1235,1954,10
46416525751,46416525749,-2,1470,1767,10
46418357631,46418357630,-1,971,1799,10
46422554498,46422554496,-2,1127,2287,10
46422957138,46422957138,0,1476,1292,10
46424736746,46424736741,-5,983,2188,10
46426573538,46426573537,-1,1303,1265,10
46427286190,46427286189,-1,1458,2127,10
46430679794,46430679793,-1,1183,1915,10
46431839200,46431839200,0,1744,2075,10
46436569579,46436569579,0,1539,1897,10
46437683869,46437683869,0,1175,2153,10
46439426428,46439426427,-1,22849,44060,10
46441332035,46441332033,-2,1318,1775,10
46446252915,46446252913,-2,995,1544,10
46446447301,46446447300,-1,993,1958,10
46446676534,46446676534,0,1258,1508,10
46455206236,46455206232,-4,1446,1560,10
46459558090,46459558089,-1,1652,2072,10
46463640070,46463640070,0,1258,1859,10
46468476583,46468476581,-2,1367,2158,10
46471029823,46471029822,-1,1340,1647,10
46477349426,46477349423,-3,1531,2386,10
46479089727,46479089726,-1,1130,2296,10
46480025711,46480025708,-3,1310,1830,10
46480645538,46480645537,-1,1256,1477,10
46488065314,46488065314,0,1786,1910,10
46490056474,46490056474,0,1303,2040,10
46490177003,46490177002,-1,816,1689,10
46492206536,46492206534,-2,1375,2048,10
46495620431,46495620432,1,1307,2011,10
46499979635,46499979633,-2,1039,1720,10
46503123957,46503123956,-1,1113,1283,10
46505683278,46505683278,0,1035,1630,10
46506286612,46506286630,18,1301,1234,10
46512300990,46512300987,-3,1343,2816,10
46515531007,46515531004,-3,901,1794,10
46519503627,46519503626,-1,929,1225,10
46522880115,46522880114,-1,892,2158,10
46524408989,46524408987,-2,1143,2212,10
46526695941,46526695938,-3,1259,1724,10
46526739037,46526739035,-2,600,1504,10
46527189208,46527189206,-2,1291,2819,10
46534128750,46534128749,-1,1068,2407,10
46534589044,46534589043,-1,1334,2476,10
46535163758,46535163757,-1,1258,2567,10
46536667203,46536667205,2,1740,2132,10
46539715370,46539715368,-2,1468,2988,10
46542173483,46542173481,-2,1357,1444,10
46542972766,46542972764,-2,1515,2030,10
46545749587,46545749586,-1,967,1854,10
46547406822,46547406819,-3,1546,2287,10
46547584730,46547584717,-13,733,1553,10
46547911731,46547911739,8,380,774,10
46550847215,46550847217,2,1174,1943,10
46551008495,46551008498,3,1214,1452,10
46551612194,46551612194,0,1487,1981,10
46560429514,46560429513,-1,1149,1437,10
46561270932,46561270929,-3,1025,2124,10
46562237243,46562237241,-2,912,1778,10
46564291609,46564291607,-2,1768,3000,10
46565147849,46565147846,-3,984,2231,10
46566392293,46566392288,-5,1035,2722,10
46566513766,46566513764,-2,956,2614,10
46567788382,46567788379,-3,786,1484,10
46568361962,46568361962,0,2520,3743,10
46573242803,46573242801,-2,960,1445,10
46574481877,46574481877,0,1128,1396,10
46579993534,46579993533,-1,1366,2291,10
46581130698,46581130698,0,2613,3874,10
46582244142,46582244141,-1,1304,1935,10
46582275698,46582275698,0,1083,1833,10
46582698198,46582698195,-3,1163,1848,10
46590525642,46590525640,-2,1291,2013,10
46594026066,46594026063,-3,1181,2061,10
46596335393,46596335393,0,865,1060,10
46597723526,46597723525,-1,1260,1759,10
46599867001,46599866998,-3,988,1595,10
46604822654,46604822654,0,1264,1496,10
46609245383,46609245384,1,721,1601,10
46611079364,46611079362,-2,1298,1490,10
46617806891,46617806889,-2,944,1748,10
46622973374,46622973373,-1,1590,1699,10
46623787248,46623787246,-2,1485,2417,10
46628594362,46628594359,-3,1457,2139,10
46628798817,46628798814,-3,1299,2194,10
46632626202,46632626202,0,1847,1912,10
46642472430,46642472431,1,1247,1581,10
46643045958,46643045959,1,1542,2304,10
46643572414,46643572414,0,1826,1381,10
46645313786,46645313786,0,1569,2055,10
46646372548,46646372549,1,1424,1558,10
46648337345,46648337345,0,903,950,10
46649039353,46649039351,-2,693,1513,10
46654043611,46654043608,-3,1035,2608,10
46655785725,46655785723,-2,928,1990,10
46657611331,46657611329,-2,1600,1926,10
46660785361,46660785361,0,1653,2656,10
46663029009,46663029007,-2,1164,2794,10
46667758472,46667758471,-1,1357,1908,10
46669811077,46669811086,9,884,1388,10
46675288805,46675288805,0,1051,1620,10
46677049694,46677049692,-2,1218,2883,10
46677209555,46677209554,-1,1171,1716,10
46677565498,46677565494,-4,1342,2520,10
46678964507,46678964510,3,1300,1324,10
46679289511,46679289512,1,1042,1810,10
46680125107,46680125107,0,1047,2147,10
46680718474,46680718471,-3,683,930,10
46681436238,46681436237,-1,1284,1556,10
46684129462,46684129462,0,1541,1841,10
46690144403,46690144402,-1,1026,1598,10
46690518737,46690518735,-2,718,1552,10
46694668108,46694668107,-1,1250,2802,10
46694693915,46694693918,3,1678,1792,10
46696295189,46696295189,0,1698,2059,10
46697856541,46697856539,-2,1223,2036,10
46699590135,46699590133,-2,1326,2063,10
46700305987,46700306006,19,664,1692,10
46704052993,46704052995,2,1796,1471,10
46705547734,46705547730,-4,1176,2606,10
46708172285,46708172281,-4,1089,1138,10
46709310408,46709310398,-10,755,2008,10
46709365587,46709365573,-14,1361,1801,10
46709573513,46709573515,2,1260,1816,10
46710302101,46710302099,-2,967,1865,10
46710983299,46710983298,-1,1452,1948,10
46713293682,46713293681,-1,1334,2693,10
46721060940,46721060947,7,474,9708,10
46723291999,46723292000,1,966,1758,10
46724830993,46724830991,-2,1820,2355,10
46725160970,46725160949,-21,1085,1611,10
46725363803,46725363805,2,1351,1619,10
46726395107,46726395106,-1,1177,2055,10
46729936416,46729936414,-2,1217,1490,10
46732994902,46732994911,9,873,2055,10
46734322697,46734322695,-2,1198,2012,10
46734872285,46734872285,0,1288,2012,10
46737915869,46737915870,1,1460,1549,10
46739737395,46739737394,-1,1150,1569,10
46744895261,46744895261,0,1252,1327,10
46749482529,46749482528,-1,948,1579,10
46750122910,46750122911,1,903,861,10
46751595336,46751595335,-1,1390,1527,10
46752896017,46752896015,-2,1132,2296,10
46756328514,46756328514,0,1143,1812,10
46758570635,46758570638,3,1120,1886,10
46764262937,46764262934,-3,878,2282,10
46769275813,46769275815,2,1476,1709,10
46769424774,46769424773,-1,903,1604,10
46771451770,46771451767,-3,1479,3134,10
46777226358,46777226366,8,3226,1696,10
46783430750,46783430749,-1,1448,1652,10
46783491059,46783491046,-13,1676,2436,10
46785059317,46785059314,-3,1410,1285,10
46787604543,46787604542,-1,1225,1781,10
46789274562,46789274558,-4,1027,2093,10
46790219706,46790219726,20,1726,2040,10
46790791197,46790791193,-4,40654,17720,10
46792619166,46792619166,0,1209,1416,10
46795247947,46795247945,-2,1962,2396,10
46796905229,46796905225,-4,1208,3139,10
46797625198,46797625193,-5,1754,6791,10
46801148720,46801148718,-2,1078,1712,10
46802221119,46802221117,-2,629,1993,10
46808321175,46808321175,0,980,1742,10
46815530489,46815530489,0,945,1722,10
46822924710,46822924710,0,925,1278,10
46829266897,46829266895,-2,1313,1377,10
46830116575,46830116574,-1,1365,1582,10
46833765346,46833765346,0,915,1062,10
46834626371,46834626370,-1,1542,2645,10
46834992846,46834992846,0,1587,1979,10
46839389139,46839389141,2,873,1077,10
46841551918,46841551918,0,984,1016,10
46848465205,46848465203,-2,19672,7289,10
46854730477,46854730474,-3,1122,1545,10
46858638115,46858638115,0,796,1636,10
46862245367,46862245366,-1,1769,2607,10
46862357464,46862357463,-1,1180,2504,10
46870100030,46870100029,-1,1819,2367,10
46872044659,46872044659,0,612,600,10
46872882589,46872882586,-3,1028,2012,10
46873197433,46873197430,-3,1250,1826,10
46876489975,46876489973,-2,1276,2001,10
46877267897,46877267897,0,1412,2171,10
46879901079,46879901080,1,967,1688,10
46880485074,46880485094,20,762,1709,10
46881534397,46881534404,7,6442,2273,10
46885597572,46885597573,1,1677,1638,10
46886461750,46886461748,-2,1294,1380,10
46886786062,46886786060,-2,1037,2145,10
46891345218,46891345218,0,1017,1646,10
46892490349,46892490332,-17,1369,1024,10
46894636968,46894636966,-2,2481,3977,10
46897819543,46897819539,-4,1093,2497,10
46901093722,46901093722,0,1623,2268,10
46901369302,46901369315,13,12031,35719,10
46902084042,46902084039,-3,1450,2464,10
46904182298,46904182297,-1,1203,2244,10
46907420581,46907420579,-2,1348,2168,10
46911230025,46911230019,-6,746,3608,10
46913182050,46913182047,-3,1636,1778,10
46917742699,46917742698,-1,1212,1728,10
46921730768,46921730766,-2,2341,4824,10
46923419598,46923419597,-1,1111,1584,10
46923986429,46923986416,-13,1633,1656,10
46924595462,46924595461,-1,1714,2174,10
46926113318,46926113316,-2,1253,2385,10
46927827065,46927827062,-3,1309,1979,10
46929959749,46929959746,-3,1413,1385,10
46930923898,46930923897,-1,868,2150,10
46931232339,46931232338,-1,1124,2075,10
46938482029,46938482026,-3,980,2257,10
46939373467,46939373469,2,859,889,10
46940302955,46940302952,-3,1610,2795,10
46941816209,46941816209,0,1182,1553,10
46942234395,46942234391,-4,1591,2047,10
46943382298,46943382297,-1,1303,2296,10
46946274450,46946274449,-1,1044,1945,10
46946749458,46946749458,0,1099,1582,10
46947554630,46947554626,-4,1007,1583,10
46947807841,46947807838,-3,1122,1975,10
46948373882,46948373880,-2,937,2535,10
46949217659,46949217651,-8,727,1546,10
46951657438,46951657435,-3,1208,2058,10
46951956264,46951956262,-2,1333,2005,10
46952138373,46952138371,-2,1362,2066,10
46952651971,46952651969,-2,1373,2246,10
46953083352,46953083349,-3,1064,1855,10
46957246589,46957246593,4,2898,1690,10
46958830799,46958830798,-1,1645,2549,10
46960037313,46960037313,0,3442,3313,10
46960858694,46960858693,-1,1462,2912,10
46963745006,46963745005,-1,1102,2004,10
46966314190,46966314189,-1,1163,1692,10
46967972874,46967972873,-1,1441,1448,10
46968650608,46968650593,-15,887,1047,10
46975534767,46975534767,0,1041,1960,10
46977187195,46977187194,-1,1015,1905,10
46981061632,46981061632,0,1707,2175,10
46983418886,46983418885,-1,1613,1988,10
46984223694,46984223676,-18,383,526,10
46985495850,46985495850,0,874,1582,10
46988137069,46988137066,-3,1537,2345,10
46989544723,46989544722,-1,1161,1415,10
46990208401,46990208399,-2,1449,2286,10
46992077706,46992077701,-5,641,1786,10
46992152337,46992152334,-3,1389,1754,10
46992457311,46992457311,0,1276,2015,10
46992733145,46992733142,-3,927,2344,10
46995499111,46995499116,5,5456,36506,10
46995669459,46995669458,-1,1856,1798,10
47000440778,47000440776,-2,983,2193,10
47000681054,47000681052,-2,1607,2137,10
47002771273,47002771272,-1,1280,1734,10
47004288018,47004288024,6,3147,1396,10
47005571706,47005571709,3,1355,2116,10
47008758265,47008758260,-5,31760,15099,10
47014173667,47014173670,3,1355,1638,10
47014239310,47014239309,-1,952,1755,10
47014462530,47014462530,0,1081,1477,10
47017791312,47017791311,-1,1403,2311,10
47018106987,47018107004,17,340,879,10
47022934619,47022934618,-1,1509,2318,10
47023251855,47023251859,4,1168,1055,10
47025913587,47025913586,-1,1063,1508,10
47027306810,47027306809,-1,1083,817,10
47028288646,47028288646,0,1073,2181,10
47036770131,47036770131,0,1255,2102,10
47037388532,47037388526,-6,1289,3381,10
47037713523,47037713522,-1,1032,1865,10
47040021434,47040021431,-3,1082,1258,10
47045549051,47045549036,-15,776,1831,10
47049306667,47049306666,-1,461,1242,10
47050413942,47050413946,4,10399,6704,10
47052249574,47052249574,0,789,1008,10
47054381837,47054381836,-1,1365,2429,10
47058318882,47058318880,-2,1725,2509,10
47058937331,47058937327,-4,954,1783,10
47059570885,47059570883,-2,1743,2832,10
47059778200,47059778199,-1,1352,1843,10
47065492317,47065492322,5,2133,1128,10
47065756729,47065756727,-2,1190,1714,10
47065882850,47065882870,20,352,1090,10
47066173812,47066173815,3,1330,840,10
47068550197,47068550198,1,1116,1510,10
47072062979,47072062985,6,2201,993,10
47074334746,47074334744,-2,1577,3258,10
47076038174,47076038174,0,1219,1099,10
47078003750,47078003749,-1,1324,1954,10
47081311782,47081311778,-4,1073,2854,10
47083911798,47083911794,-4,1105,1321,10
47084032759,47084032758,-1,1839,2629,10
47084601482,47084601477,-5,1431,2644,10
47087963069,47087963070,1,780,1632,10
47090852091,47090852088,-3,1368,2030,10
47092747022,47092747019,-3,1453,2406,10
47095430467,47095430467,0,775,1559,10
47104324460,47104324457,-3,1417,2693,10
47105149829,47105149829,0,1132,1846,10
47106998183,47106998182,-1,944,1873,10
47115636059,47115636060,1,1066,1392,10
47116807238,47116807238,0,820,1772,10
47117671306,47117671309,3,2188,1924,10
47119583079,47119583077,-2,1151,1563,10
47120570485,47120570504,19,1265,1896,10
47123776399,47123776400,1,1792,2115,10
47124276823,47124276822,-1,1549,1630,10
47129762428,47129762429,1,1418,1697,10
47132335004,47132335005,1,1532,1516,10
47134151658,47134151656,-2,1209,2133,10
47136582090,47136582087,-3,986,1358,10
47139056575,47139056574,-1,1551,2493,10
47143452961,47143452960,-1,1635,1707,10
47143526802,47143526802,0,964,1817,10
47145562541,47145562545,4,3019,1721,10
47145665625,47145665622,-3,1171,1944,10
47147046853,47147046852,-1,1149,1430,10
47155481386,47155481383,-3,947,1454,10
47156019322,47156019321,-1,1050,2358,10
47159001206,47159001205,-1,1138,2106,10
47159332629,47159332625,-4,1167,2347,10
47159588790,47159588791,1,757,612,10
47165039847,47165039847,0,1337,1375,10
47165260967,47165260963,-4,1302,1514,10
47165462872,47165462894,22,636,2229,10
47165951492,47165951491,-1,1279,1772,10
47166598623,47166598623,0,1716,1940,10
47170482274,47170482275,1,1689,1679,10
47174980613,47174980613,0,1811,1319,10
47176800185,47176800182,-3,1946,2677,10
47177986758,47177986757,-1,1165,2011,10
47183709310,47183709307,-3,927,1083,10
47185435002,47185435000,-2,1293,2031,10
47188700406,47188700405,-1,1592,2135,10
47190711154,47190711152,-2,1220,1888,10
47194483425,47194483424,-1,1406,1927,10
47195865955,47195865959,4,6512,4386,10
47198094012,47198094010,-2,1950,2576,10
47198138137,47198138138,1,1193,1159,10
47200756513,47200756510,-3,929,1893,10
47202452809,47202452808,-1,743,2421,10
47203131382,47203131379,-3,1134,1918,10
47205781891,47205781889,-2,1240,2492,10
47209920539,47209920537,-2,1509,1675,10
47212351800,47212351798,-2,1358,2186,10
47213189782,47213189779,-3,1441,1772,10
47215142786,47215142785,-1,1338,2468,10
47218369304,47218369302,-2,1417,2089,10
47219095847,47219095846,-1,989,1814,10
47224495389,47224495382,-7,1081,2793,10
47224669986,47224670007,21,176,944,10
47230506574,47230506575,1,1651,1862,10
47235066146,47235066146,0,749,1619,10
47238148473,47238148472,-1,1157,1971,10
47238232202,47238232207,5,2526,1426,10
47251036290,47251036290,0,1072,2309,10
47255041284,47255041282,-2,1383,1928,10
47255333874,47255333870,-4,1148,2230,10
47255372966,47255372964,-2,1364,1800,10
47258028178,47258028178,0,1092,2307,10
47258819853,47258819874,21,1148,1663,10
47266292661,47266292662,1,1371,1568,10
47270221351,47270221351,0,1350,1362,10
47270311642,47270311639,-3,1096,1843,10
47270494426,47270494424,-2,1384,2148,10
47272526298,47272526298,0,1258,2314,10
47274021332,47274021331,-1,1214,1823,10
47276427638,47276427638,0,1375,1679,10
47281017640,47281017639,-1,1465,1630,10
47283770811,47283770809,-2,989,1858,10
47286123672,47286123671,-1,1573,1863,10
47289420030,47289420027,-3,1225,2398,10
47292358277,47292358274,-3,968,1931,10
47295780148,47295780147,-1,555,1137,10
47297191721,47297191732,11,9431,41240,10
47297467915,47297467911,-4,890,1468,10
47299717373,47299717370,-3,1331,2313,10
47302292858,47302292857,-1,1332,2184,10
47308358588,47308358587,-1,1771,2524,10
47311699978,47311699979,1,1614,1778,10
47311879954,47311879959,5,4228,2310,10
47314184455,47314184453,-2,1135,1421,10
47323621571,47323621569,-2,1357,1893,10
47323848804,47323848811,7,2156,810,10
47324480897,47324480896,-1,992,2562,10
47324964138,47324964137,-1,1358,2149,10
47327707010,47327707008,-2,1140,2240,10
47328088815,47328088815,0,1443,2919,10
47333248589,47333248593,4,1604,1992,10
47333487911,47333487910,-1,1432,1653,10
47334197183,47334197183,0,758,1229,10
47340902814,47340902813,-1,1627,2396,10
47341560440,47341560440,0,5898,8779,10
47347997975,47347997971,-4,1217,2360,10
47353637522,47353637523,1,1164,1962,10
47358343932,47358343929,-3,986,2444,10
47358913599,47358913598,-1,1034,1708,10
47360706694,47360706693,-1,1296,1701,10
47361883438,47361883439,1,1973,2162,10
47362613734,47362613733,-1,1071,1415,10
47364875303,47364875302,-1,2851,4736,10
47366401390,47366401389,-1,1025,1393,10
47372902133,47372902133,0,1082,2091,10
47378000658,47378000664,6,3116,1494,10
47379732722,47379732722,0,950,1489,10
47386804450,47386804447,-3,779,1435,10
47387191209,47387191199,-10,389,1191,10
47392337625,47392337624,-1,1182,1655,10
47393151690,47393151689,-1,974,1509,10
47393327875,47393327894,19,462,678,10
47396498777,47396498774,-3,1256,2519,10
47396619430,47396619429,-1,1004,2079,10
47403466457,47403466459,2,1017,1671,10
47406347999,47406347997,-2,975,3144,10
47407878095,47407878093,-2,1008,1687,10
47408589448,47408589441,-7,3510,16951,10
47411566947,47411566942,-5,898,1214,10
47412374771,47412374770,-1,1240,1953,10
47417030698,47417030701,3,1753,1302,10
47423928531,47423928532,1,1087,1861,10
47429285323,47429285323,0,1086,1994,10
47434725805,47434725804,-1,1094,2159,10
47435181792,47435181791,-1,1087,1779,10
47436069017,47436069015,-2,1169,1621,10
47437685046,47437685043,-3,1846,3327,10
47442264713,47442264711,-2,1504,1820,10
47445205496,47445205495,-1,1374,1906,10
47446150992,47446150990,-2,1168,1651,10
47447014262,47447014257,-5,1106,2076,10
47447345776,47447345773,-3,1023,1359,10
47452650203,47452650202,-1,978,1676,10
47456885844,47456885838,-6,934,2979,10
47459196618,47459196619,1,1070,1201,10
47459859973,47459859973,0,1547,2380,10
47462039753,47462039754,1,1349,2623,10
47463245905,47463245905,0,1527,1896,10
47467011186,47467011186,0,1225,1719,10
47471791574,47471791571,-3,1144,1869,10
47477778467,47477778466,-1,524,1146,10
47479223930,47479223930,0,1458,2476,10
47482852566,47482852564,-2,1122,2154,10
47484969563,47484969562,-1,878,1644,10
47486126791,47486126790,-1,1615,1899,10
47488662431,47488662430,-1,1382,1953,10
47489462894,47489462891,-3,536,1149,10
47490139476,47490139490,14,367,1164,10
47491435712,47491435711,-1,1447,3315,10
47491624973,47491624973,0,1035,1586,10
47495578198,47495578197,-1,1243,2181,10
47496916915,47496916914,-1,1272,1750,10
47498000876,47498000889,13,189,471,10
47508138968,47508138966,-2,1098,2114,10
47515243745,47515243742,-3,1552,2513,10
47515641898,47515641896,-2,1053,2378,10
47515795268,47515795266,-2,1468,2902,10
47518409320,47518409317,-3,1100,1831,10
47519206885,47519206883,-2,1336,1831,10
47523097802,47523097801,-1,1403,1382,10
47524826939,47524826936,-3,1034,2488,10
47532653719,47532653718,-1,1440,2666,10
47533243907,47533243906,-1,1388,2377,10
47538808471,47538808473,2,1128,2016,10
47541925305,47541925311,6,3659,1266,10
47544081496,47544081494,-2,1255,2146,10
47549035146,47549035146,0,1264,2091,10
47549560826,47549560824,-2,1012,1445,10
47552600209,47552600206,-3,1115,2524,10
47555096571,47555096570,-1,876,2033,10
47557089449,47557089447,-2,917,1512,10
47558341845,47558341846,1,1555,1846,10
47560151819,47560151818,-1,1352,2132,10
47565987255,47565987256,1,905,1002,10
47566227541,47566227538,-3,985,1807,10
47572708601,47572708594,-7,1007,3594,10
47573185731,47573185729,-2,1235,1937,10
47577256661,47577256661,0,3004,3303,10
47579352761,47579352761,0,1400,1626,10
47580125190,47580125189,-1,1464,2342,10
47585513518,47585513515,-3,1220,1906,10
47586712801,47586712801,0,1397,2508,10
47587335310,47587335310,0,1282,1683,10
47592747222,47592747221,-1,1349,1898,10
47594824987,47594824985,-2,1139,2023,10
47597386610,47597386610,0,857,1692,10
47597867594,47597867592,-2,1090,2828,10
47598763794,47598763792,-2,1617,2718,10
47603823891,47603823874,-17,1392,2184,10
47604907253,47604907257,4,2698,1738,10
47605017274,47605017277,3,2718,2789,10
47608494814,47608494813,-1,1040,1875,10
47611444322,47611444318,-4,1387,1679,10
47611582981,47611582979,-2,1177,2183,10
47614219100,47614219098,-2,1126,2338,10
47617171178,47617171178,0,1258,1640,10
47625255675,47625255673,-2,1073,2194,10
47626197656,47626197662,6,2801,1832,10
47628376025,47628376023,-2,1616,2338,10
47629725467,47629725466,-1,941,1586,10
47633172944,47633172938,-6,58221,20852,10
47634082060,47634082060,0,942,1487,10
47634550554,47634550548,-6,2275,6087,10
47635405541,47635405540,-1,1599,2527,10
47638870118,47638870118,0,1476,2042,10
47639172107,47639172097,-10,194,4028,10
47640131231,47640131228,-3,1189,2623,10
47641839437,47641839438,1,1184,1711,10
47642543722,47642543721,-1,1434,2946,10
47644347663,47644347660,-3,994,1806,10
47646175435,47646175438,3,946,752,10
47648232662,47648232669,7,2853,1137,10
47657234237,47657234237,0,1628,2162,10
47658278878,47658278877,-1,1178,1393,10
47658409749,47658409748,-1,1342,2804,10
47661471588,47661471588,0,1061,2548,10
47661989482,47661989502,20,926,1981,10
47663451925,47663451922,-3,886,1769,10
47666162934,47666162936,2,1500,1571,10
47669528786,47669528786,0,1167,1955,10
47672596558,47672596558,0,983,1231,10
47674846085,47674846086,1,2375,2314,10
47677900340,47677900338,-2,1432,1768,10
47686432648,47686432645,-3,1370,2649,10
47690795768,47690795766,-2,1899,2818,10
47692426662,47692426662,0,923,1974,10
47695224794,47695224812,18,232,214,10
47697439308,47697439306,-2,1338,2095,10
47702200950,47702200948,-2,1317,2277,10
47703086402,47703086402,0,1214,1731,10
47703311862,47703311862,0,1652,2972,10
47705843205,47705843214,9,4487,1157,10
47708151124,47708151121,-3,1294,2881,10
47714389806,47714389822,16,1128,2088,10
47718748072,47718748075,3,13985,10514,10
47719125623,47719125621,-2,1077,1939,10
47723014774,47723014782,8,8973,1870,10
47723877861,47723877860,-1,1334,2132,10
47730304791,47730304789,-2,733,2249,10
47730609290,47730609288,-2,833,2054,10
47734181448,47734181445,-3,1150,1419,10
47735154894,47735154893,-1,1225,1813,10
47735980718,47735980716,-2,963,1932,10
47736536966,47736536965,-1,1173,1802,10
47740337913,47740337911,-2,1264,1740,10
47740703799,47740703798,-1,956,1670,10
47743090797,47743090798,1,1018,1426,10
47747102507,47747102508,1,1453,1452,10
47748711399,47748711398,-1,1123,2023,10
47749179356,47749179353,-3,1335,1679,10
47749457563,47749457564,1,1321,1357,10
47750189026,47750189025,-1,1405,1886,10
47758233789,47758233789,0,1120,1331,10
47759709091,47759709098,7,4085,1206,10
47760529394,47760529393,-1,1350,1955,10
47761035447,47761035446,-1,1214,1586,10
47762521301,47762521299,-2,1315,1436,10
47765895438,47765895437,-1,1514,1319,10
47767916531,47767916529,-2,1348,1411,10
47768373398,47768373398,0,1307,1677,10
47774407349,47774407346,-3,1305,2434,10
47775891076,47775891072,-4,971,1244,10
47782585010,47782585009,-1,760,1154,10
47783905927,47783905922,-5,1420,1816,10
47784102871,47784102870,-1,1243,1937,10
47784362380,47784362396,16,895,1916,10
47785893099,47785893098,-1,1118,1969,10
47786855618,47786855639,21,1163,2272,10
47789764551,47789764549,-2,1193,1559,10
47790038371,47790038368,-3,914,1362,10
47791491555,47791491552,-3,929,1841,10
47792572582,47792572581,-1,1080,1651,10
47792603719,47792603717,-2,1002,1699,10
47792913915,47792913899,-16,1078,2286,10
47793765890,47793765874,-16,238,866,10
47796174947,47796174945,-2,1216,1772,10
47796975390,47796975389,-1,1288,1745,10
47798218194,47798218193,-1,1966,2573,10
47798555321,47798555324,3,1582,1862,10
47802276610,47802276611,1,1361,2618,10
47803312518,47803312514,-4,944,2122,10
47804654259,47804654259,0,1409,1929,10
47805991598,47805991595,-3,1142,2689,10
47808222156,47808222154,-2,1575,2228,10
47808477074,47808477071,-3,1332,2644,10
47809568110,47809568108,-2,1044,1669,10
47811296230,47811296230,0,1184,2576,10
47814373788,47814373786,-2,26870,15474,10
47819392027,47819392026,-1,1869,1884,10
47826720517,47826720514,-3,742,1838,10
47828324717,47828324715,-2,790,2212,10
47828742768,47828742790,22,1290,2100,10
47829594574,47829594573,-1,1131,2496,10
47829965497,47829965498,1,1050,1392,10
47830836314,47830836312,-2,1043,1729,10
47836073142,47836073141,-1,1767,2679,10
47836531866,47836531864,-2,913,1962,10
47843095065,47843095063,-2,1086,2007,10
47847130275,47847130274,-1,1831,2134,10
47852775747,47852775750,3,2261,1686,10
47860762154,47860762157,3,1992,1901,10
47864552441,47864552438,-3,2638,4625,10
47865540006,47865540004,-2,1615,2382,10
47866332083,47866332082,-1,1254,1530,10
47868278877,47868278877,0,1411,2196,10
47873877931,47873877926,-5,844,1581,10
47879927441,47879927439,-2,1370,2504,10
47883546782,47883546779,-3,1368,2002,10
47884847124,47884847141,17,1400,2004,10
47887692498,47887692496,-2,1279,1561,10
47888278421,47888278419,-2,1386,2219,10
47889218610,47889218607,-3,1575,2749,10
47889961302,47889961301,-1,1275,1916,10
47894078137,47894078136,-1,1686,2490,10
47896516126,47896516125,-1,812,1555,10
47897069945,47897069946,1,1410,1720,10
47897157179,47897157178,-1,1027,1626,10
47899257233,47899257233,0,1192,2133,10
47903130334,47903130334,0,1401,1465,10
47903218215,47903218192,-23,2515,1728,10
47903766032,47903766026,-6,1929,5400,10
47907096257,47907096255,-2,1108,2451,10
47907427933,47907427931,-2,883,2350,10
47909859183,47909859181,-2,1099,1989,10
47918733783,47918733783,0,1721,1986,10
47919020926,47919020924,-2,1100,1937,10
47921655794,47921655792,-2,888,1931,10
47922063123,47922063122,-1,899,1423,10
47923552328,47923552327,-1,1313,2642,10
47927437753,47927437751,-2,1092,1918,10
47927487620,47927487618,-2,1703,1777,10
47932193202,47932193202,0,1069,1887,10
47936317246,47936317246,0,1080,1178,10
47937965735,47937965730,-5,1131,1999,10
47938535614,47938535613,-1,1194,2065,10
47943633303,47943633305,2,844,1409,10
47946285131,47946285130,-1,981,2043,10
47947323225,47947323225,0,1831,1329,10
47947651869,47947651867,-2,1271,2192,10
47949205533,47949205531,-2,1420,2251,10
47950358449,47950358449,0,1255,2441,10
47952926110,47952926115,5,1729,1281,10
47954068655,47954068653,-2,1152,2510,10
47954903697,47954903697,0,991,1940,10
47956426344,47956426341,-3,1333,2192,10
47958137109,47958137105,-4,808,1752,10
47958771713,47958771712,-1,1339,1836,10
47959707253,47959707250,-3,1275,2501,10
47962862657,47962862663,6,1241,482,10
47972406914,47972406914,0,947,2093,10
47973730374,47973730372,-2,1385,2085,10
47973801440,47973801437,-3,1374,2174,10
47977377177,47977377174,-3,723,2186,10
47980067042,47980067039,-3,719,1867,10
47980548027,47980548046,19,728,1892,10
47982799852,47982799851,-1,1441,2206,10
47984522258,47984522258,0,1578,1598,10
47985432882,47985432879,-3,842,1688,10
47987732898,47987732897,-1,930,2061,10
47987928969,47987928968,-1,1166,1540,10
47991759246,47991759244,-2,1431,1762,10
47992845566,47992845566,0,546,1158,10
47996512465,47996512464,-1,2166,4896,10
47998085110,47998085106,-4,1180,3139,10
47999094553,47999094552,-1,759,2313,10
48001096842,48001096842,0,1217,1830,10
48003583871,48003583866,-5,1068,1695,10
48003778495,48003778494,-1,1175,1675,10
48005149077,48005149083,6,8974,3375,10
48005234527,48005234528,1,1682,2208,10
48006342717,48006342715,-2,1460,2447,10
48008787774,48008787773,-1,1619,1964,10
48009566005,48009566002,-3,1493,2078,10
48011260128,48011260128,0,1184,1830,10
48012007613,48012007613,0,1318,1970,10
48013638166,48013638165,-1,956,2230,10
48016689371,48016689369,-2,1174,1992,10
48019319175,48019319174,-1,1126,1707,10
48024698676,48024698672,-4,1094,1745,10
48024956037,48024956035,-2,1230,1920,10
48025266782,48025266787,5,3155,1229,10
48026187703,48026187702,-1,935,2166,10
48026240234,48026240253,19,767,1326,10
48027508609,48027508607,-2,1504,2639,10
48027575356,48027575371,15,273,1451,10
48030987718,48030987716,-2,913,1660,10
48036450338,48036450337,-1,1059,1852,10
48036851976,48036851998,22,410,963,10
48038460931,48038460930,-1,1169,1874,10
48042360355,48042360358,3,2288,2590,10
48043950650,48043950647,-3,1339,2196,10
48044613539,48044613539,0,795,1283,10
48044905931,48044905941,10,340,772,10
48045528982,48045528985,3,1495,1614,10
48050482696,48050482694,-2,1239,2508,10
48053604439,48053604441,2,1408,2459,10
48058325367,48058325366,-1,1168,2330,10
48059076437,48059076437,0,961,2608,10
48061803945,48061803946,1,1455,2488,10
48064669605,48064669602,-3,2020,3784,10
48068480249,48068480253,4,3851,2798,10
48069066210,48069066210,0,1350,1910,10
48069378381,48069378383,2,2812,2529,10
48069534250,48069534249,-1,875,1414,10
48071357880,48071357882,2,1672,1263,10
48074175998,48074175999,1,1615,1976,10
48075254282,48075254282,0,3214,3943,10
48075981289,48075981286,-3,1848,3280,10
48077928623,48077928626,3,1017,1695,10
48079135289,48079135289,0,1220,1514,10
48080383362,48080383361,-1,1001,2089,10
48081032613,48081032614,1,1642,2024,10
48081748879,48081748885,6,2512,1110,10
48082483407,48082483410,3,1596,1693,10
48094740018,48094740018,0,1572,1865,10
48097511927,48097511927,0,1206,1736,10
48099402850,48099402854,4,1210,1101,10
48100604551,48100604550,-1,2351,2890,10
48102881719,48102881714,-5,1459,1872,10
48104298317,48104298315,-2,883,2159,10
48105548687,48105548686,-1,931,1973,10
48107264450,48107264448,-2,1167,2537,10
48109581562,48109581562,0,1165,1847,10
48111498930,48111498929,-1,1277,2123,10
48123618164,48123618164,0,1455,2342,10
48124011741,48124011740,-1,1297,2939,10
48125432685,48125432682,-3,1330,3079,10
48126506723,48126506721,-2,1670,2872,10
48129084189,48129084187,-2,1169,2234,10
48129782504,48129782500,-4,1457,2194,10
48134941865,48134941867,2,1283,1267,10
48137555887,48137555886,-1,967,2553,10
48147583968,48147583966,-2,1065,2922,10
48148966945,48148966942,-3,1315,2998,10
48149048572,48149048572,0,1708,2434,10
48151082680,48151082682,2,1477,2496,10
48157283454,48157283453,-1,1119,1833,10
48157432573,48157432570,-3,1351,1957,10
48157549853,48157549851,-2,1606,1836,10
48157626626,48157626625,-1,1444,1780,10
48159334164,48159334186,22,1698,1760,10
48161651363,48161651365,2,948,1862,10
48166390566,48166390562,-4,1651,2291,10
48167320946,48167320945,-1,1257,1723,10
48170969351,48170969350,-1,1592,1836,10
48175777330,48175777330,0,1754,2232,10
48181573118,48181573115,-3,1478,1963,10
48183337643,48183337638,-5,1202,1825,10
48183835280,48183835301,21,1229,2512,10
48185695023,48185695022,-1,1129,2089,10
48192140366,48192140365,-1,1325,1914,10
48196866720,48196866719,-1,1130,1836,10
48197260831,48197260829,-2,1394,1908,10
48200544982,48200544980,-2,1270,1693,10
48208672459,48208672457,-2,1401,2123,10
48218430492,48218430491,-1,1785,2278,10
48220557045,48220557042,-3,1072,1889,10
48227913438,48227913438,0,944,1744,10
48230559989,48230559987,-2,1405,1795,10
48233579197,48233579198,1,1137,2044,10
48236336930,48236336930,0,1179,2141,10
48241851425,48241851422,-3,18692,15700,10
48242142597,48242142606,9,12160,22586,10
48247129553,48247129551,-2,900,2296,10
48248019654,48248019653,-1,20902,35064,10
48251636603,48251636602,-1,1426,1450,10
48252351773,48252351773,0,1018,1325,10
48254481031,48254481027,-4,935,2187,10
48255910615,48255910622,7,3622,1150,10
48257107897,48257107898,1,867,2116,10
48258684970,48258684965,-5,2209,6085,10
48265119470,48265119470,0,1964,2028,10
48266250774,48266250770,-4,1000,1668,10
48266964075,48266964054,-21,1072,2463,10
48267664874,48267664874,0,1272,2326,10
48269949157,48269949157,0,1235,1663,10
48272357903,48272357902,-1,965,2714,10
48273218351,48273218350,-1,1209,1780,10
48274417943,48274417945,2,44058,53007,10
48274876714,48274876721,7,2786,1169,10
48275414991,48275414990,-1,1260,1827,10
48276525298,48276525298,0,1030,1511,10
48276924305,48276924310,5,2302,1520,10
48279694358,48279694357,-1,1405,2113,10
48281289382,48281289381,-1,1069,2001,10
48285534486,48285534485,-1,1499,2359,10
48295698838,48295698838,0,1551,2842,10
48297975225,48297975222,-3,1028,1792,10
48300069010,48300069009,-1,1302,1903,10
48303916303,48303916302,-1,588,1193,10
48304343869,48304343869,0,1636,1619,10
48306342954,48306342953,-1,1382,2148,10
48309073783,48309073783,0,1097,1009,10
48310199933,48310199934,1,1429,2694,10
48311640921,48311640920,-1,1513,1962,10
48312941251,48312941249,-2,1363,2970,10
48314066037,48314066058,21,1265,1095,10
48317751423,48317751423,0,1303,1432,10
48319292070,48319292069,-1,818,1083,10
48320567999,48320567997,-2,781,1232,10
48324947803,48324947801,-2,1514,2604,10
48329010132,48329010130,-2,1121,1847,10
48334841702,48334841701,-1,1134,1078,10
48335874921,48335874921,0,1504,2059,10
48342074687,48342074689,2,881,950,10
48348673471,48348673470,-1,1284,2533,10
48348892295,48348892294,-1,999,2140,10
48354988695,48354988698,3,1561,1194,10
48355035975,48355035953,-22,1470,2142,10
48355097143,48355097142,-1,1356,3052,10
48361523930,48361523928,-2,1201,1638,10
48361982041,48361982043,2,27695,27461,10
48366090925,48366090925,0,1327,1667,10
48366550651,48366550648,-3,700,1693,10
48366960118,48366960115,-3,1250,2683,10
48370063899,48370063906,7,4055,1249,10
48370650577,48370650574,-3,1754,2227,10
48374185250,48374185247,-3,1298,2016,10
48375342294,48375342291,-3,648,1932,10
48378644494,48378644494,0,1503,1724,10
48380330770,48380330767,-3,1331,2835,10
48380932915,48380932914,-1,1324,2695,10
48381428394,48381428415,21,300,895,10
48382525882,48382525882,0,1346,1855,10
48383388691,48383388690,-1,1092,2014,10
48383646399,48383646399,0,1262,2674,10
48384962008,48384962007,-1,1367,1944,10
48396460628,48396460627,-1,1512,2518,10
48397809693,48397809690,-3,997,1790,10
48398568607,48398568606,-1,1002,1981,10
48399499252,48399499250,-2,1678,2672,10
48399788273,48399788273,0,1787,1886,10
48401955685,48401955683,-2,1716,2381,10
48402895739,48402895733,-6,1415,6996,10
48410683417,48410683414,-3,1985,2835,10
48412844543,48412844542,-1,1987,3234,10
48414599268,48414599265,-3,1387,2548,10
48414964427,48414964406,-21,756,1382,10
48420279241,48420279242,1,1124,2132,10
48425918554,48425918553,-1,1953,1706,10
48425976362,48425976359,-3,1015,2177,10
48429406676,48429406677,1,1838,2232,10
48430027507,48430027506,-1,1416,1910,10
48430088490,48430088478,-12,1141,1801,10
48434268830,48434268829,-1,479,1401,10
48436822223,48436822221,-2,1563,2669,10
48437401660,48437401658,-2,1556,2779,10
48441557862,48441557863,1,1219,1296,10
48441938210,48441938207,-3,1096,2751,10
48444222326,48444222326,0,1302,1943,10
48447465302,48447465302,0,1067,2196,10
48449951669,48449951667,-2,1328,2804,10
48459232771,48459232772,1,1657,1580,10
48462794235,48462794232,-3,802,1967,10
48465800174,48465800173,-1,1159,2261,10
48467500937,48467500935,-2,1319,2720,10
48468167722,48468167721,-1,1357,1638,10
48474415706,48474415710,4,2139,1013,10
48475811073,48475811072,-1,1211,2082,10
48479979998,48479979995,-3,1202,2296,10
48480231873,48480231861,-12,875,1785,10
48480649241,48480649240,-1,1421,1922,10
48490700431,48490700430,-1,1005,2001,10
48492866122,48492866118,-4,1366,2508,10
48493675042,48493675050,8,31493,57285,10
48494228514,48494228493,-21,1176,2405,10
48494956767,48494956765,-2,972,2732,10
48495287989,48495287986,-3,1329,1834,10
48496014633,48496014633,0,1025,2224,10
48496161662,48496161662,0,1687,1709,10
48499996546,48499996546,0,918,1789,10
48501190179,48501190180,1,1347,1863,10
48504525745,48504525745,0,787,1916,10
48505505498,48505505502,4,181,826,10
48510444565,48510444564,-1,975,1837,10
48512668638,48512668638,0,685,1914,10
48515792803,48515792801,-2,1383,2315,10
48516361066,48516361062,-4,1110,2569,10
48519198943,48519198941,-2,893,1389,10
48519798179,48519798177,-2,1697,1946,10
48524072803,48524072802,-1,718,1299,10
48524567863,48524567862,-1,678,1242,10
48528012427,48528012426,-1,1265,1989,10
48528798785,48528798782,-3,1699,2301,10
48530661110,48530661113,3,368,751,10
48534292650,48534292648,-2,1057,1499,10
48535981908,48535981906,-2,980,1490,10
48536472658,48536472653,-5,1288,2151,10
48539844484,48539844481,-3,1378,1925,10
48539877425,48539877424,-1,1776,2723,10
48539938485,48539938484,-1,1594,1748,10
48540671870,48540671870,0,1172,1776,10
48542103229,48542103222,-7,1459,2791,10
48547858642,48547858642,0,1336,1738,10
48550311905,48550311902,-3,1367,2266,10
48551650674,48551650671,-3,1372,1831,10
48551852718,48551852719,1,1540,1544,10
48552876504,48552876502,-2,1014,1645,10
48553907059,48553907058,-1,1081,2394,10
48554675255,48554675253,-2,1298,1913,10
48555359364,48555359369,5,30295,16680,10
48556207486,48556207484,-2,1172,1648,10
48557234467,48557234465,-2,953,2005,10
48563185352,48563185351,-1,1271,1738,10
48564294690,48564294690,0,1146,1562,10
48566454790,48566454787,-3,1006,1680,10
48567380314,48567380311,-3,1168,1441,10
48570203717,48570203713,-4,1400,3318,10
48572836646,48572836646,0,1320,2207,10
48574563525,48574563520,-5,3750,9768,10
48575801678,48575801675,-3,1418,2352,10
48577232160,48577232159,-1,1122,2424,10
48578809674,48578809673,-1,1140,1728,10
48582013884,48582013881,-3,1270,1789,10
48582776804,48582776802,-2,1310,1886,10
48584572453,48584572450,-3,1284,1745,10
48587373956,48587373954,-2,1257,2459,10
48591191906,48591191901,-5,1430,5858,10
48592621759,48592621758,-1,846,1665,10
48594655742,48594655741,-1,1154,1534,10
48599444355,48599444349,-6,1621,2422,10
48599959926,48599959925,-1,676,1404,10
48601364318,48601364317,-1,965,2314,10
48602385075,48602385074,-1,1110,1896,10
48606724486,48606724486,0,1263,1367,10
48607430205,48607430205,0,1237,1901,10
48612512231,48612512231,0,751,587,10
48615068898,48615068899,1,1728,2106,10
48617683911,48617683909,-2,1173,1828,10
48620335121,48620335122,1,1197,1979,10
48622023451,48622023449,-2,885,2265,10
48624290813,48624290813,0,878,1234,10
48624595183,48624595182,-1,1189,2417,10
48627584837,48627584831,-6,984,4595,10
48631131910,48631131908,-2,1097,1574,10
48633398325,48633398325,0,922,1856,10
48635347834,48635347834,0,1809,2483,10
48638517042,48638517041,-1,1186,1906,10
48639786988,48639786987,-1,2450,3574,10
48641924546,48641924545,-1,999,1873,10
48643179836,48643179835,-1,1437,2223,10
48646278939,48646278937,-2,935,2290,10
48646751367,48646751360,-7,1458,8760,10
48651389367,48651389366,-1,867,1548,10
48653129483,48653129482,-1,1408,1331,10
48654713942,48654713941,-1,1245,2132,10
48656009370,48656009357,-13,1255,1681,10
48659601804,48659601803,-1,1575,2432,10
48662956591,48662956587,-4,1040,2720,10
48666802714,48666802714,0,752,1304,10
48667533460,48667533459,-1,1142,1840,10
48667904529,48667904526,-3,1057,2014,10
48668557247,48668557246,-1,1190,1637,10
48669233924,48669233925,1,1869,1531,10
48672289314,48672289313,-1,878,1215,10
48673233115,48673233115,0,1291,1598,10
48674448700,48674448698,-2,1562,2538,10
48675457946,48675457945,-1,1148,1728,10
48676694232,48676694223,-9,1202,1871,10
48679829693,48679829693,0,1266,1400,10
48680493418,48680493415,-3,1261,1998,10
48681340501,48681340502,1,936,1296,10
48681496474,48681496482,8,398,1228,10
48681636647,48681636647,0,786,1049,10
48682370485,48682370484,-1,1111,1586,10
48682437141,48682437138,-3,1151,1921,10
48686923291,48686923290,-1,1506,2183,10
48690368818,48690368816,-2,1688,2090,10
48690427668,48690427666,-2,1399,1877,10
48690993114,48690993111,-3,1103,1627,10
48692493555,48692493555,0,1595,2151,10
48694879502,48694879501,-1,1028,2086,10
48697191304,48697191301,-3,1136,2093,10
48698246926,48698246924,-2,1605,2058,10
48705352909,48705352909,0,1527,1738,10
48712098634,48712098634,0,1164,1884,10
48714865748,48714865746,-2,1170,2058,10
48719484406,48719484403,-3,1482,2276,10
48721055634,48721055631,-3,1305,2703,10
48724464622,48724464622,0,1216,2166,10
48726254733,48726254731,-2,1302,2803,10
48726812955,48726812956,1,1578,1934,10
48734032107,48734032106,-1,870,1290,10
48734365874,48734365891,17,259,801,10
48739201069,48739201068,-1,1671,2376,10
48740093542,48740093541,-1,1060,1639,10
48741256400,48741256398,-2,1241,2575,10
48745836169,48745836167,-2,1790,2099,10
48747140491,48747140490,-1,1067,2132,10
48747587971,48747587959,-12,247,814,10
48751613329,48751613335,6,14585,8087,10
48751743809,48751743808,-1,937,1725,10
48753220506,48753220505,-1,1157,1344,10
48755671666,48755671664,-2,1257,1668,10
48758031849,48758031849,0,2966,3706,10
48758974054,48758974051,-3,1153,3053,10
48759921936,48759921934,-2,1217,2311,10
48762170130,48762170127,-3,1110,2002,10
48768838357,48768838356,-1,1368,1441,10
48774651818,48774651819,1,1840,1952,10
48781036518,48781036515,-3,1868,2517,10
48783443817,48783443817,0,1105,2488,10
48784167165,48784167163,-2,1131,1827,10
48786728081,48786728081,0,1220,1885,10
48793060330,48793060328,-2,1109,2681,10
48793615330,48793615346,16,285,578,10
48795385066,48795385065,-1,1151,1278,10
48797223255,48797223258,3,1507,1969,10
48802052649,48802052649,0,1290,2473,10
48803520817,48803520809,-8,769,1042,10
48804463126,48804463125,-1,1306,2065,10
48805013626,48805013623,-3,744,1593,10
48806481794,48806481793,-1,1171,1895,10
48814068617,48814068612,-5,1050,3541,10
48819307383,48819307382,-1,1146,2446,10
48819705464,48819705462,-2,340,1288,10
48819984213,48819984210,-3,1234,2045,10
48821682265,48821682265,0,1074,1613,10
48825423683,48825423687,4,1315,1015,10
48826746688,48826746685,-3,1232,1748,10
48826965182,48826965182,0,1192,2385,10
48831661470,48831661471,1,1597,1504,10
48833671720,48833671717,-3,813,1354,10
48834114202,48834114201,-1,1306,2280,10
48839572964,48839572962,-2,1294,2301,10
48841523961,48841523962,1,949,1853,10
48842177263,48842177257,-6,3241,12552,10
48843992886,48843992886,0,1248,1314,10
48845166798,48845166803,5,2703,1470,10
48846172001,48846172001,0,1373,2161,10
48848263269,48848263267,-2,876,1700,10
48852955022,48852955018,-4,1265,1550,10
48853129232,48853129237,5,3789,2519,10
48853323147,48853323149,2,1349,2218,10
48854580538,48854580537,-1,1144,1844,10
48855166451,48855166433,-18,1141,1563,10
48858137581,48858137582,1,1475,2254,10
48861135575,48861135572,-3,933,1739,10
48862062185,48862062184,-1,989,1526,10
48865428521,48865428526,5,2404,1037,10
48866093317,48866093319,2,1661,1881,10
48867360511,48867360511,0,1066,1924,10
48867575924,48867575921,-3,1445,2052,10
48867822263,48867822261,-2,979,1630,10
48868511655,48868511653,-2,818,1602,10
48869957449,48869957449,0,1395,1956,10
48870067910,48870067908,-2,1261,1736,10
48871232410,48871232392,-18,1298,1820,10
48871623734,48871623731,-3,1522,2251,10
48874988698,48874988698,0,1022,1117,10
48876859658,48876859656,-2,1350,2079,10
48879636314,48879636313,-1,1357,1873,10
48885168069,48885168067,-2,1106,2367,10
48890942724,48890942723,-1,1790,2148,10
48892724021,48892724018,-3,1400,1653,10
48893727794,48893727801,7,3529,1766,10
48895343409,48895343431,22,825,2046,10
48896621734,48896621732,-2,1033,2127,10
48902821302,48902821298,-4,1200,2843,10
48905504082,48905504081,-1,1467,2326,10
48906516789,48906516794,5,3655,1367,10
48907843025,48907843022,-3,1492,2617,10
48908799650,48908799649,-1,1323,2470,10
48910941581,48910941589,8,4922,1343,10
48914597393,48914597392,-1,1276,2116,10
48916691275,48916691278,3,1566,1152,10
48923259579,48923259578,-1,1388,2235,10
48933976282,48933976283,1,1037,1369,10
48934773970,48934773968,-2,1877,3777,10
48936137506,48936137506,0,13865,16326,10
48937766542,48937766541,-1,1151,1640,10
48938881231,48938881229,-2,1309,2169,10
48939665348,48939665347,-1,1575,1891,10
48945415583,48945415582,-1,409,1100,10
48949836849,48949836849,0,960,1781,10
48951211380,48951211379,-1,1162,1620,10
48951348082,48951348082,0,681,1902,10
48952080650,48952080646,-4,1480,2388,10
48955791776,48955791761,-15,1261,1961,10
48956260903,48956260902,-1,1558,2115,10
48956736817,48956736817,0,1491,1930,10
48958011685,48958011684,-1,1698,2693,10
48958969552,48958969569,17,341,907,10
48964079321,48964079321,0,1121,1436,10
48964693073,48964693074,1,982,1058,10
48968115414,48968115414,0,1348,1304,10
48969125086,48969125085,-1,1461,2295,10
48969679094,48969679093,-1,1622,2961,10
48971515282,48971515281,-1,1143,1558,10
48981848143,48981848139,-4,1312,2348,10
48988147262,48988147269,7,9068,4813,10
48988935127,48988935127,0,1176,1930,10
48994423642,48994423642,0,1987,1609,10
48995959038,48995959035,-3,1864,3226,10
48996605875,48996605874,-1,1102,1746,10
48998733175,48998733173,-2,1170,1450,10
48998850220,48998850230,10,111,1734,10
48999094865,48999094863,-2,1150,2093,10
48999953371,48999953390,19,1091,1847,10
49001939717,49001939714,-3,1040,1767,10
49005670486,49005670483,-3,825,1641,10
49005849496,49005849494,-2,1087,1537,10
49005891428,49005891441,13,130,825,10
49007093226,49007093226,0,996,1361,10
49008269059,49008269057,-2,1195,1790,10
49016234254,49016234251,-3,1613,2346,10
49019735233,49019735233,0,1191,1895,10
49021009794,49021009793,-1,1526,1639,10
49021779058,49021779058,0,810,1759,10
49027616410,49027616410,0,943,1589,10
49030611434,49030611430,-4,1480,2518,10
49032855822,49032855818,-4,1314,1598,10
49033320493,49033320492,-1,1264,2096,10
49034630003,49034630004,1,1780,1449,10
49038783218,49038783214,-4,1255,2167,10
49040094571,49040094569,-2,1505,2279,10
49040239153,49040239152,-1,1389,1520,10
49045589425,49045589422,-3,1404,2541,10
49054643650,49054643650,0,1338,3003,10
49057073459,49057073457,-2,1433,1735,10
49057799004,49057799002,-2,1360,2777,10
49062190807,49062190806,-1,1345,2017,10
49065878133,49065878132,-1,1060,1903,10
49066012228,49066012228,0,834,997,10
49068603962,49068603966,4,3055,1744,10
49071625152,49071625151,-1,891,2376,10
49072062994,49072062994,0,918,1859,10
49073276751,49073276751,0,1516,1588,10
49074169205,49074169203,-2,2609,4458,10
49077140757,49077140754,-3,1542,2230,10
49078204910,49078204916,6,5483,2133,10
49080313485,49080313485,0,1035,2030,10
49081658585,49081658583,-2,1351,1878,10
49085517849,49085517842,-7,1225,2800,10
49093822597,49093822594,-3,2016,2807,10
49098621950,49098621949,-1,1363,2231,10
49101229459,49101229456,-3,1463,2962,10
49101583609,49101583608,-1,1321,1221,10
49105509597,49105509593,-4,1533,1932,10
49106240427,49106240426,-1,1382,1629,10
49111302674,49111302674,0,999,1813,10
49111441033,49111441033,0,812,1670,10
49112345882,49112345883,1,1100,1215,10
49113492671,49113492666,-5,1233,2342,10
49114181868,49114181866,-2,1336,2303,10
49115512451,49115512449,-2,1181,1831,10
49116465851,49116465848,-3,1338,2148,10
49120726206,49120726205,-1,965,1888,10
49121593763,49121593767,4,4381,2164,10
49131098446,49131098443,-3,1337,1600,10
49134965598,49134965597,-1,1152,1599,10
49135694594,49135694593,-1,334,882,10
49141854563,49141854561,-2,1250,2016,10
49142735124,49142735119,-5,1172,2564,10
49149381106,49149381109,3,3757,3038,10
49151763095,49151763095,0,1524,1668,10
49152966901,49152966899,-2,1443,2690,10
49154801134,49154801134,0,1050,1878,10
49155062481,49155062478,-3,1541,1872,10
49155601394,49155601395,1,1020,1579,10
49158493667,49158493666,-1,1224,2064,10
49159056957,49159056954,-3,1371,2904,10
49164730190,49164730191,1,1057,1363,10
49170711681,49170711676,-5,722,1727,10
49171122969,49171122953,-16,1315,1684,10
49171388835,49171388833,-2,1325,2667,10
49171558852,49171558854,2,1233,1449,10
49172847745,49172847742,-3,1163,1899,10
49177268752,49177268750,-2,1187,2210,10
49178020783,49178020783,0,1454,1499,10
49179371323,49179371321,-2,1223,1758,10
49183294389,49183294387,-2,1019,1937,10
49185513415,49185513413,-2,1156,1920,10
49186094884,49186094884,0,1836,1428,10
49189927458,49189927455,-3,1008,2089,10
49193322678,49193322677,-1,1267,2292,10
49193461334,49193461333,-1,1405,1939,10
49193822457,49193822457,0,1209,1713,10
49195035894,49195035894,0,2927,3219,10
49203782146,49203782145,-1,1383,1797,10
49206324653,49206324651,-2,1198,2279,10
49207705786,49207705785,-1,1432,2158,10
49208607590,49208607588,-2,1439,2057,10
49209775258,49209775258,0,1512,2296,10
49210763639,49210763637,-2,1165,1560,10
49213434751,49213434746,-5,2626,7720,10
49214937302,49214937301,-1,819,1722,10
49215616139,49215616138,-1,1264,1688,10
49216885922,49216885919,-3,1259,2175,10
49218780595,49218780593,-2,1369,2309,10
49220961231,49220961230,-1,805,996,10
49222271899,49222271898,-1,1308,1888,10
49226108206,49226108207,1,1164,2776,10
49230954790,49230954789,-1,1311,2531,10
49232767309,49232767307,-2,1098,1646,10
49232818647,49232818645,-2,1039,1912,10
49232896716,49232896729,13,289,752,10
49235215279,49235215282,3,2118,1848,10
49236889014,49236889011,-3,1472,2096,10
49238308578,49238308576,-2,1088,2066,10
49238373018,49238373010,-8,1667,5541,10
49239924449,49239924471,22,1214,2509,10
49241568527,49241568527,0,1284,1516,10
49242391985,49242391982,-3,1825,2602,10
49242575250,49242575249,-1,1100,2553,10
49249028010,49249028010,0,928,1620,10
49252835019,49252835018,-1,1085,1549,10
49254626604,49254626602,-2,1207,2374,10
49255681394,49255681393,-1,1065,2345,10
49256118697,49256118715,18,1193,1795,10
49256255249,49256255247,-2,1149,1220,10
49261333857,49261333853,-4,1388,4163,10
49261879613,49261879611,-2,1066,1990,10
49262727594,49262727594,0,1407,1618,10
49270925657,49270925657,0,1493,2033,10
49273308468,49273308452,-16,229,527,10
49274986269,49274986268,-1,875,2056,10
49275147523,49275147500,-23,1065,1258,10
49278409112,49278409110,-2,1420,1505,10
49279977374,49279977376,2,1202,1386,10
49283653167,49283653167,0,24513,24283,10
49283852502,49283852501,-1,1280,2511,10
49283964389,49283964388,-1,1229,1870,10
49287394423,49287394426,3,2771,3242,10
49302222435,49302222433,-2,1136,1834,10
49302270758,49302270754,-4,1001,1606,10
49302646408,49302646406,-2,1426,2288,10
49306718064,49306718070,6,5839,2710,10
49310566282,49310566281,-1,980,1930,10
49311876540,49311876539,-1,1377,1713,10
49314978503,49314978503,0,1101,1350,10
49316826039,49316826036,-3,1276,2064,10
49316944884,49316944881,-3,1673,2559,10
49317311293,49317311292,-1,1690,2681,10
49320764047,49320764045,-2,1314,2031,10
49321650161,49321650161,0,812,1188,10
49323550353,49323550354,1,1608,1594,10
49325835650,49325835646,-4,788,2138,10
49329353669,49329353666,-3,1387,2141,10
49330265035,49330265035,0,1578,2169,10
49333071576,49333071580,4,30581,32016,10
49333492242,49333492238,-4,1219,1832,10
49334383897,49334383896,-1,1109,1399,10
49335806667,49335806666,-1,1767,2570,10
49336554018,49336554016,-2,1332,2275,10
49339272055,49339272050,-5,1239,6277,10
49345420492,49345420493,1,5227,21629,10
49347416665,49347416661,-4,870,2351,10
49347931545,49347931543,-2,1507,2533,10
49348894875,49348894873,-2,1286,3215,10
49352405924,49352405921,-3,1380,3200,10
49356886258,49356886257,-1,1104,2385,10
49357135942,49357135941,-1,1335,2264,10
49359174969,49359174969,0,2141,2285,10
49360183090,49360183110,20,1155,2108,10
49362204058,49362204058,0,1073,1970,10
49363860809,49363860813,4,13620,8237,10
49365115918,49365115917,-1,1296,1943,10
49366544881,49366544882,1,1205,1491,10
49369025831,49369025830,-1,907,992,10
49369344190,49369344189,-1,1658,2978,10
49371345601,49371345599,-2,1392,2531,10
49371891082,49371891082,0,1045,1258,10
49377120482,49377120481,-1,1427,2066,10
49378138457,49378138458,1,1264,1407,10
49378858955,49378858954,-1,1565,2099,10
49380866540,49380866538,-2,1960,2744,10
49381565794,49381565794,0,1053,1452,10
49383879037,49383879035,-2,1505,2132,10
49384292894,49384292892,-2,1214,2214,10
49387505483,49387505482,-1,884,1989,10
49390813477,49390813476,-1,1588,2465,10
49391202457,49391202463,6,2872,1736,10
49391737314,49391737314,0,1041,1930,10
49394539811,49394539809,-2,1573,2201,10
49401874158,49401874156,-2,1488,1591,10
49407135401,49407135404,3,1464,967,10
49408854642,49408854639,-3,840,2009,10
49409891670,49409891664,-6,1284,2113,10
49420730053,49420730054,1,3068,2391,10
49424067201,49424067201,0,1209,947,10
49424228747,49424228766,19,176,1123,10
49425274253,49425274249,-4,2210,4370,10
49430573479,49430573481,2,1437,1429,10
49433816358,49433816358,0,1755,1974,10
49440827975,49440827974,-1,1618,2319,10
49442257766,49442257764,-2,1228,1762,10
49447746006,49447746002,-4,787,1875,10
49452657250,49452657249,-1,1008,2129,10
49453024346,49453024346,0,1127,1794,10
49454409118,49454409110,-8,1762,8434,10
49454887402,49454887402,0,1332,1803,10
49460375561,49460375561,0,1277,1643,10
49461966863,49461966867,4,970,893,10
49462729366,49462729366,0,920,1010,10
49463183333,49463183331,-2,1326,1801,10
49464271691,49464271691,0,1537,2838,10
49464609722,49464609718,-4,1018,2887,10
49466020838,49466020835,-3,1324,1407,10
49466217745,49466217742,-3,1245,2276,10
49467735986,49467735982,-4,1085,1573,10
49474083949,49474083948,-1,1722,2523,10
49474167339,49474167339,0,1022,1391,10
49477198732,49477198731,-1,1112,2443,10
49479761415,49479761414,-1,1522,2223,10
49480817278,49480817277,-1,1237,2491,10
49481119351,49481119347,-4,1440,4234,10
49483458470,49483458469,-1,1157,1567,10
49484305542,49484305534,-8,877,4260,10
49485364771,49485364770,-1,957,1940,10
49485889830,49485889830,0,1545,1939,10
49487262193,49487262191,-2,1640,2251,10
49489949827,49489949826,-1,954,2047,10
49490421450,49490421450,0,1045,1761,10
49490721370,49490721367,-3,1128,2485,10
49491129789,49491129787,-2,1478,2742,10
49494608121,49494608125,4,2279,1385,10
49496977226,49496977229,3,1570,1879,10
49497568378,49497568377,-1,1157,1527,10
49497814114,49497814114,0,1204,2290,10
49502444290,49502444294,4,4052,2414,10
49503000969,49503000969,0,1192,1235,10
49513316601,49513316599,-2,1577,1579,10
49518571153,49518571153,0,1105,1652,10
49523522111,49523522108,-3,870,1220,10
49524069798,49524069802,4,1063,1494,10
49525337507,49525337507,0,1040,1320,10
49526245674,49526245673,-1,1035,2555,10
49526666756,49526666763,7,164,791,10
49534244133,49534244130,-3,1355,2880,10
49539342574,49539342574,0,933,2456,10
49539615994,49539615993,-1,976,1882,10
49541300199,49541300192,-7,17093,55908,10
49550274918,49550274918,0,1717,2014,10
49551230367,49551230366,-1,1322,2957,10
49552808154,49552808153,-1,1293,2958,10
49554989771,49554989771,0,1783,2280,10
49556511249,49556511248,-1,917,2046,10
49559485227,49559485234,7,2786,957,10
49560481199,49560481197,-2,1328,2107,10
49560642315,49560642314,-1,1474,1798,10
49561025582,49561025578,-4,1176,3140,10
49567591937,49567591933,-4,1041,1541,10
49569390187,49569390186,-1,1349,2443,10
49574635903,49574635903,0,1429,2225,10
49576664393,49576664391,-2,1656,2290,10
49576706198,49576706195,-3,1085,1993,10
49578242969,49578242967,-2,1260,1913,10
49579827363,49579827361,-2,1182,2258,10
49584138608,49584138607,-1,1213,1758,10
49588490966,49588490966,0,867,1632,10
49589270151,49589270149,-2,1343,2117,10
49589535358,49589535359,1,1549,2431,10
49589872003,49589872002,-1,1452,1774,10
49590027348,49590027348,0,1192,2150,10
49590548621,49590548621,0,1535,2465,10
49592003338,49592003337,-1,1020,1641,10
49595974629,49595974628,-1,686,882,10
49596484610,49596484609,-1,979,1812,10
49596595665,49596595665,0,1143,1862,10
49597733019,49597733018,-1,1496,1950,10
49598840453,49598840452,-1,1230,1884,10
49603280447,49603280446,-1,886,1994,10
49607023041,49607023037,-4,948,1876,10
49607632704,49607632702,-2,1845,2236,10
49613738159,49613738153,-6,1342,4380,10
49614997439,49614997437,-2,1215,1470,10
49615378350,49615378350,0,790,1286,10
49620767273,49620767270,-3,1605,3071,10
49626017423,49626017421,-2,1347,1349,10
49626637662,49626637658,-4,1259,2313,10
49628369031,49628369029,-2,1315,1879,10
49634578410,49634578410,0,1217,1962,10
49635528697,49635528694,-3,1160,2020,10
49636923551,49636923553,2,1244,1115,10
49640862703,49640862705,2,2135,1495,10
49641979325,49641979321,-4,2137,4371,10
49645475206,49645475206,0,1358,2223,10
49647084916,49647084916,0,1850,2371,10
49648953037,49648953037,0,1321,2216,10
49650436687,49650436687,0,1274,1894,10
49652921501,49652921498,-3,1103,2163,10
49654351153,49654351152,-1,1624,2528,10
49655385878,49655385878,0,3085,3652,10
49655806067,49655806067,0,1131,2025,10
49656223698,49656223698,0,1129,1667,10
49657839162,49657839182,20,1204,1165,10
49658463992,49658463986,-6,1384,4558,10
49658773289,49658773289,0,1341,1128,10
49660032495,49660032498,3,956,1208,10
49660163218,49660163219,1,1109,1800,10
49664197184,49664197184,0,961,1341,10
49666640663,49666640662,-1,1334,1459,10
49666983740,49666983751,11,22,866,10
49668330382,49668330382,0,1375,1668,10
49669681967,49669681971,4,1790,1181,10
49679228194,49679228195,1,1254,1351,10
49683696619,49683696616,-3,788,2060,10
49687988166,49687988165,-1,1046,1995,10
49691148526,49691148523,-3,1139,1775,10
49692332400,49692332406,6,6202,2656,10
49694106354,49694106352,-2,1392,2964,10
49702297365,49702297366,1,1640,1874,10
49704519438,49704519437,-1,2040,2780,10
49708071886,49708071887,1,1267,1936,10
49708236501,49708236500,-1,1353,1818,10
49710827242,49710827240,-2,1223,2512,10
49713801945,49713801944,-1,1113,1446,10
49716655542,49716655541,-1,1335,1160,10
49718880929,49718880929,0,3121,3505,10
49719139030,49719139026,-4,1529,3167,10
49719429178,49719429178,0,2182,3005,10
49720401827,49720401835,8,166,715,10
49720741879,49720741876,-3,879,2105,10
49722456201,49722456199,-2,1166,1613,10
49724489377,49724489376,-1,999,1696,10
49725957546,49725957546,0,1332,1961,10
49730843103,49730843101,-2,1462,2032,10
49731773154,49731773153,-1,874,1643,10
49735384438,49735384438,0,1398,1402,10
49740110626,49740110624,-2,1243,1683,10
49743596145,49743596143,-2,1389,2187,10
49744443968,49744443969,1,1096,1667,10
49748980585,49748980583,-2,1195,1516,10
49750205117,49750205114,-3,1116,2503,10
49751116814,49751116813,-1,1355,2565,10
49752657335,49752657333,-2,1415,1670,10
49753400034,49753400032,-2,1212,1957,10
49755300918,49755300916,-2,769,1368,10
49757091319,49757091318,-1,1283,1958,10
49760649010,49760649010,0,1663,2158,10
49762219231,49762219229,-2,1411,1622,10
49763883333,49763883330,-3,748,1914,10
49764389944,49764389938,-6,1089,1496,10
49768894961,49768894960,-1,1027,1906,10
49772128625,49772128624,-1,1002,2016,10
49773462152,49773462150,-2,1693,2853,10
49776041802,49776041799,-3,1467,2487,10
49776951687,49776951686,-1,1442,2178,10
49780923627,49780923625,-2,1108,2543,10
49781229814,49781229828,14,1195,2600,10
49782193836,49782193859,23,1077,1595,10
49783951727,49783951729,2,2487,2105,10
49783987099,49783987098,-1,986,1807,10
49784479764,49784479762,-2,962,2152,10
49792832446,49792832442,-4,1064,1566,10
49798580706,49798580706,0,1273,2595,10
49798865752,49798865751,-1,29,1222,10
49801122999,49801122997,-2,1146,1616,10
49801477930,49801477929,-1,1142,1882,10
49802271546,49802271545,-1,1326,1743,10
49804628610,49804628608,-2,1431,2185,10
49804762353,49804762353,0,1039,1856,10
49807034048,49807034045,-3,1339,2860,10
49807769282,49807769282,0,856,1736,10
49809343383,49809343381,-2,1048,2136,10
49811734216,49811734212,-4,1036,1774,10
49815678063,49815678061,-2,1584,2517,10
49815838583,49815838582,-1,1385,2450,10
49815964262,49815964257,-5,1524,4259,10
49816089074,49816089073,-1,1234,1688,10
49816882485,49816882482,-3,1463,2209,10
49818149342,49818149338,-4,1239,2141,10
49819712772,49819712770,-2,1313,2113,10
49820910961,49820910960,-1,857,1305,10
49822620999,49822621000,1,1187,1814,10
49825519454,49825519457,3,1741,1790,10
49825901909,49825901906,-3,1257,3070,10
49827526449,49827526446,-3,1432,2245,10
49827743852,49827743851,-1,1788,2318,10
49830210385,49830210384,-1,1581,2403,10
49830439863,49830439862,-1,1098,2042,10
49834051325,49834051326,1,1010,1777,10
49836554082,49836554081,-1,1131,2566,10
49838552074,49838552074,0,1145,1582,10
49843377735,49843377738,3,577,1319,10
49848615142,49848615141,-1,1571,2385,10
49856192247,49856192239,-8,1079,5547,10
49857759803,49857759802,-1,1306,1623,10
49868822251,49868822250,-1,924,1540,10
49876289132,49876289140,8,759,1205,10
49877863303,49877863302,-1,1674,2375,10
49883166465,49883166462,-3,1449,2464,10
49883430174,49883430171,-3,1196,1427,10
49884730962,49884730959,-3,654,1366,10
49889008833,49889008837,4,2732,1407,10
49891223072,49891223072,0,1183,2204,10
49892211565,49892211561,-4,1129,2074,10
49894766542,49894766544,2,1496,1289,10
49896182094,49896182093,-1,1608,1933,10
49898295102,49898295101,-1,1296,2255,10
49899014555,49899014551,-4,1085,2215,10
49903787891,49903787891,0,1742,2068,10
49904762297,49904762296,-1,1042,2210,10
49905790444,49905790450,6,2155,953,10
49906786157,49906786153,-4,964,2617,10
49909501640,49909501638,-2,1428,2375,10
49910114023,49910114022,-1,1009,1648,10
49912357846,49912357843,-3,1076,1691,10
49912907255,49912907253,-2,1304,2070,10
49913019892,49913019892,0,1392,1607,10
49913156442,49913156439,-3,1035,1826,10
49919664661,49919664665,4,1837,1419,10
49922603774,49922603773,-1,1590,2046,10
49925153598,49925153601,3,1355,1622,10
49925881689,49925881686,-3,1419,2662,10
49927949955,49927949949,-6,1664,3536,10
49929029191,49929029190,-1,1484,1688,10
49929408110,49929408105,-5,1760,8950,10
49930147302,49930147301,-1,1327,1924,10
49931031782,49931031782,0,1080,1247,10
49932671235,49932671234,-1,1725,2472,10
49936488722,49936488727,5,2481,803,10
49938193935,49938193935,0,1349,1759,10
49938717403,49938717399,-4,1314,1819,10
49947610795,49947610793,-2,1747,3088,10
49950473642,49950473642,0,1182,1674,10
49953168710,49953168709,-1,1019,1744,10
49953770397,49953770398,1,1312,1675,10
49960114122,49960114126,4,1212,1923,10
49960534654,49960534660,6,1841,1708,10
49965113901,49965113900,-1,1314,1857,10
49966254015,49966254014,-1,1173,2324,10
49967029923,49967029924,1,1109,2027,10
49968510017,49968510014,-3,1474,1823,10
49970934816,49970934814,-2,1098,1986,10
49971017812,49971017806,-6,884,4070,10
49971625285,49971625286,1,1493,1956,10
49972750246,49972750246,0,1761,2157,10
49976378182,49976378182,0,766,1079,10
49978989683,49978989673,-10,36936,14241,10
49979657845,49979657845,0,1187,1866,10
49980956415,49980956421,6,1155,1320,10
49982074225,49982074223,-2,1253,2895,10
49987306727,49987306726,-1,1253,1801,10
49989715234,49989715234,0,1299,1486,10
49990074161,49990074153,-8,2357,9316,10
49991761287,49991761286,-1,907,2158,10
49994672736,49994672735,-1,1312,1357,10
49996810922,49996810921,-1,1312,2316,10
49997162843,49997162850,7,3428,1571,10
49999664370,49999664367,-3,927,1169,10
50003184062,50003184042,-20,1773,918,10
50004050964,50004050961,-3,1654,2619,10
50006040190,50006040193,3,1399,1598,10
50008403415,50008403414,-1,999,2497,10
50008535127,50008535122,-5,1208,3278,10
50012101166,50012101166,0,1374,1595,10
50018995808,50018995806,-2,1864,2916,10
50019591967,50019591975,8,3427,1066,10
50022974419,50022974419,0,1461,2133,10
50025266795,50025266790,-5,24766,13383,10
50025480122,50025480119,-3,1135,2719,10
50025579234,50025579234,0,1079,1706,10
50045447966,50045447966,0,831,1399,10
50051509387,50051509386,-1,1077,1752,10
50056071309,50056071306,-3,1031,1990,10
50058619690,50058619689,-1,1111,2147,10
50059264839,50059264838,-1,1546,2267,10
50062277423,50062277422,-1,1247,1588,10
50066143719,50066143716,-3,938,1760,10
50067041222,50067041219,-3,1063,1013,10
50076697442,50076697438,-4,1365,2030,10
50079217918,50079217916,-2,1497,2826,10
50080353365,50080353363,-2,1050,1232,10
50080931591,50080931594,3,69004,68691,10
50081268626,50081268626,0,1347,2376,10
50081732578,50081732575,-3,1504,2339,10
50092583804,50092583802,-2,1352,2438,10
50093931550,50093931549,-1,1346,2267,10
50095710234,50095710233,-1,1743,2257,10
50102927486,50102927486,0,1079,1565,10
50104157917,50104157898,-19,783,885,10
50105853303,50105853308,5,140,3138,10
50109194695,50109194694,-1,854,1704,10
50110695671,50110695667,-4,1097,2174,10
50114526731,50114526731,0,1629,2516,10
50115251340,50115251339,-1,1226,2030,10
50118495958,50118495955,-3,1008,2132,10
50119770526,50119770524,-2,1245,2080,10
50120064031,50120064026,-5,11389,16072,10
50120822924,50120822923,-1,1674,2215,10
50121107321,50121107318,-3,1209,2505,10
50123877878,50123877874,-4,1165,1524,10
50127248120,50127248118,-2,1034,2254,10
50128076534,50128076533,-1,1335,2444,10
50129074760,50129074758,-2,1062,2008,10
50138774094,50138774092,-2,1318,2476,10
50139296387,50139296385,-2,1566,2502,10
50140232533,50140232531,-2,1191,1559,10
50142421854,50142421859,5,1869,1758,10
50142669938,50142669932,-6,1629,6421,10
50149373427,50149373425,-2,1091,2105,10
50150976298,50150976296,-2,968,1907,10
50151865970,50151865967,-3,1115,1141,10
50152649506,50152649507,1,1629,2034,10
50154583498,50154583498,0,797,1876,10
50158116303,50158116303,0,1397,1668,10
50158417047,50158417046,-1,1031,1984,10
50165858285,50165858282,-3,1530,3349,10
50168418141,50168418143,2,1924,1776,10
50171911899,50171911897,-2,1253,2124,10
50173533050,50173533049,-1,1398,1921,10
50177049774,50177049774,0,1210,1695,10
50177902753,50177902752,-1,1031,2103,10
50178817174,50178817174,0,1284,2443,10
50179742177,50179742171,-6,1642,4405,10
50182636871,50182636869,-2,857,1904,10
50186306011,50186306009,-2,782,1352,10
50190867454,50190867452,-2,853,1623,10
50193197321,50193197322,1,746,1438,10
50194055816,50194055815,-1,1108,1790,10
50195366280,50195366278,-2,1026,1921,10
50197636030,50197636030,0,1380,2265,10
50200126772,50200126770,-2,774,1364,10
50201705404,50201705402,-2,1272,2167,10
50204722676,50204722674,-2,1470,2144,10
50206285695,50206285694,-1,1334,1584,10
50207495119,50207495120,1,1520,1731,10
50209051221,50209051230,9,4741,1435,10
50209267887,50209267872,-15,1394,492,10
50210947191,50210947194,3,1512,1967,10
50216199310,50216199313,3,1197,1656,10
50219278353,50219278351,-2,1041,1894,10
50219331338,50219331338,0,658,1441,10
50220059023,50220059021,-2,1309,2868,10
50224038954,50224038953,-1,1632,2508,10
50224769203,50224769202,-1,911,1211,10
50230230442,50230230442,0,869,1502,10
50230941708,50230941727,19,968,2031,10
50231090271,50231090271,0,1347,1516,10
50231152235,50231152237,2,1703,1754,10
50231266227,50231266222,-5,1327,1916,10
50232867946,50232867946,0,2109,2392,10
50240132878,50240132874,-4,1237,1960,10
50240401747,50240401748,1,1147,2179,10
50241662582,50241662582,0,988,1444,10
50241802811,50241802816,5,1930,1555,10
50246899289,50246899286,-3,961,1698,10
50248922771,50248922770,-1,1835,1653,10
50253990729,50253990727,-2,1246,2128,10
50255055050,50255055054,4,2204,1363,10
50256954647,50256954646,-1,1172,2000,10
50259196009,50259196007,-2,1427,2303,10
50261622870,50261622869,-1,1186,2087,10
50262358416,50262358415,-1,1079,1710,10
50262499511,50262499517,6,2481,1884,10
50263844670,50263844669,-1,1792,3514,10
50265555383,50265555382,-1,1223,1615,10
50267239888,50267239887,-1,1632,1667,10
50268916546,50268916544,-2,1373,2578,10
50269160609,50269160608,-1,1119,2291,10
50270097131,50270097112,-19,864,1537,10
50275722615,50275722611,-4,1148,921,10
50279196835,50279196833,-2,1272,1799,10
50281262614,50281262613,-1,1158,1658,10
50284032286,50284032281,-5,1917,5326,10
50284703662,50284703662,0,1748,2610,10
50293096410,50293096408,-2,1183,2124,10
50293542414,50293542413,-1,745,1310,10
50295354217,50295354217,0,1081,2348,10
50295477157,50295477154,-3,1425,2058,10
50297456213,50297456211,-2,998,1697,10
50300200219,50300200218,-1,1254,1621,10
50301481928,50301481927,-1,1427,1654,10
50301655067,50301655067,0,2177,2069,10
50301764126,50301764125,-1,1318,1653,10
50303292391,50303292387,-4,1316,2371,10
50306621238,50306621234,-4,1281,1885,10
50310699168,50310699170,2,1281,1231,10
50313678913,50313678912,-1,1161,1689,10
50314964964,50314964962,-2,1026,2018,10
50318302920,50318302919,-1,1972,2702,10
50320947670,50320947669,-1,1060,2499,10
50322398297,50322398297,0,1305,1569,10
50324049870,50324049870,0,1164,1843,10
50326926106,50326926114,8,15078,32950,10
50329781488,50329781486,-2,1399,1730,10
50330505621,50330505619,-2,1194,2509,10
50331462979,50331462978,-1,1188,2247,10
50331662329,50331662327,-2,1422,2111,10
50336731514,50336731514,0,1217,1979,10
50338568192,50338568189,-3,994,2295,10
50342573931,50342573928,-3,1330,2656,10
50344446127,50344446126,-1,1582,2870,10
50345227630,50345227630,0,1093,1572,10
50349882017,50349882015,-2,1032,2061,10
50349929371,50349929354,-17,171,710,10
50358569118,50358569130,12,13725,49720,10
50364980838,50364980859,21,844,1050,10
50365240694,50365240694,0,1014,1619,10
50366331503,50366331503,0,1286,1615,10
50366758314,50366758314,0,1151,2018,10
50367662783,50367662781,-2,1491,2406,10
50368535766,50368535766,0,1373,2124,10
50370423413,50370423410,-3,1173,2225,10
50375728751,50375728754,3,1830,2148,10
50377321939,50377321936,-3,1070,2677,10
50377447818,50377447839,21,1398,1773,10
50379758070,50379758072,2,1165,1301,10
50386252605,50386252602,-3,1111,1688,10
50387663274,50387663273,-1,1272,1876,10
50389695594,50389695593,-1,1292,2023,10
50392622190,50392622189,-1,1236,1805,10
50392811026,50392811031,5,20978,48190,10
50396673705,50396673702,-3,1103,1770,10
50400463535,50400463530,-5,1222,2245,10
50402929947,50402929947,0,1250,2145,10
50403196948,50403196940,-8,1347,2138,10
50405614434,50405614431,-3,1319,1636,10
50406541601,50406541601,0,1116,1514,10
50408365140,50408365137,-3,1560,2461,10
50413232889,50413232890,1,1441,2184,10
50415742331,50415742329,-2,931,1911,10
50416084950,50416084950,0,924,1562,10
50419284638,50419284636,-2,1214,1845,10
50420497548,50420497548,0,1237,1799,10
50421359225,50421359225,0,1209,2364,10
50424146067,50424146061,-6,903,2146,10
50425265360,50425265358,-2,745,1762,10
50426377329,50426377328,-1,1545,1768,10
50426860635,50426860633,-2,1073,997,10
50437256915,50437256919,4,10251,6636,10
50438718563,50438718561,-2,1027,1932,10
50440269859,50440269859,0,1537,2424,10
50441617962,50441617959,-3,1163,1399,10
50443237502,50443237501,-1,1223,2022,10
50443733706,50443733702,-4,825,999,10
50444459266,50444459265,-1,1216,1847,10
50448467251,50448467249,-2,1248,1664,10
50450070729,50450070735,6,2160,871,10
50450147238,50450147234,-4,1423,2975,10
50450357689,50450357669,-20,1107,1700,10
50456397194,50456397190,-4,667,1244,10
50457560914,50457560915,1,1730,2213,10
50457747421,50457747422,1,1454,1910,10
50457889785,50457889787,2,716,1349,10
50458230382,50458230381,-1,1635,2163,10
50468684078,50468684076,-2,1282,1875,10
50473742805,50473742801,-4,25165,14798,10
50476501766,50476501765,-1,995,1889,10
50476698538,50476698530,-8,318,1325,10
50478345059,50478345047,-12,76,565,10
50479465606,50479465605,-1,1120,1719,10
50480646908,50480646923,15,98,5410,10
50481851051,50481851049,-2,1156,2261,10
50485467694,50485467696,2,1248,1689,10
50487251142,50487251141,-1,994,2328,10
50487499935,50487499934,-1,820,1433,10
50488166246,50488166245,-1,1136,1738,10
50490442050,50490442048,-2,1336,2011,10
50490937153,50490937154,1,1378,2377,10
50494651585,50494651581,-4,1665,4683,10
50496804421,50496804419,-2,2019,3249,10
50498620415,50498620414,-1,1544,2129,10
50498888278,50498888278,0,936,2189,10
50504481258,50504481257,-1,1048,2215,10
50506337906,50506337902,-4,2022,4700,10
50514202810,50514202810,0,1943,2081,10
50515339710,50515339709,-1,1052,2803,10
50517387252,50517387251,-1,1622,2669,10
50519703142,50519703141,-1,1468,1932,10
50519837369,50519837388,19,911,1690,10
50523756644,50523756642,-2,1605,2370,10
50524326951,50524326948,-3,1322,2174,10
50524725954,50524725953,-1,1255,1867,10
50527783213,50527783211,-2,981,1637,10
50529493273,50529493271,-2,1320,1748,10
50530892177,50530892174,-3,1110,2535,10
50538618413,50538618405,-8,988,5288,10
50543085576,50543085574,-2,1043,2478,10
50545350766,50545350764,-2,1280,1791,10
50550256494,50550256491,-3,1049,1568,10
50552281594,50552281614,20,1049,1845,10
50552459302,50552459296,-6,863,1635,10
50552694345,50552694343,-2,1321,1711,10
50554223475,50554223474,-1,1379,1954,10
50554424074,50554424074,0,1408,1959,10
50555284184,50555284181,-3,1052,2530,10
50556502935,50556502937,2,1185,1404,10
50565986462,50565986458,-4,1160,2349,10
50567175824,50567175822,-2,1323,2480,10
50567310970,50567310990,20,1810,2495,10
50572665782,50572665778,-4,1589,2692,10
50577053069,50577053067,-2,1254,2263,10
50578150298,50578150298,0,822,957,10
50578452307,50578452306,-1,1168,1770,10
50578685227,50578685246,19,1613,2606,10
50578763847,50578763846,-1,1384,2108,10
50579406742,50579406738,-4,1086,1568,10
50580523201,50580523200,-1,1347,1787,10
50581869368,50581869366,-2,1065,2347,10
50582503380,50582503399,19,533,1340,10
50582540371,50582540366,-5,1208,2487,10
50582662775,50582662773,-2,1044,1830,10
50587536990,50587536972,-18,1414,2590,10
50587739331,50587739350,19,982,2619,10
50588114074,50588114075,1,662,1122,10
50588460875,50588460878,3,1629,1362,10
50590471909,50590471908,-1,1461,2366,10
50592512581,50592512579,-2,1168,1863,10
50598661711,50598661709,-2,957,1432,10
50607628643,50607628641,-2,1075,1856,10
50608485942,50608485941,-1,1204,1785,10
50611514054,50611514053,-1,1558,2741,10
50621790520,50621790518,-2,1227,1333,10
50622735951,50622735951,0,939,2047,10
50624848225,50624848223,-2,977,2793,10
50628655617,50628655617,0,959,1763,10
50631406642,50631406642,0,1041,2015,10
50632409334,50632409332,-2,1330,1810,10
50632661455,50632661456,1,1133,1915,10
50635965774,50635965773,-1,1517,1968,10
50637651674,50637651674,0,998,1907,10
50639191156,50639191171,15,1148,1865,10
50639300882,50639300882,0,1264,2586,10
50639603891,50639603890,-1,1741,2395,10
50640524924,50640524923,-1,1268,1999,10
50649506259,50649506259,0,1414,1951,10
50649624859,50649624860,1,1088,954,10
50651003847,50651003846,-1,1140,2057,10
50651262039,50651262041,2,36892,33235,10
50652033239,50652033238,-1,1258,1872,10
50653017040,50653017038,-2,1003,2034,10
50653541142,50653541138,-4,1526,4140,10
50659790230,50659790227,-3,1014,2084,10
50672442547,50672442546,-1,1208,1985,10
50673206142,50673206139,-3,1543,2887,10
50675231750,50675231750,0,772,1251,10
50678119910,50678119910,0,1229,2380,10
50678165673,50678165662,-11,34650,14093,10
50685000435,50685000434,-1,1156,1759,10
50695408862,50695408843,-19,1143,1907,10
50696446310,50696446310,0,1318,1767,10
50699016691,50699016688,-3,1399,1375,10
50701601618,50701601610,-8,2139,8594,10
50703300573,50703300573,0,1533,1630,10
50707432119,50707432117,-2,1271,2541,10
50708304888,50708304884,-4,1279,2459,10
50711032147,50711032143,-4,1373,2162,10
50711744202,50711744204,2,900,1236,10
50714929890,50714929889,-1,884,1749,10
50715596243,50715596242,-1,1354,2170,10
50718961421,50718961425,4,1571,1476,10
50724030217,50724030216,-1,1381,2812,10
50724220752,50724220747,-5,250,646,10
50725172869,50725172867,-2,952,950,10
50725653985,50725654001,16,1195,1805,10
50726351583,50726351582,-1,1313,2033,10
50726729570,50726729570,0,811,1092,10
50728043178,50728043176,-2,901,1615,10
50734126557,50734126556,-1,1568,2496,10
50734310371,50734310370,-1,991,1352,10
50735157881,50735157880,-1,1195,1613,10
50735435574,50735435587,13,3580,1354,10
50740824083,50740824078,-5,952,1702,10
50742229821,50742229820,-1,949,2535,10
50743393627,50743393625,-2,1545,2197,10
50745485116,50745485115,-1,892,1540,10
50750274519,50750274518,-1,980,1220,10
50751658275,50751658274,-1,878,1432,10
50755402922,50755402921,-1,840,1861,10
50757665178,50757665177,-1,1107,1796,10
50758387659,50758387657,-2,650,1408,10
50759351956,50759351955,-1,1533,2581,10
50759880190,50759880189,-1,1139,2011,10
50764034742,50764034742,0,835,1719,10
50766669162,50766669161,-1,812,2547,10
50767541610,50767541610,0,1387,1763,10
50770601247,50770601245,-2,1181,1725,10
50771812615,50771812613,-2,972,2189,10
50774749788,50774749774,-14,635,1239,10
50781111190,50781111193,3,992,1500,10
50783005694,50783005691,-3,1163,1933,10
50783742093,50783742093,0,1043,1775,10
50783807885,50783807885,0,577,1002,10
50786567554,50786567552,-2,1995,2303,10
50786814672,50786814672,0,1031,2233,10
50788165031,50788165028,-3,1521,1974,10
50790058273,50790058276,3,4048,2715,10
50791116702,50791116702,0,1062,2602,10
50792874220,50792874205,-15,1608,2560,10
50792989838,50792989838,0,1480,1336,10
50795890959,50795890957,-2,1624,2768,10
50798280181,50798280179,-2,1210,1453,10
50804995293,50804995291,-2,1720,1986,10
50811640170,50811640167,-3,1003,1810,10
50812669791,50812669790,-1,791,971,10
50815751778,50815751775,-3,589,1513,10
50818170790,50818170791,1,1354,1716,10
50818951848,50818951845,-3,1068,1807,10
50822207474,50822207473,-1,998,2467,10
50833095604,50833095603,-1,1505,3079,10
50833156584,50833156605,21,691,1640,10
50833510085,50833510092,7,10459,42149,10
50834153881,50834153877,-4,3017,5705,10
50834544499,50834544498,-1,1395,1547,10
50834988778,50834988778,0,1147,1303,10
50837298390,50837298388,-2,1406,2152,10
50837701202,50837701199,-3,1956,6195,10
50840225411,50840225409,-2,1083,1992,10
50844544139,50844544137,-2,940,2357,10
50849914922,50849914925,3,1084,894,10
50850076646,50850076645,-1,1241,2310,10
50850656275,50850656273,-2,1325,2151,10
50850743799,50850743796,-3,1216,1907,10
50850909259,50850909257,-2,1103,2124,10
50854965325,50854965326,1,4206,4416,10
50856199652,50856199650,-2,1315,2316,10
50856799602,50856799600,-2,1750,3095,10
50861152342,50861152341,-1,1105,2109,10
50862558485,50862558485,0,1529,2408,10
50864184361,50864184378,17,134,1673,10
50866750935,50866750936,1,880,1551,10
50868120617,50868120614,-3,1196,1935,10
50868381273,50868381273,0,808,2368,10
50868500018,50868500017,-1,1358,1684,10
50869945400,50869945398,-2,1245,2235,10
50876540134,50876540134,0,1363,2067,10
50878258637,50878258637,0,573,1492,10
50880199876,50880199873,-3,1703,2532,10
50887184672,50887184670,-2,887,1785,10
50890584743,50890584739,-4,1148,2742,10
50892685770,50892685769,-1,907,2000,10
50893671906,50893671927,21,1313,1555,10
50895454526,50895454523,-3,872,384,10
50901006283,50901006282,-1,1187,2208,10
50905320532,50905320530,-2,1142,1942,10
50905569002,50905568996,-6,543,1123,10
50907396544,50907396551,7,5759,2073,10
50912555738,50912555735,-3,1056,2525,10
50914600438,50914600436,-2,1141,1373,10
50917297633,50917297635,2,1232,1802,10
50919316774,50919316776,2,1639,2077,10
50920039600,50920039598,-2,1413,2225,10
50922938887,50922938884,-3,1209,1981,10
50922989594,50922989612,18,792,1432,10
50923718878,50923718886,8,1196,832,10
50930127059,50930127058,-1,1031,2388,10
50930903234,50930903232,-2,1315,1600,10
50933751497,50933751495,-2,1755,2484,10
50939651562,50939651562,0,1071,1037,10
50944593814,50944593814,0,978,2089,10
50944661954,50944661954,0,1426,2025,10
50947553099,50947553097,-2,1124,2262,10
50948281692,50948281690,-2,1233,2424,10
50949445952,50949445952,0,1424,1395,10
50951353037,50951353037,0,1549,2399,10
50960559534,50960559535,1,1679,2213,10
50961335162,50961335162,0,1343,2342,10
50965780022,50965780018,-4,1266,2743,10
50966843886,50966843886,0,1431,2380,10
50970586675,50970586684,9,4040,1528,10
50973450069,50973450069,0,1596,2422,10
50976671255,50976671253,-2,1530,2626,10
50977482839,50977482839,0,924,1431,10
50980224524,50980224522,-2,1069,2131,10
50986151074,50986151075,1,1469,1446,10
50986882818,50986882817,-1,1597,2174,10
50987147812,50987147806,-6,1822,6859,10
50988668878,50988668878,0,1383,1687,10
50991199156,50991199158,2,1829,2131,10
50994983758,50994983758,0,1330,2034,10
50995096673,50995096670,-3,1264,2087,10
50995485011,50995485012,1,1141,1178,10
50996083059,50996083054,-5,678,1940,10
50996169017,50996169015,-2,1067,1787,10
51000296345,51000296346,1,1473,1175,10
51001369860,51001369857,-3,1704,1594,10
51001713948,51001713966,18,1047,1903,10
51003372536,51003372536,0,982,1288,10
51003648315,51003648314,-1,1076,1910,10
51003864395,51003864396,1,1144,1590,10
51007788133,51007788135,2,1806,1834,10
51013989802,51013989798,-4,1047,1774,10
51017166102,51017166097,-5,1377,5536,10
51017613049,51017613048,-1,911,1609,10
51019628895,51019628893,-2,1005,1738,10
51024856682,51024856675,-7,1644,8733,10
51026705643,51026705641,-2,1005,2271,10
51027702771,51027702770,-1,671,1267,10
51031715836,51031715834,-2,1127,1506,10
51033311939,51033311937,-2,879,2129,10
51035266402,51035266403,1,1822,1765,10
51035445950,51035445950,0,1915,2816,10
51038662630,51038662634,4,1535,1690,10
51042927247,51042927245,-2,990,1956,10
51043797273,51043797272,-1,4073,4757,10
51044347789,51044347790,1,804,1319,10
51051243178,51051243178,0,849,1299,10
51052126259,51052126259,0,1535,1346,10
51056435033,51056435031,-2,1366,2125,10
51057771295,51057771294,-1,1291,1636,10
51058285738,51058285738,0,1299,3161,10
51063564550,51063564550,0,1263,2559,10
51063617512,51063617509,-3,1343,2329,10
51065817922,51065817921,-1,1605,1475,10
51066192455,51066192454,-1,916,1646,10
51066837742,51066837740,-2,1081,2270,10
51073118238,51073118237,-1,1310,1889,10
51081879262,51081879263,1,3162,3644,10
51082410514,51082410513,-1,1508,1452,10
51083165244,51083165261,17,1026,1771,10
51083377467,51083377467,0,1037,2114,10
51090198394,51090198397,3,3441,3797,10
51091942427,51091942446,19,985,1766,10
51094459049,51094459047,-2,976,1264,10
51096517795,51096517811,16,885,1722,10
51099095519,51099095518,-1,1315,1664,10
51099704358,51099704357,-1,1234,2101,10
51103508081,51103508081,0,1338,1568,10
51106822754,51106822753,-1,1269,2280,10
51109119763,51109119762,-1,1279,1967,10
51114541918,51114541919,1,1087,1551,10
51116956743,51116956742,-1,1722,2085,10
51117376633,51117376630,-3,2308,2582,10
51117440701,51117440699,-2,1220,1706,10
51121245058,51121245060,2,1415,1902,10
51121568963,51121568962,-1,1422,2898,10
51123758325,51123758322,-3,1073,2261,10
51128012039,51128012036,-3,1214,2458,10
51128770032,51128770048,16,1144,2706,10
51129517813,51129517806,-7,2016,5526,10
51133977653,51133977653,0,1201,1736,10
51137111865,51137111863,-2,1176,1584,10
51137385237,51137385235,-2,1250,1718,10
51140624175,51140624173,-2,1152,1662,10
51142434344,51142434342,-2,1419,2492,10
51146653107,51146653103,-4,605,820,10
51147568975,51147568973,-2,1215,1990,10
51151788878,51151788875,-3,1442,2707,10
51152115506,51152115504,-2,953,1853,10
51153558194,51153558194,0,1037,1672,10
51158834650,51158834648,-2,1282,1882,10
51159748353,51159748353,0,1182,1402,10
51165635800,51165635798,-2,1452,2840,10
51165931075,51165931055,-20,1089,1771,10
51171598742,51171598742,0,1281,2364,10
51173205789,51173205789,0,1040,1743,10
51175986785,51175986783,-2,1619,2909,10
51177540960,51177540959,-1,1574,2395,10
51184788642,51184788642,0,1801,2396,10
51188442603,51188442602,-1,1570,1656,10
51191717863,51191717859,-4,1133,2407,10
51194462242,51194462242,0,927,1476,10
51198748987,51198748983,-4,1031,1558,10
51200010489,51200010489,0,1351,1759,10
51201431893,51201431894,1,1292,1903,10
51204131096,51204131094,-2,899,2358,10
51210147819,51210147796,-23,1180,1325,10
51211438938,51211438939,1,1455,1474,10
51212120826,51212120824,-2,1252,1506,10
51212783702,51212783702,0,1952,2270,10
51215870478,51215870477,-1,1150,2363,10
51220065102,51220065102,0,1175,1585,10
51220396423,51220396422,-1,1089,1280,10
51220812173,51220812170,-3,1395,2767,10
51222191138,51222191152,14,467,10649,10
51224344327,51224344326,-1,1056,2667,10
51225109329,51225109328,-1,976,2172,10
51227286422,51227286421,-1,1248,2223,10
51229639813,51229639817,4,1766,2709,10
51230664835,51230664834,-1,1177,765,10
51231337343,51231337342,-1,1221,1812,10
51234363852,51234363851,-1,1093,2763,10
51236376497,51236376495,-2,1540,2038,10
51240032443,51240032442,-1,1186,1554,10
51243630185,51243630180,-5,1188,3229,10
51243673470,51243673470,0,1295,2294,10
51243709426,51243709427,1,1180,1904,10
51244236073,51244236069,-4,1485,2249,10
51245305815,51245305792,-23,1075,2091,10
51246874714,51246874713,-1,1039,1595,10
51248091734,51248091732,-2,1155,2381,10
51248560762,51248560758,-4,972,1635,10
51248854409,51248854407,-2,1067,2115,10
51249600136,51249600142,6,3031,1392,10
51253387243,51253387243,0,1167,1532,10
51254817625,51254817623,-2,1200,1939,10
51255274597,51255274598,1,1508,1743,10
51255748174,51255748172,-2,990,1757,10
51256926467,51256926466,-1,1374,1392,10
51257694844,51257694841,-3,893,1407,10
51259180358,51259180367,9,3534,971,10
51261978310,51261978312,2,1679,1633,10
51262566995,51262567010,15,1043,2247,10
51263931255,51263931253,-2,1120,2388,10
51264288665,51264288663,-2,1514,3005,10
51264737798,51264737798,0,1165,1962,10
51270311873,51270311874,1,1251,1779,10
51271353184,51271353182,-2,1217,2059,10
51273570102,51273570101,-1,1387,2055,10
51276621059,51276621058,-1,1828,2549,10
51277497392,51277497388,-4,1155,1338,10
51278999196,51278999194,-2,1597,2388,10
51283262934,51283262935,1,2099,2342,10
51284828741,51284828741,0,1349,2123,10
51287406070,51287406054,-16,1748,2301,10
51293543198,51293543194,-4,1459,1663,10
51295265267,51295265265,-2,994,2637,10
51297394314,51297394311,-3,1487,1577,10
51299372030,51299372028,-2,1388,2568,10
51316596467,51316596463,-4,1208,2255,10
51318727591,51318727587,-4,1199,2411,10
51320974921,51320974906,-15,278,1141,10
51321535250,51321535249,-1,1043,1639,10
51325054322,51325054321,-1,1337,1771,10
51326012553,51326012553,0,1325,2604,10
51333924062,51333924062,0,1985,1977,10
51336316202,51336316203,1,1716,1583,10
51338457060,51338457059,-1,1270,2725,10
51338551082,51338551081,-1,669,1580,10
51343839429,51343839429,0,1703,2103,10
51344414063,51344414062,-1,1219,1646,10
51346206083,51346206082,-1,1113,2242,10
51346994788,51346994786,-2,1124,2151,10
51351119523,51351119523,0,1378,2121,10
51351814586,51351814585,-1,1584,2104,10
51352878014,51352878012,-2,1544,3039,10
51355782910,51355782910,0,932,1491,10
51359718890,51359718869,-21,1074,1826,10
51359961037,51359961034,-3,824,1943,10
51360347422,51360347421,-1,1579,2023,10
51362957121,51362957121,0,1063,963,10
51365837163,51365837164,1,921,1621,10
51370597455,51370597451,-4,43776,27514,10
51377114836,51377114834,-2,1453,2822,10
51383468411,51383468409,-2,1318,2408,10
51383592467,51383592454,-13,975,2164,10
51385582281,51385582279,-2,1270,1819,10
51386642281,51386642278,-3,913,1432,10
51388389085,51388389084,-1,1150,1505,10
51392561348,51392561342,-6,1281,3835,10
51396991217,51396991218,1,1130,1202,10
51400454226,51400454223,-3,1617,2581,10
51402395796,51402395793,-3,1540,2397,10
51409973944,51409973941,-3,1182,1715,10
51413725645,51413725644,-1,1086,1983,10
51414268706,51414268705,-1,2561,3179,10
51416150611,51416150610,-1,1006,2266,10
51420890959,51420890955,-4,876,1292,10
51423007800,51423007799,-1,1282,1995,10
51423370518,51423370517,-1,1540,2688,10
51425522895,51425522895,0,1357,1839,10
51428470537,51428470541,4,4293,2497,10
51430754931,51430754931,0,1573,1777,10
51441094742,51441094738,-4,1179,2929,10
51441683865,51441683859,-6,955,1048,10
51442541168,51442541151,-17,904,1778,10
51445660573,51445660571,-2,1387,1963,10
51446453506,51446453486,-20,1199,2330,10
51447737517,51447737516,-1,1125,1697,10
51453123647,51453123645,-2,1256,1821,10
51454171466,51454171463,-3,1356,2015,10
51456910028,51456910026,-2,1086,2116,10
51459918882,51459918883,1,639,758,10
51462432103,51462432102,-1,810,1239,10
51462467019,51462467013,-6,1188,1441,10
51466214722,51466214722,0,1481,1841,10
51468953111,51468953118,7,1099,680,10
51471199507,51471199506,-1,1214,2503,10
51471998773,51471998766,-7,1594,3413,10
51472711350,51472711348,-2,1083,2166,10
51476926349,51476926353,4,1247,1883,10
51477073193,51477073193,0,1276,1858,10
51481290651,51481290649,-2,1177,2368,10
51483044143,51483044142,-1,761,2282,10
51483857755,51483857755,0,1680,2199,10
51486325659,51486325658,-1,601,1039,10
51487031047,51487031046,-1,981,1973,10
51488066520,51488066519,-1,1220,1895,10
51488749710,51488749710,0,1286,1999,10
51489572368,51489572368,0,1748,1722,10
51491396437,51491396435,-2,1025,1262,10
51503536051,51503536050,-1,1223,1714,10
51507886920,51507886922,2,1669,1463,10
51510673409,51510673412,3,779,1384,10
51511521997,51511521998,1,1134,1832,10
51512926509,51512926509,0,378,1710,10
51514628838,51514628836,-2,1215,2001,10
51514715751,51514715750,-1,1206,2086,10
51515116966,51515116966,0,937,1730,10
51515455198,51515455198,0,905,1867,10
51517424778,51517424776,-2,1290,2017,10
51519581498,51519581495,-3,999,2463,10
51525684206,51525684205,-1,1353,1588,10
51526168491,51526168486,-5,1174,1998,10
51532478714,51532478710,-4,1215,1825,10
51536135155,51536135158,3,2059,1978,10
51540649558,51540649557,-1,1260,1741,10
51543888543,51543888542,-1,1333,2371,10
51545506387,51545506380,-7,1085,1139,10
51553537883,51553537883,0,1040,1258,10
51559616975,51559616974,-1,1543,2198,10
51562555001,51562555002,1,1199,1746,10
51564858819,51564858818,-1,1141,1576,10
51567485682,51567485679,-3,1444,1699,10
51575838681,51575838680,-1,1056,1954,10
51576503507,51576503499,-8,282,535,10
51579448393,51579448394,1,2202,1702,10
51584996323,51584996323,0,1017,1706,10
51585600354,51585600354,0,1359,1932,10
51593594118,51593594118,0,1272,1378,10
51601049433,51601049437,4,1613,1379,10
51613574462,51613574462,0,1315,3000,10
51614462868,51614462865,-3,1715,2184,10
51622779994,51622779995,1,1349,1712,10
51632424839,51632424839,0,765,1799,10
51634743885,51634743886,1,783,1179,10
51635900189,51635900187,-2,1569,2319,10
51636928487,51636928487,0,1434,2103,10
51637562587,51637562583,-4,871,2073,10
51639197996,51639197994,-2,1380,2124,10
51646628924,51646628924,0,1468,2449,10
51646762724,51646762722,-2,1388,1838,10
51650080199,51650080200,1,800,1648,10
51650858621,51650858618,-3,802,2169,10
51651800718,51651800717,-1,1390,1776,10
51655626890,51655626889,-1,1153,1590,10
51657827141,51657827142,1,1445,2363,10
51659190663,51659190662,-1,1103,2350,10
51662371663,51662371661,-2,1437,2212,10
51662456618,51662456618,0,809,1622,10
51664096619,51664096603,-16,800,305,10
51668637355,51668637354,-1,750,1234,10
51673503179,51673503177,-2,1342,2392,10
51673598908,51673598908,0,1080,2194,10
51678844402,51678844402,0,1984,2081,10
51679742838,51679742838,0,1267,1745,10
51686861982,51686861980,-2,1360,2012,10
51690758017,51690758018,1,767,1390,10
51691413558,51691413556,-2,2137,4738,10
51694780303,51694780303,0,1369,2398,10
51696567472,51696567473,1,1151,1591,10
51700211735,51700211733,-2,1289,2312,10
51708457218,51708457217,-1,1065,1853,10
51709251430,51709251429,-1,543,978,10
51715094386,51715094385,-1,1056,2073,10
51725531961,51725531961,0,917,1648,10
51728918510,51728918509,-1,1372,2028,10
51730265233,51730265243,10,13802,31706,10
51731547200,51731547199,-1,1427,3061,10
51738210474,51738210474,0,1139,1926,10
51740817975,51740817974,-1,776,1730,10
51741652567,51741652563,-4,1009,2085,10
51742839989,51742839990,1,1288,1773,10
51743163864,51743163851,-13,1121,1789,10
51748054406,51748054404,-2,1232,1533,10
51751254161,51751254160,-1,1029,1557,10
51751731683,51751731681,-2,1389,1649,10
51751913276,51751913274,-2,1172,1239,10
51754924407,51754924408,1,1287,1762,10
51755857390,51755857388,-2,1026,1508,10
51757714510,51757714508,-2,1228,1551,10
51759431891,51759431889,-2,1121,1843,10
51759460000,51759459997,-3,776,1538,10
51761089446,51761089443,-3,1172,2050,10
51761552618,51761552615,-3,1007,1714,10
51763035371,51763035369,-2,1337,1756,10
51765375687,51765375686,-1,1226,2261,10
51776129150,51776129153,3,1722,1690,10
51777131319,51777131318,-1,1142,1742,10
51780055091,51780055090,-1,941,2314,10
51781654786,51781654784,-2,2024,2197,10
51783485161,51783485159,-2,1515,2705,10
51783683283,51783683303,20,695,1512,10
51784173539,51784173541,2,1373,1689,10
51790741421,51790741421,0,892,1113,10
51792615032,51792615030,-2,1413,2292,10
51794658689,51794658686,-3,1338,3338,10
51797847250,51797847247,-3,937,1311,10
51798509024,51798509010,-14,1545,1511,10
51798741139,51798741134,-5,1164,3725,10
51802410974,51802410971,-3,737,2144,10
51805325742,51805325741,-1,847,1689,10
51806540087,51806540085,-2,1330,1972,10
51809514381,51809514382,1,1913,2134,10
51812772047,51812772045,-2,966,1847,10
51813571761,51813571761,0,1494,1833,10
51815279158,51815279155,-3,1490,1908,10
51816365315,51816365317,2,881,1270,10
51816517881,51816517883,2,774,1078,10
51816961823,51816961822,-1,3213,4011,10
51819147730,51819147727,-3,707,1317,10
51820623391,51820623390,-1,1276,1746,10
51830786425,51830786423,-2,1038,1866,10
51831902683,51831902688,5,2487,1655,10
51832477263,51832477261,-2,896,2162,10
51834059476,51834059475,-1,1524,2506,10
51837663335,51837663337,2,2160,1354,10
51838381121,51838381120,-1,1357,2105,10
51839475561,51839475558,-3,1366,2541,10
51840337578,51840337578,0,1440,1975,10
51848258107,51848258106,-1,1252,1578,10
51849047983,51849047983,0,2186,2985,10
51852276738,51852276738,0,991,1470,10
51853573249,51853573265,16,1409,1514,10
51856950027,51856950026,-1,1195,1889,10
51861003984,51861003983,-1,1387,1769,10
51861332215,51861332213,-2,893,2639,10
51864606717,51864606715,-2,1959,2446,10
51870907342,51870907341,-1,1192,1947,10
51871026594,51871026575,-19,166,1070,10
51881433306,51881433305,-1,1153,2055,10
51883226342,51883226338,-4,798,1465,10
51887239299,51887239297,-2,1007,1836,10
51888344330,51888344335,5,2310,1218,10
51889952642,51889952641,-1,1464,2261,10
51897083033,51897083033,0,1326,2418,10
51898717622,51898717630,8,5207,1351,10
51903059288,51903059298,10,17790,23414,10
51903663313,51903663306,-7,743,3518,10
51904888222,51904888222,0,1014,2144,10
51912456067,51912456066,-1,1108,2019,10
51925384957,51925384957,0,1607,2300,10
51929384202,51929384202,0,1761,2637,10
51929980298,51929980298,0,1075,2034,10
51930235198,51930235199,1,995,1216,10
51933901440,51933901437,-3,844,1935,10
51934688713,51934688735,22,79,344,10
51935948399,51935948398,-1,980,1329,10
51937299666,51937299648,-18,5932,1821,10
51938135026,51938135038,12,13999,39323,10
51953462446,51953462444,-2,1681,2014,10
51953935230,51953935234,4,1546,1179,10
51954518273,51954518270,-3,1233,1879,10
51956744347,51956744346,-1,1717,1698,10
51957904569,51957904569,0,780,1879,10
51960713733,51960713730,-3,1000,1248,10
51962129487,51962129485,-2,1325,2128,10
51962278414,51962278414,0,824,1086,10
51962858466,51962858474,8,11256,34226,10
51964864570,51964864570,0,1413,1473,10
51966942521,51966942527,6,2534,1486,10
51967175573,51967175573,0,836,1524,10
51969391818,51969391822,4,2904,1897,10
51969917867,51969917867,0,1187,1563,10
51976872446,51976872444,-2,1171,1362,10
51977456225,51977456223,-2,1802,2750,10
51979534414,51979534413,-1,1742,2447,10
51985136059,51985136066,7,899,1745,10
51985370868,51985370866,-2,1202,1579,10
51986923849,51986923847,-2,1157,2214,10
51987342774,51987342770,-4,1581,1225,10
51988021148,51988021142,-6,900,1300,10
51989016337,51989016342,5,4950,2893,10
51992102909,51992102915,6,2350,36743,10
51999746557,51999746557,0,1197,2053,10
52000288426,52000288423,-3,1328,2419,10
52000316514,52000316515,1,1225,1967,10
52001000122,52001000121,-1,1137,2201,10
52002933955,52002933953,-2,45088,5062,10
52003653682,52003653687,5,1372,1493,10
52004369382,52004369382,0,1073,2002,10
52014947682,52014947681,-1,1348,1721,10
52023935309,52023935307,-2,1559,2094,10
52027434165,52027434169,4,2029,1808,10
52030580615,52030580609,-6,1835,7507,10
52032337858,52032337861,3,1297,1302,10
52034404023,52034404024,1,1040,1829,10
52037145566,52037145562,-4,1422,2771,10
52037494259,52037494237,-22,1025,1693,10
52042661060,52042661058,-2,1390,2331,10
52042765721,52042765722,1,1418,1152,10
52043346393,52043346394,1,1626,1523,10
52051643997,52051643998,1,1836,1793,10
52052206366,52052206364,-2,1372,2401,10
52054133451,52054133447,-4,1299,1677,10
52054405471,52054405471,0,985,1351,10
52055654679,52055654678,-1,1242,2158,10
52056259974,52056259972,-2,1867,2659,10
52056801242,52056801249,7,4139,2817,10
52059110447,52059110446,-1,938,1788,10
52060136931,52060136925,-6,2071,9619,10
52061499617,52061499615,-2,1397,2087,10
52062294378,52062294378,0,1147,1936,10
52063446178,52063446174,-4,1524,2281,10
52065783342,52065783340,-2,1743,2741,10
52066869837,52066869835,-2,1070,1985,10
52068597094,52068597087,-7,931,1958,10
52074298215,52074298211,-4,877,1818,10
52076499121,52076499118,-3,1143,2136,10
52079568235,52079568233,-2,942,1578,10
52081947066,52081947066,0,1049,2190,10
52083811089,52083811089,0,1354,2091,10
52086607299,52086607298,-1,1406,1983,10
52088831602,52088831599,-3,968,1710,10
52091861603,52091861601,-2,1071,1721,10
52095156255,52095156250,-5,1120,1999,10
52101529503,52101529501,-2,1226,2112,10
52102752196,52102752194,-2,1277,1954,10
52103734270,52103734270,0,1040,1753,10
52103765263,52103765262,-1,1207,1773,10
52104117418,52104117417,-1,1035,1529,10
52104993903,52104993902,-1,1130,2122,10
52109268912,52109268913,1,1259,1503,10
52112076714,52112076714,0,1141,2194,10
52112377375,52112377373,-2,1403,2300,10
52118965065,52118965073,8,2505,1325,10
52121755840,52121755841,1,11119,10825,10
52121839102,52121839100,-2,968,1471,10
52122441952,52122441949,-3,834,1972,10
52122802268,52122802249,-19,1036,1771,10
52124734027,52124734026,-1,953,2159,10
52126216305,52126216305,0,1566,1806,10
52127455192,52127455189,-3,1180,2280,10
52127680051,52127680055,4,311,888,10
52130792062,52130792063,1,1549,1634,10
52133347424,52133347424,0,1138,1581,10
52133461207,52133461205,-2,1033,1352,10
52140751462,52140751462,0,1394,2203,10
52142426925,52142426922,-3,1074,1449,10
52148189126,52148189125,-1,1086,1627,10
52148495066,52148495066,0,851,1879,10
52150312491,52150312486,-5,1189,2868,10
52152126598,52152126597,-1,854,1592,10
52157805090,52157805088,-2,1726,2331,10
52158024410,52158024410,0,829,1102,10
52158986875,52158986872,-3,841,1333,10
52160929845,52160929842,-3,1403,2538,10
52162204611,52162204609,-2,1328,1497,10
52163357603,52163357603,0,1115,1718,10
52167478714,52167478709,-5,936,1923,10
52169696059,52169696057,-2,1015,1721,10
52169777098,52169777099,1,912,2070,10
52172977939,52172977935,-4,853,1865,10
52176572697,52176572697,0,1465,1823,10
52178267950,52178267951,1,1394,1394,10
52179580914,52179580913,-1,997,1866,10
52181305124,52181305117,-7,1893,6630,10
52182185959,52182185959,0,1224,1205,10
52183601206,52183601208,2,1117,1900,10
52184128891,52184128889,-2,850,1463,10
52188254162,52188254161,-1,1176,1814,10
52188630508,52188630525,17,535,1592,10
52193025712,52193025711,-1,1717,2673,10
52196582373,52196582369,-4,1121,2629,10
52197618431,52197618430,-1,1035,959,10
52201347689,52201347689,0,1243,1040,10
52203122111,52203122111,0,2638,3511,10
52206152905,52206152904,-1,1335,2197,10
52206466084,52206466101,17,1288,1998,10
52213192804,52213192804,0,1497,2847,10
52218351045,52218351043,-2,1082,2442,10
52220097095,52220097093,-2,1405,2159,10
52220910434,52220910435,1,1418,1698,10
52221510241,52221510256,15,16129,18555,10
52230348934,52230348943,9,2103,1143,10
52231084159,52231084158,-1,1522,2214,10
52233057539,52233057539,0,1036,2136,10
52233589472,52233589470,-2,1305,2594,10
52233711014,52233711014,0,1068,1816,10
52235906425,52235906425,0,1421,1633,10
52238582951,52238582947,-4,841,2121,10
52240244827,52240244825,-2,1277,3029,10
52242912063,52242912061,-2,1238,2200,10
52246093652,52246093652,0,1428,2160,10
52248501425,52248501423,-2,1124,2231,10
52253213669,52253213667,-2,1443,1847,10
52257190597,52257190595,-2,898,868,10
52260993165,52260993163,-2,1237,1906,10
52261138647,52261138645,-2,1369,1905,10
52261453321,52261453321,0,1663,2048,10
52273392230,52273392230,0,1071,2154,10
52273455069,52273455070,1,1151,1829,10
52276054655,52276054653,-2,1099,1790,10
52278550683,52278550684,1,1339,2413,10
52279770633,52279770630,-3,1265,2311,10
52280697161,52280697158,-3,1099,1722,10
52282832815,52282832814,-1,1209,2118,10
52283110130,52283110117,-13,1285,2289,10
52288025111,52288025111,0,920,1870,10
52289544674,52289544673,-1,1215,1873,10
52291023041,52291023041,0,1355,2601,10
52293843319,52293843318,-1,1699,2986,10
52296476923,52296476921,-2,1502,2227,10
52296913799,52296913798,-1,1270,1959,10
52297681274,52297681275,1,1550,1750,10
52298979585,52298979584,-1,1037,1814,10
52307038432,52307038430,-2,1229,2301,10
52309887831,52309887826,-5,1223,2643,10
52312454426,52312454425,-1,1142,1964,10
52314143519,52314143502,-17,1297,2148,10
52314241600,52314241587,-13,253,498,10
52315347941,52315347940,-1,1807,2204,10
52317613859,52317613857,-2,1131,1624,10
52319395133,52319395133,0,1743,2542,10
52321125775,52321125771,-4,1336,2868,10
52322679391,52322679390,-1,825,840,10
52322932623,52322932619,-4,1266,1085,10
52323528645,52323528646,1,1256,1445,10
52325570122,52325570121,-1,1561,2154,10
52332769362,52332769363,1,1203,2246,10
52333336861,52333336860,-1,1694,2399,10
52333928923,52333928923,0,954,1242,10
52334559489,52334559488,-1,1080,2103,10
52337293659,52337293656,-3,573,1203,10
52339692843,52339692823,-20,1948,2646,10
52340448852,52340448850,-2,1513,1958,10
52343385744,52343385743,-1,19462,8491,10
52347616551,52347616550,-1,1434,2125,10
52350597344,52350597343,-1,1353,2031,10
52354499735,52354499736,1,1674,2637,10
52355397195,52355397189,-6,1022,4694,10
52359207029,52359207026,-3,859,1350,10
52363751010,52363751009,-1,1017,1887,10
52368693208,52368693208,0,1889,2903,10
52374472242,52374472242,0,1529,2079,10
52377499462,52377499461,-1,1884,2537,10
52377564454,52377564457,3,2465,1888,10
52379486042,52379486043,1,2008,2360,10
52380083105,52380083102,-3,1447,1700,10
52381137135,52381137141,6,2563,1221,10
52383897357,52383897355,-2,1518,2422,10
52386745374,52386745371,-3,1562,3559,10
52391261790,52391261787,-3,1208,1957,10
52398145817,52398145818,1,1330,2188,10
52404909962,52404909940,-22,1564,1735,10
52405226352,52405226351,-1,1507,2121,10
52406243081,52406243087,6,2467,869,10
52409469799,52409469796,-3,606,1493,10
52413474041,52413474038,-3,1292,2419,10
52420428826,52420428826,0,1262,2243,10
52426335411,52426335406,-5,1334,2117,10
52428838727,52428838725,-2,647,1321,10
52432007119,52432007117,-2,791,1984,10
52435149611,52435149609,-2,708,1317,10
52439848615,52439848613,-2,1326,2129,10
52442157825,52442157824,-1,1469,1777,10
52444177809,52444177810,1,1540,2293,10
52444348774,52444348776,2,39564,31168,10
52445776333,52445776325,-8,2389,12287,10
52449772046,52449772042,-4,1035,2622,10
52452420158,52452420156,-2,1395,2612,10
52455112668,52455112666,-2,1063,1655,10
52456846305,52456846303,-2,922,1762,10
52460071390,52460071386,-4,1323,1958,10
52460505734,52460505733,-1,935,2041,10
52460820694,52460820692,-2,1071,2239,10
52461277441,52461277439,-2,1608,2138,10
52462172135,52462172133,-2,1184,2070,10
52462612890,52462612887,-3,104,1235,10
52463244818,52463244817,-1,786,2283,10
52464484982,52464484989,7,2553,1034,10
52465456798,52465456797,-1,1600,2341,10
52466710142,52466710141,-1,1650,1677,10
52467455755,52467455757,2,1179,1163,10
52470504106,52470504106,0,1037,1141,10
52479964562,52479964563,1,1233,2056,10
52480311849,52480311847,-2,947,1860,10
52482971655,52482971655,0,1153,2209,10
52484105051,52484105050,-1,1084,2077,10
52487631011,52487631009,-2,1233,2244,10
52492732179,52492732178,-1,1051,1669,10
52493477047,52493477046,-1,1437,1753,10
52493692015,52493692016,1,1227,1768,10
52495023115,52495023115,0,1678,2123,10
52495564874,52495564874,0,869,1826,10
52501770967,52501770962,-5,2153,6376,10
52502563588,52502563586,-2,1454,1913,10
52503847927,52503847923,-4,1310,2970,10
52505465200,52505465198,-2,2555,4283,10
52507126751,52507126751,0,1317,1772,10
52507841194,52507841193,-1,1785,1972,10
52508348481,52508348479,-2,1193,2126,10
52517602874,52517602874,0,1211,1951,10
52520129643,52520129641,-2,954,2462,10
52521475557,52521475555,-2,902,1776,10
52526744716,52526744707,-9,1595,2894,10
52528264525,52528264522,-3,1227,1821,10
52530670690,52530670687,-3,708,1200,10
52532739678,52532739686,8,15659,14462,10
52533293155,52533293153,-2,1015,1592,10
52538480343,52538480341,-2,1208,1991,10
52540996429,52540996422,-7,955,5134,10
52547533726,52547533725,-1,1185,1823,10
52552915773,52552915772,-1,891,1388,10
52554156769,52554156766,-3,925,2342,10
52556264500,52556264497,-3,1108,2389,10
52557837939,52557837936,-3,771,1474,10
52558417722,52558417722,0,1259,2047,10
52562160070,52562160069,-1,1516,2362,10
52564140402,52564140399,-3,977,1551,10
52568081445,52568081443,-2,1209,1569,10
52569194488,52569194489,1,1228,2141,10
52570492789,52570492791,2,1293,1557,10
52582122905,52582122903,-2,1147,1984,10
52585403032,52585403033,1,1157,1580,10
52586150024,52586150023,-1,2273,3660,10
52591426884,52591426882,-2,1006,1821,10
52597732810,52597732810,0,965,2117,10
52599570458,52599570457,-1,1358,1405,10
52602524523,52602524523,0,1500,1597,10
52605206187,52605206181,-6,1500,2715,10
52605969713,52605969711,-2,812,1440,10
52606367210,52606367204,-6,28858,16157,10
52610222879,52610222877,-2,1075,1825,10
52612330171,52612330169,-2,816,1629,10
52613798882,52613798879,-3,933,1950,10
52613850411,52613850410,-1,1120,1928,10
52615768783,52615768800,17,1604,1610,10
52617539180,52617539178,-2,1721,1783,10
52624170566,52624170567,1,1266,1989,10
52626103790,52626103789,-1,1334,1409,10
52627283713,52627283712,-1,1314,1466,10
52628208915,52628208915,0,1186,1479,10
52632480593,52632480591,-2,1058,1952,10
52633272065,52633272065,0,1372,1649,10
52634650005,52634650002,-3,1260,2048,10
52636178003,52636177984,-19,1378,1719,10
52641056366,52641056366,0,1351,1893,10
52643812174,52643812172,-2,1527,2928,10
52644281925,52644281919,-6,1076,3541,10
52644664472,52644664471,-1,1000,2023,10
52646632246,52646632246,0,1352,2135,10
52646675765,52646675762,-3,1006,2643,10
52648794062,52648794060,-2,1059,2261,10
52649162617,52649162615,-2,965,1590,10
52650878492,52650878488,-4,1263,1765,10
52654884639,52654884641,2,1274,1982,10
52658605802,52658605802,0,1518,2470,10
52659626998,52659626997,-1,1387,1871,10
52663612699,52663612698,-1,936,1217,10
52667558261,52667558261,0,1395,2270,10
52669086390,52669086388,-2,1000,1456,10
52671655881,52671655881,0,1165,1883,10
52675440698,52675440697,-1,1170,2045,10
52681877530,52681877537,7,4413,1630,10
52682643355,52682643359,4,2119,1454,10
52684796008,52684796026,18,443,918,10
52684950476,52684950475,-1,1333,2258,10
52688776219,52688776218,-1,1423,2545,10
52689669198,52689669198,0,939,1767,10
52689854505,52689854503,-2,1356,2033,10
52692625938,52692625932,-6,1300,2953,10
52695851999,52695851998,-1,1706,2119,10
52697034094,52697034095,1,1024,2025,10
52700262927,52700262926,-1,1683,1284,10
52700660792,52700660791,-1,1121,2296,10
52703714086,52703714086,0,972,1304,10
52705428125,52705428123,-2,1113,2794,10
52707208438,52707208438,0,1137,1446,10
52708870938,52708870937,-1,1395,1633,10
52715411314,52715411310,-4,1283,2215,10
52718262909,52718262906,-3,1133,2377,10
52719634561,52719634562,1,3111,2945,10
52720183799,52720183797,-2,1202,1916,10
52721883933,52721883932,-1,1335,1977,10
52722129558,52722129556,-2,1278,2823,10
52723026000,52723026000,0,1199,1701,10
52723920023,52723920022,-1,1371,1622,10
52724179963,52724179954,-9,253,701,10
52729001366,52729001366,0,1060,2059,10
52734315109,52734315106,-3,1297,2237,10
52737068534,52737068533,-1,1732,2878,10
52737176938,52737176937,-1,1174,1610,10
52737823751,52737823750,-1,844,2114,10
52742243618,52742243618,0,1356,2136,10
52743758326,52743758325,-1,1871,2327,10
52743865383,52743865381,-2,1026,1632,10
52746874720,52746874722,2,2380,1802,10
52747233188,52747233192,4,1423,862,10
52752439134,52752439133,-1,1254,1671,10
52752866339,52752866338,-1,824,1766,10
52753762795,52753762790,-5,1127,2968,10
52754279982,52754279982,0,1273,2357,10
52757142471,52757142473,2,1587,1375,10
52759383345,52759383342,-3,776,1911,10
52759543689,52759543690,1,991,1469,10
52762967079,52762967078,-1,857,1072,10
52765391846,52765391844,-2,1420,2274,10
52766218318,52766218318,0,886,1548,10
52769356348,52769356348,0,1211,1519,10
52770773051,52770773050,-1,1097,1683,10
52771155758,52771155763,5,2137,1536,10
52772052745,52772052744,-1,734,1833,10
52773052978,52773052978,0,1455,1853,10
52774896580,52774896579,-1,1259,2315,10
52779328261,52779328258,-3,1142,1484,10
52782324171,52782324171,0,1629,2935,10
52785470923,52785470922,-1,1099,1879,10
52785534450,52785534444,-6,983,1570,10
52787808383,52787808381,-2,718,1094,10
52790907514,52790907502,-12,721,1324,10
52794389890,52794389889,-1,1128,2160,10
52800769752,52800769756,4,2224,1465,10
52801207569,52801207568,-1,1541,1906,10
52808553279,52808553274,-5,721,1929,10
52810355367,52810355365,-2,1160,2650,10
52810916892,52810916891,-1,1346,2174,10
52813857235,52813857235,0,1534,1795,10
52815309491,52815309488,-3,883,1317,10
52822088971,52822088980,9,14857,25127,10
52825396602,52825396601,-1,1233,1712,10
52827739106,52827739105,-1,1359,1629,10
52828638954,52828638958,4,1267,2061,10
52833936170,52833936168,-2,969,1652,10
52846822734,52846822730,-4,1017,2198,10
52848336318,52848336316,-2,962,2203,10
52852160490,52852160489,-1,1102,1790,10
52856163179,52856163174,-5,2128,5858,10
52856504759,52856504757,-2,1024,2091,10
52857915359,52857915355,-4,1103,3005,10
52865519492,52865519490,-2,1274,1855,10
52866268276,52866268275,-1,1071,1557,10
52868177884,52868177890,6,4796,2313,10
52873754128,52873754126,-2,18842,16140,10
52875159067,52875159066,-1,1123,1551,10
52876261128,52876261126,-2,1318,2247,10
52876825641,52876825638,-3,1040,1977,10
52877156200,52877156210,10,12216,36655,10
52879377362,52879377362,0,997,1161,10
52881958688,52881958685,-3,1323,1977,10
52883910990,52883910990,0,1689,2071,10
52898451726,52898451745,19,1649,3659,10
52900333053,52900333052,-1,1234,1965,10
52900675228,52900675225,-3,899,1644,10
52902784339,52902784337,-2,740,1988,10
52904073765,52904073766,1,1118,1321,10
52906033001,52906033000,-1,1867,2781,10
52907264391,52907264390,-1,979,1843,10
52909444606,52909444605,-1,863,1827,10
52910442117,52910442116,-1,1309,2418,10
52913113383,52913113385,2,1080,1796,10
52917919341,52917919341,0,1522,1798,10
52921509474,52921509470,-4,1218,1960,10
52922503970,52922503965,-5,1222,3308,10
52924591297,52924591294,-3,1298,3358,10
52925471230,52925471227,-3,1169,2828,10
52930147585,52930147584,-1,1226,1408,10
52930206313,52930206318,5,1233,1096,10
52932858610,52932858608,-2,1106,1802,10
52935341363,52935341360,-3,904,1824,10
52939883775,52939883773,-2,1321,2340,10
52942444309,52942444306,-3,1386,2708,10
52963923191,52963923190,-1,1135,1294,10
52967043823,52967043821,-2,986,1431,10
52967310590,52967310590,0,1153,1725,10
52969101270,52969101265,-5,1861,6212,10
52969695237,52969695235,-2,1259,1865,10
52973101635,52973101634,-1,1136,1309,10
52974497187,52974497188,1,1000,1930,10
52975183864,52975183862,-2,1328,2101,10
52975783411,52975783410,-1,1067,1439,10
52977405876,52977405881,5,3009,1412,10
52980722046,52980722045,-1,1380,2262,10
52981814199,52981814197,-2,1395,2188,10
52986440881,52986440878,-3,1035,1819,10
52989705581,52989705579,-2,1239,2172,10
52989882739,52989882736,-3,1487,1807,10
52992955706,52992955707,1,1402,1369,10
52993366768,52993366766,-2,1493,1856,10
52995590606,52995590606,0,1825,2061,10
52997985386,52997985387,1,971,1143,10
53000716184,53000716182,-2,719,1364,10
53002546417,53002546417,0,1240,1432,10
53007574338,53007574340,2,8685,6731,10
53008183129,53008183126,-3,899,1302,10
53008655917,53008655916,-1,1516,1611,10
53009083242,53009083241,-1,1016,1396,10
53010335921,53010335920,-1,1129,2151,10
53011228466,53011228464,-2,1025,2163,10
53014006937,53014006935,-2,1376,2257,10
53015410875,53015410874,-1,1078,1589,10
53019228289,53019228299,10,17885,21732,10
53019947451,53019947450,-1,1089,1227,10
53020278709,53020278705,-4,1285,2422,10
53020860137,53020860138,1,1445,1930,10
53024429598,53024429598,0,1058,1588,10
53025609982,53025609982,0,1720,1522,10
53028231170,53028231170,0,1361,2189,10
53033013588,53033013588,0,2024,3542,10
53037025351,53037025350,-1,953,1380,10
53037465002,53037465002,0,881,1349,10
53038081967,53038081965,-2,821,1033,10
53041803049,53041803046,-3,1365,1740,10
53043985954,53043985954,0,877,1759,10
53047340358,53047340357,-1,1179,2061,10
53055054479,53055054479,0,1093,1802,10
53059074131,53059074130,-1,1330,1902,10
53062831174,53062831173,-1,1051,2171,10
53063050024,53063050046,22,714,1802,10
53064904475,53064904474,-1,1142,1994,10
53065790266,53065790264,-2,1420,2324,10
53066307701,53066307703,2,1545,1328,10
53067410631,53067410635,4,2026,1255,10
53068886173,53068886171,-2,1269,1824,10
53070142026,53070142022,-4,1312,3013,10
53071638282,53071638280,-2,1084,1292,10
53071948502,53071948498,-4,1922,2319,10
53072784478,53072784477,-1,1486,2185,10
53073331837,53073331838,1,1391,1411,10
53075436986,53075436986,0,11281,11693,10
53079484427,53079484426,-1,1605,2017,10
53081913835,53081913834,-1,960,1881,10
53084845706,53084845705,-1,1048,2231,10
53086685147,53086685145,-2,1451,1940,10
53087878794,53087878791,-3,1024,1999,10
53089116091,53089116088,-3,769,1951,10
53091373463,53091373466,3,1540,1882,10
53092650153,53092650153,0,1388,2294,10
53094775411,53094775410,-1,1458,2018,10
53095778722,53095778719,-3,892,1519,10
53100663475,53100663474,-1,1205,1931,10
53111489316,53111489321,5,3487,2607,10
53112196827,53112196821,-6,1548,7150,10
53112283913,53112283908,-5,2477,8140,10
53113136530,53113136538,8,11061,26085,10
53114846257,53114846254,-3,1460,2124,10
53116032555,53116032574,19,657,1057,10
53117009460,53117009459,-1,1642,2536,10
53117518971,53117518967,-4,1132,1956,10
53118507686,53118507685,-1,1228,1813,10
53119193624,53119193645,21,901,1577,10
53123461415,53123461413,-2,1626,2650,10
53130705502,53130705499,-3,978,1956,10
53131183546,53131183543,-3,1211,1773,10
53133262942,53133262942,0,1392,1852,10
53136169449,53136169446,-3,1251,2300,10
53140648343,53140648341,-2,704,1679,10
53142279251,53142279249,-2,1700,2508,10
53144546578,53144546578,0,1211,2316,10
53145265346,53145265342,-4,970,1713,10
53147350238,53147350239,1,1068,1583,10
53148984271,53148984270,-1,1067,1376,10
53149982956,53149982954,-2,822,1293,10
53151508287,53151508285,-2,1730,2652,10
53153816713,53153816711,-2,858,1325,10
53155617631,53155617631,0,1042,2122,10
53157074069,53157074068,-1,950,2127,10
53159867920,53159867920,0,1103,1863,10
53163215541,53163215542,1,1408,2249,10
53166977087,53166977086,-1,2095,2655,10
53171439246,53171439244,-2,1093,2264,10
53171612558,53171612556,-2,1470,2045,10
53173842944,53173842946,2,1246,472,10
53178336450,53178336450,0,1208,2064,10
53186661574,53186661572,-2,1497,2695,10
53187284499,53187284497,-2,1353,2052,10
53190307656,53190307659,3,2674,2030,10
53192415101,53192415098,-3,1180,2565,10
53194297038,53194297038,0,1765,2520,10
53196039074,53196039072,-2,841,1756,10
53202859050,53202859048,-2,1254,2182,10
53203234624,53203234646,22,789,1098,10
53204807127,53204807126,-1,1424,2139,10
53208571717,53208571719,2,654,1379,10
53209788049,53209788045,-4,1079,2943,10
53212368314,53212368314,0,951,1751,10
53214123678,53214123676,-2,1493,1695,10
53216382402,53216382401,-1,973,2302,10
53217694337,53217694333,-4,1368,2388,10
53219469938,53219469933,-5,910,3072,10
53221709805,53221709803,-2,1371,1954,10
53225454319,53225454317,-2,889,2153,10
53227610339,53227610338,-1,1038,1863,10
53232434883,53232434883,0,1256,2320,10
53238531903,53238531902,-1,1191,1541,10
53239214742,53239214741,-1,1298,2326,10
53242397246,53242397242,-4,797,3381,10
53245006783,53245006782,-1,1133,2126,10
53245188752,53245188757,5,2429,1239,10
53245258250,53245258249,-1,1400,1781,10
53245951484,53245951482,-2,1256,2523,10
53253396085,53253396084,-1,1718,2120,10
53254221543,53254221541,-2,1635,2541,10
53255541444,53255541444,0,1106,2061,10
53262699476,53262699475,-1,1201,1533,10
53273966897,53273966897,0,1072,1509,10
53274578758,53274578763,5,2685,1089,10
53276279330,53276279328,-2,841,1517,10
53279712796,53279712794,-2,1602,2260,10
53281786803,53281786801,-2,1522,2576,10
53284074779,53284074778,-1,1329,2084,10
53285957814,53285957811,-3,1118,1746,10
53287850358,53287850356,-2,885,2880,10
53289947918,53289947917,-1,1153,2117,10
53290129664,53290129658,-6,941,1399,10
53291118980,53291118974,-6,2101,7213,10
53299931342,53299931341,-1,1156,1469,10
53304089577,53304089575,-2,912,1619,10
53307606381,53307606378,-3,962,2143,10
53309192754,53309192754,0,1092,1596,10
53309773117,53309773117,0,1421,1553,10
53310122937,53310122934,-3,1190,2382,10
53318119739,53318119739,0,1322,2503,10
53319511478,53319511477,-1,966,1851,10
53320610363,53320610358,-5,812,1246,10
53321220821,53321220821,0,1173,2469,10
53321249880,53321249878,-2,1154,1711,10
53322445058,53322445058,0,1377,2257,10
53323316382,53323316381,-1,903,1714,10
53325271887,53325271886,-1,955,1726,10
53326658858,53326658856,-2,1276,2223,10
53328143553,53328143553,0,822,2169,10
53330445944,53330445942,-2,1212,2059,10
53330776257,53330776255,-2,1513,2483,10
53332229966,53332229964,-2,1146,1840,10
53334542491,53334542485,-6,1018,3313,10
53344583498,53344583497,-1,1256,1903,10
53344884394,53344884391,-3,1111,1274,10
53348773246,53348773245,-1,1407,2219,10
53365214418,53365214417,-1,2348,3354,10
53365386470,53365386467,-3,1525,2223,10
53367516390,53367516387,-3,1016,2025,10
53369723938,53369723935,-3,1163,2590,10
53373483645,53373483650,5,1997,1507,10
53373912060,53373912060,0,1147,1727,10
53375655417,53375655414,-3,1340,2411,10
53376747755,53376747754,-1,640,1532,10
53379269970,53379269970,0,1301,1803,10
53382879471,53382879470,-1,1487,1865,10
53382963760,53382963755,-5,1400,2680,10
53383409211,53383409210,-1,661,1141,10
53384971431,53384971425,-6,597,1906,10
53394763792,53394763793,1,1111,1644,10
53398524087,53398524086,-1,1225,2140,10
53398821667,53398821668,1,21861,32474,10
53400200727,53400200726,-1,1186,1859,10
53408055925,53408055925,0,1444,2053,10
53419202188,53419202184,-4,1436,2253,10
53420192299,53420192298,-1,1234,1325,10
53427337867,53427337881,14,17088,19473,10
53436246327,53436246332,5,2012,1325,10
53438439042,53438439041,-1,1072,1290,10
53440928442,53440928438,-4,1622,2882,10
53441432786,53441432783,-3,1478,2162,10
53441934641,53441934637,-4,1113,1561,10
53444539256,53444539258,2,2716,1294,10
53444722004,53444722002,-2,1356,2062,10
53444861551,53444861550,-1,1212,1890,10
53449302312,53449302298,-14,1236,1312,10
53449843345,53449843326,-19,520,1142,10
53451992315,53451992311,-4,1290,1909,10
53452289726,53452289725,-1,1104,1778,10
53454354886,53454354886,0,1594,2562,10
53456841397,53456841396,-1,1362,1530,10
53458183510,53458183510,0,1172,1147,10
53459689627,53459689624,-3,1059,1502,10
53463151653,53463151650,-3,1366,2194,10
53463923718,53463923717,-1,948,2254,10
53466522729,53466522729,0,1116,1370,10
53469559729,53469559728,-1,1269,1408,10
53469922210,53469922209,-1,1450,2822,10
53471651910,53471651909,-1,1349,2044,10
53474547177,53474547175,-2,880,2164,10
53475401133,53475401137,4,1829,1313,10
53479502022,53479502022,0,1242,2692,10
53487297281,53487297278,-3,1071,1629,10
53493910497,53493910496,-1,1123,2437,10
53495485418,53495485418,0,822,1332,10
53495676439,53495676434,-5,1332,5434,10
53496263115,53496263114,-1,1442,2664,10
53499995446,53499995444,-2,1296,1186,10
53505375739,53505375740,1,1396,1063,10
53507612911,53507612909,-2,1258,1552,10
53507990173,53507990181,8,4255,1069,10
53510727923,53510727927,4,2065,1289,10
53511014262,53511014266,4,3805,2653,10
53511104745,53511104746,1,1174,1511,10
53515146731,53515146730,-1,1294,2894,10
53520804138,53520804135,-3,748,1480,10
53525653838,53525653839,1,921,1985,10
53525995006,53525995005,-1,1139,1810,10
53531549771,53531549771,0,1238,2057,10
53535006656,53535006658,2,1770,1997,10
53535160562,53535160559,-3,1056,1567,10
53546164302,53546164296,-6,1095,3634,10
53546432161,53546432162,1,1469,2406,10
53550133671,53550133670,-1,1420,1811,10
53550318444,53550318442,-2,1357,2277,10
53552578878,53552578883,5,672,1175,10
53556609231,53556609229,-2,1505,2907,10
53559098414,53559098415,1,1349,1899,10
53559695253,53559695254,1,1186,1447,10
53563209759,53563209741,-18,1038,1606,10
53565647928,53565647923,-5,933,1644,10
53565904347,53565904346,-1,1352,2078,10
53569170595,53569170595,0,818,793,10
53569541319,53569541320,1,1328,1460,10
53574725206,53574725206,0,1234,1607,10
53575437329,53575437328,-1,926,1773,10
53576173386,53576173385,-1,1250,2021,10
53580890714,53580890718,4,2265,1384,10
53582966051,53582966068,17,1168,1392,10
53584973753,53584973750,-3,1319,3079,10
53585037905,53585037894,-11,1154,1930,10
53588243005,53588243003,-2,1722,2292,10
53589184650,53589184650,0,1042,1400,10
53589222653,53589222650,-3,1198,2113,10
53589681205,53589681203,-2,1389,2724,10
53589942605,53589942603,-2,1069,2487,10
53592474517,53592474517,0,1216,2185,10
53593309639,53593309638,-1,948,1539,10
53596983419,53596983415,-4,808,3469,10
53597518162,53597518161,-1,1492,1949,10
53599902440,53599902437,-3,1292,2545,10
53601745484,53601745481,-3,1403,2056,10
53605023329,53605023328,-1,1016,1961,10
53605607082,53605607081,-1,1097,2421,10
53605710463,53605710461,-2,989,2254,10
53608255095,53608255093,-2,938,1139,10
53611007912,53611007910,-2,833,1493,10
53612584430,53612584430,0,1021,1702,10
53612832800,53612832798,-2,1445,2969,10
53618230095,53618230093,-2,1425,2340,10
53620551432,53620551429,-3,1672,4829,10
53624261367,53624261378,11,11628,42530,10
53626857834,53626857833,-1,1568,2325,10
53627382990,53627382989,-1,1162,1580,10
53629645131,53629645130,-1,1030,1616,10
53632797855,53632797854,-1,694,1450,10
53634758088,53634758087,-1,1178,2373,10
53636217945,53636217943,-2,1185,2093,10
53638445262,53638445257,-5,1943,7146,10
53640427697,53640427697,0,1034,2140,10
53641649295,53641649294,-1,919,1111,10
53654848377,53654848377,0,819,1527,10
53656667042,53656667042,0,865,1647,10
53658926106,53658926104,-2,1644,2349,10
53659724741,53659724739,-2,1076,1896,10
53661965301,53661965300,-1,1007,1727,10
53663482194,53663482192,-2,1267,2124,10
53663697174,53663697173,-1,1441,1828,10
53666563910,53666563909,-1,1643,2118,10
53666593963,53666593961,-2,1148,1803,10
53670125344,53670125341,-3,1383,2465,10
53673826190,53673826187,-3,611,1391,10
53674392329,53674392325,-4,803,2236,10
53675120182,53675120186,4,12769,10289,10
53678254232,53678254231,-1,1199,2414,10
53683556054,53683556055,1,647,1689,10
53684432522,53684432521,-1,1293,2043,10
53686815452,53686815451,-1,1215,1346,10
53688387511,53688387508,-3,2168,3588,10
53691649095,53691649092,-3,575,184,10
53694558617,53694558618,1,1353,1084,10
53695564949,53695564949,0,1484,1847,10
53696017132,53696017126,-6,1318,4447,10
53697738912,53697738908,-4,1065,2732,10
53700513083,53700513082,-1,1424,2532,10
53700708281,53700708278,-3,798,1798,10
53704072246,53704072243,-3,1445,1537,10
53704811277,53704811278,1,1321,2025,10
53711062503,53711062500,-3,1827,2057,10
53714395519,53714395518,-1,1506,2498,10
53717583566,53717583566,0,816,1708,10
53718793939,53718793946,7,17025,15633,10
53720442858,53720442858,0,784,1458,10
53722209507,53722209504,-3,1541,1936,10
53724533382,53724533382,0,1587,2204,10
53724574033,53724574033,0,1374,2780,10
53728380364,53728380362,-2,1655,1908,10
53731601127,53731601126,-1,1158,2331,10
53731889258,53731889255,-3,1692,2866,10
53737279282,53737279281,-1,1549,1656,10
53738254454,53738254462,8,1006,1551,10
53739467150,53739467149,-1,3735,6883,10
53743716890,53743716890,0,1281,1472,10
53749383215,53749383212,-3,1048,2050,10
53759677435,53759677433,-2,1188,2670,10
53759844705,53759844705,0,1206,1714,10
53760649290,53760649289,-1,1492,2094,10
53766451237,53766451233,-4,1189,1967,10
53778402015,53778402016,1,944,1705,10
53779386079,53779386074,-5,2258,6206,10
53783440825,53783440829,4,3286,1414,10
53784248922,53784248919,-3,917,2104,10
53785350079,53785350078,-1,1373,1437,10
53788561740,53788561738,-2,1132,2426,10
53788993597,53788993595,-2,1208,2508,10
53791320281,53791320282,1,1086,2315,10
53794061837,53794061834,-3,1222,1825,10
53795118786,53795118782,-4,763,1282,10
53796743179,53796743178,-1,1485,1510,10
53809528389,53809528387,-2,1390,1858,10
53810480238,53810480235,-3,1185,2509,10
53812184086,53812184081,-5,656,2912,10
53814424687,53814424686,-1,1307,2130,10
53818717142,53818717141,-1,1201,1872,10
53819512332,53819512337,5,10776,5718,10
53819765343,53819765341,-2,1223,1571,10
53819822927,53819822926,-1,1100,1268,10
53820735825,53820735825,0,1181,2164,10
53825410693,53825410697,4,1750,2349,10
53826139203,53826139195,-8,922,2085,10
53827635083,53827635081,-2,1007,2160,10
53831018682,53831018681,-1,1504,2756,10
53831552350,53831552350,0,1024,1944,10
53831922655,53831922654,-1,1107,1793,10
53833047776,53833047775,-1,1194,2007,10
53835795075,53835795073,-2,723,1553,10
53835891739,53835891737,-2,1653,1675,10
53843308352,53843308349,-3,2246,5174,10
53844329913,53844329912,-1,1071,2044,10
53847741345,53847741343,-2,1711,3471,10
53848977226,53848977225,-1,1147,1350,10
53856648735,53856648732,-3,814,1451,10
53862082831,53862082830,-1,1003,1612,10
53863253127,53863253126,-1,1692,2403,10
53868977318,53868977318,0,480,635,10
53871634355,53871634355,0,1411,2372,10
53873064408,53873064406,-2,1271,2054,10
53875817309,53875817308,-1,1044,1984,10
53887180548,53887180547,-1,1190,1870,10
53887414380,53887414398,18,722,1000,10
53891608818,53891608817,-1,1315,1954,10
53892864339,53892864337,-2,1197,1740,10
53894994146,53894994145,-1,1711,2247,10
53897778214,53897778214,0,1096,1632,10
53903906801,53903906798,-3,1205,1820,10
53904575873,53904575872,-1,1443,2732,10
53909145146,53909145146,0,916,1475,10
53911220094,53911220093,-1,1026,1465,10
53911889737,53911889758,21,866,2299,10
53915791457,53915791454,-3,931,1637,10
53918996204,53918996203,-1,1647,2856,10
53920454743,53920454740,-3,1085,1881,10
53922247166,53922247166,0,1262,2455,10
53924038139,53924038138,-1,1030,1571,10
53925081218,53925081217,-1,1100,2301,10
53929816388,53929816389,1,1002,1945,10
53930578664,53930578661,-3,1128,1571,10
53937924510,53937924506,-4,841,2217,10
53939703537,53939703536,-1,1136,1683,10
53941762206,53941762204,-2,1655,1866,10
53942421399,53942421403,4,2415,2736,10
53946874743,53946874742,-1,1470,2039,10
53947090529,53947090527,-2,1057,2240,10
53948600213,53948600210,-3,1044,2566,10
53949202618,53949202617,-1,1296,1545,10
53960319647,53960319646,-1,970,2087,10
53962283678,53962283699,21,379,862,10
53964506922,53964506917,-5,1649,3184,10
53965046703,53965046706,3,1920,1902,10
53968198355,53968198355,0,833,2153,10
53970262950,53970262949,-1,1298,1459,10
53971717083,53971717083,0,1204,2068,10
53973161747,53973161746,-1,978,1222,10
53986021824,53986021827,3,28049,28635,10
53986920397,53986920397,0,1802,2613,10
53987692977,53987692973,-4,870,2824,10
53989962498,53989962495,-3,1172,1806,10
53990024789,53990024787,-2,1450,2201,10
53992587374,53992587375,1,1770,2165,10
53997322137,53997322135,-2,1388,2088,10
54011221665,54011221663,-2,1161,1553,10
54019586481,54019586478,-3,1391,1699,10
54020696938,54020696939,1,981,1329,10
54024043461,54024043461,0,1162,1312,10
54029013457,54029013455,-2,1147,1728,10
54032174606,54032174607,1,1476,1866,10
54032338570,54032338566,-4,1313,2013,10
54032539232,54032539218,-14,331,832,10
54032972744,54032972763,19,527,1191,10
54033118574,54033118575,1,1189,1908,10
54034604081,54034604086,5,2368,1460,10
54034645445,54034645445,0,1795,2235,10
54035041067,54035041064,-3,1444,2363,10
54036100885,54036100883,-2,1574,2786,10
54036688616,54036688639,23,1242,1178,10
54039208586,54039208585,-1,667,1296,10
54043131950,54043131949,-1,1342,1724,10
54044968385,54044968382,-3,1289,1857,10
54046803574,54046803574,0,1318,2061,10
54048072857,54048072856,-1,1868,2551,10
54050221239,54050221234,-5,727,2245,10
54054071262,54054071260,-2,1095,2050,10
54055922377,54055922374,-3,547,1370,10
54056490915,54056490914,-1,1275,1629,10
54057025288,54057025286,-2,1573,2479,10
54058530234,54058530235,1,1040,2269,10
54061367450,54061367448,-2,1722,1822,10
54063123401,54063123399,-2,1312,2021,10
54066915518,54066915517,-1,878,1348,10
54071774438,54071774433,-5,1377,2174,10
54075308527,54075308523,-4,808,1909,10
54078218775,54078218775,0,1460,2416,10
54082392650,54082392645,-5,1052,2076,10
54083613359,54083613359,0,1049,1982,10
54085050349,54085050347,-2,1567,3069,10
54085683211,54085683210,-1,1118,1648,10
54086003486,54086003486,0,1246,1378,10
54086778117,54086778114,-3,1511,1991,10
54089232681,54089232679,-2,1711,2303,10
54089260210,54089260202,-8,1104,2084,10
54089630796,54089630813,17,1267,2082,10
54091073038,54091073037,-1,749,1481,10
54093532155,54093532155,0,1075,1582,10
54094364050,54094364049,-1,1153,2948,10
54096925522,54096925523,1,936,2140,10
54099553169,54099553169,0,1032,1455,10
54100600059,54100600057,-2,1112,2379,10
54100744694,54100744694,0,1361,1747,10
54106113738,54106113736,-2,649,1477,10
54106386402,54106386422,20,1277,1945,10
54108442880,54108442879,-1,1231,2098,10
54108501906,54108501904,-2,1173,2053,10
54108543081,54108543080,-1,1343,2395,10
54111896747,54111896746,-1,1617,1563,10
54113416887,54113416887,0,1197,1668,10
54113941468,54113941467,-1,1041,1878,10
54115652414,54115652413,-1,1799,2452,10
54116252462,54116252459,-3,919,1821,10
54123232309,54123232310,1,1235,1794,10
54123682622,54123682621,-1,958,1928,10
54124597464,54124597446,-18,1175,1482,10
54130155193,54130155190,-3,1006,2024,10
54131965710,54131965709,-1,1316,2733,10
54133022274,54133022271,-3,980,1858,10
54133671391,54133671389,-2,1443,2323,10
54134989982,54134989980,-2,1119,1799,10
54135843171,54135843170,-1,1334,2581,10
54137273322,54137273321,-1,1719,2594,10
54137682510,54137682509,-1,966,1252,10
54140809394,54140809393,-1,1176,2818,10
54141178149,54141178154,5,4939,2339,10
54141328457,54141328459,2,1362,931,10
54145533715,54145533715,0,1503,1736,10
54147243293,54147243292,-1,1254,1692,10
54147795906,54147795906,0,1368,1574,10
54151838013,54151838010,-3,794,2008,10
54154834214,54154834214,0,622,1633,10
54166124495,54166124495,0,935,1243,10
54168558118,54168558117,-1,1452,1987,10
54169143019,54169143038,19,1538,1197,10
54173812612,54173812611,-1,1383,1760,10
54178368297,54178368281,-16,231,787,10
54179904998,54179904998,0,1151,1882,10
54182393303,54182393303,0,1292,1243,10
54183073286,54183073285,-1,1222,2172,10
54189596398,54189596394,-4,1310,2423,10
54191806243,54191806243,0,1280,1695,10
54210856591,54210856590,-1,1328,1634,10
54210929057,54210929056,-1,1526,2791,10
54213057766,54213057763,-3,1475,2143,10
54220196659,54220196659,0,1086,1569,10
54225811302,54225811301,-1,1582,2362,10
54225886025,54225886024,-1,1431,1917,10
54227752026,54227752025,-1,1034,1554,10
54231441242,54231441239,-3,1591,1391,10
54232620267,54232620263,-4,1246,1076,10
54242770395,54242770397,2,1241,2147,10
54245186303,54245186301,-2,1130,1411,10
54249152731,54249152730,-1,1005,2055,10
54249743845,54249743850,5,1430,1346,10
54254698830,54254698829,-1,672,1321,10
54257156345,54257156343,-2,805,1313,10
54257879323,54257879325,2,1011,876,10
54263538050,54263538049,-1,1108,1631,10
54265386013,54265386012,-1,722,1655,10
54271868109,54271868108,-1,1044,2089,10
54274517875,54274517868,-7,28520,12537,10
54274580570,54274580575,5,1302,1437,10
54277386813,54277386811,-2,1191,2406,10
54278584415,54278584415,0,1147,2010,10
54280237789,54280237786,-3,1220,1513,10
54285091701,54285091699,-2,1641,2250,10
54286437082,54286437082,0,952,1073,10
54291060329,54291060325,-4,1308,1709,10
54299826638,54299826634,-4,1310,2399,10
54308568969,54308568971,2,1535,2009,10
54309572774,54309572774,0,1565,2547,10
54310349103,54310349098,-5,2448,5090,10
54310629691,54310629692,1,1962,2541,10
54312639108,54312639108,0,1202,2150,10
54315440903,54315440900,-3,1458,1774,10
54316699505,54316699503,-2,1377,1699,10
54317763002,54317763001,-1,1166,2167,10
54320183657,54320183650,-7,1848,6241,10
54322700869,54322700862,-7,2587,7937,10
54325685143,54325685142,-1,787,1507,10
54326076215,54326076213,-2,1322,1827,10
54327737354,54327737350,-4,1130,1772,10
54328463824,54328463822,-2,1783,2836,10
54335918638,54335918637,-1,940,2350,10
54339542674,54339542672,-2,1154,2109,10
54340900176,54340900174,-2,1119,2216,10
54345188899,54345188897,-2,1234,2275,10
54346001378,54346001377,-1,1193,2411,10
54347773569,54347773563,-6,1025,3204,10
54348144046,54348144046,0,1229,1394,10
54350200717,54350200722,5,4934,2838,10
54357815633,54357815632,-1,1228,2032,10
54361623426,54361623425,-1,975,1498,10
54363160046,54363160044,-2,5687,10318,10
54363317331,54363317329,-2,1321,2384,10
54364027334,54364027332,-2,1299,2021,10
54365199134,54365199129,-5,1245,3363,10
54365778165,54365778162,-3,1228,2116,10
54369958562,54369958557,-5,778,2014,10
54373061299,54373061297,-2,1117,1445,10
54373917322,54373917319,-3,1686,1984,10
54380146294,54380146294,0,1685,2507,10
54383321416,54383321422,6,2701,1411,10
54385165510,54385165510,0,1701,1472,10
54386037895,54386037893,-2,1017,1739,10
54387585733,54387585723,-10,22129,12912,10
54390474810,54390474808,-2,1194,1998,10
54393565777,54393565776,-1,1102,1351,10
54396077562,54396077560,-2,1766,2514,10
54396595178,54396595177,-1,1387,1434,10
54407595226,54407595221,-5,601,1360,10
54409334838,54409334836,-2,1347,2237,10
54410515986,54410515987,1,1053,1796,10
54410898327,54410898324,-3,916,1670,10
54411420785,54411420784,-1,2031,3224,10
54413126587,54413126585,-2,1383,2263,10
54414715491,54414715489,-2,2365,3787,10
54417794397,54417794396,-1,1925,2107,10
54418023339,54418023338,-1,1312,2181,10
54418144528,54418144526,-2,1373,2628,10
54419914467,54419914466,-1,1506,1841,10
54420682310,54420682307,-3,643,1737,10
54424548485,54424548486,1,1322,2608,10
54427471755,54427471753,-2,1288,2019,10
54431631693,54431631691,-2,1224,2650,10
54433029962,54433029958,-4,24447,14813,10
54434842498,54434842498,0,929,1769,10
54437261760,54437261758,-2,773,1450,10
54440170114,54440170113,-1,1125,1972,10
54444621428,54444621426,-2,1138,1937,10
54444926390,54444926390,0,1434,1921,10
54445048194,54445048195,1,1065,2083,10
54446807369,54446807391,22,312,872,10
54447220159,54447220158,-1,913,1434,10
54448140974,54448140974,0,1580,2667,10
54448355737,54448355742,5,1944,1483,10
54451121464,54451121463,-1,1174,1486,10
54454098728,54454098726,-2,1046,1822,10
54456757788,54456757787,-1,858,2169,10
54462145860,54462145861,1,1090,1503,10
54463471766,54463471766,0,1201,1352,10
54463712844,54463712863,19,1171,1488,10
54464662691,54464662690,-1,1169,1586,10
54470013162,54470013158,-4,1143,1652,10
54470385673,54470385673,0,810,1521,10
54470415312,54470415296,-16,1420,1919,10
54471685280,54471685278,-2,1133,2209,10
54474038590,54474038590,0,953,1186,10
54474713151,54474713151,0,898,1462,10
54474920675,54474920695,20,1564,2928,10
54476386172,54476386171,-1,1375,1501,10
54480781384,54480781385,1,1281,1516,10
54485587745,54485587743,-2,950,1681,10
54487475833,54487475833,0,1723,1632,10
54490174833,54490174833,0,1438,2020,10
54490577062,54490577061,-1,1350,1793,10
54490961923,54490961922,-1,879,1914,10
54493173265,54493173262,-3,1170,2298,10
54493543044,54493543042,-2,1577,2351,10
54503114363,54503114361,-2,37701,21820,10
54503342822,54503342822,0,1492,1747,10
54509161093,54509161093,0,702,1067,10
54510129275,54510129271,-4,703,1119,10
54511129447,54511129446,-1,1075,1433,10
54511801939,54511801937,-2,971,1794,10
54512169905,54512169902,-3,1242,1355,10
54512643070,54512643067,-3,991,1863,10
54512764768,54512764765,-3,1391,2165,10
54514342138,54514342137,-1,1190,1964,10
54514623302,54514623301,-1,1221,2479,10
54515183080,54515183081,1,1124,1898,10
54517045319,54517045318,-1,1419,2846,10
54517384835,54517384833,-2,1124,1604,10
54518437479,54518437477,-2,1410,1873,10
54518664015,54518664011,-4,1303,1512,10
54519711462,54519711460,-2,961,1460,10
54522787559,54522787557,-2,1058,2042,10
54522919673,54522919695,22,982,2089,10
54523229843,54523229842,-1,939,2305,10
54524269232,54524269231,-1,1131,1594,10
54528977488,54528977485,-3,733,1206,10
54529712707,54529712706,-1,1018,1775,10
54535458374,54535458373,-1,1111,1571,10
54535792435,54535792434,-1,659,1453,10
54536122797,54536122796,-1,1452,1906,10
54537091831,54537091831,0,1145,2007,10
54538893439,54538893434,-5,1269,3430,10
54540772351,54540772350,-1,1406,2692,10
54541588865,54541588865,0,1505,2781,10
54542023338,54542023337,-1,1409,2288,10
54546704518,54546704519,1,1370,2175,10
54549348528,54549348525,-3,1457,2253,10
54550711136,54550711132,-4,1234,3579,10
54551245846,54551245845,-1,1377,2539,10
54552299962,54552299962,0,1225,1671,10
54555028594,54555028594,0,1593,1956,10
54556377898,54556377918,20,1253,1816,10
54558394458,54558394457,-1,1356,1412,10
54560432831,54560432829,-2,1443,3682,10
54578855379,54578855376,-3,788,1358,10
54581573050,54581573048,-2,974,2031,10
54584327193,54584327191,-2,829,1482,10
54587137512,54587137506,-6,1312,3465,10
54591244103,54591244104,1,901,914,10
54591804737,54591804735,-2,1395,1485,10
54593778701,54593778714,13,755,1133,10
54595570578,54595570583,5,1450,735,10
54597604330,54597604329,-1,996,2300,10
54598270834,54598270821,-13,1127,1676,10
54598725419,54598725396,-23,1061,2210,10
54598939219,54598939218,-1,1189,2088,10
54600013802,54600013802,0,1565,1921,10
54603363499,54603363498,-1,740,1876,10
54604505373,54604505373,0,1099,1302,10
54607165150,54607165151,1,1296,1597,10
54612256988,54612256980,-8,1050,1701,10
54613962637,54613962637,0,1162,2456,10
54621018415,54621018414,-1,1469,2678,10
54624152625,54624152626,1,1152,1782,10
54625059957,54625059955,-2,1281,2035,10
54625325430,54625325426,-4,1479,2317,10
54627055395,54627055396,1,1040,1590,10
54633195775,54633195776,1,1119,2123,10
54635347466,54635347465,-1,1305,2259,10
54639166890,54639166871,-19,1113,2497,10
54640765511,54640765512,1,803,1103,10
54648333046,54648333052,6,1177,1314,10
54650831201,54650831201,0,1484,1263,10
54654145573,54654145571,-2,1276,1526,10
54655045242,54655045241,-1,856,2073,10
54656284068,54656284065,-3,1572,1813,10
54659185445,54659185443,-2,782,1620,10
54660885199,54660885197,-2,707,1171,10
54661464781,54661464780,-1,1415,1781,10
54661570354,54661570354,0,1478,1716,10
54662846283,54662846279,-4,1903,2470,10
54662894935,54662894937,2,3054,2366,10
54672626621,54672626621,0,1219,1967,10
54674637187,54674637189,2,1480,1495,10
54678859847,54678859846,-1,1410,1502,10
54682518118,54682518117,-1,1415,2402,10
54683407558,54683407557,-1,926,1930,10
54684080024,54684080019,-5,1510,3944,10
54687375038,54687375035,-3,1019,1707,10
54691166989,54691166987,-2,32294,57646,10
54691728786,54691728784,-2,1663,2642,10
54692295596,54692295594,-2,1088,1887,10
54694184938,54694184937,-1,1643,2297,10
54698668217,54698668215,-2,1097,2241,10
54699626254,54699626254,0,830,1282,10
54701814547,54701814556,9,1137,1807,10
54703437374,54703437371,-3,1017,1653,10
54706336643,54706336650,7,1755,909,10
54709077226,54709077225,-1,766,1457,10
54709624071,54709624070,-1,1627,2182,10
54712557619,54712557615,-4,1207,2457,10
54719816751,54719816750,-1,1560,2775,10
54721591712,54721591710,-2,1180,1904,10
54722309960,54722309983,23,1171,1422,10
54722810082,54722810100,18,1109,1560,10
54723541641,54723541641,0,1619,1867,10
54728370945,54728370944,-1,1319,2371,10
54729194264,54729194259,-5,2673,4484,10
54734902438,54734902442,4,2399,2900,10
54737390034,54737390034,0,1032,2003,10
54739130252,54739130252,0,738,1400,10
54741522845,54741522839,-6,1428,2194,10
54741941967,54741941968,1,871,1832,10
54743602294,54743602288,-6,1177,3083,10
54745736702,54745736699,-3,868,2015,10
54746525938,54746525939,1,1309,1506,10
54747152302,54747152301,-1,1389,2270,10
54749091188,54749091205,17,1146,2100,10
54749880642,54749880641,-1,1363,2209,10
54751907770,54751907767,-3,1117,1943,10
54752454267,54752454267,0,1312,1577,10
54755658838,54755658835,-3,1216,1784,10
54757034491,54757034486,-5,901,2319,10
54762054749,54762054748,-1,2069,2060,10
54763053277,54763053276,-1,1335,2406,10
54767954262,54767954265,3,1471,1363,10
54774237766,54774237771,5,15077,8324,10
54778774255,54778774253,-2,1335,2492,10
54778907973,54778907972,-1,1076,2191,10
54779334852,54779334850,-2,1305,2001,10
54782279130,54782279129,-1,1209,1050,10
54789805178,54789805178,0,1273,2279,10
54791574965,54791574963,-2,1371,1614,10
54792299977,54792299961,-16,1136,2962,10
54793330882,54793330881,-1,1109,2002,10
54794911141,54794911141,0,993,1939,10
54795988986,54795988986,0,1277,1736,10
54797195617,54797195619,2,1339,1391,10
54801654140,54801654138,-2,1127,1823,10
54805412818,54805412819,1,1941,1862,10
54805856669,54805856664,-5,2065,5937,10
54810546542,54810546541,-1,1492,1885,10
54813145743,54813145744,1,1569,2107,10
54817719335,54817719331,-4,1142,1283,10
54819647870,54819647869,-1,617,1214,10
54820087696,54820087693,-3,1255,1657,10
54821851809,54821851808,-1,1448,2519,10
54826834270,54826834267,-3,796,1895,10
54829787440,54829787438,-2,999,1239,10
54836697587,54836697584,-3,1316,3292,10
54837315901,54837315902,1,1944,1979,10
54837646446,54837646445,-1,1283,1699,10
54839290117,54839290114,-3,1284,1463,10
54840588620,54840588620,0,1524,2276,10
54842806815,54842806814,-1,1554,2278,10
54848947201,54848947199,-2,1321,2015,10
54851668121,54851668123,2,1282,1253,10
54852119046,54852119043,-3,857,1624,10
54865924814,54865924813,-1,1228,1888,10
54866011233,54866011229,-4,992,2369,10
54870281518,54870281514,-4,1370,3298,10
54870394626,54870394624,-2,1313,2127,10
54870793485,54870793483,-2,1455,2117,10
54877333969,54877333966,-3,1481,2010,10
54878656437,54878656435,-2,1497,2336,10
54880618782,54880618781,-1,1579,2283,10
54882046414,54882046410,-4,1113,1836,10
54885284020,54885284018,-2,1463,2185,10
54885762412,54885762426,14,567,1491,10
54887717479,54887717477,-2,883,1678,10
54890133666,54890133666,0,1186,1747,10
54891915236,54891915235,-1,1576,2799,10
54895316814,54895316813,-1,1053,1513,10
54897433183,54897433179,-4,1043,2309,10
54900470679,54900470677,-2,1607,2558,10
54904394436,54904394437,1,1391,1807,10
54904420012,54904419994,-18,1967,717,10
54904826572,54904826570,-2,1277,1637,10
54906134190,54906134196,6,1917,1389,10
54912629752,54912629750,-2,1379,2408,10
54912959729,54912959729,0,1614,1909,10
54913094270,54913094270,0,1139,3066,10
54914265606,54914265610,4,1402,1196,10
54919806889,54919806885,-4,1827,3655,10
54922901238,54922901237,-1,1684,1879,10
54925286870,54925286867,-3,1043,2549,10
54925911267,54925911265,-2,1194,1671,10
54931074058,54931074055,-3,1126,2758,10
54933805875,54933805874,-1,1133,1396,10
54934755612,54934755612,0,1258,2453,10
54936359037,54936359035,-2,1466,2457,10
54938181974,54938181970,-4,1157,2221,10
54940270782,54940270782,0,1298,1780,10
54943303535,54943303534,-1,1063,1813,10
54943871646,54943871646,0,1132,2028,10
54949160555,54949160555,0,1287,1377,10
54950233158,54950233154,-4,1558,2777,10
54955258379,54955258378,-1,1235,1419,10
54955729678,54955729678,0,1351,1862,10
54959377791,54959377787,-4,742,2722,10
54960761274,54960761274,0,1358,1632,10
54961266330,54961266331,1,1090,1732,10
54967808737,54967808734,-3,1176,2569,10
54970592738,54970592735,-3,1055,2200,10
54972814846,54972814846,0,1836,3175,10
54974845909,54974845906,-3,1754,1744,10
54975202081,54975202078,-3,1232,2357,10
54977734773,54977734772,-1,1467,2001,10
54980575030,54980575030,0,1407,2369,10
54982852845,54982852845,0,1217,1841,10
54988496139,54988496134,-5,1197,3304,10
54995725045,54995725044,-1,584,1628,10
54996688519,54996688519,0,972,1530,10
54998233022,54998233024,2,1322,1640,10
55003678921,55003678920,-1,1475,2084,10
55005162834,55005162833,-1,1446,1644,10
55012395663,55012395662,-1,1752,2577,10
55014077796,55014077795,-1,1126,1550,10
55021889867,55021889866,-1,1250,2087,10
55023843949,55023843949,0,1051,2166,10
55024125976,55024125981,5,3261,1204,10
55026555869,55026555868,-1,1416,1228,10
55031374714,55031374710,-4,14513,55157,10
55032125499,55032125499,0,1519,1585,10
55033494111,55033494110,-1,1558,2310,10
55036957219,55036957217,-2,1001,1689,10
55045300214,55045300214,0,891,1594,10
55045951627,55045951626,-1,1358,2041,10
55047555087,55047555085,-2,1223,2413,10
55049758851,55049758848,-3,1277,1684,10
55050453984,55050453986,2,3003,2407,10
55051461890,55051461888,-2,1292,1695,10
55053624831,55053624829,-2,1340,2110,10
55060719554,55060719552,-2,1699,2395,10
55060746842,55060746834,-8,1091,7023,10
55062216883,55062216883,0,1253,2011,10
55064530359,55064530355,-4,1085,1819,10
55068386831,55068386831,0,419,796,10
55073595221,55073595223,2,2322,2826,10
55076041070,55076041073,3,1706,1518,10
55080896083,55080896083,0,1928,2486,10
55083447953,55083447954,1,1452,1802,10
55085519437,55085519435,-2,1678,1986,10
55088139146,55088139146,0,1489,1726,10
55089473039,55089473038,-1,1031,1898,10
55090439549,55090439548,-1,879,1791,10
55091024865,55091024863,-2,1601,2993,10
55093887258,55093887258,0,989,2377,10
55101848271,55101848270,-1,864,2192,10
55104203649,55104203646,-3,1821,2665,10
55104909064,55104909062,-2,1234,1680,10
55106406417,55106406416,-1,718,2480,10
55106660795,55106660780,-15,1352,1753,10
55107979025,55107979030,5,2914,1585,10
55108759042,55108759042,0,1031,1698,10
55109743414,55109743414,0,828,1567,10
55110815678,55110815678,0,1054,1668,10
55113763024,55113763023,-1,1108,1855,10
55114021625,55114021644,19,1066,1815,10
55114966568,55114966566,-2,1240,2495,10
55119469350,55119469350,0,1395,1535,10
55120396104,55120396102,-2,1201,2399,10
55121161165,55121161158,-7,864,3324,10
55123681218,55123681200,-18,2413,822,10
55125527182,55125527182,0,1245,1713,10
55134546834,55134546825,-9,1300,3790,10
55135977226,55135977225,-1,2076,2511,10
55136021209,55136021210,1,823,1472,10
55139708465,55139708470,5,3135,1247,10
55146788606,55146788606,0,703,3071,10
55147764919,55147764918,-1,1274,1778,10
55151233951,55151233947,-4,1359,2051,10
55151796297,55151796296,-1,1514,2048,10
55156393509,55156393509,0,1429,2329,10
55157002125,55157002125,0,1313,2096,10
55157464870,55157464870,0,1376,1757,10
55158794411,55158794410,-1,1720,1835,10
55159118143,55159118142,-1,1325,2057,10
55161861219,55161861218,-1,1688,2238,10
55162471669,55162471667,-2,1452,1730,10
55162810522,55162810537,15,931,5062,10
55163175346,55163175346,0,1518,1703,10
55169495378,55169495376,-2,672,1271,10
55175569875,55175569871,-4,946,1632,10
55176618813,55176618822,9,16875,18410,10
55177187332,55177187331,-1,1029,1894,10
55178269857,55178269857,0,1113,1688,10
55178787383,55178787381,-2,1217,1337,10
55179945534,55179945533,-1,1384,2485,10
55181556118,55181556119,1,1242,2096,10
55190166370,55190166368,-2,1325,2343,10
55194600224,55194600243,19,1186,1896,10
55194949043,55194949042,-1,1447,1787,10
55196019962,55196019962,0,1047,2105,10
55196923583,55196923580,-3,741,1815,10
55198393714,55198393714,0,1495,1690,10
55202407434,55202407434,0,1475,2836,10
55203518537,55203518537,0,1074,1338,10
55204167056,55204167054,-2,548,1593,10
55206424330,55206424323,-7,1946,6759,10
55207889276,55207889275,-1,1257,1947,10
55208730726,55208730725,-1,1434,1636,10
55211868113,55211868111,-2,1680,3347,10
55215697082,55215697081,-1,1137,2459,10
55217130531,55217130547,16,966,958,10
55217541914,55217541916,2,1710,2120,10
55217762347,55217762345,-2,1028,1654,10
55218706931,55218706932,1,877,2001,10
55218864252,55218864270,18,922,2237,10
55221750277,55221750283,6,6098,30412,10
55223187158,55223187152,-6,1107,4587,10
55225719810,55225719808,-2,1306,2666,10
55226793377,55226793376,-1,1064,1589,10
55227362554,55227362553,-1,1041,2721,10
55228750913,55228750911,-2,1372,2434,10
55229044114,55229044111,-3,1367,1962,10
55237584603,55237584601,-2,1244,1923,10
55239430375,55239430381,6,1329,2017,10
55240638982,55240638981,-1,1340,2147,10
55241127113,55241127134,21,675,1462,10
55241599159,55241599158,-1,707,1712,10
55242651412,55242651410,-2,1137,1896,10
55243726006,55243726005,-1,1588,2890,10
55245009021,55245009016,-5,1234,2144,10
55245629146,55245629145,-1,1543,2444,10
55254127470,55254127469,-1,987,1595,10
55254167667,55254167650,-17,1037,1236,10
55255044881,55255044877,-4,1568,2121,10
55257864189,55257864188,-1,1164,1677,10
55258295199,55258295198,-1,937,2206,10
55259347710,55259347708,-2,888,1624,10
55260351967,55260351965,-2,1064,1655,10
55264362585,55264362584,-1,999,1544,10
55264600593,55264600612,19,948,1702,10
55264818209,55264818219,10,1350,1069,10
55266676041,55266676041,0,1255,1793,10
55267754707,55267754705,-2,1580,2738,10
55268572078,55268572077,-1,1297,1963,10
55269474114,55269474112,-2,1117,2593,10
55275751606,55275751605,-1,982,2412,10
55276060366,55276060361,-5,1086,3116,10
55277358078,55277358076,-2,1371,2669,10
55277910353,55277910350,-3,1219,2007,10
55282355866,55282355867,1,891,1056,10
55290390543,55290390542,-1,1185,1598,10
55290684010,55290684007,-3,1809,3649,10
55291268970,55291268963,-7,1231,7234,10
55293675223,55293675222,-1,1202,1752,10
55298127821,55298127820,-1,1337,2008,10
55299110845,55299110852,7,6203,1926,10
55301347327,55301347326,-1,1349,2413,10
55303823293,55303823291,-2,989,1823,10
55304700187,55304700186,-1,1166,2641,10
55318942639,55318942638,-1,888,1325,10
55321416418,55321416418,0,1130,1100,10
55325977986,55325977985,-1,980,1810,10
55326449533,55326449531,-2,1572,2931,10
55333198027,55333198025,-2,1610,2117,10
55333296941,55333296943,2,1584,1328,10
55337011232,55337011230,-2,1500,2044,10
55338136973,55338136971,-2,2455,3203,10
55338720853,55338720851,-2,843,1639,10
55342576605,55342576612,7,2744,1423,10
55342882861,55342882861,0,1174,1920,10
55343746554,55343746562,8,1776,1632,10
55344871428,55344871425,-3,1732,2597,10
55347459679,55347459676,-3,987,3434,10
55348155231,55348155232,1,1575,2259,10
55348689998,55348689999,1,1284,1941,10
55349872744,55349872744,0,1700,1884,10
55349954519,55349954522,3,4759,21396,10
55351771126,55351771123,-3,1062,1927,10
55352654113,55352654111,-2,1153,2316,10
55356863255,55356863253,-2,1432,1777,10
55358906514,55358906513,-1,1159,1173,10
55360882306,55360882302,-4,1002,2232,10
55364830907,55364830906,-1,1605,2261,10
55369434750,55369434746,-4,998,1408,10
55372540242,55372540242,0,994,1915,10
55373182634,55373182634,0,1289,2572,10
55373911690,55373911698,8,9514,23292,10
55375225502,55375225499,-3,994,2504,10
55376801425,55376801426,1,788,1212,10
55377862619,55377862619,0,1185,2004,10
55378022549,55378022547,-2,1217,1977,10
55378356063,55378356062,-1,1437,1901,10
55382213478,55382213497,19,835,1168,10
55382668347,55382668346,-1,1285,1916,10
55382912106,55382912102,-4,926,2557,10
55383006546,55383006543,-3,883,2056,10
55390028363,55390028365,2,1157,1462,10
55392906646,55392906643,-3,381,1053,10
55393455128,55393455125,-3,1162,1655,10
55395853311,55395853310,-1,1592,2001,10
55397715067,55397715066,-1,1092,1958,10
55397899275,55397899272,-3,1245,2225,10
55398659712,55398659693,-19,949,1370,10
55399416569,55399416567,-2,1398,2591,10
55401414271,55401414269,-2,1270,2078,10
55403564402,55403564403,1,2717,2695,10
55404465562,55404465557,-5,1367,1929,10
55405638203,55405638202,-1,1041,1250,10
55408032322,55408032321,-1,1135,2557,10
55411929998,55411930003,5,1544,856,10
55413392146,55413392145,-1,1093,2192,10
55414364408,55414364431,23,1004,1684,10
55416868978,55416868975,-3,1121,2453,10
55423844770,55423844765,-5,1197,3407,10
55427025044,55427025042,-2,1607,2687,10
55427672314,55427672313,-1,1387,2268,10
55433487131,55433487130,-1,1224,2379,10
55435733848,55435733846,-2,893,1934,10
55438612481,55438612503,22,525,841,10
55440831775,55440831774,-1,1203,1771,10
55440931841,55440931841,0,1119,1991,10
55442696602,55442696603,1,3035,3778,10
55444452893,55444452891,-2,1311,2529,10
55445418194,55445418187,-7,710,2510,10
55447962699,55447962698,-1,1010,1475,10
55452216539,55452216537,-2,1316,2241,10
55452638328,55452638325,-3,1613,3073,10
55461378037,55461378034,-3,921,1016,10
55464188799,55464188798,-1,720,1790,10
55464626181,55464626181,0,1444,2703,10
55470969634,55470969631,-3,1076,3253,10
55476456378,55476456383,5,2479,1838,10
55477057950,55477057950,0,892,2008,10
55482391826,55482391825,-1,1385,1931,10
55495264918,55495264919,1,1239,1276,10
55496358557,55496358556,-1,1506,2345,10
55497586746,55497586744,-2,962,1697,10
55499703678,55499703677,-1,1217,2109,10
55501118438,55501118438,0,1544,1231,10
55501751638,55501751639,1,1302,1302,10
55502723051,55502723050,-1,1789,2742,10
55504317538,55504317535,-3,1285,1736,10
55506014736,55506014734,-2,1687,2480,10
55506218137,55506218158,21,305,1667,10
55512828793,55512828789,-4,1186,2380,10
55517521202,55517521200,-2,1414,2141,10
55518229851,55518229851,0,1399,2614,10
55526269657,55526269656,-1,1300,2089,10
55529717324,55529717321,-3,1130,2836,10
55533693658,55533693661,3,1138,1439,10
55540194685,55540194683,-2,1233,2840,10
55546370454,55546370451,-3,1228,1519,10
55548343887,55548343888,1,1328,1124,10
55549405456,55549405462,6,4405,1377,10
55551691123,55551691121,-2,967,2479,10
55556086313,55556086310,-3,1168,1885,10
55558182327,55558182325,-2,1141,1694,10
55559714526,55559714525,-1,1663,2821,10
55559791735,55559791734,-1,1452,1779,10
55564563625,55564563625,0,1017,1289,10
55574057953,55574057954,1,1027,1439,10
55575694458,55575694458,0,1456,1538,10
55576357749,55576357753,4,1426,1355,10
55576555155,55576555154,-1,940,1644,10
55580058406,55580058404,-2,1436,2161,10
55580407385,55580407384,-1,1107,2263,10
55587844799,55587844798,-1,1524,2428,10
55593454541,55593454539,-2,1409,1688,10
55600982229,55600982231,2,1686,1271,10
55608372862,55608372862,0,731,1321,10
55610649947,55610649947,0,966,1515,10
55612062283,55612062281,-2,1135,1450,10
55616436097,55616436097,0,1340,1527,10
55618331989,55618331987,-2,1570,1861,10
55619291099,55619291093,-6,1126,1541,10
55621565579,55621565579,0,1253,2152,10
55628368165,55628368166,1,1460,1060,10
55629326178,55629326179,1,1495,1508,10
55633924159,55633924157,-2,1646,3721,10
55634320847,55634320845,-2,997,1857,10
55634960314,55634960312,-2,1486,2538,10
55644217179,55644217176,-3,1196,1670,10
55645853018,55645853018,0,1432,1776,10
55645883331,55645883314,-17,135,706,10
55646470094,55646470091,-3,1680,1635,10
55646935374,55646935372,-2,1449,2072,10
55648884798,55648884797,-1,776,2367,10
55654041173,55654041169,-4,697,1874,10
55656297122,55656297120,-2,1087,2020,10
55657061034,55657061033,-1,1009,2139,10
55657432839,55657432839,0,1319,1898,10
55658981930,55658981930,0,1098,1908,10
55659063582,55659063584,2,1734,1080,10
55659423343,55659423320,-23,802,1794,10
55661449490,55661449489,-1,1440,1912,10
55661802941,55661802938,-3,751,1422,10
55665615614,55665615611,-3,1290,3144,10
55669126272,55669126270,-2,1285,2328,10
55669635600,55669635597,-3,1265,1704,10
55670019340,55670019338,-2,1522,1333,10
55672033677,55672033677,0,1023,1293,10
55673900724,55673900722,-2,1283,2197,10
55677680472,55677680471,-1,1223,1301,10
55678028497,55678028508,11,27,1303,10
55680721010,55680721007,-3,1518,2806,10
55681959266,55681959266,0,1129,1901,10
55685164303,55685164306,3,1744,1011,10
55686605985,55686605986,1,882,2086,10
55687948769,55687948767,-2,893,1878,10
55692632803,55692632801,-2,1498,2714,10
55696153156,55696153152,-4,1299,2350,10
55697939697,55697939694,-3,1062,2101,10
55699397241,55699397256,15,553,888,10
55701684159,55701684158,-1,1735,2139,10
55701961517,55701961522,5,3952,1990,10
55708507271,55708507269,-2,1183,1645,10
55708777318,55708777318,0,522,883,10
55709849731,55709849730,-1,1113,1698,10
55710033995,55710033993,-2,1088,2178,10
55711459082,55711459083,1,1452,1986,10
55712572172,55712572174,2,1219,1377,10
55716644574,55716644573,-1,1451,1855,10
55724247625,55724247626,1,951,1722,10
55726426808,55726426826,18,1414,1720,10
55733922521,55733922519,-2,1382,2294,10
55742714733,55742714731,-2,1124,1423,10
55744459410,55744459410,0,823,1819,10
55746208859,55746208858,-1,1106,2028,10
55748716300,55748716299,-1,1212,1712,10
55748952790,55748952789,-1,1478,1976,10
55750470683,55750470681,-2,1489,2709,10
55751229282,55751229282,0,1078,2375,10
55759246959,55759246958,-1,1521,2861,10
55765503230,55765503229,-1,1329,2774,10
55765921306,55765921305,-1,1342,2755,10
55768386322,55768386319,-3,1076,2479,10
55768413953,55768413951,-2,1055,1871,10
55768800171,55768800165,-6,1142,6630,10
55769928918,55769928918,0,1298,1770,10
55772387179,55772387175,-4,871,1404,10
55773023917,55773023918,1,944,1396,10
55775852490,55775852490,0,1116,1914,10
55776387231,55776387230,-1,1287,2207,10
55776609872,55776609872,0,1219,2246,10
55777254635,55777254637,2,22821,39110,10
55777388377,55777388376,-1,1097,2188,10
55777434771,55777434763,-8,849,855,10
55778209334,55778209334,0,1185,2081,10
55779940715,55779940713,-2,1292,1923,10
55780411139,55780411129,-10,856,1224,10
55780606642,55780606640,-2,1068,1707,10
55781590362,55781590362,0,1351,2386,10
55785694026,55785694025,-1,1019,1937,10
55786250157,55786250158,1,1271,1569,10
55787769163,55787769163,0,1148,2006,10
55789443818,55789443822,4,1779,1421,10
55796167888,55796167886,-2,1157,2310,10
55797451266,55797451264,-2,1176,1405,10
55797622670,55797622649,-21,1605,1455,10
55800986061,55800986060,-1,949,1463,10
55803868205,55803868203,-2,808,1497,10
55806573697,55806573719,22,1114,3133,10
55812458610,55812458610,0,1362,2037,10
55820775980,55820775978,-2,1134,2773,10
55827467512,55827467510,-2,1306,1688,10
55829438189,55829438184,-5,923,1450,10
55835375832,55835375831,-1,1116,1724,10
55836892406,55836892406,0,973,1811,10
55838216026,55838216026,0,1224,2027,10
55840562171,55840562166,-5,981,1641,10
55843057402,55843057402,0,831,2105,10
55845915367,55845915366,-1,1269,1428,10
55849145018,55849145018,0,1435,2253,10
55849230203,55849230198,-5,1643,4853,10
55849259666,55849259665,-1,698,1879,10
55852302387,55852302384,-3,1244,2098,10
55858403993,55858403992,-1,1679,2966,10
55859256858,55859256858,0,987,1363,10
55863805583,55863805582,-1,1019,1953,10
55866702706,55866702705,-1,1334,1818,10
55867130235,55867130237,2,6329,22018,10
55868634446,55868634446,0,1142,1613,10
55870470142,55870470140,-2,1012,1874,10
55871551311,55871551312,1,922,1795,10
55872143876,55872143876,0,1773,1867,10
55874862359,55874862358,-1,1481,2420,10
55875229103,55875229103,0,909,1687,10
55877160721,55877160717,-4,1467,2335,10
55877365668,55877365668,0,1577,1805,10
55882089947,55882089946,-1,1335,2604,10
55882427325,55882427337,12,18816,23345,10
55887501106,55887501105,-1,1547,1905,10
55893749746,55893749745,-1,1331,2719,10
55894440902,55894440899,-3,1328,2038,10
55895620166,55895620160,-6,851,2335,10
55898896019,55898896017,-2,877,2202,10
55900117137,55900117141,4,2394,1526,10
55900320038,55900320037,-1,949,1617,10
55902775862,55902775861,-1,1027,1221,10
55904761526,55904761526,0,843,1568,10
55906923723,55906923700,-23,1188,1682,10
55908177516,55908177514,-2,1478,1902,10
55923831038,55923831038,0,1211,1769,10
55925304931,55925304930,-1,1441,2279,10
55926463174,55926463170,-4,1062,2622,10
55929617027,55929617025,-2,1018,1280,10
55932564554,55932564553,-1,891,1348,10
55938617614,55938617610,-4,735,1325,10
55941316875,55941316875,0,1257,1492,10
55942282004,55942282002,-2,1605,2129,10
55942407633,55942407631,-2,1899,1906,10
55943873576,55943873574,-2,1373,2286,10
55943988259,55943988257,-2,1599,2476,10
55944196526,55944196522,-4,1372,2405,10
55946107421,55946107421,0,931,1463,10
55951535275,55951535275,0,1240,1707,10
55953281371,55953281369,-2,1426,3288,10
55956349098,55956349097,-1,982,1644,10
55957148457,55957148457,0,1250,1687,10
55960126245,55960126248,3,3942,3021,10
55961883306,55961883305,-1,1015,1980,10
55964673562,55964673561,-1,1384,2073,10
55968363394,55968363394,0,665,1348,10
55972031470,55972031465,-5,1100,1562,10
55980375079,55980375079,0,1074,1549,10
55982953256,55982953255,-1,1466,2278,10
55991831623,55991831621,-2,1108,2362,10
56000590469,56000590467,-2,1688,2304,10
56001783894,56001783893,-1,1129,1756,10
56002293566,56002293566,0,858,1791,10
56003561286,56003561284,-2,713,1496,10
56004303932,56004303934,2,2818,3729,10
56006363147,56006363146,-1,811,1871,10
56010862547,56010862551,4,20376,44184,10
56014203777,56014203775,-2,1034,2098,10
56015159172,56015159173,1,1791,1580,10
56015779070,56015779066,-4,1029,3246,10
56026550177,56026550174,-3,1221,2676,10
56028199137,56028199134,-3,1194,1602,10
56028568054,56028568053,-1,1294,2219,10
56033420467,56033420465,-2,900,2087,10
56035370825,56035370826,1,1747,1802,10
56036962061,56036962061,0,1514,2423,10
56038167407,56038167408,1,859,1232,10
56040599718,56040599719,1,2093,1467,10
56051847250,56051847250,0,1005,1685,10
56052484992,56052484992,0,1534,2426,10
56058514378,56058514389,11,14909,37437,10
56059858010,56059858009,-1,809,1835,10
56061344693,56061344693,0,1168,1746,10
56064778234,56064778234,0,1183,1417,10
56066911441,56066911441,0,1169,1890,10
56073284193,56073284193,0,1089,1831,10
56079435949,56079435952,3,2379,1658,10
56089347103,56089347102,-1,1064,1927,10
56089815313,56089815334,21,1141,1798,10
56091282611,56091282610,-1,1090,1274,10
56096835495,56096835494,-1,1684,1652,10
56099445042,56099445047,5,17677,51795,10
56100612258,56100612256,-2,1083,1938,10
56102102235,56102102234,-1,899,1508,10
56104938538,56104938537,-1,1334,2803,10
56105179157,56105179156,-1,1420,1692,10
56106311079,56106311078,-1,1893,2001,10
56110411765,56110411765,0,1114,1898,10
56112149090,56112149091,1,1359,2097,10
56112248235,56112248254,19,1709,3570,10
56114062501,56114062501,0,1779,1905,10
56115569744,56115569744,0,1517,1523,10
56117769031,56117769030,-1,700,1934,10
56118510995,56118511002,7,7245,2503,10
56120049531,56120049533,2,1490,1537,10
56120868932,56120868934,2,1499,1381,10
56121357670,56121357669,-1,1312,2177,10
56124434122,56124434122,0,1314,1839,10
56124836047,56124836043,-4,1644,2837,10
56125379438,56125379434,-4,1129,1603,10
56127657411,56127657408,-3,1221,1887,10
56128359676,56128359674,-2,1666,2212,10
56130448327,56130448323,-4,594,2341,10
56131789026,56131789024,-2,1185,1545,10
56131977155,56131977154,-1,838,1445,10
56132927344,56132927342,-2,1646,2365,10
56134137375,56134137373,-2,1369,2372,10
56134540510,56134540509,-1,954,1787,10
56135708767,56135708766,-1,1512,1960,10
56137022105,56137022102,-3,1555,2219,10
56137547494,56137547498,4,1128,1534,10
56140033029,56140033027,-2,1039,1875,10
56147026434,56147026431,-3,1174,2452,10
56150845054,56150845053,-1,1139,1795,10
56151390029,56151390025,-4,1280,2371,10
56154008414,56154008411,-3,1479,1624,10
56156758166,56156758163,-3,805,1963,10
56157833681,56157833678,-3,991,2408,10
56158027134,56158027133,-1,1059,1644,10
56168319603,56168319602,-1,1443,2094,10
56171725558,56171725556,-2,1038,1856,10
56176629750,56176629748,-2,1370,2615,10
56181401266,56181401274,8,1793,908,10
56184485241,56184485246,5,5337,2574,10
56185094459,56185094457,-2,907,1870,10
56186587531,56186587527,-4,990,1404,10
56194213818,56194213816,-2,925,1204,10
56194452030,56194452027,-3,1048,1366,10
56198917495,56198917493,-2,593,1057,10
56204409217,56204409219,2,1000,1173,10
56208526045,56208526042,-3,1293,1461,10
56211080282,56211080281,-1,1558,2677,10
56212024039,56212024058,19,1142,1684,10
56212469467,56212469466,-1,1339,1779,10
56213023342,56213023343,1,1589,1633,10
56216066970,56216066969,-1,1563,2222,10
56216305010,56216305007,-3,1027,1283,10
56218626578,56218626578,0,1088,1865,10
56218888489,56218888486,-3,1240,2258,10
56219085759,56219085758,-1,1060,2542,10
56224165364,56224165362,-2,1292,1893,10
56226660974,56226660967,-7,726,2070,10
56227336505,56227336502,-3,1447,2415,10
56229644736,56229644743,7,3040,978,10
56235610672,56235610671,-1,1023,2155,10
56237592643,56237592638,-5,1374,3159,10
56241357079,56241357077,-2,1191,1890,10
56242875642,56242875641,-1,1697,2825,10
56243864098,56243864097,-1,1056,1708,10
56244851938,56244851939,1,44,1897,10
56246461817,56246461817,0,1576,1823,10
56248172394,56248172394,0,949,1067,10
56248682708,56248682722,14,409,878,10
56253509523,56253509521,-2,1160,1760,10
56254861194,56254861193,-1,1582,1893,10
56256077216,56256077215,-1,1601,2166,10
56257238911,56257238910,-1,1387,2207,10
56259090639,56259090638,-1,872,1450,10
56260181382,56260181382,0,664,1519,10
56265358602,56265358597,-5,992,1927,10
56265759478,56265759477,-1,1306,1807,10
56270742334,56270742334,0,1211,2504,10
56272317119,56272317104,-15,907,759,10
56272519745,56272519756,11,251,1182,10
56275233243,56275233240,-3,578,1897,10
56277564098,56277564098,0,868,1617,10
56279737791,56279737790,-1,1150,1923,10
56281676018,56281676015,-3,1612,1701,10
56281977583,56281977582,-1,701,1409,10
56285335139,56285335145,6,3061,1321,10
56299370194,56299370194,0,951,1590,10
56300133874,56300133874,0,739,1634,10
56307397578,56307397575,-3,1762,3300,10
56309215643,56309215642,-1,2087,2321,10
56312100658,56312100654,-4,682,1837,10
56312582552,56312582551,-1,1433,2681,10
56312839909,56312839906,-3,1210,1660,10
56313252722,56313252722,0,1296,1559,10
56322109047,56322109045,-2,1145,2306,10
56325667041,56325667039,-2,1042,2010,10
56325877358,56325877356,-2,1640,2355,10
56329073630,56329073628,-2,1110,1606,10
56332968973,56332968971,-2,1240,1680,10
56333895955,56333895954,-1,1437,1693,10
56334859647,56334859646,-1,1176,1943,10
56337171321,56337171321,0,869,1726,10
56337862454,56337862451,-3,1385,1979,10
56339441363,56339441362,-1,1190,1637,10
56340548083,56340548082,-1,1151,2344,10
56340799768,56340799791,23,553,1482,10
56344408042,56344408041,-1,1282,3051,10
56346171586,56346171586,0,1296,2103,10
56348836438,56348836445,7,2458,1308,10
56352964066,56352964065,-1,1097,2309,10
56367412706,56367412703,-3,1873,2561,10
56375745254,56375745253,-1,1044,2028,10
56378087718,56378087714,-4,851,1185,10
56379298201,56379298212,11,368,7430,10
56381449438,56381449438,0,1595,1617,10
56382080693,56382080693,0,1428,1868,10
56382996815,56382996814,-1,1387,2570,10
56384092147,56384092150,3,1686,1429,10
56386393525,56386393524,-1,1488,2029,10
56387303829,56387303822,-7,1974,4974,10
56388807151,56388807150,-1,967,2179,10
56392564625,56392564625,0,1131,1441,10
56393988870,56393988866,-4,824,1667,10
56396195042,56396195038,-4,1088,1842,10
56398422817,56398422813,-4,1167,1994,10
56399717533,56399717532,-1,1655,1956,10
56404615909,56404615906,-3,1551,2061,10
56405820490,56405820478,-12,987,2385,10
56405958339,56405958338,-1,934,2352,10
56406020142,56406020140,-2,1516,2300,10
56407071807,56407071806,-1,1171,1529,10
56407901499,56407901497,-2,1596,1841,10
56408501372,56408501370,-2,2327,4281,10
56412800797,56412800796,-1,1546,3052,10
56418784897,56418784897,0,1146,1676,10
56419767869,56419767867,-2,1843,1991,10
56425296618,56425296617,-1,1174,1772,10
56426259472,56426259471,-1,1397,2473,10
56427362083,56427362081,-2,697,2255,10
56427387258,56427387277,19,1164,2163,10
56428799124,56428799121,-3,1220,1713,10
56434119608,56434119601,-7,1929,6318,10
56443364158,56443364157,-1,1362,2301,10
56444442907,56444442905,-2,1198,1910,10
56448006009,56448006005,-4,1045,2105,10
56448601620,56448601635,15,1128,2590,10
56453424866,56453424866,0,1040,2378,10
56454430351,56454430349,-2,1124,1990,10
56454617206,56454617205,-1,1363,2804,10
56458375558,56458375555,-3,887,1067,10
56458591492,56458591492,0,1574,1742,10
56458722377,56458722374,-3,1049,2095,10
56459660623,56459660623,0,1091,1724,10
56460724766,56460724765,-1,1199,1625,10
56460812802,56460812800,-2,1209,1804,10
56461910261,56461910262,1,3189,3177,10
56467556324,56467556322,-2,1181,1845,10
56468228863,56468228862,-1,1123,2205,10
56469966362,56469966359,-3,1391,2422,10
56472266658,56472266657,-1,1488,1438,10
56475845786,56475845781,-5,978,3833,10
56475944705,56475944710,5,7832,5819,10
56476403614,56476403614,0,943,1726,10
56477736631,56477736630,-1,983,1482,10
56479281489,56479281487,-2,1212,1510,10
56482729091,56482729087,-4,996,2634,10
56482888330,56482888314,-16,1002,1609,10
56486106475,56486106473,-2,1238,2002,10
56488683606,56488683607,1,1020,926,10
56489188607,56489188607,0,797,1092,10
56489924032,56489924026,-6,380,1190,10
56492136233,56492136233,0,1049,2069,10
56493275507,56493275506,-1,853,1735,10
56495371007,56495371005,-2,782,1409,10
56497272826,56497272822,-4,1123,1715,10
56498285309,56498285315,6,2154,1151,10
56500146405,56500146403,-2,1014,2035,10
56500472370,56500472368,-2,729,1721,10
56500830618,56500830636,18,424,1249,10
56503027142,56503027142,0,1064,1763,10
56503530931,56503530927,-4,2956,5473,10
56504463502,56504463502,0,1243,2164,10
56505854739,56505854734,-5,1009,1956,10
56506995577,56506995574,-3,1672,2913,10
56509154669,56509154669,0,1417,2126,10
56510315422,56510315420,-2,793,2599,10
56512035569,56512035570,1,1538,2345,10
56512080817,56512080816,-1,1358,2219,10
56523080385,56523080385,0,1147,1792,10
56524818342,56524818345,3,1379,2145,10
56525796274,56525796272,-2,1158,1618,10
56529791625,56529791625,0,1475,2465,10
56531962316,56531962314,-2,964,2120,10
56543685018,56543685017,-1,1204,1867,10
56544358512,56544358508,-4,1291,3003,10
56549443733,56549443730,-3,1460,1968,10
56556568887,56556568886,-1,1090,2096,10
56558347055,56558347054,-1,1458,1926,10
56558739615,56558739614,-1,874,1049,10
56559261115,56559261130,15,1159,2182,10
56561074274,56561074278,4,2594,1634,10
56561116281,56561116299,18,493,165,10
56564685715,56564685714,-1,787,1632,10
56566556711,56566556707,-4,1367,2999,10
56571255465,56571255464,-1,33067,23089,10
56572690557,56572690557,0,1725,2613,10
56575532482,56575532483,1,1239,2375,10
56577726795,56577726794,-1,1360,1757,10
56578762260,56578762259,-1,1146,1449,10
56581175218,56581175224,6,4978,2586,10
56584472490,56584472488,-2,1027,2231,10
56589188415,56589188415,0,1613,2108,10
56589866985,56589866982,-3,1138,3022,10
56590061462,56590061461,-1,1328,1567,10
56592866075,56592866077,2,1629,2580,10
56593208283,56593208282,-1,1236,1360,10
56596028952,56596028951,-1,1059,1952,10
56597531058,56597531062,4,1123,1660,10
56597632583,56597632602,19,662,1606,10
56598041866,56598041862,-4,841,2063,10
56600642703,56600642700,-3,1420,2146,10
56608148420,56608148418,-2,1150,2024,10
56609286720,56609286718,-2,1278,1983,10
56617273857,56617273857,0,1391,1848,10
56619882136,56619882133,-3,1311,1976,10
56625524010,56625524009,-1,1107,2635,10
56625960351,56625960352,1,1254,1860,10
56627994551,56627994550,-1,1068,1210,10
56629270291,56629270291,0,1379,1577,10
56630183218,56630183217,-1,1799,2847,10
56632761631,56632761630,-1,1368,2030,10
56634106478,56634106476,-2,1136,2211,10
56635518604,56635518606,2,1856,2247,10
56637590631,56637590631,0,1773,1488,10
56640037974,56640037973,-1,559,1736,10
56640745431,56640745429,-2,1103,2147,10
56647504394,56647504393,-1,1131,1785,10
56648479541,56648479539,-2,1249,2684,10
56653001334,56653001337,3,1563,1519,10
56655141508,56655141514,6,3290,1703,10
56664834862,56664834860,-2,990,2363,10
56668282675,56668282675,0,965,1448,10
56668891289,56668891273,-16,866,1034,10
56669186823,56669186817,-6,920,9450,10
56673850556,56673850549,-7,2460,10479,10
56676670047,56676670047,0,1397,1721,10
56677455914,56677455913,-1,1182,1925,10
56679872869,56679872867,-2,1453,2421,10
56682975295,56682975293,-2,1319,1552,10
56683181399,56683181400,1,929,1440,10
56684055395,56684055394,-1,1036,1979,10
56686782718,56686782715,-3,1055,1794,10
56688127867,56688127866,-1,1034,1699,10
56688921129,56688921136,7,896,1684,10
56693270838,56693270835,-3,1381,1860,10
56697283846,56697283843,-3,1378,2913,10
56698577918,56698577918,0,1344,2384,10
56699347065,56699347063,-2,1304,1785,10
56702472269,56702472267,-2,985,1746,10
56703916547,56703916547,0,1355,1696,10
56709683875,56709683853,-22,1340,1978,10
56710329819,56710329815,-4,954,1861,10
56711188556,56711188552,-4,1431,2812,10
56711516475,56711516482,7,5417,1991,10
56711583177,56711583174,-3,1452,2120,10
56711772461,56711772459,-2,634,917,10
56719112753,56719112752,-1,1294,1662,10
56720052018,56720052015,-3,1074,3075,10
56720607198,56720607198,0,983,1746,10
56721257235,56721257254,19,456,930,10
56722357275,56722357273,-2,1257,2047,10
56724992729,56724992726,-3,1202,2118,10
56730068578,56730068599,21,729,1317,10
56731685382,56731685382,0,1625,1898,10
56732244183,56732244179,-4,899,2296,10
56732603645,56732603643,-2,1528,2033,10
56734693550,56734693549,-1,1414,1411,10
56736692004,56736692003,-1,1318,2287,10
56736753685,56736753680,-5,4740,13031,10
56737739031,56737739034,3,1997,1537,10
56740870663,56740870662,-1,1151,1875,10
56743606498,56743606497,-1,1480,1590,10
56747696925,56747696924,-1,1476,2248,10
56750125312,56750125315,3,1622,1912,10
56752285083,56752285087,4,1578,1359,10
56761152993,56761152993,0,1359,2320,10
56762464261,56762464263,2,1377,1419,10
56762823731,56762823730,-1,1600,1606,10
56763687367,56763687361,-6,974,2489,10
56764835048,56764835050,2,898,1038,10
56767601144,56767601143,-1,1419,1818,10
56771733507,56771733506,-1,1437,1756,10
56780491218,56780491218,0,947,1320,10
56781167968,56781167968,0,802,1581,10
56781235769,56781235758,-11,1498,1898,10
56781979849,56781979845,-4,905,2211,10
56782254994,56782254994,0,692,1653,10
56782299322,56782299321,-1,783,858,10
56784529568,56784529567,-1,1335,2278,10
56784935201,56784935198,-3,1406,2342,10
56785087778,56785087778,0,1027,1184,10
56785186968,56785186949,-19,307,724,10
56787296895,56787296901,6,6606,2705,10
56789628714,56789628710,-4,1218,2461,10
56790518526,56790518525,-1,1526,1945,10
56794870577,56794870574,-3,1461,1528,10
56796173566,56796173565,-1,1139,1555,10
56798743530,56798743527,-3,1174,2204,10
56800548589,56800548586,-3,1462,2344,10
56805113324,56805113322,-2,1717,2480,10
56806583982,56806583982,0,1258,2389,10
56809174550,56809174547,-3,1506,2732,10
56819369375,56819369375,0,1232,1945,10
56819739522,56819739520,-2,901,2010,10
56827168561,56827168561,0,1018,1828,10
56830217973,56830217969,-4,1023,1887,10
56830480949,56830480950,1,946,1629,10
56832097710,56832097706,-4,1077,2473,10
56832576317,56832576317,0,1397,2156,10
56833421441,56833421442,1,1712,1985,10
56836269237,56836269234,-3,1362,2206,10
56836913023,56836913022,-1,1083,978,10
56840831218,56840831218,0,1302,1723,10
56841988086,56841988080,-6,1533,3873,10
56842264220,56842264220,0,1150,1701,10
56846815822,56846815821,-1,785,1726,10
56847106137,56847106136,-1,1395,2086,10
56847321586,56847321593,7,161,649,10
56848133945,56848133957,12,241,968,10
56849364559,56849364558,-1,1212,1255,10
56852613352,56852613352,0,1507,2431,10
56853282485,56853282483,-2,1134,1627,10
56855545466,56855545470,4,2156,968,10
56858611125,56858611122,-3,1137,1515,10
56861104023,56861104029,6,7465,26838,10
56861614176,56861614170,-6,673,1699,10
56865446157,56865446154,-3,1333,1620,10
56870358696,56870358695,-1,1609,1619,10
56874263071,56874263069,-2,1338,2238,10
56883777345,56883777346,1,1343,2091,10
56886604431,56886604429,-2,971,1682,10
56887482858,56887482858,0,1477,2161,10
56889169670,56889169668,-2,1152,2112,10
56890202178,56890202177,-1,1327,2300,10
56890558858,56890558855,-3,1032,1396,10
56891565978,56891565978,0,1355,1525,10
56894121458,56894121458,0,1307,2011,10
56895089359,56895089358,-1,1419,2135,10
56898009091,56898009087,-4,1159,1518,10
56900589434,56900589437,3,2484,1937,10
56905870363,56905870341,-22,1366,896,10
56907210441,56907210440,-1,561,1818,10
56908318166,56908318167,1,954,1116,10
56908974378,56908974384,6,3935,1509,10
56909812642,56909812639,-3,1351,2144,10
56910167336,56910167320,-16,689,1137,10
56912219903,56912219901,-2,1196,1684,10
56912566595,56912566594,-1,876,1842,10
56918045259,56918045258,-1,844,1701,10
56918315529,56918315535,6,2981,1549,10
56921076466,56921076465,-1,807,1767,10
56923009079,56923009078,-1,1185,2250,10
56925832077,56925832076,-1,1133,2104,10
56926814273,56926814273,0,698,659,10
56929100766,56929100763,-3,1121,2034,10
56932619965,56932619947,-18,21760,39929,10
56933375565,56933375558,-7,1009,2977,10
56933760318,56933760321,3,1615,1329,10
56933985918,56933985918,0,1484,1640,10
56934294093,56934294093,0,1644,2571,10
56935571159,56935571157,-2,1066,2865,10
56939442170,56939442171,1,1516,1792,10
56941300147,56941300146,-1,1432,2013,10
56945251453,56945251452,-1,1315,1869,10
56945486319,56945486317,-2,999,1710,10
56945837997,56945838003,6,2555,1134,10
56948710323,56948710324,1,1109,1641,10
56950422609,56950422606,-3,2357,2835,10
56951367582,56951367581,-1,1315,1633,10
56954420901,56954420897,-4,948,2706,10
56956073694,56956073700,6,3887,1809,10
56956155085,56956155085,0,967,1543,10
56958765550,56958765546,-4,1044,3024,10
56961091250,56961091250,0,1356,2587,10
56961470019,56961470018,-1,945,1787,10
56968339803,56968339803,0,1238,1680,10
56969689350,56969689349,-1,1197,1832,10
56972391152,56972391149,-3,1240,1867,10
56973768496,56973768494,-2,1518,1866,10
56973873461,56973873459,-2,1023,1460,10
56975787909,56975787908,-1,1905,3164,10
56978321431,56978321429,-2,770,1272,10
56979250021,56979250017,-4,1291,2314,10
56981288142,56981288141,-1,1573,2020,10
56981704808,56981704807,-1,1284,2054,10
56984248922,56984248919,-3,560,1238,10
56984540496,56984540517,21,1490,1918,10
56986532157,56986532149,-8,1654,11216,10
56989433717,56989433714,-3,1028,2277,10
56992152894,56992152894,0,2053,2830,10
56994264718,56994264718,0,989,2350,10
56995065040,56995065031,-9,1215,1939,10
57000849922,57000849919,-3,1062,1971,10
57003294101,57003294102,1,1799,2506,10
57006745019,57006745037,18,1048,1530,10
57009325979,57009325978,-1,948,2183,10
57009882543,57009882542,-1,1454,2218,10
57012096503,57012096503,0,783,1105,10
57015123997,57015123990,-7,1428,4255,10
57020522193,57020522190,-3,1597,2553,10
57023878401,57023878410,9,2851,1104,10
57027047379,57027047379,0,850,1932,10
57028138593,57028138591,-2,1045,2671,10
57036663653,57036663650,-3,1281,1373,10
57039621594,57039621591,-3,874,1830,10
57041435418,57041435417,-1,785,1548,10
57041940086,57041940086,0,1504,1744,10
57042909685,57042909685,0,1108,1391,10
57048586796,57048586794,-2,1374,2152,10
57056651597,57056651597,0,932,1397,10
57059221235,57059221231,-4,783,1679,10
57059375670,57059375670,0,1803,1986,10
57061076050,57061076050,0,1547,2247,10
57062038287,57062038291,4,1224,1235,10
57065410426,57065410426,0,1552,1896,10
57066276662,57066276658,-4,990,2145,10
57069488161,57069488162,1,1693,1699,10
57071323270,57071323271,1,1319,1759,10
57071892009,57071892007,-2,1234,1569,10
57072535454,57072535453,-1,1102,1859,10
57075193684,57075193682,-2,1925,2605,10
57075881563,57075881560,-3,878,1921,10
57078881066,57078881064,-2,1296,2600,10
57079214403,57079214423,20,1397,1913,10
57080148139,57080148141,2,1049,1559,10
57080894300,57080894298,-2,1092,1596,10
57082245935,57082245933,-2,1402,1866,10
57084388653,57084388652,-1,1425,1720,10
57092605794,57092605791,-3,1580,1700,10
57094395897,57094395901,4,1712,1492,10
57095696377,57095696382,5,2125,1650,10
57096072063,57096072063,0,1065,1468,10
57098606100,57098606103,3,1078,1243,10
57098834061,57098834059,-2,2300,3371,10
57104655728,57104655724,-4,1308,2627,10
57105979232,57105979229,-3,1459,2045,10
57106134143,57106134139,-4,804,1871,10
57106964122,57106964119,-3,1387,3200,10
57111292362,57111292359,-3,1159,2225,10
57112226486,57112226485,-1,1273,1730,10
57113030977,57113030977,0,1257,2031,10
57114959088,57114959086,-2,1462,2203,10
57116553211,57116553209,-2,1349,1926,10
57117636499,57117636497,-2,1764,3144,10
57118111285,57118111284,-1,1517,2450,10
57123618645,57123618646,1,2419,2284,10
57125021037,57125021058,21,642,1128,10
57128107980,57128108001,21,1359,4722,10
57130256352,57130256351,-1,1424,2710,10
57130334541,57130334541,0,1303,2188,10
57132703579,57132703581,2,1101,2043,10
57133764068,57133764066,-2,1076,1642,10
57141138714,57141138714,0,1186,1312,10
57142338554,57142338555,1,2245,2178,10
57144850113,57144850115,2,1223,1390,10
57145287594,57145287591,-3,1551,3449,10
57147944898,57147944895,-3,914,1793,10
57148401042,57148401037,-5,1455,3499,10
57150092322,57150092322,0,755,1254,10
57150752481,57150752479,-2,1129,1718,10
57152060411,57152060410,-1,1371,2401,10
57152112227,57152112228,1,157,610,10
57173320733,57173320733,0,1260,2394,10
57179114303,57179114311,8,2964,1409,10
57179439789,57179439788,-1,1515,2447,10
57184563261,57184563260,-1,1275,1936,10
57190115252,57190115250,-2,1126,1948,10
57191295915,57191295913,-2,1134,1625,10
57192816191,57192816191,0,1969,1828,10
57193576595,57193576593,-2,1248,2060,10
57196308319,57196308318,-1,1610,2848,10
57199091746,57199091746,0,1617,1378,10
57200059999,57200059997,-2,1249,1737,10
57200267281,57200267302,21,957,1123,10
57200363769,57200363765,-4,1568,2495,10
57200483119,57200483121,2,923,1453,10
57202275363,57202275362,-1,917,1659,10
57205839387,57205839386,-1,1654,1950,10
57206654543,57206654541,-2,1650,3258,10
57209077894,57209077893,-1,1225,1908,10
57211037701,57211037698,-3,1105,1895,10
57211836807,57211836806,-1,1976,2058,10
57213887102,57213887099,-3,1533,1320,10
57215638548,57215638564,16,653,1422,10
57220474433,57220474430,-3,892,1570,10
57229471909,57229471906,-3,1181,1855,10
57231585470,57231585470,0,623,1462,10
57233433504,57233433502,-2,868,1615,10
57236238426,57236238430,4,2727,1759,10
57240929198,57240929197,-1,1268,2171,10
57241241152,57241241150,-2,1256,2006,10
57241739058,57241739058,0,1024,1609,10
57244160209,57244160207,-2,971,1621,10
57244963228,57244963242,14,385,820,10
57246359633,57246359631,-2,1203,2154,10
57251823667,57251823665,-2,1111,1398,10
57251854859,57251854857,-2,1635,2312,10
57254517034,57254517032,-2,1239,2434,10
57262021571,57262021570,-1,1300,1731,10
57263766905,57263766905,0,1312,2374,10
57267376716,57267376702,-14,1249,1870,10
57270206229,57270206227,-2,32101,50537,10
57270499742,57270499725,-17,1606,883,10
57270651474,57270651474,0,1646,2330,10
57270990487,57270990472,-15,1140,2067,10
57273223989,57273223988,-1,1162,1737,10
57275734956,57275734976,20,1373,2237,10
57276383868,57276383870,2,1628,1223,10
57283637522,57283637522,0,1288,1960,10
57288024142,57288024142,0,1231,2419,10
57288514338,57288514337,-1,1340,1960,10
57289128095,57289128094,-1,1447,2396,10
57289425814,57289425811,-3,1024,1968,10
57289453481,57289453501,20,306,1300,10
57291213637,57291213637,0,1443,1848,10
57293681487,57293681487,0,1367,1960,10
57295891294,57295891291,-3,1086,2229,10
57300504027,57300504026,-1,628,1408,10
57302117792,57302117792,0,1417,2199,10
57308436063,57308436062,-1,1562,1735,10
57309174540,57309174539,-1,1707,2808,10
57309780866,57309780866,0,1269,1317,10
57317251750,57317251750,0,1065,2286,10
57318925015,57318925013,-2,1062,2331,10
57321687933,57321687931,-2,1549,2718,10
57322901912,57322901915,3,1576,1622,10
57323256583,57323256581,-2,1124,1835,10
57324186785,57324186784,-1,1473,1792,10
57324760217,57324760218,1,1091,2170,10
57326775617,57326775615,-2,1507,1522,10
57327469986,57327469986,0,719,1769,10
57331102542,57331102538,-4,1386,2498,10
57332986450,57332986448,-2,1341,2247,10
57335814902,57335814902,0,1292,1897,10
57336008805,57336008806,1,3299,4029,10
57339660182,57339660182,0,1218,2350,10
57340166747,57340166748,1,2221,1950,10
57342729621,57342729625,4,1483,1593,10
57344313191,57344313189,-2,970,2290,10
57346092939,57346092943,4,1673,1133,10
57348030356,57348030355,-1,1377,1860,10
57361401046,57361401044,-2,1498,2663,10
57364510519,57364510518,-1,1995,2734,10
57372277623,57372277621,-2,1215,1566,10
57378348783,57378348782,-1,1062,1704,10
57379455365,57379455363,-2,1395,2318,10
57380247097,57380247076,-21,375,3684,10
57381175013,57381175013,0,1819,2879,10
57382588521,57382588527,6,2336,1092,10
57391554814,57391554812,-2,1321,3393,10
57391658041,57391658041,0,1236,1599,10
57393763401,57393763397,-4,1113,1827,10
57395587017,57395587022,5,2572,1467,10
57398074250,57398074249,-1,1048,1390,10
57398426595,57398426595,0,1033,2171,10
57398458918,57398458919,1,1045,1951,10
57404453505,57404453506,1,1971,2125,10
57413337451,57413337450,-1,1777,3049,10
57421669499,57421669496,-3,1323,2650,10
57423651159,57423651154,-5,2294,5405,10
57424964563,57424964560,-3,1185,3687,10
57425069843,57425069841,-2,1533,2289,10
57425186512,57425186511,-1,1310,1271,10
57429433518,57429433517,-1,1286,2313,10
57431306394,57431306399,5,2713,1636,10
57433704214,57433704215,1,1092,1132,10
57434695218,57434695222,4,2375,1764,10
57435777657,57435777654,-3,1217,2719,10
57436804695,57436804693,-2,1067,2462,10
57436874571,57436874571,0,1828,1564,10
57440637245,57440637243,-2,851,1105,10
57440890802,57440890806,4,27544,113258,10
57442524362,57442524365,3,35,1119,10
57443162746,57443162745,-1,859,1821,10
57444304822,57444304821,-1,1288,1853,10
57445186454,57445186450,-4,1076,1736,10
57446406113,57446406112,-1,1134,2069,10
57448652066,57448652063,-3,1280,2466,10
57451139186,57451139201,15,17727,28225,10
57452436966,57452436965,-1,1154,2052,10
57452834253,57452834251,-2,1249,2310,10
57454831353,57454831347,-6,2354,9040,10
57458585828,57458585826,-2,1266,2283,10
57467608871,57467608875,4,2499,1581,10
57469344904,57469344907,3,2892,1544,10
57469758353,57469758351,-2,591,1257,10
57481173338,57481173334,-4,876,1685,10
57484172038,57484172037,-1,1334,2734,10
57486484470,57486484469,-1,995,978,10
57490944491,57490944490,-1,1287,2106,10
57493295426,57493295423,-3,1269,1572,10
57493857337,57493857358,21,1168,2246,10
57496685150,57496685152,2,1253,1922,10
57499435383,57499435383,0,1024,2570,10
57499563826,57499563823,-3,1118,1986,10
57499922194,57499922191,-3,1240,1906,10
57501832758,57501832757,-1,1640,1153,10
57505213922,57505213921,-1,1090,1754,10
57506670648,57506670647,-1,1236,1864,10
57512021310,57512021309,-1,817,1745,10
57512402970,57512402967,-3,1416,2568,10
57512490255,57512490249,-6,1211,5765,10
57513338201,57513338201,0,1226,1572,10
57516008275,57516008274,-1,1042,2054,10
57518325137,57518325134,-3,1517,2568,10
57520059050,57520059049,-1,1339,1418,10
57523910965,57523910965,0,1281,1474,10
57526375335,57526375334,-1,1350,2071,10
57529566496,57529566493,-3,1072,2314,10
57530225082,57530225073,-9,908,2170,10
57531014850,57531014846,-4,1226,2590,10
57535644139,57535644138,-1,719,1739,10
57537385870,57537385870,0,1292,1567,10
57543236650,57543236649,-1,1312,1754,10
57548754685,57548754685,0,1816,2279,10
57549929778,57549929779,1,1201,1303,10
57555974148,57555974147,-1,1609,2135,10
57558689526,57558689525,-1,1015,1777,10
57559013685,57559013684,-1,1341,1595,10
57564447234,57564447234,0,1648,2603,10
57565937014,57565937013,-1,1684,2515,10
57566534613,57566534613,0,1240,1941,10
57566876478,57566876477,-1,1351,1462,10
57568113695,57568113695,0,2059,2665,10
57569464859,57569464872,13,1338,1775,10
57569628707,57569628720,13,1201,1897,10
57569949035,57569949034,-1,1108,2586,10
57572288946,57572288945,-1,1477,2368,10
57576648257,57576648255,-2,1244,1833,10
57577031069,57577031070,1,1027,1465,10
57578998350,57578998346,-4,1343,2279,10
57579934535,57579934533,-2,1024,1778,10
57589375014,57589375013,-1,1436,2121,10
57593235696,57593235697,1,421,1432,10
57600406507,57600406503,-4,943,2643,10
57603466249,57603466249,0,1260,1709,10
57607295990,57607295988,-2,1060,1661,10
57608667214,57608667211,-3,1482,2845,10
57612231866,57612231869,3,912,1133,10
57612962861,57612962858,-3,989,1404,10
57613706238,57613706238,0,1121,1477,10
57616549582,57616549579,-3,1495,2230,10
57624527490,57624527510,20,777,1885,10
57628623594,57628623592,-2,1290,2466,10
57630488069,57630488064,-5,981,1767,10
57631234825,57631234807,-18,960,1597,10
57639806442,57639806440,-2,1146,2401,10
57640552979,57640552979,0,1655,2156,10
57641204956,57641204955,-1,1089,1663,10
57643752679,57643752677,-2,827,1943,10
57643878914,57643878913,-1,1131,1833,10
57645711058,57645711063,5,2033,1043,10
57646237030,57646237033,3,991,1469,10
57650131715,57650131710,-5,1195,2655,10
57650522573,57650522571,-2,1690,2605,10
57652153898,57652153895,-3,677,2094,10
57654276445,57654276445,0,1341,1764,10
57657027046,57657027046,0,1510,1673,10
57657230964,57657230962,-2,1837,2676,10
57659007867,57659007866,-1,1458,3112,10
57660364577,57660364576,-1,1000,1673,10
57661669890,57661669891,1,1607,1338,10
57662202311,57662202310,-1,1205,1859,10
57662648969,57662648987,18,110,1363,10
57663553734,57663553734,0,1010,1623,10
57663598728,57663598739,11,81,848,10
57664781212,57664781210,-2,1324,1730,10
57668064546,57668064543,-3,1372,2938,10
57670222731,57670222729,-2,1127,2377,10
57670420688,57670420686,-2,1605,3044,10
57670862361,57670862360,-1,1180,2352,10
57672329305,57672329302,-3,1212,1909,10
57674071454,57674071454,0,1412,1441,10
57674408979,57674408978,-1,732,1072,10
57675373673,57675373671,-2,1452,1960,10
57677294418,57677294415,-3,991,1903,10
57680112554,57680112547,-7,30672,12313,10
57680421617,57680421615,-2,1064,1695,10
57681764365,57681764365,0,964,2200,10
57684082487,57684082489,2,1318,1596,10
57685330365,57685330364,-1,1547,2094,10
57686706455,57686706453,-2,1369,2330,10
57689018894,57689018893,-1,1138,1260,10
57691916577,57691916577,0,1675,1931,10
57696373378,57696373377,-1,1515,2447,10
57702077907,57702077904,-3,1126,2158,10
57703136416,57703136414,-2,1559,2066,10
57703532419,57703532421,2,1399,1093,10
57703561087,57703561086,-1,1041,1952,10
57705806179,57705806183,4,4229,2819,10
57706765154,57706765153,-1,1280,1518,10
57708341066,57708341064,-2,1188,1704,10
57711328462,57711328461,-1,979,1612,10
57711882947,57711882943,-4,1059,1951,10
57713442029,57713442027,-2,1484,1921,10
57717159625,57717159623,-2,1035,2037,10
57721731778,57721731778,0,1229,1829,10
57723054667,57723054666,-1,1179,1181,10
57723465103,57723465103,0,1529,2153,10
57725096087,57725096087,0,571,1616,10
57727032950,57727032949,-1,1219,2398,10
57744108875,57744108875,0,1347,1550,10
57745975571,57745975571,0,1245,1933,10
57752719701,57752719699,-2,1270,2129,10
57755082990,57755082988,-2,1203,1997,10
57755135437,57755135436,-1,2116,1983,10
57759259595,57759259602,7,4074,1660,10
57760045613,57760045613,0,1852,2425,10
57762582935,57762582933,-2,1031,1977,10
57764589267,57764589269,2,1423,1931,10
57765741499,57765741497,-2,1332,2680,10
57765870334,57765870334,0,1641,2809,10
57767391934,57767391930,-4,1083,1445,10
57773114370,57773114370,0,708,1155,10
57776183045,57776183041,-4,1205,3774,10
57781346921,57781346930,9,12651,34162,10
57782855518,57782855513,-5,1482,4279,10
57784644966,57784644966,0,1181,2697,10
57788610678,57788610681,3,2209,2014,10
57791203252,57791203270,18,1097,1362,10
57791553897,57791553895,-2,1812,2601,10
57797394810,57797394809,-1,948,1608,10
57797694368,57797694366,-2,1278,2764,10
57797927498,57797927495,-3,1331,1728,10
57799822119,57799822117,-2,1299,2460,10
57803542195,57803542196,1,1083,1761,10
57807540695,57807540694,-1,1108,2070,10
57808451146,57808451146,0,1734,2305,10
57808688917,57808688918,1,1494,2003,10
57810271338,57810271338,0,1446,2020,10
57816672573,57816672574,1,933,1152,10
57817818810,57817818812,2,3598,3438,10
57818150872,57818150872,0,1269,2311,10
57818265336,57818265334,-2,852,2477,10
57819267926,57819267925,-1,1372,2807,10
57820047822,57820047821,-1,1117,1873,10
57824503624,57824503623,-1,1425,1653,10
57830461295,57830461290,-5,1031,2171,10
57832153755,57832153753,-2,1487,1512,10
57833021397,57833021389,-8,900,4693,10
57836143349,57836143347,-2,1737,2846,10
57837126538,57837126536,-2,1184,2019,10
57844636772,57844636770,-2,1143,2116,10
57846059891,57846059890,-1,1301,1503,10
57846283982,57846283987,5,2809,1586,10
57847325426,57847325425,-1,432,652,10
57848567257,57848567255,-2,977,1353,10
57849343394,57849343393,-1,1355,2342,10
57850855558,57850855558,0,681,1656,10
57851010674,57851010674,0,711,1580,10
57853774142,57853774137,-5,905,1778,10
57854729891,57854729885,-6,1179,5626,10
57856552739,57856552737,-2,1524,2963,10
57856992259,57856992258,-1,1240,2152,10
57857211884,57857211885,1,2538,3558,10
57861431947,57861431946,-1,974,1987,10
57864161262,57864161259,-3,550,1157,10
57866691334,57866691332,-2,1104,1774,10
57868703202,57868703201,-1,1360,2550,10
57869182054,57869182054,0,1018,1568,10
57869482402,57869482406,4,1679,1622,10
57869552837,57869552835,-2,1341,2073,10
57870734630,57870734629,-1,927,1589,10
57870915437,57870915434,-3,1560,1874,10
57873237585,57873237584,-1,1211,2427,10
57875031862,57875031859,-3,664,1917,10
57875603851,57875603829,-22,1045,1938,10
57876217417,57876217421,4,4643,21756,10
57884458682,57884458679,-3,1083,2717,10
57884987339,57884987343,4,11161,8250,10
57885531999,57885531997,-2,1532,1936,10
57888445589,57888445588,-1,1395,1692,10
57894659742,57894659741,-1,1443,2358,10
57894874490,57894874489,-1,1076,1242,10
57897825109,57897825109,0,1616,2182,10
57904419450,57904419451,1,1428,2243,10
57905131942,57905131941,-1,1190,962,10
57907366326,57907366329,3,1369,1289,10
57914159730,57914159726,-4,1683,2561,10
57914225276,57914225274,-2,1521,2709,10
57914637375,57914637375,0,1392,1590,10
57919353010,57919353009,-1,1242,2707,10
57921075839,57921075838,-1,1280,1092,10
57921765047,57921765046,-1,1382,2248,10
57926104351,57926104349,-2,1106,1969,10
57928265449,57928265449,0,950,1264,10
57930030907,57930030906,-1,1267,1911,10
57932071791,57932071789,-2,1214,2093,10
57932505726,57932505725,-1,1021,1407,10
57939957802,57939957802,0,909,1502,10
57946330457,57946330457,0,1621,2438,10
57947520898,57947520896,-2,1727,2060,10
57948883939,57948883937,-2,1233,1780,10
57949201961,57949201983,22,767,1633,10
57956940945,57956940945,0,1236,1734,10
57958707317,57958707316,-1,2045,2476,10
57959369186,57959369185,-1,1326,2068,10
57960708000,57960708000,0,2055,1205,10
57961821610,57961821607,-3,1155,2006,10
57970374454,57970374453,-1,1691,1625,10
57972101509,57972101507,-2,1469,2846,10
57973679659,57973679667,8,2791,1509,10
57981284914,57981284913,-1,1820,1886,10
57990728633,57990728630,-3,1065,1629,10
57992462150,57992462150,0,1307,2337,10
57993970553,57993970555,2,1421,1774,10
57995408090,57995408089,-1,1254,2353,10
57995938098,57995938097,-1,1053,2442,10
57996440829,57996440829,0,1017,1853,10
57996629442,57996629433,-9,1253,2971,10
57997710521,57997710513,-8,1075,1954,10
57999625738,57999625742,4,1687,891,10
58007853225,58007853222,-3,1800,2750,10
58007982982,58007982981,-1,1157,1861,10
58010155579,58010155580,1,1877,1569,10
58011471137,58011471134,-3,1128,1890,10
58015535674,58015535673,-1,1675,2485,10
58015584027,58015584026,-1,1367,1977,10
58016222343,58016222341,-2,1309,1954,10
58017270313,58017270314,1,1479,1891,10
58017673496,58017673494,-2,1428,1913,10
58017933890,58017933890,0,1524,1561,10
58018390393,58018390410,17,479,2213,10
58018594440,58018594442,2,1680,2476,10
58021514118,58021514118,0,650,1949,10
58029547222,58029547221,-1,1965,1335,10
58030046106,58030046106,0,1096,1435,10
58031267225,58031267243,18,1044,1430,10
58042555517,58042555515,-2,1394,1742,10
58049989175,58049989174,-1,869,2164,10
58050621484,58050621482,-2,1127,1223,10
58054073012,58054073012,0,1368,1838,10
58056736191,58056736190,-1,925,1915,10
58058918750,58058918756,6,1586,866,10
58063180319,58063180331,12,9887,33302,10
58064271106,58064271107,1,1961,1196,10
58065229738,58065229738,0,1484,2041,10
58078675326,58078675326,0,1149,2113,10
58085822309,58085822306,-3,1113,2059,10
58097399142,58097399141,-1,1245,1825,10
58100145207,58100145205,-2,650,1085,10
58100891079,58100891077,-2,850,1723,10
58101550953,58101550970,17,436,1808,10
58102956648,58102956651,3,2068,1291,10
58103881631,58103881631,0,1902,2528,10
58108083273,58108083294,21,335,452,10
58109535267,58109535272,5,2292,1719,10
58111366115,58111366114,-1,1170,2367,10
58111393941,58111393938,-3,1173,1918,10
58112726786,58112726787,1,1786,1534,10
58114742090,58114742088,-2,1486,2171,10
58117623981,58117623979,-2,1782,1944,10
58117860917,58117860915,-2,1318,1850,10
58119564763,58119564763,0,1052,1767,10
58121377376,58121377375,-1,1422,2054,10
58123823034,58123823029,-5,923,1811,10
58125702385,58125702386,1,1657,1620,10
58129223730,58129223728,-2,1339,2374,10
58131215774,58131215774,0,1654,2156,10
58131663317,58131663321,4,2199,1750,10
58134682498,58134682497,-1,1237,2108,10
58135819006,58135819006,0,1384,1524,10
58140255082,58140255079,-3,886,1683,10
58144914706,58144914705,-1,791,1900,10
58147205936,58147205930,-6,11868,15260,10
58148608891,58148608889,-2,1276,2274,10
58149029736,58149029733,-3,1513,2169,10
58150028395,58150028393,-2,795,2866,10
58151842511,58151842514,3,3511,2213,10
58153793917,58153793915,-2,1440,1903,10
58153973465,58153973465,0,1011,1196,10
58157291514,58157291510,-4,658,1756,10
58158728050,58158728050,0,2843,3605,10
58171633997,58171633998,1,1241,1755,10
58175495600,58175495597,-3,1270,2322,10
58178213548,58178213546,-2,986,1725,10
58178268145,58178268145,0,1423,2086,10
58178800019,58178800018,-1,1114,1563,10
58179448593,58179448591,-2,877,2065,10
58180137002,58180137003,1,1349,1127,10
58183512102,58183512101,-1,1051,1339,10
58184326770,58184326767,-3,1194,2534,10
58186409670,58186409669,-1,1517,2524,10
58187004366,58187004365,-1,1210,2488,10
58190280102,58190280102,0,1230,2012,10
58192740420,58192740422,2,1001,1224,10
58193848048,58193848049,1,1148,1247,10
58195731097,58195731094,-3,1143,1178,10
58197778552,58197778547,-5,1026,1811,10
58197969570,58197969591,21,1692,1795,10
58198043657,58198043657,0,1415,2227,10
58199659115,58199659113,-2,1734,2808,10
58200198117,58200198114,-3,1700,4955,10
58204857665,58204857667,2,1544,1244,10
58207523635,58207523634,-1,1458,2282,10
58209752320,58209752321,1,1217,864,10
58210487635,58210487655,20,1353,1217,10
58217403326,58217403326,0,2076,1855,10
58225332163,58225332162,-1,1365,1576,10
58227913041,58227913042,1,1019,1693,10
58229451043,58229451042,-1,1616,2516,10
58231844714,58231844714,0,1239,1345,10
58233620693,58233620692,-1,1585,2076,10
58238393963,58238393967,4,2031,2114,10
58240567030,58240567019,-11,10023,37709,10
58241322765,58241322766,1,903,1251,10
58242693993,58242693986,-7,1420,6991,10
58245036382,58245036382,0,1441,2046,10
58245735079,58245735079,0,1294,1808,10
58246026322,58246026322,0,998,2157,10
58248528477,58248528477,0,1494,2048,10
58249745862,58249745860,-2,1156,1817,10
58257508356,58257508363,7,5667,2514,10
58258649261,58258649260,-1,1241,2098,10
58259944350,58259944349,-1,714,2158,10
58260340476,58260340473,-3,1149,1948,10
58261072781,58261072778,-3,1230,2574,10
58263723701,58263723700,-1,1291,2182,10
58265691014,58265691014,0,2068,1601,10
58269954643,58269954646,3,3040,3534,10
58270757686,58270757681,-5,1077,3271,10
58270913083,58270913066,-17,1103,1748,10
58273736277,58273736275,-2,1289,2145,10
58274124774,58274124774,0,978,1774,10
58274300761,58274300759,-2,1065,2108,10
58274679694,58274679694,0,1329,1926,10
58274760357,58274760358,1,1146,1495,10
58277718170,58277718168,-2,1707,3086,10
58279931678,58279931677,-1,3615,6117,10
58282120287,58282120285,-2,1511,2514,10
58282986359,58282986359,0,1006,1652,10
58285657562,58285657561,-1,1615,1806,10
58286752577,58286752584,7,3659,1838,10
58296015865,58296015866,1,3124,2408,10
58301914469,58301914473,4,1357,1487,10
58302794675,58302794674,-1,918,1420,10
58302885521,58302885518,-3,1368,2654,10
58304365113,58304365111,-2,864,1309,10
58305811409,58305811409,0,1073,1416,10
58314240062,58314240062,0,1241,1165,10
58316482537,58316482537,0,1334,2360,10
58326482039,58326482037,-2,1203,1434,10
58330164748,58330164745,-3,1123,1809,10
58330407650,58330407630,-20,1122,1785,10
58332427987,58332427986,-1,478,738,10
58338685351,58338685349,-2,875,1498,10
58339269907,58339269905,-2,1046,1505,10
58346828546,58346828551,5,2468,977,10
58347388746,58347388750,4,1660,1614,10
58348385618,58348385617,-1,1183,1924,10
58352281401,58352281401,0,1312,1852,10
58353174477,58353174478,1,1187,1954,10
58353935200,58353935199,-1,1310,1889,10
58355143132,58355143131,-1,1261,2071,10
58357080370,58357080377,7,6126,1976,10
58357694237,58357694236,-1,958,1594,10
58359221492,58359221489,-3,2313,5593,10
58359364517,58359364512,-5,732,3086,10
58364601229,58364601231,2,1238,1463,10
58365631323,58365631322,-1,2065,2806,10
58381780430,58381780433,3,2052,1558,10
58382200793,58382200790,-3,900,1175,10
58386302419,58386302418,-1,973,1319,10
58388438390,58388438390,0,1456,1267,10
58389310803,58389310803,0,1528,2426,10
58390110122,58390110122,0,1094,2217,10
58390876643,58390876641,-2,1293,2350,10
58393621502,58393621501,-1,1650,2998,10
58394615770,58394615769,-1,1980,1856,10
58396675053,58396675052,-1,1263,2069,10
58397428782,58397428782,0,1121,2217,10
58397891966,58397891963,-3,1167,2087,10
58400359392,58400359395,3,4749,3492,10
58401517314,58401517313,-1,1024,1349,10
58401589357,58401589355,-2,2684,4186,10
58402787910,58402787907,-3,1347,1459,10
58403959695,58403959693,-2,1403,1699,10
58403994274,58403994259,-15,440,931,10
58405263347,58405263346,-1,1092,1710,10
58405935624,58405935624,0,1848,1844,10
58407869035,58407869034,-1,1725,1990,10
58411569043,58411569041,-2,870,1359,10
58412753762,58412753761,-1,1360,2283,10
58412978298,58412978297,-1,1024,1659,10
58415502555,58415502557,2,1049,1196,10
58420629877,58420629874,-3,1411,1847,10
58421242537,58421242542,5,2427,1342,10
58421813671,58421813670,-1,865,1092,10
58422117162,58422117161,-1,1440,2023,10
58423780682,58423780681,-1,1610,2391,10
58424056361,58424056359,-2,1230,1965,10
58426519446,58426519445,-1,1656,3838,10
58427734046,58427734040,-6,2670,8533,10
58430994626,58430994626,0,1717,2059,10
58445000551,58445000547,-4,601,1331,10
58445533259,58445533255,-4,1486,2374,10
58449868793,58449868791,-2,1444,1300,10
58450548556,58450548560,4,3368,2114,10
58458686442,58458686441,-1,1635,2638,10
58463213410,58463213410,0,753,1061,10
58466906731,58466906731,0,1574,1741,10
58471662207,58471662202,-5,1038,3212,10
58472155713,58472155734,21,769,1142,10
58478049482,58478049483,1,1441,1954,10
58481566782,58481566777,-5,1075,2722,10
58487001234,58487001235,1,1267,1821,10
58487096422,58487096421,-1,1487,2261,10
58493417532,58493417525,-7,2326,6951,10
58494024339,58494024341,2,1220,1726,10
58495987961,58495987961,0,1361,2084,10
58496191269,58496191267,-2,1023,1521,10
58496587330,58496587329,-1,1160,1973,10
58500465886,58500465886,0,1142,1598,10
58502280892,58502280893,1,1064,778,10
58507053363,58507053361,-2,1617,2559,10
58507554753,58507554751,-2,1581,2102,10
58508317254,58508317251,-3,1320,2181,10
58508506909,58508506909,0,1393,2173,10
58515618987,58515618991,4,1585,1485,10
58517718272,58517718269,-3,1023,1723,10
58519802539,58519802538,-1,953,1981,10
58526176400,58526176397,-3,912,1981,10
58528090406,58528090403,-3,1295,1935,10
58531053563,58531053583,20,690,1343,10
58535935446,58535935446,0,1969,3136,10
58544644890,58544644888,-2,1173,2275,10
58545150450,58545150428,-22,789,1173,10
58546736241,58546736241,0,1083,2036,10
58547671910,58547671911,1,968,1427,10
58548429334,58548429333,-1,960,1437,10
58549263797,58549263794,-3,1273,1877,10
58550892398,58550892397,-1,882,1949,10
58551721476,58551721489,13,1452,4680,10
58555781923,58555781923,0,1406,1593,10
58556940987,58556940985,-2,1179,1724,10
58561596051,58561596053,2,1799,2036,10
58561780496,58561780494,-2,1574,2209,10
58561874409,58561874407,-2,1259,2486,10
58562121603,58562121602,-1,857,1624,10
58562367317,58562367316,-1,1275,1858,10
58562772290,58562772288,-2,1453,1765,10
58564572675,58564572673,-2,997,1657,10
58565667469,58565667472,3,983,1445,10
58568022082,58568022081,-1,801,822,10
58568825438,58568825437,-1,1208,1567,10
58569198416,58569198398,-18,1052,2263,10
58569675914,58569675911,-3,1216,1545,10
58571943562,58571943561,-1,663,1176,10
58572640038,58572640038,0,854,1332,10
58574602534,58574602540,6,1309,1220,10
58577066637,58577066635,-2,964,1240,10
58580243757,58580243754,-3,1433,1745,10
58583727837,58583727844,7,11981,41836,10
58584131171,58584131171,0,1398,2373,10
58587334933,58587334930,-3,1395,2975,10
58588335037,58588335037,0,1174,2023,10
58588837479,58588837479,0,856,1505,10
58589374453,58589374452,-1,1140,2264,10
58589463904,58589463902,-2,1228,2611,10
58593413745,58593413745,0,1543,2165,10
58595445050,58595445047,-3,641,510,10
58600215883,58600215882,-1,820,1610,10
58602680207,58602680211,4,1273,988,10
58613001451,58613001446,-5,1433,3591,10
58618724534,58618724534,0,1389,2067,10
58619412427,58619412427,0,1405,1691,10
58621808222,58621808223,1,1083,1815,10
58625876819,58625876818,-1,1022,1852,10
58633492654,58633492652,-2,1316,2120,10
58634218515,58634218513,-2,1321,1463,10
58634831462,58634831466,4,3075,2263,10
58636076441,58636076439,-2,1212,1839,10
58636975881,58636975877,-4,1066,1801,10
58637204914,58637204928,14,181,758,10
58638641746,58638641746,0,1062,2188,10
58640608658,58640608656,-2,1299,1778,10
58641119458,58641119459,1,2367,2647,10
58642891312,58642891309,-3,1406,2606,10
58644776426,58644776425,-1,655,2041,10
58647744906,58647744904,-2,938,1610,10
58649414737,58649414735,-2,1165,2447,10
58652317930,58652317929,-1,1230,1658,10
58654423889,58654423889,0,1082,1747,10
58657722663,58657722658,-5,1032,2997,10
58658018542,58658018539,-3,1736,2595,10
58658193111,58658193110,-1,1230,2022,10
58659190791,58659190789,-2,1338,2081,10
58660442017,58660442014,-3,1055,1276,10
58661613218,58661613219,1,1346,1593,10
58662937506,58662937502,-4,1200,3241,10
58668087639,58668087638,-1,1097,2664,10
58669871684,58669871685,1,983,1438,10
58673027695,58673027693,-2,919,1270,10
58681165965,58681165962,-3,1116,2138,10
58683020539,58683020538,-1,1162,1706,10
58688189822,58688189825,3,2042,1363,10
58691833473,58691833474,1,769,1558,10
58693042003,58693041999,-4,1098,1509,10
58693910713,58693910713,0,1219,1703,10
58695870677,58695870677,0,933,1878,10
58698747044,58698747042,-2,1413,1958,10
58701518089,58701518089,0,1776,2337,10
58706671562,58706671562,0,1114,2141,10
58708315166,58708315163,-3,973,1558,10
58709552961,58709552961,0,1362,1825,10
58710039302,58710039301,-1,1152,2975,10
58710594730,58710594714,-16,141,1265,10
58711850882,58711850880,-2,1295,2163,10
58713362639,58713362637,-2,1671,2300,10
58714257026,58714257025,-1,1519,2109,10
58720993960,58720993957,-3,1140,1714,10
58723687730,58723687726,-4,1173,3202,10
58724022650,58724022632,-18,1496,2012,10
58724443343,58724443342,-1,679,1196,10
58727369021,58727369018,-3,1364,1468,10
58729539975,58729539975,0,1582,2381,10
58734375051,58734375048,-3,1073,2009,10
58737463722,58737463722,0,1312,1538,10
58740186447,58740186446,-1,1325,2336,10
58743104239,58743104243,4,1567,1011,10
58743998297,58743998298,1,1188,1594,10
58744260889,58744260896,7,10334,1705,10
58746920810,58746920810,0,1667,3015,10
58747745783,58747745779,-4,1198,2656,10
58748548795,58748548780,-15,1169,1712,10
58750630651,58750630629,-22,1426,2194,10
58752490431,58752490428,-3,1382,1481,10
58756004127,58756004125,-2,870,1914,10
58757394445,58757394443,-2,1234,2108,10
58758278659,58758278657,-2,1355,2120,10
58763240137,58763240135,-2,682,1653,10
58767757076,58767757094,18,217,868,10
58768102486,58768102485,-1,1626,1536,10
58771930874,58771930875,1,1371,2548,10
58772174288,58772174286,-2,1097,1923,10
58775759526,58775759525,-1,789,1602,10
58777679961,58777679961,0,1149,1735,10
58782355972,58782355972,0,1419,1762,10
58787234478,58787234478,0,1002,2200,10
58793112983,58793112981,-2,1075,2778,10
58800071980,58800071978,-2,1150,1549,10
58801280143,58801280137,-6,956,3266,10
58801939537,58801939542,5,370,668,10
58802106286,58802106285,-1,1343,2150,10
58802439557,58802439559,2,2160,1427,10
58803902203,58803902202,-1,1086,1747,10
58805558137,58805558137,0,1161,2067,10
58806255189,58806255189,0,1098,1999,10
58806517163,58806517162,-1,1217,1706,10
58809256058,58809256058,0,1002,1744,10
58811368362,58811368362,0,968,1616,10
58816210627,58816210625,-2,944,2336,10
58817325405,58817325407,2,2843,2184,10
58819000782,58819000779,-3,979,2583,10
58820006677,58820006676,-1,1412,2805,10
58822582382,58822582387,5,17979,18711,10
58823832999,58823832998,-1,1167,2023,10
58825442334,58825442331,-3,1253,1939,10
58826026757,58826026755,-2,1397,1559,10
58828217277,58828217275,-2,1158,2246,10
58828564263,58828564281,18,1352,1929,10
58829587595,58829587584,-11,1078,2070,10
58830193900,58830193901,1,1464,1544,10
58832432374,58832432372,-2,2077,2738,10
58832760964,58832760960,-4,1312,2848,10
58833375124,58833375121,-3,511,983,10
58836142170,58836142169,-1,1487,2028,10
58839150962,58839150962,0,1179,2027,10
58840808722,58840808721,-1,1158,2854,10
58846096306,58846096305,-1,1397,2496,10
58846128318,58846128325,7,2509,1391,10
58848430371,58848430370,-1,1358,1703,10
58852349394,58852349395,1,763,1904,10
58853936833,58853936830,-3,824,1594,10
58857392442,58857392442,0,756,1712,10
58862571934,58862571934,0,1687,1734,10
58863577331,58863577330,-1,1514,2003,10
58873798881,58873798875,-6,2044,6009,10
58874023060,58874023059,-1,1263,2145,10
58877946606,58877946606,0,1102,1545,10
58884119701,58884119698,-3,1106,1809,10
58884937282,58884937279,-3,1045,2373,10
58885448059,58885448058,-1,1378,1721,10
58887708301,58887708300,-1,1421,2108,10
58895629275,58895629274,-1,1367,2575,10
58899033162,58899033159,-3,1236,1789,10
58902114319,58902114318,-1,963,2468,10
58904195542,58904195541,-1,1411,1404,10
58908895534,58908895532,-2,1469,2078,10
58909316418,58909316417,-1,1706,1704,10
58910278918,58910278915,-3,1294,2043,10
58912601134,58912601131,-3,1262,1599,10
58914447115,58914447113,-2,1191,1709,10
58916798357,58916798357,0,1038,1334,10
58920841787,58920841786,-1,1619,1871,10
58921817211,58921817210,-1,1460,2090,10
58925154114,58925154113,-1,1016,1882,10
58928610418,58928610417,-1,860,1108,10
58929339678,58929339678,0,1209,2014,10
58931764578,58931764577,-1,1420,2450,10
58932424040,58932424043,3,2524,1903,10
58937120992,58937120990,-2,1210,1887,10
58938331759,58938331758,-1,859,1850,10
58939589403,58939589401,-2,1184,1586,10
58939922789,58939922789,0,1326,1603,10
58940692115,58940692111,-4,1505,2849,10
58943451942,58943451941,-1,936,1888,10
58943670457,58943670455,-2,1585,2712,10
58946572186,58946572186,0,1008,1297,10
58956618593,58956618593,0,1773,2286,10
58967712907,58967712904,-3,1202,1437,10
58968685438,58968685442,4,1399,654,10
58969531458,58969531458,0,1559,1851,10
58969947251,58969947250,-1,988,1866,10
58974116597,58974116597,0,1362,1519,10
58974323266,58974323265,-1,2161,3699,10
58975207677,58975207681,4,1518,1908,10
58980332037,58980332035,-2,1180,1675,10
58982521645,58982521645,0,1416,1753,10
58987751127,58987751120,-7,945,4018,10
58990568991,58990568989,-2,1234,2064,10
58991049615,58991049616,1,1521,1987,10
58991084227,58991084245,18,1358,1841,10
58994942595,58994942595,0,1378,1656,10
58995608114,58995608113,-1,867,1177,10
58997904586,58997904581,-5,1190,2020,10
59006243866,59006243872,6,1851,1342,10
59006309291,59006309289,-2,1721,2274,10
59009089095,59009089094,-1,1745,2776,10
59014136229,59014136226,-3,841,1413,10
59017434102,59017434102,0,1708,2213,10
59019055173,59019055171,-2,1031,1688,10
59023775545,59023775545,0,1770,2120,10
59029623895,59029623891,-4,1202,2557,10
59031167358,59031167355,-3,1159,2076,10
59034785697,59034785696,-1,798,1765,10
59039157455,59039157455,0,1142,1272,10
59039911103,59039911101,-2,1088,1624,10
59049148938,59049148939,1,1106,1303,10
59051332966,59051332967,1,1246,1687,10
59051751083,59051751082,-1,1308,1958,10
59051996900,59051996919,19,189,654,10
59057801057,59057801058,1,1283,1426,10
59063861402,59063861401,-1,1339,2661,10
59068372776,59068372773,-3,1417,2960,10
59081846395,59081846394,-1,920,1951,10
59081901572,59081901586,14,907,1364,10
59083605646,59083605646,0,1035,1709,10
59084063967,59084063965,-2,1275,2139,10
59085811318,59085811316,-2,1545,1892,10
59087882087,59087882073,-14,1242,2358,10
59089133161,59089133157,-4,1855,2588,10
59090405767,59090405767,0,1109,1894,10
59096197143,59096197142,-1,1269,2035,10
59098256783,59098256781,-2,1331,2389,10
59103971367,59103971350,-17,1574,1933,10
59106832340,59106832342,2,1288,1911,10
59108029343,59108029341,-2,1233,2053,10
59112440991,59112440989,-2,1111,2351,10
59113543099,59113543098,-1,1151,2162,10
59117393553,59117393554,1,934,882,10
59117701179,59117701179,0,970,1622,10
59123570897,59123570907,10,18947,41772,10
59123617586,59123617584,-2,1203,2313,10
59125961278,59125961277,-1,1035,1852,10
59126810215,59126810213,-2,1371,1888,10
59127047791,59127047791,0,1029,1868,10
59131030909,59131030909,0,1293,2178,10
59131278956,59131278954,-2,1218,2385,10
59131969519,59131969517,-2,750,2090,10
59135661437,59135661439,2,1219,1563,10
59135971486,59135971485,-1,1144,1767,10
59139359503,59139359505,2,1059,1419,10
59139877934,59139877935,1,1535,2026,10
59142427818,59142427815,-3,1124,1572,10
59144842674,59144842671,-3,1137,1412,10
59146175571,59146175572,1,1105,2068,10
59153111507,59153111505,-2,985,1373,10
59155207369,59155207368,-1,842,1989,10
59157316418,59157316415,-3,1527,2190,10
59157470379,59157470368,-11,1177,2585,10
59159271615,59159271615,0,1311,1681,10
59166733169,59166733170,1,1116,1421,10
59175166397,59175166397,0,1136,1518,10
59176908542,59176908541,-1,1214,1835,10
59179630220,59179630225,5,4466,2521,10
59182450533,59182450534,1,1097,1211,10
59185261898,59185261897,-1,708,1847,10
59194016378,59194016378,0,1139,1309,10
59194719206,59194719206,0,856,973,10
59203179822,59203179820,-2,822,2335,10
59207041122,59207041122,0,1055,1838,10
59207396996,59207396994,-2,1434,2847,10
59208776558,59208776557,-1,1550,2583,10
59214105338,59214105337,-1,1292,2089,10
59214637484,59214637483,-1,1617,2645,10
59218361631,59218361628,-3,791,1608,10
59225392695,59225392693,-2,1179,2122,10
59229627900,59229627899,-1,1440,1647,10
59230805171,59230805168,-3,959,1699,10
59232940529,59232940526,-3,1433,1922,10
59233003681,59233003677,-4,1054,1904,10
59235983251,59235983252,1,1372,2107,10
59236530048,59236530045,-3,1517,2052,10
59237261807,59237261805,-2,939,2002,10
59241610429,59241610451,22,660,1623,10
59242632411,59242632410,-1,855,2041,10
59243624678,59243624676,-2,1033,1732,10
59245549994,59245549994,0,1079,1930,10
59245682990,59245682990,0,905,1456,10
59249256645,59249256647,2,1863,1335,10
59250011731,59250011731,0,1195,1662,10
59255392708,59255392706,-2,1582,3500,10
59256524377,59256524374,-3,1049,2368,10
59256748901,59256748898,-3,953,1921,10
59259245378,59259245380,2,723,808,10
59261269287,59261269286,-1,1271,2179,10
59261692155,59261692153,-2,946,1760,10
59266918459,59266918457,-2,1016,2029,10
59267903293,59267903292,-1,1212,1506,10
59268491821,59268491823,2,987,1077,10
59268989646,59268989646,0,1751,2967,10
59270894887,59270894884,-3,896,2092,10
59272131678,59272131678,0,825,2041,10
59275339087,59275339086,-1,1355,1461,10
59280653411,59280653407,-4,1103,1882,10
59286300733,59286300733,0,1626,1791,10
59286965417,59286965415,-2,1322,2052,10
59287431608,59287431608,0,1819,2617,10
59289653605,59289653604,-1,1574,2645,10
59292618961,59292618967,6,1010,852,10
59295568331,59295568328,-3,1024,2112,10
59297540939,59297540940,1,1225,2204,10
59298103855,59298103855,0,1570,2336,10
59300396251,59300396249,-2,1133,2068,10
59304389625,59304389622,-3,1537,1796,10
59306442402,59306442399,-3,1140,2427,10
59309893799,59309893797,-2,1380,2426,10
59312675026,59312675030,4,1021,1060,10
59314281379,59314281381,2,1155,2119,10
59314915533,59314915533,0,1196,951,10
59318253154,59318253152,-2,1452,2284,10
59322451471,59322451470,-1,1075,1794,10
59325508663,59325508661,-2,998,1824,10
59327906374,59327906374,0,1271,1414,10
59328397859,59328397854,-5,2327,7976,10
59332216425,59332216423,-2,1073,1670,10
59335702093,59335702089,-4,1586,1864,10
59339539486,59339539484,-2,1141,1766,10
59340719261,59340719262,1,1758,1416,10
59344540706,59344540706,0,1162,2274,10
59344788125,59344788123,-2,1506,2075,10
59345079274,59345079273,-1,1344,1589,10
59345710977,59345710969,-8,745,1907,10
59346032921,59346032918,-3,1296,2002,10
59353581203,59353581209,6,4090,1497,10
59354817101,59354817101,0,1075,1945,10
59355195175,59355195174,-1,960,1722,10
59355796142,59355796141,-1,226,526,10
59357588792,59357588790,-2,1496,1890,10
59358507761,59358507759,-2,1154,1811,10
59359369174,59359369174,0,1380,2055,10
59359745712,59359745709,-3,21222,17746,10
59364073193,59364073193,0,1275,1492,10
59366084435,59366084435,0,1343,2157,10
59366704809,59366704806,-3,1405,2079,10
59370726705,59370726703,-2,1391,2639,10
59376114326,59376114322,-4,1348,3145,10
59376775606,59376775606,0,1107,1966,10
59377340484,59377340483,-1,725,1399,10
59379286169,59379286169,0,1252,2050,10
59379571999,59379572015,16,1170,1606,10
59380430960,59380430958,-2,1257,2095,10
59385307994,59385307991,-3,863,2060,10
59387381075,59387381074,-1,1115,1949,10
59389725491,59389725490,-1,1828,2276,10
59389907085,59389907083,-2,1198,1695,10
59390221939,59390221930,-9,714,1888,10
59392610662,59392610661,-1,1349,1954,10
59393884587,59393884579,-8,33086,7367,10
59394422859,59394422859,0,2972,2697,10
59394490138,59394490138,0,969,1812,10
59396465389,59396465387,-2,1661,2288,10
59396773529,59396773527,-2,1179,1543,10
59397770178,59397770177,-1,1955,2985,10
59401192562,59401192561,-1,1060,1694,10
59402491867,59402491865,-2,1095,2101,10
59403418456,59403418459,3,3674,2343,10
59404515423,59404515429,6,1003,959,10
59404540522,59404540505,-17,1535,758,10
59405643227,59405643223,-4,1365,2131,10
59406405330,59406405324,-6,22081,18398,10
59412011370,59412011366,-4,972,3506,10
59412363659,59412363658,-1,590,1165,10
59415195739,59415195738,-1,1183,1775,10
59417867544,59417867542,-2,661,1708,10
59422970183,59422970183,0,1811,1994,10
59428307828,59428307827,-1,1178,2208,10
59430816811,59430816797,-14,775,1920,10
59432613057,59432613056,-1,1258,2272,10
59432699351,59432699350,-1,1855,2281,10
59436085110,59436085110,0,1507,2415,10
59436362370,59436362370,0,1243,1510,10
59437390581,59437390578,-3,1792,2708,10
59438931618,59438931616,-2,1183,1883,10
59439135897,59439135898,1,1638,2192,10
59440538378,59440538378,0,1274,2377,10
59444597225,59444597223,-2,1109,2117,10
59453382197,59453382197,0,1214,1794,10
59453582280,59453582280,0,1711,1733,10
59456756633,59456756629,-4,1083,2180,10
59457009757,59457009757,0,1894,2531,10
59457507131,59457507129,-2,738,2038,10
59457790498,59457790481,-17,1102,1969,10
59458654658,59458654660,2,1042,1829,10
59460072004,59460072006,2,1587,1410,10
59461063499,59461063498,-1,1176,1792,10
59462056288,59462056285,-3,1352,1944,10
59467391959,59467391958,-1,1781,2671,10
59471445170,59471445170,0,989,1492,10
59472074918,59472074914,-4,1388,2226,10
59472857547,59472857546,-1,1097,1744,10
59475277015,59475277012,-3,1428,2667,10
59475547737,59475547733,-4,1386,2400,10
59477393355,59477393354,-1,1790,2393,10
59477624603,59477624604,1,1115,1059,10
59484835461,59484835459,-2,1538,2578,10
59489784734,59489784734,0,1764,2851,10
59490670513,59490670509,-4,1702,3221,10
59490963395,59490963394,-1,1661,3032,10
59491561594,59491561592,-2,1298,2271,10
59493162483,59493162481,-2,1144,1547,10
59496024923,59496024923,0,1053,1983,10
59496060907,59496060901,-6,2037,7151,10
59496929294,59496929290,-4,1683,2664,10
59497288182,59497288182,0,1652,2500,10
59497947887,59497947886,-1,1330,1977,10
59498505725,59498505722,-3,968,2379,10
59499776650,59499776648,-2,1065,1798,10
59500429139,59500429157,18,1553,2563,10
59501252544,59501252543,-1,1445,2133,10
59502530984,59502530983,-1,1136,2374,10
59502683942,59502683941,-1,1467,2670,10
59503588145,59503588143,-2,1080,1376,10
59507657846,59507657845,-1,1655,2219,10
59509971475,59509971470,-5,1046,4119,10
59510101482,59510101498,16,110,701,10
59510703345,59510703366,21,718,1428,10
59511155765,59511155762,-3,1792,2854,10
59512436438,59512436438,0,928,2029,10
59513217639,59513217638,-1,1174,1644,10
59514265640,59514265621,-19,1267,2111,10
59514665587,59514665586,-1,1174,1528,10
59516829362,59516829365,3,4009,2413,10
59519041706,59519041703,-3,1298,2221,10
59520708959,59520708956,-3,763,1310,10
59524006347,59524006347,0,998,1327,10
59525216867,59525216862,-5,1046,2712,10
59529258778,59529258774,-4,776,1642,10
59537705302,59537705302,0,749,1576,10
59539285566,59539285565,-1,1177,2349,10
59540992161,59540992158,-3,1123,2004,10
59543196583,59543196581,-2,1668,2041,10
59546070291,59546070290,-1,911,1731,10
59549016467,59549016464,-3,1055,1766,10
59549423810,59549423806,-4,1169,1779,10
59549679322,59549679319,-3,1142,1774,10
59550474174,59550474173,-1,1050,1310,10
59551653991,59551653990,-1,1007,1538,10
59558033233,59558033233,0,1195,1409,10
59561531935,59561531934,-1,1181,1700,10
59564260026,59564260025,-1,1115,1799,10
59565074603,59565074602,-1,1601,1665,10
59565974257,59565974256,-1,1511,2959,10
59567210452,59567210449,-3,18254,15969,10
59568556739,59568556737,-2,1468,1901,10
59571513096,59571513095,-1,1109,2769,10
59575474786,59575474786,0,1267,1391,10
59576146732,59576146730,-2,1218,2066,10
59578337836,59578337835,-1,1564,2226,10
59581248286,59581248285,-1,951,2052,10
59586694090,59586694089,-1,1908,2395,10
59589685262,59589685261,-1,544,1015,10
59593670455,59593670455,0,1064,1809,10
59594426852,59594426850,-2,1595,2737,10
59595590841,59595590838,-3,1439,2040,10
59595828588,59595828586,-2,1063,1493,10
59598576699,59598576695,-4,887,1412,10
59600580478,59600580481,3,1140,1404,10
59606000755,59606000755,0,1524,2154,10
59607589117,59607589121,4,2157,1761,10
59611573999,59611573999,0,905,1646,10
59614526921,59614526921,0,1841,1568,10
59615620700,59615620700,0,1714,2046,10
59615785020,59615785017,-3,643,1678,10
59618182545,59618182550,5,716,1278,10
59618781661,59618781662,1,1953,1344,10
59620951785,59620951782,-3,1369,2220,10
59632058434,59632058431,-3,2069,2443,10
59634363822,59634363824,2,1583,1742,10
59635537446,59635537444,-2,1474,2442,10
59636900959,59636900958,-1,1138,2101,10
59641185182,59641185182,0,1539,1991,10
59642612539,59642612538,-1,1819,2420,10
59642936508,59642936506,-2,1207,2300,10
59644396119,59644396118,-1,886,1227,10
59645662295,59645662294,-1,1428,1822,10
59645738333,59645738331,-2,1598,1967,10
59649218211,59649218208,-3,2605,5075,10
59652925990,59652925994,4,1895,1068,10
59654919686,59654919685,-1,976,1495,10
59655384538,59655384538,0,1080,2102,10
59658620994,59658620993,-1,1334,2092,10
59661108777,59661108774,-3,1409,2018,10
59665124508,59665124506,-2,1777,2363,10
59668524131,59668524118,-13,1245,1518,10
59669724651,59669724652,1,1308,1795,10
59674469614,59674469613,-1,1600,1907,10
59677808825,59677808825,0,1298,2221,10
59681486030,59681486030,0,1190,1433,10
59683593972,59683593966,-6,1970,6029,10
59686127201,59686127200,-1,967,2374,10
59686375802,59686375808,6,3212,1546,10
59686488702,59686488702,0,1349,1424,10
59692192533,59692192526,-7,1150,2981,10
59696430542,59696430541,-1,1397,2006,10
59702272239,59702272237,-2,1478,2525,10
59706392110,59706392108,-2,659,1954,10
59707505083,59707505085,2,504,1045,10
59707948925,59707948921,-4,1743,2085,10
59708468983,59708468980,-3,1222,1595,10
59710604053,59710604053,0,890,1712,10
59713676654,59713676657,3,1887,1661,10
59717145646,59717145644,-2,1202,1508,10
59717704022,59717704026,4,1660,2388,10
59718026917,59718026914,-3,874,1738,10
59719962514,59719962514,0,1059,1711,10
59721176705,59721176705,0,1208,1728,10
59724795498,59724795502,4,1181,1683,10
59729691909,59729691907,-2,1477,2647,10
59729957173,59729957173,0,1326,1976,10
59730528954,59730528954,0,936,2073,10
59730680735,59730680735,0,1164,2083,10
59731236371,59731236369,-2,969,1718,10
59731539516,59731539534,18,1271,2771,10
59731829439,59731829435,-4,810,3267,10
59738221094,59738221092,-2,678,1685,10
59739017094,59739017094,0,1370,2087,10
59739570322,59739570318,-4,688,1068,10
59740677258,59740677257,-1,1626,2292,10
59741741241,59741741241,0,8513,49943,10
59741857381,59741857387,6,2938,734,10
59745709095,59745709093,-2,663,1689,10
59748063998,59748063998,0,991,1550,10
59752806674,59752806674,0,1456,2150,10
59757071212,59757071214,2,2233,1159,10
59758706606,59758706606,0,856,1658,10
59761010564,59761010562,-2,1697,2356,10
59762412563,59762412562,-1,1265,2035,10
59762763076,59762763073,-3,1309,2637,10
59763146843,59763146842,-1,1226,1633,10
59764561768,59764561766,-2,1259,2675,10
59764638311,59764638310,-1,1343,1652,10
59766434535,59766434533,-2,1122,2380,10
59768680931,59768680930,-1,1322,1890,10
59770310222,59770310225,3,3542,2598,10
59772394922,59772394921,-1,1459,1782,10
59772495600,59772495599,-1,1046,1446,10
59773904291,59773904290,-1,1001,1721,10
59779306897,59779306894,-3,1398,1229,10
59780244066,59780244072,6,568,1151,10
59782913079,59782913077,-2,1792,2589,10
59783497877,59783497876,-1,1553,1583,10
59784265886,59784265887,1,794,1254,10
59785017211,59785017210,-1,1558,1407,10
59786031075,59786031074,-1,1257,2427,10
59787337514,59787337513,-1,910,1549,10
59788181842,59788181839,-3,1252,2309,10
59788839414,59788839409,-5,1811,6252,10
59789336057,59789336050,-7,3147,10360,10
59790933599,59790933598,-1,1235,2024,10
59791067731,59791067731,0,2556,3298,10
59791962648,59791962648,0,920,2294,10
59792632594,59792632591,-3,1159,2008,10
59804283315,59804283314,-1,895,2136,10
59804782030,59804782027,-3,1151,2198,10
59805701640,59805701638,-2,1433,2615,10
59812596054,59812596053,-1,917,1725,10
59823477777,59823477774,-3,1086,1625,10
59826525591,59826525589,-2,1027,2288,10
59827348876,59827348871,-5,632,4214,10
59827440482,59827440495,13,432,1093,10
59828169342,59828169341,-1,1105,1873,10
59832182450,59832182447,-3,1178,1575,10
59833980261,59833980261,0,1363,2116,10
59836586254,59836586255,1,1323,1503,10
59836974256,59836974254,-2,1422,2651,10
59840548435,59840548434,-1,1228,1645,10
59841394230,59841394229,-1,1477,2042,10
59842837352,59842837349,-3,1559,2068,10
59845690814,59845690812,-2,1279,1827,10
59847273158,59847273158,0,1272,1337,10
59848106482,59848106482,0,1208,1671,10
59850115273,59850115273,0,1499,2971,10
59855620699,59855620698,-1,1225,2290,10
59856748043,59856748041,-2,1205,2144,10
59858105053,59858105050,-3,1504,2101,10
59860217543,59860217541,-2,1257,2182,10
59863569427,59863569419,-8,1356,1706,10
59863823582,59863823596,14,7004,50572,10
59869417794,59869417792,-2,1214,2294,10
59870411799,59870411800,1,1274,1706,10
59874238397,59874238395,-2,1119,1370,10
59875120167,59875120170,3,7768,7027,10
59875488610,59875488609,-1,796,1381,10
59879308017,59879308016,-1,1775,1826,10
59887637986,59887637985,-1,1202,2248,10
59888384309,59888384310,1,1139,1576,10
59892204814,59892204819,5,2525,1230,10
59901429558,59901429557,-1,1168,1506,10
59905001044,59905001044,0,39259,18758,10
59906997733,59906997733,0,1531,1540,10
59907362643,59907362639,-4,1362,2326,10
59908284735,59908284734,-1,1100,1642,10
59908737297,59908737286,-11,1098,2022,10
59908912766,59908912766,0,1053,1806,10
59909848706,59909848705,-1,848,1746,10
59910482555,59910482555,0,973,1410,10
59913743011,59913743010,-1,751,1383,10
59917348578,59917348579,1,794,1665,10
59923028906,59923028903,-3,1195,2216,10
59923085618,59923085597,-21,235,791,10
59924702370,59924702366,-4,1084,1901,10
59926295220,59926295218,-2,930,1850,10
59931122665,59931122662,-3,1367,1648,10
59932610034,59932610034,0,897,2005,10
59937163091,59937163090,-1,1039,2365,10
59937427652,59937427650,-2,1055,2036,10
59937888407,59937888404,-3,1470,2419,10
59938027983,59938027982,-1,1645,2884,10
59941749350,59941749347,-3,924,1699,10
59942324150,59942324149,-1,976,1884,10
59943824296,59943824296,0,1481,2743,10
59947710372,59947710371,-1,1342,1972,10
59948407455,59948407453,-2,766,2036,10
59950762423,59950762422,-1,1030,1144,10
59954661888,59954661886,-2,1781,2962,10
59955905626,59955905622,-4,1457,2286,10
59956711897,59956711898,1,1395,1764,10
59956782087,59956782086,-1,529,1532,10
59957542734,59957542733,-1,874,1635,10
59958251274,59958251273,-1,1271,2133,10
59959941255,59959941253,-2,1338,1899,10
59963057207,59963057209,2,1482,1771,10
59964396974,59964396972,-2,1005,1441,10
59965351505,59965351503,-2,1654,2452,10
59965912206,59965912206,0,614,1540,10
59968586850,59968586850,0,1401,2122,10
59969136121,59969136118,-3,1139,2423,10
59969390022,59969390023,1,1450,1681,10
59970039762,59970039760,-2,1037,2456,10
59970406763,59970406762,-1,875,1207,10
59975664015,59975664015,0,1013,1732,10
59976345138,59976345135,-3,1497,2128,10
59976890322,59976890318,-4,1040,1476,10
59980066361,59980066361,0,1445,2448,10
59982264933,59982264934,1,1868,2053,10
59982658659,59982658657,-2,1519,2963,10
59983069233,59983069234,1,1502,1068,10
59984484990,59984484989,-1,1288,2048,10
59985418877,59985418865,-12,2514,4719,10
59991070982,59991070981,-1,1282,1755,10
59992739038,59992739037,-1,1783,2671,10
59994062390,59994062397,7,2995,1423,10
59998618891,59998618890,-1,1083,2775,10
59999989592,59999989590,-2,1315,2102,10
60000405055,60000405050,-5,2323,5708,10
60000576694,60000576694,0,892,1648,10
60001769353,60001769350,-3,1275,1847,10
60004229919,60004229918,-1,1883,2308,10
60007253117,60007253118,1,1761,2106,10
60007321159,60007321156,-3,1204,1954,10
60011701349,60011701347,-2,1326,1931,10
60014461169,60014461169,0,1370,1956,10
60018277350,60018277350,0,1380,2201,10
60021352920,60021352917,-3,1144,2344,10
60026451385,60026451383,-2,1170,2790,10
60030613015,60030613011,-4,1442,1732,10
60031388598,60031388602,4,1424,1181,10
60032505142,60032505139,-3,1306,2466,10
60033343680,60033343679,-1,891,2353,10
60034166423,60034166421,-2,1143,1827,10
60034329895,60034329893,-2,1230,1951,10
60036899441,60036899439,-2,1254,1955,10
60037518214,60037518213,-1,1299,2046,10
60038429654,60038429655,1,1124,1603,10
60039332002,60039331998,-4,1522,2283,10
60040097911,60040097910,-1,1218,2632,10
60041122265,60041122262,-3,1209,2097,10
60046442932,60046442933,1,1291,2044,10
60054406203,60054406202,-1,1038,2357,10
60063403265,60063403261,-4,1171,2652,10
60069121527,60069121529,2,1658,1832,10
60069592808,60069592806,-2,1320,2220,10
60072252177,60072252174,-3,1172,1981,10
60072700161,60072700159,-2,1494,2687,10
60076973155,60076973150,-5,273,696,10
60080296003,60080296001,-2,1538,2481,10
60082340950,60082340946,-4,1497,2953,10
60083008490,60083008491,1,845,1242,10
60085715598,60085715594,-4,1204,3626,10
60085762851,60085762851,0,275,757,10
60086294002,60086294001,-1,1744,2368,10
60087134045,60087134043,-2,1077,2334,10
60087228596,60087228593,-3,1300,2285,10
60090019325,60090019322,-3,1572,2683,10
60099798969,60099798966,-3,1138,1576,10
60100257633,60100257612,-21,1546,2563,10
60104838290,60104838290,0,667,1448,10
60106053910,60106053910,0,1287,2447,10
60107074373,60107074374,1,1248,1736,10
60108768438,60108768437,-1,1067,1274,10
60112749377,60112749374,-3,1320,1701,10
60113041582,60113041581,-1,1014,2079,10
60113078417,60113078416,-1,1158,2281,10
60115260633,60115260629,-4,1435,2426,10
60118471318,60118471317,-1,972,2433,10
60122987054,60122987054,0,778,1604,10
60123951657,60123951654,-3,1257,2834,10
60125760086,60125760089,3,1003,1529,10
60127461025,60127461024,-1,1236,2099,10
60130226303,60130226302,-1,1139,2455,10
60132090638,60132090636,-2,1321,1812,10
60138057978,60138057975,-3,1175,2154,10
60138951541,60138951541,0,1280,1579,10
60143341602,60143341601,-1,1074,1819,10
60145895373,60145895372,-1,1265,2572,10
60152308819,60152308816,-3,914,1989,10
60156483870,60156483861,-9,828,9922,10
60156824607,60156824605,-2,968,1514,10
60157659713,60157659713,0,641,1247,10
60158842378,60158842377,-1,1122,1779,10
60161201969,60161201973,4,1335,1711,10
60161681581,60161681582,1,1283,1621,10
60164314518,60164314517,-1,1443,2249,10
60165028965,60165028962,-3,1014,2193,10
60173492222,60173492223,1,1158,1416,10
60177798586,60177798589,3,1498,1485,10
60180124181,60180124181,0,1428,1830,10
60180626610,60180626606,-4,824,1530,10
60182029195,60182029189,-6,954,2303,10
60182165011,60182165010,-1,909,1968,10
60183663323,60183663319,-4,1215,4076,10
60184066079,60184066077,-2,1162,2546,10
60184513012,60184513009,-3,716,2126,10
60185213762,60185213762,0,1214,1861,10
60190255282,60190255281,-1,1443,1919,10
60190863641,60190863638,-3,1421,3170,10
60191164590,60191164586,-4,557,3551,10
60192553227,60192553226,-1,1726,2363,10
60201241065,60201241063,-2,1857,2894,10
60202738893,60202738891,-2,1221,1838,10
60202772735,60202772734,-1,878,1683,10
60204434473,60204434473,0,1044,2033,10
60207991402,60207991401,-1,1854,2314,10
60208670697,60208670696,-1,1444,2115,10
60210081576,60210081576,0,762,1604,10
60211614454,60211614450,-4,1195,2102,10
60217266869,60217266870,1,1430,1947,10
60218913837,60218913837,0,1390,2063,10
60220655104,60220655101,-3,991,2294,10
60222353274,60222353275,1,1694,1962,10
60225377228,60225377226,-2,1161,1967,10
60227401833,60227401833,0,1088,1931,10
60229524891,60229524890,-1,943,1909,10
60231828435,60231828435,0,1171,1912,10
60234023095,60234023093,-2,1980,3375,10
60240583077,60240583077,0,1164,1262,10
60245431211,60245431209,-2,1326,2343,10
60246930638,60246930657,19,724,1320,10
60250549850,60250549847,-3,852,1746,10
60250585410,60250585414,4,2988,1540,10
60257715901,60257715901,0,1366,1769,10
60259697731,60259697733,2,2603,2737,10
60260670557,60260670555,-2,668,1194,10
60263725920,60263725919,-1,1697,2386,10
60265750387,60265750385,-2,934,2130,10
60268498976,60268498972,-4,1323,3090,10
60271670049,60271670048,-1,1544,3014,10
60275332160,60275332157,-3,872,1388,10
60277094297,60277094295,-2,1691,2361,10
60279735198,60279735195,-3,1399,3277,10
60283535827,60283535827,0,1491,1839,10
60286170071,60286170078,7,2266,824,10
60287558765,60287558770,5,2382,814,10
60289796219,60289796217,-2,1537,2100,10
60291405103,60291405105,2,982,1201,10
60295433474,60295433473,-1,1215,2249,10
60298684298,60298684297,-1,1328,2197,10
60300999910,60300999926,16,1274,2144,10
60303107089,60303107090,1,1550,2206,10
60305329479,60305329479,0,1041,1942,10
60305688529,60305688528,-1,1606,1475,10
60308299351,60308299350,-1,854,1626,10
60312867353,60312867350,-3,1003,2025,10
60317287750,60317287749,-1,1306,2525,10
60318499466,60318499467,1,1285,1850,10
60319419246,60319419245,-1,1507,2080,10
60319961232,60319961230,-2,1087,1409,10
60323474991,60323474990,-1,1121,1538,10
60325619130,60325619126,-4,1389,3917,10
60333761417,60333761415,-2,1503,2094,10
60333980835,60333980834,-1,2031,2665,10
60345047096,60345047093,-3,1414,1599,10
60345606755,60345606753,-2,1190,1990,10
60354125325,60354125323,-2,1435,1585,10
60354311921,60354311914,-7,294,710,10
60357134805,60357134802,-3,786,1736,10
60358035530,60358035529,-1,1111,1798,10
60360056125,60360056125,0,1106,1312,10
60363291520,60363291529,9,18535,16190,10
60365981769,60365981769,0,1912,2679,10
60372745833,60372745835,2,1452,1531,10
60373955062,60373955061,-1,1102,2261,10
60380212418,60380212417,-1,940,2468,10
60383512514,60383512514,0,723,1412,10
60384987476,60384987474,-2,977,1842,10
60386691690,60386691693,3,1454,1293,10
60387176393,60387176373,-20,985,1772,10
60389529522,60389529522,0,870,1312,10
60390229590,60390229589,-1,1181,2252,10
60392850964,60392850962,-2,1677,2699,10
60393829689,60393829687,-2,1199,2552,10
60398236534,60398236532,-2,1356,2632,10
60401335369,60401335365,-4,1183,2423,10
60403153381,60403153381,0,1476,2482,10
60403829178,60403829176,-2,1959,2188,10
60404802477,60404802474,-3,841,2256,10
60405008805,60405008803,-2,1385,1693,10
60405710622,60405710622,0,1129,1943,10
60406299028,60406299010,-18,143,460,10
60410935990,60410935989,-1,2690,2452,10
60411838394,60411838392,-2,1272,2016,10
60412411388,60412411387,-1,1644,2303,10
60417120774,60417120769,-5,1863,5286,10
60417520088,60417520086,-2,1301,1910,10
60421341407,60421341408,1,1966,2219,10
60422679475,60422679482,7,3518,1513,10
60424073402,60424073398,-4,831,2515,10
60431349106,60431349105,-1,1049,1329,10
60431941483,60431941483,0,604,1415,10
60432088914,60432088934,20,659,1137,10
60434809792,60434809794,2,1793,1965,10
60438931111,60438931107,-4,1293,1941,10
60439586409,60439586406,-3,933,2069,10
60440461402,60440461414,12,1181,1737,10
60443804842,60443804841,-1,1478,2001,10
60445076265,60445076266,1,1298,1777,10
60445263307,60445263305,-2,1210,1805,10
60445393642,60445393640,-2,893,2943,10
60446244003,60446244002,-1,1335,2323,10
60453204795,60453204789,-6,1314,4384,10
60455404511,60455404511,0,643,939,10
60459589605,60459589604,-1,1379,2169,10
60461522357,60461522355,-2,1097,1839,10
60462667110,60462667109,-1,1421,2094,10
60463721885,60463721884,-1,1741,2659,10
60464226095,60464226095,0,1274,1867,10
60464644960,60464644981,21,716,1290,10
60465309815,60465309814,-1,862,1834,10
60468206322,60468206321,-1,1256,1991,10
60471995807,60471995797,-10,1152,4855,10
60477857198,60477857197,-1,1545,1966,10
60478964535,60478964534,-1,1940,1758,10
60480476959,60480476957,-2,1057,2581,10
60484429947,60484429947,0,1564,2145,10
60488467116,60488467122,6,3551,1013,10
60489428450,60489428448,-2,672,2432,10
60491465594,60491465582,-12,295,1143,10
60492627564,60492627558,-6,1800,3930,10
60499692746,60499692747,1,780,1226,10
60500664908,60500664904,-4,931,1532,10
60502073446,60502073446,0,1373,2064,10
60503991575,60503991572,-3,1250,1917,10
60507439741,60507439739,-2,1172,2229,10
60507827718,60507827717,-1,848,1327,10
60510846083,60510846082,-1,1074,1459,10
60513842095,60513842096,1,1130,1590,10
60514066714,60514066712,-2,888,2227,10
60515357502,60515357500,-2,1046,2023,10
60515618458,60515618458,0,925,1739,10
60517010082,60517010081,-1,1869,2465,10
60518778186,60518778189,3,7710,7581,10
60520511338,60520511334,-4,1052,1308,10
60524589395,60524589411,16,387,258,10
60530925706,60530925704,-2,1228,2495,10
60535317882,60535317893,11,1321,1570,10
60537125583,60537125579,-4,1121,1939,10
60538226621,60538226622,1,584,1009,10
60538766160,60538766166,6,2789,1585,10
60540177041,60540177037,-4,1434,2273,10
60540663995,60540663993,-2,1537,1633,10
60542185308,60542185314,6,4586,1440,10
60547983042,60547983041,-1,1042,1660,10
60549967565,60549967566,1,1134,2028,10
60551259953,60551259955,2,848,1883,10
60553066961,60553066960,-1,1359,2429,10
60553194319,60553194317,-2,1061,1495,10
60556428854,60556428851,-3,1782,2308,10
60556596362,60556596360,-2,1173,1578,10
60558153459,60558153458,-1,1266,1749,10
60558370011,60558370024,13,772,3133,10
60563470171,60563470172,1,1033,1773,10
60563583518,60563583519,1,1312,1492,10
60572770194,60572770188,-6,1283,2322,10
60573598061,60573598069,8,13879,4590,10
60576999131,60576999129,-2,1000,1657,10
60578803855,60578803854,-1,1165,2347,10
60582297504,60582297501,-3,1177,2455,10
60582503113,60582503133,20,100,1542,10
60587209247,60587209246,-1,1017,1129,10
60590778163,60590778162,-1,1346,2004,10
60591171728,60591171727,-1,752,1738,10
60591828538,60591828523,-15,269,735,10
60594467101,60594467108,7,1998,1232,10
60599930178,60599930178,0,1414,2504,10
60601135679,60601135682,3,1590,1429,10
60603552730,60603552730,0,1036,1592,10
60604159446,60604159445,-1,1383,2199,10
60605864555,60605864565,10,2916,577,10
60606238485,60606238482,-3,958,1669,10
60611641474,60611641473,-1,926,1350,10
60615099742,60615099741,-1,1358,1672,10
60618756361,60618756360,-1,1204,2147,10
60620092931,60620092931,0,975,1297,10
60625016495,60625016495,0,1775,2696,10
60626186589,60626186590,1,1047,1405,10
60628067126,60628067123,-3,1015,1427,10
60629002201,60629002202,1,1101,1334,10
60629813425,60629813422,-3,1482,2199,10
60631082422,60631082422,0,1295,1858,10
60640345290,60640345289,-1,410,1079,10
60641721958,60641721953,-5,712,2820,10
60642033071,60642033069,-2,856,1345,10
60642660894,60642660895,1,3120,2898,10
60642943919,60642943920,1,1451,1498,10
60643675628,60643675626,-2,811,2328,10
60645756990,60645756991,1,1110,1632,10
60648588694,60648588692,-2,1297,2371,10
60656677144,60656677126,-18,1110,1971,10
60658533355,60658533361,6,1452,1131,10
60663982558,60663982556,-2,1049,1895,10
60671863151,60671863149,-2,1933,2598,10
60679922850,60679922847,-3,760,2114,10
60682907349,60682907348,-1,1052,1601,10
60684248058,60684248056,-2,1247,2153,10
60685468814,60685468814,0,971,1848,10
60687647710,60687647710,0,1055,1131,10
60692765017,60692765018,1,1663,1877,10
60696787532,60696787529,-3,1202,2118,10
60697020020,60697020038,18,1139,1485,10
60699499860,60699499861,1,1640,2040,10
60701872674,60701872689,15,396,563,10
60703125192,60703125190,-2,1196,1726,10
60705285697,60705285694,-3,1298,1567,10
60709292934,60709292930,-4,1555,2444,10
60711566733,60711566738,5,723,734,10
60714043578,60714043577,-1,1843,2006,10
60717082854,60717082850,-4,1261,1904,10
60717336649,60717336644,-5,1560,2242,10
60721654322,60721654321,-1,1304,2115,10
60724663416,60724663415,-1,1291,1795,10
60724841733,60724841731,-2,1465,2311,10
60729362265,60729362262,-3,1493,1912,10
60734719344,60734719334,-10,1262,461,10
60737742705,60737742706,1,1276,1814,10
60738188494,60738188493,-1,1290,2138,10
60743719795,60743719794,-1,927,1585,10
60745093830,60745093826,-4,1678,3953,10
60748789338,60748789337,-1,1188,3054,10
60750427323,60750427320,-3,1178,2288,10
60755235563,60755235562,-1,1532,2879,10
60755511622,60755511623,1,779,1492,10
60755859763,60755859762,-1,979,1454,10
60763400502,60763400504,2,1643,1799,10
60765904016,60765904002,-14,706,1265,10
60766698547,60766698543,-4,1056,2209,10
60769186458,60769186457,-1,1281,1536,10
60769420446,60769420443,-3,1190,1959,10
60769927681,60769927681,0,1048,1456,10
60773803354,60773803355,1,1499,1819,10
60774488476,60774488473,-3,1369,1863,10
60778553354,60778553352,-2,1142,1267,10
60779919730,60779919723,-7,1059,4630,10
60784351799,60784351797,-2,1253,2193,10
60786195803,60786195798,-5,761,1461,10
60786884717,60786884714,-3,1034,2274,10
60793211049,60793211049,0,1778,1922,10
60795714402,60795714400,-2,613,1568,10
60796332853,60796332852,-1,984,2069,10
60797636762,60797636758,-4,578,199,10
60799338379,60799338377,-2,1336,1516,10
60799880064,60799880062,-2,1371,1853,10
60804005985,60804005983,-2,1341,2662,10
60815915399,60815915398,-1,1518,2116,10
60815986988,60815986986,-2,689,2255,10
60817810214,60817810213,-1,1240,2415,10
60818179784,60818179775,-9,747,1715,10
60819180666,60819180665,-1,786,1565,10
60820157234,60820157236,2,847,1535,10
60821440978,60821440978,0,1494,2681,10
60822502291,60822502287,-4,824,2338,10
60824642383,60824642380,-3,922,1632,10
60835533550,60835533549,-1,1082,2443,10
60839220207,60839220207,0,1760,1822,10
60841593223,60841593223,0,1140,2608,10
60846627403,60846627401,-2,839,1801,10
60848574357,60848574354,-3,840,1764,10
60849928217,60849928214,-3,827,2248,10
60851722557,60851722556,-1,1888,1940,10
60853787138,60853787138,0,1048,1793,10
60855135857,60855135847,-10,15788,26631,10
60855658051,60855658049,-2,1413,2286,10
60860931589,60860931587,-2,1335,2079,10
60862907521,60862907518,-3,888,2082,10
60863123562,60863123562,0,976,1068,10
60863596606,60863596606,0,1150,2024,10
60865945699,60865945705,6,4294,1607,10
60868448624,60868448626,2,1159,1179,10
60869734290,60869734292,2,36719,80484,10
60871405023,60871405023,0,1130,1896,10
60873571249,60873571251,2,1185,1291,10
60875566723,60875566721,-2,1093,1529,10
60883179643,60883179642,-1,1166,2224,10
60883335290,60883335289,-1,927,1869,10
60887098402,60887098403,1,1433,2263,10
60888386994,60888386994,0,1239,1727,10
60890868114,60890868114,0,1557,1345,10
60891440885,60891440886,1,1356,1594,10
60894288258,60894288254,-4,1382,2074,10
60896334979,60896334978,-1,1234,2695,10
60898145114,60898145117,3,1591,1080,10
60902981565,60902981564,-1,1068,1860,10
60903252158,60903252157,-1,1173,1969,10
60905417011,60905417014,3,1254,1971,10
60906453131,60906453129,-2,1456,2350,10
60908587843,60908587841,-2,1048,1967,10
60909087297,60909087295,-2,1272,2569,10
60911896331,60911896330,-1,1673,2165,10
60912984999,60912985002,3,882,1552,10
60917004801,60917004799,-2,1349,1582,10
60919948561,60919948559,-2,1332,2614,10
60921438503,60921438502,-1,1338,1777,10
60926117856,60926117855,-1,4148,6358,10
60926984667,60926984665,-2,1136,2672,10
60927323603,60927323603,0,1219,2040,10
60928337278,60928337277,-1,1264,2126,10
60928388558,60928388557,-1,1104,1148,10
60932788448,60932788447,-1,883,2118,10
60935144502,60935144502,0,955,1177,10
60935320751,60935320757,6,5211,2168,10
60936977809,60936977807,-2,1491,1863,10
60938062574,60938062572,-2,965,1423,10
60941443440,60941443438,-2,1872,2537,10
60945936076,60945936074,-2,918,2525,10
60947422770,60947422770,0,952,2435,10
60949565628,60949565627,-1,1876,2639,10
60951935598,60951935595,-3,1590,1964,10
60954767966,60954767967,1,1280,2033,10
60954940416,60954940414,-2,1271,1888,10
60957077996,60957077995,-1,1221,1727,10
60958712595,60958712595,0,905,1434,10
60959594657,60959594658,1,1981,2289,10
60962970549,60962970547,-2,914,1730,10
60965493733,60965493731,-2,1607,2098,10
60968736591,60968736596,5,2574,1756,10
60971271077,60971271077,0,1009,2580,10
60972485345,60972485342,-3,1651,2210,10
60973824891,60973824888,-3,1003,1453,10
60975501300,60975501298,-2,993,2231,10
60975823176,60975823173,-3,1261,1651,10
60979442663,60979442662,-1,823,1273,10
60981807226,60981807221,-5,812,1982,10
60986580542,60986580541,-1,1010,1415,10
60989239790,60989239791,1,815,880,10
60991323487,60991323482,-5,1154,1853,10
60992738817,60992738815,-2,883,1407,10
60994897154,60994897153,-1,1848,2605,10
60996453839,60996453838,-1,1444,2011,10
60997210050,60997210046,-4,1689,2797,10
61004364390,61004364387,-3,1271,1233,10
61006945890,61006945886,-4,492,858,10
61007256018,61007256014,-4,1167,2896,10
61008106937,61008106916,-21,1175,2308,10
61009462262,61009462261,-1,5185,8140,10
61009955110,61009955110,0,1018,1370,10
61011854086,61011854085,-1,1542,2421,10
61015300426,61015300426,0,1113,1642,10
61019222044,61019222046,2,3003,3601,10
61022463786,61022463785,-1,973,1514,10
61024477539,61024477538,-1,1334,1599,10
61024553642,61024553639,-3,713,2190,10
61026879773,61026879773,0,1253,2321,10
61026950148,61026950144,-4,1184,1867,10
61027635362,61027635361,-1,1181,2122,10
61028017773,61028017771,-2,1302,1530,10
61029609179,61029609181,2,1461,2265,10
61030794359,61030794358,-1,1315,2695,10
61031806276,61031806271,-5,1363,2413,10
61033627714,61033627719,5,1112,954,10
61038822202,61038822199,-3,1432,2628,10
61040358385,61040358380,-5,1184,3691,10
61041476498,61041476502,4,2461,1418,10
61045358370,61045358370,0,1172,1752,10
61046286448,61046286445,-3,942,1957,10
61048189870,61048189867,-3,931,2080,10
61049207814,61049207814,0,1218,2346,10
61051044586,61051044590,4,3560,1560,10
61053191349,61053191349,0,1264,2443,10
61057205095,61057205094,-1,828,1496,10
61058522971,61058522972,1,1287,1843,10
61060069114,61060069113,-1,1581,2851,10
61060891499,61060891498,-1,815,1419,10
61067047735,61067047733,-2,1348,2074,10
61072627054,61072627057,3,814,1561,10
61074638270,61074638271,1,1130,1234,10
61075517314,61075517311,-3,1342,1217,10
61076637758,61076637753,-5,1465,3546,10
61077010686,61077010686,0,1335,1390,10
61081967758,61081967757,-1,1580,2598,10
61082192844,61082192844,0,1266,2785,10
61083038418,61083038418,0,1054,2002,10
61089716543,61089716540,-3,1058,2214,10
61093055894,61093055891,-3,1067,1308,10
61098596744,61098596735,-9,28926,16252,10
61101085362,61101085361,-1,1541,1589,10
61105226771,61105226769,-2,1031,2028,10
61105571881,61105571881,0,942,1514,10
61106097123,61106097121,-2,1067,1599,10
61109987823,61109987827,4,1599,1446,10
61112386522,61112386521,-1,1069,1994,10
61116320358,61116320358,0,1702,2304,10
61117231990,61117231986,-4,1193,1973,10
61119358253,61119358252,-1,1528,1810,10
61120932459,61120932458,-1,1442,1780,10
61124055543,61124055545,2,34005,32649,10
61125599977,61125599974,-3,1592,2045,10
61127539601,61127539598,-3,1217,1917,10
61130014124,61130014123,-1,1153,2012,10
61135496189,61135496190,1,1551,1563,10
61136177165,61136177155,-10,1247,5007,10
61144321874,61144321873,-1,1437,2198,10
61145983699,61145983699,0,1243,1716,10
61151410815,61151410815,0,1421,2529,10
61152969632,61152969631,-1,878,2281,10
61154295286,61154295285,-1,1391,1764,10
61154761701,61154761698,-3,828,1254,10
61155756881,61155756880,-1,1178,1916,10
61156938904,61156938904,0,1426,2223,10
61163112146,61163112144,-2,1085,1909,10
61167395629,61167395631,2,2146,1784,10
61170053091,61170053090,-1,766,920,10
61173876487,61173876486,-1,1144,1961,10
61176947639,61176947638,-1,1529,2781,10
61179311769,61179311767,-2,1011,1825,10
61180445123,61180445117,-6,1455,1880,10
61183254559,61183254559,0,1324,1764,10
61183797965,61183797963,-2,1039,1576,10
61187332218,61187332213,-5,4597,13828,10
61193105116,61193105114,-2,1224,2007,10
61196188919,61196188918,-1,1041,1911,10
61197061116,61197061114,-2,1139,1911,10
61201334234,61201334234,0,1208,2084,10
61202020526,61202020526,0,822,1201,10
61202704161,61202704166,5,3788,1547,10
61203464145,61203464144,-1,1145,1792,10
61205228681,61205228680,-1,1023,1313,10
61207662142,61207662138,-4,990,1713,10
61211048900,61211048898,-2,807,1268,10
61213236330,61213236327,-3,1178,1599,10
61214144503,61214144502,-1,1224,1595,10
61214257453,61214257450,-3,1087,1556,10
61215125350,61215125350,0,1233,2011,10
61216143835,61216143818,-17,177,912,10
61218665965,61218665966,1,1331,1919,10
61224370329,61224370328,-1,980,1716,10
61227959896,61227959895,-1,1458,2451,10
61228920382,61228920377,-5,722,2992,10
61236329414,61236329414,0,842,1667,10
61236686710,61236686707,-3,1150,2567,10
61239827419,61239827419,0,1044,1390,10
61240793249,61240793249,0,1166,1385,10
61242569806,61242569802,-4,1050,1988,10
61245370386,61245370385,-1,956,2563,10
61247471155,61247471150,-5,1272,1804,10
61249889969,61249889968,-1,1338,1966,10
61253313506,61253313506,0,1277,1603,10
61258096666,61258096667,1,1996,1954,10
61258321150,61258321150,0,1218,2202,10
61262934990,61262934989,-1,1291,2010,10
61269347947,61269347926,-21,807,1838,10
61270386819,61270386825,6,1653,696,10
61275383723,61275383722,-1,892,1879,10
61275478754,61275478755,1,1256,1651,10
61276400494,61276400495,1,16028,7517,10
61279998981,61279998979,-2,1078,1891,10
61281038866,61281038866,0,1185,1851,10
61282419315,61282419311,-4,899,1796,10
61283208460,61283208464,4,2567,1620,10
61286896730,61286896729,-1,1350,2838,10
61288392842,61288392846,4,2142,1312,10
61289580295,61289580294,-1,1521,2185,10
61291905030,61291905030,0,981,1678,10
61293098300,61293098298,-2,1609,1928,10
61295739439,61295739434,-5,986,1973,10
61296025409,61296025406,-3,1493,2642,10
61297522591,61297522591,0,946,1403,10
61299147450,61299147450,0,948,1293,10
61302115538,61302115534,-4,1131,2190,10
61303989802,61303989802,0,1227,1530,10
61308355766,61308355764,-2,849,1462,10
61308470578,61308470574,-4,1112,1915,10
61310267750,61310267749,-1,838,1278,10
61314183041,61314183042,1,1465,1727,10
61316665835,61316665834,-1,1335,1879,10
61318642340,61318642338,-2,1440,2042,10
61324257987,61324257986,-1,1084,1780,10
61324721703,61324721701,-2,1309,2042,10
61325783494,61325783495,1,1110,1957,10
61325948991,61325948972,-19,692,662,10
61329045957,61329045954,-3,518,994,10
61329247102,61329247101,-1,2307,4649,10
61337955371,61337955376,5,1421,1051,10
61342399693,61342399692,-1,1361,1719,10
61342609820,61342609818,-2,1357,2589,10
61347462433,61347462431,-2,1500,1889,10
61353429419,61353429396,-23,510,711,10
61353940623,61353940622,-1,19137,10015,10
61354794994,61354794993,-1,712,1450,10
61356363662,61356363658,-4,1383,3013,10
61357668167,61357668166,-1,855,1428,10
61361508759,61361508757,-2,1469,1376,10
61364644985,61364644982,-3,1099,2009,10
61369917534,61369917533,-1,1011,1235,10
61376676751,61376676741,-10,1665,274,10
61378264078,61378264077,-1,1397,1343,10
61390470439,61390470444,5,16504,17515,10
61391201382,61391201380,-2,1242,2369,10
61392648322,61392648316,-6,958,5906,10
61394245134,61394245131,-3,902,1461,10
61394815491,61394815471,-20,947,1460,10
61396264314,61396264314,0,1717,2285,10
61396362497,61396362477,-20,856,1459,10
61402495906,61402495904,-2,969,1542,10
61402645929,61402645950,21,724,1494,10
61403757722,61403757721,-1,947,1919,10
61413345594,61413345592,-2,1139,1570,10
61420989311,61420989308,-3,769,1405,10
61427409609,61427409609,0,1363,1635,10
61427805298,61427805294,-4,701,1476,10
61428167055,61428167054,-1,870,2437,10
61432888495,61432888494,-1,873,1328,10
61433618167,61433618166,-1,870,2064,10
61433723294,61433723291,-3,840,1597,10
61435011974,61435011974,0,1333,2912,10
61436526875,61436526873,-2,1120,2966,10
61440885719,61440885719,0,1534,1875,10
61441126572,61441126570,-2,1257,2416,10
61442392532,61442392531,-1,1053,1335,10
61442446601,61442446600,-1,1377,2464,10
61445930729,61445930726,-3,1497,2524,10
61448279240,61448279240,0,3170,3436,10
61448542358,61448542358,0,1506,2386,10
61451691362,61451691360,-2,1533,1982,10
61459476241,61459476241,0,1529,2777,10
61460462958,61460462955,-3,448,1641,10
61463664635,61463664633,-2,1116,2448,10
61466194044,61466194042,-2,1147,2062,10
61467375622,61467375622,0,3304,4668,10
61468147498,61468147495,-3,994,2136,10
61473920973,61473920971,-2,1645,2700,10
61479362485,61479362486,1,1643,1793,10
61486248842,61486248843,1,1411,1565,10
61491412770,61491412780,10,15809,22416,10
61492866729,61492866729,0,1387,2624,10
61497414287,61497414286,-1,1492,2382,10
61499330657,61499330670,13,18515,42778,10
61502906989,61502906990,1,1420,1532,10
61505183435,61505183431,-4,1201,1844,10
61509439004,61509439002,-2,1057,2010,10
61515357462,61515357458,-4,1380,2074,10
61516647107,61516647107,0,1221,1564,10
61519103881,61519103882,1,1914,2420,10
61520226197,61520226204,7,19496,43332,10
61520400671,61520400670,-1,1326,1799,10
61521548559,61521548559,0,983,1699,10
61521843731,61521843724,-7,1006,1730,10
61525565906,61525565906,0,1515,1935,10
61527228318,61527228315,-3,1285,1709,10
61532939087,61532939095,8,12732,1919,10
61533856938,61533856931,-7,2303,7269,10
61534541427,61534541423,-4,1042,1818,10
61535604618,61535604616,-2,980,1192,10
61541190167,61541190166,-1,1161,1724,10
61546131063,61546131080,17,319,1808,10
61547549333,61547549329,-4,515,1419,10
61549544630,61549544626,-4,1202,1937,10
61549577454,61549577458,4,1145,1085,10
61550487910,61550487907,-3,1307,2078,10
61550902015,61550902014,-1,793,1545,10
61553074023,61553074021,-2,1629,2489,10
61554491510,61554491508,-2,1524,3272,10
61554577597,61554577595,-2,1834,2429,10
61555168630,61555168627,-3,1150,1389,10
61555310875,61555310865,-10,1442,3022,10
61555748110,61555748111,1,1296,2746,10
61557195626,61557195622,-4,2037,5569,10
61557478023,61557478022,-1,1021,1997,10
61557637403,61557637423,20,834,1433,10
61559122771,61559122768,-3,1581,2133,10
61565115397,61565115394,-3,1228,2379,10
61567501483,61567501481,-2,931,1369,10
61571317286,61571317285,-1,887,1764,10
61574084230,61574084230,0,1247,2021,10
61576693986,61576693983,-3,1545,2119,10
61579904547,61579904546,-1,1173,2220,10
61582341964,61582341945,-19,988,1499,10
61586444350,61586444345,-5,1057,2973,10
61594656878,61594656877,-1,926,2093,10
61609650474,61609650467,-7,2472,8719,10
61611770157,61611770158,1,1162,1439,10
61617800518,61617800518,0,1049,1700,10
61618219696,61618219682,-14,1217,1836,10
61619485790,61619485791,1,1279,1669,10
61620372388,61620372387,-1,1085,2202,10
61631447191,61631447189,-2,1307,2640,10
61633052705,61633052702,-3,793,1641,10
61637339302,61637339301,-1,912,2224,10
61638581604,61638581602,-2,1305,1880,10
61638957563,61638957561,-2,1482,2033,10
61639695065,61639695063,-2,1854,3527,10
61643709721,61643709723,2,5179,3195,10
61647627194,61647627192,-2,910,2262,10
61649619374,61649619375,1,989,1821,10
61651741083,61651741081,-2,890,2158,10
61652294306,61652294326,20,1133,1802,10
61657377814,61657377814,0,1151,2145,10
61658784085,61658784086,1,39000,16654,10
61667699347,61667699347,0,1309,1824,10
61672185065,61672185082,17,1509,1456,10
61672830917,61672830915,-2,2043,14893,10
61674919565,61674919564,-1,1176,1978,10
61677503735,61677503733,-2,1393,1861,10
61677688280,61677688279,-1,1137,1666,10
61679405038,61679405036,-2,1256,2642,10
61683445577,61683445576,-1,1010,2249,10
61683818679,61683818677,-2,1343,2147,10
61686319643,61686319641,-2,1487,1741,10
61686497535,61686497533,-2,1078,2340,10
61688972558,61688972558,0,1566,2010,10
61689752885,61689752883,-2,1446,2157,10
61690036210,61690036210,0,2035,2091,10
61693289783,61693289781,-2,1633,1916,10
61694168785,61694168783,-2,1021,2103,10
61694517735,61694517735,0,1020,2606,10
61696338155,61696338156,1,1270,2162,10
61696847287,61696847285,-2,883,1641,10
61697906398,61697906397,-1,1015,1984,10
61698022194,61698022214,20,696,1180,10
61700130353,61700130352,-1,1155,2061,10
61703380158,61703380154,-4,1194,1774,10
61706866429,61706866429,0,1198,1959,10
61707023069,61707023066,-3,1175,2200,10
61721972706,61721972705,-1,2692,3201,10
61723038199,61723038197,-2,1138,1831,10
61725768555,61725768555,0,1066,1207,10
61726557009,61726557006,-3,1062,2499,10
61727509114,61727509112,-2,1302,1550,10
61732324059,61732324059,0,1638,1629,10
61732654415,61732654412,-3,740,1326,10
61736309451,61736309450,-1,1720,1764,10
61737524882,61737524899,17,774,2648,10
61740625874,61740625871,-3,1308,2964,10
61744511099,61744511098,-1,1309,2095,10
61745907938,61745907938,0,1474,2120,10
61747328022,61747328021,-1,1336,2040,10
61748143179,61748143187,8,8567,2587,10
61750450125,61750450127,2,1013,1410,10
61751330717,61751330716,-1,1830,1863,10
61751863202,61751863199,-3,2040,2606,10
61752043163,61752043162,-1,1209,1829,10
61753931747,61753931746,-1,976,1914,10
61759238723,61759238722,-1,1298,1477,10
61761852636,61761852634,-2,842,1785,10
61767094317,61767094316,-1,725,1675,10
61773082872,61773082882,10,12693,34217,10
61777830273,61777830274,1,1626,2504,10
61778872050,61778872046,-4,1230,2406,10
61780681242,61780681241,-1,1400,2252,10
61782551831,61782551830,-1,1134,1913,10
61784933959,61784933958,-1,1236,1951,10
61784994697,61784994718,21,909,1603,10
61786861170,61786861169,-1,1135,1999,10
61793291553,61793291553,0,1429,2241,10
61796006821,61796006822,1,2453,2619,10
61798281164,61798281163,-1,736,2302,10
61802030468,61802030469,1,28933,33126,10
61804033380,61804033384,4,4006,2559,10
61804284997,61804284998,1,1182,1391,10
61806555522,61806555510,-12,12723,41267,10
61808716510,61808716509,-1,1051,1119,10
61809746391,61809746390,-1,1071,2159,10
61810245879,61810245880,1,837,1495,10
61811285566,61811285565,-1,1596,1848,10
61812642810,61812642823,13,2201,1359,10
61813436775,61813436774,-1,875,1594,10
61817152917,61817152918,1,1271,2019,10
61818780025,61818780022,-3,891,1756,10
61821690917,61821690916,-1,1079,1577,10
61822780440,61822780461,21,825,1495,10
61826999494,61826999492,-2,872,2023,10
61830545990,61830545986,-4,1265,2831,10
61831709367,61831709366,-1,898,2271,10
61832498198,61832498195,-3,1472,1896,10
61832817639,61832817641,2,927,735,10
61833602628,61833602634,6,5646,1806,10
61835316702,61835316702,0,1381,1089,10
61835484093,61835484090,-3,1045,1685,10
61836866269,61836866267,-2,1034,1989,10
61843313701,61843313703,2,1719,1202,10
61844350511,61844350509,-2,1482,2611,10
61847810720,61847810719,-1,1323,2362,10
61851975898,61851975898,0,1196,1970,10
61855438826,61855438826,0,1202,926,10
61856630917,61856630917,0,1505,2226,10
61858406724,61858406722,-2,1079,1816,10
61858896969,61858896971,2,1318,1034,10
61860017019,61860017018,-1,910,1369,10
61866482116,61866482113,-3,1081,1888,10
61869377029,61869377027,-2,1624,2267,10
61869443070,61869443066,-4,1551,3033,10
61869895895,61869895892,-3,1042,1612,10
61874672041,61874672041,0,1156,2141,10
61876533766,61876533771,5,2579,1948,10
61877324391,61877324389,-2,1599,2377,10
61880146762,61880146761,-1,1173,1676,10
61888701124,61888701141,17,731,5151,10
61891347605,61891347606,1,1574,1361,10
61897399142,61897399142,0,1612,2506,10
61900339898,61900339897,-1,960,1745,10
61902123707,61902123705,-2,869,1740,10
61907138851,61907138850,-1,954,2087,10
61908050047,61908050046,-1,1427,2598,10
61909270790,61909270790,0,1074,1815,10
61910845787,61910845785,-2,1079,1942,10
61913242758,61913242754,-4,850,2251,10
61918926266,61918926264,-2,778,1761,10
61920083608,61920083608,0,1026,1638,10
61921733901,61921733899,-2,866,1525,10
61933836306,61933836304,-2,1129,1879,10
61938754261,61938754260,-1,599,1435,10
61940426322,61940426322,0,869,1842,10
61942599721,61942599721,0,1253,1881,10
61947584080,61947584085,5,28399,22343,10
61952311109,61952311109,0,1852,1468,10
61955212865,61955212867,2,1266,1210,10
61957771628,61957771620,-8,1045,6419,10
61958594810,61958594811,1,1253,1566,10
61965107618,61965107616,-2,1832,2564,10
61965644856,61965644878,22,1263,2825,10
61970643529,61970643529,0,966,1878,10
61977951997,61977951999,2,1097,1888,10
61980126840,61980126838,-2,1499,3011,10
61986354443,61986354442,-1,1452,1840,10
61989276707,61989276706,-1,1253,2182,10
61989518054,61989518052,-2,827,1900,10
61990826056,61990826053,-3,984,1970,10
61992686198,61992686198,0,1056,1617,10
61994438195,61994438192,-3,1134,3025,10
61995678419,61995678417,-2,1488,2081,10
61999247377,61999247375,-2,1330,1767,10
62001105010,62001105007,-3,519,1846,10
62002256467,62002256462,-5,866,2399,10
62008696439,62008696438,-1,811,1723,10
62011074724,62011074724,0,1436,1592,10
62012980708,62012980705,-3,1180,2746,10
62027957995,62027957994,-1,1036,2530,10
62028939103,62028939097,-6,1299,2008,10
62029614061,62029614059,-2,18526,2213,10
62035382787,62035382785,-2,909,1552,10
62036962159,62036962158,-1,2130,2396,10
62037507950,62037507949,-1,1068,1708,10
62037708367,62037708367,0,1012,1648,10
62037892938,62037892935,-3,1185,2072,10
62040154846,62040154843,-3,1073,2383,10
62042452777,62042452777,0,1388,2374,10
62042687443,62042687444,1,1222,1500,10
62045230618,62045230618,0,1176,1571,10
62045418621,62045418620,-1,990,2090,10
62046057733,62046057731,-2,1542,2239,10
62046650550,62046650550,0,2446,2369,10
62049394546,62049394543,-3,841,1679,10
62052033478,62052033477,-1,1472,2801,10
62054641561,62054641560,-1,1125,1738,10
62059969522,62059969523,1,6764,20062,10
62063756087,62063756083,-4,907,2654,10
62065932862,62065932862,0,705,1645,10
62068354685,62068354685,0,1145,2004,10
62074636509,62074636506,-3,1478,1976,10
62079788765,62079788766,1,1947,1949,10
62085593273,62085593274,1,2034,1606,10
62086866304,62086866301,-3,1700,2174,10
62087780862,62087780860,-2,1608,2536,10
62090296501,62090296499,-2,1787,2710,10
62090776245,62090776246,1,1154,1386,10
62094744145,62094744142,-3,1836,2552,10
62095714898,62095714895,-3,839,2070,10
62097062523,62097062522,-1,1185,2120,10
62097199723,62097199722,-1,1032,2187,10
62100062274,62100062273,-1,1497,1437,10
62105166482,62105166480,-2,1101,2029,10
62106840658,62106840657,-1,1170,2793,10
62107816665,62107816685,20,1286,1445,10
62112149050,62112149049,-1,1259,1482,10
62113114498,62113114497,-1,1333,2178,10
62116565894,62116565891,-3,1654,5099,10
62116913143,62116913141,-2,1532,3033,10
62122615383,62122615383,0,1363,1849,10
62123826699,62123826698,-1,960,1900,10
62124250760,62124250759,-1,1077,1853,10
62125632410,62125632410,0,1310,1974,10
62130473998,62130473997,-1,1746,2683,10
62135524181,62135524179,-2,885,1312,10
62137054667,62137054667,0,1196,1999,10
62138122970,62138122965,-5,927,2055,10
62139568113,62139568114,1,1065,2155,10
62140930578,62140930575,-3,1810,4958,10
62141091742,62141091742,0,1397,1457,10
62145595864,62145595861,-3,1155,2030,10
62146010245,62146010243,-2,2042,2791,10
62150365059,62150365057,-2,1192,2451,10
62150725195,62150725193,-2,1082,1775,10
62157547523,62157547527,4,13826,10533,10
62157970777,62157970778,1,806,1339,10
62159603215,62159603215,0,1319,2095,10
62162904596,62162904592,-4,1732,5891,10
62164097371,62164097369,-2,1192,1938,10
62166419873,62166419870,-3,1432,2113,10
62166773391,62166773390,-1,1569,2599,10
62169264956,62169264954,-2,1102,2762,10
62171070490,62171070488,-2,711,1592,10
62172245804,62172245801,-3,844,2202,10
62173308034,62173308042,8,3692,1788,10
62177191607,62177191602,-5,1120,3406,10
62187306030,62187306027,-3,980,1558,10
62187397779,62187397772,-7,1055,1687,10
62190821166,62190821167,1,2639,3202,10
62197701034,62197701032,-2,1461,2305,10
62200756389,62200756387,-2,1599,2179,10
62203628829,62203628827,-2,1369,1764,10
62203758353,62203758359,6,350,1152,10
62215479002,62215479000,-2,1168,2192,10
62217449655,62217449653,-2,947,1818,10
62219418307,62219418307,0,1041,1787,10
62220408186,62220408183,-3,990,1730,10
62224620349,62224620349,0,2092,2094,10
62224655034,62224655035,1,1635,2212,10
62227444065,62227444067,2,1971,2491,10
62228099154,62228099152,-2,1052,2583,10
62228625740,62228625758,18,1214,2159,10
62229349355,62229349359,4,1509,1424,10
62229927690,62229927689,-1,1185,1507,10
62231570169,62231570168,-1,1164,2478,10
62232357563,62232357557,-6,4346,13999,10
62233515634,62233515631,-3,994,2184,10
62233859090,62233859089,-1,1447,1594,10
62235102477,62235102477,0,1210,1970,10
62240581729,62240581722,-7,1294,4636,10
62240686015,62240686014,-1,976,1637,10
62245536658,62245536658,0,1376,2131,10
62246307941,62246307939,-2,1380,2100,10
62249698451,62249698450,-1,890,1238,10
62250812391,62250812390,-1,1247,2623,10
62253797912,62253797909,-3,1503,2427,10
62254428549,62254428547,-2,1491,2279,10
62255848708,62255848702,-6,1095,2977,10
62257159233,62257159230,-3,1999,2626,10
62260664822,62260664826,4,1925,1677,10
62262916888,62262916888,0,51827,30529,10
62264683693,62264683692,-1,1224,2018,10
62265970573,62265970572,-1,1270,2865,10
62266556210,62266556209,-1,1299,1628,10
62266923962,62266923968,6,890,1614,10
62269767147,62269767146,-1,1308,1628,10
62271045411,62271045410,-1,1472,1703,10
62274253237,62274253231,-6,1497,3428,10
62274903507,62274903504,-3,872,2129,10
62276766961,62276766956,-5,1460,3817,10
62279907606,62279907606,0,1065,1699,10
62279944347,62279944345,-2,1032,1886,10
62282562454,62282562453,-1,1248,1958,10
62287100541,62287100540,-1,1246,2029,10
62290279363,62290279346,-17,1184,5694,10
62291180822,62291180820,-2,1010,1565,10
62291439018,62291439015,-3,1150,1987,10
62291889859,62291889878,19,1307,2845,10
62299763517,62299763514,-3,1424,1565,10
62304242383,62304242382,-1,850,1838,10
62306651771,62306651770,-1,1392,2502,10
62307035766,62307035769,3,1089,1034,10
62308418966,62308418966,0,1215,2094,10
62308539176,62308539159,-17,876,2172,10
62308574819,62308574834,15,990,3308,10
62310453324,62310453322,-2,1399,3012,10
62310992879,62310992878,-1,770,1791,10
62326457890,62326457891,1,1894,1601,10
62329181898,62329181897,-1,1030,1601,10
62331307231,62331307232,1,981,2083,10
62331797118,62331797116,-2,1424,2534,10
62332644386,62332644371,-15,99,679,10
62339563154,62339563168,14,997,1735,10
62339797866,62339797866,0,804,1240,10
62341714960,62341714962,2,3416,3769,10
62342888595,62342888593,-2,1458,2199,10
62345097599,62345097600,1,1653,1879,10
62345815711,62345815711,0,1039,1324,10
62347533254,62347533253,-1,1101,2337,10
62347728398,62347728397,-1,1276,1937,10
62347876170,62347876168,-2,1133,2651,10
62351438138,62351438134,-4,1014,1455,10
62351667183,62351667181,-2,1085,1891,10
62353079677,62353079673,-4,1319,3212,10
62354196133,62354196134,1,30635,19795,10
62354339686,62354339687,1,832,1576,10
62355762252,62355762249,-3,1042,1663,10
62358719108,62358719105,-3,1063,1541,10
62361003378,62361003377,-1,877,2192,10
62361234234,62361234230,-4,1067,1527,10
62362894538,62362894541,3,1119,1850,10
62364532816,62364532814,-2,1219,1895,10
62365657855,62365657851,-4,799,1763,10
62366481462,62366481442,-20,3710,2120,10
62369112584,62369112586,2,1901,1615,10
62369218069,62369218066,-3,1664,2546,10
62369824523,62369824527,4,22269,12714,10
62371342386,62371342385,-1,1185,2401,10
62374513162,62374513161,-1,1195,1791,10
62375530456,62375530455,-1,1506,2604,10
62379796391,62379796392,1,1250,1664,10
62383053967,62383053966,-1,955,2152,10
62387309879,62387309877,-2,981,1476,10
62390300156,62390300157,1,3396,3191,10
62393497625,62393497623,-2,1155,1301,10
62396378092,62396378088,-4,1326,1500,10
62402636140,62402636138,-2,890,1817,10
62409395164,62409395161,-3,1225,1781,10
62412133578,62412133574,-4,1482,1676,10
62418883058,62418883057,-1,1033,2015,10
62418950811,62418950810,-1,1132,1929,10
62419639958,62419639967,9,7887,1515,10
62420214486,62420214484,-2,614,1571,10
62421905069,62421905070,1,1684,1492,10
62422252734,62422252733,-1,632,1530,10
62424303278,62424303279,1,2004,1860,10
62424474436,62424474434,-2,1235,2699,10
62428700488,62428700485,-3,1039,1888,10
62432263450,62432263455,5,1548,1157,10
62433623033,62433623034,1,1559,1978,10
62433704661,62433704658,-3,1013,2329,10
62434884616,62434884599,-17,1132,2319,10
62436378134,62436378134,0,1345,1867,10
62439261803,62439261789,-14,1045,2112,10
62439505715,62439505698,-17,1035,1619,10
62441245875,62441245873,-2,1303,1607,10
62442759793,62442759795,2,898,1282,10
62444472121,62444472119,-2,1501,2252,10
62445494863,62445494862,-1,1216,2149,10
62447273665,62447273663,-2,956,1946,10
62449083398,62449083398,0,1261,2091,10
62449197662,62449197662,0,801,1127,10
62449956087,62449956086,-1,1186,2050,10
62451249902,62451249901,-1,839,1970,10
62453314079,62453314078,-1,1038,1156,10
62454221156,62454221154,-2,1505,2257,10
62454355376,62454355374,-2,1558,2424,10
62455836561,62455836559,-2,1148,1812,10
62457117221,62457117225,4,3805,3068,10
62458248233,62458248230,-3,1417,1908,10
62458768242,62458768258,16,204,609,10
62470538005,62470538005,0,1662,3108,10
62471525487,62471525485,-2,1008,1619,10
62472761112,62472761109,-3,1288,2128,10
62474624020,62474624014,-6,1157,4781,10
62476535807,62476535826,19,931,1059,10
62480145809,62480145809,0,1508,2280,10
62481939233,62481939231,-2,1839,2481,10
62489507322,62489507322,0,1438,1817,10
62491252189,62491252187,-2,1098,2315,10
62494858990,62494858987,-3,1290,2132,10
62495597297,62495597295,-2,1607,1986,10
62496102348,62496102346,-2,1195,1870,10
62496671853,62496671853,0,1522,1470,10
62504625005,62504625003,-2,960,1923,10
62505939269,62505939266,-3,2235,2470,10
62511964810,62511964810,0,1046,1125,10
62512950767,62512950772,5,5054,2893,10
62518642567,62518642563,-4,932,1866,10
62522529674,62522529671,-3,1259,1597,10
62522660895,62522660893,-2,1103,1347,10
62523963511,62523963510,-1,1322,1854,10
62527431234,62527431233,-1,1520,2683,10
62530958763,62530958764,1,1181,2247,10
62531146993,62531146992,-1,1154,1792,10
62531902779,62531902775,-4,1110,2250,10
62533822569,62533822569,0,790,1622,10
62537755105,62537755105,0,1582,2059,10
62543147267,62543147267,0,807,1372,10
62546374464,62546374462,-2,1220,1708,10
62557994770,62557994768,-2,1187,2002,10
62560962519,62560962518,-1,927,2045,10
62562029049,62562029041,-8,2164,6693,10
62566492167,62566492167,0,858,1816,10
62567240546,62567240545,-1,984,1739,10
62572681634,62572681655,21,1125,1728,10
62574540389,62574540386,-3,1022,1459,10
62575687866,62575687865,-1,1691,3251,10
62578002822,62578002818,-4,4862,13756,10
62578216867,62578216866,-1,592,887,10
62582439670,62582439671,1,1180,2070,10
62584308561,62584308559,-2,7213,11277,10
62585641926,62585641923,-3,1106,2109,10
62587436617,62587436615,-2,1208,1713,10
62589719569,62589719560,-9,10124,16001,10
62590751462,62590751461,-1,1021,2246,10
62592761829,62592761830,1,1061,2154,10
62595180192,62595180191,-1,1135,2017,10
62596576463,62596576460,-3,1133,1583,10
62600543910,62600543910,0,1093,1013,10
62601055875,62601055895,20,903,1720,10
62604268090,62604268089,-1,953,1815,10
62606487683,62606487703,20,1149,1434,10
62609117711,62609117708,-3,1556,2558,10
62609316722,62609316721,-1,1342,2420,10
62612092241,62612092239,-2,1242,1550,10
62613354923,62613354920,-3,987,1653,10
62615376386,62615376390,4,2381,1216,10
62615517572,62615517572,0,1313,1614,10
62619879998,62619879998,0,979,1667,10
62626183100,62626183099,-1,1028,1802,10
62628008990,62628008989,-1,1226,2580,10
62628418604,62628418603,-1,1007,1195,10
62636381343,62636381342,-1,1082,1892,10
62639018466,62639018463,-3,1320,2349,10
62640070745,62640070741,-4,1351,3056,10
62640265034,62640265030,-4,1307,1977,10
62640665378,62640665397,19,978,1426,10
62641173088,62641173089,1,1261,1219,10
62642092492,62642092492,0,1031,1455,10
62648154826,62648154823,-3,682,1070,10
62649173469,62649173467,-2,906,1674,10
62649829115,62649829115,0,1105,1448,10
62651109387,62651109389,2,1388,1359,10
62653437987,62653437986,-1,866,2258,10
62654725870,62654725869,-1,910,1704,10
62656200755,62656200753,-2,1169,1178,10
62656671910,62656671908,-2,1366,1663,10
62661606955,62661606953,-2,1135,2183,10
62662305594,62662305596,2,2379,1496,10
62667762692,62667762690,-2,1513,3331,10
62668087102,62668087101,-1,1119,1894,10
62672829630,62672829630,0,885,1307,10
62674587926,62674587925,-1,1264,2050,10
62675314946,62675314942,-4,1127,2182,10
62677013396,62677013394,-2,1016,2564,10
62678981405,62678981411,6,3974,1167,10
62681947838,62681947839,1,1379,1889,10
62681999351,62681999346,-5,1444,3957,10
62682212487,62682212485,-2,1512,2284,10
62684465176,62684465175,-1,705,1900,10
62687522974,62687522974,0,1506,2824,10
62695701666,62695701665,-1,1255,2558,10
62697618508,62697618507,-1,1181,1350,10
62700316142,62700316141,-1,1249,2038,10
62704224801,62704224800,-1,877,2051,10
62707924329,62707924329,0,1080,1540,10
62708060996,62708060999,3,1641,1546,10
62709702961,62709702955,-6,1373,4072,10
62710496723,62710496722,-1,603,1520,10
62712292218,62712292217,-1,1485,1490,10
62712340482,62712340479,-3,1257,2479,10
62712982767,62712982765,-2,905,1902,10
62714224534,62714224532,-2,1544,1536,10
62725684562,62725684565,3,1292,1664,10
62726816087,62726816087,0,1334,1699,10
62728919731,62728919727,-4,1211,2127,10
62729952809,62729952810,1,1630,1379,10
62734647379,62734647382,3,1254,1542,10
62736953696,62736953694,-2,1000,1122,10
62738995926,62738995925,-1,1850,2033,10
62740315192,62740315191,-1,1606,2139,10
62744071820,62744071818,-2,1506,1826,10
62746065064,62746065065,1,1099,2481,10
62746721861,62746721861,0,1431,2421,10
62750592127,62750592121,-6,952,3292,10
62754904707,62754904705,-2,1331,2001,10
62757202506,62757202505,-1,885,1702,10
62759066086,62759066085,-1,1097,1412,10
62760379723,62760379710,-13,227,483,10
62764361562,62764361561,-1,1272,1507,10
62765728738,62765728737,-1,986,2127,10
62766301833,62766301830,-3,1041,2267,10
62768796610,62768796609,-1,1383,2271,10
62769710378,62769710375,-3,1528,2075,10
62773458032,62773458031,-1,1234,2180,10
62773529294,62773529293,-1,943,1625,10
62774269246,62774269245,-1,1072,1666,10
62775372590,62775372590,0,930,1550,10
62779212577,62779212575,-2,833,1816,10
62780284231,62780284230,-1,876,1158,10
62780985630,62780985630,0,1185,1805,10
62784212495,62784212493,-2,997,2100,10
62784757092,62784757096,4,1965,1205,10
62787205176,62787205176,0,1568,2047,10
62787342154,62787342154,0,1107,2493,10
62787748698,62787748705,7,5543,5588,10
62788337087,62788337087,0,993,1791,10
62791421956,62791421955,-1,1707,2144,10
62795225930,62795225925,-5,1330,3909,10
62801606110,62801606107,-3,1263,2271,10
62801741597,62801741595,-2,1725,2732,10
62803136971,62803136968,-3,743,1754,10
62804401587,62804401585,-2,1184,2471,10
62805475547,62805475547,0,954,1106,10
62805791833,62805791835,2,1395,1696,10
62806625306,62806625304,-2,1157,1705,10
62807528859,62807528858,-1,1375,2395,10
62809414439,62809414431,-8,1101,3351,10
62810864365,62810864363,-2,1149,1627,10
62811450386,62811450385,-1,1411,1985,10
62812773174,62812773174,0,1144,1860,10
62817685566,62817685566,0,2277,1582,10
62822342190,62822342185,-5,704,2834,10
62823337130,62823337129,-1,1035,1320,10
62824794120,62824794118,-2,1058,2137,10
62825151279,62825151278,-1,1159,1949,10
62828033978,62828033977,-1,1484,1702,10
62834196870,62834196869,-1,1196,1063,10
62834732897,62834732897,0,1594,1741,10
62843671462,62843671465,3,1065,1717,10
62845319964,62845319962,-2,1270,2630,10
62848785886,62848785884,-2,1332,2298,10
62849149975,62849149974,-1,1232,2180,10
62854156233,62854156231,-2,1278,2427,10
62856736406,62856736402,-4,936,1683,10
62857003002,62857002998,-4,1109,2213,10
62859199529,62859199528,-1,971,1558,10
62861036648,62861036647,-1,1303,1430,10
62861739556,62861739550,-6,1524,5227,10
62868449746,62868449745,-1,1317,2666,10
62875599798,62875599795,-3,996,3128,10
62877270418,62877270426,8,3232,1259,10
62881629625,62881629622,-3,1296,2001,10
62883488825,62883488826,1,1364,1381,10
62887469299,62887469307,8,14057,51101,10
62894444154,62894444152,-2,1016,1488,10
62894975050,62894975066,16,921,1900,10
62896246714,62896246714,0,969,919,10
62898340342,62898340341,-1,1104,1229,10
62898935346,62898935358,12,534,1325,10
62899619097,62899619095,-2,1353,1932,10
62903109061,62903109065,4,2774,1424,10
62906210998,62906210995,-3,957,1689,10
62907261411,62907261415,4,870,1497,10
62908569068,62908569068,0,991,1941,10
62910339099,62910339099,0,1387,1703,10
62913257407,62913257403,-4,923,1739,10
62913590456,62913590455,-1,1332,1538,10
62913923104,62913923106,2,8365,20568,10
62914118266,62914118262,-4,1017,1840,10
62919269521,62919269519,-2,1462,2223,10
62921215715,62921215709,-6,1199,3226,10
62924450050,62924450049,-1,1046,1741,10
62925050711,62925050710,-1,1455,2587,10
62926255443,62926255441,-2,1100,2352,10
62926461158,62926461159,1,730,1779,10
62928260163,62928260163,0,1171,2417,10
62931552483,62931552482,-1,1665,1451,10
62932551535,62932551534,-1,813,1951,10
62934920414,62934920414,0,1346,1608,10
62937630367,62937630366,-1,1178,1971,10
62943153065,62943153064,-1,1286,1898,10
62949665906,62949665903,-3,1709,1957,10
62950174818,62950174818,0,1251,1529,10
62952226861,62952226862,1,3463,2928,10
62954042038,62954042035,-3,1062,1444,10
62955863646,62955863645,-1,7121,11304,10
62957663142,62957663140,-2,1566,2373,10
62960766442,62960766442,0,1985,2542,10
62964156890,62964156889,-1,610,1298,10
62966842659,62966842658,-1,864,1981,10
62971977935,62971977933,-2,963,1482,10
62973741409,62973741402,-7,1212,4898,10
62974690702,62974690700,-2,1630,2049,10
62978908214,62978908214,0,57689,39027,10
62981586085,62981586085,0,2007,2747,10
62982912602,62982912602,0,2011,2005,10
62984795676,62984795670,-6,1534,6539,10
62985299179,62985299180,1,1740,1934,10
62986397297,62986397297,0,1644,2212,10
62987927614,62987927612,-2,814,1411,10
62992981004,62992981002,-2,813,1996,10
62996191371,62996191368,-3,1250,2193,10
62997192259,62997192258,-1,1272,1799,10
63000494014,63000494014,0,1549,1884,10
63001242694,63001242691,-3,1153,1775,10
63001339145,63001339141,-4,1129,2155,10
63005472410,63005472409,-1,1298,2112,10
63008591059,63008591058,-1,1376,2058,10
63008863914,63008863931,17,1566,2205,10
63011538577,63011538576,-1,1273,1638,10
63012888781,63012888779,-2,1817,1796,10
63013783294,63013783293,-1,862,1451,10
63016149845,63016149845,0,1074,1687,10
63016563797,63016563792,-5,2121,7315,10
63017813338,63017813336,-2,1676,1918,10
63019539062,63019539062,0,1154,2289,10
63020248188,63020248198,10,377,1661,10
63022161152,63022161152,0,1306,1606,10
63025200291,63025200292,1,1877,1411,10
63026315438,63026315434,-4,1354,2718,10
63028223115,63028223113,-2,1268,1875,10
63030272794,63030272792,-2,1452,1789,10
63031758619,63031758623,4,1601,1061,10
63032300729,63032300727,-2,1029,1913,10
63034543306,63034543312,6,13487,26254,10
63046806159,63046806157,-2,1117,1753,10
63058409441,63058409438,-3,1663,2345,10
63061427121,63061427120,-1,1076,1995,10
63063866655,63063866656,1,1196,1727,10
63064744661,63064744660,-1,1379,1691,10
63065557913,63065557911,-2,1021,2311,10
63066597193,63066597194,1,1155,1650,10
63068256132,63068256130,-2,671,1993,10
63071836481,63071836482,1,1435,1541,10
63073187270,63073187265,-5,1220,2426,10
63084430159,63084430157,-2,1163,1730,10
63085894658,63085894657,-1,1416,1640,10
63088513337,63088513339,2,1515,1824,10
63088714591,63088714590,-1,956,1683,10
63089002891,63089002895,4,354,578,10
63090074857,63090074854,-3,1533,1840,10
63092340755,63092340758,3,780,1231,10
63092657895,63092657895,0,2117,2901,10
63093474445,63093474441,-4,1092,3865,10
63095057123,63095057122,-1,991,2232,10
63096090322,63096090322,0,1235,1976,10
63096925516,63096925516,0,1700,2703,10
63102303748,63102303746,-2,981,2665,10
63105115883,63105115891,8,1991,1010,10
63107088451,63107088449,-2,1576,2661,10
63110552313,63110552310,-3,1643,1939,10
63116794546,63116794546,0,1449,2260,10
63117934962,63117934959,-3,1246,2205,10
63124165087,63124165086,-1,1165,2114,10
63124719379,63124719378,-1,600,1856,10
63126173381,63126173379,-2,1121,2221,10
63128873523,63128873522,-1,1640,3022,10
63129295539,63129295538,-1,4784,7040,10
63130345299,63130345298,-1,1289,1706,10
63130836569,63130836570,1,1277,1353,10
63130868708,63130868723,15,631,742,10
63131753771,63131753772,1,768,1694,10
63133873722,63133873719,-3,782,1587,10
63140276943,63140276943,0,1010,1533,10
63141654484,63141654469,-15,1062,2411,10
63142649982,63142649981,-1,1730,2340,10
63154402090,63154402092,2,1361,1619,10
63155412522,63155412521,-1,1526,2559,10
63158533290,63158533288,-2,526,1578,10
63163168626,63163168624,-2,1259,2454,10
63167856934,63167856934,0,724,1934,10
63169031323,63169031322,-1,1264,1740,10
63169896983,63169896982,-1,1248,1654,10
63170912892,63170912890,-2,1237,1680,10
63171052689,63171052685,-4,1327,2071,10
63175644114,63175644113,-1,988,1517,10
63179297613,63179297614,1,825,1442,10
63185166596,63185166596,0,713,1673,10
63188189030,63188189027,-3,1290,2021,10
63191880810,63191880810,0,1241,2060,10
63194059415,63194059411,-4,2034,3377,10
63194760433,63194760433,0,1320,2112,10
63200229083,63200229081,-2,1890,1591,10
63201634163,63201634161,-2,1371,2947,10
63201991228,63201991229,1,1533,1242,10
63203620140,63203620140,0,1057,1719,10
63204955511,63204955509,-2,1047,1723,10
63206789242,63206789240,-2,1346,2313,10
63208987226,63208987226,0,1150,1763,10
63209107071,63209107073,2,4371,3785,10
63210841006,63210841006,0,808,2410,10
63211529849,63211529848,-1,591,774,10
63215077166,63215077166,0,959,1411,10
63215338570,63215338570,0,1188,2075,10
63217336721,63217336720,-1,1285,2291,10
63222473742,63222473740,-2,1089,2558,10
63231773565,63231773565,0,1291,2182,10
63237973171,63237973170,-1,1604,1388,10
63239540156,63239540149,-7,1832,3099,10
63240547245,63240547241,-4,2486,3692,10
63240612010,63240612009,-1,1217,2706,10
63242175541,63242175539,-2,971,1595,10
63242908745,63242908746,1,1191,1741,10
63243803727,63243803726,-1,1460,2513,10
63246216378,63246216378,0,1532,1661,10
63246258445,63246258443,-2,1053,1812,10
63247435487,63247435486,-1,1361,1795,10
63249329465,63249329459,-6,801,2389,10
63249446976,63249446975,-1,1598,1422,10
63250116710,63250116710,0,859,2232,10
63250819555,63250819555,0,1235,1550,10
63251907774,63251907773,-1,1443,2347,10
63253697491,63253697489,-2,1310,1358,10
63253808682,63253808681,-1,1006,1613,10
63262098392,63262098388,-4,1230,1914,10
63263424705,63263424706,1,1565,2255,10
63264864827,63264864828,1,1150,1724,10
63265851114,63265851113,-1,1118,1488,10
63267372502,63267372500,-2,1049,2297,10
63270534394,63270534392,-2,1114,1399,10
63273712276,63273712275,-1,1331,1728,10
63274617244,63274617244,0,962,2171,10
63275309822,63275309823,1,1634,1845,10
63275660202,63275660199,-3,1013,2663,10
63277933893,63277933889,-4,1495,2869,10
63279339130,63279339134,4,1508,1101,10
63279732853,63279732851,-2,1165,2414,10
63282101988,63282101986,-2,1366,2142,10
63283310728,63283310726,-2,1393,1940,10
63283337443,63283337463,20,597,824,10
63285886712,63285886710,-2,1295,1798,10
63287398230,63287398230,0,1738,2047,10
63291444746,63291444750,4,2032,1369,10
63301355147,63301355145,-2,1180,2040,10
63303871667,63303871666,-1,1000,1126,10
63304304545,63304304542,-3,1522,2465,10
63306111699,63306111696,-3,1088,1390,10
63306943850,63306943847,-3,1459,2924,10
63307404536,63307404542,6,3595,1041,10
63311935466,63311935467,1,1171,2534,10
63314170483,63314170462,-21,1255,2075,10
63315725207,63315725206,-1,1145,1941,10
63318914684,63318914681,-3,24000,9888,10
63319543541,63319543539,-2,1193,2240,10
63327731247,63327731246,-1,1341,1617,10
63329563842,63329563839,-3,982,2202,10
63330185715,63330185715,0,1375,2244,10
63330492659,63330492658,-1,1116,1735,10
63331999590,63331999589,-1,1207,2674,10
63333521421,63333521418,-3,1809,1337,10
63334774347,63334774346,-1,1177,2528,10
63335863758,63335863757,-1,1448,2058,10
63338507407,63338507406,-1,1456,1529,10
63341287022,63341287022,0,914,1846,10
63341806130,63341806130,0,1299,2311,10
63342997311,63342997310,-1,1451,1681,10
63344977721,63344977720,-1,1061,1834,10
63346041602,63346041600,-2,1262,1792,10
63347715305,63347715302,-3,1628,2629,10
63349652586,63349652585,-1,1493,1883,10
63350358205,63350358203,-2,1180,2049,10
63352097543,63352097549,6,1393,1177,10
63353772887,63353772886,-1,1434,2757,10
63355812593,63355812599,6,2984,1728,10
63359594170,63359594171,1,992,1363,10
63360455052,63360455062,10,11148,22964,10
63362172437,63362172434,-3,21361,49687,10
63363973390,63363973389,-1,1554,3095,10
63364683081,63364683077,-4,918,1706,10
63365495474,63365495473,-1,780,2120,10
63367225741,63367225748,7,11944,24653,10
63372430676,63372430675,-1,1621,1549,10
63373238827,63373238826,-1,1323,1567,10
63375599196,63375599194,-2,1269,2216,10
63376805033,63376805030,-3,1076,1570,10
63383691993,63383691998,5,881,546,10
63386327935,63386327933,-2,1259,1918,10
63386522279,63386522256,-23,511,830,10
63386991339,63386991339,0,1290,1595,10
63390631886,63390631885,-1,1069,2331,10
63390897632,63390897619,-13,165,1172,10
63403828633,63403828634,1,1276,2143,10
63413950772,63413950758,-14,1415,2183,10
63422929430,63422929427,-3,1229,2615,10
63423332940,63423332959,19,392,1533,10
63431353668,63431353668,0,1817,2092,10
63432396994,63432396991,-3,1490,2027,10
63433710528,63433710526,-2,1413,1951,10
63433738393,63433738378,-15,1245,1409,10
63435470858,63435470854,-4,1313,3037,10
63438527125,63438527128,3,2854,2631,10
63439647728,63439647735,7,7876,30783,10
63441529222,63441529220,-2,1168,1858,10
63441567976,63441567962,-14,1192,2312,10
63442745981,63442745981,0,1366,1827,10
63444924434,63444924432,-2,1238,1999,10
63446739323,63446739323,0,911,1791,10
63447420705,63447420726,21,1519,1911,10
63452645502,63452645499,-3,1456,1850,10
63453912297,63453912295,-2,1213,2815,10
63454766550,63454766550,0,1200,1984,10
63454858834,63454858832,-2,1324,2955,10
63458102383,63458102382,-1,1255,2399,10
63459625485,63459625484,-1,1030,1677,10
63462206002,63462205996,-6,1057,5417,10
63462654570,63462654565,-5,1353,2534,10
63465771362,63465771358,-4,1360,1879,10
63467624988,63467624986,-2,1126,1446,10
63473343359,63473343358,-1,958,1960,10
63474880598,63474880598,0,1065,1908,10
63475092788,63475092786,-2,1392,1769,10
63475686306,63475686305,-1,1039,1532,10
63483640014,63483639995,-19,1429,1207,10
63484051065,63484051063,-2,1259,1389,10
63485642139,63485642139,0,1066,1822,10
63488899566,63488899563,-3,1519,2237,10
63494065502,63494065499,-3,1138,2069,10
63495894530,63495894529,-1,997,3231,10
63500812278,63500812276,-2,1400,2340,10
63501319170,63501319167,-3,1244,1686,10
63504039254,63504039252,-2,790,2258,10
63506841463,63506841462,-1,1250,1231,10
63506943539,63506943540,1,1674,1476,10
63507103855,63507103833,-22,1020,1503,10
63509483790,63509483789,-1,907,1247,10
63510104941,63510104940,-1,1627,1958,10
63510316065,63510316087,22,318,747,10
63512699227,63512699225,-2,1000,1691,10
63513397393,63513397391,-2,1057,1597,10
63513896639,63513896637,-2,966,2331,10
63516024918,63516024917,-1,976,1104,10
63521240423,63521240422,-1,1329,2204,10
63525214107,63525214106,-1,1265,2328,10
63527157922,63527157920,-2,1105,2198,10
63534070432,63534070430,-2,2189,2149,10
63536624963,63536624963,0,1196,2690,10
63540270217,63540270220,3,2266,1671,10
63540886000,63540885998,-2,1016,2646,10
63543654670,63543654670,0,1196,2108,10
63544525151,63544525149,-2,884,2676,10
63546580257,63546580263,6,4839,1460,10
63547234210,63547234212,2,1160,1073,10
63547594496,63547594496,0,1134,1831,10
63552389605,63552389604,-1,1166,1951,10
63555079205,63555079198,-7,715,3423,10
63555745891,63555745888,-3,1268,1928,10
63556552734,63556552733,-1,1310,1678,10
63563113473,63563113472,-1,1788,1680,10
63563756000,63563755999,-1,1340,2265,10
63563982875,63563982862,-13,968,1619,10
63569099638,63569099638,0,1595,2010,10
63569981847,63569981848,1,3874,13981,10
63572347284,63572347285,1,1442,1682,10
63573779820,63573779813,-7,1244,2289,10
63575895517,63575895514,-3,1102,1495,10
63579097637,63579097634,-3,1348,1610,10
63580392651,63580392650,-1,1215,1303,10
63582936603,63582936600,-3,864,1764,10
63583983182,63583983180,-2,1483,2873,10
63587230531,63587230539,8,12089,36822,10
63588957332,63588957330,-2,605,1802,10
63597492697,63597492696,-1,1678,1987,10
63597865597,63597865595,-2,1395,1382,10
63602481405,63602481399,-6,1086,1646,10
63607321186,63607321183,-3,1708,2620,10
63608804285,63608804282,-3,988,1719,10
63610757254,63610757257,3,1664,1789,10
63615040574,63615040573,-1,1059,1506,10
63620211187,63620211185,-2,1220,2829,10
63621725018,63621725015,-3,1460,2005,10
63622663262,63622663260,-2,1643,1749,10
63623308033,63623308029,-4,1145,2329,10
63628187305,63628187310,5,4870,3295,10
63636349071,63636349067,-4,1112,2005,10
63636725395,63636725394,-1,1083,2014,10
63643227487,63643227485,-2,728,1371,10
63644510597,63644510594,-3,1252,2207,10
63648557663,63648557665,2,1432,2067,10
63651932783,63651932783,0,1183,1012,10
63652947271,63652947270,-1,1410,2442,10
63653121520,63653121515,-5,1583,2199,10
63654232373,63654232373,0,1434,1875,10
63656931301,63656931302,1,1174,1985,10
63657623791,63657623786,-5,1278,2490,10
63659874477,63659874474,-3,853,1263,10
63660385083,63660385082,-1,843,2354,10
63662221115,63662221113,-2,1355,2137,10
63662693283,63662693279,-4,990,1473,10
63663432378,63663432377,-1,1183,1663,10
63666240806,63666240787,-19,45939,29915,10
63666767738,63666767736,-2,969,1281,10
63667499165,63667499171,6,4268,2308,10
63668427438,63668427438,0,1525,1953,10
63670452394,63670452394,0,1864,2587,10
63672239662,63672239662,0,1188,2476,10
63674519313,63674519312,-1,1233,1990,10
63674973299,63674973313,14,405,1297,10
63676694221,63676694222,1,785,1004,10
63679424477,63679424484,7,5128,2729,10
63689628056,63689628055,-1,1764,2557,10
63692378622,63692378625,3,1115,1664,10
63699030922,63699030920,-2,998,1859,10
63701602655,63701602654,-1,1108,1369,10
63702897926,63702897926,0,1868,2087,10
63709228069,63709228068,-1,1347,1905,10
63709728852,63709728871,19,901,1751,10
63710054288,63710054286,-2,1136,1615,10
63710511178,63710511170,-8,862,1644,10
63711512214,63711512214,0,1629,1664,10
63712369126,63712369125,-1,1208,2621,10
63714176825,63714176825,0,1321,2143,10
63716694578,63716694579,1,1249,2171,10
63718472036,63718472035,-1,1598,2048,10
63727930178,63727930174,-4,1091,2305,10
63729347150,63729347149,-1,1662,1927,10
63736565958,63736565957,-1,1142,2157,10
63740052083,63740052082,-1,1374,2253,10
63740309559,63740309562,3,1049,1548,10
63743725874,63743725873,-1,1319,2078,10
63744625359,63744625357,-2,1342,2262,10
63748926974,63748926974,0,1175,2055,10
63749408186,63749408186,0,801,1524,10
63750183459,63750183439,-20,1409,2262,10
63755363826,63755363819,-7,886,4149,10
63757593302,63757593300,-2,1211,2961,10
63758415992,63758415990,-2,1674,2718,10
63759936369,63759936370,1,2227,1961,10
63765983326,63765983324,-2,1327,2522,10
63767922382,63767922379,-3,1021,1222,10
63769709546,63769709542,-4,1147,1612,10
63773212927,63773212927,0,1180,2198,10
63775212502,63775212502,0,873,1313,10
63776808015,63776808014,-1,914,2186,10
63778461579,63778461578,-1,1558,2425,10
63784696479,63784696477,-2,1326,1518,10
63785333002,63785333002,0,1057,1769,10
63787192026,63787192027,1,1157,1546,10
63791497646,63791497645,-1,1433,1381,10
63796286418,63796286413,-5,1183,2111,10
63797191271,63797191266,-5,2177,5762,10
63798648689,63798648688,-1,1054,2304,10
63811166053,63811166061,8,8163,3013,10
63811397948,63811397947,-1,1162,1758,10
63815204034,63815204029,-5,982,2112,10
63815444791,63815444786,-5,1659,4114,10
63815681815,63815681810,-5,1129,1673,10
63816530009,63816530008,-1,1134,2206,10
63818339681,63818339681,0,1515,1873,10
63820010903,63820010900,-3,1265,2439,10
63821183918,63821183916,-2,1288,2201,10
63828693958,63828693957,-1,1015,1828,10
63831798955,63831798949,-6,1227,3871,10
63836264819,63836264823,4,2283,1097,10
63838589274,63838589271,-3,1185,2646,10
63838912322,63838912322,0,1273,3448,10
63840140100,63840140098,-2,956,1677,10
63843791222,63843791218,-4,919,1539,10
63844124841,63844124859,18,327,792,10
63845428127,63845428125,-2,897,2949,10
63846637021,63846637019,-2,1397,1676,10
63846789767,63846789763,-4,1463,2119,10
63855321631,63855321609,-22,1880,1994,10
63857065915,63857065918,3,2109,1797,10
63862751531,63862751530,-1,1176,1834,10
63867009282,63867009290,8,9609,39026,10
63868795917,63868795915,-2,539,1154,10
63870874650,63870874646,-4,1141,3111,10
63876985445,63876985442,-3,998,2444,10
63881762829,63881762827,-2,1095,2075,10
63884068713,63884068710,-3,965,1859,10
63885407758,63885407756,-2,796,2015,10
63886779907,63886779906,-1,1903,2984,10
63887597782,63887597780,-2,978,1436,10
63890231806,63890231805,-1,1194,2240,10
63891360887,63891360885,-2,25596,22054,10
63892029529,63892029526,-3,829,2782,10
63893591642,63893591647,5,2629,1923,10
63896299122,63896299119,-3,1246,2285,10
63901224790,63901224791,1,1278,1575,10
63904875778,63904875773,-5,2208,10485,10
63909251530,63909251529,-1,1200,1622,10
63915413940,63915413943,3,982,1311,10
63915885833,63915885838,5,3201,2362,10
63918012429,63918012428,-1,1283,2221,10
63927643465,63927643462,-3,1236,2254,10
63929554262,63929554258,-4,827,2505,10
63933048318,63933048316,-2,1100,2495,10
63934530334,63934530333,-1,1152,2061,10
63934924962,63934924942,-20,356,1170,10
63935973138,63935973138,0,1088,1631,10
63937213692,63937213695,3,4268,3049,10
63942005610,63942005607,-3,1424,1898,10
63945152123,63945152122,-1,1432,1694,10
63947713542,63947713541,-1,1629,1739,10
63949349057,63949349055,-2,1477,1906,10
63960241686,63960241691,5,4487,1221,10
63960497871,63960497866,-5,1192,1856,10
63964348059,63964348059,0,1126,1426,10
63969980665,63969980663,-2,1584,1942,10
63973883365,63973883365,0,1475,1977,10
63975590841,63975590838,-3,1183,2189,10
63981318858,63981318856,-2,1300,2697,10
63981591486,63981591485,-1,1091,2119,10
63981716321,63981716318,-3,1054,1509,10
63982150990,63982150990,0,924,1356,10
63983897290,63983897287,-3,1263,1687,10
63986442036,63986442041,5,2117,1118,10
63987910762,63987910758,-4,1144,2519,10
63989997465,63989997463,-2,1490,2063,10
63990789567,63990789566,-1,1192,1933,10
63992626090,63992626088,-2,1159,2252,10
63994686431,63994686430,-1,748,1370,10
63997064503,63997064501,-2,1408,2165,10
64000551182,64000551185,3,2509,1583,10
64000669521,64000669518,-3,1118,1754,10
64004564849,64004564846,-3,1892,3143,10
64008003725,64008003722,-3,1483,2513,10
64016328586,64016328586,0,1142,2108,10
64019567762,64019567762,0,1445,1936,10
64020640321,64020640320,-1,1141,1946,10
64021774546,64021774545,-1,1870,2416,10
64022139276,64022139274,-2,1234,2099,10
64025536379,64025536379,0,1081,2080,10
64029610251,64029610250,-1,1134,1363,10
64030497474,64030497472,-2,1324,2686,10
64044097176,64044097174,-2,1346,1646,10
64046070598,64046070597,-1,1388,1747,10
64047198875,64047198878,3,1313,1192,10
64049423528,64049423526,-2,1245,1821,10
64051652327,64051652326,-1,818,1791,10
64052583583,64052583584,1,766,948,10
64053704082,64053704079,-3,1216,1726,10
64058182371,64058182370,-1,920,1561,10
64058344055,64058344038,-17,726,3223,10
64060901370,64060901370,0,933,1977,10
64061331426,64061331425,-1,1181,1962,10
64065084891,64065084886,-5,1136,1619,10
64069325559,64069325557,-2,1588,2281,10
64070281260,64070281278,18,931,2235,10
64076848117,64076848117,0,3031,3155,10
64080050073,64080050069,-4,1682,2316,10
64080676875,64080676875,0,1081,1765,10
64088349150,64088349148,-2,1215,2122,10
64089184567,64089184566,-1,1589,3001,10
64092136046,64092136046,0,1578,2511,10
64093724354,64093724352,-2,1444,1758,10
64095570054,64095570052,-2,1112,1458,10
64098366682,64098366679,-3,1214,1598,10
64102029194,64102029193,-1,1100,1409,10
64102566571,64102566569,-2,808,1094,10
64103961350,64103961348,-2,1441,2188,10
64105466957,64105466951,-6,1338,2366,10
64106330913,64106330911,-2,1386,1743,10
64108322460,64108322459,-1,959,2197,10
64111216422,64111216442,20,17266,43348,10
64113681218,64113681218,0,1386,2251,10
64118357561,64118357559,-2,1252,1839,10
64119741078,64119741090,12,1086,1765,10
64120487560,64120487553,-7,2054,10636,10
64122717761,64122717762,1,1109,1563,10
64131638381,64131638380,-1,1244,1822,10
64140220405,64140220407,2,2111,1475,10
64140389315,64140389314,-1,1106,2094,10
64140957704,64140957691,-13,232,589,10
64147670496,64147670494,-2,1659,1854,10
64148434494,64148434491,-3,1370,1971,10
64150351097,64150351096,-1,1699,2364,10
64153180573,64153180570,-3,1305,2535,10
64153259313,64153259297,-16,1310,2283,10
64161281683,64161281681,-2,990,1454,10
64164254226,64164254225,-1,1094,2321,10
64169625355,64169625353,-2,813,1369,10
64169900921,64169900919,-2,1116,2023,10
64170411043,64170411062,19,753,1293,10
64170936564,64170936562,-2,1263,2036,10
64173012842,64173012841,-1,1288,1390,10
64173433252,64173433250,-2,1233,1583,10
64176251426,64176251425,-1,1367,2337,10
64188719291,64188719290,-1,1361,2272,10
64188890843,64188890841,-2,1805,2853,10
64191980001,64191980001,0,956,1623,10
64192182233,64192182230,-3,711,1209,10
64196329169,64196329163,-6,949,4369,10
64198983054,64198983054,0,1916,2107,10
64201334183,64201334182,-1,1765,1684,10
64202219729,64202219727,-2,1614,1929,10
64206707682,64206707681,-1,1002,2628,10
64208167414,64208167412,-2,946,1813,10
64211687547,64211687544,-3,887,2352,10
64213776954,64213776953,-1,853,1167,10
64214668583,64214668582,-1,1541,2311,10
64214866005,64214866005,0,1368,1606,10
64218365214,64218365232,18,3992,1539,10
64220029674,64220029674,0,630,1378,10
64222468490,64222468486,-4,1387,2345,10
64222808881,64222808877,-4,1502,2150,10
64222929528,64222929519,-9,1383,1750,10
64226350390,64226350390,0,1385,1446,10
64227301870,64227301865,-5,1084,2415,10
64228884987,64228884986,-1,1062,2053,10
64229764722,64229764718,-4,1576,2508,10
64233911534,64233911534,0,1163,1993,10
64234144982,64234144981,-1,1128,1139,10
64244050373,64244050371,-2,1198,2050,10
64244973880,64244973876,-4,2264,5331,10
64245513737,64245513734,-3,1654,2701,10
64255337497,64255337493,-4,847,1859,10
64256468999,64256468998,-1,1116,2366,10
64257520886,64257520881,-5,1112,3360,10
64259013739,64259013739,0,837,1657,10
64261289213,64261289212,-1,1194,2270,10
64261699458,64261699457,-1,1158,1942,10
64262442714,64262442710,-4,1405,2430,10
64262979043,64262979023,-20,719,376,10
64265278285,64265278284,-1,1166,1633,10
64267889211,64267889212,1,829,1552,10
64268345113,64268345110,-3,1279,1511,10
64270755078,64270755078,0,876,2033,10
64273046957,64273046957,0,1871,2938,10
64273696746,64273696745,-1,1739,2274,10
64279226802,64279226801,-1,1632,2385,10
64280227974,64280227973,-1,944,2338,10
64282788884,64282788891,7,2899,840,10
64287497176,64287497173,-3,1332,1739,10
64287662363,64287662363,0,1051,1327,10
64288902211,64288902211,0,930,2069,10
64289072488,64289072510,22,1253,1949,10
64289650679,64289650678,-1,1273,2722,10
64290338826,64290338826,0,1000,2104,10
64291295515,64291295513,-2,1365,2010,10
64292394037,64292394036,-1,1285,2213,10
64293885059,64293885057,-2,1315,2404,10
64296382982,64296382987,5,1650,1121,10
64302126862,64302126867,5,1743,1531,10
64305267164,64305267163,-1,985,2376,10
64305740047,64305740044,-3,729,1420,10
64305837543,64305837545,2,1661,1491,10
64305875211,64305875204,-7,773,5127,10
64313225557,64313225557,0,1495,2704,10
64313402638,64313402636,-2,1755,2663,10
64313818829,64313818829,0,1238,1551,10
64314313932,64314313930,-2,1501,1433,10
64315658378,64315658378,0,1437,1782,10
64327341975,64327341976,1,1604,1717,10
64329148833,64329148831,-2,1651,1760,10
64329559883,64329559873,-10,945,2262,10
64331195176,64331195174,-2,955,1710,10
64334951807,64334951807,0,1240,1441,10
64337015888,64337015881,-7,197,5077,10
64339587880,64339587884,4,8880,36690,10
64341001425,64341001425,0,1250,1832,10
64344071443,64344071437,-6,1821,7100,10
64345353254,64345353253,-1,1531,2435,10
64353564230,64353564226,-4,1199,1736,10
64354827098,64354827099,1,2510,2667,10
64362627156,64362627154,-2,1454,1784,10
64363343522,64363343521,-1,1252,1452,10
64363937650,64363937650,0,1230,2541,10
64369711022,64369711024,2,850,2261,10
64369738424,64369738423,-1,1366,2422,10
64371404398,64371404396,-2,1022,2495,10
64372573050,64372573048,-2,1305,2137,10
64373102206,64373102207,1,1024,1936,10
64373495206,64373495206,0,822,1221,10
64381895574,64381895574,0,1311,1274,10
64383284650,64383284651,1,1089,1058,10
64394085026,64394085023,-3,994,1381,10
64394817265,64394817262,-3,1064,1686,10
64394919096,64394919119,23,261,1002,10
64398894967,64398894964,-3,774,2700,10
64398974799,64398974799,0,1775,2469,10
64402592915,64402592913,-2,888,1474,10
64403807067,64403807066,-1,913,2253,10
64404398237,64404398236,-1,946,1608,10
64405534557,64405534555,-2,958,2074,10
64405591666,64405591665,-1,1043,1898,10
64409411044,64409411044,0,1256,1765,10
64410726771,64410726771,0,1076,1867,10
64411689639,64411689638,-1,1099,922,10
64412284541,64412284539,-2,1280,2129,10
64417860137,64417860143,6,923,778,10
64418433641,64418433642,1,1527,2675,10
64430970365,64430970363,-2,680,1535,10
64431241721,64431241716,-5,2070,8130,10
64432572585,64432572586,1,1401,1471,10
64438045307,64438045306,-1,729,1184,10
64443288427,64443288424,-3,1535,1769,10
64455533901,64455533899,-2,1101,2208,10
64462972386,64462972386,0,3091,4072,10
64464481530,64464481529,-1,1348,1948,10
64465057683,64465057682,-1,1453,2243,10
64466652311,64466652310,-1,1262,1845,10
64466986810,64466986817,7,4791,1587,10
64467420670,64467420669,-1,1217,2571,10
64470880740,64470880739,-1,1245,1438,10
64473436230,64473436235,5,1619,1377,10
64474183693,64474183692,-1,949,1313,10
64484101635,64484101633,-2,1096,1680,10
64485528246,64485528247,1,1151,2036,10
64490455176,64490455174,-2,1273,2394,10
64490562338,64490562336,-2,1283,2860,10
64493663211,64493663211,0,1521,1852,10
64497324376,64497324374,-2,557,1194,10
64498824376,64498824375,-1,1670,1951,10
64500702406,64500702401,-5,1191,2003,10
64502893749,64502893750,1,1203,2042,10
64503404219,64503404218,-1,1019,2213,10
64505423231,64505423232,1,943,1166,10
64505733966,64505733963,-3,884,1886,10
64506573675,64506573675,0,1067,1618,10
64506846310,64506846305,-5,1086,3942,10
64507338374,64507338371,-3,1059,1431,10
64512812895,64512812894,-1,1556,2557,10
64517021185,64517021186,1,1488,1659,10
64520067991,64520067971,-20,1383,1371,10
64522513651,64522513650,-1,1314,2803,10
64530648184,64530648186,2,1247,1067,10
64532398939,64532398938,-1,1012,1367,10
64535224610,64535224609,-1,1805,2076,10
64537999322,64537999320,-2,1285,2055,10
64544378566,64544378567,1,1851,1864,10
64549312710,64549312710,0,1714,2651,10
64550237718,64550237718,0,1231,1596,10
64552534479,64552534476,-3,1030,1915,10
64552755295,64552755293,-2,1174,1821,10
64553269107,64553269105,-2,1150,1923,10
64554692606,64554692605,-1,1026,1569,10
64556454134,64556454134,0,1317,1875,10
64557289023,64557289022,-1,1099,2390,10
64560422483,64560422492,9,1173,1600,10
64563593103,64563593098,-5,1551,4696,10
64565025910,64565025915,5,2296,1317,10
64567748053,64567748053,0,1132,1416,10
64569537202,64569537203,1,924,1754,10
64571840662,64571840662,0,996,1471,10
64571958185,64571958170,-15,79,627,10
64578438746,64578438744,-2,858,1210,10
64579621191,64579621190,-1,986,2218,10
64584774083,64584774083,0,1004,1888,10
64590663007,64590663003,-4,1264,1752,10
64591822618,64591822617,-1,1209,2090,10
64592851546,64592851548,2,1727,1597,10
64602023869,64602023875,6,2852,1189,10
64602377487,64602377467,-20,1189,2552,10
64604431275,64604431274,-1,693,1868,10
64604757746,64604757765,19,1374,2713,10
64611092806,64611092799,-7,2569,8523,10
64615639173,64615639169,-4,1492,2739,10
64616344217,64616344214,-3,1073,2025,10
64618922882,64618922881,-1,1071,1667,10
64624380464,64624380465,1,1999,2157,10
64629606222,64629606224,2,933,1826,10
64630761710,64630761706,-4,821,2435,10
64631057791,64631057789,-2,1329,2233,10
64631146849,64631146832,-17,1577,2270,10
64632759921,64632759926,5,1457,1277,10
64635381226,64635381226,0,1125,1816,10
64635956454,64635956453,-1,1352,1967,10
64644456337,64644456334,-3,1207,2191,10
64648343013,64648343010,-3,1209,1921,10
64654888294,64654888294,0,981,1152,10
64655250085,64655250086,1,1646,1996,10
64657037296,64657037296,0,1605,2117,10
64657269783,64657269782,-1,958,2128,10
64662025026,64662025024,-2,17044,8134,10
64662901039,64662901038,-1,1117,1868,10
64666692421,64666692423,2,5928,4823,10
64676358409,64676358409,0,1424,2026,10
64677733700,64677733697,-3,902,2573,10
64680993383,64680993383,0,910,1087,10
64686205529,64686205527,-2,1597,1652,10
64686722078,64686722077,-1,1926,1729,10
64693097262,64693097260,-2,1379,2994,10
64699070066,64699070065,-1,1542,2232,10
64699897076,64699897079,3,2247,1866,10
64700960810,64700960807,-3,869,1764,10
64701480458,64701480458,0,1682,2228,10
64704338398,64704338395,-3,1197,1684,10
64709157701,64709157704,3,1304,1285,10
64715144409,64715144392,-17,1032,2051,10
64715718918,64715718917,-1,1559,1588,10
64719238438,64719238438,0,912,1754,10
64719674258,64719674257,-1,1051,2067,10
64725650618,64725650617,-1,1414,2448,10
64727066680,64727066680,0,775,2007,10
64731785487,64731785486,-1,1109,1941,10
64736124016,64736124014,-2,1231,2646,10
64737571010,64737571011,1,1859,2633,10
64739109558,64739109557,-1,1235,1993,10
64740210034,64740210051,17,1020,2320,10
64743378765,64743378762,-3,825,1420,10
64748222857,64748222857,0,1395,2045,10
64749173443,64749173447,4,3514,3184,10
64750148802,64750148798,-4,1250,3262,10
64752264837,64752264847,10,875,1575,10
64754095445,64754095442,-3,1283,2083,10
64757661294,64757661293,-1,1595,2435,10
64762681983,64762681981,-2,1037,2590,10
64764210203,64764210204,1,1442,1379,10
64767540873,64767540873,0,1578,1901,10
64771324302,64771324300,-2,1277,2711,10
64773155291,64773155292,1,901,1168,10
64776141330,64776141327,-3,1436,2089,10
64782509191,64782509190,-1,1007,2225,10
64786626769,64786626769,0,1355,1796,10
64786804831,64786804827,-4,1103,1666,10
64789150201,64789150201,0,1556,2978,10
64792738482,64792738493,11,12570,38403,10
64796272890,64796272889,-1,1081,2696,10
64797677262,64797677261,-1,1511,1834,10
64799660866,64799660863,-3,1767,3105,10
64800189631,64800189629,-2,1130,2604,10
64802017694,64802017693,-1,1986,2946,10
64803332584,64803332583,-1,1731,2982,10
64805888209,64805888210,1,1506,1766,10
64809960319,64809960318,-1,936,2155,10
64812451552,64812451550,-2,1446,2103,10
64814369651,64814369649,-2,1460,2221,10
64814409130,64814409128,-2,1497,2424,10
64817433226,64817433225,-1,1294,2368,10
64818202933,64818202930,-3,1330,2079,10
64825556323,64825556320,-3,1333,2500,10
64827131570,64827131569,-1,1905,1395,10
64827538467,64827538467,0,1059,1033,10
64828299301,64828299301,0,1598,1709,10
64828335131,64828335111,-20,1514,559,10
64828967875,64828967891,16,1123,1820,10
64837821273,64837821271,-2,2010,3224,10
64838577610,64838577629,19,41327,16359,10
64841282879,64841282878,-1,1155,1854,10
64842376495,64842376490,-5,404,1807,10
64842514466,64842514459,-7,1416,1529,10
64845525065,64845525065,0,952,1423,10
64846234606,64846234626,20,2572,1665,10
64848435901,64848435898,-3,1479,2271,10
64853282847,64853282842,-5,1177,1763,10
64858849036,64858849034,-2,1265,2248,10
64860289302,64860289301,-1,1086,1992,10
64863673961,64863673960,-1,903,1559,10
64865304268,64865304265,-3,706,1681,10
64867681078,64867681077,-1,725,1688,10
64869453745,64869453743,-2,2212,4467,10
64870905043,64870905061,18,1330,1625,10
64871274693,64871274690,-3,1275,2136,10
64871338601,64871338596,-5,1177,2618,10
64874571686,64874571684,-2,1699,2337,10
64874662350,64874662331,-19,691,794,10
64874886219,64874886217,-2,1101,2205,10
64875631535,64875631535,0,903,1722,10
64876620207,64876620205,-2,1219,1921,10
64877062879,64877062879,0,2747,5500,10
64877271691,64877271690,-1,977,2519,10
64881196755,64881196752,-3,1026,1205,10
64881518801,64881518807,6,1213,842,10
64887549561,64887549560,-1,918,1925,10
64889612784,64889612781,-3,1264,2395,10
64892750602,64892750602,0,1165,1483,10
64892898869,64892898866,-3,1122,1391,10
64893102516,64893102514,-2,1407,2339,10
64895438051,64895438053,2,1021,1755,10
64896138742,64896138740,-2,838,2214,10
64896420893,64896420890,-3,1096,1785,10
64897071233,64897071230,-3,1349,3052,10
64897762259,64897762258,-1,1345,2606,10
64899007870,64899007866,-4,1541,2847,10
64899219085,64899219084,-1,864,1728,10
64899538326,64899538322,-4,1180,1827,10
64902863707,64902863709,2,1183,1896,10
64907600390,64907600390,0,1053,1702,10
64914253660,64914253660,0,883,1598,10
64916327786,64916327784,-2,1335,2237,10
64920549499,64920549498,-1,733,1482,10
64921379174,64921379174,0,1048,1534,10
64922280031,64922280031,0,665,1229,10
64922918870,64922918865,-5,30426,6245,10
64925497803,64925497803,0,872,1627,10
64930905289,64930905285,-4,666,1580,10
64931489177,64931489180,3,1473,1463,10
64933208509,64933208519,10,14786,22710,10
64944529069,64944529070,1,902,1433,10
64946046082,64946046078,-4,915,2376,10
64946518881,64946518880,-1,1079,1764,10
64949765872,64949765870,-2,1375,2570,10
64951116422,64951116419,-3,1531,2547,10
64951666618,64951666601,-17,805,1667,10
64953361715,64953361714,-1,1447,2496,10
64956453038,64956453037,-1,922,1867,10
64957526231,64957526232,1,1183,1850,10
64958977203,64958977203,0,751,1565,10
64960048880,64960048877,-3,1195,2125,10
64960109154,64960109154,0,846,1538,10
64961991958,64961991953,-5,3497,12346,10
64962134709,64962134707,-2,1566,2886,10
64964829411,64964829409,-2,977,1986,10
64965566232,64965566231,-1,1160,2193,10
64967182465,64967182463,-2,1353,2035,10
64976652417,64976652417,0,1405,1609,10
64981618165,64981618167,2,1291,1017,10
64981759359,64981759357,-2,940,1617,10
64982885835,64982885834,-1,672,1588,10
64983338723,64983338720,-3,1033,2352,10
64986636643,64986636642,-1,1069,1353,10
64987538085,64987538084,-1,1163,1779,10
64990423518,64990423517,-1,1385,1491,10
64991248683,64991248683,0,1057,2313,10
64996243837,64996243835,-2,1843,2085,10
64997372018,64997372014,-4,1493,2396,10
64997492521,64997492502,-19,479,1442,10
65000377294,65000377291,-3,1680,2327,10
65000542424,65000542429,5,2203,1151,10
65001290140,65001290139,-1,1289,1920,10
65001375133,65001375133,0,1120,1926,10
65004436520,65004436518,-2,1166,2007,10
65006118609,65006118609,0,1250,1324,10
65006621833,65006621832,-1,1619,2697,10
65006680815,65006680815,0,1312,1833,10
65008913277,65008913275,-2,1563,1974,10
65009470547,65009470547,0,863,1541,10
65014042682,65014042680,-2,1174,1597,10
65014671071,65014671069,-2,1355,2046,10
65014931210,65014931212,2,1539,2244,10
65014964094,65014964093,-1,1154,1864,10
65019536353,65019536354,1,1229,1966,10
65021094341,65021094340,-1,951,2058,10
65021710235,65021710237,2,1490,1582,10
65022203126,65022203125,-1,1084,1777,10
65025867070,65025867075,5,3673,1857,10
65029790033,65029790031,-2,1259,2487,10
65036182416,65036182415,-1,1497,2511,10
65037736731,65037736735,4,3802,2263,10
65039037596,65039037594,-2,1313,2185,10
65039257965,65039257961,-4,1245,2487,10
65045630239,65045630238,-1,1644,2296,10
65047108476,65047108476,0,1293,1315,10
65047410906,65047410905,-1,1340,1745,10
65049576742,65049576742,0,1366,3099,10
65050105630,65050105629,-1,1100,12837,10
65052457185,65052457183,-2,1889,2731,10
65056024358,65056024361,3,1733,1019,10
65057965194,65057965193,-1,1011,1985,10
65061555697,65061555697,0,1478,1789,10
65063332214,65063332210,-4,1407,2924,10
65066871535,65066871534,-1,1025,2222,10
65069935306,65069935306,0,1444,3225,10
65071570466,65071570464,-2,1231,2085,10
65072009463,65072009463,0,1386,2291,10
65076924710,65076924706,-4,1221,1678,10
65078563164,65078563164,0,1557,2473,10
65079894046,65079894044,-2,1193,2243,10
65080189471,65080189472,1,958,1757,10
65080910571,65080910569,-2,1426,3126,10
65082578153,65082578150,-3,1123,2087,10
65087631754,65087631753,-1,1112,1580,10
65097861397,65097861397,0,1640,1260,10
65099526439,65099526434,-5,1401,2471,10
65099675525,65099675530,5,17157,10402,10
65100902149,65100902146,-3,1137,1879,10
65108229678,65108229678,0,1058,2229,10
65115486633,65115486633,0,828,1138,10
65117447823,65117447820,-3,1334,2091,10
65120172922,65120172922,0,936,1604,10
65120835422,65120835420,-2,1236,3398,10
65122585035,65122585038,3,1737,1169,10
65127818314,65127818313,-1,1458,2257,10
65131514910,65131514910,0,1285,1881,10
65133022138,65133022137,-1,981,2079,10
65133447421,65133447420,-1,49045,22621,10
65134743982,65134743978,-4,825,1907,10
65135275841,65135275824,-17,1809,1776,10
65135956367,65135956363,-4,1405,1760,10
65136820213,65136820212,-1,1738,2579,10
65139571697,65139571701,4,1569,1519,10
65140560738,65140560738,0,1330,2477,10
65141140386,65141140383,-3,966,2221,10
65146859354,65146859355,1,1194,1991,10
65150150078,65150150076,-2,1146,2275,10
65152209585,65152209564,-21,1133,2928,10
65152639169,65152639167,-2,1290,1783,10
65152830514,65152830510,-4,1381,1955,10
65153918473,65153918471,-2,1341,2275,10
65156198831,65156198834,3,3235,2866,10
65156471563,65156471542,-21,1404,2231,10
65157413386,65157413382,-4,1212,2017,10
65157925691,65157925689,-2,1274,2201,10
65163737031,65163737030,-1,1168,1961,10
65168260293,65168260290,-3,1291,2250,10
65170151552,65170151553,1,1161,1256,10
65171160953,65171160950,-3,1313,2280,10
65175482746,65175482744,-2,1337,2435,10
65176696072,65176696071,-1,1352,2287,10
65180516400,65180516399,-1,1197,1433,10
65181660830,65181660827,-3,1150,2231,10
65187332674,65187332675,1,1358,1626,10
65189009112,65189009111,-1,1482,2099,10
65191433997,65191433996,-1,1298,2242,10
65191577446,65191577447,1,1176,1457,10
65196253963,65196253961,-2,1364,2491,10
65198502544,65198502542,-2,1367,2873,10
65199170766,65199170765,-1,1249,1669,10
65199723150,65199723147,-3,1124,2089,10
65200674009,65200674007,-2,1498,2422,10
65201332510,65201332509,-1,1015,1932,10
65203254235,65203254233,-2,1450,2276,10
65208111595,65208111596,1,1166,2212,10
65214910326,65214910325,-1,1877,3107,10
65214961422,65214961422,0,1048,1512,10
65215854860,65215854862,2,1321,1690,10
65216724763,65216724762,-1,942,1206,10
65218307842,65218307840,-2,972,1922,10
65222072006,65222072006,0,1390,1772,10
65224258214,65224258215,1,1712,1645,10
65225000155,65225000155,0,1113,1941,10
65226714901,65226714900,-1,1483,1731,10
65227715004,65227715005,1,1467,1370,10
65229949034,65229949026,-8,27987,18902,10
65230770592,65230770592,0,1353,1635,10
65235295362,65235295363,1,2966,3483,10
65237022024,65237022022,-2,1448,1596,10
65240042973,65240042968,-5,1031,2996,10
65242521353,65242521352,-1,1047,2100,10
65250263526,65250263524,-2,1262,1821,10
65250675735,65250675733,-2,1383,1906,10
65252234825,65252234822,-3,1365,2388,10
65252375502,65252375501,-1,1398,1713,10
65252503461,65252503458,-3,1291,2023,10
65255283488,65255283491,3,1585,1597,10
65257666542,65257666537,-5,1123,2130,10
65258464017,65258464016,-1,1474,2848,10
65263756160,65263756142,-18,1227,801,10
65269929087,65269929084,-3,1021,2206,10
65271958478,65271958478,0,1213,1773,10
65272314762,65272314759,-3,1005,2025,10
65275524076,65275524076,0,2012,2071,10
65275625769,65275625769,0,1257,1514,10
65276279546,65276279550,4,1295,1569,10
65287676508,65287676516,8,8743,1462,10
65294249722,65294249721,-1,1002,1732,10
65296064590,65296064589,-1,1007,1767,10
65296503532,65296503530,-2,856,1662,10
65297550114,65297550113,-1,1177,1709,10
65300608801,65300608801,0,1661,1549,10
65302481013,65302481012,-1,947,1722,10
65302867818,65302867832,14,1039,1096,10
65302939630,65302939630,0,1401,1639,10
65306227022,65306227020,-2,1164,2131,10
65306652173,65306652172,-1,888,2218,10
65307862034,65307862013,-21,943,3489,10
65312842563,65312842561,-2,1218,1970,10
65313331861,65313331859,-2,1055,1876,10
65313743810,65313743803,-7,1206,4715,10
65315636234,65315636233,-1,1365,1578,10
65317046926,65317046926,0,1175,1756,10
65320416003,65320416003,0,1391,2045,10
65320848094,65320848090,-4,2153,8787,10
65321426804,65321426803,-1,1381,1957,10
65323571595,65323571593,-2,846,1697,10
65324830045,65324830043,-2,1321,2127,10
65328363859,65328363857,-2,789,1530,10
65330774402,65330774398,-4,1125,1558,10
65333508026,65333508023,-3,784,1948,10
65341772115,65341772115,0,1464,1718,10
65342351260,65342351279,19,1238,1327,10
65346479373,65346479372,-1,1485,2265,10
65354673229,65354673226,-3,1200,2395,10
65356793381,65356793378,-3,926,1547,10
65359881711,65359881707,-4,806,934,10
65364948976,65364948974,-2,1789,2757,10
65367294989,65367294996,7,7362,2279,10
65368182532,65368182542,10,562,2806,10
65368243890,65368243887,-3,1388,1497,10
65370497001,65370497002,1,2992,2888,10
65377858750,65377858749,-1,1110,2175,10
65381788362,65381788365,3,1463,1595,10
65383001789,65383001787,-2,913,1951,10
65383862608,65383862610,2,1612,1763,10
65385695357,65385695355,-2,1590,1819,10
65394683677,65394683675,-2,1809,2469,10
65395376739,65395376738,-1,1493,2866,10
65403642159,65403642157,-2,1254,1701,10
65403705202,65403705201,-1,1108,2050,10
65411374345,65411374341,-4,1065,1776,10
65413992191,65413992186,-5,1126,2339,10
65414818721,65414818721,0,1238,2042,10
65415411482,65415411501,19,977,1559,10
65416232027,65416232026,-1,1347,2228,10
65418930601,65418930597,-4,815,2637,10
65423919458,65423919458,0,1223,978,10
65432339342,65432339341,-1,1238,1356,10
65434801262,65434801260,-2,1159,2399,10
65436664529,65436664527,-2,1371,2138,10
65438049972,65438049970,-2,1022,1493,10
65438250415,65438250414,-1,1227,2005,10
65438484913,65438484926,13,80,1019,10
65439759729,65439759730,1,1014,1417,10
65441522575,65441522571,-4,1239,2249,10
65442184934,65442184932,-2,1412,1946,10
65444790522,65444790515,-7,917,3575,10
65449301915,65449301905,-10,1341,2762,10
65452756752,65452756751,-1,1139,1648,10
65453454750,65453454749,-1,1190,1927,10
65455572359,65455572358,-1,1121,1649,10
65459196251,65459196248,-3,1239,2289,10
65460873971,65460873972,1,1350,1204,10
65467919143,65467919141,-2,1389,2330,10
65471075381,65471075381,0,1198,1821,10
65471671274,65471671276,2,996,1410,10
65472832416,65472832406,-10,1029,2117,10
65474308606,65474308604,-2,1529,1864,10
65477336530,65477336526,-4,1153,2081,10
65479479647,65479479646,-1,1292,1725,10
65481343961,65481343959,-2,697,1617,10
65484287311,65484287310,-1,1971,2354,10
65487842777,65487842773,-4,880,2193,10
65488115971,65488115985,14,908,2541,10
65489196903,65489196905,2,1044,1172,10
65495607746,65495607745,-1,1435,1525,10
65497499903,65497499903,0,1655,1848,10
65499104106,65499104107,1,1414,1576,10
65503205230,65503205229,-1,2259,2688,10
65503727665,65503727682,17,1137,3830,10
65503868206,65503868199,-7,1558,5869,10
65506280242,65506280243,1,32436,14844,10
65508214686,65508214690,4,2228,932,10
65509254912,65509254909,-3,1604,2004,10
65511627318,65511627317,-1,1140,2014,10
65520549997,65520549995,-2,1620,2508,10
65521986290,65521986287,-3,1463,2322,10
65522473774,65522473773,-1,1943,2423,10
65523655863,65523655866,3,1375,869,10
65528803790,65528803787,-3,1358,1949,10
65530410730,65530410727,-3,1765,2365,10
65532650445,65532650445,0,1956,2986,10
65532926784,65532926787,3,1534,1887,10
65534192774,65534192773,-1,1387,2901,10
65534467544,65534467545,1,1360,1586,10
65534862345,65534862342,-3,2940,5164,10
65535028079,65535028092,13,1021,1366,10
65536292833,65536292830,-3,1249,1577,10
65537693707,65537693705,-2,820,2092,10
65537763838,65537763840,2,1486,2003,10
65539821435,65539821434,-1,1841,2346,10
65540942977,65540942984,7,15553,28573,10
65541517990,65541517989,-1,1611,2243,10
65543205615,65543205630,15,385,1245,10
65545102119,65545102118,-1,1055,2558,10
65545854150,65545854147,-3,1088,2060,10
65547527331,65547527328,-3,1269,3179,10
65547894412,65547894408,-4,1539,2076,10
65550512020,65550512018,-2,1505,2427,10
65550901718,65550901717,-1,1393,1803,10
65550992097,65550992097,0,553,1216,10
65551716343,65551716342,-1,1281,2327,10
65554148911,65554148913,2,767,1487,10
65555688794,65555688794,0,1091,1694,10
65557168981,65557168981,0,2254,2913,10
65557827026,65557827025,-1,1347,2389,10
65558066189,65558066193,4,3319,1725,10
65561383772,65561383770,-2,1360,1768,10
65562158114,65562158113,-1,1229,1789,10
65562652650,65562652650,0,1252,2071,10
65566328474,65566328477,3,1337,2168,10
65569070916,65569070914,-2,1355,1948,10
65575155990,65575155987,-3,1502,1961,10
65575277250,65575277249,-1,880,2044,10
65576691982,65576691982,0,1073,1530,10
65577173518,65577173520,2,2448,2515,10
65578053655,65578053651,-4,1094,2092,10
65580665070,65580665068,-2,2002,2529,10
65583151727,65583151726,-1,1469,1801,10
65587748271,65587748270,-1,1076,1440,10
65588951179,65588951179,0,695,818,10
65594198179,65594198179,0,863,1478,10
65597406874,65597406873,-1,964,2601,10
65597732944,65597732942,-2,1370,1715,10
65602445975,65602445975,0,711,2335,10
65603640169,65603640162,-7,2765,6542,10
65606055578,65606055577,-1,2066,2392,10
65606473890,65606473891,1,1137,1356,10
65606713337,65606713355,18,149,673,10
65608943465,65608943466,1,1500,2211,10
65612823099,65612823097,-2,997,2210,10
65617238485,65617238491,6,1684,1244,10
65618735181,65618735180,-1,1226,3619,10
65620790858,65620790857,-1,689,1136,10
65626277428,65626277426,-2,1088,1822,10
65631079229,65631079225,-4,1319,1696,10
65636611033,65636611031,-2,1193,2143,10
65639880607,65639880606,-1,1148,2204,10
65643131383,65643131381,-2,1070,2569,10
65644522218,65644522217,-1,939,1233,10
65646964635,65646964631,-4,1326,2493,10
65647753767,65647753766,-1,989,2065,10
65647877672,65647877695,23,887,1645,10
65648297785,65648297782,-3,1209,1939,10
65648909310,65648909307,-3,1120,1687,10
65650610318,65650610314,-4,963,1728,10
65651032609,65651032613,4,2265,1456,10
65654481558,65654481555,-3,1432,2286,10
65658851398,65658851397,-1,825,1963,10
65662681432,65662681431,-1,1153,2347,10
65664257010,65664257006,-4,1369,1867,10
65665581551,65665581550,-1,989,1584,10
65667760598,65667760597,-1,1280,1730,10
65668757924,65668757922,-2,1447,1725,10
65674440824,65674440823,-1,1024,1708,10
65677248123,65677248121,-2,761,2310,10
65680959905,65680959904,-1,1040,1769,10
65689043459,65689043459,0,1488,2883,10
65690153315,65690153313,-2,1127,1972,10
65694583143,65694583142,-1,1064,2052,10
65694760861,65694760859,-2,1055,2285,10
65695891088,65695891089,1,1297,1935,10
65696643573,65696643570,-3,1138,1946,10
65702876417,65702876415,-2,971,1197,10
65703794814,65703794812,-2,611,1006,10
65704237452,65704237454,2,1989,1054,10
65713135051,65713135050,-1,1032,2256,10
65713226752,65713226742,-10,1487,2396,10
65713302238,65713302238,0,1116,2515,10
65713749078,65713749078,0,1272,2555,10
65716446674,65716446674,0,991,1992,10
65716872526,65716872522,-4,1682,2581,10
65717324609,65717324607,-2,982,1530,10
65720350946,65720350945,-1,1457,2733,10
65720692134,65720692132,-2,707,1507,10
65721539541,65721539542,1,1285,2422,10
65722699141,65722699139,-2,1348,2296,10
65724260882,65724260881,-1,1321,1733,10
65725347927,65725347926,-1,1396,1794,10
65728794586,65728794581,-5,1089,3403,10
65733159088,65733159086,-2,1240,2832,10
65745119510,65745119510,0,1305,1769,10
65746118323,65746118318,-5,1199,3369,10
65750932023,65750932023,0,1021,1639,10
65752228680,65752228681,1,1930,2616,10
65754464381,65754464379,-2,1252,1961,10
65754575716,65754575725,9,61,867,10
65757759954,65757759952,-2,1806,2673,10
65767941135,65767941135,0,1206,1734,10
65769704136,65769704134,-2,789,2171,10
65770272973,65770272970,-3,1245,1866,10
65776705993,65776705990,-3,1527,1905,10
65776818000,65776817991,-9,822,1641,10
65776874088,65776874075,-13,293,1314,10
65779480975,65779480975,0,1297,2607,10
65780002946,65780002941,-5,712,1514,10
65787746351,65787746350,-1,1005,1881,10
65796817925,65796817922,-3,1772,5888,10
65799185689,65799185686,-3,1235,1866,10
65801768822,65801768822,0,1289,1700,10
65803882639,65803882636,-3,1069,1700,10
65806216703,65806216701,-2,1098,1969,10
65807075602,65807075602,0,1242,1818,10
65808868650,65808868646,-4,1311,3510,10
65811835659,65811835658,-1,1032,1175,10
65811873009,65811873010,1,1167,2752,10
65813219624,65813219622,-2,1962,2258,10
65819967527,65819967526,-1,846,1714,10
65820931973,65820931974,1,2231,2408,10
65825528174,65825528170,-4,1586,2298,10
65828273887,65828273885,-2,1694,2524,10
65829196844,65829196851,7,3168,1098,10
65833999592,65833999589,-3,1641,2562,10
65835337529,65835337528,-1,1637,1811,10
65837429194,65837429178,-16,1066,1531,10
65838704126,65838704126,0,846,219,10
65841645638,65841645637,-1,1625,2439,10
65842142366,65842142362,-4,1034,2429,10
65842776656,65842776655,-1,1524,3611,10
65847780829,65847780828,-1,1196,1917,10
65850513022,65850513029,7,8186,1767,10
65853602922,65853602921,-1,1185,1508,10
65856752683,65856752685,2,1050,1656,10
65861968553,65861968550,-3,1229,2403,10
65862203642,65862203642,0,872,1649,10
65863129973,65863129971,-2,1699,2737,10
65867748560,65867748556,-4,1347,1608,10
65869933706,65869933704,-2,1110,2354,10
65871236304,65871236301,-3,750,1664,10
65873447603,65873447601,-2,1534,2721,10
65877346815,65877346810,-5,1347,2250,10
65880864718,65880864718,0,1365,2001,10
65882234721,65882234721,0,1397,1891,10
65883278234,65883278232,-2,1477,2191,10
65883686486,65883686487,1,942,1392,10
65885388188,65885388186,-2,1378,2342,10
65888654921,65888654918,-3,1184,2028,10
65889083650,65889083648,-2,1495,2066,10
65890488021,65890488019,-2,1400,2185,10
65891661194,65891661193,-1,940,1768,10
65894067584,65894067582,-2,2138,2456,10
65897627597,65897627596,-1,1176,1717,10
65902734928,65902734923,-5,1270,1643,10
65902980002,65902980021,19,643,1885,10
65909216599,65909216599,0,1178,1465,10
65909742942,65909742942,0,1062,1409,10
65912010829,65912010826,-3,1320,1965,10
65912599145,65912599144,-1,1088,1825,10
65923707311,65923707308,-3,1625,1821,10
65925827117,65925827117,0,892,1527,10
65929767114,65929767117,3,4697,3405,10
65931491043,65931491042,-1,1316,1740,10
65933003351,65933003350,-1,984,1639,10
65933325693,65933325694,1,1707,2007,10
65934546802,65934546801,-1,1375,2217,10
65936760192,65936760189,-3,1131,2239,10
65942758066,65942758064,-2,1075,2192,10
65942996819,65942996813,-6,618,1186,10
65944007626,65944007625,-1,796,1107,10
65949690018,65949690015,-3,1053,2237,10
65954388453,65954388450,-3,1195,2322,10
65956294459,65956294453,-6,35188,18441,10
65956594040,65956594037,-3,1296,2020,10
65958392208,65958392205,-3,1460,1682,10
65958530378,65958530372,-6,1065,1873,10
65960245686,65960245685,-1,1294,1986,10
65960323004,65960323002,-2,1326,1585,10
65961696562,65961696563,1,1307,1893,10
65962873830,65962873827,-3,1336,1947,10
65963327737,65963327736,-1,1418,1972,10
65972003709,65972003707,-2,1935,2314,10
65972219130,65972219129,-1,1557,2090,10
65972336855,65972336853,-2,842,2093,10
65973378235,65973378254,19,440,974,10
65973442991,65973442990,-1,1074,1813,10
65976815685,65976815683,-2,945,2318,10
65977624497,65977624497,0,1109,1576,10
65979584686,65979584685,-1,980,1815,10
66001659354,66001659354,0,961,1973,10
66002154425,66002154424,-1,1339,2298,10
66003462367,66003462371,4,1477,1292,10
66008299653,66008299651,-2,1158,1620,10
66009539485,66009539485,0,1596,1712,10
66010002553,66010002553,0,1310,1502,10
66011125139,66011125137,-2,1697,2527,10
66015007335,66015007334,-1,1728,2034,10
66018426726,66018426726,0,1083,1412,10
66019394089,66019394089,0,978,1345,10
66019963522,66019963521,-1,1173,1324,10
66025584829,66025584829,0,1276,1717,10
66026295925,66026295921,-4,1141,1803,10
66028168404,66028168401,-3,1550,2708,10
66029445709,66029445711,2,1980,2144,10
66031041970,66031041975,5,3079,1759,10
66035026251,66035026251,0,2113,3305,10
66035816659,66035816659,0,1420,2516,10
66038493454,66038493455,1,1015,1750,10
66045141834,66045141831,-3,1352,1733,10
66053221586,66053221587,1,1072,1200,10
66053325721,66053325721,0,1102,1426,10
66053795710,66053795709,-1,1588,2143,10
66056109729,66056109726,-3,1433,1922,10
66057375189,66057375186,-3,1195,2108,10
66059287650,66059287642,-8,1362,5200,10
66059436112,66059436110,-2,1450,1739,10
66059549202,66059549201,-1,1260,1907,10
66059651459,66059651458,-1,1637,2461,10
66061326606,66061326605,-1,1088,1615,10
66061782670,66061782667,-3,1314,2511,10
66062663578,66062663578,0,1867,3943,10
66063766763,66063766762,-1,1082,1691,10
66069122717,66069122717,0,1775,2772,10
66070896439,66070896438,-1,1379,1579,10
66071424021,66071424021,0,1306,2239,10
66075871328,66075871326,-2,944,2186,10
66077110115,66077110114,-1,1456,1589,10
66078784889,66078784889,0,1531,2244,10
66080340395,66080340395,0,723,1481,10
66081664477,66081664475,-2,1541,1749,10
66083235911,66083235911,0,950,1604,10
66087720898,66087720895,-3,1116,2406,10
66090014202,66090014200,-2,985,1516,10
66093621371,66093621368,-3,1299,2901,10
66094032946,66094032944,-2,1619,2290,10
66096658637,66096658637,0,1176,2159,10
66097315013,66097315010,-3,1645,2375,10
66097460809,66097460830,21,1154,1779,10
66099092290,66099092292,2,1435,1053,10
66100575924,66100575924,0,1501,2046,10
66101343154,66101343154,0,993,1631,10
66104421754,66104421751,-3,1068,2030,10
66105833414,66105833415,1,1332,2003,10
66108660782,66108660778,-4,913,1648,10
66111065714,66111065711,-3,1375,1678,10
66111554612,66111554610,-2,1442,1760,10
66115805634,66115805639,5,1212,1234,10
66122211706,66122211705,-1,1724,2184,10
66122296681,66122296681,0,1248,2380,10
66122404365,66122404366,1,1455,1639,10
66122932497,66122932494,-3,1677,2905,10
66127066366,66127066367,1,1084,1804,10
66129966876,66129966876,0,1207,1722,10
66134513727,66134513728,1,954,1453,10
66138745823,66138745822,-1,1347,2654,10
66143619310,66143619310,0,1779,2567,10
66145288722,66145288723,1,1945,1543,10
66147436338,66147436335,-3,1158,1964,10
66150991792,66150991793,1,10645,11538,10
66151931177,66151931161,-16,1509,1570,10
66153840480,66153840478,-2,1319,2132,10
66155850250,66155850243,-7,2154,10631,10
66159561922,66159561921,-1,1401,2651,10
66163207842,66163207841,-1,1446,2357,10
66163552102,66163552105,3,1725,1932,10
66167406562,66167406566,4,1012,1396,10
66176838678,66176838677,-1,577,1169,10
66181712460,66181712458,-2,757,1439,10
66183372804,66183372802,-2,1516,1694,10
66183663251,66183663250,-1,1109,2126,10
66185277590,66185277591,1,1198,1825,10
66186344942,66186344940,-2,1465,2011,10
66187646459,66187646457,-2,1199,2574,10
66188655739,66188655738,-1,1121,1868,10
66191149320,66191149318,-2,1553,2500,10
66191184513,66191184511,-2,2463,3918,10
66193067959,66193067957,-2,1478,2143,10
66194041490,66194041489,-1,1280,2205,10
66194959175,66194959173,-2,745,1666,10
66196232977,66196232975,-2,1144,2207,10
66198398279,66198398279,0,1161,2300,10
66200729498,66200729498,0,1158,2803,10
66201169435,66201169436,1,989,1475,10
66203077474,66203077473,-1,1385,1961,10
66205846113,66205846114,1,1551,1096,10
66206508393,66206508399,6,2053,1428,10
66207304930,66207304929,-1,1228,2112,10
66207657937,66207657935,-2,1184,2163,10
66208203494,66208203494,0,1401,3082,10
66212499686,66212499684,-2,857,902,10
66217057678,66217057678,0,1187,2328,10
66220463239,66220463238,-1,1461,2115,10
66221678342,66221678339,-3,1250,1221,10
66221966134,66221966134,0,1054,1679,10
66222962395,66222962395,0,1322,1901,10
66223019875,66223019871,-4,880,1248,10
66223493008,66223493004,-4,1454,2172,10
66228092774,66228092770,-4,926,1641,10
66229579195,66229579194,-1,1194,2066,10
66236074899,66236074898,-1,990,1331,10
66236760916,66236760913,-3,1278,1995,10
66238067878,66238067878,0,1235,1269,10
66249216095,66249216095,0,917,1275,10
66250663326,66250663324,-2,1241,1996,10
66257578458,66257578457,-1,1111,1681,10
66257817332,66257817349,17,960,2106,10
66258334170,66258334169,-1,905,2188,10
66262438441,66262438442,1,1313,1805,10
66267098227,66267098227,0,1173,1901,10
66271436411,66271436411,0,852,1890,10
66272108547,66272108545,-2,1227,2051,10
66273291214,66273291214,0,1235,1927,10
66282447471,66282447471,0,1486,2037,10
66282758572,66282758570,-2,1177,2435,10
66284686643,66284686639,-4,1422,2074,10
66286431971,66286431969,-2,1034,1531,10
66289554586,66289554581,-5,1113,3840,10
66290567567,66290567567,0,1533,1908,10
66291710263,66291710264,1,1684,1775,10
66295971372,66295971371,-1,1670,1929,10
66298117510,66298117510,0,1448,1470,10
66299703099,66299703099,0,1427,1153,10
66299994539,66299994538,-1,968,1489,10
66300499413,66300499413,0,1456,1717,10
66301519639,66301519642,3,45324,37105,10
66302038643,66302038643,0,1152,1256,10
66303184480,66303184477,-3,1135,1720,10
66304672653,66304672653,0,2106,1813,10
66305841363,66305841360,-3,1336,2300,10
66313417191,66313417190,-1,1486,2237,10
66313674507,66313674505,-2,1144,1363,10
66321563823,66321563827,4,2702,1798,10
66327865857,66327865857,0,1516,1547,10
66332792083,66332792082,-1,1602,1514,10
66336245349,66336245347,-2,1314,1798,10
66351328793,66351328794,1,889,1663,10
66352652073,66352652074,1,1386,1876,10
66358737698,66358737698,0,618,1624,10
66360760170,66360760171,1,1232,2123,10
66362228918,66362228924,6,5266,2447,10
66364595456,66364595453,-3,1843,3728,10
66366246351,66366246350,-1,1376,1666,10
66367640605,66367640605,0,1074,2301,10
66367807467,66367807470,3,1594,1954,10
66368959559,66368959558,-1,1784,3431,10
66370572998,66370572999,1,936,1828,10
66376290426,66376290418,-8,883,2541,10
66377942291,66377942291,0,1490,1508,10
66378079311,66378079311,0,1655,2709,10
66378546938,66378546932,-6,2173,6168,10
66379695745,66379695751,6,274,1118,10
66382307569,66382307566,-3,1394,1642,10
66384134938,66384134943,5,3615,2323,10
66385333774,66385333776,2,1334,1404,10
66385508163,66385508161,-2,1208,2105,10
66388634954,66388634954,0,1349,2369,10
66392348782,66392348780,-2,1395,1607,10
66394651105,66394651105,0,1203,1769,10
66395910526,66395910525,-1,984,2153,10
66397713178,66397713173,-5,1218,3768,10
66397759337,66397759335,-2,1239,1287,10
66400685769,66400685768,-1,1288,2242,10
66401365647,66401365645,-2,1339,1811,10
66403947633,66403947634,1,1189,1379,10
66405243314,66405243313,-1,1179,1272,10
66405574057,66405574076,19,1423,2015,10
66407757279,66407757275,-4,672,1471,10
66408838139,66408838138,-1,1601,2570,10
66413508863,66413508861,-2,1191,2015,10
66420338795,66420338795,0,715,2106,10
66421008328,66421008326,-2,1510,1854,10
66423380196,66423380200,4,5062,2198,10
66426527018,66426527015,-3,916,1950,10
66430339142,66430339141,-1,1046,2010,10
66432845555,66432845552,-3,1798,2251,10
66433878403,66433878402,-1,1353,2192,10
66434910704,66434910703,-1,1284,1720,10
66438533812,66438533814,2,1570,1870,10
66439714486,66439714485,-1,1409,2040,10
66443901434,66443901434,0,974,1940,10
66448685890,66448685886,-4,1089,1858,10
66450282216,66450282214,-2,1380,1486,10
66450478590,66450478586,-4,991,1481,10
66452687714,66452687713,-1,1762,2423,10
66453045831,66453045830,-1,2057,2902,10
66457133300,66457133298,-2,1188,1838,10
66459682991,66459682989,-2,2101,2672,10
66460167269,66460167267,-2,1301,1696,10
66460862808,66460862789,-19,912,1629,10
66464056897,66464056897,0,1424,2580,10
66472197629,66472197629,0,1375,1671,10
66474380346,66474380344,-2,1108,2362,10
66474934822,66474934825,3,2269,1527,10
66479138401,66479138401,0,1593,2304,10
66480260202,66480260200,-2,1697,3274,10
66485167719,66485167718,-1,1131,1758,10
66492670181,66492670178,-3,1311,2499,10
66497066411,66497066409,-2,1232,1968,10
66499487425,66499487425,0,1667,2191,10
66502883565,66502883561,-4,1048,1287,10
66505424791,66505424792,1,1036,1965,10
66506980873,66506980871,-2,1008,2096,10
66514701358,66514701357,-1,824,1402,10
66515909129,66515909136,7,1111,1944,10
66518803715,66518803714,-1,827,1732,10
66522688086,66522688083,-3,1625,2396,10
66523789087,66523789086,-1,1580,2397,10
66534463901,66534463896,-5,1377,4715,10
66540719702,66540719701,-1,1903,2153,10
66546362929,66546362930,1,1328,2401,10
66547974769,66547974768,-1,811,1770,10
66548482856,66548482854,-2,1046,1546,10
66555937362,66555937362,0,2015,2844,10
66560622466,66560622467,1,1164,1720,10
66561787670,66561787671,1,1104,1984,10
66562090378,66562090377,-1,1567,1916,10
66562849090,66562849089,-1,1127,1850,10
66563388349,66563388350,1,1635,1712,10
66565042862,66565042862,0,1149,2428,10
66565694262,66565694260,-2,788,1603,10
66570222295,66570222294,-1,1216,2253,10
66573322782,66573322781,-1,1144,1848,10
66576242690,66576242709,19,1112,1688,10
66578111261,66578111259,-2,1525,2242,10
66580616718,66580616715,-3,980,1566,10
66583431229,66583431244,15,743,1287,10
66585426023,66585426033,10,11825,32199,10
66586409172,66586409169,-3,1081,2885,10
66587094752,66587094750,-2,1293,1983,10
66589078319,66589078315,-4,671,1766,10
66590063197,66590063196,-1,1735,2696,10
66590091245,66590091245,0,1767,2979,10
66591415667,66591415659,-8,886,4150,10
66591445936,66591445935,-1,1833,2076,10
66591806842,66591806841,-1,1362,2147,10
66592849959,66592849957,-2,1007,2348,10
66595047403,66595047401,-2,1050,1946,10
66597427195,66597427195,0,965,993,10
66598806965,66598806966,1,1205,1373,10
66601044555,66601044554,-1,1075,1630,10
66604169806,66604169803,-3,1863,2696,10
66604310258,66604310254,-4,1517,2960,10
66606064703,66606064700,-3,1083,2039,10
66607156689,66607156688,-1,1315,2041,10
66614537494,66614537493,-1,636,1359,10
66616520435,66616520435,0,836,1406,10
66616587177,66616587177,0,1560,1492,10
66618300121,66618300122,1,1734,1711,10
66620558793,66620558790,-3,1191,2327,10
66620985710,66620985708,-2,834,1436,10
66621587610,66621587610,0,1393,1664,10
66623879583,66623879582,-1,1679,3690,10
66624310536,66624310532,-4,995,2164,10
66632694366,66632694364,-2,1134,1801,10
66638626683,66638626681,-2,957,1975,10
66640006718,66640006719,1,1255,2020,10
66643583374,66643583374,0,1829,1404,10
66643799882,66643799880,-2,1355,1701,10
66645809925,66645809922,-3,1287,2322,10
66646774394,66646774394,0,1274,1085,10
66648879509,66648879509,0,994,1129,10
66649199422,66649199402,-20,2080,1230,10
66650256404,66650256389,-15,1176,1774,10
66651380499,66651380499,0,1719,2645,10
66656601502,66656601500,-2,1234,1919,10
66660658883,66660658883,0,1375,1849,10
66661130812,66661130810,-2,1256,2902,10
66661614671,66661614662,-9,1356,5705,10
66662765087,66662765086,-1,1391,2216,10
66663302342,66663302340,-2,1159,1676,10
66663443062,66663443062,0,1461,1635,10
66664823197,66664823203,6,5701,2028,10
66667172999,66667172998,-1,1203,2088,10
66667790358,66667790372,14,44824,11937,10
66668330079,66668330078,-1,1523,1792,10
66668827693,66668827693,0,1314,2725,10
66671308782,66671308783,1,1900,2157,10
66672229322,66672229321,-1,1104,2688,10
66676479430,66676479428,-2,1510,2336,10
66677890310,66677890310,0,1219,1842,10
66680508585,66680508578,-7,2154,7942,10
66683032668,66683032667,-1,1093,1988,10
66687227327,66687227324,-3,1241,2088,10
66689141038,66689141034,-4,879,2225,10
66690594046,66690594051,5,3374,1228,10
66692928283,66692928281,-2,925,1767,10
66696752401,66696752403,2,1341,1050,10
66698925006,66698925004,-2,1319,1629,10
66699014753,66699014752,-1,1059,1646,10
66701123839,66701123838,-1,1878,2036,10
66701375559,66701375558,-1,1075,1962,10
66703701074,66703701075,1,1186,2019,10
66704854801,66704854794,-7,2984,11810,10
66705201331,66705201330,-1,1434,1715,10
66706048618,66706048617,-1,1374,2359,10
66707841993,66707841990,-3,802,1636,10
66712399486,66712399484,-2,1129,1741,10
66721595991,66721595989,-2,1320,2304,10
66725528966,66725528968,2,787,1885,10
66728796795,66728796794,-1,1073,1954,10
66730435749,66730435747,-2,1105,1721,10
66731109631,66731109630,-1,1431,1748,10
66731962658,66731962657,-1,1053,2483,10
66732514152,66732514142,-10,1019,2318,10
66743056773,66743056771,-2,1728,2266,10
66743157618,66743157617,-1,1346,2351,10
66745607933,66745607933,0,1614,2595,10
66745908393,66745908393,0,1527,1692,10
66750825549,66750825551,2,1312,1475,10
66758156988,66758157007,19,559,1382,10
66761280802,66761280801,-1,981,1540,10
66764452558,66764452558,0,1113,1738,10
66767854337,66767854337,0,1341,2212,10
66774364397,66774364393,-4,1014,3036,10
66776058311,66776058304,-7,1153,5993,10
66777396554,66777396557,3,1860,1435,10
66778128801,66778128799,-2,1023,2106,10
66781538271,66781538271,0,1072,2125,10
66781978455,66781978454,-1,1602,2120,10
66782621427,66782621427,0,1320,2050,10
66783445750,66783445750,0,1678,2373,10
66790154092,66790154089,-3,1421,2172,10
66791780832,66791780831,-1,1033,2028,10
66792645605,66792645602,-3,1091,2205,10
66802828773,66802828771,-2,1019,1505,10
66804961974,66804961977,3,1749,1456,10
66805770642,66805770640,-2,952,2017,10
66807654343,66807654341,-2,1424,2086,10
66808791015,66808791013,-2,816,1393,10
66814418134,66814418133,-1,1201,1547,10
66817308641,66817308641,0,1458,1570,10
66819338422,66819338421,-1,1300,1766,10
66819550121,66819550140,19,551,803,10
66819827079,66819827078,-1,1196,2414,10
66820269117,66820269133,16,1342,1264,10
66820708975,66820708973,-2,1295,1970,10
66826380762,66826380761,-1,1135,2177,10
66829997613,66829997610,-3,1233,1852,10
66830109571,66830109557,-14,1260,2598,10
66835720527,66835720527,0,827,1122,10
66840474961,66840474959,-2,1220,1375,10
66842169129,66842169127,-2,1206,1714,10
66843284119,66843284115,-4,1793,5206,10
66846891069,66846891078,9,786,1479,10
66847882131,66847882129,-2,1280,1569,10
66849653908,66849653914,6,7903,3708,10
66850163534,66850163533,-1,1057,1997,10
66857254337,66857254337,0,1068,1550,10
66862985271,66862985271,0,1496,2938,10
66863560631,66863560629,-2,1172,1166,10
66876949872,66876949870,-2,1155,2914,10
66882597987,66882597986,-1,1493,2710,10
66882668764,66882668778,14,876,1351,10
66887203069,66887203067,-2,1399,1922,10
66890677095,66890677094,-1,1321,2758,10
66893202089,66893202085,-4,1301,1648,10
66897273671,66897273670,-1,758,2438,10
66898489906,66898489906,0,1659,1688,10
66899308124,66899308120,-4,977,3499,10
66899468754,66899468767,13,801,2490,10
66900057655,66900057653,-2,1333,1900,10
66902810946,66902810944,-2,1272,2125,10
66912143018,66912143016,-2,917,1542,10
66917192919,66917192918,-1,1138,1862,10
66923319034,66923319034,0,1089,1445,10
66923805411,66923805406,-5,1158,2009,10
66924448331,66924448325,-6,19379,14820,10
66929340733,66929340733,0,1100,1794,10
66934799152,66934799152,0,1520,2367,10
66943326903,66943326901,-2,1625,1730,10
66946649557,66946649539,-18,1599,1089,10
66949700541,66949700540,-1,2231,2661,10
66951688977,66951688977,0,1167,2918,10
66953631239,66953631241,2,704,896,10
66961107328,66961107327,-1,1115,2074,10
66965980121,66965980121,0,794,1945,10
66969135402,66969135402,0,1467,1770,10
66984354170,66984354167,-3,987,1744,10
66985518493,66985518493,0,905,1852,10
66987810603,66987810603,0,1237,1284,10
66987951799,66987951800,1,2612,2388,10
66987994288,66987994289,1,2377,2292,10
66990496126,66990496126,0,1538,2489,10
66992590480,66992590473,-7,1434,7004,10
67000899697,67000899694,-3,790,2125,10
67001741208,67001741199,-9,697,1472,10
67003960631,67003960635,4,2922,2478,10
67011943547,67011943546,-1,1337,1571,10
67016475195,67016475193,-2,890,1680,10
67018094526,67018094522,-4,1384,3547,10
67022278235,67022278235,0,778,1698,10
67023378906,67023378909,3,1076,1424,10
67024521444,67024521442,-2,1553,2815,10
67027615417,67027615416,-1,1880,2627,10
67031514034,67031514021,-13,747,1839,10
67031865419,67031865409,-10,333,1333,10
67034664358,67034664357,-1,1348,2263,10
67039293583,67039293583,0,1163,1496,10
67039378470,67039378470,0,1070,1940,10
67040129047,67040129045,-2,870,1524,10
67043358768,67043358763,-5,830,1751,10
67045852860,67045852863,3,1592,1194,10
67046848179,67046848179,0,1581,1874,10
67047776767,67047776765,-2,1287,1874,10
67048440145,67048440163,18,253,1651,10
67050198119,67050198118,-1,1122,1786,10
67054251122,67054251121,-1,1369,2432,10
67055148872,67055148870,-2,1396,1124,10
67055365564,67055365562,-2,1026,1679,10
67056391584,67056391581,-3,824,2923,10
67058122786,67058122786,0,918,1800,10
67058300082,67058300080,-2,1672,2879,10
67060552429,67060552430,1,1006,1715,10
67062199594,67062199593,-1,979,2031,10
67063239377,67063239373,-4,1138,2704,10
67066150328,67066150329,1,1517,1816,10
67067706099,67067706098,-1,951,1637,10
67068023161,67068023153,-8,1558,1686,10
67069142451,67069142447,-4,1208,1228,10
67069328870,67069328868,-2,1363,2154,10
67073319766,67073319763,-3,1087,1930,10
67075778874,67075778874,0,1600,2718,10
67076730818,67076730815,-3,1436,1191,10
67077397431,67077397428,-3,1172,2244,10
67080004709,67080004709,0,915,1237,10
67081158569,67081158569,0,1192,1623,10
67085732210,67085732210,0,1011,1409,10
67087416329,67087416326,-3,990,2018,10
67092419335,67092419333,-2,808,1481,10
67096684568,67096684562,-6,990,2059,10
67100510405,67100510403,-2,1666,2542,10
67101820725,67101820728,3,2761,1533,10
67101894785,67101894782,-3,1211,1744,10
67107003450,67107003450,0,982,1010,10
67108935483,67108935482,-1,1346,1868,10
67112046325,67112046338,13,781,1605,10
67112603611,67112603610,-1,1333,1516,10
67117643563,67117643564,1,1321,1774,10
67119039787,67119039787,0,1179,1637,10
67120382870,67120382869,-1,871,1522,10
67120839114,67120839114,0,1824,3052,10
67121445057,67121445076,19,750,846,10
67124285674,67124285673,-1,988,1775,10
67127028185,67127028182,-3,894,1576,10
67128065462,67128065461,-1,1575,2192,10
67128434598,67128434598,0,1216,2689,10
67129346866,67129346865,-1,1862,2075,10
67129931768,67129931765,-3,755,1571,10
67136525538,67136525537,-1,1324,2082,10
67136990878,67136990874,-4,957,1689,10
67140604486,67140604485,-1,1118,1968,10
67142939721,67142939719,-2,1139,1235,10
67143888699,67143888698,-1,1442,2835,10
67144317217,67144317216,-1,1183,1472,10
67148294384,67148294381,-3,826,1105,10
67155360885,67155360883,-2,1082,2747,10
67155894928,67155894926,-2,1035,2336,10
67159508023,67159508021,-2,1179,1812,10
67164724918,67164724918,0,1494,1820,10
67165352953,67165352959,6,4044,1337,10
67167080444,67167080438,-6,995,3754,10
67173987607,67173987607,0,1592,1601,10
67174582223,67174582221,-2,1529,3377,10
67175123145,67175123147,2,1220,2120,10
67176617087,67176617088,1,1218,1465,10
67180759935,67180759934,-1,1486,2553,10
67187888693,67187888690,-3,1188,1841,10
67188538446,67188538451,5,1545,1336,10
67188802491,67188802487,-4,1339,2315,10
67189008195,67189008193,-2,1326,2947,10
67194835527,67194835524,-3,906,1322,10
67198741622,67198741629,7,2410,1494,10
67203321390,67203321389,-1,1243,2538,10
67209102533,67209102533,0,1005,1509,10
67216302448,67216302446,-2,1043,2886,10
67217221241,67217221240,-1,1376,2117,10
67218592407,67218592403,-4,1089,2188,10
67220460935,67220460934,-1,1146,2088,10
67228627637,67228627635,-2,1345,2545,10
67229906206,67229906199,-7,693,2415,10
67232569229,67232569228,-1,1834,2573,10
67234545769,67234545767,-2,1448,2064,10
67235028967,67235028966,-1,1897,3080,10
67238074509,67238074509,0,1483,2433,10
67248037825,67248037824,-1,883,1718,10
67249830999,67249830998,-1,904,1231,10
67249857962,67249857959,-3,710,1342,10
67250702091,67250702090,-1,740,1193,10
67252883493,67252883491,-2,975,1972,10
67254022326,67254022325,-1,1235,2174,10
67256316237,67256316236,-1,983,1932,10
67256681226,67256681221,-5,1428,2627,10
67257730275,67257730274,-1,1109,1858,10
67258260286,67258260284,-2,1261,1822,10
67258543714,67258543709,-5,1203,3230,10
67270392275,67270392273,-2,1636,1949,10
67276666253,67276666250,-3,1286,2194,10
67287460079,67287460082,3,869,966,10
67289478471,67289478470,-1,919,1538,10
67294250593,67294250591,-2,1101,1525,10
67297504249,67297504248,-1,1074,1577,10
67298208908,67298208909,1,1515,1815,10
67299366849,67299366847,-2,1415,1701,10
67304257845,67304257863,18,1504,1603,10
67307986580,67307986578,-2,1057,1665,10
67310648861,67310648867,6,1380,974,10
67313282487,67313282485,-2,706,1231,10
67314353890,67314353910,20,710,198,10
67315239978,67315239978,0,1222,2085,10
67317985461,67317985458,-3,844,2008,10
67318951706,67318951705,-1,1228,1841,10
67321728677,67321728677,0,2244,3276,10
67327056385,67327056391,6,3244,1049,10
67328326713,67328326712,-1,1142,1278,10
67328948147,67328948146,-1,769,1490,10
67331180157,67331180155,-2,877,1956,10
67331441499,67331441499,0,1430,1571,10
67335840688,67335840688,0,1364,1913,10
67340967859,67340967862,3,1730,1917,10
67342854971,67342854971,0,1055,1937,10
67343785859,67343785856,-3,1685,2181,10
67344303567,67344303567,0,1267,1636,10
67345517764,67345517763,-1,1750,1423,10
67346397082,67346397081,-1,1322,1895,10
67346704469,67346704466,-3,1343,2098,10
67347013070,67347013070,0,813,1488,10
67351356171,67351356170,-1,1123,1509,10
67354561890,67354561896,6,3125,1266,10
67354928266,67354928273,7,5714,2474,10
67363529689,67363529687,-2,1398,2362,10
67364321969,67364321970,1,1429,1731,10
67364721522,67364721518,-4,593,1389,10
67366480610,67366480607,-3,1686,3870,10
67368614049,67368614047,-2,1910,2124,10
67371060766,67371060764,-2,1558,2519,10
67374913994,67374913994,0,1060,2038,10
67380071249,67380071247,-2,1178,2379,10
67386778496,67386778494,-2,1681,1904,10
67387713352,67387713349,-3,1233,2232,10
67391795855,67391795857,2,1367,1937,10
67392216773,67392216773,0,1189,1312,10
67392787621,67392787620,-1,1341,2169,10
67395172226,67395172223,-3,758,1177,10
67395354169,67395354163,-6,1133,1897,10
67401693585,67401693583,-2,1684,2982,10
67402594455,67402594452,-3,946,2382,10
67410360284,67410360285,1,1022,1047,10
67412307099,67412307097,-2,1786,2906,10
67416791550,67416791554,4,1579,735,10
67420052905,67420052903,-2,1100,1742,10
67421342162,67421342144,-18,1180,2080,10
67421533466,67421533485,19,767,1377,10
67424752482,67424752481,-1,1468,2090,10
67425974115,67425974114,-1,1316,1961,10
67426403408,67426403404,-4,848,2249,10
67429097675,67429097675,0,1382,1679,10
67433142435,67433142433,-2,1578,3254,10
67434162955,67434162954,-1,1828,2819,10
67435030229,67435030229,0,1349,2078,10
67437428133,67437428131,-2,1212,2038,10
67437609019,67437609021,2,281,858,10
67440504583,67440504582,-1,1033,1394,10
67440745987,67440745985,-2,998,2225,10
67442944468,67442944465,-3,1567,2376,10
67446896211,67446896209,-2,1062,1822,10
67447609875,67447609875,0,1252,2144,10
67450125917,67450125914,-3,922,2065,10
67452814993,67452814992,-1,1516,2611,10
67454336441,67454336437,-4,1935,2844,10
67458002579,67458002565,-14,1603,13483,10
67459210114,67459210111,-3,1310,2244,10
67468761566,67468761562,-4,1151,2791,10
67469800095,67469800090,-5,1423,3796,10
67474516766,67474516772,6,1186,2052,10
67476643774,67476643772,-2,1564,2559,10
67478814429,67478814427,-2,1079,2302,10
67479923983,67479923982,-1,898,2154,10
67482635161,67482635160,-1,1279,2142,10
67486931317,67486931317,0,1487,2219,10
67488993195,67488993195,0,1494,2475,10
67492142894,67492142890,-4,1085,2101,10
67493307391,67493307388,-3,1343,1825,10
67493742089,67493742087,-2,1281,1789,10
67495071765,67495071763,-2,1566,2160,10
67496632198,67496632198,0,1600,2182,10
67502041573,67502041573,0,1224,1991,10
67505262086,67505262085,-1,730,1891,10
67516354207,67516354206,-1,1269,1581,10
67521411455,67521411454,-1,905,1809,10
67524840598,67524840597,-1,987,1764,10
67525919403,67525919402,-1,984,1885,10
67526406801,67526406805,4,1200,899,10
67527963213,67527963212,-1,1418,1945,10
67530385502,67530385501,-1,737,1639,10
67533742294,67533742293,-1,907,1909,10
67543131042,67543131041,-1,945,1998,10
67543195098,67543195077,-21,916,1313,10
67545357663,67545357662,-1,1791,3048,10
67548142450,67548142447,-3,1291,1678,10
67550566208,67550566206,-2,852,1272,10
67551977945,67551977944,-1,1526,2142,10
67553622934,67553622934,0,1628,1927,10
67553930322,67553930316,-6,1246,4156,10
67554486303,67554486302,-1,1470,2369,10
67555773807,67555773806,-1,842,1516,10
67560437310,67560437308,-2,1260,2204,10
67563924622,67563924618,-4,1220,1509,10
67565510576,67565510573,-3,4313,11205,10
67567207913,67567207907,-6,887,2573,10
67574180675,67574180676,1,3024,3406,10
67574991837,67574991836,-1,794,1147,10
67579883300,67579883301,1,1499,1626,10
67586296450,67586296448,-2,1173,1341,10
67587185617,67587185614,-3,1486,2047,10
67587417098,67587417080,-18,771,1852,10
67590363857,67590363856,-1,2054,2494,10
67594193522,67594193521,-1,1009,2245,10
67594468153,67594468133,-20,1176,2548,10
67594612786,67594612790,4,1135,976,10
67597107421,67597107420,-1,1537,2059,10
67598425547,67598425544,-3,1469,2843,10
67612193627,67612193623,-4,2133,4195,10
67615442366,67615442365,-1,1046,1790,10
67619240058,67619240057,-1,977,1757,10
67620105154,67620105154,0,1237,2002,10
67620779447,67620779436,-11,1465,258,10
67624051460,67624051459,-1,1772,2686,10
67629329252,67629329250,-2,1370,1742,10
67629554382,67629554383,1,1050,1971,10
67634794200,67634794198,-2,1069,2281,10
67637261691,67637261691,0,1670,2261,10
67637627713,67637627735,22,682,1369,10
67640708447,67640708446,-1,1138,1308,10
67643371176,67643371174,-2,994,1778,10
67643864979,67643864975,-4,439,576,10
67644314432,67644314427,-5,1573,4663,10
67649092438,67649092436,-2,1358,2491,10
67652270142,67652270142,0,1135,1839,10
67653381703,67653381702,-1,1039,1265,10
67658128256,67658128258,2,1169,1644,10
67660731357,67660731355,-2,1668,2490,10
67661412776,67661412774,-2,1054,2688,10
67662272354,67662272351,-3,1398,2127,10
67662896385,67662896380,-5,939,4080,10
67665760023,67665760016,-7,1084,2149,10
67667816430,67667816428,-2,1122,2261,10
67668909314,67668909334,20,1252,2686,10
67671846062,67671846060,-2,1542,1763,10
67672376100,67672376118,18,748,1335,10
67681460394,67681460393,-1,1764,1411,10
67684698947,67684698946,-1,1136,2518,10
67685545018,67685545034,16,848,1385,10
67686642127,67686642126,-1,1047,1976,10
67695361232,67695361229,-3,650,1579,10
67696457111,67696457110,-1,2038,2593,10
67698590219,67698590219,0,1066,1428,10
67699688555,67699688537,-18,1368,2831,10
67702906782,67702906782,0,566,1224,10
67703165417,67703165414,-3,1085,2026,10
67704529083,67704529085,2,973,1536,10
67705037257,67705037257,0,1049,2108,10
67706257006,67706257007,1,1515,1714,10
67706283603,67706283601,-2,1238,2176,10
67708980722,67708980720,-2,878,2231,10
67710961785,67710961793,8,15875,30689,10
67712849134,67712849135,1,1462,2114,10
67713859562,67713859560,-2,1224,1830,10
67714313610,67714313610,0,1570,2358,10
67715692329,67715692327,-2,817,1623,10
67715896420,67715896419,-1,1632,1996,10
67715951602,67715951601,-1,1038,2484,10
67725391817,67725391810,-7,877,4733,10
67731152237,67731152237,0,1183,1968,10
67731807855,67731807849,-6,1022,2454,10
67731978488,67731978487,-1,1040,2131,10
67734868725,67734868723,-2,1474,2223,10
67735766193,67735766191,-2,926,1542,10
67739397158,67739397160,2,1709,1698,10
67740431834,67740431833,-1,1505,2066,10
67741013664,67741013687,23,1006,1899,10
67742747189,67742747186,-3,1043,1915,10
67746041975,67746041974,-1,1354,1778,10
67750216865,67750216866,1,1136,1503,10
67757180850,67757180847,-3,1426,2333,10
67758331106,67758331105,-1,1263,1978,10
67759832756,67759832755,-1,1008,1148,10
67762415287,67762415287,0,1682,2379,10
67766143944,67766143943,-1,1430,2215,10
67771018596,67771018590,-6,3488,9940,10
67771197007,67771196986,-21,1466,1871,10
67771707437,67771707439,2,1761,1470,10
67772145433,67772145430,-3,906,1570,10
67775622438,67775622436,-2,1069,1883,10
67777339429,67777339446,17,614,1735,10
67778413538,67778413546,8,4854,1442,10
67780086195,67780086194,-1,919,1912,10
67780277020,67780277003,-17,876,1845,10
67785018545,67785018546,1,10411,14259,10
67786934174,67786934174,0,1561,2546,10
67788461195,67788461194,-1,1131,2032,10
67788953090,67788953089,-1,1064,2259,10
67789477100,67789477101,1,1226,1895,10
67791491174,67791491173,-1,953,1372,10
67792263050,67792263049,-1,1414,2124,10
67792883616,67792883617,1,282,3180,10
67794976615,67794976614,-1,1207,1827,10
67795337842,67795337841,-1,1339,2027,10
67799113271,67799113270,-1,1195,1794,10
67800145419,67800145416,-3,941,1886,10
67801392992,67801392991,-1,1627,1945,10
67802175442,67802175458,16,785,1809,10
67808842428,67808842425,-3,1246,2207,10
67809603290,67809603289,-1,1314,1962,10
67810118062,67810118062,0,1939,2067,10
67812157846,67812157842,-4,1528,2130,10
67814872137,67814872137,0,1184,1929,10
67815326859,67815326859,0,1234,1863,10
67817334791,67817334790,-1,1073,2201,10
67818125015,67818125012,-3,657,3370,10
67818257746,67818257750,4,1218,817,10
67821140052,67821140050,-2,1306,1586,10
67821942762,67821942762,0,522,509,10
67828096778,67828096778,0,1162,1995,10
67832461152,67832461158,6,1020,837,10
67833777830,67833777830,0,1107,1985,10
67834029354,67834029355,1,1697,1338,10
67838375943,67838375943,0,1167,2250,10
67844588108,67844588105,-3,59,459,10
67845486186,67845486185,-1,1054,1748,10
67846028219,67846028218,-1,1151,1780,10
67846117967,67846117966,-1,762,1284,10
67849677056,67849677054,-2,1223,2064,10
67850810796,67850810790,-6,1029,2040,10
67853962128,67853962125,-3,1108,1984,10
67858191082,67858191081,-1,1194,2342,10
67859019443,67859019461,18,942,2687,10
67879258086,67879258087,1,1544,1120,10
67880542415,67880542413,-2,625,1841,10
67882944461,67882944461,0,1247,1555,10
67884508922,67884508921,-1,1271,1289,10
67885487570,67885487569,-1,1065,1682,10
67888486015,67888486015,0,1199,2744,10
67894001753,67894001750,-3,1477,2157,10
67895141867,67895141862,-5,1160,2848,10
67898757435,67898757435,0,1144,1619,10
67899851251,67899851248,-3,1104,2974,10
67900043183,67900043182,-1,1063,2121,10
67902671277,67902671274,-3,1805,2294,10
67902836909,67902836909,0,1137,2344,10
67908111116,67908111121,5,6675,3208,10
67908910125,67908910122,-3,1135,1724,10
67913201845,67913201842,-3,1506,2235,10
67913962170,67913962171,1,695,1564,10
67917441320,67917441317,-3,849,1615,10
67921786608,67921786607,-1,1584,1613,10
67927468175,67927468174,-1,1160,1907,10
67927538801,67927538823,22,1782,6590,10
67928837373,67928837371,-2,1322,1799,10
67930079153,67930079151,-2,1167,1706,10
67932006698,67932006697,-1,1342,1577,10
67934044070,67934044070,0,984,1626,10
67938436158,67938436158,0,1334,1505,10
67939566902,67939566899,-3,1771,2259,10
67951548806,67951548813,7,2999,1708,10
67953023074,67953023071,-3,952,1961,10
67954700930,67954700926,-4,874,2532,10
67956791127,67956791128,1,1232,1970,10
67957690219,67957690218,-1,1104,2159,10
67961006086,67961006085,-1,1315,2020,10
67965389941,67965389940,-1,871,1824,10
67968343301,67968343306,5,2815,1297,10
67968955670,67968955667,-3,1299,2241,10
67972181431,67972181430,-1,1188,1926,10
67973012875,67973012875,0,1626,1963,10
67974634915,67974634911,-4,976,2066,10
67975207099,67975207099,0,854,1457,10
67978613112,67978613112,0,932,1646,10
67980435678,67980435679,1,1331,1091,10
67991083885,67991083886,1,39554,43289,10
67991882491,67991882490,-1,1034,1252,10
67994908611,67994908611,0,1535,2123,10
68008144185,68008144183,-2,1334,1867,10
68010307343,68010307341,-2,1302,2110,10
68010460299,68010460298,-1,1779,2387,10
68015001632,68015001631,-1,1450,1896,10
68017469797,68017469797,0,954,1789,10
68018787730,68018787730,0,1758,2217,10
68023174526,68023174526,0,1206,2997,10
68023596793,68023596800,7,4616,1494,10
68024272131,68024272133,2,1585,1829,10
68027247835,68027247846,11,31068,46304,10
68030631550,68030631549,-1,1534,2856,10
68033704984,68033704982,-2,931,988,10
68035853246,68035853245,-1,827,1687,10
68038211161,68038211159,-2,873,1690,10
68039340647,68039340643,-4,1259,1715,10
68044210946,68044210944,-2,1158,2113,10
68045130784,68045130782,-2,1223,1831,10
68050951709,68050951705,-4,1384,2390,10
68056620617,68056620615,-2,1791,2316,10
68062175742,68062175741,-1,1232,1818,10
68067867403,68067867400,-3,404,1266,10
68079382886,68079382885,-1,939,1624,10
68082651902,68082651906,4,3642,3136,10
68085488059,68085488066,7,7158,3313,10
68087625073,68087625070,-3,1454,2081,10
68088408096,68088408095,-1,1648,1665,10
68090377693,68090377693,0,1268,1857,10
68095361898,68095361895,-3,1047,2043,10
68101085585,68101085585,0,1010,1855,10
68101715270,68101715270,0,1014,1627,10
68102222782,68102222782,0,1323,1825,10
68108620317,68108620322,5,3160,1597,10
68113183026,68113183026,0,1243,1401,10
68113493273,68113493271,-2,1027,1870,10
68114149868,68114149871,3,1404,1350,10
68115287862,68115287861,-1,1235,1527,10
68125315126,68125315122,-4,1035,2041,10
68129016406,68129016406,0,1262,2088,10
68132996131,68132996133,2,1294,1388,10
68133732444,68133732442,-2,1705,2441,10
68136372113,68136372118,5,4386,2628,10
68136970249,68136970248,-1,1778,1717,10
68137779782,68137779781,-1,1176,1784,10
68139785950,68139785948,-2,2105,2409,10
68140581741,68140581741,0,1410,1824,10
68141921725,68141921725,0,1170,1871,10
68142801615,68142801614,-1,1115,1249,10
68144696942,68144696939,-3,1111,1724,10
68149859556,68149859553,-3,977,2669,10
68151748906,68151748906,0,925,1274,10
68152428862,68152428860,-2,1259,2068,10
68152990281,68152990282,1,3166,3166,10
68155594520,68155594522,2,639,1548,10
68155820194,68155820195,1,636,1585,10
68160562407,68160562405,-2,954,2114,10
68161381499,68161381489,-10,1119,2170,10
68164549047,68164549046,-1,1462,2105,10
68170793645,68170793647,2,1205,1563,10
68171330472,68171330471,-1,1476,1916,10
68172516679,68172516677,-2,1549,2444,10
68174190511,68174190512,1,1089,1884,10
68177141547,68177141527,-20,1133,1889,10
68178726093,68178726091,-2,850,1521,10
68181916950,68181916950,0,1378,1990,10
68187201144,68187201140,-4,980,2235,10
68187468147,68187468126,-21,1104,2297,10
68188248486,68188248486,0,1043,1696,10
68192576902,68192576903,1,1539,2273,10
68193772300,68193772298,-2,1358,1965,10
68194020051,68194020070,19,718,1473,10
68199935587,68199935586,-1,1370,1841,10
68203997234,68203997234,0,1018,1614,10
68204923381,68204923380,-1,1055,1393,10
68207393771,68207393771,0,1143,1773,10
68209197054,68209197053,-1,1371,1926,10
68209464179,68209464181,2,1126,1383,10
68209918002,68209918000,-2,1495,2143,10
68212396053,68212396050,-3,1256,2390,10
68213497766,68213497766,0,1526,1859,10
68215225298,68215225299,1,1514,1475,10
68217673554,68217673554,0,2138,2305,10
68223965566,68223965566,0,1283,1972,10
68225022094,68225022093,-1,897,1739,10
68243028742,68243028742,0,1544,2832,10
68251005605,68251005606,1,1345,1982,10
68251220311,68251220309,-2,1233,2304,10
68253460538,68253460537,-1,1026,1269,10
68258945463,68258945461,-2,1016,2014,10
68258978957,68258978957,0,1577,1904,10
68262926770,68262926769,-1,1810,2455,10
68263818782,68263818779,-3,960,1873,10
68264942164,68264942161,-3,1573,2262,10
68265254490,68265254491,1,1568,1122,10
68266352017,68266352016,-1,1153,1744,10
68270298710,68270298694,-16,668,3125,10
68275207754,68275207752,-2,1134,2026,10
68280999679,68280999678,-1,1191,1846,10
68283473114,68283473113,-1,1043,1792,10
68284927358,68284927357,-1,1325,1882,10
68285432815,68285432813,-2,1515,2382,10
68285520547,68285520541,-6,776,2684,10
68289066798,68289066797,-1,1449,2320,10
68291195971,68291195970,-1,1413,1653,10
68292628742,68292628741,-1,1207,1695,10
68294101737,68294101737,0,1153,1911,10
68299715327,68299715326,-1,1108,1657,10
68301591331,68301591312,-19,704,686,10
68302178605,68302178604,-1,889,2162,10
68306289754,68306289750,-4,624,721,10
68308047286,68308047284,-2,1074,1796,10
68308744213,68308744213,0,1656,2142,10
68311761738,68311761736,-2,1450,2589,10
68316737166,68316737162,-4,1194,2163,10
68317345769,68317345766,-3,1272,1657,10
68322027895,68322027894,-1,1706,2464,10
68322204927,68322204927,0,744,1633,10
68322439324,68322439321,-3,1106,2069,10
68324846191,68324846191,0,1162,1630,10
68332137465,68332137463,-2,1248,1309,10
68334086953,68334086954,1,1049,1689,10
68334220080,68334220061,-19,786,2044,10
68337927913,68337927911,-2,1301,2161,10
68338069223,68338069221,-2,1161,2113,10
68340252324,68340252324,0,1275,1742,10
68342584322,68342584319,-3,1274,2216,10
68344152970,68344152970,0,1231,1346,10
68344738261,68344738258,-3,1259,2429,10
68345050232,68345050229,-3,1278,2696,10
68347443115,68347443113,-2,1181,2064,10
68347873779,68347873779,0,691,1000,10
68352252939,68352252937,-2,771,1033,10
68355087719,68355087719,0,1617,2308,10
68359060290,68359060287,-3,946,2630,10
68361010701,68361010705,4,2289,1701,10
68361622443,68361622449,6,34150,54122,10
68361661903,68361661902,-1,1201,1717,10
68362518316,68362518314,-2,1416,1851,10
68366951490,68366951491,1,1342,1634,10
68370370158,68370370157,-1,1038,1764,10
68370999026,68370999023,-3,1022,2267,10
68382135617,68382135611,-6,1479,6342,10
68384923786,68384923785,-1,1750,2567,10
68390370155,68390370152,-3,2135,5899,10
68392922091,68392922090,-1,911,1414,10
68393881581,68393881577,-4,1348,2369,10
68401765056,68401765055,-1,1058,900,10
68403165398,68403165397,-1,590,1756,10
68404924192,68404924191,-1,1286,1369,10
68407719307,68407719305,-2,686,1256,10
68409061700,68409061700,0,1564,1107,10
68415425644,68415425645,1,1753,2280,10
68420307041,68420307041,0,919,1729,10
68420930867,68420930865,-2,910,1670,10
68422040326,68422040324,-2,1608,2430,10
68422454096,68422454090,-6,1205,4899,10
68425302859,68425302857,-2,1157,1425,10
68427323895,68427323892,-3,1105,1933,10
68433081545,68433081543,-2,1096,2064,10
68434096869,68434096874,5,1075,1205,10
68435937815,68435937814,-1,933,1722,10
68437349614,68437349615,1,1413,1704,10
68437890134,68437890113,-21,994,1882,10
68444222986,68444222983,-3,1107,1629,10
68445978462,68445978460,-2,1397,2449,10
68446332724,68446332722,-2,1850,3164,10
68447012798,68447012798,0,1322,1918,10
68448764038,68448764039,1,1106,1768,10
68452653425,68452653422,-3,1091,1445,10
68460616310,68460616306,-4,998,2107,10
68460826565,68460826561,-4,1741,2752,10
68463126858,68463126859,1,1504,1924,10
68465174485,68465174489,4,2365,1211,10
68466059910,68466059906,-4,1377,1815,10
68474996226,68474996226,0,1771,2636,10
68477556181,68477556178,-3,980,1739,10
68478518601,68478518622,21,754,1092,10
68478601654,68478601655,1,28231,21356,10
68483285926,68483285925,-1,964,1937,10
68485163404,68485163406,2,1524,1709,10
68485909479,68485909479,0,1255,1949,10
68489311041,68489311040,-1,1330,1763,10
68491486069,68491486066,-3,1202,2429,10
68492112355,68492112355,0,986,1994,10
68493639622,68493639632,10,848,1557,10
68496051414,68496051411,-3,1069,1919,10
68502636721,68502636721,0,745,1334,10
68502773881,68502773878,-3,17769,37903,10
68503238851,68503238849,-2,1197,2255,10
68504424415,68504424412,-3,1097,1985,10
68507623893,68507623889,-4,995,2254,10
68507670145,68507670143,-2,1778,2755,10
68508024737,68508024740,3,1747,1270,10
68509181106,68509181123,17,1235,1479,10
68509398283,68509398281,-2,969,2582,10
68515417016,68515417013,-3,1265,2609,10
68516052800,68516052790,-10,1031,2542,10
68516264028,68516264047,19,1086,2059,10
68517253833,68517253831,-2,1397,2242,10
68518080207,68518080205,-2,1535,2202,10
68518840179,68518840175,-4,1530,2353,10
68520792331,68520792337,6,1905,1436,10
68521986517,68521986517,0,1477,1729,10
68524862148,68524862147,-1,1494,2304,10
68525243211,68525243210,-1,1003,1905,10
68531881597,68531881596,-1,1080,2032,10
68533287996,68533287991,-5,1017,2719,10
68537097291,68537097290,-1,642,948,10
68541470230,68541470228,-2,1373,3354,10
68542409411,68542409411,0,754,1639,10
68544891115,68544891114,-1,1035,1432,10
68547339792,68547339789,-3,1136,1452,10
68552889234,68552889234,0,1408,1802,10
68553153202,68553153210,8,2749,1017,10
68553503813,68553503812,-1,1444,2513,10
68553982589,68553982586,-3,1080,2230,10
68559693027,68559693038,11,1521,2066,10
68564643579,68564643580,1,1295,1531,10
68566288699,68566288698,-1,914,1798,10
68573216130,68573216130,0,1291,1882,10
68575113994,68575113992,-2,1310,1833,10
68578014797,68578014799,2,893,1210,10
68578317463,68578317461,-2,1149,1879,10
68583680566,68583680566,0,1343,1801,10
68583884421,68583884418,-3,1085,2198,10
68593090817,68593090816,-1,1532,1939,10
68593959987,68593959983,-4,1087,2946,10
68603262483,68603262482,-1,1023,1315,10
68605661137,68605661135,-2,1402,1349,10
68613579014,68613579021,7,3645,1448,10
68613953838,68613953838,0,1004,1665,10
68615836957,68615836957,0,1137,2756,10
68618524227,68618524225,-2,1188,2615,10
68619170002,68619169998,-4,973,2107,10
68622129558,68622129558,0,1315,1200,10
68623460598,68623460595,-3,782,1469,10
68626142658,68626142657,-1,1222,2186,10
68626679118,68626679117,-1,1261,1756,10
68626903837,68626903840,3,2494,1815,10
68627283153,68627283158,5,918,883,10
68630629697,68630629698,1,1242,1899,10
68640549622,68640549621,-1,1774,2104,10
68645819595,68645819592,-3,1035,1583,10
68648987705,68648987703,-2,1341,1944,10
68654593662,68654593658,-4,1501,2167,10
68658409057,68658409053,-4,1022,1833,10
68665767758,68665767757,-1,1473,2325,10
68666132418,68666132417,-1,943,1736,10
68667771917,68667771914,-3,1261,2306,10
68668405022,68668405018,-4,1553,3372,10
68670022482,68670022481,-1,864,1809,10
68672172369,68672172367,-2,1297,1710,10
68678534045,68678534046,1,2055,1552,10
68680245598,68680245595,-3,903,2051,10
68683250609,68683250609,0,1450,2139,10
68683369101,68683369106,5,2011,1747,10
68688560018,68688560017,-1,1081,3240,10
68694245538,68694245537,-1,1080,1639,10
68697055862,68697055860,-2,1262,1998,10
68699082579,68699082575,-4,1439,1710,10
68701286438,68701286438,0,1188,2222,10
68703979236,68703979232,-4,1006,1397,10
68704894857,68704894858,1,71,1215,10
68706662220,68706662239,19,110,2479,10
68711765178,68711765174,-4,1632,4589,10
68712701200,68712701199,-1,1066,2119,10
68719566606,68719566603,-3,979,1415,10
68723261039,68723261045,6,22981,37141,10
68723597491,68723597489,-2,994,1596,10
68724258822,68724258825,3,1703,1161,10
68726228817,68726228814,-3,1224,1889,10
68730216610,68730216609,-1,697,1408,10
68730978189,68730978187,-2,1607,2401,10
68734712927,68734712926,-1,1235,2204,10
68738513883,68738513881,-2,1022,1069,10
68739539928,68739539926,-2,1038,1596,10
68739823538,68739823555,17,859,2150,10
68744255449,68744255447,-2,922,1645,10
68745789457,68745789478,21,983,1454,10
68747157595,68747157590,-5,1198,2125,10
68747671343,68747671341,-2,1142,2093,10
68752339845,68752339842,-3,1460,1797,10
68758964913,68758964911,-2,1345,2701,10
68759117436,68759117418,-18,173,771,10
68761067602,68761067600,-2,1307,1874,10
68761817883,68761817882,-1,1711,1823,10
68764843139,68764843136,-3,1274,2235,10
68765112655,68765112657,2,1246,1498,10
68765703279,68765703278,-1,1287,2359,10
68766812618,68766812615,-3,1092,1696,10
68767403366,68767403362,-4,1021,1801,10
68767866010,68767866020,10,688,1112,10
68769727900,68769727899,-1,1458,2354,10
68772900816,68772900814,-2,1272,1961,10
68773953683,68773953681,-2,952,1438,10
68778083506,68778083505,-1,1384,2095,10
68782553143,68782553142,-1,505,1272,10
68784632890,68784632887,-3,1069,2078,10
68785448651,68785448650,-1,1233,1956,10
68787195487,68787195486,-1,937,2536,10
68793716127,68793716124,-3,1906,2245,10
68798238194,68798238194,0,1157,1779,10
68798996901,68798996899,-2,1073,1632,10
68806141343,68806141343,0,825,1237,10
68808646031,68808646032,1,1555,1612,10
68812517303,68812517302,-1,1106,2490,10
68815540899,68815540899,0,1148,1735,10
68817445446,68817445443,-3,833,1856,10
68819719193,68819719191,-2,1138,1496,10
68820016612,68820016611,-1,1012,1715,10
68820971024,68820971024,0,1204,2112,10
68825866310,68825866306,-4,1868,2849,10
68828609889,68828609887,-2,1209,1988,10
68831918303,68831918313,10,281,753,10
68832984820,68832984818,-2,1127,1708,10
68833652538,68833652536,-2,1058,2046,10
68835941483,68835941483,0,1168,1538,10
68842759834,68842759833,-1,1291,1238,10
68843868605,68843868606,1,941,1238,10
68847662068,68847662067,-1,1038,1844,10
68849371178,68849371178,0,1218,1553,10
68863431747,68863431745,-2,1466,1735,10
68869084728,68869084735,7,2252,27933,10
68869314017,68869314017,0,751,1328,10
68878249186,68878249183,-3,1152,1773,10
68878411006,68878411004,-2,1360,1834,10
68878753831,68878753829,-2,1773,2472,10
68880146075,68880146079,4,1623,953,10
68884393390,68884393390,0,1001,1335,10
68891155131,68891155129,-2,1166,2163,10
68893305377,68893305378,1,1119,1672,10
68898988785,68898988785,0,1277,2401,10
68899803275,68899803295,20,1282,1572,10
68900727897,68900727898,1,1826,2334,10
68903618961,68903618954,-7,2683,8065,10
68909042778,68909042783,5,1887,1546,10
68910096655,68910096665,10,190,642,10
68915263013,68915263012,-1,1074,1481,10
68915823529,68915823522,-7,2173,7752,10
68916429582,68916429585,3,8917,19681,10
68926150653,68926150654,1,764,1939,10
68926863572,68926863566,-6,157,701,10
68934949006,68934949005,-1,1222,1884,10
68937174989,68937174987,-2,1031,1424,10
68939335335,68939335333,-2,1347,2110,10
68940961160,68940961159,-1,1286,2154,10
68942411799,68942411794,-5,1061,1977,10
68946755518,68946755518,0,1107,1770,10
68950458364,68950458365,1,1661,2528,10
68950918482,68950918479,-3,1257,2513,10
68952509943,68952509942,-1,1089,2576,10
68953788371,68953788370,-1,973,1088,10
68957671438,68957671441,3,2416,1402,10
68963927899,68963927895,-4,1549,2364,10
68965332534,68965332529,-5,800,4748,10
68965497051,68965497049,-2,1498,1793,10
68967162159,68967162157,-2,1142,1675,10
68968206583,68968206564,-19,998,1711,10
68968514352,68968514350,-2,1586,2840,10
68984684658,68984684657,-1,1329,2523,10
68985325703,68985325701,-2,1167,2613,10
68986092046,68986092045,-1,1068,2001,10
68988160342,68988160338,-4,968,2525,10
68988329621,68988329620,-1,1238,2457,10
68993735457,68993735457,0,1302,2105,10
68994288095,68994288094,-1,1531,1937,10
68994404433,68994404432,-1,965,2495,10
68995900655,68995900654,-1,1189,2257,10
68996288923,68996288920,-3,1484,2582,10
68998894735,68998894733,-2,40243,17836,10
68999147059,68999147058,-1,1259,1975,10
69000618856,69000618856,0,1251,2296,10
69007004126,69007004126,0,1150,2190,10
69014391726,69014391722,-4,1314,2009,10
69015642758,69015642758,0,1146,1719,10
69015899070,69015899067,-3,837,2564,10
69016438903,69016438901,-2,1561,2036,10
69017552795,69017552794,-1,1150,2592,10
69019138957,69019138954,-3,1474,1897,10
69024819887,69024819886,-1,432,1202,10
69027844778,69027844774,-4,1232,2086,10
69028830275,69028830274,-1,493,1393,10
69030440439,69030440439,0,1813,2448,10
69031422822,69031422822,0,1002,1971,10
69032474666,69032474669,3,1426,1934,10
69035226747,69035226746,-1,1416,2586,10
69036839756,69036839754,-2,1704,2505,10
69037519690,69037519693,3,2265,1669,10
69038823370,69038823368,-2,932,2132,10
69040019383,69040019379,-4,1288,1127,10
69040546248,69040546246,-2,1184,2525,10
69041991867,69041991865,-2,1714,2000,10
69042788960,69042788958,-2,1320,2369,10
69043446910,69043446909,-1,1150,1748,10
69047168242,69047168239,-3,1196,2587,10
69048130137,69048130122,-15,953,1852,10
69051604257,69051604255,-2,1035,2545,10
69051978825,69051978830,5,4126,2310,10
69052698749,69052698750,1,15894,17329,10
69054542613,69054542611,-2,1593,2320,10
69055861758,69055861757,-1,1440,2424,10
69058953127,69058953108,-19,779,676,10
69063175370,69063175367,-3,1382,2505,10
69064412418,69064412416,-2,1268,2276,10
69068099652,69068099650,-2,1172,1987,10
69070576137,69070576142,5,2234,761,10
69071053279,69071053283,4,940,1694,10
69072889867,69072889867,0,1371,1753,10
69073877422,69073877421,-1,1361,2275,10
69074701759,69074701757,-2,588,1549,10
69075355543,69075355544,1,1897,1655,10
69076829752,69076829750,-2,1390,2170,10
69083002098,69083002100,2,1785,1681,10
69086023407,69086023406,-1,1373,2838,10
69090503738,69090503737,-1,1246,1598,10
69093149471,69093149469,-2,1006,2305,10
69096911373,69096911371,-2,1288,1483,10
69097616053,69097616055,2,1034,1267,10
69101054531,69101054529,-2,21398,4834,10
69101894491,69101894489,-2,1363,1778,10
69101996306,69101996305,-1,964,2175,10
69104026730,69104026730,0,1296,1999,10
69105587528,69105587527,-1,1569,2030,10
69106252038,69106252038,0,1241,1784,10
69113191194,69113191202,8,5283,1231,10
69115797316,69115797315,-1,1061,1866,10
69118001406,69118001406,0,1351,1335,10
69120012228,69120012229,1,16953,8044,10
69122995894,69122995893,-1,1456,2421,10
69123128229,69123128227,-2,1266,1305,10
69124073096,69124073097,1,1259,1784,10
69124782167,69124782164,-3,1763,1720,10
69126539109,69126539107,-2,1402,1964,10
69126784026,69126784040,14,346,687,10
69128166483,69128166483,0,1118,2016,10
69129195964,69129195962,-2,945,1144,10
69130448529,69130448529,0,1233,1805,10
69130792442,69130792441,-1,1047,1214,10
69131928133,69131928131,-2,865,2332,10
69132316953,69132316954,1,1699,2090,10
69137464627,69137464623,-4,617,1440,10
69142941670,69142941673,3,1707,1467,10
69144636238,69144636238,0,1290,1489,10
69149587259,69149587258,-1,1306,1615,10
69152532712,69152532710,-2,1487,2199,10
69157283815,69157283814,-1,1105,1974,10
69162997260,69162997257,-3,974,2256,10
69165904386,69165904384,-2,1501,1792,10
69167323162,69167323143,-19,1218,1691,10
69167745853,69167745852,-1,1167,1758,10
69167914688,69167914673,-15,1496,2233,10
69171497068,69171497068,0,1266,1752,10
69174223763,69174223761,-2,1315,2227,10
69177902158,69177902155,-3,1363,2151,10
69178796163,69178796161,-2,742,1796,10
69184575765,69184575759,-6,1903,7995,10
69187292418,69187292418,0,703,997,10
69189732614,69189732614,0,1094,1807,10
69192992950,69192992950,0,1122,1451,10
69199743965,69199743963,-2,1223,2220,10
69205791927,69205791921,-6,1127,4691,10
69208746123,69208746123,0,1298,1703,10
69208928497,69208928485,-12,1190,2154,10
69211081294,69211081294,0,1283,1507,10
69212629999,69212630000,1,1675,1470,10
69213683241,69213683240,-1,1777,2882,10
69217867254,69217867254,0,1053,1065,10
69222655007,69222655005,-2,1383,3099,10
69225401400,69225401394,-6,1379,4084,10
69225879054,69225879059,5,1864,1124,10
69226242031,69226242030,-1,1500,1414,10
69226992257,69226992255,-2,1253,2844,10
69228081114,69228081114,0,1061,1312,10
69233100434,69233100430,-4,1031,1853,10
69233987548,69233987542,-6,1288,2121,10
69235217054,69235217053,-1,1056,2335,10
69236525534,69236525535,1,1493,1521,10
69236671385,69236671384,-1,1511,1737,10
69242043631,69242043629,-2,633,1723,10
69245139841,69245139839,-2,1642,1664,10
69247397618,69247397618,0,1107,1718,10
69254636487,69254636486,-1,948,1551,10
69259722925,69259722922,-3,1346,2213,10
69262477814,69262477814,0,763,1588,10
69264538157,69264538154,-3,1246,1534,10
69271130491,69271130498,7,704,1056,10
69277696075,69277696074,-1,1362,1937,10
69282828123,69282828119,-4,1306,2799,10
69285497309,69285497308,-1,1012,1966,10
69286467328,69286467333,5,25777,866,10
69290179831,69290179828,-3,1387,2383,10
69290793233,69290793239,6,1945,1425,10
69291727812,69291727811,-1,1563,2201,10
69292430075,69292430072,-3,1142,1423,10
69292655462,69292655459,-3,1256,1879,10
69299226990,69299226989,-1,871,683,10
69300099558,69300099558,0,1435,2486,10
69303956637,69303956635,-2,1489,1966,10
69309308385,69309308384,-1,2086,4063,10
69309609250,69309609247,-3,1407,2506,10
69310551051,69310551050,-1,1562,2264,10
69314479406,69314479405,-1,1399,2222,10
69316355942,69316355941,-1,1387,1970,10
69317185597,69317185598,1,1754,1641,10
69317251931,69317251930,-1,1450,2510,10
69319745404,69319745404,0,1642,2284,10
69320426527,69320426528,1,1468,2408,10
69321238897,69321238896,-1,2640,3362,10
69321944834,69321944832,-2,1020,2407,10
69322427443,69322427446,3,1632,1653,10
69330110174,69330110173,-1,1109,1535,10
69330490794,69330490793,-1,1762,2666,10
69331373086,69331373085,-1,1369,2035,10
69332217809,69332217806,-3,1407,2024,10
69332300046,69332300046,0,1817,2364,10
69333583575,69333583594,19,588,1402,10
69335448982,69335448982,0,1525,2365,10
69336839169,69336839168,-1,1120,2242,10
69343380955,69343380953,-2,1309,1929,10
69346894074,69346894072,-2,1127,2057,10
69350585092,69350585084,-8,1229,2752,10
69362767861,69362767858,-3,1562,2188,10
69365701866,69365701866,0,1230,2051,10
69368180870,69368180870,0,1118,1960,10
69379766992,69379767008,16,953,1286,10
69381633847,69381633847,0,1735,2644,10
69388179114,69388179109,-5,1214,2732,10
69388496767,69388496761,-6,682,3182,10
69388805155,69388805155,0,1100,1872,10
69389591659,69389591638,-21,1331,1848,10
69389939099,69389939097,-2,1440,2315,10
69392904356,69392904378,22,512,1527,10
69394205022,69394205022,0,1219,1840,10
69396267210,69396267210,0,1368,2012,10
69397254923,69397254922,-1,1052,1996,10
69399184058,69399184059,1,1556,2224,10
69401413677,69401413674,-3,1014,1973,10
69404797082,69404797082,0,945,1510,10
69406070081,69406070080,-1,1035,1983,10
69408426125,69408426124,-1,1099,2363,10
69408803826,69408803826,0,1370,2021,10
69414510734,69414510733,-1,1507,2397,10
69415791539,69415791545,6,266,1985,10
69420153310,69420153310,0,1690,2077,10
69420981617,69420981624,7,2773,1267,10
69422017003,69422017002,-1,1884,2054,10
69424206350,69424206355,5,2917,1458,10
69424921101,69424921098,-3,676,1486,10
69426704563,69426704561,-2,1380,1788,10
69427550069,69427550069,0,1517,2162,10
69427876475,69427876476,1,901,1543,10
69432875814,69432875809,-5,669,1524,10
69435730851,69435730861,10,11799,30302,10
69437702051,69437702052,1,1266,1597,10
69440096310,69440096307,-3,1480,2027,10
69444945682,69444945683,1,1301,1608,10
69448012293,69448012288,-5,1155,3887,10
69453866200,69453866205,5,3457,1768,10
69457166646,69457166646,0,1248,1898,10
69464708746,69464708746,0,1238,1623,10
69471361087,69471361107,20,1509,2316,10
69484136044,69484136043,-1,1804,2104,10
69492137053,69492137053,0,926,1877,10
69492447489,69492447483,-6,285,557,10
69493460846,69493460847,1,1133,1612,10
69493624115,69493624110,-5,1109,1898,10
69493807721,69493807719,-2,2116,1809,10
69495596492,69495596490,-2,1395,2419,10
69497359309,69497359310,1,943,1073,10
69497599922,69497599920,-2,1276,1550,10
69499199997,69499199998,1,2014,1765,10
69509398305,69509398302,-3,1398,1912,10
69509833833,69509833827,-6,358,820,10
69513608036,69513608034,-2,1486,2416,10
69514440439,69514440436,-3,1332,2143,10
69515297055,69515297053,-2,1367,2184,10
69524562287,69524562286,-1,1087,2294,10
69525022922,69525022921,-1,1122,1738,10
69525690626,69525690626,0,1076,1900,10
69529495191,69529495190,-1,1119,2006,10
69530676318,69530676315,-3,775,2057,10
69533577781,69533577777,-4,1619,3090,10
69533687817,69533687811,-6,914,1368,10
69534924192,69534924191,-1,1290,2103,10
69536223934,69536223933,-1,1114,1980,10
69537845649,69537845648,-1,1024,1586,10
69538024771,69538024765,-6,42571,32289,10
69539099613,69539099613,0,1319,1638,10
69540589490,69540589489,-1,1331,2053,10
69541329434,69541329433,-1,2678,4422,10
69541479386,69541479382,-4,1224,2421,10
69545336226,69545336227,1,1505,1979,10
69546808874,69546808870,-4,1236,1976,10
69547118746,69547118745,-1,1129,2947,10
69548204362,69548204360,-2,1094,1877,10
69548371612,69548371617,5,1458,1180,10
69552581025,69552581034,9,3187,993,10
69553757543,69553757541,-2,1246,1900,10
69562848657,69562848656,-1,1026,1250,10
69567431583,69567431581,-2,1242,1577,10
69574577182,69574577183,1,1052,1272,10
69575200634,69575200633,-1,1227,1432,10
69575822067,69575822049,-18,1095,2049,10
69576098117,69576098115,-2,1154,1690,10
69577013853,69577013855,2,1046,2645,10
69578713914,69578713911,-3,1001,2007,10
69583564506,69583564505,-1,1074,1355,10
69585360642,69585360658,16,804,1014,10
69586329662,69586329662,0,1485,2014,10
69587159451,69587159449,-2,1532,2201,10
69589361791,69589361796,5,1942,1436,10
69589894532,69589894553,21,2012,7049,10
69590866476,69590866462,-14,1173,1728,10
69592914515,69592914513,-2,998,1966,10
69593839274,69593839273,-1,1381,2139,10
69598429008,69598429009,1,898,1622,10
69600137761,69600137759,-2,1045,1906,10
69601806726,69601806726,0,967,1700,10
69602067973,69602067971,-2,1973,2774,10
69602312226,69602312225,-1,1077,1488,10
69602881345,69602881345,0,1264,1771,10
69604578702,69604578704,2,137,751,10
69610806911,69610806908,-3,1009,2085,10
69612259254,69612259252,-2,1352,2752,10
69613498201,69613498197,-4,1194,1370,10
69617519182,69617519179,-3,1427,1257,10
69621611490,69621611491,1,1830,2453,10
69623020406,69623020405,-1,1505,3041,10
69629106233,69629106232,-1,1072,2290,10
69636244778,69636244775,-3,899,1646,10
69639387218,69639387222,4,2008,1179,10
69640191973,69640191969,-4,1380,2860,10
69644125066,69644125066,0,1258,1059,10
69645495450,69645495448,-2,1217,1247,10
69647255282,69647255282,0,985,1585,10
69648053993,69648053993,0,648,2129,10
69651159679,69651159677,-2,1474,1850,10
69651936417,69651936415,-2,1205,1949,10
69653152993,69653152990,-3,1026,1803,10
69659836070,69659836066,-4,765,1654,10
69662904123,69662904122,-1,975,1806,10
69672051751,69672051752,1,1409,1613,10
69672623218,69672623217,-1,1609,1786,10
69675983630,69675983629,-1,1461,2967,10
69682130800,69682130802,2,11880,13451,10
69691465096,69691465094,-2,937,2038,10
69692203144,69692203144,0,1049,1742,10
69692550185,69692550181,-4,736,2509,10
69699477637,69699477638,1,827,1723,10
69700447586,69700447587,1,1142,1480,10
69705309254,69705309253,-1,1177,1900,10
69705776667,69705776664,-3,1239,1680,10
69711090951,69711090952,1,930,2001,10
69711399856,69711399846,-10,137,842,10
69712002778,69712002775,-3,1220,2382,10
69713915382,69713915383,1,1035,1562,10
69714897226,69714897223,-3,1173,1807,10
69720929061,69720929059,-2,1379,1958,10
69723555657,69723555657,0,1410,1404,10
69726656215,69726656214,-1,967,1323,10
69730377838,69730377838,0,1333,2321,10
69730701477,69730701474,-3,1047,2223,10
69731232565,69731232570,5,4276,2402,10
69733902854,69733902851,-3,1253,2416,10
69734477959,69734477958,-1,951,1580,10
69736114990,69736114989,-1,1528,2107,10
69740379875,69740379877,2,2347,1610,10
69741812148,69741812145,-3,1319,2261,10
69742010622,69742010620,-2,947,1930,10
69742964503,69742964502,-1,855,2098,10
69743469923,69743469918,-5,1025,1709,10
69745717735,69745717731,-4,1617,2459,10
69752646777,69752646777,0,1577,1638,10
69752682743,69752682739,-4,1882,2147,10
69755866403,69755866403,0,1186,1517,10
69758628478,69758628477,-1,1079,1900,10
69759046402,69759046397,-5,56368,29131,10
69759815066,69759815062,-4,1189,1995,10
69761447370,69761447369,-1,1183,1743,10
69762185101,69762185102,1,1617,2209,10
69764484591,69764484590,-1,1188,2022,10
69765794782,69765794781,-1,1055,1632,10
69771862736,69771862731,-5,769,1409,10
69772719105,69772719104,-1,1480,1933,10
69773820486,69773820502,16,1468,2241,10
69774648129,69774648127,-2,1475,2505,10
69778286467,69778286466,-1,1196,1754,10
69782721764,69782721762,-2,913,2014,10
69783944905,69783944905,0,1339,2382,10
69784535606,69784535606,0,1374,1915,10
69788509401,69788509399,-2,1480,2144,10
69793237590,69793237590,0,1056,2086,10
69793926062,69793926060,-2,1082,1985,10
69796749534,69796749530,-4,1616,3169,10
69798073131,69798073130,-1,928,1508,10
69799322174,69799322173,-1,1516,2215,10
69802804571,69802804570,-1,1076,1758,10
69803775681,69803775687,6,4217,1904,10
69804102295,69804102293,-2,1582,2600,10
69804596537,69804596530,-7,659,2665,10
69805575918,69805575917,-1,1367,2163,10
69806213354,69806213354,0,1409,2338,10
69810172612,69810172612,0,1366,1810,10
69810691890,69810691888,-2,1760,2382,10
69812182102,69812182101,-1,1272,1963,10
69813744183,69813744186,3,1598,1318,10
69817793242,69817793239,-3,914,2108,10
69821706540,69821706539,-1,1580,1939,10
69825939268,69825939267,-1,1203,1951,10
69826150845,69826150845,0,1917,2412,10
69834529512,69834529510,-2,1175,2365,10
69840115625,69840115625,0,1297,1610,10
69843166026,69843166026,0,1040,2205,10
69845475223,69845475221,-2,1410,2659,10
69845613939,69845613940,1,951,1621,10
69846968477,69846968477,0,1578,2008,10
69851796867,69851796867,0,1638,1910,10
69852194343,69852194343,0,672,1796,10
69853423117,69853423117,0,1149,1936,10
69853556321,69853556303,-18,782,2088,10
69858656415,69858656414,-1,1525,2301,10
69859334688,69859334686,-2,1221,2282,10
69859624530,69859624530,0,1587,2910,10
69862952462,69862952462,0,1227,1895,10
69866768922,69866768921,-1,1985,3422,10
69869471498,69869471495,-3,18055,8327,10
69872353762,69872353761,-1,1372,1929,10
69875172038,69875172038,0,817,966,10
69877513463,69877513462,-1,965,1749,10
69877697513,69877697533,20,1325,2916,10
69884841963,69884841961,-2,1621,2287,10
69888772075,69888772072,-3,940,1948,10
69904533827,69904533820,-7,805,2428,10
69908551850,69908551850,0,1242,1692,10
69913878106,69913878105,-1,915,1504,10
69914560418,69914560417,-1,2124,2613,10
69919980277,69919980276,-1,1019,1970,10
69921734958,69921734955,-3,1400,2553,10
69924737924,69924737924,0,1616,2208,10
69926871326,69926871325,-1,985,1851,10
69927386909,69927386908,-1,1053,2400,10
69930105454,69930105454,0,1639,1866,10
69932680926,69932680922,-4,1419,2195,10
69932720899,69932720898,-1,1929,2239,10
69937191161,69937191161,0,1649,1927,10
69938149027,69938149023,-4,1063,2311,10
69938467354,69938467355,1,1721,2488,10
69938738019,69938738018,-1,1095,1599,10
69939178930,69939178929,-1,1289,2078,10
69941073479,69941073476,-3,706,1246,10
69941374388,69941374391,3,1476,1246,10
69943373176,69943373176,0,1493,2035,10
69944234521,69944234527,6,6259,2635,10
69945645264,69945645263,-1,1239,2295,10
69945805948,69945805965,17,526,3170,10
69949177329,69949177327,-2,1720,2598,10
69949403135,69949403134,-1,1312,1821,10
69950271661,69950271660,-1,1269,1924,10
69952766903,69952766904,1,1424,1683,10
69958425494,69958425490,-4,884,2223,10
69959495519,69959495524,5,5453,3297,10
69962610554,69962610555,1,1147,2192,10
69966998310,69966998309,-1,1431,2627,10
69967328602,69967328600,-2,972,1913,10
69967790203,69967790207,4,2241,1527,10
69975822883,69975822881,-2,1252,1704,10
69977932323,69977932322,-1,1153,1839,10
69982934491,69982934489,-2,891,1176,10
69983677746,69983677742,-4,1021,2573,10
69993723946,69993723941,-5,1325,2481,10
69994816276,69994816272,-4,1422,3420,10
69997578659,69997578657,-2,1450,2614,10
70012733530,70012733529,-1,1250,1437,10
70013390391,70013390392,1,1473,1384,10
70016852654,70016852651,-3,1296,2025,10
70017178977,70017178997,20,947,1856,10
70018501451,70018501451,0,1000,2061,10
70026720058,70026720058,0,1265,3121,10
70036443153,70036443151,-2,1084,1513,10
70039740523,70039740523,0,1689,2855,10
70040148247,70040148247,0,898,1743,10
70041153210,70041153207,-3,922,2163,10
70041862691,70041862687,-4,1083,1886,10
70042174875,70042174874,-1,1418,2448,10
70042624363,70042624362,-1,1321,1944,10
70044696302,70044696300,-2,1174,1633,10
70046384397,70046384397,0,756,1843,10
70048535312,70048535310,-2,1296,2175,10
70050951842,70050951838,-4,1110,1669,10
70052402747,70052402746,-1,826,1636,10
70053563427,70053563425,-2,1031,2289,10
70054353854,70054353853,-1,749,1918,10
70057640508,70057640504,-4,2572,4568,10
70058509981,70058509978,-3,762,1085,10
70058972946,70058972943,-3,1635,2458,10
70064483868,70064483861,-7,2484,7557,10
70065185353,70065185350,-3,1606,2558,10
70065372110,70065372109,-1,1579,2863,10
70070356335,70070356332,-3,28235,16930,10
70070525114,70070525113,-1,1304,1627,10
70071356442,70071356439,-3,669,1451,10
70071666161,70071666142,-19,1403,2471,10
70071868025,70071868025,0,1097,1741,10
70072241641,70072241642,1,1392,1893,10
70074375853,70074375852,-1,1093,1825,10
70074867185,70074867181,-4,1526,2596,10
70075479641,70075479662,21,786,1290,10
70076749542,70076749538,-4,1873,5332,10
70078968270,70078968268,-2,1316,2473,10
70080479069,70080479068,-1,1562,2440,10
70081965206,70081965202,-4,1232,1672,10
70085993891,70085993889,-2,1171,1840,10
70088981671,70088981670,-1,1065,1882,10
70089589162,70089589159,-3,1296,2778,10
70090429987,70090429984,-3,1393,2248,10
70091769168,70091769167,-1,1202,2277,10
70094090678,70094090676,-2,1732,2431,10
70096955365,70096955364,-1,971,1916,10
70101297527,70101297527,0,1509,1993,10
70101579702,70101579703,1,1191,2297,10
70107564658,70107564665,7,5842,2022,10
70109085910,70109085907,-3,1139,2695,10
70110251435,70110251429,-6,1853,8189,10
70110796828,70110796827,-1,1211,1751,10
70111836096,70111836086,-10,1377,2433,10
70114793126,70114793126,0,1464,2376,10
70117898880,70117898880,0,1392,2236,10
70118465062,70118465060,-2,1337,1886,10
70130205387,70130205390,3,2047,1607,10
70131664590,70131664593,3,30819,23853,10
70132112431,70132112429,-2,1251,1821,10
70132562978,70132562977,-1,1612,2489,10
70133879778,70133879781,3,1291,2082,10
70134503195,70134503193,-2,855,2144,10
70141247432,70141247431,-1,1304,1422,10
70142552951,70142552950,-1,1239,2377,10
70143809596,70143809594,-2,893,1685,10
70144859542,70144859540,-2,1040,1496,10
70145407067,70145407066,-1,1622,2447,10
70147067651,70147067649,-2,1490,2230,10
70147270665,70147270665,0,1145,1622,10
70149364706,70149364705,-1,1696,2708,10
70154567238,70154567239,1,622,1140,10
70155309389,70155309387,-2,1173,1452,10
70157335892,70157335890,-2,1400,3419,10
70158162194,70158162194,0,1013,1372,10
70158272249,70158272247,-2,1491,2167,10
70164042164,70164042163,-1,1206,1697,10
70164104179,70164104178,-1,1479,2121,10
70176795453,70176795453,0,1489,2748,10
70182683810,70182683809,-1,7809,11487,10
70183810821,70183810825,4,2069,1983,10
70185081113,70185081112,-1,1338,2141,10
70189393361,70189393358,-3,1407,1891,10
70191984506,70191984506,0,452,767,10
70192504808,70192504805,-3,636,1324,10
70194805706,70194805724,18,1126,1767,10
70199926543,70199926544,1,688,1501,10
70201273358,70201273357,-1,785,1910,10
70201768304,70201768290,-14,901,1433,10
70202898783,70202898781,-2,830,1344,10
70204985290,70204985288,-2,1187,1788,10
70205132699,70205132698,-1,1171,2208,10
70205359235,70205359236,1,1856,2249,10
70208465598,70208465597,-1,763,1725,10
70211463418,70211463414,-4,1063,2500,10
70217214276,70217214275,-1,1749,2352,10
70225643086,70225643086,0,829,1399,10
70228826615,70228826614,-1,856,1361,10
70228984839,70228984838,-1,1146,1750,10
70229055446,70229055445,-1,1034,1600,10
70229644734,70229644730,-4,1495,2417,10
70236749689,70236749688,-1,1094,2233,10
70238521898,70238521895,-3,1074,1783,10
70240229833,70240229828,-5,942,1994,10
70242386501,70242386501,0,909,2402,10
70242613002,70242613000,-2,1145,1968,10
70244147217,70244147215,-2,695,998,10
70248567211,70248567210,-1,832,2178,10
70248983824,70248983824,0,1307,2740,10
70250243718,70250243720,2,1481,1953,10
70253200177,70253200179,2,1166,1626,10
70256757228,70256757226,-2,1165,1611,10
70258952602,70258952600,-2,1335,2050,10
70259795926,70259795922,-4,787,1362,10
70261196034,70261196034,0,992,1972,10
70261849366,70261849364,-2,1282,2577,10
70263830166,70263830166,0,949,2131,10
70272387911,70272387910,-1,1449,2693,10
70272741903,70272741902,-1,1335,2023,10
70274125511,70274125511,0,1088,2001,10
70274643305,70274643311,6,2624,1603,10
70275039131,70275039131,0,924,1364,10
70275794232,70275794239,7,3877,2000,10
70287468519,70287468518,-1,877,1430,10
70288727769,70288727768,-1,873,1959,10
70288802624,70288802642,18,202,658,10
70292395173,70292395172,-1,1028,1875,10
70295586602,70295586602,0,1137,1742,10
70295778286,70295778283,-3,1248,2814,10
70298800858,70298800855,-3,1026,2220,10
70301205675,70301205675,0,955,1608,10
70302176955,70302176954,-1,1993,2572,10
70303435942,70303435941,-1,1262,2278,10
70303486553,70303486551,-2,1594,2515,10
70303513027,70303513025,-2,1171,1588,10
70305050367,70305050369,2,1648,1680,10
70305477641,70305477635,-6,1207,1824,10
70305694255,70305694254,-1,1190,1937,10
70307582810,70307582805,-5,1304,1857,10
70307745897,70307745896,-1,1701,2552,10
70310846062,70310846062,0,1476,2266,10
70316475046,70316475050,4,3993,2869,10
70316940258,70316940257,-1,1304,2562,10
70318205590,70318205591,1,3002,1635,10
70318269127,70318269125,-2,856,2114,10
70320587291,70320587289,-2,1221,2152,10
70323768701,70323768707,6,3111,1405,10
70325258324,70325258320,-4,1481,2479,10
70326681974,70326681973,-1,1016,2476,10
70327116265,70327116262,-3,1041,1888,10
70332253427,70332253426,-1,856,1540,10
70335038439,70335038458,19,1142,1687,10
70336672770,70336672769,-1,1200,2096,10
70338221085,70338221082,-3,1206,1639,10
70338947969,70338947965,-4,1077,1603,10
70344065824,70344065821,-3,1512,1868,10
70345642805,70345642805,0,923,1146,10
70347936226,70347936226,0,1303,1750,10
70353636042,70353636042,0,1574,1749,10
70354238552,70354238552,0,712,1271,10
70356940818,70356940817,-1,1020,2196,10
70360614761,70360614750,-11,448,1205,10
70365229938,70365229936,-2,1701,2686,10
70366077950,70366077949,-1,1207,1688,10
70369364310,70369364310,0,515,1548,10
70381754478,70381754477,-1,952,1697,10
70383294598,70383294594,-4,1068,2050,10
70384298339,70384298338,-1,1053,1977,10
70387032585,70387032577,-8,1393,5037,10
70388823246,70388823245,-1,1074,1598,10
70389985211,70389985210,-1,1324,2361,10
70392970291,70392970288,-3,1330,1986,10
70396185602,70396185601,-1,1445,1735,10
70396486107,70396486105,-2,1862,2657,10
70397752371,70397752371,0,1690,1923,10
70400470306,70400470304,-2,1338,1522,10
70404336438,70404336438,0,879,2100,10
70404775009,70404775007,-2,1506,1932,10
70409025571,70409025570,-1,782,2110,10
70410977427,70410977425,-2,969,1945,10
70411828931,70411828933,2,983,1108,10
70414839138,70414839135,-3,1284,1990,10
70417541285,70417541282,-3,1424,1705,10
70418673318,70418673313,-5,1298,2639,10
70419454671,70419454669,-2,1458,2552,10
70420488781,70420488778,-3,1190,1678,10
70422949878,70422949877,-1,1833,2452,10
70425135470,70425135470,0,1294,1743,10
70430720339,70430720337,-2,1184,1580,10
70431807067,70431807062,-5,1070,1685,10
70432139938,70432139938,0,1232,1997,10
70432522091,70432522091,0,2085,2531,10
70436477308,70436477311,3,1544,1480,10
70441496747,70441496747,0,1057,1838,10
70443340671,70443340671,0,939,1401,10
70447327193,70447327192,-1,1209,1748,10
70453107943,70453107947,4,1542,1204,10
70455890667,70455890665,-2,1011,1894,10
70455998065,70455998057,-8,1028,1674,10
70456926684,70456926683,-1,1054,1863,10
70457814590,70457814589,-1,1337,2032,10
70460153526,70460153525,-1,890,1925,10
70462576148,70462576146,-2,1205,2420,10
70463388529,70463388536,7,11629,29370,10
70466145341,70466145336,-5,1294,2657,10
70470265197,70470265193,-4,1780,6005,10
70472263264,70472263281,17,1235,1654,10
70474564445,70474564449,4,2991,1774,10
70476872514,70476872520,6,2270,1259,10
70480328356,70480328359,3,2360,2097,10
70482320197,70482320195,-2,1286,2188,10
70483026147,70483026145,-2,1259,2142,10
70488484031,70488484030,-1,2101,3448,10
70490806167,70490806166,-1,1061,1818,10
70492130198,70492130198,0,1130,1360,10
70494120062,70494120059,-3,1401,2389,10
70496482775,70496482774,-1,739,1634,10
70498582895,70498582893,-2,1555,2399,10
70501055734,70501055732,-2,818,1671,10
70502404373,70502404370,-3,1637,4307,10
70503402543,70503402543,0,1242,1651,10
70505919335,70505919334,-1,1400,1911,10
70506249359,70506249357,-2,1147,2083,10
70507311534,70507311533,-1,1551,2553,10
70508273895,70508273893,-2,1631,2587,10
70513708076,70513708074,-2,1430,2664,10
70514051167,70514051163,-4,29461,10508,10
70516870833,70516870831,-2,1243,2104,10
70519965458,70519965456,-2,893,1024,10
70520738660,70520738662,2,1895,1651,10
70523979437,70523979435,-2,1095,1372,10
70529696943,70529696944,1,1462,1866,10
70532920742,70532920741,-1,1695,2483,10
70534568299,70534568298,-1,1287,1826,10
70535216993,70535217013,20,845,2904,10
70536696259,70536696258,-1,1291,2259,10
70538890915,70538890914,-1,1190,2426,10
70540520371,70540520372,1,1103,1849,10
70541311819,70541311817,-2,1577,1495,10
70542903118,70542903118,0,1635,1667,10
70543123246,70543123243,-3,1126,1833,10
70543341843,70543341842,-1,1209,2294,10
70551188996,70551188994,-2,1510,2600,10
70556526789,70556526788,-1,1947,2930,10
70557472590,70557472589,-1,1143,1478,10
70557601985,70557601984,-1,1623,2145,10
70558974713,70558974711,-2,1127,2068,10
70563767060,70563767059,-1,1118,2059,10
70563812699,70563812697,-2,1467,2110,10
70570687983,70570687982,-1,1661,2089,10
70576513727,70576513725,-2,1286,1852,10
70579678594,70579678593,-1,1495,1902,10
70584019792,70584019790,-2,1397,2615,10
70584118737,70584118739,2,1103,1650,10
70585934568,70585934566,-2,1808,2404,10
70586521472,70586521470,-2,1128,1806,10
70591448715,70591448714,-1,1359,2027,10
70594723671,70594723667,-4,1386,1621,10
70597150486,70597150483,-3,2800,5283,10
70600537062,70600537062,0,1049,2423,10
70600646101,70600646098,-3,1219,2179,10
70601172059,70601172074,15,519,2605,10
70603855293,70603855291,-2,1044,2141,10
70605584700,70605584698,-2,1306,1872,10
70607091626,70607091625,-1,1052,1500,10
70607784475,70607784473,-2,884,2164,10
70611857234,70611857228,-6,1101,4277,10
70613552413,70613552413,0,1601,2086,10
70613615562,70613615561,-1,1218,2138,10
70615906855,70615906855,0,1523,2092,10
70616726990,70616726990,0,1220,1520,10
70619541626,70619541627,1,981,1781,10
70622349551,70622349549,-2,741,1928,10
70624095391,70624095389,-2,1124,2399,10
70627378020,70627378018,-2,1237,1898,10
70633183350,70633183350,0,1325,2324,10
70635240075,70635240074,-1,987,1570,10
70649968678,70649968677,-1,1504,2493,10
70650633637,70650633634,-3,666,1271,10
70655925385,70655925381,-4,30384,14545,10
70656645604,70656645603,-1,1253,1579,10
70657290475,70657290472,-3,897,2619,10
70657353725,70657353727,2,898,1100,10
70659382435,70659382434,-1,994,2600,10
70664335006,70664335006,0,1460,2294,10
70664477986,70664477984,-2,1218,2487,10
70666693001,70666693000,-1,1236,2193,10
70668704813,70668704812,-1,1118,2276,10
70671330705,70671330705,0,1141,2168,10
70671870001,70671870001,0,1399,1837,10
70672882152,70672882134,-18,902,2147,10
70675077868,70675077867,-1,720,1225,10
70676757794,70676757794,0,791,2011,10
70677666649,70677666646,-3,671,1918,10
70677750295,70677750294,-1,1041,2702,10
70678604295,70678604292,-3,1096,1909,10
70679117649,70679117647,-2,1079,1935,10
70679702553,70679702574,21,934,1914,10
70684382340,70684382339,-1,1739,2288,10
70684890733,70684890730,-3,1626,2426,10
70686993904,70686993903,-1,1162,2100,10
70687259114,70687259114,0,1090,1949,10
70691240483,70691240489,6,4705,2898,10
70692241190,70692241189,-1,1087,2179,10
70692894611,70692894613,2,1203,1343,10
70694964011,70694964009,-2,1332,2276,10
70699850914,70699850913,-1,1206,2442,10
70700726630,70700726626,-4,1193,2688,10
70703281939,70703281938,-1,1053,1370,10
70704651339,70704651337,-2,1138,2064,10
70706715301,70706715302,1,1176,1146,10
70707850111,70707850113,2,1374,961,10
70708234275,70708234274,-1,1441,1882,10
70709588114,70709588106,-8,2350,8376,10
70715419358,70715419357,-1,1480,1700,10
70718665229,70718665226,-3,1431,1727,10
70719907616,70719907614,-2,1180,2031,10
70722110656,70722110654,-2,1295,1842,10
70727230638,70727230636,-2,1604,2400,10
70731231592,70731231590,-2,1488,1928,10
70734621337,70734621335,-2,1286,1976,10
70736434097,70736434093,-4,1362,4227,10
70736670582,70736670581,-1,1301,2067,10
70738043882,70738043884,2,2604,1631,10
70738933431,70738933431,0,1331,2026,10
70747516024,70747516026,2,1812,1711,10
70747875154,70747875161,7,13053,4420,10
70752281119,70752281117,-2,1406,2740,10
70752486184,70752486182,-2,1434,2280,10
70752725346,70752725327,-19,874,1515,10
70755268206,70755268205,-1,1168,1008,10
70756334892,70756334892,0,1506,2482,10
70757127414,70757127409,-5,1182,1734,10
70758433570,70758433567,-3,1448,2089,10
70761523709,70761523706,-3,1801,2442,10
70762748364,70762748364,0,994,1750,10
70772930610,70772930611,1,1350,2169,10
70773467700,70773467701,1,2081,1662,10
70775869077,70775869075,-2,1486,2102,10
70777468725,70777468722,-3,1218,1805,10
70780480985,70780480983,-2,1146,1304,10
70781968114,70781968106,-8,1119,4553,10
70785817069,70785817066,-3,1137,2499,10
70788560942,70788560938,-4,1633,2785,10
70789439994,70789439990,-4,1107,2884,10
70789691442,70789691445,3,1975,1515,10
70791102486,70791102485,-1,626,1313,10
70791177803,70791177804,1,1008,997,10
70793854087,70793854085,-2,1253,1841,10
70795443289,70795443291,2,1912,1476,10
70797268495,70797268491,-4,1210,2315,10
70800668258,70800668259,1,878,1693,10
70800711399,70800711397,-2,1391,1586,10
70802450390,70802450389,-1,994,2049,10
70803819902,70803819900,-2,1173,2466,10
70811104700,70811104699,-1,1405,2387,10
70812799278,70812799275,-3,1059,1933,10
70817314006,70817314003,-3,943,1961,10
70818165550,70818165550,0,1056,1485,10
70820188170,70820188171,1,837,1134,10
70824580310,70824580310,0,1087,1980,10
70826434320,70826434323,3,1484,1812,10
70826462210,70826462208,-2,1412,3272,10
70830404489,70830404490,1,1888,2181,10
70833663407,70833663406,-1,754,1086,10
70836181047,70836181044,-3,1215,1640,10
70838345643,70838345642,-1,1078,2431,10
70842388741,70842388740,-1,1175,2209,10
70843360205,70843360204,-1,1394,1909,10
70844860465,70844860463,-2,1424,2090,10
70846001548,70846001546,-2,1169,2005,10
70858453291,70858453290,-1,1895,2706,10
70859651451,70859651452,1,1014,2174,10
70862656889,70862656911,22,1392,2140,10
70863135606,70863135619,13,16019,27391,10
70864678166,70864678165,-1,1252,2389,10
70868799095,70868799092,-3,940,2122,10
70869534322,70869534320,-2,1118,2024,10
70871298761,70871298777,16,446,1359,10
70872907585,70872907583,-2,842,1792,10
70876801870,70876801871,1,1318,2180,10
70877888486,70877888482,-4,921,1785,10
70878271769,70878271766,-3,904,1794,10
70881350923,70881350926,3,1665,1356,10
70881475803,70881475802,-1,1013,1752,10
70885125375,70885125369,-6,1208,3810,10
70886199936,70886199934,-2,1211,1968,10
70890872359,70890872358,-1,991,2081,10
70893057290,70893057292,2,1406,2239,10
70894877962,70894877962,0,1215,1929,10
70896197446,70896197445,-1,1529,3137,10
70896343129,70896343129,0,1061,1678,10
70898539300,70898539294,-6,1633,6626,10
70899720446,70899720443,-3,637,2344,10
70900370670,70900370671,1,1366,2077,10
70900813447,70900813445,-2,1438,1624,10
70905624289,70905624288,-1,1278,1494,10
70908685417,70908685416,-1,1225,1466,10
70910033790,70910033790,0,1194,1578,10
70911288766,70911288760,-6,637,1959,10
70912779726,70912779724,-2,23453,19477,10
70913426399,70913426397,-2,1244,1703,10
70913859775,70913859778,3,1400,1304,10
70914095165,70914095173,8,14821,21295,10
70916918247,70916918246,-1,1135,1712,10
70921381120,70921381116,-4,921,1370,10
70927661489,70927661486,-3,1203,2068,10
70927791691,70927791673,-18,860,1403,10
70928130621,70928130621,0,898,2128,10
70931059009,70931059008,-1,1024,1760,10
70931327707,70931327706,-1,850,843,10
70934649381,70934649377,-4,1104,1938,10
70937549198,70937549197,-1,1061,1877,10
70941858732,70941858730,-2,1059,1665,10
70944577566,70944577566,0,1350,1955,10
70947844514,70947844512,-2,1353,2207,10
70949865178,70949865175,-3,989,1488,10
70952127163,70952127164,1,1467,1759,10
70955706517,70955706516,-1,1343,2192,10
70967383576,70967383576,0,1103,1929,10
70970911820,70970911818,-2,1318,2176,10
70977713967,70977713965,-2,922,1819,10
70980907556,70980907559,3,1290,1142,10
70981177561,70981177558,-3,1126,1966,10
70981426955,70981426954,-1,1104,1911,10
70982889119,70982889118,-1,1405,1754,10
70993700894,70993700893,-1,1571,2476,10
71000376831,71000376831,0,1068,2156,10
71000774147,71000774154,7,3068,1626,10
71002288385,71002288383,-2,1070,1846,10
71002421579,71002421578,-1,1147,1934,10
71003836963,71003836961,-2,1222,1381,10
71005359067,71005359066,-1,1591,1323,10
71009202889,71009202910,21,641,1468,10
71009432730,71009432728,-2,874,1547,10
71012411691,71012411691,0,981,2001,10
71012619434,71012619433,-1,1123,2522,10
71013710099,71013710101,2,1207,1461,10
71016869816,71016869818,2,3392,2668,10
71018074058,71018074058,0,1705,1845,10
71020273039,71020273038,-1,849,1532,10
71022357249,71022357253,4,2730,1114,10
71034889601,71034889599,-2,1408,2261,10
71035478323,71035478325,2,31940,30869,10
71038032318,71038032313,-5,991,2726,10
71048381017,71048381014,-3,1089,1967,10
71048910204,71048910203,-1,1484,2962,10
71055594006,71055594001,-5,1587,3638,10
71056675377,71056675375,-2,564,946,10
71059264823,71059264820,-3,1044,3003,10
71067367498,71067367497,-1,1298,1816,10
71069521710,71069521710,0,911,1666,10
71070512702,71070512701,-1,846,2153,10
71071953184,71071953184,0,1346,1773,10
71076512625,71076512625,0,1260,1413,10
71078750416,71078750415,-1,1826,2557,10
71081279455,71081279454,-1,1265,1690,10
71081969231,71081969227,-4,1070,2804,10
71082515921,71082515914,-7,1018,2126,10
71082932736,71082932745,9,24060,31421,10
71082995941,71082995940,-1,1226,1850,10
71083963833,71083963831,-2,1396,2028,10
71085473590,71085473589,-1,1317,1702,10
71086280298,71086280314,16,591,1188,10
71093157649,71093157650,1,1323,1578,10
71096046275,71096046276,1,1727,2109,10
71099699314,71099699313,-1,844,1475,10
71104067703,71104067699,-4,1572,1988,10
71110433145,71110433146,1,1039,1479,10
71112637763,71112637761,-2,1276,2155,10
71115627350,71115627348,-2,1140,2364,10
71117605533,71117605530,-3,1059,2202,10
71118913601,71118913597,-4,2187,6217,10
71119388476,71119388470,-6,1077,1328,10
71126356915,71126356913,-2,1459,2411,10
71128228896,71128228899,3,20649,19271,10
71132281866,71132281865,-1,1216,1807,10
71136892245,71136892242,-3,1217,1012,10
71138282220,71138282219,-1,1347,1723,10
71139333686,71139333683,-3,1008,2605,10
71141407659,71141407659,0,1162,1399,10
71141677168,71141677167,-1,1175,1987,10
71142328654,71142328653,-1,1442,1986,10
71143404411,71143404410,-1,1399,2749,10
71147252765,71147252762,-3,1305,2053,10
71148498427,71148498426,-1,1317,1882,10
71152917237,71152917237,0,1613,1293,10
71153702186,71153702185,-1,1059,1402,10
71156598522,71156598522,0,1240,1695,10
71157132230,71157132229,-1,1233,2951,10
71157668489,71157668487,-2,1417,2019,10
71165419546,71165419547,1,2022,2894,10
71170526162,71170526163,1,1228,1757,10
71175743433,71175743432,-1,1402,2037,10
71183574191,71183574190,-1,1290,2461,10
71184695581,71184695580,-1,989,1706,10
71203809034,71203809034,0,1253,1809,10
71203971066,71203971066,0,1186,2009,10
71209087633,71209087634,1,1474,2304,10
71209677914,71209677933,19,626,1418,10
71212894302,71212894308,6,9679,30338,10
71216498646,71216498645,-1,1100,2469,10
71217384800,71217384797,-3,1651,2834,10
71219389938,71219389934,-4,923,1919,10
71222369795,71222369793,-2,956,1324,10
71223500472,71223500470,-2,1564,2158,10
71228840734,71228840733,-1,809,1240,10
71240202953,71240202954,1,2016,2164,10
71243128645,71243128645,0,2011,1840,10
71248064120,71248064118,-2,1304,2891,10
71250062899,71250062898,-1,931,1792,10
71250105219,71250105215,-4,861,1457,10
71252180994,71252180992,-2,1211,2872,10
71252446637,71252446635,-2,1267,1813,10
71253572365,71253572366,1,1407,2234,10
71259596885,71259596884,-1,1149,1392,10
71263802323,71263802320,-3,1162,1714,10
71265435021,71265435021,0,38968,53533,10
71266483262,71266483267,5,1033,1306,10
71266533714,71266533720,6,3434,1142,10
71269637951,71269637946,-5,946,2716,10
71280259605,71280259602,-3,1458,2609,10
71280630332,71280630346,14,370,811,10
71283553183,71283553182,-1,1383,1553,10
71285600191,71285600189,-2,1031,1810,10
71290438187,71290438187,0,1638,2280,10
71291979239,71291979238,-1,1197,1803,10
71292161697,71292161698,1,975,1901,10
71293303890,71293303889,-1,561,1550,10
71294352469,71294352468,-1,1043,1974,10
71296468474,71296468474,0,822,1509,10
71299443281,71299443282,1,1413,2941,10
71299809366,71299809366,0,1512,1924,10
71300350730,71300350729,-1,1240,1595,10
71303671143,71303671141,-2,1074,1739,10
71314665225,71314665222,-3,1178,1777,10
71318263464,71318263463,-1,1419,2345,10
71319097744,71319097741,-3,1306,2415,10
71319654534,71319654530,-4,878,1339,10
71320161774,71320161774,0,1068,1781,10
71321435591,71321435590,-1,1113,2354,10
71321562527,71321562525,-2,952,1273,10
71325199961,71325199959,-2,1231,1795,10
71326156529,71326156529,0,1510,2349,10
71328331010,71328331010,0,890,2118,10
71328848431,71328848431,0,1118,1485,10
71331143799,71331143796,-3,1258,1819,10
71337599905,71337599903,-2,1121,2613,10
71337658392,71337658379,-13,814,1835,10
71342092315,71342092313,-2,1140,1868,10
71342859526,71342859525,-1,1412,1679,10
71344098626,71344098625,-1,1051,1998,10
71347098310,71347098312,2,1935,1758,10
71348401723,71348401721,-2,991,1969,10
71349929806,71349929806,0,1625,2077,10
71353974977,71353974974,-3,1671,2340,10
71356093547,71356093545,-2,995,1281,10
71359922919,71359922917,-2,858,1320,10
71360086846,71360086843,-3,899,2046,10
71361434447,71361434445,-2,1519,1844,10
71366116780,71366116780,0,958,1821,10
71372729719,71372729719,0,1352,1219,10
71373376024,71373376021,-3,1082,1837,10
71384792802,71384792799,-3,1851,2202,10
71385635798,71385635798,0,1444,1939,10
71387257912,71387257931,19,1588,1528,10
71392726506,71392726499,-7,4313,17163,10
71395481299,71395481299,0,681,1822,10
71399509051,71399509047,-4,989,2388,10
71400188982,71400188982,0,1665,2198,10
71401002585,71401002583,-2,1200,2409,10
71405062402,71405062403,1,903,2268,10
71406480219,71406480216,-3,984,2070,10
71408009091,71408009095,4,2098,1192,10
71409881481,71409881477,-4,729,1252,10
71410232831,71410232829,-2,661,1582,10
71410542795,71410542794,-1,1117,1798,10
71415933563,71415933557,-6,1092,2615,10
71416645763,71416645782,19,1701,6977,10
71418556019,71418556019,0,1175,1539,10
71420773943,71420773942,-1,994,2128,10
71427332619,71427332617,-2,1064,1943,10
71429393854,71429393861,7,4175,1509,10
71429997641,71429997642,1,1332,1670,10
71436873399,71436873396,-3,1639,4094,10
71439651470,71439651469,-1,1603,2285,10
71439743413,71439743413,0,1029,2068,10
71441679849,71441679851,2,1519,2011,10
71442096867,71442096866,-1,976,1982,10
71449890698,71449890698,0,1615,2641,10
71450984937,71450984934,-3,1293,2010,10
71452280830,71452280829,-1,1116,2098,10
71455378286,71455378284,-2,1164,1444,10
71455969149,71455969146,-3,986,1602,10
71456447074,71456447075,1,1481,2227,10
71458426847,71458426849,2,818,1095,10
71459687834,71459687846,12,510,1424,10
71463423132,71463423131,-1,1476,1884,10
71464168284,71464168283,-1,1575,2609,10
71464987226,71464987226,0,1348,2332,10
71471667534,71471667534,0,1018,1565,10
71473592313,71473592306,-7,1051,7076,10
71474148722,71474148719,-3,1104,1550,10
71474739015,71474739011,-4,1250,2451,10
71475067352,71475067351,-1,936,1467,10
71483901050,71483901050,0,1022,1424,10
71484740067,71484740067,0,753,1172,10
71487738129,71487738126,-3,1020,2573,10
71492394165,71492394162,-3,891,2635,10
71493021888,71493021886,-2,1708,1875,10
71494200255,71494200252,-3,946,1312,10
71496143563,71496143559,-4,1241,1477,10
71497619402,71497619400,-2,1669,1644,10
71500220796,71500220795,-1,916,1885,10
71503255873,71503255872,-1,1196,1590,10
71504963298,71504963296,-2,1373,2312,10
71508616202,71508616202,0,1479,1683,10
71523395195,71523395195,0,1123,1822,10
71525320769,71525320774,5,2605,2026,10
71528112848,71528112846,-2,1516,3476,10
71529381774,71529381773,-1,1444,2451,10
71530164589,71530164585,-4,1373,2257,10
71531914452,71531914467,15,18,1972,10
71532330265,71532330270,5,3128,1265,10
71536426842,71536426844,2,460,1775,10
71539016785,71539016785,0,1009,985,10
71539476579,71539476578,-1,2044,2074,10
71540362432,71540362430,-2,1301,2180,10
71542492539,71542492537,-2,1026,1937,10
71547173734,71547173739,5,3342,1491,10
71549002210,71549002208,-2,1093,1244,10
71551221662,71551221664,2,1311,1239,10
71551992789,71551992795,6,5254,1702,10
71558602692,71558602684,-8,1030,1562,10
71559296547,71559296544,-3,945,2298,10
71561616595,71561616594,-1,1051,3177,10
71561702118,71561702118,0,1402,2013,10
71565384066,71565384066,0,1409,1343,10
71567929598,71567929596,-2,991,1505,10
71569301919,71569301918,-1,1535,2758,10
71571116970,71571116969,-1,1657,2159,10
71575202695,71575202693,-2,1195,2297,10
71575538274,71575538274,0,1378,1093,10
71576277230,71576277227,-3,940,1348,10
71578033921,71578033921,0,1120,1758,10
71578835886,71578835886,0,1300,3091,10
71579324202,71579324199,-3,736,1090,10
71588033757,71588033754,-3,1733,2719,10
71591904723,71591904720,-3,992,2538,10
71592739434,71592739430,-4,1046,1865,10
71596171954,71596171959,5,1569,1299,10
71597263541,71597263546,5,2179,1389,10
71597620903,71597620902,-1,1085,2674,10
71599538339,71599538338,-1,1791,2904,10
71600818439,71600818442,3,1793,1472,10
71603060892,71603060888,-4,1039,2558,10
71612503462,71612503462,0,1182,1037,10
71613115850,71613115854,4,1210,1476,10
71614336115,71614336113,-2,864,2157,10
71615503650,71615503652,2,1765,2889,10
71616442231,71616442230,-1,834,1193,10
71618423175,71618423174,-1,1542,2599,10
71618629738,71618629735,-3,1198,2556,10
71620529627,71620529625,-2,1173,1771,10
71622819498,71622819498,0,1791,2163,10
71632471946,71632471945,-1,955,2650,10
71637729139,71637729139,0,1309,1752,10
71638922731,71638922731,0,1128,1413,10
71640776286,71640776283,-3,956,2621,10
71641882900,71641882899,-1,1740,1460,10
71644523489,71644523489,0,1167,1888,10
71649476261,71649476258,-3,1099,1856,10
71651393555,71651393558,3,1422,1887,10
71652837562,71652837561,-1,1644,2714,10
71657816319,71657816317,-2,1181,2338,10
71662208618,71662208617,-1,1264,1418,10
71662381731,71662381730,-1,1024,1538,10
71663215501,71663215499,-2,1156,1935,10
71666276282,71666276289,7,3134,1220,10
71666713131,71666713130,-1,1409,2876,10
71673436591,71673436591,0,1108,1350,10
71675092996,71675092993,-3,1195,1798,10
71676034966,71676034966,0,1093,2209,10
71684193038,71684193037,-1,1307,2099,10
71684460754,71684460770,16,757,1494,10
71688473538,71688473537,-1,1056,2410,10
71689207533,71689207534,1,1665,2495,10
71689318790,71689318795,5,4856,3013,10
71693367928,71693367918,-10,931,1980,10
71695451766,71695451763,-3,1507,2465,10
71696179608,71696179605,-3,20469,12889,10
71702670673,71702670671,-2,1429,1830,10
71705791199,71705791199,0,726,1169,10
71710240774,71710240773,-1,1668,2601,10
71715493559,71715493558,-1,659,1365,10
71716188825,71716188823,-2,1262,1578,10
71717381347,71717381344,-3,1916,2290,10
71719632722,71719632722,0,1450,1224,10
71722108965,71722108965,0,1567,2496,10
71724111921,71724111918,-3,1406,1382,10
71724608360,71724608362,2,1542,2088,10
71726497118,71726497118,0,1459,2035,10
71726669971,71726669969,-2,1746,3793,10
71730078294,71730078293,-1,1447,1621,10
71730261077,71730261078,1,1245,1573,10
71732128543,71732128542,-1,1796,2347,10
71733306337,71733306324,-13,979,1319,10
71736241095,71736241094,-1,1326,2709,10
71740614488,71740614487,-1,989,2003,10
71740695839,71740695834,-5,48753,24035,10
71742290226,71742290225,-1,1777,2469,10
71744105148,71744105150,2,1263,1203,10
71746475601,71746475599,-2,1077,1580,10
71750048435,71750048432,-3,1055,1871,10
71750191534,71750191529,-5,934,1886,10
71753413386,71753413386,0,1303,1862,10
71754816586,71754816587,1,1219,2178,10
71758562543,71758562562,19,696,1591,10
71762781763,71762781761,-2,1296,2184,10
71764982678,71764982699,21,1116,2207,10
71765951727,71765951727,0,1399,1961,10
71768332574,71768332574,0,2834,3899,10
71768991098,71768991097,-1,1551,2101,10
71769652859,71769652859,0,811,1217,10
71770406009,71770405996,-13,3129,1520,10
71784230607,71784230611,4,3535,1934,10
71784793653,71784793652,-1,1372,2005,10
71789588081,71789588082,1,1324,1953,10
71791134269,71791134262,-7,1390,5928,10
71791755974,71791755971,-3,1296,2606,10
71796355046,71796355046,0,1275,1518,10
71798176409,71798176411,2,2071,1729,10
71799442854,71799442853,-1,1114,1331,10
71801886186,71801886186,0,994,1601,10
71802540958,71802540956,-2,908,1240,10
71807697190,71807697190,0,1435,1847,10
71808199507,71808199507,0,1078,1675,10
71808829058,71808829060,2,1475,1925,10
71809760158,71809760156,-2,1646,1984,10
71810753106,71810753105,-1,1249,2190,10
71813269235,71813269234,-1,1004,2418,10
71814176071,71814176071,0,1418,1499,10
71814809839,71814809836,-3,890,1873,10
71816047650,71816047650,0,1530,1484,10
71823848730,71823848730,0,1107,1995,10
71825689015,71825689012,-3,1433,3333,10
71827475447,71827475460,13,12554,50220,10
71828895023,71828895021,-2,1414,1848,10
71832303385,71832303382,-3,1474,1307,10
71840361851,71840361855,4,1464,1060,10
71841649330,71841649327,-3,1389,1642,10
71844064578,71844064578,0,984,2393,10
71844145554,71844145553,-1,988,2311,10
71850555822,71850555822,0,1284,1891,10
71852060341,71852060338,-3,2439,4035,10
71853770556,71853770554,-2,1320,2149,10
71855949356,71855949354,-2,1188,2124,10
71856831494,71856831494,0,2095,2998,10
71859699838,71859699837,-1,1222,1750,10
71860301908,71860301907,-1,1348,1918,10
71861366839,71861366839,0,908,1788,10
71863020602,71863020599,-3,1383,2049,10
71863293566,71863293566,0,1733,2585,10
71865303658,71865303652,-6,1379,2148,10
71866165534,71866165530,-4,887,3848,10
71867651146,71867651141,-5,1208,2304,10
71868095507,71868095487,-20,1140,2381,10
71868637402,71868637381,-21,1100,1959,10
71876197483,71876197483,0,1366,2169,10
71878267845,71878267844,-1,1297,2341,10
71878777957,71878777957,0,845,1251,10
71893299723,71893299723,0,1361,2143,10
71893350547,71893350548,1,8017,9120,10
71897449090,71897449090,0,1353,1604,10
71899730390,71899730392,2,1374,1922,10
71901263913,71901263910,-3,884,1390,10
71901611331,71901611329,-2,1077,2180,10
71901698405,71901698403,-2,1383,2361,10
71901791221,71901791220,-1,1039,2361,10
71902389562,71902389583,21,594,812,10
71903520527,71903520527,0,242,928,10
71905726318,71905726317,-1,965,1343,10
71906766847,71906766846,-1,906,1471,10
71912839203,71912839202,-1,1457,2008,10
71916564517,71916564515,-2,1608,2308,10
71923114238,71923114235,-3,1836,2182,10
71927630211,71927630209,-2,1015,1519,10
71927936941,71927936942,1,1359,1748,10
71929035622,71929035622,0,1270,1836,10
71929706117,71929706115,-2,1186,1726,10
71931232017,71931232018,1,1584,1960,10
71935035187,71935035194,7,6645,2177,10
71945252962,71945252962,0,1245,2217,10
71948953621,71948953618,-3,1407,1834,10
71952728746,71952728746,0,1635,2028,10
71965803343,71965803342,-1,1318,1703,10
71969069889,71969069887,-2,1664,2491,10
71970276363,71970276363,0,1401,1798,10
71971212018,71971212020,2,4845,23310,10
71977955497,71977955498,1,1670,1789,10
71986708458,71986708457,-1,1487,2038,10
71986782054,71986782053,-1,1168,1896,10
71990725274,71990725272,-2,1029,2216,10
72008165175,72008165174,-1,1138,2194,10
72009637440,72009637438,-2,1549,2611,10
72012480935,72012480932,-3,938,2488,10
72015205978,72015205976,-2,1301,2300,10
72017535411,72017535409,-2,1067,2025,10
72018275335,72018275334,-1,1158,2522,10
72018744998,72018744990,-8,2421,14856,10
72018843144,72018843143,-1,1423,1501,10
72019315568,72019315569,1,1432,1640,10
72023144037,72023144036,-1,1469,1735,10
72025260721,72025260718,-3,896,2228,10
72033262147,72033262145,-2,740,1654,10
72035011634,72035011633,-1,1505,2097,10
72037877474,72037877478,4,4268,1931,10
72041124253,72041124254,1,1789,1674,10
72043914602,72043914600,-2,1555,2682,10
72047076364,72047076363,-1,1129,1884,10
72051251233,72051251231,-2,1042,1500,10
72055607894,72055607893,-1,1767,2274,10
72063006521,72063006518,-3,1372,2512,10
72064405670,72064405658,-12,11474,40446,10
72066038445,72066038451,6,2712,1270,10
72073732575,72073732571,-4,855,2238,10
72074938329,72074938329,0,839,1913,10
72079041717,72079041714,-3,1222,1896,10
72080944086,72080944088,2,2827,2050,10
72081447860,72081447857,-3,1374,1612,10
72082915807,72082915806,-1,816,1677,10
72084432990,72084432988,-2,1542,2137,10
72085676799,72085676797,-2,1056,1805,10
72086365202,72086365200,-2,1075,2038,10
72094788877,72094788876,-1,848,1816,10
72095389539,72095389538,-1,1457,2316,10
72097369583,72097369581,-2,1103,2825,10
72098217843,72098217843,0,29317,20156,10
72099678854,72099678854,0,1089,1713,10
72100273160,72100273144,-16,1374,2316,10
72104130691,72104130689,-2,973,2428,10
72106881786,72106881783,-3,1065,1536,10
72108348809,72108348808,-1,1410,1811,10
72111842767,72111842766,-1,968,2129,10
72113203215,72113203215,0,998,2105,10
72114111577,72114111576,-1,1057,2109,10
72117498225,72117498224,-1,1019,2264,10
72119498653,72119498652,-1,854,1768,10
72120109271,72120109269,-2,1957,4364,10
72120227898,72120227896,-2,886,1895,10
72124369254,72124369253,-1,1190,1594,10
72125614701,72125614698,-3,862,936,10
72128569247,72128569243,-4,1022,2124,10
72140166963,72140166958,-5,778,2070,10
72144646340,72144646338,-2,1099,2393,10
72150099007,72150099005,-2,1469,2450,10
72153624374,72153624371,-3,1097,2199,10
72154406843,72154406836,-7,1059,2018,10
72154741922,72154741921,-1,1750,1532,10
72155890585,72155890584,-1,1124,2209,10
72156548122,72156548119,-3,1232,1654,10
72158294241,72158294238,-3,1320,2129,10
72162743472,72162743468,-4,763,1999,10
72164563441,72164563448,7,2188,1633,10
72164757842,72164757841,-1,1029,2059,10
72166999639,72166999638,-1,1506,1870,10
72168607525,72168607524,-1,2670,3827,10
72171365809,72171365788,-21,1621,2202,10
72171558890,72171558888,-2,1933,2734,10
72173402964,72173402961,-3,1324,1876,10
72175683390,72175683389,-1,1662,1983,10
72178667785,72178667783,-2,1158,1810,10
72184317287,72184317293,6,3016,1643,10
72185167713,72185167712,-1,1252,2120,10
72188074261,72188074257,-4,1475,2507,10
72188592089,72188592088,-1,1580,2363,10
72189109438,72189109437,-1,1226,1657,10
72190861348,72190861347,-1,1465,2196,10
72195053725,72195053725,0,1499,1997,10
72196251343,72196251342,-1,1150,1811,10
72196631719,72196631718,-1,1236,2097,10
72198023761,72198023759,-2,980,2008,10
72198493619,72198493618,-1,1310,1678,10
72201139694,72201139693,-1,919,1754,10
72205517584,72205517582,-2,1669,2350,10
72208288212,72208288210,-2,1132,1666,10
72208433626,72208433643,17,760,2145,10
72209376000,72209375998,-2,1703,2689,10
72209775590,72209775595,5,1511,830,10
72211392498,72211392497,-1,1126,1832,10
72211460079,72211460077,-2,1170,2167,10
72212107359,72212107357,-2,1035,1674,10
72213089424,72213089422,-2,1055,1704,10
72217231568,72217231567,-1,970,1420,10
72222029553,72222029567,14,1185,1464,10
72222166679,72222166675,-4,1272,2586,10
72222983475,72222983475,0,820,1560,10
72226304659,72226304660,1,1285,1903,10
72226697125,72226697125,0,1327,2445,10
72227678799,72227678798,-1,1306,1969,10
72231788680,72231788682,2,1725,1697,10
72232333511,72232333509,-2,1304,1485,10
72240866257,72240866262,5,2650,1996,10
72243822282,72243822278,-4,1037,1238,10
72245343682,72245343685,3,4546,4904,10
72247211606,72247211604,-2,924,1996,10
72248192725,72248192721,-4,1149,2000,10
72253501247,72253501245,-2,1323,1208,10
72254046131,72254046129,-2,1126,1479,10
72255471670,72255471668,-2,993,1531,10
72256092054,72256092053,-1,1652,1853,10
72256553574,72256553574,0,1217,1905,10
72262850514,72262850513,-1,953,1765,10
72263288698,72263288694,-4,1366,1865,10
72264021035,72264021034,-1,2060,2547,10
72264228778,72264228777,-1,1153,1789,10
72264949083,72264949082,-1,1316,1809,10
72268480522,72268480521,-1,1261,2223,10
72268949678,72268949677,-1,1360,2228,10
72272128733,72272128732,-1,1034,1581,10
72272768373,72272768372,-1,1121,1968,10
72278806789,72278806787,-2,1320,1534,10
72279271371,72279271370,-1,1817,2673,10
72281312485,72281312482,-3,1313,2730,10
72284394197,72284394195,-2,953,2118,10
72286166462,72286166461,-1,985,2643,10
72286366402,72286366415,13,951,11832,10
72286561744,72286561726,-18,967,1440,10
72286671708,72286671715,7,12556,22797,10
72287035667,72287035666,-1,1289,1681,10
72288594149,72288594149,0,1572,1585,10
72292737553,72292737553,0,1686,2480,10
72292819342,72292819341,-1,1916,2096,10
72293228343,72293228342,-1,707,1919,10
72294290786,72294290783,-3,623,1548,10
72295108567,72295108568,1,1707,2037,10
72301177587,72301177586,-1,1607,2786,10
72303823760,72303823759,-1,822,1054,10
72304419419,72304419417,-2,1191,1585,10
72306594550,72306594549,-1,1022,1605,10
72308174936,72308174926,-10,751,1524,10
72309116731,72309116730,-1,1171,1840,10
72311859303,72311859303,0,1896,1762,10
72314653870,72314653869,-1,1449,3056,10
72316130519,72316130518,-1,909,1758,10
72317890114,72317890112,-2,667,1474,10
72317959612,72317959611,-1,1151,1987,10
72320556106,72320556106,0,1305,1591,10
72322128541,72322128540,-1,1163,1724,10
72323290294,72323290301,7,3409,1469,10
72324345873,72324345872,-1,1109,1880,10
72330520607,72330520606,-1,1597,1989,10
72332132758,72332132757,-1,1344,2306,10
72335203798,72335203797,-1,1312,1814,10
72337026983,72337026985,2,950,1360,10
72341111794,72341111792,-2,1054,2081,10
72344966327,72344966322,-5,726,1202,10
72346435519,72346435518,-1,926,1868,10
72346487537,72346487536,-1,1514,2457,10
72353890666,72353890663,-3,1122,1783,10
72354155966,72354155973,7,3860,1140,10
72354459129,72354459126,-3,1079,2568,10
72355553264,72355553265,1,1037,1665,10
72360916847,72360916831,-16,1154,425,10
72364456596,72364456590,-6,902,2040,10
72367622591,72367622589,-2,1294,1851,10
72368064138,72368064137,-1,987,2340,10
72369531993,72369531990,-3,1322,2697,10
72369994242,72369994241,-1,1356,2240,10
72379164398,72379164408,10,13248,49823,10
72382180589,72382180583,-6,1360,2662,10
72382968390,72382968389,-1,832,1557,10
72385709415,72385709414,-1,997,1873,10
72386165170,72386165168,-2,1552,3032,10
72387634649,72387634646,-3,1099,2752,10
72388702399,72388702395,-4,1248,1651,10
72389295140,72389295139,-1,1634,1363,10
72396820963,72396820962,-1,1457,2484,10
72399895545,72399895543,-2,1236,1888,10
72400001074,72400001057,-17,1007,2476,10
72404111621,72404111619,-2,920,1094,10
72405416374,72405416373,-1,1193,2198,10
72406598378,72406598377,-1,1094,1761,10
72407908706,72407908705,-1,1137,2184,10
72408789071,72408789073,2,1521,1351,10
72409101770,72409101756,-14,1412,2253,10
72410597957,72410597956,-1,934,1746,10
72411615471,72411615469,-2,1177,1693,10
72414274909,72414274906,-3,1157,2263,10
72421136385,72421136385,0,950,1983,10
72423450416,72423450415,-1,1472,1890,10
72424200227,72424200223,-4,1496,2308,10
72424794933,72424794930,-3,1721,2345,10
72426699986,72426699987,1,1180,1728,10
72430904534,72430904533,-1,941,1278,10
72432326048,72432326047,-1,1722,1660,10
72433513740,72433513740,0,1601,1337,10
72433573936,72433573938,2,37081,15842,10
72434582442,72434582442,0,1199,1881,10
72435591074,72435591073,-1,967,1281,10
72436445582,72436445582,0,1723,1530,10
72437661927,72437661930,3,1714,1559,10
72438504009,72438504007,-2,1318,2409,10
72442804693,72442804690,-3,1282,2005,10
72443008667,72443008664,-3,1467,2909,10
72444212647,72444212645,-2,1562,2299,10
72447640750,72447640753,3,2165,1870,10
72447885972,72447885970,-2,1504,2087,10
72449645586,72449645585,-1,972,1324,10
72455369590,72455369588,-2,1389,2397,10
72455740618,72455740618,0,1647,2085,10
72458374226,72458374226,0,1171,1654,10
72459496956,72459496950,-6,884,3321,10
72464946448,72464946447,-1,1637,2607,10
72466298675,72466298656,-19,1470,1913,10
72468803022,72468803020,-2,1472,2549,10
72471733627,72471733625,-2,1937,2530,10
72473570357,72473570353,-4,1288,2194,10
72476542110,72476542107,-3,908,1943,10
72482417410,72482417408,-2,1343,2517,10
72483683246,72483683246,0,674,1362,10
72491432926,72491432927,1,1979,2064,10
72491558050,72491558047,-3,1718,2125,10
72494941963,72494941961,-2,1225,2246,10
72495383466,72495383471,5,2962,1017,10
72496091306,72496091302,-4,1173,1400,10
72499569514,72499569511,-3,18612,50100,10
72502114789,72502114787,-2,1405,2325,10
72503814024,72503814022,-2,483,1640,10
72510932879,72510932879,0,1590,2134,10
72512449922,72512449918,-4,891,1443,10
72513723094,72513723094,0,1263,1652,10
72515055688,72515055670,-18,890,1798,10
72515418939,72515418938,-1,1015,1947,10
72516391218,72516391217,-1,1198,2061,10
72519306499,72519306498,-1,1335,2155,10
72522757955,72522757954,-1,1414,1967,10
72523471625,72523471623,-2,1214,1605,10
72524438488,72524438484,-4,1365,2276,10
72530397460,72530397457,-3,1442,2292,10
72530509950,72530509957,7,3084,978,10
72531146347,72531146362,15,1201,1732,10
72536719416,72536719414,-2,1084,1869,10
72540358818,72540358818,0,1500,2294,10
72542835930,72542835929,-1,1145,2347,10
72544112450,72544112445,-5,17156,70798,10
72550186481,72550186481,0,1307,1975,10
72551574823,72551574821,-2,1244,1457,10
72551777323,72551777319,-4,1065,1926,10
72553119691,72553119689,-2,1001,1675,10
72557480966,72557480964,-2,1065,2015,10
72559714702,72559714702,0,1092,1831,10
72564093854,72564093852,-2,1265,1163,10
72565651002,72565651001,-1,775,1324,10
72571569755,72571569754,-1,1042,2258,10
72578403379,72578403375,-4,1181,1703,10
72579774791,72579774788,-3,1252,1706,10
72580820630,72580820627,-3,1322,2034,10
72582390182,72582390182,0,1703,2077,10
72587078358,72587078365,7,2443,1467,10
72591892014,72591892009,-5,1184,1736,10
72595524430,72595524427,-3,1320,1799,10
72597796723,72597796722,-1,1005,1612,10
72601413526,72601413523,-3,1552,2058,10
72602610351,72602610349,-2,1092,1790,10
72603074270,72603074270,0,446,1007,10
72608445948,72608445946,-2,1489,1827,10
72611947651,72611947650,-1,1101,1676,10
72613545021,72613545021,0,1153,1785,10
72614276558,72614276557,-1,1121,2265,10
72616728409,72616728410,1,1223,1208,10
72619295538,72619295537,-1,1090,1777,10
72619765125,72619765126,1,1653,1891,10
72621845090,72621845090,0,932,2136,10
72622837072,72622837070,-2,1213,1586,10
72632967254,72632967250,-4,1430,1727,10
72636683387,72636683386,-1,1279,2279,10
72639478169,72639478165,-4,894,1938,10
72639931779,72639931759,-20,46161,26446,10
72644235897,72644235895,-2,1467,2514,10
72647008338,72647008337,-1,1532,2514,10
72652693582,72652693580,-2,1446,2130,10
72654230244,72654230242,-2,1309,2261,10
72656664680,72656664679,-1,1012,2014,10
72661519791,72661519789,-2,2798,4784,10
72661573146,72661573146,0,1734,2772,10
72662487749,72662487748,-1,1452,1777,10
72662661064,72662661063,-1,1267,2040,10
72665798604,72665798607,3,3287,2986,10
72665917332,72665917332,0,1273,2700,10
72666056607,72666056605,-2,1008,1627,10
72668053843,72668053842,-1,34522,30267,10
72671215927,72671215925,-2,858,2162,10
72672654675,72672654673,-2,1353,2096,10
72674836869,72674836875,6,3200,1064,10
72681407735,72681407732,-3,752,1637,10
72688553956,72688553957,1,3416,4123,10
72690880853,72690880853,0,904,1220,10
72691864064,72691864065,1,1741,1923,10
72692207063,72692207061,-2,1101,2167,10
72696760826,72696760825,-1,1215,1889,10
72697393967,72697393965,-2,1059,3269,10
72697494367,72697494365,-2,1074,1978,10
72697815394,72697815393,-1,1695,2093,10
72698533453,72698533452,-1,1407,2137,10
72703375650,72703375647,-3,803,2809,10
72703496066,72703496063,-3,1394,2403,10
72707665505,72707665504,-1,1377,1920,10
72709181147,72709181139,-8,1105,1401,10
72712044823,72712044823,0,923,1598,10
72712679398,72712679394,-4,1095,1698,10
72712803019,72712803018,-1,1134,2070,10
72717376442,72717376441,-1,1046,938,10
72717543987,72717543986,-1,823,1758,10
72717654939,72717654937,-2,1178,2502,10
72722741699,72722741697,-2,1167,2258,10
72724321075,72724321073,-2,799,2015,10
72725232812,72725232809,-3,870,2034,10
72731546038,72731546036,-2,761,1736,10
72734649082,72734649071,-11,390,8820,10
72736405938,72736405938,0,1047,1928,10
72738010002,72738010001,-1,1211,1966,10
72741921012,72741921011,-1,1687,1195,10
72749118738,72749118717,-21,3523,1565,10
72749757238,72749757237,-1,1363,1768,10
72750130038,72750130035,-3,671,1889,10
72750421515,72750421535,20,544,1196,10
72751066261,72751066261,0,760,1305,10
72751583753,72751583751,-2,869,1942,10
72752782086,72752782081,-5,1198,1375,10
72755953826,72755953823,-3,1089,2153,10
72756130289,72756130309,20,14126,44661,10
72757239902,72757239910,8,4079,1380,10
72760586778,72760586778,0,1041,1774,10
72763922532,72763922541,9,18223,55369,10
72767208685,72767208684,-1,1203,1999,10
72768535601,72768535601,0,1030,1604,10
72769015733,72769015738,5,2689,1466,10
72769073622,72769073603,-19,1318,1556,10
72772621318,72772621317,-1,1722,2259,10
72775719882,72775719877,-5,1116,2026,10
72776383976,72776383975,-1,1370,1964,10
72788648048,72788648054,6,4705,2796,10
72792628783,72792628783,0,1396,2066,10
72792687735,72792687733,-2,1008,2190,10
72795691962,72795691961,-1,1671,2327,10
72797310762,72797310760,-2,1527,2141,10
72798902782,72798902781,-1,1459,2025,10
72799590524,72799590523,-1,1747,3098,10
72803812502,72803812502,0,1139,1296,10
72804971286,72804971286,0,1282,1725,10
72808863386,72808863385,-1,1106,1914,10
72809688670,72809688668,-2,1234,2366,10
72810773611,72810773609,-2,1315,2396,10
72813387205,72813387204,-1,42819,19212,10
72813908863,72813908862,-1,941,1632,10
72814306539,72814306538,-1,1480,1975,10
72816590253,72816590232,-21,1705,1916,10
72817620562,72817620562,0,1253,1884,10
72819056861,72819056859,-2,1778,2035,10
72827532511,72827532511,0,999,1362,10
72831208087,72831208085,-2,1201,1785,10
72831887265,72831887263,-2,1644,2762,10
72832237225,72832237225,0,1118,2138,10
72832545993,72832545990,-3,1828,3585,10
72833444697,72833444698,1,1221,1791,10
72835356101,72835356100,-1,1194,2208,10
72836466797,72836466797,0,1203,1631,10
72836533850,72836533849,-1,1326,1275,10
72836834378,72836834378,0,1109,2077,10
72837282531,72837282528,-3,1162,1775,10
72838541754,72838541752,-2,1365,1818,10
72843324725,72843324725,0,865,1227,10
72851072578,72851072577,-1,1035,1703,10
72851714015,72851714025,10,1235,1156,10
72851795248,72851795249,1,1173,1612,10
72851961943,72851961943,0,1656,2041,10
72858020267,72858020266,-1,1446,1767,10
72858078678,72858078677,-1,1066,1741,10
72858446378,72858446389,11,346,1512,10
72858889082,72858889080,-2,1186,1735,10
72860977305,72860977314,9,1524,1839,10
72862680367,72862680365,-2,1231,2565,10
72864824013,72864824012,-1,1453,2499,10
72869092226,72869092225,-1,1139,1484,10
72869615721,72869615721,0,1364,2589,10
72876983686,72876983691,5,2391,1609,10
72881310322,72881310321,-1,1600,2202,10
72882984081,72882984082,1,1145,1636,10
72885566727,72885566726,-1,975,1380,10
72887355965,72887355963,-2,1326,2545,10
72889159515,72889159515,0,914,1593,10
72889272718,72889272718,0,1377,1779,10
72897291886,72897291890,4,1173,1740,10
72899104297,72899104295,-2,927,2320,10
72903102529,72903102527,-2,1408,1847,10
72904259643,72904259644,1,1355,1573,10
72906164982,72906164981,-1,1074,1768,10
72907450895,72907450894,-1,987,1356,10
72907542975,72907542973,-2,751,1043,10
72907805169,72907805150,-19,1271,1930,10
72910217558,72910217555,-3,1074,2433,10
72913904591,72913904592,1,877,1455,10
72916614493,72916614491,-2,1220,1739,10
72919033451,72919033449,-2,952,1607,10
72919557040,72919557038,-2,1282,1486,10
72922134558,72922134557,-1,1154,1445,10
72928544945,72928544947,2,3251,4132,10
72931341980,72931341978,-2,1170,2581,10
72933156499,72933156501,2,1261,1192,10
72934308930,72934308925,-5,1297,4640,10
72941944478,72941944475,-3,1023,2137,10
72949109982,72949109984,2,1916,1234,10
72950249765,72950249762,-3,1902,4945,10
72951020946,72951020944,-2,1154,2438,10
72953034178,72953034177,-1,781,1887,10
72954072810,72954072809,-1,1218,1998,10
72955508903,72955508901,-2,1138,1703,10
72955862353,72955862352,-1,3294,4843,10
72956827839,72956827835,-4,1205,2092,10
72959878351,72959878347,-4,954,1597,10
72960692623,72960692625,2,1206,2190,10
72962062175,72962062173,-2,1815,2080,10
72970744798,72970744796,-2,1174,1997,10
72971863426,72971863423,-3,1412,1927,10
72976944352,72976944351,-1,1524,2134,10
72978165999,72978165998,-1,1110,1922,10
72979325367,72979325366,-1,1013,2442,10
72980371726,72980371723,-3,1634,2043,10
72980585077,72980585077,0,1580,2193,10
72983227401,72983227401,0,1229,1875,10
72985539875,72985539865,-10,1418,1706,10
72992937850,72992937850,0,1925,2546,10
72993583371,72993583373,2,2501,2466,10
73002311143,73002311143,0,1552,1888,10
73002482651,73002482652,1,654,1772,10
73008502562,73008502558,-4,1219,1559,10
73011321302,73011321305,3,2329,1727,10
73012340576,73012340576,0,1600,2813,10
73015218839,73015218843,4,2700,1414,10
73017297912,73017297910,-2,2175,2391,10
73017647937,73017647937,0,1674,2227,10
73017843251,73017843250,-1,1164,1400,10
73019999016,73019999014,-2,1767,1973,10
73020304732,73020304730,-2,948,2326,10
73027087463,73027087461,-2,990,1774,10
73028843330,73028843326,-4,520,2014,10
73031325175,73031325173,-2,1019,2526,10
73032257680,73032257680,0,881,980,10
73034688194,73034688192,-2,812,2103,10
73035705769,73035705768,-1,1145,3125,10
73036546752,73036546738,-14,746,930,10
73039250456,73039250451,-5,597,1794,10
73040281355,73040281355,0,1185,2499,10
73051582321,73051582321,0,992,1237,10
73053000940,73053000935,-5,829,1457,10
73053786863,73053786860,-3,1719,2302,10
73054320580,73054320578,-2,1091,1722,10
73055419374,73055419369,-5,1410,2727,10
73060001951,73060001950,-1,1600,3027,10
73060743767,73060743766,-1,1214,1823,10
73060949481,73060949479,-2,1556,1846,10
73061967090,73061967089,-1,1072,1587,10
73063407154,73063407154,0,1112,1854,10
73068202395,73068202394,-1,1299,2093,10
73068710681,73068710681,0,1070,1925,10
73071652080,73071652085,5,3118,1922,10
73072451667,73072451666,-1,1253,1468,10
73076432134,73076432133,-1,1198,2050,10
73077141018,73077141038,20,1564,2096,10
73077878641,73077878641,0,859,1834,10
73080219078,73080219072,-6,1690,6652,10
73080758651,73080758650,-1,1137,2067,10
73081032201,73081032205,4,1168,1214,10
73081092033,73081092049,16,280,1477,10
73082303141,73082303137,-4,1282,1979,10
73083490779,73083490778,-1,1597,2395,10
73088785078,73088785075,-3,852,1834,10
73090827346,73090827345,-1,1069,2686,10
73093711456,73093711454,-2,1271,2792,10
73094932518,73094932515,-3,1304,2333,10
73097754515,73097754511,-4,1251,1628,10
73099393539,73099393543,4,2778,1370,10
73104844904,73104844910,6,4927,1673,10
73105153698,73105153697,-1,1370,1579,10
73109589402,73109589405,3,1590,1571,10
73111940954,73111940955,1,721,1326,10
73111996409,73111996408,-1,1395,2260,10
73112444699,73112444698,-1,1190,2480,10
73112875722,73112875722,0,991,2004,10
73112919467,73112919468,1,795,1608,10
73113938700,73113938707,7,1904,989,10
73115008678,73115008678,0,1132,1549,10
73117011235,73117011237,2,952,1419,10
73124351019,73124351020,1,1150,2583,10
73126421938,73126421937,-1,804,1042,10
73131162717,73131162715,-2,1347,1603,10
73132019060,73132019058,-2,1554,1972,10
73132482137,73132482137,0,1040,1493,10
73133839958,73133839954,-4,606,1367,10
73136594949,73136594949,0,1279,1828,10
73138004695,73138004694,-1,926,1303,10
73142843434,73142843434,0,1137,1678,10
73153410605,73153410603,-2,645,1170,10
73156014210,73156014206,-4,1135,2136,10
73157072298,73157072315,17,739,1442,10
73159740485,73159740483,-2,1308,1625,10
73165832237,73165832234,-3,1214,3167,10
73166522516,73166522515,-1,1202,1961,10
73169292859,73169292857,-2,1383,2667,10
73170602389,73170602385,-4,972,1612,10
73170999285,73170999283,-2,875,1289,10
73171334643,73171334642,-1,897,1193,10
73174787787,73174787785,-2,1168,1085,10
73176742015,73176742013,-2,1140,2573,10
73179221973,73179221970,-3,1110,1858,10
73180758150,73180758150,0,958,1334,10
73182884037,73182884036,-1,1401,1807,10
73185846517,73185846515,-2,1250,2087,10
73187436622,73187436627,5,1363,1191,10
73192334287,73192334290,3,1670,1244,10
73201361542,73201361543,1,1187,1691,10
73203692300,73203692298,-2,1188,1791,10
73207559524,73207559523,-1,997,1443,10
73208817171,73208817172,1,1143,1775,10
73208943311,73208943306,-5,1470,3468,10
73211414519,73211414519,0,1305,2289,10
73215502195,73215502191,-4,1130,2832,10
73218976203,73218976202,-1,690,1466,10
73219877380,73219877398,18,563,831,10
73220309956,73220309953,-3,1634,2098,10
73221532872,73221532870,-2,1065,2280,10
73228527255,73228527254,-1,829,1636,10
73228950735,73228950735,0,1326,1968,10
73230403989,73230403987,-2,878,2574,10
73231437977,73231437980,3,964,1420,10
73235114631,73235114628,-3,1390,1865,10
73236767449,73236767449,0,6369,7254,10
73238761373,73238761370,-3,784,1908,10
73240457051,73240457047,-4,1495,1653,10
73251945470,73251945476,6,2047,1027,10
73252407950,73252407949,-1,1177,1811,10
73252571527,73252571526,-1,876,1482,10
73254684283,73254684278,-5,1991,3918,10
73255947115,73255947114,-1,1574,1899,10
73260247753,73260247757,4,1249,1296,10
73262207350,73262207350,0,924,2031,10
73267668890,73267668890,0,1849,1819,10
73268831318,73268831317,-1,943,2255,10
73270831709,73270831708,-1,1457,2471,10
73271037977,73271037978,1,317,1303,10
73271963342,73271963338,-4,1180,2557,10
73274048738,73274048736,-2,1254,2392,10
73274263877,73274263874,-3,966,1617,10
73277036274,73277036272,-2,1136,1976,10
73280127331,73280127329,-2,1729,2638,10
73280494726,73280494726,0,1171,2352,10
73283737962,73283737961,-1,1333,2210,10
73286299375,73286299374,-1,1093,1882,10
73287886821,73287886821,0,1063,2674,10
73290771059,73290771059,0,959,2007,10
73292549422,73292549423,1,1854,1949,10
73296728924,73296728922,-2,1424,2420,10
73297505306,73297505307,1,1734,1757,10
73305456073,73305456070,-3,1242,2531,10
73306734631,73306734630,-1,1183,2085,10
73307273882,73307273881,-1,939,1696,10
73309707179,73309707178,-1,1171,2630,10
73315170429,73315170430,1,1010,1546,10
73317520825,73317520822,-3,1119,1516,10
73317936728,73317936726,-2,1520,2343,10
73322770373,73322770374,1,1167,1597,10
73324058337,73324058337,0,1541,2597,10
73324395148,73324395145,-3,1169,1717,10
73325039294,73325039301,7,2224,1592,10
73325528464,73325528465,1,1866,2040,10
73326699654,73326699654,0,1021,2400,10
73327960281,73327960282,1,698,1216,10
73329118829,73329118831,2,3385,3113,10
73330904407,73330904406,-1,1599,2908,10
73335365147,73335365146,-1,1003,2318,10
73338956893,73338956894,1,620,1499,10
73346152181,73346152178,-3,1007,1446,10
73347619980,73347619993,13,213,518,10
73352427006,73352427005,-1,1235,1663,10
73355307742,73355307739,-3,1020,1990,10
73357006451,73357006450,-1,1198,1604,10
73359515459,73359515458,-1,910,2337,10
73364688097,73364688098,1,1322,1803,10
73368450466,73368450461,-5,1295,4385,10
73370120416,73370120416,0,1025,1482,10
73378793919,73378793918,-1,1821,1944,10
73385564921,73385564921,0,1031,1888,10
73392403938,73392403937,-1,2245,3102,10
73392475783,73392475783,0,897,2136,10
73395715187,73395715188,1,1280,2318,10
73396724579,73396724578,-1,1468,1957,10
73397625046,73397625042,-4,1724,2179,10
73408443137,73408443137,0,2298,2368,10
73411126817,73411126819,2,1222,2105,10
73414585887,73414585885,-2,958,2092,10
73416525641,73416525641,0,1280,2627,10
73416662035,73416662054,19,320,7322,10
73419136197,73419136195,-2,1604,1650,10
73419532217,73419532216,-1,1627,1857,10
73420297672,73420297657,-15,1338,2475,10
73422249518,73422249517,-1,1088,1812,10
73424294711,73424294710,-1,1260,2061,10
73427211805,73427211804,-1,1267,1704,10
73430413725,73430413722,-3,1307,1793,10
73432490646,73432490645,-1,1562,2192,10
73436220514,73436220513,-1,1897,2537,10
73437343434,73437343435,1,1470,2462,10
73438896925,73438896925,0,1573,2181,10
73439228336,73439228356,20,720,1178,10
73442527420,73442527418,-2,974,1592,10
73448150578,73448150579,1,1812,1898,10
73451145671,73451145674,3,1725,1553,10
73451427526,73451427523,-3,1123,1766,10
73451561585,73451561581,-4,1619,5300,10
73455151027,73455151026,-1,455,931,10
73458839550,73458839550,0,1270,1523,10
73459304145,73459304143,-2,1387,1796,10
73463880266,73463880266,0,1560,1920,10
73466701571,73466701578,7,4108,2021,10
73468146607,73468146606,-1,1198,2437,10
73469663433,73469663434,1,1667,2496,10
73479989648,73479989646,-2,1471,2835,10
73482174412,73482174409,-3,1446,2111,10
73482410291,73482410290,-1,1426,1901,10
73483256154,73483256154,0,1347,2172,10
73486543343,73486543341,-2,1441,2117,10
73487968003,73487967993,-10,804,1215,10
73488522022,73488522018,-4,985,1950,10
73495078570,73495078569,-1,1493,1566,10
73496030422,73496030423,1,815,2048,10
73497678493,73497678493,0,889,1499,10
73498659108,73498659098,-10,88,2248,10
73500755309,73500755303,-6,22715,12576,10
73501565165,73501565165,0,1503,2010,10
73502580247,73502580246,-1,938,2194,10
73506370993,73506370989,-4,3078,14906,10
73506717715,73506717714,-1,1280,2776,10
73516091237,73516091235,-2,1224,3261,10
73517709314,73517709307,-7,1150,5499,10
73520193150,73520193150,0,1651,1514,10
73521066850,73521066857,7,5962,2910,10
73521724086,73521724084,-2,1154,1942,10
73523683978,73523683977,-1,1064,1738,10
73524517162,73524517161,-1,1416,2209,10
73527119990,73527119985,-5,859,3560,10
73528827206,73528827206,0,9732,11566,10
73529388949,73529388950,1,1470,1444,10
73530319760,73530319759,-1,1001,1550,10
73532272002,73532272001,-1,1554,2632,10
73536706770,73536706769,-1,1471,2635,10
73536910044,73536910042,-2,1325,3369,10
73537315410,73537315412,2,1339,1649,10
73540707118,73540707117,-1,912,1466,10
73543368426,73543368425,-1,1491,2189,10
73547042500,73547042499,-1,1085,2020,10
73548587866,73548587865,-1,1236,1938,10
73550754069,73550754066,-3,1406,1631,10
73552462563,73552462561,-2,998,1482,10
73554258641,73554258640,-1,1375,1763,10
73557970299,73557970294,-5,687,1191,10
73559281449,73559281446,-3,1302,1731,10
73561236758,73561236758,0,781,1826,10
73565403469,73565403467,-2,1044,1428,10
73565485195,73565485194,-1,1172,1540,10
73566073475,73566073475,0,1238,2213,10
73567977253,73567977251,-2,1183,1783,10
73569212740,73569212738,-2,696,1383,10
73570774190,73570774192,2,2186,1237,10
73571674487,73571674485,-2,1400,1986,10
73571848207,73571848203,-4,1574,2474,10
73573832447,73573832451,4,1314,690,10
73574202705,73574202705,0,1467,1985,10
73577509767,73577509744,-23,1081,501,10
73589700985,73589700984,-1,1240,2131,10
73592078556,73592078555,-1,1373,2403,10
73592175490,73592175477,-13,1073,1774,10
73593834594,73593834594,0,1310,1566,10
73595387891,73595387889,-2,888,2035,10
73596050045,73596050043,-2,1284,2400,10
73598504259,73598504261,2,299,936,10
73600618962,73600618962,0,1242,1746,10
73600648412,73600648411,-1,1261,1501,10
73605668133,73605668131,-2,1413,2320,10
73608694776,73608694777,1,1649,2024,10
73610301193,73610301192,-1,1114,2022,10
73610408946,73610408946,0,787,2002,10
73610834537,73610834529,-8,802,1472,10
73611059930,73611059930,0,1475,1947,10
73611754941,73611754941,0,1103,2289,10
73614323010,73614323010,0,1189,1945,10
73614395717,73614395713,-4,1381,2323,10
73616926863,73616926864,1,1343,1948,10
73618688829,73618688826,-3,1504,2420,10
73618763441,73618763454,13,306,1539,10
73626464333,73626464333,0,1267,1506,10
73629659453,73629659452,-1,1506,1980,10
73632874363,73632874359,-4,2128,3186,10
73635983298,73635983301,3,2527,1976,10
73636784873,73636784870,-3,1352,2142,10
73639077585,73639077584,-1,30187,24443,10
73643121461,73643121459,-2,1123,1668,10
73645432075,73645432074,-1,1083,1727,10
73645818354,73645818352,-2,1021,2632,10
73646083452,73646083451,-1,1455,2501,10
73647635117,73647635117,0,1156,2155,10
73647820129,73647820149,20,318,1259,10
73653969993,73653969993,0,1738,1721,10
73655006481,73655006478,-3,1111,2998,10
73655340819,73655340812,-7,945,1532,10
73657917530,73657917528,-2,1257,2199,10
73660334986,73660334985,-1,1157,2521,10
73661151159,73661151158,-1,1104,2218,10
73661640666,73661640665,-1,1228,1856,10
73666420735,73666420733,-2,1139,1974,10
73666984337,73666984336,-1,1324,2160,10
73674106846,73674106845,-1,929,1428,10
73679062112,73679062110,-2,1067,1525,10
73683401023,73683401020,-3,1507,3018,10
73688191225,73688191222,-3,1245,1130,10
73690475735,73690475734,-1,1312,1557,10
73691062888,73691062887,-1,1554,2153,10
73693267249,73693267248,-1,889,1880,10
73698432338,73698432339,1,1096,1750,10
73698489769,73698489751,-18,446,1058,10
73699166043,73699166061,18,1120,2038,10
73699627422,73699627441,19,839,1826,10
73703605452,73703605451,-1,1271,1543,10
73705555118,73705555118,0,962,928,10
73708069003,73708069002,-1,1434,1655,10
73709527002,73709527002,0,1567,2347,10
73709788170,73709788170,0,1450,1491,10
73712638156,73712638152,-4,870,2337,10
73718598232,73718598230,-2,1005,2691,10
73730038928,73730038928,0,1669,2234,10
73732014347,73732014347,0,1384,1499,10
73733128055,73733128054,-1,1210,2055,10
73738175489,73738175489,0,1118,1551,10
73744508122,73744508120,-2,847,2089,10
73745174832,73745174833,1,1774,2219,10
73746127979,73746127978,-1,1644,2573,10
73746723903,73746723902,-1,1598,1974,10
73748878116,73748878113,-3,1464,2681,10
73750463230,73750463229,-1,1106,1770,10
73752770434,73752770433,-1,1502,1869,10
73755059681,73755059680,-1,814,1414,10
73759695821,73759695819,-2,1347,2000,10
73762693382,73762693382,0,1280,1311,10
73764417669,73764417666,-3,961,1629,10
73766299047,73766299047,0,1094,2065,10
73768211079,73768211078,-1,1005,1725,10
73769819528,73769819525,-3,1377,2318,10
73772680101,73772680099,-2,1454,2361,10
73774935227,73774935223,-4,521,1465,10
73776187667,73776187664,-3,1063,2253,10
73779023870,73779023867,-3,1155,1628,10
73782526402,73782526402,0,1432,1789,10
73783949338,73783949343,5,1702,823,10
73786145009,73786145007,-2,1274,1477,10
73787604510,73787604509,-1,861,1203,10
73796143399,73796143400,1,1627,1658,10
73797138019,73797138016,-3,1481,1928,10
73798527390,73798527389,-1,1040,1388,10
73799187171,73799187169,-2,1015,1656,10
73800593031,73800593030,-1,927,1341,10
73803654360,73803654354,-6,21549,12873,10
73807315514,73807315513,-1,1497,1651,10
73810086987,73810086986,-1,862,2176,10
73810177638,73810177639,1,1197,1357,10
73813271489,73813271487,-2,1676,2457,10
73817473339,73817473337,-2,747,1552,10
73819262122,73819262122,0,1201,1912,10
73819632099,73819632098,-1,1106,1330,10
73821771963,73821771962,-1,1126,1864,10
73821980698,73821980696,-2,1635,2309,10
73839159014,73839159012,-2,1240,2167,10
73839563306,73839563307,1,1434,1900,10
73842270253,73842270251,-2,1159,1581,10
73847256294,73847256294,0,1335,1604,10
73847801308,73847801306,-2,1035,1899,10
73848990299,73848990298,-1,1374,1857,10
73849748890,73849748890,0,1150,1995,10
73850258624,73850258620,-4,990,1680,10
73850659401,73850659423,22,1396,1857,10
73854283757,73854283758,1,1006,1480,10
73856959209,73856959205,-4,1210,1379,10
73863734437,73863734434,-3,1838,2969,10
73867299650,73867299649,-1,1253,1835,10
73868161788,73868161805,17,659,1987,10
73868658012,73868658010,-2,989,2164,10
73870683883,73870683878,-5,1086,3266,10
73872207672,73872207670,-2,1446,3564,10
73872638542,73872638543,1,357,585,10
73875364208,73875364210,2,27821,22083,10
73875841195,73875841198,3,1515,1219,10
73877564362,73877564361,-1,1382,2079,10
73878292280,73878292280,0,1238,1172,10
73878373351,73878373329,-22,2054,569,10
73879321877,73879321874,-3,895,1631,10
73881300486,73881300484,-2,1983,2189,10
73883459002,73883458996,-6,883,5574,10
73898744439,73898744439,0,661,1575,10
73900500106,73900500107,1,1301,1442,10
73902989872,73902989869,-3,1425,3170,10
73905866754,73905866753,-1,940,1484,10
73912099113,73912099110,-3,1221,2154,10
73912621295,73912621292,-3,1058,2017,10
73917533478,73917533474,-4,1447,1979,10
73918621994,73918621999,5,2224,2284,10
73920174069,73920174067,-2,1151,1950,10
73923657047,73923657046,-1,1162,1763,10
73936083533,73936083530,-3,770,1295,10
73939253946,73939253945,-1,1219,2460,10
73940243248,73940243265,17,692,952,10
73950833821,73950833821,0,1304,2468,10
73951032646,73951032645,-1,1282,2082,10
73951252795,73951252792,-3,1709,2866,10
73952155475,73952155470,-5,1100,3796,10
73952768669,73952768667,-2,1286,2141,10
73953974073,73953974070,-3,1492,2835,10
73955684183,73955684178,-5,1128,3637,10
73956014019,73956014017,-2,1147,2862,10
73962371169,73962371166,-3,934,1999,10
73963503769,73963503768,-1,1237,2095,10
73965994993,73965994997,4,2960,2128,10
73967668617,73967668614,-3,1412,2368,10
73971998134,73971998135,1,1094,1625,10
73972679116,73972679113,-3,1611,1823,10
73975402475,73975402473,-2,1393,1655,10
73975718374,73975718372,-2,672,1771,10
73977020263,73977020260,-3,1198,2128,10
73982734218,73982734221,3,1570,1264,10
73983781518,73983781518,0,958,1432,10
73988951709,73988951710,1,1914,1298,10
73995050185,73995050185,0,1361,2787,10
74002576966,74002576965,-1,1626,2577,10
74004682685,74004682682,-3,1582,2875,10
74004874321,74004874319,-2,1753,2475,10
74007606043,74007606042,-1,2378,6346,10
74008735730,74008735727,-3,1191,2062,10
74021709706,74021709703,-3,1203,2374,10
74023172160,74023172158,-2,808,1699,10
74026483110,74026483106,-4,671,1623,10
74029281008,74029281006,-2,1415,1581,10
74033470890,74033470888,-2,916,1717,10
74034550899,74034550893,-6,2485,8064,10
74035381743,74035381742,-1,1276,2023,10
74036457683,74036457680,-3,1033,1533,10
74037579293,74037579294,1,1363,2215,10
74040369941,74040369939,-2,1492,2220,10
74048187922,74048187921,-1,624,1557,10
74051046262,74051046261,-1,1178,2000,10
74052273149,74052273149,0,1598,1641,10
74052739126,74052739126,0,1311,1795,10
74052865626,74052865621,-5,898,3966,10
74053744723,74053744717,-6,996,2036,10
74055704737,74055704735,-2,1138,1693,10
74056164313,74056164313,0,1380,1994,10
74056834122,74056834122,0,1263,1769,10
74063089965,74063089966,1,1039,2169,10
74063912375,74063912373,-2,1166,1820,10
74064430290,74064430291,1,1124,1504,10
74066987102,74066987101,-1,922,2469,10
74068401935,74068401933,-2,1813,2625,10
74069283530,74069283530,0,1535,1288,10
74070091986,74070091984,-2,2007,2441,10
74070395388,74070395393,5,18793,19217,10
74070876682,74070876678,-4,920,1865,10
74073820079,74073820078,-1,1194,1837,10
74081707493,74081707493,0,1219,2111,10
74085260175,74085260171,-4,1500,2912,10
74092827094,74092827093,-1,1250,2186,10
74093076683,74093076681,-2,1112,1854,10
74097810091,74097810090,-1,1258,2358,10
74097886866,74097886845,-21,894,2311,10
74099535179,74099535178,-1,1307,2603,10
74100254790,74100254789,-1,1127,2239,10
74101615148,74101615151,3,1903,1539,10
74110003942,74110003942,0,1250,2064,10
74110419279,74110419276,-3,1289,1623,10
74114851114,74114851112,-2,1247,1729,10
74115023151,74115023169,18,1194,1375,10
74115189603,74115189602,-1,852,1653,10
74115673237,74115673237,0,1308,2071,10
74121928040,74121928039,-1,1453,1401,10
74123767394,74123767391,-3,937,2563,10
74126942731,74126942729,-2,1120,1585,10
74128014768,74128014765,-3,1722,2186,10
74129414639,74129414638,-1,1402,2089,10
74129856950,74129856950,0,1039,2253,10
74129895035,74129895022,-13,3033,1491,10
74130105611,74130105609,-2,1125,2275,10
74135187568,74135187566,-2,1008,2255,10
74138721443,74138721444,1,1307,1467,10
74139080781,74139080781,0,706,1366,10
74142492570,74142492570,0,1110,2061,10
74144386151,74144386153,2,1080,1635,10
74148784710,74148784709,-1,393,884,10
74151680576,74151680573,-3,1004,1849,10
74151997407,74151997403,-4,1216,1980,10
74156603561,74156603559,-2,1224,2453,10
74160407555,74160407553,-2,1146,1956,10
74162311031,74162311029,-2,1420,2192,10
74167107247,74167107245,-2,1498,2186,10
74173680571,74173680569,-2,981,2299,10
74174755195,74174755192,-3,1246,2131,10
74174800599,74174800598,-1,22017,20622,10
74177398205,74177398203,-2,1224,2354,10
74178860738,74178860733,-5,1435,4913,10
74183753458,74183753455,-3,1412,2061,10
74190308931,74190308938,7,5171,1541,10
74191044553,74191044549,-4,1315,2794,10
74194960445,74194960443,-2,1568,1822,10
74197166783,74197166785,2,1075,1656,10
74198223307,74198223306,-1,1328,1874,10
74204967078,74204967075,-3,1178,1862,10
74205435147,74205435143,-4,1432,2232,10
74206426743,74206426743,0,706,1013,10
74209783169,74209783176,7,15202,28531,10
74210551193,74210551193,0,722,1762,10
74211254394,74211254393,-1,1260,2271,10
74211988734,74211988732,-2,1375,1510,10
74219597918,74219597918,0,1090,2072,10
74221536254,74221536253,-1,1145,2245,10
74221836719,74221836719,0,1337,1972,10
74222971466,74222971466,0,1151,1980,10
74223247522,74223247520,-2,1437,2448,10
74223574930,74223574929,-1,1310,2432,10
74225396985,74225396965,-20,1415,2005,10
74227335962,74227335959,-3,1129,2282,10
74230654867,74230654864,-3,28657,20288,10
74236528533,74236528530,-3,1259,1669,10
74236842044,74236842058,14,1117,1416,10
74238950147,74238950147,0,1754,2258,10
74243767206,74243767205,-1,1056,1837,10
74248037346,74248037347,1,967,1936,10
74248884843,74248884842,-1,1267,1908,10
74254290924,74254290917,-7,1123,2886,10
74256992762,74256992761,-1,1074,2148,10
74262756707,74262756705,-2,1886,2143,10
74264563741,74264563739,-2,1268,2383,10
74269319974,74269319970,-4,1143,1399,10
74274878236,74274878234,-2,1387,1683,10
74277001768,74277001768,0,1467,1809,10
74281603553,74281603559,6,3335,1640,10
74283408867,74283408865,-2,1355,1770,10
74284826606,74284826605,-1,1016,3105,10
74286069310,74286069310,0,601,1261,10
74290832771,74290832770,-1,1378,1859,10
74292320665,74292320664,-1,1321,2317,10
74292846063,74292846061,-2,1495,1650,10
74294921675,74294921675,0,1143,2124,10
74297511292,74297511290,-2,847,2041,10
74298193529,74298193513,-16,1299,355,10
74298531483,74298531483,0,940,1377,10
74301020571,74301020572,1,22096,26382,10
74301740063,74301740061,-2,1797,2627,10
74304261703,74304261705,2,1465,1514,10
74306553062,74306553062,0,1293,1756,10
74308932317,74308932322,5,2006,1470,10
74309357634,74309357634,0,1095,1440,10
74313132041,74313132038,-3,1512,2539,10
74315095917,74315095914,-3,1321,1717,10
74317334982,74317334981,-1,1925,2275,10
74318910973,74318910972,-1,1267,1515,10
74319082124,74319082122,-2,1317,1952,10
74319404226,74319404225,-1,1219,1796,10
74321784067,74321784069,2,1410,1476,10
74325742645,74325742645,0,1151,2267,10
74330324300,74330324299,-1,1157,2558,10
74330354421,74330354419,-2,1260,1951,10
74330480347,74330480349,2,1240,1533,10
74332436649,74332436647,-2,1646,1432,10
74333366655,74333366655,0,1490,2235,10
74333635212,74333635218,6,2296,1805,10
74334965202,74334965198,-4,802,1643,10
74335659546,74335659545,-1,1808,3222,10
74336205721,74336205716,-5,873,4042,10
74339986991,74339986990,-1,1009,2257,10
74341707709,74341707709,0,1454,1906,10
74343700766,74343700768,2,5074,16583,10
74345368159,74345368157,-2,1431,1853,10
74349406407,74349406409,2,1084,1250,10
74357217803,74357217797,-6,1063,2082,10
74361209195,74361209194,-1,1170,1793,10
74362758426,74362758425,-1,1528,1984,10
74363036501,74363036500,-1,999,1780,10
74366001298,74366001298,0,1196,1628,10
74368643244,74368643251,7,7324,1535,10
74370495978,74370495975,-3,1219,1451,10
74371794867,74371794865,-2,1176,1790,10
74373565288,74373565295,7,9875,9104,10
74374040649,74374040646,-3,781,996,10
74375125779,74375125774,-5,1667,3249,10
74376282885,74376282886,1,1185,2601,10
74376537437,74376537433,-4,1183,2843,10
74377503869,74377503867,-2,1014,1410,10
74378365834,74378365835,1,1310,2155,10
74378523457,74378523454,-3,1531,1595,10
74378719670,74378719667,-3,1195,1804,10
74380127435,74380127431,-4,1070,2467,10
74381491719,74381491715,-4,1327,3423,10
74384616205,74384616202,-3,774,2611,10
74385831047,74385831046,-1,1386,1999,10
74387306865,74387306863,-2,1456,3513,10
74392414549,74392414546,-3,1287,2272,10
74393609450,74393609446,-4,1003,2231,10
74394496339,74394496338,-1,1132,1854,10
74397066873,74397066871,-2,1045,1726,10
74398018849,74398018848,-1,1279,1702,10
74399402617,74399402629,12,322,881,10
74400304738,74400304735,-3,919,2536,10
74404741868,74404741866,-2,1123,2605,10
74409840321,74409840321,0,1461,1909,10
74410251577,74410251574,-3,1547,2779,10
74411210263,74411210261,-2,1069,1218,10
74412435573,74412435572,-1,1020,1750,10
74416803850,74416803848,-2,1328,2198,10
74418547265,74418547264,-1,1378,2301,10
74424065217,74424065214,-3,1271,1873,10
74424233345,74424233345,0,6126,7506,10
74424404254,74424404256,2,1333,1323,10
74424612345,74424612344,-1,1272,1697,10
74426642238,74426642234,-4,1130,5059,10
74428007848,74428007845,-3,1444,2855,10
74428738466,74428738466,0,933,1819,10
74433322646,74433322646,0,1006,1706,10
74433687254,74433687248,-6,488,2286,10
74435361021,74435361019,-2,1316,1385,10
74435920738,74435920736,-2,1357,2249,10
74437444759,74437444740,-19,1515,1702,10
74441503118,74441503136,18,953,1374,10
74443738359,74443738362,3,1583,1446,10
74452490772,74452490769,-3,1301,3126,10
74454545371,74454545370,-1,1468,1746,10
74460054882,74460054881,-1,1422,1733,10
74461593161,74461593159,-2,1217,1216,10
74465535355,74465535353,-2,807,1283,10
74467117354,74467117354,0,1471,2099,10
74469757499,74469757497,-2,1178,1748,10
74473337246,74473337245,-1,882,1526,10
74479418982,74479418982,0,1667,1617,10
74482402756,74482402754,-2,1921,1683,10
74485543651,74485543646,-5,973,3272,10
74489788842,74489788839,-3,754,1117,10
74493430063,74493430062,-1,1286,1945,10
74494832014,74494832013,-1,1630,2246,10
74498908035,74498908033,-2,838,1789,10
74504221074,74504221074,0,1371,2199,10
74504663617,74504663615,-2,1329,2182,10
74505151819,74505151817,-2,1282,2697,10
74505256098,74505256098,0,205,1419,10
74514447749,74514447749,0,1385,1853,10
74519481814,74519481798,-16,796,558,10
74521583059,74521583057,-2,1045,1853,10
74524878643,74524878643,0,1086,1854,10
74527664466,74527664463,-3,1041,2443,10
74528583222,74528583222,0,1257,2648,10
74530277538,74530277537,-1,1186,1878,10
74531458572,74531458570,-2,960,2098,10
74531848930,74531848912,-18,1139,2108,10
74532182526,74532182524,-2,1619,2122,10
74534243382,74534243378,-4,973,2187,10
74535788273,74535788270,-3,1251,2203,10
74536650210,74536650209,-1,3202,4655,10
74536725848,74536725847,-1,1702,1872,10
74539254482,74539254482,0,1306,2907,10
74547221902,74547221901,-1,2271,4931,10
74547368003,74547368002,-1,921,1485,10
74547697467,74547697464,-3,922,2677,10
74549792107,74549792107,0,1308,1500,10
74550802022,74550802021,-1,928,1531,10
74551951596,74551951594,-2,1439,2145,10
74553478997,74553478994,-3,1238,2118,10
74554193571,74554193568,-3,1436,2038,10
74558651762,74558651761,-1,1548,3085,10
74561825637,74561825636,-1,1290,2742,10
74566623162,74566623161,-1,1330,1554,10
74567161654,74567161652,-2,1212,1697,10
74572929130,74572929127,-3,1531,2473,10
74575067357,74575067355,-2,950,2267,10
74576418417,74576418417,0,1373,1768,10
74580007454,74580007451,-3,1476,1975,10
74582984963,74582984964,1,687,1715,10
74588221614,74588221612,-2,1181,1392,10
74590837972,74590837968,-4,1766,4135,10
74591268205,74591268205,0,1329,2616,10
74591716358,74591716365,7,5762,2921,10
74591811377,74591811374,-3,1452,2150,10
74593476509,74593476510,1,1479,1560,10
74594465585,74594465581,-4,2445,4798,10
74595450919,74595450917,-2,1346,1959,10
74611640750,74611640750,0,1493,1961,10
74613304846,74613304845,-1,1083,2034,10
74615387247,74615387245,-2,998,1880,10
74616473166,74616473165,-1,855,1505,10
74617440518,74617440523,5,6161,2818,10
74617735146,74617735144,-2,912,1953,10
74618427370,74618427366,-4,1141,2018,10
74619361573,74619361567,-6,1363,6077,10
74621838045,74621838044,-1,1092,2656,10
74624099478,74624099477,-1,1148,1800,10
74638241034,74638241033,-1,1370,2391,10
74638846659,74638846658,-1,1027,1477,10
74641649957,74641649957,0,1343,2088,10
74642904536,74642904531,-5,1310,2722,10
74646060419,74646060428,9,9940,42809,10
74646970231,74646970230,-1,871,1271,10
74647454882,74647454875,-7,937,1686,10
74655709299,74655709296,-3,853,1395,10
74657011869,74657011863,-6,1749,8918,10
74657795477,74657795478,1,1085,1134,10
74660101550,74660101556,6,1615,1012,10
74662952520,74662952519,-1,1062,1833,10
74665173293,74665173290,-3,1562,2130,10
74666910558,74666910555,-3,1382,2229,10
74669169550,74669169547,-3,1152,1736,10
74673352970,74673352970,0,1482,2363,10
74673586807,74673586806,-1,1417,2193,10
74679705506,74679705507,1,1439,1829,10
74680800874,74680800874,0,979,1570,10
74682323883,74682323882,-1,1090,1476,10
74687314666,74687314664,-2,929,1777,10
74688169528,74688169526,-2,1234,1922,10
74695272905,74695272905,0,1298,1974,10
74696691971,74696691970,-1,1017,1824,10
74703774457,74703774460,3,968,1612,10
74704008422,74704008421,-1,1157,2272,10
74704393355,74704393355,0,1119,1499,10
74714381169,74714381166,-3,1078,2224,10
74715388438,74715388438,0,1493,2571,10
74716033030,74716033029,-1,932,1169,10
74717480946,74717480944,-2,1240,2920,10
74720421402,74720421403,1,1207,1909,10
74723697047,74723697041,-6,2021,8963,10
74729095029,74729095027,-2,1219,2042,10
74729414742,74729414742,0,1130,1773,10
74730005173,74730005171,-2,830,1531,10
74731791035,74731791038,3,1114,2154,10
74732650784,74732650805,21,1256,2067,10
74732929209,74732929209,0,1292,1530,10
74736122659,74736122663,4,2444,1552,10
74737473694,74737473694,0,875,1512,10
74743150297,74743150298,1,1603,1824,10
74745938742,74745938742,0,1409,1935,10
74750352607,74750352606,-1,1105,2027,10
74752034641,74752034638,-3,1080,2085,10
74753744826,74753744832,6,1131,1464,10
74754543922,74754543921,-1,1194,1343,10
74758064918,74758064915,-3,1189,1978,10
74760769024,74760769007,-17,1046,2196,10
74762391214,74762391210,-4,1169,1580,10
74763926295,74763926291,-4,1007,2004,10
74765042258,74765042251,-7,1898,9694,10
74766709604,74766709605,1,1323,1448,10
74770367724,74770367722,-2,916,1396,10
74772389870,74772389871,1,822,1512,10
74772828203,74772828203,0,1140,1633,10
74777575309,74777575306,-3,1050,2180,10
74778420370,74778420368,-2,1826,2596,10
74786722308,74786722308,0,1719,2600,10
74787234218,74787234221,3,1591,1827,10
74795495090,74795495089,-1,1551,1935,10
74795551602,74795551602,0,1059,1255,10
74797769698,74797769697,-1,1341,2289,10
74798035401,74798035399,-2,654,911,10
74799053605,74799053606,1,1130,1750,10
74800000531,74800000531,0,1255,2691,10
74803511102,74803511101,-1,995,997,10
74807788839,74807788819,-20,1570,1930,10
74809565639,74809565619,-20,698,2219,10
74810736894,74810736894,0,1017,1711,10
74811987286,74811987286,0,1115,1514,10
74814397174,74814397171,-3,767,1128,10
74819040978,74819040978,0,1438,1578,10
74820104063,74820104063,0,1432,2423,10
74822134118,74822134115,-3,1109,2324,10
74825573603,74825573602,-1,1577,2130,10
74836827845,74836827841,-4,1250,2073,10
74838724159,74838724158,-1,1437,2041,10
74842299718,74842299715,-3,1119,1618,10
74845205103,74845205105,2,1523,2095,10
74847302906,74847302902,-4,1247,1806,10
74848227359,74848227360,1,1599,1969,10
74850003887,74850003864,-23,1464,1787,10
74852522984,74852522982,-2,1192,2561,10
74852905793,74852905795,2,2709,2141,10
74853559697,74853559697,0,1009,1762,10
74854768882,74854768881,-1,1687,2033,10
74856881117,74856881115,-2,1034,1595,10
74871145286,74871145302,16,1991,1468,10
74872295582,74872295578,-4,1729,3471,10
74879633598,74879633596,-2,1193,2061,10
74879853942,74879853947,5,2278,1415,10
74881444906,74881444902,-4,1379,2367,10
74881738320,74881738339,19,17250,26700,10
74884598665,74884598665,0,1520,2537,10
74889969396,74889969398,2,3319,2302,10
74891029342,74891029338,-4,1502,2697,10
74896017462,74896017463,1,969,1285,10
74898231171,74898231169,-2,1470,2211,10
74899625330,74899625329,-1,519,1808,10
74900514209,74900514206,-3,1122,2287,10
74904580916,74904580914,-2,1251,2073,10
74907335206,74907335205,-1,1028,1474,10
74907726250,74907726248,-2,1194,2057,10
74908267021,74908267026,5,2497,1219,10
74911483017,74911483033,16,1159,1394,10
74914684205,74914684222,17,1900,1566,10
74920707542,74920707542,0,1217,2990,10
74922013427,74922013424,-3,1081,1832,10
74922167261,74922167261,0,1547,2914,10
74927138533,74927138534,1,1154,1522,10
74929478174,74929478175,1,1221,1631,10
74931519950,74931519947,-3,1446,1489,10
74932631551,74932631549,-2,1317,2839,10
74932946724,74932946723,-1,1785,2793,10
74933210458,74933210454,-4,1023,1919,10
74937961781,74937961778,-3,1227,1586,10
74939438910,74939438909,-1,1214,1838,10
74942178212,74942178210,-2,1303,1239,10
74946498935,74946498931,-4,1045,1888,10
74948854986,74948854984,-2,1429,2163,10
74951481365,74951481364,-1,1436,2425,10
74952881376,74952881379,3,1603,1783,10
74953020374,74953020375,1,1101,1670,10
74953112465,74953112462,-3,918,1402,10
74953977746,74953977746,0,1670,2123,10
74958437848,74958437847,-1,21452,12632,10
74959511750,74959511749,-1,1301,2151,10
74960932674,74960932671,-3,1095,1681,10
74967982782,74967982781,-1,1159,1972,10
74972672208,74972672207,-1,1155,1656,10
74978441129,74978441135,6,6896,2368,10
74979602741,74979602738,-3,1655,2452,10
74979744151,74979744150,-1,1260,2276,10
74979891723,74979891705,-18,1648,6072,10
74982234545,74982234543,-2,1955,3069,10
74992638992,74992638981,-11,46694,16115,10
74992947818,74992947816,-2,1244,2988,10
74995145429,74995145427,-2,1176,1690,10
74997123416,74997123413,-3,1116,1874,10
74998493171,74998493166,-5,1479,2223,10
74998708377,74998708366,-11,217,673,10
75002626261,75002626257,-4,969,2399,10
75002690913,75002690913,0,1630,1342,10
75011618142,75011618141,-1,1323,1731,10
75012803098,75012803099,1,1315,1094,10
75014864782,75014864781,-1,1577,1886,10
75015021923,75015021917,-6,1119,2180,10
75018873029,75018873023,-6,1064,3184,10
75021331268,75021331266,-2,827,1719,10
75022425919,75022425917,-2,1345,3085,10
75026334962,75026334962,0,1452,2135,10
75029943431,75029943429,-2,1207,2056,10
75030576556,75030576556,0,1311,1512,10
75031665916,75031665915,-1,1741,1924,10
75031721291,75031721293,2,2627,4235,10
75034549050,75034549046,-4,890,1297,10
75035795786,75035795785,-1,1043,2245,10
75038982749,75038982749,0,1393,2020,10
75039296501,75039296502,1,2319,2374,10
75046792030,75046792027,-3,1329,2780,10
75048888013,75048888014,1,2232,2014,10
75049303378,75049303378,0,955,1497,10
75051641442,75051641437,-5,1446,6093,10
75054851394,75054851394,0,1078,2885,10
75055539940,75055539941,1,1106,1976,10
75055824938,75055824922,-16,1115,2364,10
75058799307,75058799307,0,1210,2024,10
75060208826,75060208826,0,1283,1997,10
75063038086,75063038085,-1,1014,2221,10
75066241491,75066241490,-1,1464,1551,10
75072380615,75072380613,-2,1248,1795,10
75074176315,75074176314,-1,1019,2077,10
75074211646,75074211644,-2,973,2594,10
75076067730,75076067737,7,3929,1963,10
75076648728,75076648726,-2,1552,2268,10
75079999066,75079999066,0,2216,2686,10
75080571416,75080571414,-2,1634,2657,10
75082763598,75082763595,-3,1400,2460,10
75082995999,75082995994,-5,1013,1630,10
75085028555,75085028537,-18,1047,1724,10
75085715102,75085715103,1,1116,1781,10
75086130482,75086130479,-3,1112,2049,10
75087457069,75087457068,-1,1424,1803,10
75088199941,75088199939,-2,1199,1917,10
75088269468,75088269485,17,844,1615,10
75090058791,75090058788,-3,1092,2566,10
75091766850,75091766850,0,1044,1433,10
75094741895,75094741878,-17,1331,2369,10
75095515312,75095515310,-2,962,2084,10
75098815280,75098815278,-2,1081,1571,10
75099129198,75099129199,1,1918,1603,10
75099179162,75099179159,-3,1223,2947,10
75104886342,75104886342,0,1738,2936,10
75117576089,75117576086,-3,3061,5888,10
75118491170,75118491171,1,1534,2289,10
75122291762,75122291763,1,1217,1546,10
75123306450,75123306449,-1,1541,2818,10
75123873972,75123873970,-2,1752,2192,10
75124906853,75124906851,-2,1253,1963,10
75126046138,75126046138,0,1352,1909,10
75127020254,75127020251,-3,1756,2736,10
75129975614,75129975611,-3,873,2715,10
75131425852,75131425849,-3,1790,3702,10
75131497386,75131497383,-3,1109,2391,10
75137262870,75137262870,0,1845,2232,10
75139423038,75139423037,-1,1305,2408,10
75140676466,75140676465,-1,1138,1319,10
75145012876,75145012881,5,2350,1347,10
75154852259,75154852261,2,25834,18416,10
75164605133,75164605131,-2,1817,2164,10
75172213161,75172213160,-1,1294,1588,10
75174103621,75174103620,-1,1452,1979,10
75176128477,75176128476,-1,1070,2041,10
75179752035,75179752034,-1,1184,2371,10
75179901701,75179901699,-2,1431,1752,10
75184489160,75184489159,-1,1529,2520,10
75186661943,75186661942,-1,1169,1855,10
75192016302,75192016302,0,1009,1856,10
75197452931,75197452929,-2,1405,2158,10
75199737330,75199737329,-1,546,1417,10
75202609658,75202609656,-2,1099,1659,10
75202913432,75202913431,-1,1429,2006,10
75204907328,75204907326,-2,1153,1311,10
75208262859,75208262858,-1,1334,1712,10
75210865661,75210865646,-15,515,277,10
75218260013,75218260013,0,1476,2479,10
75218608470,75218608479,9,1002,1784,10
75220905010,75220905008,-2,1090,2274,10
75221656808,75221656805,-3,1352,1655,10
75223259417,75223259417,0,734,2326,10
75224617641,75224617642,1,1269,2096,10
75224829634,75224829630,-4,1261,1896,10
75227083966,75227083966,0,1088,2586,10
75227512566,75227512566,0,1038,1897,10
75232562910,75232562908,-2,768,2340,10
75235802942,75235802941,-1,1250,2279,10
75243433907,75243433906,-1,948,2034,10
75248612951,75248612946,-5,1111,3917,10
75249531830,75249531830,0,1379,2090,10
75250702545,75250702545,0,1938,1955,10
75253225223,75253225223,0,920,1694,10
75254687227,75254687227,0,1011,1712,10
75254752287,75254752284,-3,2026,4951,10
75255914101,75255914099,-2,1486,2267,10
75257000939,75257000939,0,1087,1636,10
75257972703,75257972701,-2,1091,1471,10
75258992478,75258992477,-1,886,1642,10
75259841295,75259841298,3,1221,1266,10
75261784851,75261784851,0,773,1650,10
75262276662,75262276661,-1,921,1789,10
75266276515,75266276514,-1,1115,2822,10
75266479308,75266479305,-3,1023,1878,10
75268046164,75268046161,-3,1316,1829,10
75269723025,75269723024,-1,1124,1827,10
75271487659,75271487655,-4,1069,3176,10
75273072706,75273072707,1,1406,1492,10
75273400274,75273400275,1,1315,1710,10
75273737070,75273737068,-2,1275,2119,10
75278764694,75278764694,0,1287,2575,10
75279316184,75279316183,-1,1679,1951,10
75279856740,75279856737,-3,915,1804,10
75280363222,75280363203,-19,774,695,10
75282711540,75282711544,4,19983,38049,10
75284392267,75284392266,-1,1127,1766,10
75285355751,75285355750,-1,911,1172,10
75286136462,75286136461,-1,953,1627,10
75290416498,75290416497,-1,1698,2140,10
75290461152,75290461149,-3,1177,2569,10
75302603733,75302603726,-7,1036,4009,10
75302778665,75302778678,13,188,839,10
75303427890,75303427889,-1,2106,2020,10
75308362918,75308362914,-4,1415,2175,10
75310161571,75310161570,-1,811,1236,10
75312190522,75312190521,-1,1055,1411,10
75312639729,75312639729,0,1745,2766,10
75317501671,75317501670,-1,1135,1868,10
75318823766,75318823765,-1,860,1609,10
75320400981,75320400978,-3,1528,2871,10
75323687580,75323687593,13,1295,1634,10
75325688639,75325688642,3,1162,1461,10
75328251637,75328251636,-1,850,1713,10
75332625526,75332625527,1,1376,1308,10
75334568129,75334568128,-1,1755,2843,10
75336545859,75336545857,-2,1679,2710,10
75338940143,75338940141,-2,1500,1649,10
75339286719,75339286717,-2,1380,1656,10
75340310699,75340310698,-1,1688,2609,10
75340566858,75340566858,0,1387,1874,10
75341323876,75341323879,3,5101,18233,10
75343402041,75343402040,-1,1616,2899,10
75347588807,75347588805,-2,1123,2498,10
75349304911,75349304909,-2,779,1828,10
75351974297,75351974295,-2,1284,1708,10
75355541512,75355541517,5,427,845,10
75358050238,75358050241,3,3925,3132,10
75360473955,75360473959,4,1972,1711,10
75362050945,75362050943,-2,1395,1958,10
75367573482,75367573477,-5,794,2158,10
75370159402,75370159405,3,1429,1578,10
75370557625,75370557624,-1,1665,2158,10
75371399073,75371399071,-2,1826,2281,10
75371484538,75371484555,17,845,701,10
75371792482,75371792481,-1,1083,1655,10
75372948258,75372948267,9,1280,1575,10
75379718068,75379718061,-7,1816,7625,10
75379964238,75379964237,-1,1136,2163,10
75380468694,75380468692,-2,1142,2770,10
75382117010,75382117009,-1,1137,1735,10
75386878482,75386878482,0,1375,1831,10
75395342856,75395342853,-3,1384,1951,10
75402210563,75402210569,6,3670,1295,10
75403037303,75403037299,-4,1199,2044,10
75420331215,75420331214,-1,806,2570,10
75421082534,75421082534,0,945,1304,10
75426125220,75426125216,-4,1285,2048,10
75427185118,75427185118,0,991,1897,10
75432405306,75432405303,-3,1100,2121,10
75435597366,75435597367,1,1145,1691,10
75439585467,75439585466,-1,1186,2101,10
75440319746,75440319766,20,1006,2058,10
75441788318,75441788333,15,17343,18986,10
75450757257,75450757255,-2,1262,1791,10
75455626438,75455626439,1,1759,1570,10
75456677662,75456677657,-5,1212,3154,10
75457884661,75457884659,-2,1182,2469,10
75461243717,75461243715,-2,1339,2294,10
75465570966,75465570984,18,1183,1281,10
75469050818,75469050815,-3,1738,2201,10
75469824086,75469824087,1,1280,1443,10
75470584787,75470584785,-2,1312,1494,10
75475194234,75475194233,-1,1049,1379,10
75476674838,75476674837,-1,1436,2563,10
75479372507,75479372508,1,650,1585,10
75481434003,75481434013,10,1172,1721,10
75483646780,75483646778,-2,965,3231,10
75486421078,75486421076,-2,872,1361,10
75486976571,75486976570,-1,894,1800,10
75489961581,75489961581,0,1114,1573,10
75492096975,75492096974,-1,908,1411,10
75494949307,75494949306,-1,754,1741,10
75501689099,75501689098,-1,998,1869,10
75501933898,75501933908,10,1521,1084,10
75504432808,75504432808,0,1467,1933,10
75504839420,75504839397,-23,1650,2414,10
75505935421,75505935421,0,1382,1845,10
75506494593,75506494611,18,1622,1755,10
75507197318,75507197317,-1,864,1769,10
75508717907,75508717914,7,2745,1364,10
75511206190,75511206189,-1,1231,1959,10
75511893134,75511893140,6,5859,2719,10
75511950294,75511950289,-5,1354,2192,10
75512561837,75512561836,-1,1225,2434,10
75515601432,75515601438,6,3945,1425,10
75518202221,75518202221,0,1763,2676,10
75520049216,75520049213,-3,1450,2720,10
75520471170,75520471166,-4,1156,2179,10
75524412195,75524412193,-2,820,1216,10
75526877476,75526877476,0,1207,1452,10
75534953776,75534953794,18,734,1265,10
75536073166,75536073165,-1,1124,1912,10
75539943427,75539943426,-1,1092,2216,10
75542715587,75542715585,-2,1227,2415,10
75547257832,75547257838,6,12560,21004,10
75547518794,75547518793,-1,1239,1790,10
75547628020,75547628022,2,25031,25486,10
75548528662,75548528662,0,1396,1796,10
75548859406,75548859404,-2,1687,3521,10
75549359000,75549358998,-2,1406,1320,10
75550474146,75550474143,-3,762,2863,10
75555999309,75555999315,6,2231,1100,10
75563459501,75563459498,-3,1284,2479,10
75564278077,75564278079,2,1327,1447,10
75564692431,75564692433,2,1884,1978,10
75565896663,75565896662,-1,1136,2357,10
75565969938,75565969938,0,2165,2109,10
75571334207,75571334206,-1,1453,2367,10
75572805822,75572805822,0,1068,2412,10
75577107691,75577107703,12,664,1250,10
75578859484,75578859483,-1,827,1262,10
75587761518,75587761506,-12,853,1915,10
75591981839,75591981838,-1,1325,1974,10
75594690008,75594690006,-2,1561,2099,10
75597909212,75597909209,-3,918,2182,10
75598788210,75598788229,19,660,1927,10
75599554354,75599554353,-1,1111,1661,10
75601647110,75601647109,-1,1329,2045,10
75604208361,75604208358,-3,1350,1967,10
75605485839,75605485842,3,1415,1169,10
75607230814,75607230813,-1,1219,1750,10
75609169330,75609169327,-3,936,2081,10
75612652965,75612652962,-3,1103,1309,10
75617719059,75617719058,-1,1167,1918,10
75617818713,75617818715,2,1673,1225,10
75621639591,75621639589,-2,797,1735,10
75625463271,75625463269,-2,1567,2801,10
75625623935,75625623935,0,1198,1821,10
75629609234,75629609233,-1,1775,2598,10
75629933204,75629933202,-2,1284,2083,10
75630075739,75630075724,-15,1097,2958,10
75637652884,75637652892,8,14330,30552,10
75638045502,75638045502,0,990,1940,10
75639621724,75639621721,-3,740,2296,10
75641477354,75641477352,-2,1498,2065,10
75641630560,75641630559,-1,1487,1918,10
75643152645,75643152643,-2,1102,2013,10
75650458481,75650458479,-2,861,1840,10
75653653401,75653653398,-3,1299,1526,10
75654448895,75654448893,-2,1091,1658,10
75657572171,75657572171,0,1287,2367,10
75660873914,75660873921,7,4111,1628,10
75663004791,75663004788,-3,1349,2771,10
75664643070,75664643066,-4,1148,1533,10
75666865384,75666865382,-2,1191,1591,10
75671303363,75671303361,-2,842,1270,10
75674004271,75674004272,1,2041,1912,10
75679105765,75679105762,-3,1590,2236,10
75681510711,75681510710,-1,1212,1940,10
75684228939,75684228945,6,4786,1655,10
75684262139,75684262140,1,1051,1717,10
75691175871,75691175870,-1,1405,2243,10
75691777044,75691777063,19,1215,2372,10
75692441971,75692441971,0,1058,2421,10
75692663117,75692663116,-1,1042,1880,10
75694397575,75694397576,1,1427,1662,10
75696211843,75696211837,-6,1335,2893,10
75697327108,75697327103,-5,1595,3671,10
75698160746,75698160725,-21,701,1422,10
75698925045,75698925042,-3,852,1285,10
75700911699,75700911698,-1,1123,1405,10
75703158656,75703158654,-2,925,2732,10
75703477894,75703477890,-4,1223,1818,10
75706402354,75706402353,-1,1231,2633,10
75709758826,75709758844,18,1725,1132,10
75714219850,75714219849,-1,1032,1522,10
75719686701,75719686701,0,1128,1391,10
75720514798,75720514797,-1,1038,1764,10
75726173138,75726173137,-1,703,1096,10
75726326236,75726326235,-1,1550,1624,10
75729921349,75729921345,-4,1062,2449,10
75731681256,75731681259,3,2085,1452,10
75732769390,75732769387,-3,1443,2347,10
75736194491,75736194490,-1,1825,1529,10
75736976802,75736976802,0,904,1523,10
75739599518,75739599518,0,1648,1773,10
75743504233,75743504231,-2,1243,1883,10
75750204135,75750204130,-5,1274,2776,10
75756179234,75756179238,4,1866,1177,10
75756763710,75756763711,1,1456,1303,10
75759217788,75759217787,-1,2784,3361,10
75760391254,75760391252,-2,1150,2031,10
75761559078,75761559076,-2,1569,2143,10
75769449267,75769449268,1,1509,2420,10
75771637141,75771637141,0,887,1436,10
75774527483,75774527483,0,1097,2214,10
75776851750,75776851748,-2,751,1691,10
75778308985,75778308983,-2,1142,2109,10
75780578923,75780578920,-3,900,2842,10
75780886895,75780886895,0,1534,1799,10
75784793002,75784792998,-4,1114,2422,10
75786268205,75786268209,4,1219,997,10
75787050813,75787050810,-3,1337,2302,10
75790031839,75790031837,-2,838,2162,10
75791003158,75791003156,-2,750,1641,10
75792480352,75792480349,-3,1612,2236,10
75793634847,75793634844,-3,1164,2036,10
75801772419,75801772418,-1,917,1672,10
75807504070,75807504069,-1,1703,1914,10
75808139879,75808139879,0,1023,1272,10
75810622046,75810622045,-1,1017,1094,10
75815801022,75815801020,-2,1408,2378,10
75819330571,75819330571,0,1212,2115,10
75825705759,75825705759,0,1221,1104,10
75825763748,75825763750,2,1342,1499,10
75827351067,75827351065,-2,1031,2017,10
75830476934,75830476936,2,1190,2201,10
75833398869,75833398867,-2,1412,1522,10
75839809498,75839809500,2,1383,1308,10
75840823162,75840823166,4,1337,1038,10
75841856865,75841856862,-3,992,1790,10
75843307659,75843307659,0,1697,1507,10
75846862157,75846862154,-3,1458,2730,10
75847340592,75847340590,-2,1438,2775,10
75853330995,75853330993,-2,53628,38433,10
75855053779,75855053777,-2,1158,1497,10
75857397264,75857397260,-4,1131,1944,10
75858739954,75858739951,-3,1068,1174,10
75859451803,75859451803,0,1067,1612,10
75861893388,75861893387,-1,1139,1754,10
75868727398,75868727400,2,1173,1598,10
75868779227,75868779226,-1,1237,2027,10
75872905343,75872905341,-2,1591,1801,10
75875116558,75875116554,-4,1032,3412,10
75877190429,75877190431,2,1501,2070,10
75883186820,75883186817,-3,1414,2052,10
75883982126,75883982132,6,2251,1452,10
75887126042,75887126042,0,1346,1663,10
75895712594,75895712593,-1,1572,2662,10
75896327450,75896327468,18,107,1043,10
75898387714,75898387711,-3,1211,2814,10
75902059771,75902059768,-3,1332,1496,10
75903358351,75903358350,-1,1907,2923,10
75904437048,75904437054,6,4164,1523,10
75906896989,75906896987,-2,1371,2626,10
75908786176,75908786169,-7,660,4006,10
75909053371,75909053352,-19,1116,2325,10
75909842651,75909842649,-2,1252,1832,10
75910753206,75910753204,-2,1446,1581,10
75911618154,75911618151,-3,1194,1396,10
75914056253,75914056253,0,1418,1721,10
75914321381,75914321385,4,2287,1586,10
75916349775,75916349774,-1,1443,1997,10
75916939956,75916939953,-3,1387,2217,10
75917084793,75917084812,19,831,2528,10
75917639567,75917639565,-2,1476,1966,10
75918946440,75918946439,-1,1025,1558,10
75922406903,75922406901,-2,1111,1697,10
75923298312,75923298310,-2,913,1301,10
75924197034,75924197033,-1,992,926,10
75928446718,75928446714,-4,1142,2103,10
75928568715,75928568710,-5,1159,3831,10
75932800467,75932800464,-3,1328,2470,10
75936524450,75936524451,1,2076,2484,10
75937258750,75937258748,-2,1203,1700,10
75940094743,75940094741,-2,1036,1259,10
75940565310,75940565306,-4,969,2200,10
75940679085,75940679082,-3,1390,1657,10
75942863222,75942863220,-2,963,2531,10
75942932118,75942932118,0,1020,1615,10
75943486420,75943486418,-2,21580,9139,10
75943561770,75943561756,-14,5105,2669,10
75944108715,75944108714,-1,1377,1932,10
75944762638,75944762638,0,1697,2209,10
75947366194,75947366193,-1,1159,2328,10
75951032923,75951032922,-1,1284,3006,10
75954509150,75954509147,-3,850,1934,10
75954933621,75954933621,0,1359,1845,10
75960473723,75960473721,-2,1432,3161,10
75964889365,75964889361,-4,937,1456,10
75967780014,75967780013,-1,1554,2783,10
75968101022,75968101020,-2,775,1427,10
75968963265,75968963263,-2,1489,2669,10
75969841807,75969841802,-5,541,1853,10
75976260958,75976260957,-1,935,1525,10
75980416885,75980416886,1,1566,2391,10
75985321631,75985321630,-1,1123,2121,10
75985941805,75985941803,-2,941,2336,10
75987718306,75987718312,6,2175,1582,10
75988463135,75988463135,0,1221,1857,10
75989222427,75989222426,-1,1187,2266,10
75990471623,75990471622,-1,843,1793,10
75992944710,75992944707,-3,823,1544,10
75993474200,75993474197,-3,1597,1988,10
75994204813,75994204812,-1,1130,2122,10
75994578650,75994578650,0,1795,1946,10
75994662453,75994662452,-1,1663,1592,10
75995143933,75995143931,-2,1356,1399,10
75995580302,75995580301,-1,941,2073,10
75995631077,75995631076,-1,1188,1907,10
75996166293,75996166291,-2,848,1900,10
75996977010,75996977010,0,874,1869,10
75997607214,75997607211,-3,1110,2197,10
75999105180,75999105178,-2,1244,1566,10
76001709646,76001709635,-11,2995,13306,10
76004304574,76004304571,-3,1139,1860,10
76008279155,76008279154,-1,1128,1508,10
76008736070,76008736069,-1,6681,12523,10
76016735338,76016735337,-1,1228,1994,10
76016947953,76016947959,6,295,485,10
76017997697,76017997696,-1,1397,2349,10
76020713477,76020713474,-3,1372,2424,10
76028233310,76028233308,-2,1336,2795,10
76029112493,76029112492,-1,960,1637,10
76033913305,76033913301,-4,929,1540,10
76039651334,76039651331,-3,836,2207,10
76041772887,76041772885,-2,1195,2311,10
76044800014,76044800013,-1,1392,2269,10
76045064804,76045064802,-2,2689,3887,10
76052999122,76052999120,-2,1439,1975,10
76054141972,76054141973,1,1124,1349,10
76057637082,76057637080,-2,1122,2047,10
76060380026,76060380033,7,4145,1421,10
76061913310,76061913309,-1,1739,2447,10
76063869147,76063869146,-1,1462,1961,10
76068311071,76068311068,-3,1153,2758,10
76068511490,76068511472,-18,1214,1885,10
76068581167,76068581166,-1,1144,1751,10
76070712665,76070712665,0,999,1808,10
76071327695,76071327685,-10,1262,1752,10
76077527785,76077527786,1,1012,1256,10
76081357935,76081357934,-1,1274,1709,10
76083285621,76083285618,-3,997,2136,10
76084478307,76084478306,-1,1215,2922,10
76085397573,76085397573,0,1202,1865,10
76091558440,76091558439,-1,1477,1890,10
76104009675,76104009673,-2,1203,1575,10
76106624261,76106624262,1,1100,1815,10
76112462788,76112462787,-1,1191,2282,10
76116730095,76116730094,-1,1535,3247,10
76118403211,76118403211,0,1226,1480,10
76118630157,76118630157,0,1291,1704,10
76119304765,76119304770,5,2551,1279,10
76125550491,76125550491,0,1073,1647,10
76126204906,76126204904,-2,964,1484,10
76130638531,76130638530,-1,1525,2245,10
76136374087,76136374086,-1,1270,1751,10
76137194858,76137194879,21,1244,1915,10
76137639538,76137639538,0,1547,1773,10
76139286139,76139286134,-5,1112,3605,10
76140648023,76140648023,0,1525,1984,10
76142929469,76142929469,0,1337,1304,10
76149478700,76149478701,1,850,1561,10
76150033194,76150033192,-2,904,1868,10
76153707066,76153707066,0,1544,1886,10
76156268498,76156268496,-2,958,1476,10
76157911128,76157911125,-3,1388,2339,10
76158744384,76158744382,-2,976,2682,10
76162121342,76162121339,-3,936,2016,10
76165037045,76165037045,0,1397,2305,10
76167782422,76167782421,-1,1300,1703,10
76170688503,76170688501,-2,1101,3083,10
76173737555,76173737554,-1,1450,1961,10
76178241610,76178241610,0,1227,2064,10
76181097695,76181097689,-6,924,3581,10
76183813763,76183813766,3,1445,1846,10
76186341190,76186341189,-1,1351,1556,10
76188145070,76188145069,-1,1365,1926,10
76189570380,76189570379,-1,1404,1510,10
76191187394,76191187391,-3,1214,2200,10
76192859194,76192859191,-3,1643,1954,10
76193903974,76193903970,-4,696,1171,10
76195404125,76195404123,-2,735,1281,10
76197230762,76197230761,-1,1344,2559,10
76200871727,76200871725,-2,1083,2141,10
76202198055,76202198054,-1,917,1750,10
76205104665,76205104663,-2,1002,2307,10
76206433899,76206433898,-1,1397,2893,10
76206980842,76206980842,0,826,2300,10
76211704810,76211704806,-4,1561,1857,10
76217235669,76217235672,3,1348,1574,10
76218896048,76218896047,-1,1537,1971,10
76221995933,76221995932,-1,1109,1751,10
76223746829,76223746827,-2,1099,1955,10
76228748385,76228748370,-15,2522,1326,10
76234781751,76234781750,-1,1406,2132,10
76239159302,76239159302,0,922,2364,10
76239287290,76239287311,21,142,618,10
76247846886,76247846885,-1,1661,2044,10
76248670182,76248670181,-1,1325,1709,10
76249602125,76249602129,4,1919,1423,10
76250766973,76250766974,1,777,1688,10
76251145431,76251145430,-1,1039,1508,10
76251792779,76251792785,6,1708,890,10
76256544088,76256544088,0,789,1484,10
76258177451,76258177449,-2,573,786,10
76259939158,76259939154,-4,1746,5148,10
76261325747,76261325746,-1,962,1925,10
76262882680,76262882678,-2,955,1419,10
76263818419,76263818438,19,28,1786,10
76266572862,76266572864,2,1115,1783,10
76267102487,76267102483,-4,1463,2550,10
76268953170,76268953167,-3,1195,1747,10
76276571297,76276571295,-2,1448,1933,10
76276628763,76276628762,-1,1322,1960,10
76277816016,76277816038,22,955,2398,10
76277972347,76277972345,-2,1205,2430,10
76279871854,76279871851,-3,1556,2056,10
76281103579,76281103575,-4,1131,2102,10
76281204542,76281204546,4,1634,1144,10
76283646858,76283646858,0,989,1730,10
76287953485,76287953482,-3,710,988,10
76288581107,76288581105,-2,1218,1913,10
76289108203,76289108199,-4,476,2107,10
76289302393,76289302391,-2,1107,2257,10
76292074591,76292074589,-2,1193,1403,10
76293377614,76293377619,5,5365,2572,10
76294834631,76294834628,-3,1396,1604,10
76295786191,76295786189,-2,793,2020,10
76298304285,76298304284,-1,1150,2282,10
76300757638,76300757634,-4,1485,2421,10
76301354648,76301354665,17,492,902,10
76302693525,76302693531,6,2370,812,10
76303713886,76303713883,-3,1607,2627,10
76304227988,76304227986,-2,2555,3442,10
76305528104,76305528102,-2,1764,2640,10
76307986849,76307986849,0,1176,2090,10
76309360527,76309360525,-2,1256,1538,10
76311474543,76311474543,0,2234,2342,10
76322220380,76322220381,1,1135,1716,10
76327803206,76327803208,2,1607,2589,10
76331271610,76331271608,-2,1106,2734,10
76337543807,76337543806,-1,1122,2991,10
76339586560,76339586559,-1,31379,23204,10
76339760390,76339760390,0,874,1356,10
76340485186,76340485201,15,503,2663,10
76342008357,76342008352,-5,31626,13442,10
76343332454,76343332459,5,3042,1522,10
76343642491,76343642491,0,1015,1545,10
76346478475,76346478474,-1,1191,1311,10
76349774497,76349774495,-2,1470,2322,10
76351302865,76351302862,-3,1287,1645,10
76360490346,76360490349,3,964,1823,10
76362719030,76362719027,-3,1317,2813,10
76366199521,76366199521,0,1305,1686,10
76368572201,76368572199,-2,1455,1840,10
76369531301,76369531299,-2,841,1429,10
76371306655,76371306656,1,1352,1339,10
76373442930,76373442934,4,5321,2776,10
76374201882,76374201880,-2,1125,1866,10
76375041946,76375041946,0,1286,1677,10
76378109015,76378109014,-1,1200,1615,10
76380441430,76380441431,1,1605,2162,10
76381625557,76381625557,0,1450,2122,10
76382379006,76382379005,-1,1286,2157,10
76384023186,76384023182,-4,1273,1605,10
76384230586,76384230586,0,1896,2183,10
76384732566,76384732565,-1,1363,1867,10
76390448111,76390448112,1,1552,2145,10
76391346027,76391346025,-2,1018,1726,10
76393022906,76393022905,-1,1693,2395,10
76393590699,76393590698,-1,996,1816,10
76394265065,76394265066,1,2335,1990,10
76395724450,76395724452,2,1500,1284,10
76395782102,76395782097,-5,680,2764,10
76396089051,76396089049,-2,1317,2371,10
76411925602,76411925602,0,1130,1618,10
76417222567,76417222565,-2,891,1555,10
76421482946,76421482942,-4,1337,2383,10
76422758335,76422758335,0,749,2037,10
76424671431,76424671429,-2,1259,1733,10
76430785895,76430785894,-1,1158,1957,10
76434083059,76434083058,-1,1060,1842,10
76439207788,76439207786,-2,1563,1458,10
76439380945,76439380945,0,1331,1248,10
76440224531,76440224531,0,1420,1631,10
76440337415,76440337414,-1,1315,1875,10
76442285117,76442285117,0,1135,2015,10
76443239885,76443239884,-1,1091,1632,10
76444620382,76444620381,-1,1264,1917,10
76453784490,76453784490,0,1375,2208,10
76456060412,76456060410,-2,1394,1986,10
76456882607,76456882605,-2,1335,2597,10
76468488375,76468488374,-1,1203,2020,10
76473379407,76473379405,-2,1049,2645,10
76474257602,76474257601,-1,1283,2582,10
76475499898,76475499897,-1,1453,2031,10
76477040015,76477040014,-1,1222,1696,10
76478623083,76478623082,-1,1139,1682,10
76478889323,76478889323,0,1120,1343,10
76482336825,76482336825,0,1298,2245,10
76485854110,76485854110,0,1418,2174,10
76486139959,76486139959,0,507,1618,10
76486632117,76486632115,-2,1073,1658,10
76490256543,76490256542,-1,1172,2402,10
76491540711,76491540710,-1,1455,2592,10
76492319755,76492319755,0,1143,1888,10
76492838213,76492838209,-4,18018,18273,10
76498758087,76498758086,-1,758,1566,10
76500540506,76500540507,1,2182,3133,10
76505676066,76505676065,-1,1599,1907,10
76516575030,76516575030,0,1373,1624,10
76525394482,76525394480,-2,1824,3117,10
76526092409,76526092409,0,1072,2123,10
76529843007,76529843008,1,858,1994,10
76530590387,76530590386,-1,1288,1891,10
76534805137,76534805135,-2,1223,1365,10
76537562397,76537562393,-4,1029,1891,10
76542011551,76542011550,-1,1324,2399,10
76542241839,76542241837,-2,1127,1354,10
76545720858,76545720859,1,1437,2232,10
76547428513,76547428519,6,3237,2042,10
76554297263,76554297265,2,704,1227,10
76555240938,76555240938,0,1326,2223,10
76560173011,76560173009,-2,1067,1865,10
76562968899,76562968898,-1,1268,2255,10
76564059791,76564059790,-1,1448,1926,10
76566403472,76566403469,-3,853,1520,10
76567665591,76567665590,-1,1086,2280,10
76571062068,76571062064,-4,1552,2029,10
76572546613,76572546610,-3,1158,1921,10
76574048520,76574048522,2,10387,10068,10
76577100090,76577100087,-3,1378,2061,10
76579582746,76579582766,20,537,1437,10
76581908361,76581908359,-2,1074,1871,10
76583749964,76583749970,6,3268,1585,10
76584759519,76584759517,-2,937,1221,10
76586487593,76586487592,-1,830,1767,10
76588103104,76588103085,-19,67,984,10
76590985545,76590985542,-3,1149,2423,10
76591241185,76591241181,-4,1055,2862,10
76593295583,76593295581,-2,1425,2580,10
76595648609,76595648607,-2,1235,1350,10
76596673767,76596673765,-2,1397,1910,10
76597510621,76597510619,-2,583,814,10
76599328132,76599328130,-2,1367,2207,10
76611317484,76611317490,6,1378,1993,10
76611537463,76611537456,-7,1332,3139,10
76620513636,76620513634,-2,1200,1689,10
76622050894,76622050897,3,1954,1619,10
76624352538,76624352536,-2,1051,2572,10
76624926262,76624926266,4,2662,1906,10
76626090487,76626090487,0,1004,2172,10
76628935667,76628935667,0,574,999,10
76634526699,76634526697,-2,1256,1636,10
76637551302,76637551307,5,2699,1483,10
76639120933,76639120933,0,1654,1807,10
76639744782,76639744783,1,2067,1656,10
76644635894,76644635894,0,1053,1967,10
76645111030,76645111028,-2,1687,2956,10
76647203531,76647203530,-1,928,1654,10
76648895397,76648895395,-2,1204,1844,10
76649339161,76649339159,-2,1045,1541,10
76649702138,76649702124,-14,452,1717,10
76650063608,76650063609,1,1276,1823,10
76650379617,76650379619,2,969,2154,10
76654022138,76654022137,-1,1132,2463,10
76654404002,76654404017,15,677,2187,10
76656764738,76656764736,-2,1083,1970,10
76659582846,76659582846,0,792,1879,10
76659810858,76659810856,-2,1080,2124,10
76663450602,76663450600,-2,1027,1546,10
76663544422,76663544421,-1,1022,1948,10
76667582789,76667582781,-8,1642,10577,10
76668210755,76668210753,-2,1008,2123,10
76669129400,76669129386,-14,814,1288,10
76675410043,76675410041,-2,1157,2234,10
76677092739,76677092738,-1,1288,1368,10
76681559876,76681559874,-2,984,2101,10
76685811567,76685811574,7,2850,1248,10
76687705610,76687705610,0,925,2170,10
76687972184,76687972181,-3,1362,2186,10
76688711131,76688711131,0,1406,1764,10
76688927569,76688927567,-2,1253,1552,10
76689042301,76689042303,2,1239,2243,10
76689431853,76689431853,0,1298,1678,10
76690715954,76690715950,-4,1573,1728,10
76697396346,76697396346,0,1341,1448,10
76699213101,76699213098,-3,986,2164,10
76699722062,76699722059,-3,972,1675,10
76700127783,76700127781,-2,1016,2123,10
76702147724,76702147725,1,2102,1977,10
76705846362,76705846361,-1,967,1512,10
76708514782,76708514797,15,961,1358,10
76712487123,76712487122,-1,1261,2525,10
76717126709,76717126707,-2,1342,1818,10
76721111051,76721111046,-5,871,3562,10
76723920833,76723920831,-2,1417,2259,10
76731206011,76731206010,-1,1616,2041,10
76732876110,76732876110,0,1245,1610,10
76735362047,76735362045,-2,1007,1549,10
76735453892,76735453908,16,1035,2010,10
76735704252,76735704270,18,735,2306,10
76738386760,76738386757,-3,2558,6897,10
76745146663,76745146662,-1,1117,1967,10
76757006475,76757006474,-1,1663,1787,10
76757291683,76757291683,0,1436,1842,10
76758882295,76758882295,0,1276,2257,10
76762756671,76762756667,-4,948,2580,10
76762821251,76762821244,-7,820,2056,10
76763020146,76763020147,1,2090,2975,10
76764882021,76764882022,1,935,1591,10
76765273230,76765273227,-3,896,1810,10
76766162113,76766162106,-7,1086,2135,10
76768760394,76768760394,0,1360,1890,10
76769543146,76769543146,0,1496,2086,10
76770880859,76770880858,-1,1082,1627,10
76772113137,76772113136,-1,1311,2831,10
76773859187,76773859186,-1,1072,1940,10
76774117401,76774117401,0,1364,1884,10
76774753311,76774753311,0,1561,2563,10
76774913654,76774913655,1,1537,1926,10
76776185086,76776185084,-2,1473,2300,10
76778602454,76778602453,-1,1176,1544,10
76780481027,76780481025,-2,1097,1804,10
76783974442,76783974441,-1,1726,2875,10
76784929711,76784929707,-4,1188,1659,10
76786389823,76786389829,6,2911,1085,10
76788712490,76788712489,-1,1507,2283,10
76790916568,76790916567,-1,1395,2591,10
76797929055,76797929054,-1,1285,1546,10
76800113386,76800113386,0,1423,1565,10
76800770541,76800770537,-4,1733,2294,10
76810194907,76810194899,-8,1657,8433,10
76810366099,76810366118,19,877,2241,10
76811865130,76811865132,2,1469,2305,10
76812249931,76812249939,8,1636,809,10
76815901103,76815901102,-1,1077,1832,10
76818532837,76818532834,-3,1201,1717,10
76818616087,76818616085,-2,767,1296,10
76819829522,76819829522,0,1411,2082,10
76820436023,76820436023,0,836,1122,10
76823260398,76823260397,-1,1120,1832,10
76824158040,76824158039,-1,1508,2048,10
76824644626,76824644625,-1,992,1887,10
76825272093,76825272091,-2,1323,2558,10
76826314681,76826314681,0,2369,2720,10
76827360017,76827360014,-3,58729,31496,10
76828142813,76828142812,-1,1585,2059,10
76828653179,76828653180,1,1274,1585,10
76832348628,76832348625,-3,1105,1661,10
76835034957,76835034955,-2,1073,1992,10
76841415647,76841415645,-2,1136,1450,10
76843492973,76843492973,0,1579,1922,10
76844285550,76844285548,-2,1396,2099,10
76849517356,76849517356,0,511,590,10
76851495108,76851495114,6,2300,1154,10
76853152776,76853152774,-2,1067,1490,10
76858063448,76858063446,-2,1308,1464,10
76861119354,76861119353,-1,1231,1947,10
76861640963,76861640963,0,1322,1766,10
76862632587,76862632586,-1,1151,2367,10
76870992831,76870992830,-1,1277,1851,10
76871889776,76871889786,10,12400,24023,10
76871983819,76871983822,3,2064,1591,10
76875787702,76875787703,1,1242,2285,10
76877252882,76877252883,1,1524,1773,10
76878484622,76878484622,0,1485,2323,10
76878611106,76878611107,1,54711,51264,10
76881986182,76881986193,11,35467,1898,10
76882104313,76882104311,-2,1213,1914,10
76883070328,76883070328,0,1206,2252,10
76885848113,76885848110,-3,1369,2451,10
76889158473,76889158471,-2,1321,1853,10
76890242334,76890242334,0,1150,2182,10
76890420571,76890420571,0,1374,1469,10
76890788298,76890788294,-4,869,4007,10
76891412772,76891412771,-1,1702,1840,10
76893632509,76893632526,17,764,1094,10
76899236190,76899236190,0,948,1624,10
76900129883,76900129882,-1,1018,1774,10
76901474579,76901474598,19,876,971,10
76901856183,76901856179,-4,962,2378,10
76902645032,76902645028,-4,1118,1990,10
76907591366,76907591363,-3,1167,1808,10
76908030951,76908030949,-2,949,1642,10
76908642050,76908642047,-3,808,2438,10
76914001685,76914001681,-4,1322,2691,10
76914971729,76914971727,-2,806,2122,10
76915487586,76915487586,0,1065,900,10
76915897781,76915897777,-4,1477,2245,10
76920447855,76920447851,-4,1050,2500,10
76925820523,76925820527,4,1368,1498,10
76926619710,76926619722,12,1267,2143,10
76926776279,76926776280,1,1726,1825,10
76929746076,76929746074,-2,1124,2347,10
76930475162,76930475161,-1,1310,2509,10
76932915515,76932915513,-2,1361,2589,10
76936679185,76936679182,-3,1178,2204,10
76937219913,76937219913,0,1093,1668,10
76937811887,76937811886,-1,1192,1544,10
76945175214,76945175213,-1,721,1988,10
76945578567,76945578565,-2,1145,1671,10
76947441311,76947441313,2,1377,1779,10
76949023861,76949023859,-2,1421,2247,10
76949453814,76949453812,-2,1689,3031,10
76954874803,76954874802,-1,974,1038,10
76955669334,76955669332,-2,1064,2117,10
76956341650,76956341647,-3,1240,1835,10
76957652120,76957652120,0,1420,2307,10
76959074581,76959074581,0,1065,1347,10
76959738223,76959738223,0,916,1685,10
76960644816,76960644801,-15,1284,1070,10
76961065822,76961065824,2,1067,1247,10
76961592618,76961592615,-3,1397,1905,10
76965742819,76965742817,-2,1095,1639,10
76966469219,76966469217,-2,1080,1329,10
76967214507,76967214506,-1,1227,1535,10
76969191859,76969191858,-1,1238,2201,10
76970992195,76970992195,0,1092,1761,10
76972531999,76972531997,-2,1645,2349,10
76974027160,76974027161,1,1303,1757,10
76979556592,76979556590,-2,883,1685,10
76980138470,76980138469,-1,985,2097,10
76982287702,76982287701,-1,1600,1558,10
76985226613,76985226611,-2,1204,2174,10
76988990462,76988990462,0,1171,1493,10
76990994570,76990994569,-1,1052,1498,10
76992831954,76992831946,-8,1487,7722,10
76995320491,76995320490,-1,1061,1853,10
76995969971,76995969973,2,1564,1562,10
76996215161,76996215161,0,1820,2046,10
76997240981,76997240983,2,1545,1467,10
76997721998,76997721999,1,1768,1971,10
76998236313,76998236314,1,997,1742,10
77001788083,77001788084,1,1804,2283,10
77005474253,77005474253,0,1765,1757,10
77015767008,77015767001,-7,772,1458,10
77017325283,77017325282,-1,745,1312,10
77017976232,77017976255,23,829,993,10
77025495069,77025495068,-1,694,2293,10
77026512767,77026512767,0,918,2058,10
77026790294,77026790293,-1,1177,1880,10
77028287741,77028287738,-3,1119,1750,10
77031584327,77031584323,-4,1039,1335,10
77034991912,77034991910,-2,1420,2275,10
77038830721,77038830719,-2,1029,2176,10
77040026203,77040026201,-2,977,2205,10
77040679547,77040679545,-2,990,2071,10
77046283474,77046283475,1,986,1807,10
77050638983,77050638981,-2,979,1771,10
77052019526,77052019524,-2,1521,2336,10
77052313063,77052313062,-1,1134,1813,10
77052915294,77052915291,-3,994,1688,10
77055420313,77055420310,-3,1426,1524,10
77059954863,77059954861,-2,1815,3014,10
77063891825,77063891826,1,994,2338,10
77064394546,77064394543,-3,860,1404,10
77066174650,77066174649,-1,1280,2276,10
77066893178,77066893175,-3,1249,2010,10
77073049246,77073049242,-4,952,1834,10
77074452639,77074452637,-2,1259,1927,10
77075715466,77075715466,0,785,1752,10
77076090093,77076090091,-2,1294,2536,10
77077719722,77077719722,0,1352,2570,10
77078868494,77078868494,0,664,1392,10
77078945717,77078945719,2,1727,1699,10
77080047915,77080047915,0,1410,2060,10
77084739854,77084739852,-2,1412,2184,10
77086298573,77086298571,-2,1229,1909,10
77087650146,77087650145,-1,975,1465,10
77093587526,77093587523,-3,1567,2038,10
77099952971,77099952971,0,746,1466,10
77103170175,77103170173,-2,1459,2057,10
77105881286,77105881283,-3,1319,3459,10
77108523776,77108523787,11,10911,42254,10
77109769267,77109769267,0,4064,6249,10
77114263397,77114263394,-3,1439,1848,10
77114858641,77114858639,-2,1332,1603,10
77125975354,77125975351,-3,1245,2607,10
77129371180,77129371179,-1,999,1879,10
77132343424,77132343422,-2,1151,1720,10
77137181645,77137181641,-4,1146,2367,10
77144650774,77144650773,-1,846,2034,10
77147799077,77147799075,-2,1058,1443,10
77157418135,77157418135,0,1058,1409,10
77157944123,77157944122,-1,742,1200,10
77161634114,77161634114,0,1031,1624,10
77163597542,77163597540,-2,788,1785,10
77163749798,77163749819,21,1355,1793,10
77164311164,77164311162,-2,1285,1765,10
77165320321,77165320318,-3,1324,2172,10
77166213246,77166213245,-1,1001,2329,10
77172828258,77172828257,-1,1134,1805,10
77173396697,77173396714,17,641,1378,10
77173499118,77173499115,-3,1374,1932,10
77174221540,77174221538,-2,63,435,10
77174890755,77174890753,-2,1598,2403,10
77175820650,77175820648,-2,1311,2274,10
77180402266,77180402265,-1,1158,2335,10
77180588530,77180588528,-2,1315,1948,10
77180672745,77180672742,-3,1430,2074,10
77183006181,77183006177,-4,1461,2460,10
77187523107,77187523106,-1,774,1554,10
77187948555,77187948552,-3,1152,2366,10
77189077707,77189077706,-1,1528,1756,10
77193222863,77193222862,-1,802,1707,10
77202218795,77202218795,0,994,1606,10
77203262729,77203262722,-7,2005,10243,10
77203518882,77203518881,-1,1066,2353,10
77207619562,77207619559,-3,866,2167,10
77209199011,77209199010,-1,1134,1244,10
77209898153,77209898151,-2,3021,4634,10
77210098624,77210098631,7,14337,7470,10
77214102862,77214102863,1,940,1257,10
77215491994,77215491990,-4,1626,3176,10
77220648095,77220648093,-2,1317,2069,10
77223248995,77223248994,-1,1135,1474,10
77223902527,77223902530,3,3450,2932,10
77224038288,77224038285,-3,1441,1926,10
77225551944,77225551927,-17,1119,895,10
77228123579,77228123571,-8,1276,5622,10
77231319909,77231319908,-1,1179,1496,10
77232133234,77232133233,-1,1403,1576,10
77232893463,77232893462,-1,2258,2915,10
77235969505,77235969507,2,1555,1487,10
77243229714,77243229713,-1,1553,2890,10
77244171954,77244171954,0,1521,1717,10
77248191240,77248191240,0,1255,1719,10
77256958607,77256958604,-3,1158,3317,10
77257870721,77257870717,-4,893,1936,10
77260953594,77260953590,-4,1193,1897,10
77264776526,77264776525,-1,1440,4105,10
77265427525,77265427524,-1,1610,2087,10
77266601562,77266601558,-4,1159,1791,10
77269092833,77269092854,21,943,2057,10
77270724115,77270724112,-3,1048,2024,10
77272163442,77272163441,-1,1038,2554,10
77276440470,77276440470,0,1731,1536,10
77279250113,77279250114,1,1387,1713,10
77280427681,77280427680,-1,1320,2321,10
77283231398,77283231397,-1,1273,1787,10
77284206398,77284206403,5,2183,1178,10
77285671470,77285671469,-1,849,1876,10
77285861280,77285861274,-6,1017,1868,10
77286527259,77286527250,-9,1022,1534,10
77290321457,77290321457,0,1322,2001,10
77294588055,77294588053,-2,960,1348,10
77307132611,77307132611,0,1922,2749,10
77315023542,77315023542,0,830,2356,10
77317533374,77317533373,-1,1265,1447,10
77318628052,77318628050,-2,1241,1607,10
77318820557,77318820558,1,1918,1358,10
77320610285,77320610283,-2,1624,3033,10
77320928120,77320928122,2,1135,1928,10
77320964683,77320964682,-1,1294,2348,10
77322702166,77322702165,-1,1664,1535,10
77324078430,77324078429,-1,1097,1537,10
77325785050,77325785047,-3,1352,2793,10
77328375133,77328375130,-3,932,1798,10
77330919890,77330919893,3,24852,36089,10
77332669612,77332669611,-1,1547,2230,10
77340719233,77340719241,8,5371,1001,10
77343052126,77343052126,0,1249,2136,10
77343152682,77343152684,2,1161,2058,10
77343939666,77343939652,-14,1019,1798,10
77345775858,77345775857,-1,1277,1626,10
77347867823,77347867822,-1,825,2192,10
77352274237,77352274238,1,1629,1638,10
77353475683,77353475681,-2,1729,3246,10
77355020783,77355020785,2,1082,1641,10
77355724345,77355724366,21,1902,2174,10
77357296510,77357296509,-1,1521,1493,10
77359503474,77359503471,-3,1245,2030,10
77361978150,77361978149,-1,1184,2336,10
77364726842,77364726840,-2,1253,1439,10
77366045213,77366045212,-1,1540,3039,10
77368933605,77368933602,-3,1462,1688,10
77370630607,77370630608,1,1396,1740,10
77372441070,77372441068,-2,2563,4776,10
77373703525,77373703526,1,1022,1968,10
77380601218,77380601216,-2,1382,2624,10
77382007258,77382007258,0,1690,1837,10
77382263377,77382263376,-1,731,1645,10
77383862327,77383862325,-2,1482,2256,10
77384203271,77384203270,-1,979,1667,10
77385531215,77385531210,-5,1001,1951,10
77388750418,77388750417,-1,781,2493,10
77399198510,77399198510,0,1135,1268,10
77400765494,77400765492,-2,959,1269,10
77401473716,77401473723,7,19737,28652,10
77402659703,77402659703,0,1092,1721,10
77406911235,77406911234,-1,751,2039,10
77407526669,77407526671,2,1542,1423,10
77411707771,77411707770,-1,1047,1545,10
77412119352,77412119350,-2,1284,2018,10
77413160475,77413160474,-1,1137,2075,10
77413366243,77413366243,0,1167,2379,10
77414009973,77414009973,0,1621,2368,10
77414575179,77414575175,-4,1303,3104,10
77419356639,77419356639,0,1134,1584,10
77420458257,77420458253,-4,1716,5174,10
77426187609,77426187607,-2,1577,1625,10
77428620190,77428620187,-3,975,2258,10
77437525219,77437525218,-1,1182,2226,10
77440353930,77440353929,-1,1063,2286,10
77440628308,77440628302,-6,417,1125,10
77441723954,77441723955,1,1112,1747,10
77446479267,77446479268,1,1610,2053,10
77451376559,77451376557,-2,776,1682,10
77451406253,77451406251,-2,1286,1826,10
77453396768,77453396766,-2,1644,2162,10
77455504081,77455504080,-1,1389,2041,10
77456151385,77456151366,-19,851,2070,10
77462717824,77462717822,-2,1232,1507,10
77463895091,77463895084,-7,1927,6548,10
77470344188,77470344187,-1,1412,2643,10
77472247143,77472247143,0,39258,17882,10
77472378246,77472378246,0,698,2560,10
77473322402,77473322401,-1,1249,2381,10
77474555876,77474555875,-1,1370,1594,10
77476087167,77476087167,0,1051,1671,10
77479582682,77479582684,2,1423,1699,10
77479790463,77479790462,-1,1102,1729,10
77483552723,77483552721,-2,865,2063,10
77486674161,77486674160,-1,1025,1376,10
77490202941,77490202941,0,1382,2193,10
77496722454,77496722452,-2,1266,2618,10
77498917217,77498917217,0,1035,2086,10
77501721863,77501721870,7,3434,1368,10
77504435816,77504435814,-2,1051,2563,10
77506670698,77506670699,1,1273,2375,10
77508116258,77508116256,-2,1721,2398,10
77508769507,77508769505,-2,990,1663,10
77510054339,77510054342,3,1668,1542,10
77510246271,77510246267,-4,1184,1720,10
77511742706,77511742706,0,908,1287,10
77524827857,77524827855,-2,1278,1604,10
77525209141,77525209138,-3,1789,2726,10
77534620699,77534620697,-2,1576,1983,10
77535820127,77535820123,-4,944,3420,10
77536793043,77536793040,-3,1544,2405,10
77545015066,77545015066,0,1188,2126,10
77545541638,77545541626,-12,11733,37547,10
77547043414,77547043418,4,1549,1539,10
77550365063,77550365071,8,2069,786,10
77554422410,77554422408,-2,903,1855,10
77556081726,77556081726,0,1318,2438,10
77558404512,77558404512,0,1419,2161,10
77560042069,77560042074,5,1769,1039,10
77562051157,77562051154,-3,1535,1951,10
77563198569,77563198567,-2,1180,2322,10
77563244291,77563244285,-6,938,1309,10
77568844190,77568844189,-1,1676,2338,10
77571281285,77571281282,-3,1128,2146,10
77572220292,77572220290,-2,1030,2301,10
77573439626,77573439624,-2,1273,1397,10
77574031106,77574031103,-3,1096,1222,10
77576613484,77576613483,-1,1566,1616,10
77579202135,77579202133,-2,2007,2406,10
77579252163,77579252161,-2,1118,2260,10
77580716144,77580716142,-2,1127,1900,10
77583281830,77583281833,3,1014,1116,10
77584693063,77584693062,-1,1391,2203,10
77585778171,77585778170,-1,1419,1817,10
77586471715,77586471713,-2,1107,2300,10
77587725783,77587725779,-4,991,1515,10
77587980950,77587980946,-4,1618,2214,10
77589292771,77589292769,-2,1194,2361,10
77592450714,77592450712,-2,1646,1928,10
77592780774,77592780772,-2,877,1939,10
77594351519,77594351518,-1,1259,1618,10
77596573795,77596573794,-1,1247,2441,10
77600592596,77600592593,-3,879,3284,10
77603936010,77603936015,5,3542,2244,10
77604364926,77604364925,-1,1332,2121,10
77612414150,77612414147,-3,996,2337,10
77615918566,77615918565,-1,981,2298,10
77618097750,77618097746,-4,1345,2057,10
77618200539,77618200537,-2,1183,2138,10
77621300310,77621300309,-1,1876,2684,10
77627808623,77627808623,0,1201,2280,10
77627840322,77627840302,-20,1376,2424,10
77628064946,77628064948,2,3003,2544,10
77629385249,77629385248,-1,32325,39771,10
77631135679,77631135678,-1,1641,1477,10
77634566588,77634566598,10,20415,44769,10
77636785782,77636785781,-1,651,1861,10
77639601122,77639601116,-6,1326,2085,10
77640521218,77640521216,-2,981,1638,10
77645436946,77645436942,-4,1277,1974,10
77645641613,77645641612,-1,1311,2053,10
77645838301,77645838301,0,1046,2352,10
77649194249,77649194261,12,2286,940,10
77650582906,77650582905,-1,1132,2031,10
77652723150,77652723149,-1,1618,2176,10
77655472830,77655472829,-1,1145,2161,10
77661142128,77661142128,0,1122,1419,10
77661673200,77661673195,-5,1224,2481,10
77667782838,77667782834,-4,1204,2008,10
77667827654,77667827654,0,1857,2076,10
77669774591,77669774591,0,1283,1916,10
77671559042,77671559042,0,1316,1428,10
77675758366,77675758365,-1,1141,2109,10
77677142959,77677142963,4,3606,1765,10
77677927915,77677927912,-3,891,1302,10
77677973423,77677973422,-1,1132,2388,10
77678231991,77678231994,3,1386,991,10
77679813465,77679813463,-2,1281,2141,10
77681609002,77681609000,-2,1266,1972,10
77683708586,77683708583,-3,2663,4515,10
77691859820,77691859813,-7,1370,6921,10
77692216531,77692216527,-4,1064,2599,10
77698997485,77698997486,1,1181,2173,10
77700384257,77700384258,1,1304,1919,10
77703118227,77703118223,-4,1071,2532,10
77707277495,77707277494,-1,980,1414,10
77709939378,77709939378,0,1757,2106,10
77725434898,77725434892,-6,1564,7368,10
77727533597,77727533596,-1,902,1871,10
77728873727,77728873726,-1,1367,2610,10
77729090969,77729090967,-2,1943,2371,10
77734634395,77734634394,-1,1088,1217,10
77735170802,77735170819,17,1537,1376,10
77739616951,77739616946,-5,1683,37963,10
77739740238,77739740237,-1,1124,2043,10
77739903634,77739903635,1,574,1226,10
77740034011,77740034011,0,1244,1720,10
77740750491,77740750489,-2,1067,1738,10
77741391650,77741391650,0,1482,2048,10
77742712273,77742712268,-5,1368,2417,10
77746788110,77746788109,-1,771,1644,10
77751533570,77751533566,-4,1247,2716,10
77755084694,77755084691,-3,967,1659,10
77756867667,77756867666,-1,1291,1604,10
77757890209,77757890206,-3,1153,1405,10
77763142561,77763142558,-3,1118,1731,10
77765807410,77765807409,-1,1610,2166,10
77768540163,77768540161,-2,805,1943,10
77769499728,77769499724,-4,938,2148,10
77772242666,77772242665,-1,1304,2145,10
77775038571,77775038570,-1,1029,2037,10
77777244209,77777244207,-2,1590,2941,10
77778627684,77778627682,-2,1152,2797,10
77779109274,77779109272,-2,1285,1765,10
77780525920,77780525918,-2,1160,1829,10
77780575744,77780575741,-3,1404,1677,10
77781395781,77781395779,-2,1207,2704,10
77782129192,77782129212,20,733,1230,10
77784492910,77784492909,-1,1467,2613,10
77786326783,77786326785,2,1049,1406,10
77789515075,77789515070,-5,1204,2491,10
77794736587,77794736588,1,1344,2938,10
77796573675,77796573673,-2,1102,2987,10
77798133991,77798133990,-1,1159,2596,10
77799382670,77799382676,6,354,1987,10
77799775001,77799774998,-3,946,2031,10
77805432991,77805432992,1,1046,1792,10
77806937161,77806937166,5,3168,1384,10
77808672919,77808672920,1,1591,2663,10
77811180559,77811180557,-2,1002,1388,10
77813961797,77813961795,-2,842,1629,10
77819461527,77819461525,-2,1332,2334,10
77820920895,77820920892,-3,882,1944,10
77823884421,77823884421,0,907,1872,10
77826198953,77826198952,-1,259,1097,10
77832566994,77832566995,1,1483,1554,10
77833271241,77833271248,7,9056,2576,10
77836266739,77836266737,-2,1575,2664,10
77838982406,77838982401,-5,848,2597,10
77846363653,77846363652,-1,1363,1377,10
77848521571,77848521573,2,1801,2206,10
77852172478,77852172488,10,1265,1974,10
77853336813,77853336810,-3,2094,4424,10
77854982065,77854982063,-2,1663,2849,10
77855110219,77855110218,-1,1537,2319,10
77855829005,77855829019,14,1148,1523,10
77860110238,77860110235,-3,1043,2449,10
77860839857,77860839859,2,175,905,10
77863510789,77863510791,2,1347,1712,10
77864962634,77864962637,3,4519,20856,10
77867889429,77867889435,6,2571,1320,10
77872452625,77872452625,0,1005,1801,10
77875117238,77875117237,-1,1699,2565,10
77877579552,77877579557,5,2277,1701,10
77879091000,77879090998,-2,1366,2310,10
77883761152,77883761151,-1,1382,2506,10
77894307101,77894307099,-2,1674,2029,10
77897694145,77897694138,-7,892,1572,10
77897772597,77897772595,-2,1028,2144,10
77900358218,77900358218,0,888,1985,10
77908900339,77908900338,-1,1336,1868,10
77910690070,77910690074,4,1454,1299,10
77911969570,77911969571,1,1271,1158,10
77913421007,77913421005,-2,1761,3239,10
77913486166,77913486165,-1,1365,2418,10
77914547995,77914547995,0,1134,1648,10
77915024882,77915024879,-3,1523,2621,10
77917354619,77917354616,-3,943,2074,10
77926279401,77926279392,-9,43620,7998,10
77926451718,77926451717,-1,1416,2793,10
77928708905,77928708905,0,1826,1602,10
77933794166,77933794165,-1,1119,1825,10
77935964994,77935964992,-2,880,1557,10
77936336548,77936336544,-4,1382,1799,10
77941007290,77941007307,17,37,867,10
77942603711,77942603711,0,834,1551,10
77945495685,77945495697,12,17150,53791,10
77946465424,77946465421,-3,1005,1610,10
77948518231,77948518231,0,1297,1550,10
77949722174,77949722170,-4,1045,2146,10
77952572772,77952572770,-2,1119,2311,10
77953326694,77953326698,4,1279,2591,10
77953511530,77953511529,-1,1196,2290,10
77958556055,77958556053,-2,1012,1830,10
77959049317,77959049323,6,903,1399,10
77961375926,77961375925,-1,1250,2424,10
77961729146,77961729145,-1,1102,1323,10
77963512227,77963512231,4,2526,1728,10
77968751938,77968751937,-1,1269,1337,10
77973740447,77973740446,-1,933,2031,10
77974645818,77974645816,-2,1250,1993,10
77978447188,77978447186,-2,1150,1953,10
77986273989,77986273987,-2,1075,3050,10
77986704392,77986704391,-1,1055,1942,10
77987456867,77987456866,-1,1656,1963,10
77990669075,77990669071,-4,1235,3100,10
77992003959,77992003961,2,1314,981,10
77993099835,77993099841,6,3412,1486,10
77996937618,77996937618,0,819,1717,10
77996972027,77996972023,-4,1466,2977,10
77997263898,77997263898,0,1455,1571,10
77999547809,77999547805,-4,1137,2289,10
78001210304,78001210303,-1,2069,2827,10
78002249181,78002249185,4,1311,1654,10
78004592862,78004592862,0,1037,1863,10
78004865889,78004865883,-6,940,2752,10
78009227820,78009227818,-2,1033,2777,10
78011284388,78011284386,-2,947,1816,10
78013197455,78013197455,0,925,1234,10
78015922247,78015922246,-1,1372,2469,10
78016131014,78016131014,0,920,1857,10
78020904358,78020904370,12,1196,1352,10
78021471790,78021471788,-2,1358,2792,10
78023984524,78023984518,-6,456,5694,10
78029675286,78029675284,-2,1267,1625,10
78030679218,78030679217,-1,746,1619,10
78038604913,78038604908,-5,4626,14716,10
78039879887,78039879885,-2,1253,1740,10
78048119972,78048119971,-1,1026,2234,10
78048608000,78048607999,-1,1034,1203,10
78050244289,78050244290,1,1346,1616,10
78050862686,78050862686,0,974,1947,10
78051621074,78051621081,7,1255,2598,10
78055425759,78055425757,-2,1101,2129,10
78057263466,78057263466,0,1962,2383,10
78060289570,78060289569,-1,1351,2080,10
78060741131,78060741143,12,2935,7845,10
78061998510,78061998512,2,12470,22757,10
78064476300,78064476298,-2,982,1759,10
78065603075,78065603073,-2,841,1931,10
78069706187,78069706185,-2,1389,1755,10
78072763133,78072763131,-2,1168,1808,10
78073189755,78073189751,-4,1135,2562,10
78077256051,78077256049,-2,1594,2388,10
78082466518,78082466517,-1,1227,2266,10
78084458084,78084458082,-2,1188,2294,10
78085361195,78085361193,-2,942,1783,10
78086588550,78086588549,-1,1629,2000,10
78086807082,78086807081,-1,1020,1770,10
78090550138,78090550139,1,788,1176,10
78091262270,78091262266,-4,1268,2804,10
78092927440,78092927438,-2,1402,2114,10
78095519631,78095519629,-2,630,1476,10
78099947434,78099947436,2,1157,1768,10
78100864563,78100864559,-4,998,2206,10
78102788163,78102788182,19,1173,2629,10
78103233709,78103233709,0,1375,1895,10
78103398582,78103398578,-4,836,1938,10
78105831970,78105831967,-3,1312,1436,10
78106574669,78106574669,0,1393,2038,10
78106879851,78106879832,-19,994,1473,10
78107117879,78107117879,0,1049,1734,10
78108349291,78108349289,-2,1298,2244,10
78108465451,78108465450,-1,1462,2037,10
78109356509,78109356509,0,1100,1729,10
78112243862,78112243860,-2,1880,1731,10
78117107146,78117107146,0,866,1326,10
78118216694,78118216694,0,1075,1888,10
78120609109,78120609105,-4,1013,1685,10
78121541027,78121541024,-3,1038,2257,10
78123407365,78123407362,-3,1219,2210,10
78131488722,78131488721,-1,1005,2373,10
78134512510,78134512511,1,1233,2009,10
78134660706,78134660703,-3,1719,3201,10
78142679181,78142679161,-20,226,1086,10
78144249017,78144249006,-11,1209,2127,10
78146912583,78146912580,-3,1185,2107,10
78150853122,78150853124,2,1145,1968,10
78151701443,78151701442,-1,1023,2243,10
78152991613,78152991611,-2,1125,2098,10
78156336281,78156336277,-4,1409,2393,10
78159661945,78159661950,5,1742,1289,10
78164918402,78164918402,0,1539,2771,10
78165793628,78165793628,0,1029,1689,10
78167424663,78167424662,-1,905,1464,10
78167792325,78167792323,-2,1274,2124,10
78168282112,78168282110,-2,1396,2589,10
78172097877,78172097878,1,1145,1995,10
78174138283,78174138288,5,5152,2125,10
78176930902,78176930902,0,971,1421,10
78177200642,78177200641,-1,1205,1994,10
78178709063,78178709058,-5,1464,2257,10
78180369782,78180369779,-3,1388,1844,10
78183956057,78183956054,-3,1078,1330,10
78185666302,78185666299,-3,1154,2271,10
78187439806,78187439802,-4,771,1094,10
78190390805,78190390804,-1,1566,2329,10
78193497027,78193497025,-2,1480,2273,10
78193655128,78193655126,-2,1469,2709,10
78197751438,78197751437,-1,995,1879,10
78199037735,78199037734,-1,595,1182,10
78199193969,78199193967,-2,971,1340,10
78199284808,78199284798,-10,1394,2443,10
78203764766,78203764765,-1,945,1716,10
78204496274,78204496274,0,964,1681,10
78212820829,78212820825,-4,851,1664,10
78213159986,78213159984,-2,967,1071,10
78213408923,78213408922,-1,1663,2212,10
78213568682,78213568678,-4,1012,2205,10
78217323301,78217323293,-8,1018,1584,10
78223040017,78223040017,0,809,1899,10
78224206077,78224206075,-2,1795,3138,10
78228471480,78228471479,-1,815,1991,10
78230923119,78230923119,0,1664,2429,10
78232134677,78232134677,0,1469,2036,10
78246227838,78246227835,-3,953,2050,10
78248673092,78248673090,-2,1506,1925,10
78251923887,78251923886,-1,1172,1784,10
78252532878,78252532874,-4,1034,2019,10
78255874086,78255874087,1,1180,1517,10
78258041847,78258041845,-2,1164,1841,10
78262086845,78262086845,0,1071,1638,10
78263140753,78263140751,-2,1219,2430,10
78263546138,78263546118,-20,786,1518,10
78263787789,78263787788,-1,1492,2399,10
78268139023,78268139021,-2,897,1229,10
78269516615,78269516614,-1,1511,2265,10
78272352235,78272352234,-1,1369,1725,10
78275794449,78275794450,1,1204,1818,10
78277744687,78277744686,-1,1312,2289,10
78278427370,78278427367,-3,1221,2358,10
78285477592,78285477587,-5,741,1144,10
78287116142,78287116140,-2,1410,1733,10
78292564442,78292564440,-2,1571,1836,10
78295680707,78295680706,-1,1329,1972,10
78296378895,78296378895,0,1235,2012,10
78297166817,78297166810,-7,782,3275,10
78300306262,78300306261,-1,1178,2378,10
78300717162,78300717160,-2,1071,1821,10
78301351686,78301351686,0,1178,1894,10
78306768227,78306768226,-1,1437,1965,10
78309820778,78309820776,-2,1652,2773,10
78310518790,78310518791,1,2727,2725,10
78316824210,78316824204,-6,1426,6274,10
78318721383,78318721382,-1,1067,1460,10
78318844652,78318844651,-1,1526,2179,10
78319188890,78319188889,-1,754,993,10
78322973047,78322973047,0,1335,1737,10
78324602833,78324602838,5,2690,1606,10
78327893793,78327893791,-2,1524,1859,10
78328827735,78328827734,-1,963,1667,10
78328895078,78328895078,0,1640,1596,10
78332361842,78332361839,-3,1378,1896,10
78332709009,78332709007,-2,1437,2377,10
78333210333,78333210331,-2,1305,2305,10
78333359974,78333359974,0,1160,1115,10
78333521343,78333521342,-1,1375,1797,10
78338402202,78338402202,0,1065,2027,10
78341096641,78341096641,0,787,1606,10
78341853380,78341853379,-1,824,1161,10
78344999043,78344999032,-11,709,2519,10
78348281338,78348281338,0,794,1216,10
78351538781,78351538781,0,1302,1806,10
78352413286,78352413285,-1,1180,1776,10
78354025947,78354025949,2,1649,2487,10
78355511126,78355511126,0,1524,2495,10
78358634457,78358634455,-2,1705,2113,10
78359264721,78359264719,-2,1089,1910,10
78360973255,78360973253,-2,974,1845,10
78362463246,78362463245,-1,1068,1693,10
78362538726,78362538726,0,967,1523,10
78364046389,78364046386,-3,1746,2142,10
78364887525,78364887522,-3,1010,2219,10
78364944010,78364944005,-5,723,1399,10
78365724034,78365724033,-1,1285,1397,10
78367020818,78367020817,-1,1590,2016,10
78370682725,78370682722,-3,1059,2549,10
78372295655,78372295655,0,1253,2829,10
78382363339,78382363337,-2,1441,2326,10
78389903896,78389903897,1,1227,1691,10
78390193538,78390193537,-1,742,1589,10
78393543956,78393543956,0,1009,2300,10
78394017277,78394017274,-3,1324,2734,10
78396156586,78396156585,-1,1274,2503,10
78396559283,78396559271,-12,1229,1196,10
78399296995,78399296994,-1,1200,2923,10
78401907366,78401907366,0,747,1384,10
78402753373,78402753373,0,1536,1747,10
78404020431,78404020431,0,632,1313,10
78405787343,78405787342,-1,1667,2918,10
78406708709,78406708706,-3,1012,1362,10
78409353197,78409353196,-1,1762,2694,10
78412518101,78412518100,-1,1607,2899,10
78413090304,78413090306,2,3967,29891,10
78414628708,78414628726,18,1404,1927,10
78415248961,78415248958,-3,911,1833,10
78415766485,78415766481,-4,2997,5246,10
78417188403,78417188405,2,1131,1581,10
78419674772,78419674774,2,2396,1428,10
78422282547,78422282544,-3,995,1288,10
78423406794,78423406794,0,1033,1601,10
78426926562,78426926561,-1,756,1390,10
78430632922,78430632922,0,1679,1507,10
78431207753,78431207753,0,16097,6566,10
78434724622,78434724619,-3,1194,2025,10
78435759671,78435759670,-1,985,1580,10
78438991639,78438991638,-1,669,1437,10
78439512283,78439512277,-6,34450,17573,10
78440291109,78440291107,-2,1343,1761,10
78442710974,78442710973,-1,1398,1785,10
78445006814,78445006813,-1,1450,2704,10
78448860176,78448860175,-1,980,1951,10
78449305386,78449305383,-3,686,1358,10
78456065320,78456065314,-6,2610,5630,10
78457881201,78457881199,-2,1039,2013,10
78460948341,78460948341,0,1112,1715,10
78462763642,78462763640,-2,1436,2195,10
78463426895,78463426891,-4,1644,2328,10
78464036538,78464036537,-1,1457,1655,10
78465484655,78465484654,-1,1085,1667,10
78470714994,78470714993,-1,1028,1126,10
78471442817,78471442818,1,1537,1885,10
78473648903,78473648900,-3,769,1539,10
78474118180,78474118178,-2,1370,2213,10
78474720627,78474720626,-1,1168,2158,10
78475258009,78475258009,0,1213,2786,10
78476850594,78476850591,-3,1275,2505,10
78479422586,78479422586,0,1252,1833,10
78485198762,78485198768,6,2376,1899,10
78490175587,78490175586,-1,1386,2172,10
78491152699,78491152700,1,465,1123,10
78492891885,78492891882,-3,986,1977,10
78493691341,78493691340,-1,1242,1853,10
78495123771,78495123770,-1,1749,2659,10
78496833803,78496833802,-1,1070,2405,10
78499488970,78499488969,-1,1701,2040,10
78502678279,78502678278,-1,938,2515,10
78507262703,78507262704,1,1441,2001,10
78511053071,78511053070,-1,893,1855,10
78513362101,78513362105,4,1295,1413,10
78514757278,78514757277,-1,1491,2708,10
78516919518,78516919517,-1,1233,2512,10
78516997201,78516997194,-7,1185,2263,10
78524814087,78524814085,-2,1098,1987,10
78525351135,78525351134,-1,1039,2598,10
78526269530,78526269530,0,908,1885,10
78526415334,78526415333,-1,1032,2009,10
78527993330,78527993329,-1,915,1944,10
78529199730,78529199728,-2,1210,1985,10
78531241550,78531241548,-2,1518,2851,10
78531383818,78531383818,0,1355,2435,10
78531582992,78531582992,0,1523,2040,10
78536948331,78536948329,-2,1196,2017,10
78541424779,78541424775,-4,1096,1096,10
78548243371,78548243372,1,1406,2154,10
78548763873,78548763873,0,1297,1774,10
78550004939,78550004957,18,814,2327,10
78551216692,78551216689,-3,1924,4414,10
78551620990,78551620988,-2,1093,2296,10
78552054298,78552054295,-3,993,1802,10
78558952890,78558952887,-3,859,1735,10
78560270126,78560270125,-1,1235,2278,10
78560533282,78560533301,19,363,721,10
78562797243,78562797241,-2,1044,1946,10
78563038373,78563038371,-2,1728,2515,10
78563657726,78563657722,-4,1207,2555,10
78566412530,78566412527,-3,1324,2243,10
78566621889,78566621886,-3,903,2258,10
78575156519,78575156521,2,1445,1924,10
78580055299,78580055298,-1,1388,1933,10
78582103398,78582103398,0,1026,1230,10
78584530739,78584530737,-2,1753,2551,10
78587300504,78587300510,6,2994,1932,10
78587464775,78587464772,-3,1172,1714,10
78590054080,78590054077,-3,1416,1561,10
78599350403,78599350398,-5,1543,2703,10
78599679012,78599679008,-4,828,2139,10
78601607790,78601607790,0,1666,1989,10
78603407450,78603407448,-2,1600,1931,10
78605106939,78605106938,-1,1016,3129,10
78608438763,78608438763,0,1578,2114,10
78609451298,78609451296,-2,663,1633,10
78609946749,78609946746,-3,1089,1595,10
78614739623,78614739631,8,1044,1326,10
78618322777,78618322777,0,1484,1989,10
78620342611,78620342612,1,1193,2069,10
78626265390,78626265396,6,2508,1215,10
78626708819,78626708823,4,982,1072,10
78633144558,78633144558,0,995,2111,10
78634463778,78634463791,13,1278,1522,10
78637183239,78637183236,-3,1332,2321,10
78639125145,78639125144,-1,1529,2134,10
78643452149,78643452147,-2,1095,2202,10
78643839065,78643839066,1,1243,1974,10
78644152590,78644152589,-1,931,1379,10
78645801998,78645801997,-1,1383,1653,10
78649186747,78649186748,1,1899,2513,10
78650418705,78650418703,-2,1630,2008,10
78654931581,78654931582,1,1526,2227,10
78656434317,78656434320,3,4143,3434,10
78657114151,78657114149,-2,1274,2476,10
78658314034,78658314034,0,1645,2113,10
78659991707,78659991705,-2,1155,2133,10
78660737415,78660737413,-2,1276,1998,10
78664598155,78664598153,-2,1299,1214,10
78668155798,78668155798,0,701,1502,10
78671483004,78671482998,-6,1064,4447,10
78671562659,78671562657,-2,994,1495,10
78676920434,78676920432,-2,1543,2322,10
78682414099,78682414098,-1,1136,1851,10
78685506529,78685506530,1,1142,1504,10
78687170862,78687170863,1,1178,2825,10
78688916313,78688916314,1,1156,1253,10
78689937128,78689937128,0,1421,2181,10
78690936818,78690936815,-3,1493,1574,10
78699279110,78699279110,0,1058,1452,10
78699549203,78699549202,-1,1260,2132,10
78701181182,78701181179,-3,1712,2330,10
78701535710,78701535709,-1,1413,2163,10
78701914496,78701914493,-3,811,1552,10
78703388951,78703388964,13,1000,1475,10
78704663234,78704663234,0,1090,2287,10
78708273090,78708273088,-2,1231,2749,10
78709735235,78709735251,16,449,1263,10
78712588169,78712588167,-2,1399,2498,10
78715355419,78715355414,-5,881,2777,10
78715474947,78715474946,-1,1198,2594,10
78718605185,78718605182,-3,1397,1436,10
78718942928,78718942925,-3,1572,1391,10
78726512762,78726512760,-2,1383,1616,10
78726567133,78726567131,-2,1538,1821,10
78731767694,78731767691,-3,1600,2959,10
78732036227,78732036226,-1,1087,1963,10
78733478378,78733478375,-3,1256,2322,10
78735498466,78735498480,14,1010,1291,10
78740877077,78740877072,-5,2161,7365,10
78748153387,78748153387,0,1240,2568,10
78749677986,78749677989,3,1279,2418,10
78750994959,78750994958,-1,1179,1958,10
78751684074,78751684078,4,3178,3161,10
78757000177,78757000177,0,1415,1898,10
78761378280,78761378279,-1,796,1792,10
78761766733,78761766732,-1,700,1278,10
78764841393,78764841393,0,862,2020,10
78765432312,78765432310,-2,1127,2183,10
78771185233,78771185231,-2,1680,2031,10
78773022099,78773022107,8,260,786,10
78782209654,78782209654,0,1410,1949,10
78782552209,78782552211,2,1407,1633,10
78783028951,78783028951,0,899,1473,10
78783797029,78783797029,0,649,1351,10
78784372231,78784372230,-1,1695,2354,10
78784952084,78784952081,-3,790,2767,10
78787100901,78787100899,-2,1195,2437,10
78788315938,78788315942,4,2302,1437,10
78791196324,78791196322,-2,954,1972,10
78791657773,78791657770,-3,1526,2266,10
78793737643,78793737641,-2,1112,1359,10
78794008002,78794008001,-1,1347,1941,10
78799045582,78799045580,-2,906,1532,10
78799464818,78799464818,0,1843,2015,10
78801248285,78801248282,-3,1272,2261,10
78802195815,78802195814,-1,1513,2416,10
78802421297,78802421291,-6,773,2500,10
78806900342,78806900342,0,1196,1456,10
78808936338,78808936336,-2,1669,2137,10
78815237075,78815237073,-2,1421,1510,10
78815441395,78815441399,4,27382,19707,10
78816526929,78816526944,15,897,1320,10
78818647591,78818647589,-2,1243,2347,10
78830309844,78830309842,-2,852,1846,10
78830692761,78830692758,-3,1511,2370,10
78831527722,78831527723,1,1042,1496,10
78832885066,78832885065,-1,1561,2127,10
78833359905,78833359903,-2,1003,1610,10
78841777582,78841777580,-2,1019,1475,10
78844828838,78844828835,-3,946,1734,10
78846490119,78846490124,5,2236,1080,10
78848854595,78848854594,-1,615,1490,10
78850932547,78850932543,-4,1021,2140,10
78857673694,78857673694,0,892,1788,10
78861243949,78861243947,-2,811,1051,10
78863145695,78863145694,-1,1563,2582,10
78863434735,78863434734,-1,880,2356,10
78867461548,78867461546,-2,1212,2245,10
78868410711,78868410710,-1,1297,1849,10
78869433274,78869433274,0,1902,2273,10
78872305222,78872305221,-1,1417,2139,10
78874075801,78874075803,2,1512,1065,10
78874158347,78874158345,-2,939,1703,10
78875542531,78875542535,4,2031,932,10
78876407516,78876407515,-1,1362,1987,10
78885397955,78885397955,0,688,1498,10
78887872988,78887872987,-1,1397,2096,10
78892422682,78892422681,-1,959,1572,10
78894769650,78894769648,-2,1183,2119,10
78897914782,78897914781,-1,1160,2063,10
78901537403,78901537401,-2,1111,2487,10
78901714802,78901714800,-2,1860,2887,10
78904560478,78904560478,0,1407,1813,10
78904922346,78904922345,-1,1370,1548,10
78910671740,78910671739,-1,1643,2618,10
78910707527,78910707526,-1,1045,1891,10
78912516425,78912516425,0,2683,3742,10
78916597894,78916597894,0,1081,1734,10
78921960465,78921960463,-2,1192,1586,10
78922034379,78922034374,-5,734,1950,10
78923141186,78923141185,-1,1273,2658,10
78925985201,78925985198,-3,1429,1681,10
78926654083,78926654065,-18,1163,2873,10
78929092355,78929092374,19,27237,22572,10
78931669263,78931669262,-1,2185,2386,10
78935741533,78935741533,0,1803,2750,10
78935782267,78935782267,0,1237,1610,10
78937150497,78937150494,-3,883,1663,10
78939193854,78939193851,-3,995,1388,10
78941018583,78941018581,-2,1068,1084,10
78948441606,78948441605,-1,1323,2161,10
78967322498,78967322495,-3,1007,1570,10
78968230154,78968230140,-14,986,1690,10
78972221820,78972221818,-2,1585,3178,10
78976456572,78976456571,-1,1016,2150,10
78981539018,78981539022,4,10991,7444,10
78982692918,78982692918,0,1307,2300,10
78987820654,78987820654,0,922,1776,10
78988314070,78988314070,0,1126,2167,10
78990455473,78990455473,0,1158,1712,10
78995297873,78995297879,6,5936,1325,10
78996050151,78996050149,-2,1624,2114,10
78998817847,78998817846,-1,829,1599,10
78999366219,78999366237,18,119,1053,10
79000528877,79000528876,-1,1105,1771,10
79003369416,79003369414,-2,1324,2853,10
79005479898,79005479897,-1,1539,2074,10
79007293245,79007293243,-2,1805,3050,10
79015912384,79015912384,0,3021,2422,10
79022063593,79022063591,-2,1337,1594,10
79022318898,79022318898,0,1552,2953,10
79022415933,79022415934,1,1541,1384,10
79024606602,79024606602,0,1261,1800,10
79028898366,79028898362,-4,1308,2340,10
79029249281,79029249278,-3,1470,2167,10
79029788905,79029788902,-3,1052,1528,10
79030893597,79030893594,-3,1692,2775,10
79031129251,79031129250,-1,922,1538,10
79031300217,79031300213,-4,1893,3298,10
79034241027,79034241026,-1,1296,1762,10
79042997398,79042997395,-3,952,2333,10
79045952831,79045952827,-4,999,1937,10
79046613186,79046613183,-3,1238,2075,10
79046908834,79046908837,3,1879,1504,10
79049613060,79049613058,-2,1591,2080,10
79052578011,79052578009,-2,1154,2191,10
79053478594,79053478595,1,1386,1670,10
79058067622,79058067621,-1,1793,2604,10
79059293431,79059293430,-1,889,1840,10
79061041325,79061041326,1,1061,2343,10
79064230381,79064230386,5,7124,3153,10
79066621035,79066621034,-1,1108,1895,10
79067992547,79067992545,-2,1615,2165,10
79068450941,79068450952,11,10781,43441,10
79070591226,79070591222,-4,1090,1904,10
79072915861,79072915860,-1,1052,2367,10
79074805037,79074805036,-1,1087,1256,10
79076556434,79076556430,-4,1450,2108,10
79076591593,79076591613,20,776,1996,10
79077428395,79077428393,-2,1655,1833,10
79078063430,79078063429,-1,880,1661,10
79081112199,79081112199,0,1564,2394,10
79081456563,79081456561,-2,1233,2209,10
79082772230,79082772229,-1,1599,2287,10
79083780429,79083780425,-4,1250,2507,10
79085018695,79085018694,-1,861,1438,10
79097072582,79097072581,-1,1379,2015,10
79102194393,79102194393,0,883,1545,10
79105240013,79105240013,0,1621,2372,10
79115089787,79115089784,-3,543,1734,10
79116823697,79116823717,20,1681,1356,10
79117079103,79117079102,-1,1272,1745,10
79123167599,79123167597,-2,1540,2938,10
79125503419,79125503419,0,535,1228,10
79125942304,79125942294,-10,1359,2398,10
79126516756,79126516773,17,1150,2058,10
79130784950,79130784955,5,1972,929,10
79134169689,79134169690,1,1218,1619,10
79135614551,79135614549,-2,1093,2249,10
79138132489,79138132489,0,949,1805,10
79139339631,79139339629,-2,1029,1617,10
79140603554,79140603554,0,706,1693,10
79140634876,79140634854,-22,833,1938,10
79141077030,79141077030,0,1688,2083,10
79147087890,79147087887,-3,1422,1816,10
79147197310,79147197303,-7,1143,4186,10
79151579501,79151579498,-3,973,2404,10
79152555283,79152555282,-1,1261,1799,10
79154461630,79154461629,-1,953,2434,10
79156066710,79156066710,0,1301,1905,10
79159370846,79159370846,0,1253,2264,10
79159448539,79159448537,-2,1396,1868,10
79161595922,79161595921,-1,1344,2371,10
79166276507,79166276510,3,3075,1951,10
79166931308,79166931306,-2,892,2608,10
79169139423,79169139420,-3,1210,2005,10
79173501354,79173501353,-1,1407,1835,10
79173915877,79173915876,-1,1594,2331,10
79176706694,79176706693,-1,1184,1875,10
79177223874,79177223873,-1,1176,2007,10
79177977268,79177977266,-2,1066,1825,10
79178523342,79178523342,0,22361,20586,10
79178724009,79178724008,-1,1385,2173,10
79179175040,79179175057,17,315,830,10
79183078246,79183078245,-1,1096,1900,10
79183373303,79183373301,-2,1438,2303,10
79188947239,79188947238,-1,1485,2026,10
79190074728,79190074719,-9,1167,1601,10
79190468311,79190468310,-1,1274,2654,10
79191684183,79191684182,-1,1485,1588,10
79191710043,79191710042,-1,1633,2870,10
79193337747,79193337753,6,3294,1061,10
79194794739,79194794735,-4,954,2723,10
79196584541,79196584541,0,1639,2112,10
79200513981,79200513976,-5,1200,5246,10
79202631101,79202631101,0,1404,2012,10
79204264931,79204264930,-1,799,1516,10
79204308543,79204308541,-2,1804,2801,10
79205726106,79205726106,0,1209,2561,10
79208812487,79208812486,-1,1238,2316,10
79209324194,79209324191,-3,1453,2234,10
79211335310,79211335307,-3,841,2263,10
79211501934,79211501931,-3,1077,2391,10
79211892803,79211892801,-2,1237,2299,10
79212336347,79212336346,-1,510,2005,10
79212442472,79212442471,-1,914,2282,10
79221476969,79221476968,-1,1746,2205,10
79222386353,79222386349,-4,761,1810,10
79223238582,79223238582,0,1647,2312,10
79229669779,79229669778,-1,643,882,10
79230673635,79230673633,-2,979,1159,10
79231570971,79231570959,-12,1166,1817,10
79233699938,79233699937,-1,1299,2288,10
79235672970,79235672969,-1,1595,2083,10
79237834864,79237834866,2,1298,1825,10
79242882531,79242882530,-1,1758,2173,10
79243089193,79243089191,-2,1454,2322,10
79246140050,79246140047,-3,1000,1896,10
79246305714,79246305715,1,1287,1567,10
79246723489,79246723482,-7,1732,10669,10
79248292688,79248292687,-1,1269,1615,10
79248684245,79248684242,-3,1351,1955,10
79254638597,79254638596,-1,1679,2058,10
79254849864,79254849862,-2,1609,1715,10
79260053847,79260053847,0,1350,1548,10
79261245624,79261245618,-6,944,3670,10
79261618851,79261618850,-1,1443,2147,10
79264473554,79264473554,0,1225,1517,10
79267463575,79267463577,2,3893,4475,10
79269908178,79269908176,-2,1024,1579,10
79270491889,79270491888,-1,1198,2084,10
79274324975,79274324974,-1,2733,4897,10
79275099577,79275099569,-8,828,2486,10
79282965044,79282965042,-2,1367,3060,10
79283634523,79283634501,-22,157,766,10
79293375886,79293375885,-1,940,1657,10
79295435929,79295435927,-2,1195,1814,10
79302689392,79302689392,0,1762,3107,10
79304852921,79304852917,-4,868,3078,10
79308588190,79308588191,1,823,2357,10
79314117178,79314117177,-1,569,2283,10
79316732269,79316732268,-1,912,2023,10
79320185621,79320185622,1,8522,50267,10
79320285878,79320285884,6,12192,20482,10
79320352259,79320352257,-2,1436,2226,10
79327249197,79327249197,0,1321,1976,10
79327774036,79327774033,-3,1508,2236,10
79328032105,79328032104,-1,980,2632,10
79331568859,79331568853,-6,1253,3885,10
79335335202,79335335200,-2,1458,2199,10
79337792298,79337792297,-1,1204,1927,10
79343203849,79343203861,12,4674,18331,10
79345511628,79345511629,1,1760,1764,10
79348926078,79348926078,0,1974,2435,10
79350761998,79350761997,-1,935,2150,10
79351745310,79351745308,-2,1089,1413,10
79352041066,79352041066,0,1369,2240,10
79352658842,79352658845,3,1270,570,10
79353935245,79353935242,-3,2696,4917,10
79356054271,79356054283,12,1379,1854,10
79358331931,79358331933,2,1024,2043,10
79360447379,79360447377,-2,583,1253,10
79361059021,79361059021,0,1122,1858,10
79362891562,79362891562,0,1178,1590,10
79364929795,79364929795,0,1722,1711,10
79365183695,79365183697,2,1491,1795,10
79371227562,79371227560,-2,1186,1898,10
79373125523,79373125518,-5,1291,1878,10
79378467847,79378467845,-2,1168,1881,10
79380051507,79380051508,1,1088,1648,10
79381718990,79381718989,-1,1189,1749,10
79385287815,79385287814,-1,1178,2287,10
79387599466,79387599467,1,992,1669,10
79388348942,79388348944,2,1726,1728,10
79391574183,79391574183,0,974,2246,10
79394911642,79394911638,-4,1196,3127,10
79396625519,79396625516,-3,1043,1507,10
79399034231,79399034233,2,1691,2124,10
79402069318,79402069318,0,1415,1984,10
79403200749,79403200749,0,1414,1342,10
79412880066,79412880071,5,1457,1170,10
79415545829,79415545842,13,15552,45733,10
79416852075,79416852074,-1,1242,2353,10
79420367113,79420367111,-2,906,1191,10
79422350834,79422350834,0,1801,2113,10
79424339994,79424339994,0,838,1440,10
79430096524,79430096521,-3,1452,2858,10
79436037215,79436037213,-2,1182,1482,10
79436906114,79436906118,4,1614,1049,10
79443142885,79443142883,-2,994,1406,10
79445555439,79445555439,0,1127,1763,10
79445581523,79445581543,20,1463,1363,10
79446690975,79446690974,-1,1397,2446,10
79452908781,79452908779,-2,1526,2543,10
79458306278,79458306278,0,1164,2191,10
79459842230,79459842228,-2,1005,2773,10
79460068755,79460068753,-2,1362,1904,10
79464038506,79464038504,-2,1270,2193,10
79464910354,79464910354,0,851,2514,10
79466740578,79466740577,-1,1003,2025,10
79467603045,79467603043,-2,1038,1507,10
79468358816,79468358814,-2,1388,2857,10
79468540425,79468540446,21,389,1684,10
79476947162,79476947166,4,1983,1584,10
79477553452,79477553453,1,938,2079,10
79478358913,79478358897,-16,1434,2166,10
79480680342,79480680340,-2,1111,2163,10
79485035656,79485035654,-2,1541,2211,10
79488988615,79488988593,-22,949,1813,10
79493420584,79493420582,-2,1039,1493,10
79497098431,79497098431,0,1195,1939,10
79497864505,79497864502,-3,858,1905,10
79509764380,79509764379,-1,1714,2176,10
79520901028,79520901028,0,865,2038,10
79521629067,79521629051,-16,1509,2013,10
79522624161,79522624157,-4,1156,1623,10
79524400266,79524400267,1,1167,1429,10
79525261766,79525261765,-1,1689,2473,10
79525489253,79525489260,7,14366,6869,10
79526707321,79526707320,-1,1614,2344,10
79528018530,79528018526,-4,1311,2247,10
79528177611,79528177610,-1,1081,1677,10
79536709699,79536709698,-1,1326,1978,10
79537893943,79537893939,-4,1031,1956,10
79540607266,79540607266,0,1472,1795,10
79541111196,79541111193,-3,1132,1665,10
79544127966,79544127968,2,1225,1473,10
79547228213,79547228213,0,1387,1534,10
79551435916,79551435914,-2,968,1234,10
79555332570,79555332568,-2,1473,2297,10
79556266431,79556266430,-1,1636,2973,10
79560653862,79560653862,0,1365,2611,10
79562104178,79562104179,1,1197,1539,10
79562924473,79562924470,-3,869,2213,10
79565714666,79565714670,4,3712,2263,10
79569184622,79569184623,1,906,1224,10
79571197253,79571197251,-2,740,1073,10
79571726223,79571726223,0,1236,2262,10
79574332955,79574332951,-4,1334,2171,10
79574518530,79574518530,0,1018,1631,10
79577958391,79577958389,-2,900,940,10
79583129608,79583129605,-3,1089,1702,10
79584861890,79584861890,0,1234,2144,10
79586999151,79586999131,-20,1473,1989,10
79587723049,79587723049,0,1412,1722,10
79587873611,79587873610,-1,1015,1807,10
79589590386,79589590382,-4,1218,1530,10
79600102338,79600102337,-1,1239,2414,10
79603861757,79603861756,-1,1171,1721,10
79609266862,79609266859,-3,1205,1976,10
79611219070,79611219070,0,935,1921,10
79612488710,79612488729,19,937,1454,10
79613319925,79613319922,-3,611,1389,10
79613859941,79613859943,2,2718,1896,10
79621022933,79621022934,1,1411,1152,10
79622201973,79622201970,-3,1245,1955,10
79622550666,79622550686,20,918,2691,10
79626500939,79626500935,-4,910,2907,10
79627069135,79627069130,-5,1680,5718,10
79627315045,79627315045,0,1052,1836,10
79630410091,79630410090,-1,1346,1891,10
79634842348,79634842353,5,2925,1321,10
79635079131,79635079130,-1,1210,1513,10
79639995330,79639995323,-7,986,3087,10
79653473362,79653473358,-4,953,2226,10
79653574187,79653574203,16,756,2090,10
79657598194,79657598194,0,1390,1655,10
79658412402,79658412398,-4,1562,2617,10
79663113266,79663113278,12,1252,1945,10
79663586958,79663586960,2,2019,1387,10
79674996030,79674996030,0,1649,1561,10
79675111408,79675111406,-2,1037,1716,10
79679015340,79679015340,0,1516,2144,10
79679237832,79679237830,-2,1016,2111,10
79681728450,79681728449,-1,1406,2302,10
79693779022,79693779022,0,1153,1697,10
79695585581,79695585600,19,1157,1855,10
79696385277,79696385279,2,2340,1494,10
79697660781,79697660778,-3,1904,2391,10
79704202995,79704202993,-2,965,1392,10
79705169966,79705169966,0,9669,12848,10
79706034518,79706034509,-9,32312,56138,10
79706894086,79706894085,-1,1438,2349,10
79707630519,79707630518,-1,1663,2179,10
79708336906,79708336904,-2,2361,2131,10
79709069433,79709069432,-1,889,1630,10
79711079338,79711079334,-4,1999,2233,10
79712680030,79712680030,0,990,1449,10
79718056179,79718056176,-3,1246,2187,10
79720883566,79720883566,0,1261,2129,10
79721107314,79721107335,21,1529,2030,10
79723237262,79723237261,-1,1304,2226,10
79726773574,79726773554,-20,919,1550,10
79728699906,79728699907,1,811,1238,10
79731373943,79731373941,-2,1401,2262,10
79731472814,79731472814,0,1715,1959,10
79731733409,79731733409,0,1000,1906,10
79735339518,79735339521,3,1498,1294,10
79736787380,79736787379,-1,1526,2282,10
79742692241,79742692240,-1,1319,1269,10
79748668917,79748668914,-3,1081,1646,10
79749404174,79749404176,2,1386,2216,10
79754682892,79754682890,-2,1043,2020,10
79755161069,79755161067,-2,1541,2231,10
79756185599,79756185598,-1,1271,1983,10
79756327072,79756327057,-15,1078,2197,10
79758865386,79758865383,-3,1417,2275,10
79761626997,79761626995,-2,853,2096,10
79764031134,79764031115,-19,1134,1593,10
79765513403,79765513400,-3,848,1199,10
79766781596,79766781597,1,1766,1455,10
79769387243,79769387242,-1,1008,1659,10
79769701959,79769701966,7,2581,1214,10
79770715791,79770715791,0,1025,882,10
79773344367,79773344365,-2,1572,2115,10
79775918447,79775918445,-2,752,1766,10
79776186579,79776186578,-1,995,973,10
79777727043,79777727040,-3,1080,2197,10
79780955246,79780955246,0,1041,1417,10
79781144009,79781144006,-3,1429,2163,10
79781726984,79781727003,19,859,1222,10
79782429823,79782429821,-2,1175,2091,10
79783550512,79783550531,19,803,2117,10
79785211194,79785211193,-1,1269,1807,10
79789188250,79789188253,3,1226,1653,10
79789406533,79789406529,-4,999,1739,10
79795098371,79795098373,2,2337,2208,10
79798686644,79798686646,2,2155,1951,10
79798872047,79798872044,-3,1054,1675,10
79803464639,79803464636,-3,1325,2566,10
79807247803,79807247801,-2,1096,1805,10
79807485347,79807485347,0,1106,1433,10
79812051651,79812051649,-2,1556,2058,10
79815353775,79815353774,-1,1093,1737,10
79819194887,79819194884,-3,1271,2009,10
79819226824,79819226822,-2,1223,1701,10
79820106698,79820106702,4,4599,4073,10
79820359638,79820359636,-2,1679,2430,10
79822024354,79822024353,-1,1131,2010,10
79822930546,79822930546,0,1077,2112,10
79827905234,79827905234,0,1300,1841,10
79833919382,79833919380,-2,1105,2322,10
79836079565,79836079566,1,1119,1886,10
79838742659,79838742659,0,1400,1514,10
79839566467,79839566466,-1,1219,2349,10
79843896154,79843896153,-1,1574,1534,10
79844051468,79844051467,-1,1612,1922,10
79848651490,79848651489,-1,1180,1828,10
79849274854,79849274854,0,1576,2094,10
79850861566,79850861563,-3,1243,2780,10
79852588497,79852588500,3,1731,1805,10
79853222857,79853222854,-3,951,1494,10
79854783317,79854783317,0,2182,2528,10
79855316049,79855316048,-1,1503,2024,10
79859929830,79859929827,-3,945,2266,10
79861218274,79861218270,-4,1179,2383,10
79861338314,79861338314,0,1227,1813,10
79865295964,79865295962,-2,1068,1774,10
79865825637,79865825634,-3,1713,2358,10
79868673995,79868673997,2,876,1100,10
79870604989,79870604989,0,1634,1692,10
79871961487,79871961486,-1,878,1027,10
79873846126,79873846123,-3,1176,2311,10
79876849345,79876849341,-4,1007,1222,10
79877684733,79877684730,-3,1028,1032,10
79884128146,79884128145,-1,1388,1749,10
79885471127,79885471127,0,1320,1776,10
79886910703,79886910703,0,3627,18642,10
79891677398,79891677397,-1,1213,2303,10
79891858542,79891858540,-2,723,1464,10
79892671095,79892671093,-2,1570,2035,10
79893305484,79893305480,-4,21693,16977,10
79899316805,79899316805,0,1143,2289,10
79901467140,79901467139,-1,1177,1761,10
79905370342,79905370342,0,1143,1340,10
79907162306,79907162305,-1,876,1447,10
79910413667,79910413666,-1,1253,1693,10
79911113026,79911113024,-2,1307,1371,10
79913780445,79913780443,-2,1062,1336,10
79917185867,79917185862,-5,1311,2687,10
79917641715,79917641714,-1,608,1409,10
79921779306,79921779308,2,1132,1839,10
79923815007,79923815006,-1,1112,2771,10
79931012258,79931012256,-2,458,1420,10
79933817571,79933817576,5,3884,1806,10
79935146334,79935146333,-1,922,2420,10
79940093719,79940093719,0,871,1556,10
79940177093,79940177090,-3,1025,2594,10
79940495270,79940495266,-4,1015,1568,10
79947620734,79947620733,-1,1328,1589,10
79949986397,79949986395,-2,1418,1501,10
79952389478,79952389478,0,1702,2286,10
79955383187,79955383185,-2,993,1908,10
79958326625,79958326626,1,1293,2094,10
79959016113,79959016111,-2,1002,1724,10
79959438302,79959438300,-2,1445,1754,10
79959509992,79959509997,5,15593,8679,10
79959571651,79959571646,-5,880,1389,10
79960196779,79960196769,-10,1359,2463,10
79961133188,79961133182,-6,2266,8197,10
79962852354,79962852360,6,1641,1219,10
79963221374,79963221371,-3,1018,1271,10
79966143393,79966143393,0,1408,1819,10
79967016651,79967016650,-1,1045,1713,10
79969688400,79969688396,-4,1504,3606,10
79978141603,79978141601,-2,1092,1980,10
79978727922,79978727919,-3,1404,2708,10
79979013712,79979013710,-2,1291,2066,10
79984450643,79984450637,-6,1037,1450,10
79990757188,79990757172,-16,1715,1232,10
79993790839,79993790833,-6,970,3218,10
79995780704,79995780701,-3,1241,1297,10
79997258845,79997258845,0,1266,2041,10
80005820726,80005820724,-2,1014,1829,10
80005959085,80005959082,-3,759,1976,10
80007175969,80007175966,-3,1924,6676,10
80007819373,80007819374,1,1375,1659,10
80010421680,80010421677,-3,1520,2583,10
80012675306,80012675305,-1,1358,2440,10
80014028244,80014028245,1,1583,3066,10
80019801551,80019801549,-2,1189,1929,10
80029610305,80029610302,-3,1518,1639,10
80033173227,80033173223,-4,1081,2492,10
80034831401,80034831401,0,1281,1514,10
80037100494,80037100491,-3,1123,2317,10
80038721210,80038721214,4,4174,2622,10
80043134298,80043134297,-1,1352,2076,10
80045830770,80045830770,0,1108,2059,10
80046512451,80046512450,-1,1145,2292,10
80047961443,80047961441,-2,897,2279,10
80052225422,80052225421,-1,1276,1700,10
80053813504,80053813501,-3,967,2472,10
80053941929,80053941922,-7,1192,1767,10
80056319026,80056319025,-1,1862,2304,10
80056955098,80056955098,0,1501,1978,10
80057376939,80057376936,-3,1279,2423,10
80058391165,80058391162,-3,1543,2636,10
80060975123,80060975122,-1,1156,2202,10
80064907754,80064907753,-1,1318,2215,10
80069546858,80069546855,-3,1580,2131,10
80069861379,80069861369,-10,1688,1978,10
80070771101,80070771099,-2,1103,1861,10
80071473513,80071473511,-2,1023,1505,10
80073226710,80073226707,-3,1219,1595,10
80074137958,80074137957,-1,1256,2175,10
80078376210,80078376210,0,661,862,10
80079561632,80079561630,-2,1173,1313,10
80081741995,80081741996,1,875,1701,10
80082316318,80082316315,-3,1348,2464,10
80082646511,80082646507,-4,1099,2399,10
80082992998,80082992995,-3,1182,1850,10
80084215473,80084215471,-2,1506,1616,10
80084993613,80084993610,-3,1279,1430,10
80089615015,80089615014,-1,1425,1840,10
80097208167,80097208166,-1,1396,1632,10
80097266582,80097266579,-3,1102,2911,10
80100824459,80100824458,-1,1148,1673,10
80101943207,80101943205,-2,903,1112,10
80103071426,80103071426,0,924,1659,10
80106270390,80106270385,-5,712,1661,10
80111794342,80111794338,-4,897,1580,10
80114221261,80114221260,-1,1664,2627,10
80120258315,80120258314,-1,1085,1625,10
80121016314,80121016313,-1,1282,2076,10
80122932475,80122932480,5,12425,8466,10
80123473213,80123473212,-1,963,1880,10
80127138247,80127138246,-1,1065,1630,10
80132381659,80132381658,-1,1633,2009,10
80134743374,80134743374,0,1354,2309,10
80137486791,80137486789,-2,943,1845,10
80139621425,80139621422,-3,1145,2913,10
80140529124,80140529130,6,2213,1189,10
80145199123,80145199121,-2,1119,1511,10
80145871223,80145871221,-2,1206,1271,10
80146284585,80146284582,-3,1136,1819,10
80149159838,80149159835,-3,1179,2487,10
80150058370,80150058366,-4,1103,1317,10
80154030206,80154030208,2,1830,1377,10
80154250056,80154250054,-2,1028,1733,10
80156895214,80156895210,-4,1057,2112,10
80157925865,80157925866,1,1318,1505,10
80158641184,80158641184,0,1301,1771,10
80167678783,80167678787,4,3866,2250,10
80170221986,80170221985,-1,909,1743,10
80171390452,80171390450,-2,1203,2101,10
80172075215,80172075215,0,611,998,10
80176871650,80176871650,0,1398,2316,10
80178553511,80178553506,-5,19771,17392,10
80181624108,80181624107,-1,1402,2224,10
80183332375,80183332373,-2,1025,2285,10
80184798523,80184798521,-2,502,917,10
80186259770,80186259767,-3,1458,1754,10
80191433340,80191433343,3,1319,2188,10
80191524521,80191524521,0,1380,2174,10
80192666842,80192666841,-1,1010,2301,10
80198836683,80198836682,-1,1140,1460,10
80200338391,80200338392,1,1327,1616,10
80203748783,80203748779,-4,1101,2894,10
80204888387,80204888385,-2,1466,3139,10
80205190459,80205190462,3,1576,1545,10
80205854061,80205854062,1,969,1295,10
80206297317,80206297317,0,1175,2036,10
80207511471,80207511470,-1,1366,2242,10
80207820774,80207820773,-1,1437,1693,10
80210443767,80210443766,-1,935,1478,10
80215195066,80215195066,0,1437,1912,10
80215605483,80215605481,-2,480,1306,10
80218083326,80218083331,5,4936,3735,10
80218233823,80218233821,-2,1224,2655,10
80222225635,80222225634,-1,1553,2670,10
80222572751,80222572750,-1,1128,1883,10
80224925964,80224925962,-2,1024,1835,10
80226747500,80226747498,-2,1501,1595,10
80228207810,80228207806,-4,1073,2338,10
80232478855,80232478854,-1,1030,1608,10
80233333596,80233333595,-1,1426,1957,10
80234363578,80234363577,-1,1406,1697,10
80238114121,80238114134,13,18562,57910,10
80241855613,80241855611,-2,1013,1804,10
80243720775,80243720773,-2,1270,1900,10
80244304781,80244304781,0,1041,1840,10
80246989770,80246989768,-2,1553,2513,10
80253675230,80253675230,0,1302,2461,10
80253798134,80253798133,-1,1765,2323,10
80254174691,80254174690,-1,1134,1294,10
80255483464,80255483465,1,1007,1238,10
80256044943,80256044947,4,2333,1564,10
80257221093,80257221090,-3,1806,2182,10
80258817054,80258817053,-1,1111,2772,10
80260673980,80260673975,-5,867,2263,10
80262432939,80262432935,-4,1240,2649,10
80264960126,80264960122,-4,1033,2377,10
80266256683,80266256691,8,264,582,10
80277998490,80277998486,-4,1244,2206,10
80278622256,80278622254,-2,1178,2002,10
80280008043,80280008042,-1,852,1308,10
80281606400,80281606397,-3,1620,2597,10
80283603455,80283603453,-2,863,1144,10
80284405260,80284405266,6,966,1549,10
80286469183,80286469183,0,1160,1689,10
80292675594,80292675594,0,1159,2107,10
80293870141,80293870139,-2,1824,3098,10
80301427946,80301427945,-1,721,1239,10
80303136478,80303136472,-6,945,2375,10
80306167301,80306167299,-2,750,1412,10
80306622421,80306622422,1,1552,2034,10
80309861793,80309861789,-4,1356,2447,10
80312721555,80312721553,-2,899,2244,10
80315616233,80315616231,-2,1094,2072,10
80315988674,80315988674,0,1507,2963,10
80316593637,80316593642,5,12650,24786,10
80322031143,80322031141,-2,973,1754,10
80325995639,80325995639,0,1230,1241,10
80327611879,80327611879,0,1125,1786,10
80327870863,80327870870,7,5862,2645,10
80334082409,80334082423,14,18889,29094,10
80335731966,80335731967,1,1690,1909,10
80340497638,80340497636,-2,1174,1914,10
80342564519,80342564517,-2,1677,2852,10
80344751803,80344751801,-2,977,1278,10
80351482649,80351482646,-3,1529,2448,10
80353289392,80353289391,-1,1820,3256,10
80356471718,80356471714,-4,1004,2492,10
80359742904,80359742906,2,39466,17192,10
80360772061,80360772059,-2,1001,2311,10
80361030878,80361030881,3,631,1360,10
80361617662,80361617666,4,2424,1478,10
80364051126,80364051123,-3,1657,3061,10
80364584914,80364584908,-6,31047,12091,10
80367014482,80367014480,-2,802,2007,10
80367848069,80367848072,3,1735,1157,10
80367950742,80367950742,0,1044,1649,10
80370129159,80370129157,-2,1209,2395,10
80372077710,80372077710,0,1321,1685,10
80372570032,80372570034,2,1558,1600,10
80375680061,80375680070,9,17716,15858,10
80375987284,80375987282,-2,1186,2958,10
80379065270,80379065267,-3,1143,2462,10
80380061916,80380061933,17,1221,1838,10
80381376171,80381376170,-1,1261,2410,10
80382641338,80382641339,1,1180,1627,10
80382985665,80382985661,-4,651,1409,10
80383330535,80383330535,0,1053,2523,10
80386509963,80386509961,-2,1305,2005,10
80386646019,80386646038,19,875,1109,10
80389850474,80389850472,-2,1193,2072,10
80394226878,80394226875,-3,1222,1587,10
80394862506,80394862507,1,1527,2125,10
80400530135,80400530132,-3,1179,1968,10
80400806590,80400806589,-1,1676,1747,10
80403761621,80403761619,-2,951,2274,10
80404029250,80404029250,0,1769,1826,10
80405937621,80405937620,-1,1457,2521,10
80407228160,80407228150,-10,375,7786,10
80412095579,80412095578,-1,1126,1899,10
80416852878,80416852877,-1,1502,3426,10
80417129002,80417129000,-2,1503,1892,10
80419881311,80419881311,0,973,1220,10
80429021567,80429021565,-2,1230,2171,10
80435048411,80435048410,-1,1107,2122,10
80439387746,80439387745,-1,1122,1879,10
80439955297,80439955297,0,999,1119,10
80444874698,80444874695,-3,890,1555,10
80445332115,80445332094,-21,1753,1173,10
80445934822,80445934821,-1,1062,1577,10
80451883703,80451883699,-4,1568,2718,10
80452057783,80452057786,3,665,960,10
80452804706,80452804705,-1,1327,2585,10
80454823162,80454823163,1,1330,2309,10
80456036598,80456036591,-7,1260,5156,10
80456307010,80456307008,-2,781,1893,10
80457659890,80457659889,-1,1755,2116,10
80459376610,80459376609,-1,1488,2773,10
80464733995,80464733993,-2,980,1521,10
80466839018,80466839017,-1,1096,2057,10
80469889029,80469889029,0,1335,2462,10
80471408332,80471408325,-7,88,4672,10
80471440052,80471440050,-2,1291,1687,10
80472228421,80472228424,3,2457,1495,10
80475001455,80475001455,0,7932,9295,10
80476095230,80476095230,0,1417,2069,10
80477426846,80477426844,-2,1525,1633,10
80480925729,80480925729,0,1852,2999,10
80481755887,80481755894,7,4600,1331,10
80482498457,80482498454,-3,1007,1820,10
80484726139,80484726137,-2,1083,1644,10
80487776427,80487776424,-3,1298,1179,10
80489826594,80489826593,-1,1594,2838,10
80494838771,80494838768,-3,1132,1916,10
80496224899,80496224902,3,1849,1600,10
80496696686,80496696686,0,1626,2867,10
80503265692,80503265690,-2,974,1787,10
80505316206,80505316203,-3,1193,2186,10
80506889538,80506889538,0,1357,2400,10
80507438338,80507438337,-1,689,1758,10
80512543069,80512543067,-2,770,858,10
80524044506,80524044505,-1,990,1920,10
80529236770,80529236776,6,13335,37306,10
80546634724,80546634722,-2,1114,2151,10
80547702986,80547702986,0,1171,2070,10
80552173198,80552173195,-3,975,1941,10
80552760326,80552760323,-3,670,1180,10
80558204944,80558204942,-2,1531,2223,10
80559012302,80559012300,-2,943,2020,10
80562304666,80562304666,0,1042,2295,10
80566212533,80566212531,-2,872,241,10
80567158963,80567158962,-1,1178,1775,10
80569322696,80569322695,-1,2001,2245,10
80570479986,80570479985,-1,1044,1928,10
80573288690,80573288690,0,1033,2355,10
80594685812,80594685818,6,5817,2492,10
80595733297,80595733296,-1,1257,1605,10
80596368750,80596368750,0,1032,2081,10
80596965610,80596965609,-1,1248,1888,10
80601849569,80601849566,-3,1151,2316,10
80603285309,80603285310,1,1324,2129,10
80606859146,80606859143,-3,1368,2655,10
80607792232,80607792231,-1,1185,1203,10
80609344713,80609344719,6,1496,1363,10
80610218750,80610218746,-4,951,1332,10
80623116727,80623116726,-1,1271,1472,10
80626766941,80626766940,-1,837,1532,10
80629790846,80629790838,-8,22992,16144,10
80631508357,80631508354,-3,1333,2369,10
80634013074,80634013073,-1,1291,2148,10
80638022463,80638022461,-2,980,2452,10
80644469452,80644469450,-2,1384,3252,10
80644676852,80644676858,6,4852,1784,10
80644847040,80644847043,3,1823,1142,10
80648649010,80648649010,0,1418,2022,10
80648990219,80648990211,-8,978,2649,10
80652179921,80652179918,-3,1040,2367,10
80654498728,80654498726,-2,1031,1644,10
80658770489,80658770490,1,1016,1703,10
80660601569,80660601567,-2,1387,1823,10
80664319062,80664319062,0,1178,1966,10
80665114774,80665114774,0,821,1359,10
80666418611,80666418611,0,1515,2368,10
80667162454,80667162453,-1,1067,1834,10
80675228703,80675228702,-1,943,1909,10
80675734862,80675734860,-2,1118,2016,10
80677487775,80677487774,-1,1364,1536,10
80685144255,80685144254,-1,1042,1812,10
80687106534,80687106546,12,10638,48452,10
80689368305,80689368305,0,1067,1902,10
80689598400,80689598399,-1,1353,1812,10
80691039483,80691039467,-16,391,1917,10
80692816626,80692816623,-3,1346,2135,10
80693076258,80693076257,-1,701,1153,10
80696259936,80696259929,-7,2896,8436,10
80697396363,80697396364,1,24290,21940,10
80697628558,80697628561,3,1425,1695,10
80698946460,80698946454,-6,973,4390,10
80703923794,80703923795,1,1115,1136,10
80705925171,80705925170,-1,955,1214,10
80706460502,80706460501,-1,1081,1509,10
80706631594,80706631591,-3,1411,2777,10
80712843119,80712843114,-5,1337,2039,10
80718943381,80718943382,1,1546,1450,10
80722491810,80722491809,-1,973,2121,10
80723558613,80723558614,1,1092,1731,10
80725042577,80725042575,-2,984,2047,10
80727139564,80727139558,-6,1067,3753,10
80727715825,80727715813,-12,1126,2596,10
80735755114,80735755112,-2,1164,1683,10
80737455950,80737455950,0,1297,1909,10
80739099818,80739099817,-1,945,1827,10
80739213330,80739213329,-1,1176,1677,10
80739936655,80739936655,0,1490,2096,10
80740650889,80740650889,0,1679,1687,10
80742668174,80742668171,-3,1529,2051,10
80744708174,80744708173,-1,1268,2319,10
80753068182,80753068196,14,41118,11155,10
80758689802,80758689800,-2,941,2063,10
80759616290,80759616290,0,961,2061,10
80760775681,80760775678,-3,1284,2288,10
80762128603,80762128602,-1,1376,1869,10
80768722292,80768722291,-1,1478,1472,10
80772207462,80772207461,-1,1069,2103,10
80779068095,80779068096,1,1210,1820,10
80786439126,80786439123,-3,1153,2224,10
80792237635,80792237633,-2,1199,2059,10
80793268745,80793268744,-1,1432,1712,10
80798474951,80798474952,1,1341,2074,10
80799213601,80799213598,-3,1270,2036,10
80799292610,80799292610,0,1575,2005,10
80802384498,80802384497,-1,1206,1910,10
80802840485,80802840481,-4,1026,2533,10
80812419601,80812419622,21,280,947,10
80813726176,80813726199,23,1217,2243,10
80814816956,80814816955,-1,1597,1927,10
80816538668,80816538667,-1,2100,2937,10
80823178759,80823178758,-1,1635,2802,10
80823695110,80823695108,-2,1491,2217,10
80828700547,80828700547,0,1237,2187,10
80828823289,80828823287,-2,1165,2115,10
80830987108,80830987107,-1,1244,1901,10
80832172087,80832172085,-2,1109,2146,10
80843579487,80843579484,-3,1506,2008,10
80847308810,80847308806,-4,1550,2873,10
80853607491,80853607489,-2,1230,1969,10
80855139313,80855139312,-1,1690,2629,10
80855590698,80855590698,0,1566,1647,10
80858413504,80858413505,1,926,2327,10
80861277036,80861277034,-2,1126,2227,10
80861528888,80861528893,5,4261,2043,10
80874392844,80874392848,4,1496,1020,10
80875491595,80875491593,-2,1130,1793,10
80877687226,80877687226,0,1283,1669,10
80877851522,80877851523,1,1383,2119,10
80878489724,80878489723,-1,995,2044,10
80883681095,80883681094,-1,1018,2302,10
80884556717,80884556711,-6,799,5764,10
80887795374,80887795369,-5,1201,2491,10
80888031523,80888031522,-1,1071,1304,10
80889867842,80889867841,-1,1090,2287,10
80890992715,80890992714,-1,1545,2496,10
80892052591,80892052592,1,987,1733,10
80893477162,80893477161,-1,1117,1909,10
80895843402,80895843403,1,1608,1224,10
80896165315,80896165312,-3,1569,2699,10
80897646685,80897646685,0,1192,1473,10
80898419189,80898419185,-4,1213,2547,10
80899858575,80899858573,-2,1667,2085,10
80905673475,80905673472,-3,1092,1717,10
80906074055,80906074053,-2,1758,2167,10
80906599025,80906599026,1,1576,1857,10
80906868814,80906868813,-1,874,1623,10
80907674836,80907674859,23,433,2517,10
80909193527,80909193526,-1,1954,3206,10
80912858480,80912858481,1,1279,1923,10
80913036776,80913036797,21,1157,1455,10
80914918980,80914918980,0,1593,1706,10
80919544077,80919544077,0,1191,2559,10
80919762449,80919762449,0,1849,2324,10
80921156602,80921156602,0,1665,2127,10
80921307799,80921307801,2,1467,1323,10
80922023779,80922023775,-4,1270,2493,10
80922716078,80922716077,-1,1264,1619,10
80925153511,80925153509,-2,980,1748,10
80925253278,80925253276,-2,1064,1960,10
80929031182,80929031190,8,9622,37187,10
80934131731,80934131729,-2,1173,2816,10
80935532647,80935532645,-2,1166,2070,10
80940007238,80940007235,-3,2226,5931,10
80940556791,80940556790,-1,492,1021,10
80944807135,80944807131,-4,1249,2348,10
80946365192,80946365190,-2,950,2087,10
80947497552,80947497550,-2,1662,2044,10
80948671165,80948671163,-2,1517,2792,10
80949154646,80949154642,-4,1062,3046,10
80952332697,80952332695,-2,879,1136,10
80958546024,80958546021,-3,1525,2335,10
80962128778,80962128778,0,1123,2164,10
80963090820,80963090834,14,569,1364,10
80963386793,80963386790,-3,2050,2386,10
80963754585,80963754583,-2,1503,1997,10
80965887414,80965887412,-2,1912,2649,10
80966753213,80966753211,-2,906,2865,10
80970626847,80970626846,-1,1187,1670,10
80972504754,80972504759,5,3542,1772,10
80973997192,80973997186,-6,1437,4559,10
80974710160,80974710177,17,764,4678,10
80974852081,80974852080,-1,790,1702,10
80978060891,80978060889,-2,1608,3004,10
80979049166,80979049165,-1,1148,2140,10
80980254303,80980254301,-2,1143,2517,10
80984718663,80984718661,-2,731,1530,10
80986394295,80986394294,-1,1587,2450,10
80989086715,80989086713,-2,1124,1386,10
80990494673,80990494672,-1,26828,15640,10
80994095092,80994095091,-1,1415,2091,10
80994752403,80994752400,-3,1046,2520,10
80998526227,80998526225,-2,1087,2593,10
81000336294,81000336295,1,883,1393,10
81001489287,81001489285,-2,1013,1841,10
81002903099,81002903098,-1,1654,2933,10
81004451064,81004451062,-2,1255,2266,10
81010688910,81010688910,0,32415,19061,10
81012899019,81012899017,-2,1167,2289,10
81014156742,81014156741,-1,1005,1725,10
81014606952,81014606938,-14,1466,2291,10
81014746769,81014746769,0,1472,2161,10
81015714873,81015714870,-3,902,1577,10
81017369470,81017369470,0,1336,1827,10
81022503093,81022503091,-2,1481,2484,10
81025828067,81025828066,-1,1117,2025,10
81026429035,81026429030,-5,1099,2809,10
81026471536,81026471531,-5,1261,1391,10
81026750645,81026750645,0,1309,1800,10
81030451047,81030451046,-1,1319,2302,10
81031261118,81031261117,-1,1268,2005,10
81034635527,81034635524,-3,1117,1379,10
81035208954,81035208971,17,284,644,10
81036727473,81036727485,12,1468,2009,10
81038235314,81038235311,-3,615,1248,10
81044461011,81044461011,0,749,1991,10
81049302485,81049302483,-2,1584,2218,10
81053221643,81053221640,-3,1014,2328,10
81057665770,81057665768,-2,1174,2216,10
81060738292,81060738290,-2,1157,1885,10
81061564326,81061564325,-1,1527,3186,10
81063590357,81063590355,-2,1116,2588,10
81064172689,81064172689,0,1338,1985,10
81065420671,81065420669,-2,1535,1741,10
81065885193,81065885192,-1,1010,1674,10
81066275215,81066275213,-2,1265,2667,10
81066896657,81066896656,-1,2678,2632,10
81070252290,81070252310,20,706,1086,10
81072137957,81072137953,-4,610,1493,10
81077077643,81077077641,-2,961,1669,10
81082650045,81082650043,-2,1299,3103,10
81082879733,81082879733,0,662,1383,10
81083491753,81083491774,21,1161,2560,10
81083973378,81083973378,0,1087,1717,10
81089221310,81089221310,0,1102,1004,10
81092151458,81092151462,4,1680,1519,10
81094271289,81094271288,-1,1329,2006,10
81102970272,81102970270,-2,1200,2300,10
81104579454,81104579453,-1,1199,2111,10
81105295949,81105295949,0,1247,1660,10
81106040073,81106040074,1,172,655,10
81108199581,81108199578,-3,1214,2039,10
81109613779,81109613778,-1,1348,2250,10
81109689212,81109689229,17,1136,1869,10
81111336519,81111336518,-1,874,1726,10
81111458891,81111458889,-2,1164,2361,10
81119506536,81119506534,-2,1614,1396,10
81123042468,81123042465,-3,1205,2444,10
81123351510,81123351510,0,1473,3606,10
81130128076,81130128074,-2,1483,2349,10
81130818098,81130818090,-8,1347,4954,10
81138903899,81138903898,-1,1208,1781,10
81140163146,81140163143,-3,1559,1917,10
81143185890,81143185888,-2,1501,2100,10
81144954582,81144954582,0,1341,1486,10
81147405197,81147405192,-5,725,1793,10
81152316857,81152316863,6,33264,15729,10
81154147564,81154147565,1,1474,2379,10
81156701706,81156701702,-4,1112,1853,10
81159874894,81159874899,5,1971,1795,10
81162146291,81162146290,-1,829,1924,10
81169655239,81169655238,-1,980,2359,10
81169743675,81169743659,-16,1664,2782,10
81171017443,81171017442,-1,1068,1924,10
81174631650,81174631645,-5,990,3807,10
81177546703,81177546699,-4,766,1419,10
81178450294,81178450290,-4,1085,1950,10
81183410762,81183410783,21,817,1418,10
81184897523,81184897522,-1,1907,3213,10
81184989213,81184989209,-4,996,1811,10
81186393692,81186393689,-3,1360,2416,10
81188671310,81188671315,5,4229,2340,10
81191577826,81191577822,-4,1332,4237,10
81192501911,81192501911,0,1704,1476,10
81193096311,81193096309,-2,975,1752,10
81198434217,81198434216,-1,1297,2382,10
81198696849,81198696842,-7,979,1763,10
81198853395,81198853399,4,1196,860,10
81202952706,81202952706,0,994,1730,10
81203889453,81203889454,1,1156,2110,10
81208287504,81208287501,-3,818,1225,10
81211493935,81211493935,0,1335,1814,10
81213235635,81213235635,0,910,1897,10
81217284543,81217284542,-1,1091,2025,10
81228018205,81228018199,-6,1106,5115,10
81230965317,81230965316,-1,1501,2326,10
81236867997,81236867995,-2,837,1715,10
81237893305,81237893303,-2,1185,2156,10
81238209988,81238210006,18,544,1439,10
81242779714,81242779711,-3,1246,1700,10
81254031225,81254031222,-3,1359,2293,10
81255291646,81255291646,0,1276,1408,10
81255904040,81255904038,-2,914,2323,10
81258718839,81258718839,0,1910,2634,10
81259956153,81259956152,-1,1317,2695,10
81263841780,81263841782,2,1040,1847,10
81266278113,81266278113,0,1072,1146,10
81266523012,81266523031,19,677,1408,10
81266728624,81266728627,3,1900,1614,10
81267217902,81267217902,0,1472,1875,10
81267741231,81267741234,3,2626,1747,10
81268000777,81268000776,-1,1450,2237,10
81270203503,81270203498,-5,956,1355,10
81273319835,81273319838,3,4139,3504,10
81282373629,81282373626,-3,1331,1755,10
81282762081,81282762080,-1,1064,2146,10
81285582386,81285582385,-1,838,2123,10
81285901754,81285901738,-16,7,2039,10
81290912906,81290912905,-1,1423,1935,10
81291397409,81291397410,1,1275,1721,10
81291646512,81291646511,-1,1703,2210,10
81292456775,81292456771,-4,895,1728,10
81292505465,81292505483,18,377,1306,10
81293100995,81293100993,-2,1566,2632,10
81294934094,81294934094,0,1004,1447,10
81296258175,81296258171,-4,938,1561,10
81301639406,81301639403,-3,1423,2674,10
81305023392,81305023391,-1,993,1279,10
81305569343,81305569343,0,1186,1854,10
81305682039,81305682039,0,1347,2159,10
81306510037,81306510035,-2,1169,2153,10
81307379611,81307379611,0,1595,1982,10
81311493289,81311493292,3,1062,1809,10
81313248938,81313248938,0,1464,1793,10
81314761395,81314761390,-5,944,2036,10
81319932635,81319932630,-5,1518,2759,10
81322335210,81322335210,0,1073,1538,10
81323734786,81323734784,-2,988,1454,10
81323820601,81323820601,0,1365,2033,10
81325808808,81325808806,-2,1037,2050,10
81330011895,81330011892,-3,1230,1404,10
81331810979,81331810976,-3,922,2864,10
81332208108,81332208127,19,807,1154,10
81335567041,81335567041,0,1281,1910,10
81336430137,81336430137,0,2747,2437,10
81336840174,81336840171,-3,1501,2456,10
81338971502,81338971500,-2,1590,2637,10
81342326105,81342326111,6,2507,1449,10
81342630342,81342630342,0,1219,2154,10
81343425049,81343425038,-11,986,2158,10
81344198078,81344198076,-2,1515,2263,10
81345994421,81345994421,0,1338,2233,10
81349946367,81349946365,-2,1038,1551,10
81351259825,81351259819,-6,1083,3374,10
81356334146,81356334143,-3,911,943,10
81357169194,81357169193,-1,1841,2940,10
81358972922,81358972922,0,1277,1933,10
81359409090,81359409089,-1,978,1767,10
81364549254,81364549254,0,921,1909,10
81369038291,81369038288,-3,1240,1635,10
81373130026,81373130034,8,11655,28679,10
81375163655,81375163654,-1,1039,2161,10
81376705134,81376705131,-3,1351,1807,10
81378295650,81378295649,-1,1262,1471,10
81379144229,81379144227,-2,1651,1866,10
81379700725,81379700725,0,1527,1597,10
81387774065,81387774066,1,1420,2044,10
81389147887,81389147885,-2,1116,1876,10
81390445086,81390445082,-4,1214,1614,10
81395455203,81395455196,-7,1279,5616,10
81395501229,81395501229,0,1289,2111,10
81401870522,81401870522,0,1161,1530,10
81406097862,81406097861,-1,1216,1698,10
81409529389,81409529373,-16,1172,1664,10
81412870306,81412870303,-3,2412,6228,10
81412917727,81412917723,-4,1075,2425,10
81419421635,81419421633,-2,1340,2110,10
81424147377,81424147374,-3,1051,1356,10
81428120802,81428120801,-1,1352,2107,10
81434528082,81434528081,-1,1159,2292,10
81436180563,81436180562,-1,1046,1563,10
81439255746,81439255746,0,961,1369,10
81440515861,81440515862,1,1324,1638,10
81440644641,81440644635,-6,1331,1950,10
81442098593,81442098590,-3,1192,2187,10
81444556483,81444556481,-2,1199,1954,10
81445313766,81445313765,-1,1203,2062,10
81446682011,81446682010,-1,1405,1940,10
81448905999,81448905995,-4,948,1190,10
81451403854,81451403854,0,1616,1511,10
81451748567,81451748566,-1,974,1311,10
81454583731,81454583729,-2,1014,1601,10
81460453596,81460453595,-1,980,2278,10
81463284258,81463284255,-3,736,1689,10
81464050584,81464050585,1,1985,2383,10
81465013582,81465013582,0,988,945,10
81467662204,81467662201,-3,809,1594,10
81468258393,81468258393,0,973,1612,10
81469545982,81469545981,-1,1077,1618,10
81473616701,81473616702,1,3239,3771,10
81473679965,81473679967,2,956,1850,10
81477684643,81477684642,-1,1121,1945,10
81478783068,81478783068,0,1312,2440,10
81481586691,81481586690,-1,1353,2354,10
81482728624,81482728624,0,813,1652,10
81482958043,81482958041,-2,1011,1663,10
81484069111,81484069111,0,1153,1454,10
81484371233,81484371232,-1,1154,2573,10
81488076006,81488076005,-1,1634,1841,10
81492829698,81492829700,2,925,1717,10
81493723470,81493723465,-5,1859,3127,10
81497813598,81497813598,0,1722,2067,10
81503837685,81503837685,0,1414,1478,10
81504621434,81504621433,-1,1082,1532,10
81513310578,81513310576,-2,1387,1591,10
81517465024,81517465022,-2,1182,1689,10
81521862081,81521862086,5,2284,2222,10
81522332427,81522332422,-5,1948,5920,10
81526472391,81526472394,3,2301,1795,10
81530946250,81530946250,0,776,2153,10
81531285730,81531285730,0,1290,2002,10
81531471555,81531471551,-4,794,1818,10
81531614570,81531614561,-9,1171,1864,10
81533108942,81533108941,-1,1015,1590,10
81535971565,81535971565,0,1362,1451,10
81539181173,81539181173,0,1101,1618,10
81541281429,81541281426,-3,1449,1415,10
81549197998,81549197998,0,1143,2601,10
81554731994,81554731993,-1,1382,1878,10
81556328619,81556328614,-5,1035,1886,10
81557911458,81557911460,2,9326,18388,10
81561034841,81561034833,-8,1407,2072,10
81562354896,81562354896,0,1098,2190,10
81562948202,81562948218,16,685,1502,10
81564360459,81564360455,-4,970,2151,10
81570819982,81570819978,-4,1252,2213,10
81571448155,81571448156,1,1035,1677,10
81576630607,81576630604,-3,1513,3523,10
81577795983,81577795981,-2,1272,2247,10
81581372782,81581372783,1,1074,1563,10
81582210658,81582210659,1,1344,1310,10
81584019450,81584019447,-3,909,1697,10
81585722183,81585722181,-2,871,2405,10
81586309379,81586309376,-3,929,1648,10
81589208696,81589208695,-1,758,1825,10
81593270668,81593270665,-3,994,1781,10
81594160544,81594160546,2,1002,1546,10
81605155318,81605155316,-2,1088,1710,10
81605285598,81605285595,-3,969,1291,10
81605395229,81605395226,-3,1497,2455,10
81609645032,81609645032,0,1492,2325,10
81613456689,81613456697,8,4884,1941,10
81616046902,81616046898,-4,968,2148,10
81622089622,81622089626,4,3645,2222,10
81622160217,81622160215,-2,1069,2280,10
81624783751,81624783753,2,1692,1554,10
81627025069,81627025066,-3,1507,2317,10
81630111553,81630111551,-2,928,1683,10
81634374678,81634374675,-3,1153,2206,10
81639361015,81639361015,0,1106,1660,10
81642586173,81642586169,-4,843,3540,10
81643772807,81643772807,0,1395,1432,10
81643885014,81643885014,0,1175,1801,10
81644368974,81644368973,-1,655,1748,10
81648103383,81648103382,-1,1025,2264,10
81648323913,81648323931,18,1168,1515,10
81649546483,81649546479,-4,2167,5570,10
81651387677,81651387678,1,1555,2188,10
81651768782,81651768783,1,1322,1428,10
81652420090,81652420090,0,1579,2388,10
81656907915,81656907913,-2,1058,2254,10
81662174050,81662174047,-3,1243,1796,10
81664705351,81664705349,-2,1309,1576,10
81666228151,81666228150,-1,1387,2090,10
81666642367,81666642365,-2,959,1805,10
81668833226,81668833226,0,1338,2580,10
81670149619,81670149618,-1,1222,1529,10
81676061430,81676061426,-4,1445,3298,10
81678645903,81678645901,-2,1587,3503,10
81685979157,81685979157,0,1005,1413,10
81692833342,81692833339,-3,1106,2097,10
81696383118,81696383117,-1,1184,2607,10
81699212162,81699212161,-1,1483,2352,10
81700281287,81700281286,-1,1302,2319,10
81704499797,81704499794,-3,1722,3199,10
81704845563,81704845562,-1,1002,1861,10
81706213494,81706213491,-3,876,2057,10
81709400381,81709400378,-3,1313,2142,10
81713624362,81713624362,0,1178,2853,10
81713820703,81713820704,1,1202,1982,10
81714573358,81714573359,1,1043,2024,10
81715392944,81715392943,-1,1108,1749,10
81717349281,81717349279,-2,1083,1670,10
81718469085,81718469087,2,1273,2474,10
81723718101,81723718101,0,1078,1603,10
81726402116,81726402114,-2,20886,15766,10
81731668037,81731668036,-1,1043,1833,10
81732871445,81732871444,-1,1219,1757,10
81733534311,81733534307,-4,1228,1772,10
81735210217,81735210228,11,951,1325,10
81735706321,81735706319,-2,925,2159,10
81737829038,81737829036,-2,1814,2576,10
81738909763,81738909762,-1,1193,2168,10
81741426686,81741426684,-2,927,2288,10
81741688116,81741688130,14,381,956,10
81744510167,81744510166,-1,1005,1808,10
81744962921,81744962943,22,900,2538,10
81745439694,81745439693,-1,1308,2022,10
81747168690,81747168690,0,1371,1614,10
81747645651,81747645650,-1,1268,1930,10
81750977234,81750977233,-1,1045,1531,10
81752236257,81752236256,-1,1225,1960,10
81753328288,81753328290,2,10925,8823,10
81756814403,81756814403,0,1290,1746,10
81761827291,81761827287,-4,549,718,10
81762870198,81762870198,0,1346,1900,10
81764176242,81764176241,-1,1632,2393,10
81767227434,81767227434,0,1264,1957,10
81771140327,81771140326,-1,1334,1921,10
81771193925,81771193925,0,1479,2406,10
81771991327,81771991325,-2,1408,2091,10
81772208306,81772208296,-10,953,2327,10
81775632842,81775632840,-2,997,1561,10
81776789841,81776789838,-3,1201,2244,10
81778504857,81778504859,2,890,735,10
81782289637,81782289619,-18,1341,1838,10
81788450541,81788450541,0,1776,1699,10
81790289649,81790289649,0,1419,2287,10
81790371237,81790371236,-1,1325,2255,10
81792689812,81792689815,3,1289,1625,10
81797122383,81797122384,1,789,1501,10
81798191436,81798191435,-1,1215,1324,10
81799059359,81799059357,-2,1563,1435,10
81799609526,81799609524,-2,1071,1774,10
81801944581,81801944574,-7,1285,3341,10
81804778803,81804778803,0,2093,2553,10
81806245251,81806245255,4,1107,1843,10
81808760027,81808760027,0,1517,2376,10
81808854999,81808854998,-1,938,1897,10
81808925484,81808925498,14,728,1222,10
81816522917,81816522913,-4,1201,2766,10
81817621812,81817621811,-1,1145,1267,10
81818671886,81818671882,-4,1235,1691,10
81819168660,81819168676,16,972,1977,10
81824150101,81824150100,-1,1616,2404,10
81824203759,81824203757,-2,1502,2235,10
81830640291,81830640293,2,1983,2110,10
81831335802,81831335801,-1,1397,1971,10
81837265239,81837265235,-4,1490,3176,10
81837665740,81837665740,0,1549,1870,10
81841723995,81841723994,-1,885,1778,10
81847948646,81847948643,-3,1071,2260,10
81851985650,81851985649,-1,941,2564,10
81853562962,81853562960,-2,1409,2263,10
81858601115,81858601111,-4,1469,2409,10
81859785073,81859785071,-2,1426,1542,10
81859927034,81859927027,-7,1086,1733,10
81860719382,81860719382,0,1180,1630,10
81862033734,81862033734,0,1770,1508,10
81863865964,81863865960,-4,1137,2652,10
81870905762,81870905763,1,1343,1882,10
81872331286,81872331285,-1,1001,2170,10
81872561411,81872561409,-2,996,1966,10
81874655922,81874655921,-1,1552,2078,10
81876405915,81876405914,-1,931,2449,10
81877010578,81877010580,2,1515,1669,10
81877411850,81877411847,-3,939,1829,10
81878918746,81878918745,-1,1859,1637,10
81883970095,81883970094,-1,1377,2424,10
81891107707,81891107707,0,895,1535,10
81892311159,81892311157,-2,1345,1882,10
81892689996,81892689996,0,1426,2011,10
81894887301,81894887301,0,1215,2358,10
81896153010,81896153010,0,1120,2263,10
81896842211,81896842210,-1,1431,2620,10
81897514497,81897514500,3,1712,2128,10
81902588695,81902588693,-2,1247,1810,10
81903870879,81903870878,-1,1869,2452,10
81904592194,81904592201,7,5197,2063,10
81908519645,81908519644,-1,1374,2148,10
81909695739,81909695737,-2,744,2448,10
81910581041,81910581039,-2,1291,2224,10
81910759565,81910759563,-2,1623,1561,10
81913978911,81913978906,-5,1197,1988,10
81914632267,81914632266,-1,897,1256,10
81919660541,81919660540,-1,1432,1854,10
81926604417,81926604415,-2,1073,1402,10
81927980807,81927980804,-3,1136,2314,10
81933332558,81933332556,-2,904,1738,10
81935596805,81935596802,-3,1255,2193,10
81939627574,81939627574,0,1403,2085,10
81944230115,81944230115,0,1483,2140,10
81945146038,81945146036,-2,1460,2437,10
81946904038,81946904035,-3,827,2604,10
81950168285,81950168285,0,2044,2031,10
81952134802,81952134800,-2,1476,1803,10
81956100177,81956100176,-1,975,1979,10
81956161592,81956161577,-15,1526,2975,10
81958048170,81958048173,3,1068,2264,10
81960127714,81960127713,-1,1672,1665,10
81962732369,81962732368,-1,1026,1828,10
81963661813,81963661810,-3,31435,14400,10
81965107016,81965107014,-2,1118,2152,10
81971663898,81971663895,-3,1262,2184,10
81975574674,81975574671,-3,1066,1953,10
81977494782,81977494782,0,1495,2110,10
81978978388,81978978389,1,4008,15519,10
81979953249,81979953247,-2,962,1577,10
81989985093,81989985088,-5,1073,5498,10
81990041080,81990041073,-7,1066,1906,10
81991385778,81991385777,-1,1114,2385,10
81992018694,81992018692,-2,1361,1906,10
81992883864,81992883861,-3,1857,2343,10
81992964371,81992964371,0,1239,2033,10
81995266759,81995266756,-3,1593,2198,10
81995733195,81995733193,-2,986,1880,10
81996193111,81996193110,-1,1141,1919,10
81998759654,81998759652,-2,1050,1839,10
81999682350,81999682346,-4,1433,1334,10
82000163049,82000163046,-3,1403,2329,10
82002243622,82002243621,-1,1053,2220,10
82004135794,82004135795,1,1569,1870,10
82006981773,82006981772,-1,1743,1680,10
82007491393,82007491400,7,13907,4890,10
82009460250,82009460250,0,792,2292,10
82013116151,82013116150,-1,944,1470,10
82014094154,82014094154,0,1897,2505,10
82022476019,82022476015,-4,1684,2996,10
82024947322,82024947327,5,1952,1113,10
82025820635,82025820630,-5,989,2276,10
82025912675,82025912671,-4,162,391,10
82026653858,82026653858,0,1420,1820,10
82026838714,82026838715,1,1216,1598,10
82029357214,82029357213,-1,1315,1559,10
82029758775,82029758775,0,1003,1535,10
82031173651,82031173650,-1,942,1911,10
82031209450,82031209446,-4,1031,1807,10
82034190587,82034190587,0,1062,2003,10
82036819249,82036819247,-2,1822,4277,10
82041674050,82041674050,0,1156,2360,10
82043282251,82043282249,-2,1208,2527,10
82043325840,82043325838,-2,1421,1948,10
82044301410,82044301418,8,1391,2256,10
82049782345,82049782342,-3,1053,1983,10
82050173109,82050173106,-3,1204,1830,10
82057521529,82057521527,-2,932,1867,10
82058019819,82058019825,6,2187,1235,10
82062513311,82062513309,-2,1160,1813,10
82062681134,82062681133,-1,1272,2525,10
82062854090,82062854088,-2,989,1830,10
82063465155,82063465154,-1,1292,1337,10
82064081565,82064081563,-2,1250,2448,10
82065148267,82065148265,-2,1609,2100,10
82068785439,82068785437,-2,883,1925,10
82068881609,82068881613,4,2099,2923,10
82070788676,82070788674,-2,1241,1439,10
82074297793,82074297793,0,1250,2462,10
82076683110,82076683110,0,1553,2358,10
82078370350,82078370349,-1,873,2519,10
82079401139,82079401138,-1,857,1797,10
82080690207,82080690207,0,713,1294,10
82082955510,82082955511,1,1386,1205,10
82083125046,82083125043,-3,1489,2061,10
82083400955,82083400953,-2,970,2066,10
82084284288,82084284286,-2,2095,3496,10
82084668798,82084668797,-1,996,2426,10
82086176406,82086176406,0,1189,1656,10
82090205307,82090205306,-1,719,885,10
82100916678,82100916676,-2,1937,2861,10
82102423615,82102423614,-1,1194,1999,10
82119677161,82119677162,1,1435,1522,10
82119773482,82119773479,-3,1958,2815,10
82122180248,82122180245,-3,1590,2796,10
82122334505,82122334506,1,24585,33981,10
82125287453,82125287452,-1,1450,2427,10
82127184937,82127184933,-4,1360,2736,10
82128540219,82128540218,-1,923,1482,10
82129389651,82129389629,-22,1047,1767,10
82129651973,82129651970,-3,941,1954,10
82134137711,82134137707,-4,1000,3065,10
82143456102,82143456097,-5,3794,9929,10
82143581064,82143581060,-4,1236,2311,10
82147342963,82147342964,1,1352,1773,10
82149285373,82149285371,-2,1272,1850,10
82149489052,82149489050,-2,1230,2133,10
82150224087,82150224083,-4,751,1920,10
82159986365,82159986363,-2,1552,1933,10
82161987848,82161987848,0,1083,1492,10
82162891474,82162891472,-2,1012,2113,10
82166312556,82166312558,2,1525,1308,10
82167765732,82167765731,-1,1111,2045,10
82169387360,82169387358,-2,1871,2773,10
82171363103,82171363103,0,1387,1813,10
82171493371,82171493367,-4,1798,2502,10
82171583806,82171583806,0,1424,1843,10
82172707043,82172707043,0,1279,2861,10
82176210469,82176210469,0,1777,2072,10
82177269075,82177269069,-6,1559,2676,10
82177389981,82177389979,-2,1030,1511,10
82178686959,82178686957,-2,1525,2284,10
82183988438,82183988436,-2,1861,2141,10
82186408759,82186408758,-1,1738,2506,10
82191562775,82191562775,0,958,1897,10
82193264297,82193264295,-2,1612,2648,10
82193778359,82193778358,-1,1224,2309,10
82195583765,82195583770,5,2817,1309,10
82201256593,82201256594,1,1252,2354,10
82205170225,82205170224,-1,1232,1813,10
82207245079,82207245079,0,843,1568,10
82208983884,82208983884,0,1150,1671,10
82210177285,82210177291,6,3113,1288,10
82213194922,82213194930,8,3584,999,10
82213840970,82213840968,-2,1342,1847,10
82217852736,82217852734,-2,873,2073,10
82220016775,82220016770,-5,671,2852,10
82221079754,82221079741,-13,1070,1899,10
82225672138,82225672143,5,3731,2610,10
82226003782,82226003780,-2,1368,2018,10
82229619834,82229619834,0,1193,3548,10
82230011655,82230011653,-2,1161,1571,10
82232948190,82232948189,-1,1153,1121,10
82236294651,82236294649,-2,1073,2364,10
82240669441,82240669440,-1,1010,2194,10
82241545157,82241545157,0,778,1333,10
82249264912,82249264910,-2,880,1803,10
82249855331,82249855330,-1,1263,2335,10
82250804250,82250804248,-2,1016,1185,10
82251931551,82251931548,-3,1077,1564,10
82253294623,82253294620,-3,807,1698,10
82254271182,82254271183,1,1331,1790,10
82254314805,82254314802,-3,1222,2140,10
82255297913,82255297909,-4,1135,2145,10
82255348052,82255348029,-23,244,777,10
82256016127,82256016122,-5,647,1344,10
82256465026,82256465025,-1,1268,2721,10
82256906031,82256906031,0,1169,1006,10
82257025526,82257025523,-3,821,1546,10
82258900716,82258900715,-1,1393,1306,10
82259650712,82259650709,-3,1337,2447,10
82272338079,82272338077,-2,954,1801,10
82273940442,82273940438,-4,770,1501,10
82274764946,82274764946,0,1233,2195,10
82279321855,82279321853,-2,979,1833,10
82285876103,82285876102,-1,672,2102,10
82288093739,82288093738,-1,1302,1890,10
82293733319,82293733318,-1,1287,1877,10
82307611621,82307611626,5,38352,18209,10
82308026644,82308026642,-2,1406,2163,10
82311092254,82311092252,-2,1999,2656,10
82312789168,82312789189,21,1048,1176,10
82317078323,82317078326,3,899,1296,10
82319191285,82319191264,-21,1075,3001,10
82324002465,82324002464,-1,908,1630,10
82324648835,82324648834,-1,1101,2527,10
82325053657,82325053657,0,1178,2180,10
82326532825,82326532824,-1,1583,1795,10
82327905655,82327905654,-1,1130,1383,10
82328553458,82328553447,-11,920,1309,10
82332996609,82332996603,-6,1861,8609,10
82333483711,82333483710,-1,1301,1530,10
82334939073,82334939073,0,1799,2315,10
82335295551,82335295549,-2,745,2118,10
82337014331,82337014329,-2,1030,1719,10
82337337449,82337337449,0,2335,2453,10
82342098697,82342098703,6,2307,1299,10
82350434441,82350434440,-1,1325,2085,10
82350965645,82350965643,-2,1199,1823,10
82355830051,82355830049,-2,1081,2574,10
82357794562,82357794562,0,1065,1306,10
82358780474,82358780471,-3,1721,1759,10
82359924232,82359924236,4,48232,31455,10
82360266661,82360266658,-3,1313,2755,10
82361391320,82361391314,-6,1120,1885,10
82363635216,82363635214,-2,874,1930,10
82364196493,82364196492,-1,1255,2168,10
82364835602,82364835601,-1,1210,2078,10
82365567619,82365567626,7,5749,1187,10
82366749049,82366749046,-3,1825,3767,10
82367185206,82367185204,-2,1065,1794,10
82370605391,82370605389,-2,1456,2395,10
82372522134,82372522132,-2,1380,1710,10
82377607963,82377607962,-1,953,1390,10
82380641359,82380641361,2,1826,1992,10
82380794546,82380794546,0,967,1938,10
82382251363,82382251364,1,1250,1644,10
82386413318,82386413318,0,1583,2016,10
82387213914,82387213913,-1,1098,2104,10
82388343192,82388343202,10,13740,39649,10
82389340852,82389340850,-2,1277,2294,10
82392326576,82392326574,-2,1395,2139,10
82393057594,82393057614,20,1126,1781,10
82393227495,82393227493,-2,1284,2752,10
82396053459,82396053458,-1,1129,1970,10
82397535822,82397535821,-1,1288,1832,10
82398467355,82398467353,-2,1139,2521,10
82405276771,82405276771,0,991,1720,10
82407401182,82407401181,-1,1539,2345,10
82407581639,82407581639,0,1365,2769,10
82409972241,82409972238,-3,1183,2313,10
82411304655,82411304653,-2,1268,2320,10
82415340287,82415340286,-1,1056,1728,10
82420775001,82420774998,-3,1301,1309,10
82421737977,82421737977,0,888,878,10
82422480526,82422480522,-4,1626,5596,10
82425272987,82425272985,-2,1671,2360,10
82425685714,82425685713,-1,2419,4561,10
82426733058,82426733057,-1,1333,2006,10
82430034067,82430034066,-1,1327,2444,10
82430608787,82430608786,-1,928,1503,10
82432515911,82432515910,-1,1036,1339,10
82432906670,82432906669,-1,1106,1889,10
82436299849,82436299849,0,1140,1646,10
82438857295,82438857293,-2,1447,2044,10
82439464276,82439464282,6,3880,1501,10
82443698142,82443698141,-1,1402,2199,10
82446327261,82446327258,-3,701,1466,10
82453879935,82453879933,-2,798,1270,10
82456106035,82456106038,3,49495,57073,10
82458353044,82458353044,0,1443,1642,10
82464084404,82464084402,-2,1437,1771,10
82465838038,82465838036,-2,1332,2080,10
82467585058,82467585061,3,2181,1749,10
82470484147,82470484146,-1,868,1633,10
82470895004,82470895023,19,1491,2268,10
82472821838,82472821838,0,1070,1849,10
82473710071,82473710069,-2,1321,1947,10
82474552123,82474552121,-2,1214,1880,10
82475372435,82475372452,17,1449,1812,10
82475633838,82475633836,-2,1081,2517,10
82479035970,82479035969,-1,1346,3181,10
82481329345,82481329344,-1,1414,2267,10
82483674050,82483674054,4,2112,1224,10
82483999853,82483999852,-1,1511,2197,10
82484293822,82484293817,-5,829,1624,10
82487108822,82487108819,-3,1208,2476,10
82487340846,82487340846,0,1371,1586,10
82490821806,82490821806,0,1154,1937,10
82496606343,82496606344,1,1012,1434,10
82496922303,82496922302,-1,1330,1741,10
82498876618,82498876626,8,850,341,10
82503965639,82503965638,-1,1472,1993,10
82510508214,82510508213,-1,816,2026,10
82512565381,82512565385,4,2852,1595,10
82513190061,82513190059,-2,857,1878,10
82514442423,82514442423,0,890,2104,10
82516184743,82516184741,-2,1088,2287,10
82517185706,82517185706,0,942,1492,10
82517554083,82517554081,-2,953,1609,10
82517823407,82517823409,2,1231,1691,10
82517975949,82517975946,-3,1174,1862,10
82527809634,82527809632,-2,1202,2054,10
82528356442,82528356440,-2,1248,2263,10
82530307517,82530307514,-3,1455,2362,10
82539039530,82539039529,-1,1227,1756,10
82541415947,82541415946,-1,1401,2396,10
82544796450,82544796450,0,1711,2944,10
82547079197,82547079198,1,1707,2366,10
82547136424,82547136425,1,1668,1334,10
82550073602,82550073600,-2,1335,1644,10
82551169934,82551169933,-1,1255,1524,10
82552333201,82552333181,-20,286,634,10
82558473189,82558473189,0,1478,2349,10
82560577194,82560577191,-3,881,1606,10
82565967931,82565967930,-1,1775,1972,10
82566578462,82566578463,1,1769,1215,10
82568583109,82568583106,-3,1021,1811,10
82568944888,82568944886,-2,828,1610,10
82569854226,82569854224,-2,1280,2179,10
82572019587,82572019590,3,1632,1437,10
82572495556,82572495576,20,1067,1673,10
82573475750,82573475751,1,1537,1244,10
82573927022,82573927021,-1,1528,2062,10
82578118983,82578118981,-2,948,2465,10
82581907694,82581907694,0,2002,1910,10
82582034373,82582034373,0,998,1956,10
82587631435,82587631432,-3,1201,3068,10
82588396434,82588396435,1,1407,2487,10
82592279042,82592279041,-1,1122,1499,10
82598230015,82598230015,0,1479,1706,10
82600104682,82600104679,-3,1362,2165,10
82600674898,82600674897,-1,1295,2676,10
82604050970,82604050985,15,372,106,10
82608401581,82608401578,-3,1341,1523,10
82611225645,82611225644,-1,1784,2383,10
82611662752,82611662749,-3,1093,2049,10
82613176036,82613176035,-1,1089,1369,10
82619031411,82619031412,1,672,1227,10
82620203866,82620203863,-3,1142,1903,10
82622090915,82622090915,0,1536,2497,10
82623606091,82623606109,18,1071,1296,10
82623890104,82623890101,-3,1872,3077,10
82626411117,82626411112,-5,1423,3072,10
82626524658,82626524678,20,936,4120,10
82628455624,82628455622,-2,1571,2449,10
82629368370,82629368368,-2,1118,2424,10
82629797512,82629797502,-10,183,665,10
82630443054,82630443053,-1,1214,1916,10
82633597591,82633597589,-2,1459,2897,10
82634059957,82634059958,1,680,1635,10
82645238554,82645238555,1,952,1584,10
82646831841,82646831841,0,700,789,10
82648722062,82648722059,-3,505,1522,10
82654706442,82654706446,4,2346,1545,10
82655897799,82655897799,0,1340,1513,10
82659911739,82659911738,-1,800,1446,10
82661639945,82661639944,-1,998,2069,10
82663814942,82663814942,0,805,1397,10
82670950273,82670950272,-1,1625,2415,10
82671981142,82671981141,-1,909,1981,10
82674865739,82674865738,-1,1805,2126,10
82676316439,82676316438,-1,1356,2055,10
82676830546,82676830546,0,1342,2121,10
82683360702,82683360702,0,7019,8851,10
82689652075,82689652075,0,1802,2009,10
82689853409,82689853407,-2,869,1695,10
82697151207,82697151206,-1,1013,1707,10
82699158769,82699158769,0,1190,1841,10
82700844675,82700844674,-1,966,1499,10
82703744473,82703744471,-2,1437,1910,10
82705861097,82705861094,-3,1307,1588,10
82707683439,82707683442,3,1259,1415,10
82713500766,82713500763,-3,1258,1597,10
82718414598,82718414597,-1,1014,1738,10
82721195280,82721195279,-1,1206,1487,10
82721287802,82721287799,-3,1001,2199,10
82721330259,82721330273,14,1656,9863,10
82729319883,82729319881,-2,1178,1999,10
82730428516,82730428518,2,1790,1716,10
82734177420,82734177419,-1,1088,1580,10
82738756090,82738756091,1,1288,1733,10
82740221993,82740221993,0,1190,1824,10
82741778819,82741778814,-5,716,2073,10
82742601558,82742601558,0,1610,2505,10
82743533643,82743533637,-6,790,1695,10
82743861133,82743861131,-2,884,1516,10
82744726294,82744726291,-3,1119,2877,10
82749659562,82749659561,-1,1013,1920,10
82750084426,82750084425,-1,1286,2371,10
82753887366,82753887370,4,2553,1703,10
82755311003,82755311002,-1,1846,2614,10
82756295074,82756295079,5,3763,2066,10
82758554810,82758554809,-1,1123,1437,10
82759549800,82759549798,-2,1330,1436,10
82763096489,82763096490,1,1470,1465,10
82768528797,82768528795,-2,1191,1972,10
82770594787,82770594789,2,1138,1067,10
82772128327,82772128324,-3,794,1343,10
82774275745,82774275745,0,1229,2397,10
82776285262,82776285259,-3,751,1435,10
82782340218,82782340216,-2,1264,2232,10
82785949410,82785949406,-4,1111,2694,10
82789096318,82789096318,0,1346,1851,10
82790460666,82790460668,2,1379,980,10
82791645474,82791645469,-5,1209,1839,10
82795916228,82795916225,-3,1760,2683,10
82799003949,82799003947,-2,779,1566,10
82800600946,82800600951,5,5887,2385,10
82800900050,82800900050,0,1295,1762,10
82804193447,82804193445,-2,828,1861,10
82808758318,82808758319,1,1053,1885,10
82810364877,82810364874,-3,1613,1732,10
82810489218,82810489217,-1,1237,1446,10
82812877921,82812877922,1,1154,854,10
82815107089,82815107082,-7,805,3869,10
82818881767,82818881781,14,1166,1824,10
82819608187,82819608185,-2,1305,2443,10
82821415674,82821415670,-4,1150,2446,10
82825899491,82825899490,-1,1187,1372,10
82828955339,82828955335,-4,1225,1940,10
82829161199,82829161197,-2,1153,1648,10
82830493597,82830493597,0,1333,1673,10
82837196967,82837196966,-1,1543,2202,10
82837485274,82837485282,8,33,1794,10
82838175700,82838175698,-2,1166,2851,10
82840552696,82840552693,-3,1534,2554,10
82843043778,82843043777,-1,1214,1719,10
82847619387,82847619387,0,1586,2631,10
82849332704,82849332702,-2,1659,2065,10
82850888961,82850888961,0,1657,1893,10
82856010854,82856010850,-4,882,2297,10
82862144932,82862144930,-2,1375,2269,10
82864290422,82864290421,-1,1059,2001,10
82864524889,82864524887,-2,1096,2103,10
82865021914,82865021914,0,1268,2495,10
82865369631,82865369630,-1,1098,2102,10
82871331679,82871331678,-1,1096,1729,10
82871496627,82871496642,15,680,3278,10
82872971732,82872971731,-1,1072,1242,10
82873035546,82873035529,-17,1254,2621,10
82875297185,82875297190,5,5905,2589,10
82888773335,82888773335,0,1195,1660,10
82890795902,82890795902,0,1054,2395,10
82892963298,82892963294,-4,1227,2010,10
82899711635,82899711635,0,1300,2031,10
82900791696,82900791695,-1,1198,1891,10
82903236600,82903236603,3,2567,1848,10
82904708142,82904708141,-1,964,1683,10
82909528025,82909528022,-3,1194,1702,10
82910578566,82910578564,-2,1487,3347,10
82910957290,82910957290,0,949,1976,10
82912391298,82912391296,-2,1309,1765,10
82917728230,82917728229,-1,899,1882,10
82918373603,82918373601,-2,1004,1973,10
82918774724,82918774724,0,1282,1956,10
82923182365,82923182364,-1,1159,1603,10
82926483650,82926483650,0,1646,1713,10
82929769025,82929769023,-2,1151,1269,10
82931034058,82931034054,-4,1386,2118,10
82931506362,82931506360,-2,1543,2690,10
82932655910,82932655908,-2,873,2250,10
82935321722,82935321721,-1,980,1481,10
82935524841,82935524842,1,1022,1812,10
82937996030,82937996029,-1,1768,1757,10
82939898350,82939898349,-1,1497,1507,10
82940105240,82940105239,-1,1405,1706,10
82940357523,82940357522,-1,1159,2356,10
82942695660,82942695655,-5,988,2243,10
82945957327,82945957321,-6,788,2689,10
82946197104,82946197125,21,818,1856,10
82947568481,82947568478,-3,1127,1844,10
82947913567,82947913566,-1,1265,1487,10
82950046479,82950046478,-1,1494,1963,10
82950810165,82950810164,-1,882,1971,10
82958004250,82958004247,-3,1184,2104,10
82961268751,82961268749,-2,954,1951,10
82962235275,82962235272,-3,1147,2416,10
82962421716,82962421712,-4,1484,1548,10
82963978244,82963978242,-2,1445,1997,10
82966161467,82966161465,-2,1031,1234,10
82967088178,82967088178,0,1052,1316,10
82968921914,82968921910,-4,887,1747,10
82969147206,82969147205,-1,921,2352,10
82977483392,82977483391,-1,1159,1841,10
82984397214,82984397214,0,1059,1185,10
82987495458,82987495456,-2,1414,2101,10
82988736185,82988736183,-2,1183,1125,10
82991802766,82991802766,0,1038,1578,10
82995188621,82995188622,1,1545,1472,10
82995517934,82995517933,-1,980,2476,10
82995948543,82995948541,-2,1101,2433,10
83000377514,83000377518,4,1494,1154,10
83000499315,83000499314,-1,752,979,10
83002327297,83002327295,-2,988,1629,10
83002667674,83002667671,-3,1159,2058,10
83002923714,83002923718,4,1678,777,10
83002958099,83002958107,8,1111,1581,10
83007017350,83007017348,-2,1499,1630,10
83007141503,83007141503,0,993,1427,10
83012020976,83012020974,-2,1088,1348,10
83012112495,83012112494,-1,923,1742,10
83019858550,83019858550,0,1400,2324,10
83023710978,83023710958,-20,955,648,10
83024433956,83024433954,-2,1639,1257,10
83028562016,83028562011,-5,869,2266,10
83032485469,83032485468,-1,1015,1583,10
83033692517,83033692515,-2,1066,1474,10
83035166823,83035166826,3,1868,1423,10
83035794431,83035794429,-2,952,1681,10
83040901053,83040901052,-1,1077,2212,10
83040964337,83040964333,-4,22998,10356,10
83042568544,83042568543,-1,1147,2068,10
83043848160,83043848156,-4,2521,6408,10
83044349771,83044349775,4,1987,1214,10
83044925488,83044925486,-2,1320,2000,10
83046590069,83046590067,-2,1659,2487,10
83048169129,83048169127,-2,1330,1571,10
83050644145,83050644143,-2,1013,2002,10
83051339317,83051339316,-1,867,1440,10
83055373910,83055373917,7,6771,2972,10
83055581728,83055581723,-5,1656,4472,10
83060194681,83060194687,6,3338,1416,10
83061236583,83061236584,1,879,1659,10
83062221637,83062221636,-1,1715,2134,10
83066635713,83066635712,-1,1477,1748,10
83071793787,83071793786,-1,783,1151,10
83079539366,83079539365,-1,1854,2218,10
83081288738,83081288736,-2,981,2212,10
83083409938,83083409934,-4,2322,6055,10
83088103732,83088103727,-5,1387,2371,10
83092965530,83092965527,-3,1227,2432,10
83093898680,83093898682,2,1296,1140,10
83094496018,83094496018,0,1189,1780,10
83094578559,83094578554,-5,1530,4294,10
83097181230,83097181228,-2,1264,2094,10
83098035906,83098035903,-3,1003,1762,10
83099591350,83099591349,-1,980,1943,10
83100836589,83100836588,-1,1337,1937,10
83101405669,83101405669,0,1092,1626,10
83102812022,83102812019,-3,1146,1575,10
83103243710,83103243713,3,937,1541,10
83105703218,83105703214,-4,1273,3332,10
83106473673,83106473673,0,1126,1678,10
83106672061,83106672061,0,1566,2294,10
83109635780,83109635780,0,1355,1685,10
83109963226,83109963222,-4,1015,2902,10
83112269277,83112269276,-1,1174,1793,10
83114128198,83114128196,-2,2415,4462,10
83117016521,83117016520,-1,1116,1605,10
83118068406,83118068405,-1,989,1734,10
83121374049,83121374049,0,1125,1738,10
83122157195,83122157193,-2,942,1517,10
83126360050,83126360049,-1,1043,1662,10
83126919285,83126919284,-1,1245,1711,10
83133011222,83133011220,-2,1391,1570,10
83134389405,83134389402,-3,1310,2046,10
83136790783,83136790783,0,1284,3030,10
83136996465,83136996466,1,1268,1433,10
83140384266,83140384260,-6,851,4506,10
83140994414,83140994414,0,1251,2644,10
83141443862,83141443861,-1,1182,2358,10
83142778185,83142778184,-1,1419,2083,10
83151057868,83151057867,-1,929,2091,10
83152616534,83152616531,-3,1210,2763,10
83152806438,83152806433,-5,1043,2854,10
83154277942,83154277939,-3,1371,1700,10
83156124778,83156124775,-3,1559,1842,10
83159772771,83159772770,-1,1067,1804,10
83162831722,83162831722,0,770,1870,10
83166445982,83166445981,-1,875,2001,10
83170820667,83170820667,0,1230,652,10
83171862894,83171862894,0,1654,2344,10
83173991186,83173991186,0,928,2687,10
83174886422,83174886422,0,992,1568,10
83175676085,83175676099,14,3276,1294,10
83177334815,83177334813,-2,1363,1784,10
83177969837,83177969836,-1,589,1934,10
83183698595,83183698597,2,1329,1450,10
83184481917,83184481917,0,1187,1438,10
83194601499,83194601498,-1,2841,4531,10
83196626293,83196626290,-3,1434,2187,10
83198124770,83198124769,-1,1343,1887,10
83198857523,83198857523,0,1820,1910,10
83201446825,83201446823,-2,1156,1756,10
83202387843,83202387836,-7,953,1516,10
83206774892,83206774890,-2,1130,2262,10
83207629663,83207629663,0,970,1667,10
83210191038,83210191037,-1,1256,1627,10
83211052790,83211052788,-2,923,1816,10
83211321684,83211321682,-2,1635,2313,10
83211725916,83211725914,-2,872,2350,10
83212521108,83212521101,-7,2885,8512,10
83222308980,83222308979,-1,1082,2412,10
83222616202,83222616182,-20,623,1646,10
83224956784,83224956785,1,1153,1842,10
83225145819,83225145817,-2,1040,1210,10
83229418670,83229418666,-4,1337,2360,10
83230972573,83230972572,-1,3337,5258,10
83238505490,83238505489,-1,1393,2195,10
83244533078,83244533077,-1,1099,1964,10
83247263442,83247263441,-1,1456,1760,10
83248941016,83248940995,-21,1116,2042,10
83257456675,83257456665,-10,1519,9646,10
83258755952,83258755952,0,1220,2329,10
83259824749,83259824748,-1,1134,2243,10
83261307999,83261307995,-4,628,1339,10
83267312690,83267312687,-3,1010,2353,10
83267657258,83267657277,19,802,1349,10
83269160153,83269160151,-2,1084,2274,10
83269372193,83269372206,13,551,853,10
83271600360,83271600360,0,1122,2391,10
83271815973,83271815971,-2,1884,1949,10
83271943781,83271943781,0,1067,984,10
83272291430,83272291428,-2,1689,2699,10
83274815058,83274815055,-3,1514,2169,10
83275367518,83275367518,0,1536,2151,10
83276482225,83276482223,-2,1203,2238,10
83277034091,83277034106,15,7643,49734,10
83277077020,83277077033,13,16547,40814,10
83283903195,83283903194,-1,1092,1815,10
83284189464,83284189486,22,1316,1767,10
83285303781,83285303780,-1,1284,1959,10
83288045787,83288045786,-1,1975,1832,10
83291521200,83291521197,-3,1095,2286,10
83294191468,83294191469,1,1612,2009,10
83298180413,83298180409,-4,1179,1989,10
83299104899,83299104897,-2,2512,4182,10
83301558485,83301558484,-1,1064,1908,10
83303667135,83303667135,0,1550,1813,10
83305804930,83305804930,0,1287,2515,10
83309611213,83309611214,1,1472,1769,10
83310069146,83310069146,0,1044,1792,10
83311772134,83311772133,-1,945,1630,10
83312335294,83312335291,-3,1488,2765,10
83314142013,83314142010,-3,979,1748,10
83314247062,83314247061,-1,1244,1752,10
83314659352,83314659346,-6,1104,1659,10
83316013066,83316013065,-1,763,1545,10
83318473895,83318473893,-2,1494,2655,10
83319846170,83319846175,5,2900,1640,10
83320375752,83320375752,0,1149,1347,10
83320521087,83320521086,-1,650,1764,10
83320726415,83320726415,0,1244,1443,10
83322735082,83322735083,1,1116,1808,10
83325948667,83325948666,-1,1263,2088,10
83326000213,83326000214,1,1114,1620,10
83327982614,83327982610,-4,1099,1889,10
83328266894,83328266890,-4,1025,2123,10
83334083434,83334083436,2,1081,1302,10
83337726870,83337726868,-2,833,2221,10
83338083722,83338083708,-14,1076,1720,10
83340889198,83340889197,-1,105439,25847,10
83341486295,83341486297,2,1350,956,10
83344653367,83344653366,-1,1427,2108,10
83346698547,83346698545,-2,1136,2051,10
83349521781,83349521782,1,2837,3623,10
83352232978,83352232976,-2,855,1695,10
83358379046,83358379043,-3,1091,1583,10
83361505471,83361505470,-1,1682,2036,10
83364902174,83364902173,-1,2010,1643,10
83365794007,83365794009,2,1279,1804,10
83366569868,83366569867,-1,1857,3320,10
83367955506,83367955505,-1,1019,2265,10
83369881789,83369881789,0,1318,2525,10
83370499485,83370499484,-1,890,2027,10
83372332660,83372332662,2,4957,5904,10
83372849947,83372849948,1,692,1078,10
83375343556,83375343553,-3,1893,5138,10
83377745302,83377745300,-2,826,1873,10
83379210558,83379210557,-1,1001,1999,10
83379829302,83379829301,-1,1143,2008,10
83382237846,83382237846,0,1276,1752,10
83384971159,83384971159,0,1337,1459,10
83386184947,83386184943,-4,766,1467,10
83389215988,83389215986,-2,1160,2237,10
83390889888,83390889885,-3,1319,1597,10
83392067210,83392067190,-20,1148,1330,10
83395628025,83395628025,0,1409,2668,10
83396151807,83396151807,0,976,2136,10
83396303938,83396303926,-12,1053,1393,10
83398071944,83398071949,5,2764,1525,10
83399517609,83399517615,6,12584,5237,10
83400063649,83400063642,-7,1924,5794,10
83401925418,83401925417,-1,1264,2100,10
83402922492,83402922485,-7,642,2101,10
83403852589,83403852587,-2,1216,1563,10
83405240670,83405240670,0,1116,1211,10
83405352485,83405352489,4,1599,1105,10
83406592709,83406592710,1,986,2222,10
83406715715,83406715716,1,1349,1478,10
83407547529,83407547525,-4,2205,4496,10
83410465050,83410465050,0,1081,2309,10
83414938865,83414938863,-2,1240,1952,10
83415609113,83415609099,-14,1536,2332,10
83416869234,83416869233,-1,1248,1693,10
83419940679,83419940674,-5,1157,3116,10
83422264982,83422264983,1,1109,1315,10
83428398479,83428398480,1,1296,1643,10
83428553661,83428553658,-3,1426,1996,10
83430685549,83430685552,3,1084,1772,10
83430979096,83430979118,22,1541,1483,10
83436039394,83436039394,0,1510,1842,10
83436620290,83436620289,-1,1427,2078,10
83439801738,83439801739,1,1324,1755,10
83440982498,83440982495,-3,1340,1849,10
83445777943,83445777938,-5,1232,2053,10
83452798995,83452798994,-1,1292,1447,10
83454036700,83454036700,0,1700,1185,10
83458555990,83458555990,0,1321,2003,10
83464637662,83464637660,-2,758,1323,10
83466726266,83466726265,-1,1015,1977,10
83470022876,83470022876,0,1225,2427,10
83470971720,83470971727,7,8105,36541,10
83471249784,83471249783,-1,1482,1724,10
83476630857,83476630857,0,1013,1545,10
83477208502,83477208499,-3,1065,1704,10
83483717543,83483717541,-2,1204,2050,10
83484621141,83484621143,2,1594,2222,10
83489695458,83489695457,-1,1544,2201,10
83490303054,83490303055,1,939,1085,10
83493248502,83493248503,1,1418,2012,10
83493763789,83493763789,0,1608,2206,10
83494808380,83494808378,-2,1714,2537,10
83495684622,83495684621,-1,1087,2181,10
83499867567,83499867565,-2,1241,1940,10
83500322530,83500322538,8,1427,1031,10
83500569579,83500569578,-1,739,1449,10
83505000522,83505000520,-2,1607,1870,10
83515004190,83515004198,8,2468,1397,10
83521476146,83521476144,-2,1683,2517,10
83524000855,83524000854,-1,1388,2126,10
83529727894,83529727894,0,958,1470,10
83530767051,83530767050,-1,1194,2374,10
83530961098,83530961098,0,1013,1955,10
83537301731,83537301731,0,951,1805,10
83538002454,83538002453,-1,1661,2028,10
83538606871,83538606870,-1,745,1673,10
83539790538,83539790538,0,997,1336,10
83541316262,83541316265,3,939,1509,10
83544185690,83544185689,-1,1220,1667,10
83544790706,83544790725,19,737,1022,10
83549075747,83549075747,0,913,996,10
83549644141,83549644140,-1,1261,1959,10
83559792187,83559792186,-1,1877,2876,10
83559847853,83559847851,-2,843,1740,10
83561865405,83561865406,1,1405,2172,10
83565034773,83565034770,-3,1386,3190,10
83565362650,83565362650,0,2023,2722,10
83568865119,83568865117,-2,1313,2502,10
83569322002,83569322002,0,1552,2207,10
83569908969,83569908966,-3,1738,1974,10
83576375080,83576375078,-2,1613,3012,10
83584006563,83584006562,-1,1520,2303,10
83587120505,83587120504,-1,1126,1736,10
83588134041,83588134040,-1,1007,2528,10
83590431139,83590431135,-4,1665,2724,10
83590912347,83590912346,-1,1759,1765,10
83598360075,83598360074,-1,1102,1931,10
83598726866,83598726887,21,144,634,10
83599797306,83599797306,0,1362,1699,10
83604110850,83604110848,-2,960,1749,10
83610637310,83610637309,-1,1124,1852,10
83615454207,83615454205,-2,929,1911,10
83616484120,83616484120,0,1121,2738,10
83618468251,83618468253,2,983,1611,10
83618880315,83618880314,-1,1086,2267,10
83620069208,83620069205,-3,1191,2156,10
83622978817,83622978814,-3,1135,1644,10
83638793986,83638793986,0,1841,2889,10
83639662463,83639662462,-1,956,1576,10
83641789650,83641789671,21,1149,1864,10
83649077086,83649077090,4,1621,1318,10
83652766250,83652766248,-2,1300,2183,10
83656485897,83656485896,-1,1213,1865,10
83657018206,83657018205,-1,839,1517,10
83665366109,83665366105,-4,1225,2794,10
83668841799,83668841799,0,1241,1251,10
83674476486,83674476486,0,1294,2223,10
83678332025,83678332026,1,1034,1258,10
83683757058,83683757058,0,1187,1709,10
83690705269,83690705269,0,1096,1273,10
83691020342,83691020337,-5,1549,2872,10
83694630421,83694630418,-3,1913,2190,10
83697561721,83697561719,-2,1307,2892,10
83698847153,83698847152,-1,1285,1909,10
83700018747,83700018746,-1,1261,1787,10
83706879671,83706879667,-4,1282,1884,10
83712521094,83712521095,1,1417,1261,10
83713021322,83713021321,-1,880,1556,10
83715890651,83715890649,-2,1022,1978,10
83719803756,83719803754,-2,1286,1657,10
83720461088,83720461078,-10,515,1388,10
83723619322,83723619322,0,1817,3032,10
83724592438,83724592444,6,6196,2298,10
83726205578,83726205577,-1,1322,2146,10
83726756793,83726756799,6,4665,2997,10
83727955161,83727955161,0,947,1444,10
83730045785,83730045782,-3,1052,2044,10
83733834670,83733834669,-1,1290,2839,10
83734032925,83734032926,1,1379,2196,10
83734433057,83734433057,0,1450,2040,10
83735236241,83735236240,-1,1019,2531,10
83740054897,83740054916,19,895,1373,10
83740685316,83740685317,1,2191,2683,10
83741602246,83741602245,-1,1262,1991,10
83743016706,83743016706,0,1304,1859,10
83745155509,83745155506,-3,1014,2256,10
83748706281,83748706286,5,962,1478,10
83754094227,83754094225,-2,1048,1875,10
83755104745,83755104739,-6,1200,1832,10
83756937723,83756937720,-3,1198,2336,10
83758288339,83758288336,-3,1007,1768,10
83759635287,83759635286,-1,1347,2201,10
83760098770,83760098769,-1,1353,1839,10
83761667560,83761667554,-6,983,1844,10
83762503376,83762503375,-1,1081,1606,10
83768698846,83768698846,0,900,1798,10
83770834738,83770834741,3,1349,2195,10
83771213550,83771213549,-1,1517,2334,10
83782289597,83782289598,1,1238,1715,10
83782391761,83782391759,-2,951,8567,10
83784568431,83784568429,-2,968,1347,10
83786061847,83786061845,-2,1322,2372,10
83791477638,83791477638,0,1351,2078,10
83803496343,83803496342,-1,1516,2097,10
83808274331,83808274329,-2,1997,2578,10
83810233174,83810233170,-4,1073,1868,10
83816058258,83816058256,-2,1719,2773,10
83816099839,83816099834,-5,872,2020,10
83821709477,83821709475,-2,1075,1651,10
83826335547,83826335543,-4,909,1626,10
83828811490,83828811489,-1,1020,2185,10
83830248263,83830248263,0,1218,1544,10
83831552415,83831552413,-2,1299,2102,10
83833617837,83833617837,0,1107,1371,10
83834290647,83834290647,0,1101,1911,10
83836848657,83836848657,0,1565,1645,10
83839533729,83839533727,-2,1543,1875,10
83839643866,83839643882,16,986,1613,10
83840667094,83840667093,-1,930,1524,10
83842457779,83842457778,-1,1096,2102,10
83844830042,83844830041,-1,1452,2965,10
83846146679,83846146683,4,623,526,10
83850070722,83850070726,4,1496,1077,10
83850791899,83850791898,-1,1106,1194,10
83854626586,83854626582,-4,1564,2180,10
83857568878,83857568877,-1,996,1816,10
83857935750,83857935750,0,893,1977,10
83859555162,83859555162,0,1282,1689,10
83860790174,83860790173,-1,1122,2380,10
83864921843,83864921843,0,1479,2161,10
83865633779,83865633774,-5,932,2168,10
83866534224,83866534222,-2,1443,1791,10
83869155039,83869155039,0,1360,2359,10
83869691902,83869691901,-1,1182,2048,10
83870739858,83870739853,-5,746,3121,10
83870821193,83870821173,-20,1040,1272,10
83872878157,83872878158,1,1483,1822,10
83873993263,83873993261,-2,1097,2120,10
83874465563,83874465561,-2,1561,1597,10
83875637103,83875637101,-2,1103,1692,10
83875986094,83875986093,-1,657,1753,10
83876930750,83876930769,19,970,1871,10
83879977795,83879977794,-1,872,2002,10
83881976540,83881976541,1,21028,19748,10
83884861315,83884861313,-2,1010,2498,10
83892130409,83892130411,2,1361,1659,10
83893001682,83893001682,0,1029,2339,10
83897209082,83897209082,0,930,1638,10
83903184679,83903184682,3,1270,1376,10
83904356178,83904356178,0,979,1726,10
83906215513,83906215511,-2,1416,2486,10
83907167904,83907167900,-4,1178,2563,10
83911501571,83911501570,-1,919,2281,10
83911570715,83911570709,-6,1123,2244,10
83917235310,83917235309,-1,1374,2204,10
83918760944,83918760943,-1,582,1138,10
83924627498,83924627498,0,1364,2360,10
83929664184,83929664182,-2,854,2118,10
83934970191,83934970195,4,2166,1297,10
83935086758,83935086754,-4,1543,2539,10
83935980883,83935980879,-4,1565,2147,10
83939144407,83939144407,0,1697,2355,10
83944161958,83944161955,-3,1029,1446,10
83947232180,83947232178,-2,890,1639,10
83953170157,83953170153,-4,1425,1876,10
83955078615,83955078614,-1,1106,1771,10
83955845890,83955845887,-3,1145,1351,10
83959627253,83959627250,-3,1176,2088,10
83959999124,83959999126,2,1334,1023,10
83961050554,83961050555,1,1101,1470,10
83963048452,83963048449,-3,1228,2049,10
83971395049,83971395047,-2,709,2104,10
83982329683,83982329679,-4,2,1180,10
83985943726,83985943725,-1,1050,2247,10
83987469726,83987469724,-2,959,1828,10
83989204417,83989204415,-2,1147,1865,10
83990647950,83990647945,-5,1086,3293,10
83990755814,83990755814,0,246,896,10
83992895233,83992895232,-1,2170,2698,10
83993372667,83993372662,-5,1000,3212,10
83993849627,83993849625,-2,1280,2464,10
83995191736,83995191735,-1,1434,2082,10
83998563923,83998563922,-1,1398,2046,10
84000216500,84000216498,-2,1234,1785,10
84003039414,84003039413,-1,825,1467,10
84007011815,84007011814,-1,1431,2095,10
84008570646,84008570645,-1,639,1837,10
84011233406,84011233405,-1,1257,2009,10
84011523894,84011523892,-2,1528,2199,10
84013812707,84013812705,-2,1619,2857,10
84015514548,84015514546,-2,1111,1547,10
84016564274,84016564271,-3,1335,2714,10
84018758763,84018758760,-3,779,1920,10
84019663834,84019663833,-1,1157,2001,10
84020174621,84020174619,-2,1512,1643,10
84024219801,84024219798,-3,763,2551,10
84027547429,84027547427,-2,1200,2730,10
84028040972,84028040954,-18,905,1406,10
84036487375,84036487373,-2,1031,2356,10
84036828913,84036828914,1,962,1671,10
84043297693,84043297692,-1,1301,1921,10
84045797326,84045797326,0,1932,2769,10
84046245083,84046245081,-2,1359,2017,10
84047326946,84047326945,-1,1321,2633,10
84048644988,84048644987,-1,1554,2103,10
84048768509,84048768508,-1,1212,1961,10
84049712835,84049712842,7,1020,1807,10
84053281406,84053281405,-1,721,1242,10
84053940230,84053940228,-2,2210,2159,10
84058526203,84058526182,-21,1146,1997,10
84059348829,84059348826,-3,733,1786,10
84061306577,84061306573,-4,1255,2059,10
84063761043,84063761043,0,1182,1295,10
84068043238,84068043238,0,1636,2194,10
84075916174,84075916181,7,4474,1443,10
84077766904,84077766903,-1,837,1687,10
84079563869,84079563867,-2,999,2152,10
84079873073,84079873073,0,973,1914,10
84082330423,84082330422,-1,752,1764,10
84082982205,84082982205,0,1521,1988,10
84085300058,84085300057,-1,1240,1898,10
84085442690,84085442687,-3,1264,1973,10
84086209765,84086209766,1,1597,1525,10
84088587006,84088587006,0,1057,2036,10
84088799240,84088799241,1,1320,2333,10
84092392378,84092392373,-5,831,1493,10
84092593572,84092593582,10,354,1828,10
84096532087,84096532085,-2,1171,2289,10
84102318538,84102318537,-1,1270,1757,10
84105732298,84105732297,-1,1960,2226,10
84112124960,84112124957,-3,1238,2052,10
84113019667,84113019671,4,222,1157,10
84115300918,84115300924,6,2577,1526,10
84116793559,84116793559,0,1127,1449,10
84123756098,84123756094,-4,1305,1898,10
84129536478,84129536477,-1,820,1426,10
84131577794,84131577792,-2,1686,2332,10
84131922373,84131922373,0,856,2263,10
84132253736,84132253759,23,1015,1622,10
84134964974,84134964974,0,1137,1437,10
84137275070,84137275070,0,1135,1983,10
84138015608,84138015605,-3,1381,2067,10
84142075297,84142075298,1,1139,2353,10
84142590755,84142590755,0,942,1544,10
84143686663,84143686664,1,802,2012,10
84145024670,84145024670,0,1001,1724,10
84147113591,84147113591,0,1501,1726,10
84149248934,84149248934,0,2090,2312,10
84149276627,84149276626,-1,938,2392,10
84152052099,84152052098,-1,861,1368,10
84152598076,84152598085,9,1805,1370,10
84157228849,84157228847,-2,1404,1764,10
84158052990,84158052986,-4,1536,3080,10
84159588699,84159588698,-1,1105,2096,10
84159718166,84159718165,-1,1355,1549,10
84160664990,84160664989,-1,1495,2372,10
84166359330,84166359331,1,704,1059,10
84167420719,84167420718,-1,1266,2250,10
84167659523,84167659518,-5,746,2306,10
84172013389,84172013393,4,1231,1707,10
84178679619,84178679621,2,1290,1777,10
84180119432,84180119434,2,1749,1971,10
84184263808,84184263802,-6,1309,6297,10
84186710131,84186710128,-3,1333,2583,10
84191043363,84191043357,-6,995,4807,10
84197891970,84197891969,-1,961,1798,10
84207544750,84207544749,-1,1274,2345,10
84208837795,84208837803,8,258,669,10
84209904522,84209904520,-2,973,1717,10
84214309422,84214309421,-1,1471,2379,10
84216948007,84216948005,-2,1221,2608,10
84225195497,84225195495,-2,1363,2736,10
84225631130,84225631125,-5,904,1504,10
84226239297,84226239295,-2,1507,1431,10
84226851711,84226851709,-2,1218,1784,10
84235905001,84235904999,-2,1334,2714,10
84235938999,84235938998,-1,1044,1738,10
84236703002,84236703001,-1,930,1608,10
84237487126,84237487132,6,5729,2169,10
84239705717,84239705722,5,2462,1337,10
84240813995,84240813995,0,1343,2288,10
84241981215,84241981213,-2,718,1560,10
84246083020,84246083017,-3,959,1012,10
84253077991,84253077987,-4,1203,2220,10
84262126757,84262126754,-3,936,1530,10
84262697842,84262697842,0,1044,2194,10
84264884414,84264884417,3,1498,1448,10
84267463191,84267463191,0,978,1979,10
84269638101,84269638102,1,1050,1686,10
84278339166,84278339165,-1,859,1717,10
84280122391,84280122390,-1,1253,2021,10
84286087822,84286087821,-1,859,1806,10
84292690911,84292690910,-1,1544,1979,10
84293517538,84293517542,4,2366,901,10
84296235117,84296235121,4,2724,2552,10
84296515787,84296515786,-1,1551,2340,10
84296931759,84296931759,0,886,1915,10
84299393106,84299393104,-2,1193,1729,10
84303309194,84303309193,-1,27463,44127,10
84304774875,84304774873,-2,1685,2575,10
84305447233,84305447232,-1,1725,2284,10
84309571785,84309571785,0,1499,2617,10
84314397559,84314397557,-2,881,1413,10
84317174160,84317174162,2,1411,2150,10
84323227993,84323227994,1,1233,1752,10
84325312114,84325312113,-1,1332,1738,10
84326366000,84326366004,4,2927,1509,10
84334382759,84334382757,-2,1488,2203,10
84335775214,84335775213,-1,1059,2016,10
84338441894,84338441894,0,1390,1674,10
84339283899,84339283898,-1,880,1255,10
84340052835,84340052834,-1,900,1275,10
84340208622,84340208618,-4,1024,1838,10
84346489514,84346489514,0,1102,1412,10
84349118448,84349118446,-2,1257,1978,10
84349638282,84349638280,-2,983,1429,10
84352183011,84352183007,-4,1155,2074,10
84354802370,84354802369,-1,1540,2314,10
84357315759,84357315757,-2,1633,2360,10
84363415409,84363415415,6,1406,1013,10
84364195023,84364195019,-4,1375,2984,10
84370321311,84370321311,0,1084,2074,10
84372434076,84372434074,-2,1333,3034,10
84373082563,84373082562,-1,1303,1755,10
84373628952,84373628951,-1,1337,2626,10
84378005513,84378005511,-2,1490,1894,10
84380823958,84380823958,0,696,1258,10
84381651440,84381651438,-2,1180,1799,10
84385738397,84385738394,-3,1096,1968,10
84387725548,84387725545,-3,1081,1507,10
84389223990,84389223990,0,1973,2805,10
84389549913,84389549912,-1,1141,2580,10
84390215293,84390215291,-2,1094,1959,10
84391679469,84391679466,-3,1706,1920,10
84394061415,84394061413,-2,1331,2006,10
84395560763,84395560762,-1,964,1663,10
84398639494,84398639492,-2,1810,2453,10
84401954013,84401954010,-3,770,2095,10
84403280558,84403280558,0,1192,1481,10
84405752674,84405752671,-3,1436,3047,10
84409317632,84409317631,-1,1227,2259,10
84409366520,84409366511,-9,223,683,10
84414179647,84414179653,6,5425,2031,10
84425007421,84425007415,-6,2658,8233,10
84425597483,84425597482,-1,1293,1428,10
84425977482,84425977480,-2,1136,2277,10
84432484841,84432484840,-1,1157,1674,10
84432744832,84432744855,23,1082,1401,10
84436061875,84436061875,0,966,2272,10
84443358394,84443358392,-2,1435,1496,10
84449086925,84449086921,-4,1366,5021,10
84451084447,84451084446,-1,1186,2212,10
84452560890,84452560889,-1,1231,2009,10
84452726730,84452726730,0,1170,2133,10
84455390963,84455390962,-1,1801,2217,10
84455637162,84455637162,0,878,1388,10
84460255758,84460255758,0,915,1394,10
84463384291,84463384290,-1,1098,1347,10
84464141431,84464141430,-1,1567,1909,10
84468439698,84468439693,-5,1199,1591,10
84468490088,84468490090,2,1213,1242,10
84472659922,84472659921,-1,729,1518,10
84473445578,84473445575,-3,1459,2105,10
84475300046,84475300046,0,1002,2017,10
84480026750,84480026749,-1,1200,1962,10
84489745950,84489745948,-2,870,1692,10
84491574937,84491574918,-19,753,1470,10
84496084792,84496084790,-2,955,2450,10
84503083645,84503083643,-2,1215,2111,10
84503723087,84503723084,-3,966,1825,10
84504266826,84504266822,-4,1243,2675,10
84504483280,84504483298,18,517,978,10
84506053713,84506053711,-2,1283,1949,10
84509731531,84509731530,-1,1733,2031,10
84514621188,84514621188,0,1504,1957,10
84515002276,84515002274,-2,1185,1897,10
84515971852,84515971852,0,1625,2393,10
84520420329,84520420332,3,729,1126,10
84529866206,84529866206,0,1093,2407,10
84531184544,84531184541,-3,1429,1498,10
84532067001,84532067001,0,1127,2067,10
84532495543,84532495524,-19,984,1603,10
84532590361,84532590345,-16,1081,2236,10
84533616825,84533616826,1,1335,1798,10
84536201241,84536201241,0,1099,1993,10
84536835587,84536835606,19,651,1640,10
84539417655,84539417653,-2,1582,1724,10
84539516655,84539516654,-1,1115,1461,10
84540791514,84540791513,-1,1505,2321,10
84546098925,84546098924,-1,1564,2444,10
84546509391,84546509389,-2,964,1976,10
84547486516,84547486516,0,1087,1867,10
84548935318,84548935319,1,978,1611,10
84551054818,84551054818,0,1873,1966,10
84558585969,84558585969,0,1552,2420,10
84560460849,84560460847,-2,953,1629,10
84561957598,84561957598,0,1898,2877,10
84562580635,84562580636,1,1863,2102,10
84563804814,84563804813,-1,1350,1822,10
84565601522,84565601523,1,1179,1332,10
84567278858,84567278857,-1,729,1456,10
84567867576,84567867575,-1,1263,1837,10
84569162707,84569162705,-2,1243,2164,10
84578502246,84578502246,0,1027,1110,10
84579849914,84579849911,-3,1371,1471,10
84580922049,84580922050,1,859,1180,10
84581337804,84581337821,17,965,1878,10
84582182067,84582182087,20,1159,2160,10
84582559525,84582559533,8,4887,2546,10
84583998994,84583998992,-2,1290,1986,10
84585936226,84585936224,-2,1241,1768,10
84589515598,84589515597,-1,1831,3299,10
84593412446,84593412447,1,1777,2107,10
84596332530,84596332527,-3,1049,2401,10
84599230362,84599230362,0,1197,1747,10
84601228828,84601228827,-1,1502,2425,10
84603602252,84603602252,0,1793,2653,10
84606330911,84606330909,-2,1164,1997,10
84606727161,84606727158,-3,912,2111,10
84606898830,84606898830,0,798,1137,10
84620100827,84620100828,1,1632,1585,10
84620784662,84620784662,0,1506,1452,10
84626110949,84626110945,-4,1160,2073,10
84626215574,84626215573,-1,991,1701,10
84629291698,84629291697,-1,1416,2340,10
84632719397,84632719396,-1,1468,2285,10
84637167289,84637167287,-2,1003,1359,10
84638507562,84638507558,-4,1601,2526,10
84640109496,84640109518,22,686,1413,10
84642264891,84642264888,-3,1284,2648,10
84643732546,84643732547,1,883,1154,10
84645822891,84645822891,0,1079,2163,10
84647756770,84647756771,1,865,1519,10
84649616662,84649616662,0,1087,1771,10
84650426249,84650426248,-1,1206,2619,10
84657663117,84657663117,0,1293,2315,10
84659613360,84659613362,2,2214,1765,10
84665661966,84665661965,-1,1005,1795,10
84666125347,84666125345,-2,1252,1801,10
84667505022,84667505019,-3,1442,1421,10
84672750210,84672750209,-1,2035,2482,10
84675666907,84675666906,-1,1423,1722,10
84677299994,84677299994,0,1080,1904,10
84677819261,84677819260,-1,1543,2322,10
84681096077,84681096074,-3,1222,2491,10
84686363932,84686363931,-1,1269,2040,10
84690962022,84690962021,-1,990,1874,10
84695755355,84695755355,0,876,1844,10
84698109466,84698109465,-1,1043,1879,10
84699618317,84699618322,5,926,488,10
84703454314,84703454313,-1,1775,1832,10
84707730694,84707730693,-1,1064,1775,10
84713496368,84713496367,-1,1629,2316,10
84714653306,84714653304,-2,1569,2093,10
84714836034,84714836033,-1,1324,1896,10
84716083940,84716083938,-2,1828,2184,10
84718191334,84718191333,-1,997,2124,10
84718315398,84718315397,-1,1223,1396,10
84722224107,84722224109,2,909,2091,10
84724264918,84724264917,-1,1238,1780,10
84724310395,84724310393,-2,1310,1379,10
84729012562,84729012561,-1,1551,2070,10
84733077517,84733077517,0,961,2197,10
84735073571,84735073570,-1,1424,1889,10
84741729877,84741729876,-1,1273,2370,10
84748561071,84748561070,-1,1245,1978,10
84753302082,84753302084,2,1542,1823,10
84757867344,84757867342,-2,957,1996,10
84761811551,84761811554,3,1067,569,10
84762419403,84762419401,-2,1181,1755,10
84762559482,84762559482,0,1924,2944,10
84763661993,84763661992,-1,1497,2061,10
84764938030,84764938029,-1,1327,1928,10
84765331290,84765331291,1,647,1851,10
84765851451,84765851449,-2,1337,2611,10
84766334094,84766334090,-4,896,1754,10
84766521697,84766521719,22,1421,1695,10
84766956644,84766956641,-3,1160,2279,10
84770422502,84770422502,0,879,1969,10
84770815509,84770815508,-1,1243,2357,10
84777242951,84777242950,-1,1402,3366,10
84778907252,84778907251,-1,1669,2865,10
84778945002,84778945002,0,1621,2443,10
84779101625,84779101624,-1,1217,1502,10
84780579363,84780579362,-1,1217,2128,10
84781148466,84781148464,-2,1671,2143,10
84784569187,84784569185,-2,1148,1877,10
84788685867,84788685862,-5,1688,4028,10
84789845645,84789845642,-3,974,2005,10
84792752966,84792752966,0,1642,1287,10
84793347830,84793347827,-3,958,2855,10
84796867290,84796867286,-4,1355,2019,10
84799164202,84799164203,1,1174,2069,10
84799978405,84799978403,-2,1874,2383,10
84800947834,84800947828,-6,932,4688,10
84807501652,84807501667,15,7030,48214,10
84807921967,84807921965,-2,1204,1489,10
84812314921,84812314928,7,4505,1298,10
84814249343,84814249342,-1,847,1296,10
84822020098,84822020116,18,876,1540,10
84824634183,84824634181,-2,1278,2036,10
84826342919,84826342918,-1,794,1900,10
84828734135,84828734131,-4,788,2415,10
84834909083,84834909080,-3,943,3378,10
84836732742,84836732740,-2,1131,2020,10
84837178218,84837178217,-1,1206,1788,10
84843011194,84843011191,-3,1152,2085,10
84844469875,84844469874,-1,1124,1625,10
84844599471,84844599470,-1,1041,2076,10
84852468054,84852468055,1,898,1703,10
84853999598,84853999596,-2,1486,1938,10
84858998411,84858998409,-2,1166,1985,10
84861979716,84861979720,4,1701,1571,10
84863231398,84863231397,-1,1181,2003,10
84865991303,84865991304,1,1479,2228,10
84867005143,84867005140,-3,1130,2592,10
84867864759,84867864758,-1,1020,2339,10
84870081310,84870081311,1,1597,1602,10
84871485623,84871485624,1,1412,2153,10
84876646689,84876646689,0,1327,1822,10
84877330690,84877330688,-2,1451,1801,10
84888045810,84888045806,-4,901,2451,10
84893316667,84893316664,-3,1210,2274,10
84894293154,84894293173,19,1033,2059,10
84894754426,84894754425,-1,1306,2168,10
84898216834,84898216833,-1,980,1628,10
84899582306,84899582307,1,1983,1846,10
84899797170,84899797171,1,1344,1728,10
84900292946,84900292945,-1,7385,11284,10
84901386985,84901386985,0,1374,2654,10
84903629063,84903629063,0,900,1994,10
84907711035,84907711037,2,1170,1698,10
84910360978,84910360977,-1,1398,2245,10
84913253582,84913253589,7,3570,2163,10
84913393071,84913393065,-6,3948,14397,10
84914582691,84914582693,2,1194,1500,10
84920941261,84920941261,0,924,2376,10
84921189012,84921189021,9,17,569,10
84921591498,84921591495,-3,1169,1616,10
84927486398,84927486397,-1,986,1837,10
84932234719,84932234718,-1,1309,1536,10
84938236077,84938236098,21,3484,9525,10
84944859083,84944859082,-1,1205,2597,10
84946770217,84946770214,-3,1034,2059,10
84948757159,84948757159,0,1290,1518,10
84949762411,84949762410,-1,767,1641,10
84951431966,84951431965,-1,1455,2727,10
84952859259,84952859255,-4,961,1572,10
84957677850,84957677851,1,877,1895,10
84959976546,84959976544,-2,1204,1545,10
84960704894,84960704895,1,1011,1882,10
84961554889,84961554895,6,1521,2083,10
84962414889,84962414891,2,1440,1872,10
84963497286,84963497287,1,1704,1432,10
84964624605,84964624602,-3,1099,2037,10
84967866762,84967866762,0,1169,1892,10
84968010007,84968010002,-5,1240,2072,10
84971364742,84971364758,16,1460,1775,10
84977219686,84977219690,4,1078,953,10
84978975843,84978975842,-1,1332,2325,10
84980419610,84980419609,-1,1262,1485,10
84988228179,84988228178,-1,1681,2387,10
84989648971,84989648966,-5,886,1808,10
84992139017,84992139019,2,2393,2773,10
84993298452,84993298450,-2,1376,3176,10
84993480494,84993480493,-1,1518,2259,10
84997125107,84997125106,-1,1222,1679,10
84998277763,84998277765,2,1386,2357,10
84999376934,84999376941,7,17773,19744,10
85007825918,85007825915,-3,627,1643,10
85007924337,85007924318,-19,453,1029,10
85009925466,85009925465,-1,1461,2065,10
85011864999,85011864997,-2,1560,2201,10
85014978226,85014978226,0,1191,2391,10
85016640190,85016640189,-1,846,1443,10
85017766423,85017766421,-2,981,1729,10
85029050660,85029050657,-3,1567,2151,10
85032052471,85032052471,0,1080,2045,10
85037274201,85037274200,-1,944,1442,10
85039465750,85039465749,-1,1258,1816,10
85041726203,85041726202,-1,1020,2129,10
85041840270,85041840269,-1,1209,1963,10
85044973414,85044973414,0,1145,1301,10
85048055635,85048055629,-6,897,5248,10
85048312024,85048312013,-11,1249,1650,10
85049828803,85049828801,-2,1116,1716,10
85054425303,85054425303,0,1269,2001,10
85056120663,85056120662,-1,1305,2135,10
85057066623,85057066621,-2,1071,1787,10
85063659690,85063659690,0,620,1963,10
85070000250,85070000250,0,2977,4241,10
85071296514,85071296517,3,1782,1539,10
85071557776,85071557774,-2,1759,2977,10
85071651930,85071651911,-19,762,1063,10
85072397786,85072397785,-1,1736,1597,10
85075683326,85075683325,-1,911,1550,10
85076066354,85076066354,0,830,945,10
85077151219,85077151227,8,1402,1253,10
85080834267,85080834267,0,1761,2291,10
85082270435,85082270413,-22,1615,1954,10
85083128795,85083128794,-1,805,1553,10
85084085393,85084085391,-2,1348,1881,10
85086348010,85086348009,-1,1323,1560,10
85087830694,85087830690,-4,1821,5602,10
85091913103,85091913101,-2,996,1568,10
85095785345,85095785343,-2,1929,1971,10
85098316866,85098316863,-3,1308,1682,10
85099633314,85099633314,0,1080,1513,10
85100476512,85100476508,-4,1329,3008,10
85102061749,85102061749,0,1541,1576,10
85105736340,85105736337,-3,1573,3728,10
85106792757,85106792758,1,819,1365,10
85106999239,85106999241,2,1389,1682,10
85108120031,85108120030,-1,886,1301,10
85109730002,85109730001,-1,1319,2528,10
85118019673,85118019672,-1,1189,1426,10
85121423839,85121423838,-1,1479,2669,10
85121948126,85121948125,-1,1954,2617,10
85123819580,85123819578,-2,1107,2279,10
85125186909,85125186908,-1,1009,2244,10
85127458273,85127458293,20,265,812,10
85134239305,85134239304,-1,1755,1644,10
85134395986,85134395985,-1,1116,2646,10
85136672878,85136672877,-1,2930,5805,10
85140259766,85140259765,-1,1676,2414,10
85140416779,85140416778,-1,1283,1663,10
85140596694,85140596695,1,1125,1889,10
85142878170,85142878168,-2,844,1950,10
85143941282,85143941282,0,44147,4844,10
85156308302,85156308303,1,1637,2053,10
85157586106,85157586110,4,2229,1289,10
85161251618,85161251618,0,3110,3917,10
85164603759,85164603759,0,729,1071,10
85166611529,85166611529,0,1169,2091,10
85173018758,85173018756,-2,1255,2276,10
85173555502,85173555499,-3,1233,1948,10
85175455195,85175455194,-1,752,2088,10
85179200621,85179200615,-6,965,3117,10
85180026962,85180026961,-1,1418,1667,10
85181487159,85181487157,-2,1332,2028,10
85185310223,85185310224,1,1029,1495,10
85187448825,85187448824,-1,1100,1514,10
85188628617,85188628622,5,3158,1727,10
85188844841,85188844838,-3,1589,1744,10
85193192304,85193192302,-2,1084,876,10
85198233616,85198233613,-3,1503,1837,10
85199396153,85199396134,-19,833,1629,10
85201859807,85201859808,1,864,2278,10
85202457402,85202457407,5,16169,44564,10
85203028750,85203028750,0,1032,1916,10
85204807129,85204807130,1,14536,12682,10
85205823159,85205823157,-2,1013,1969,10
85206928370,85206928368,-2,539,1122,10
85207334426,85207334407,-19,117,6785,10
85207603366,85207603366,0,1041,2019,10
85210244814,85210244825,11,1232,1736,10
85213979863,85213979862,-1,820,1837,10
85216168603,85216168601,-2,1267,2474,10
85224188838,85224188834,-4,1524,2152,10
85228893962,85228893958,-4,817,2255,10
85230524327,85230524326,-1,1605,2473,10
85231674323,85231674323,0,1061,1544,10
85232467659,85232467657,-2,1001,1331,10
85237335324,85237335323,-1,1912,3159,10
85238776368,85238776367,-1,1501,2365,10
85243108551,85243108550,-1,1388,1718,10
85244289375,85244289373,-2,878,1671,10
85245313858,85245313878,20,1356,1741,10
85245702370,85245702371,1,1044,1040,10
85246864310,85246864311,1,1120,914,10
85247568943,85247568942,-1,654,1523,10
85248128715,85248128715,0,997,1677,10
85258505451,85258505450,-1,1093,2023,10
85263005535,85263005535,0,912,1674,10
85267516338,85267516334,-4,1001,1668,10
85269151544,85269151542,-2,1242,1388,10
85269636430,85269636429,-1,1493,2192,10
85279811620,85279811618,-2,985,1233,10
85283477573,85283477571,-2,1554,1968,10
85291265570,85291265567,-3,1229,1747,10
85294691004,85294691002,-2,1434,1599,10
85298723571,85298723570,-1,1069,1328,10
85299100878,85299100877,-1,1600,2196,10
85300998441,85300998442,1,1675,1620,10
85301578606,85301578607,1,1270,1161,10
85304103625,85304103630,5,1880,1190,10
85304157247,85304157245,-2,1073,1846,10
85304952203,85304952198,-5,1204,2287,10
85305728637,85305728634,-3,1159,1632,10
85309651200,85309651199,-1,1060,1478,10
85310891929,85310891929,0,1419,1412,10
85317048425,85317048422,-3,1569,2540,10
85323110430,85323110427,-3,1285,2694,10
85323553573,85323553569,-4,1136,2065,10
85326548125,85326548126,1,1260,1565,10
85329412621,85329412618,-3,1573,1968,10
85340186490,85340186489,-1,1137,1787,10
85342537808,85342537806,-2,1211,1658,10
85343044328,85343044351,23,981,1433,10
85346345085,85346345080,-5,922,4262,10
85346529791,85346529790,-1,1551,2814,10
85347574311,85347574309,-2,1331,1532,10
85349906978,85349906977,-1,1174,2458,10
85350223818,85350223815,-3,1144,1808,10
85359128881,85359128878,-3,1094,2080,10
85363638276,85363638275,-1,1175,2228,10
85363695577,85363695572,-5,1317,3016,10
85367672434,85367672434,0,824,1335,10
85371021143,85371021141,-2,1036,1997,10
85374754181,85374754187,6,2193,1067,10
85375218204,85375218206,2,1760,1503,10
85377141047,85377141044,-3,1160,2304,10
85378790097,85378790097,0,1364,1944,10
85380442142,85380442147,5,4842,2677,10
85380970381,85380970386,5,2672,1138,10
85381522661,85381522661,0,925,1546,10
85385791780,85385791777,-3,1104,2003,10
85386215258,85386215254,-4,767,1060,10
85386498820,85386498816,-4,1375,2682,10
85387767131,85387767130,-1,1191,1447,10
85389835591,85389835586,-5,1496,3615,10
85392203418,85392203417,-1,1484,1715,10
85399228894,85399228893,-1,1111,1862,10
85400728837,85400728837,0,1232,1642,10
85403068998,85403068998,0,1087,1655,10
85403554226,85403554225,-1,1159,1480,10
85405574415,85405574414,-1,1125,2233,10
85405999299,85405999297,-2,1091,2063,10
85409171801,85409171799,-2,1110,1750,10
85409743891,85409743907,16,839,1447,10
85422163450,85422163450,0,1796,2172,10
85425108135,85425108137,2,2490,1819,10
85427678490,85427678492,2,1693,2299,10
85428622535,85428622534,-1,1062,1769,10
85432451379,85432451378,-1,844,1272,10
85436121578,85436121574,-4,1375,2589,10
85436270161,85436270161,0,1708,1841,10
85437890536,85437890537,1,1173,1152,10
85444514819,85444514807,-12,1219,1762,10
85448939651,85448939629,-22,846,1059,10
85448978072,85448978093,21,1092,2914,10
85450632597,85450632596,-1,2122,1413,10
85454113363,85454113362,-1,1356,1726,10
85454153444,85454153442,-2,1049,1939,10
85456923392,85456923389,-3,1122,2194,10
85456976075,85456976074,-1,1118,1757,10
85458671698,85458671697,-1,1395,1826,10
85460629706,85460629705,-1,1579,2216,10
85461565813,85461565813,0,1196,2080,10
85466222818,85466222815,-3,2381,2332,10
85468819651,85468819657,6,5343,1346,10
85471637091,85471637093,2,1616,1978,10
85475792658,85475792657,-1,1447,1793,10
85476879024,85476879022,-2,1568,1946,10
85477661234,85477661233,-1,1069,1709,10
85485964878,85485964874,-4,1230,1833,10
85487066763,85487066761,-2,1260,2232,10
85487944446,85487944443,-3,1258,2359,10
85491062994,85491062993,-1,1010,1688,10
85491176255,85491176253,-2,533,1269,10
85495492610,85495492610,0,1113,1588,10
85498302719,85498302719,0,1609,2606,10
85500001556,85500001553,-3,1190,2816,10
85502210846,85502210846,0,845,1305,10
85505102935,85505102932,-3,1428,1953,10
85505605858,85505605857,-1,966,1843,10
85506566302,85506566298,-4,1283,2022,10
85513236582,85513236582,0,819,1644,10
85516372750,85516372749,-1,925,1771,10
85517348082,85517348082,0,1203,1777,10
85517427099,85517427094,-5,917,3207,10
85519466584,85519466583,-1,834,1581,10
85521353038,85521353039,1,1105,983,10
85524679971,85524679970,-1,1204,1813,10
85528342232,85528342230,-2,677,1514,10
85529057600,85529057598,-2,1173,2263,10
85529899100,85529899098,-2,1726,2004,10
85534727247,85534727246,-1,921,1914,10
85536196501,85536196507,6,1598,1220,10
85540595018,85540595021,3,11383,11051,10
85541505859,85541505855,-4,1468,2297,10
85545161733,85545161733,0,982,1533,10
85548357284,85548357284,0,1607,2177,10
85549779586,85549779584,-2,1033,2689,10
85551414087,85551414085,-2,1897,2419,10
85552413370,85552413369,-1,1192,1898,10
85558931879,85558931876,-3,998,2135,10
85560921321,85560921319,-2,1772,2531,10
85566294755,85566294754,-1,1186,2217,10
85567701961,85567701962,1,1559,2303,10
85569175802,85569175807,5,3941,2405,10
85576032754,85576032753,-1,1598,1665,10
85577414352,85577414350,-2,1569,2096,10
85578107171,85578107170,-1,974,1333,10
85580462559,85580462561,2,1499,1544,10
85580930746,85580930744,-2,1471,3298,10
85581826739,85581826729,-10,1132,1189,10
85584056888,85584056888,0,1557,1862,10
85584379267,85584379266,-1,1387,2529,10
85586185109,85586185109,0,1175,2063,10
85589982767,85589982765,-2,1098,1811,10
85592056130,85592056130,0,1157,2049,10
85592883122,85592883121,-1,1400,1868,10
85594138138,85594138143,5,2522,2004,10
85594818209,85594818206,-3,1144,2440,10
85596712493,85596712491,-2,961,2199,10
85596832370,85596832358,-12,815,1929,10
85600706251,85600706249,-2,1185,2201,10
85601711354,85601711353,-1,1297,1751,10
85602230346,85602230346,0,1353,2288,10
85607952630,85607952631,1,1843,1483,10
85608718555,85608718549,-6,2471,7591,10
85609211941,85609211939,-2,1390,2353,10
85609818808,85609818807,-1,1323,1299,10
85612509049,85612509047,-2,1479,1744,10
85612587517,85612587514,-3,1232,2154,10
85612952895,85612952894,-1,1177,2266,10
85613372056,85613372055,-1,1204,2475,10
85619164371,85619164366,-5,843,1981,10
85621947340,85621947335,-5,1697,2452,10
85623311071,85623311070,-1,1083,2291,10
85630667662,85630667662,0,1242,1380,10
85630982095,85630982094,-1,1251,1852,10
85632671047,85632671047,0,1116,1449,10
85632812427,85632812442,15,386,1081,10
85633310786,85633310786,0,936,1337,10
85635898518,85635898518,0,988,1496,10
85639544075,85639544074,-1,1142,1938,10
85643245761,85643245759,-2,1485,2308,10
85647944544,85647944545,1,1131,1957,10
85648071042,85648071043,1,1871,2336,10
85649760318,85649760318,0,1530,1787,10
85649810073,85649810071,-2,1203,1590,10
85653662907,85653662906,-1,1438,1555,10
85656000114,85656000110,-4,1911,4529,10
85666703302,85666703301,-1,1088,1828,10
85671679379,85671679378,-1,1290,2465,10
85671798273,85671798270,-3,1241,2317,10
85675950714,85675950711,-3,933,2171,10
85677846533,85677846534,1,1109,1837,10
85677983586,85677983579,-7,1771,6402,10
85680104436,85680104436,0,1295,1922,10
85684258871,85684258870,-1,21526,21073,10
85685508459,85685508458,-1,1422,3153,10
85686579175,85686579174,-1,3463,3740,10
85686855122,85686855119,-3,1343,1891,10
85688320835,85688320835,0,971,1215,10
85689148651,85689148645,-6,1862,7477,10
85692567771,85692567773,2,1683,1513,10
85698211881,85698211882,1,3295,2929,10
85702565337,85702565334,-3,1268,1260,10
85707224645,85707224650,5,2282,1235,10
85709369359,85709369355,-4,976,1601,10
85710223339,85710223337,-2,1110,2686,10
85710548895,85710548894,-1,1478,1912,10
85712900802,85712900801,-1,970,1999,10
85716982109,85716982107,-2,966,1707,10
85718435075,85718435073,-2,1057,2205,10
85719697053,85719697050,-3,1291,1799,10
85720738181,85720738179,-2,1464,2033,10
85726951551,85726951549,-2,1574,1716,10
85729536462,85729536463,1,1346,2130,10
85730809862,85730809862,0,888,1171,10
85733687811,85733687810,-1,1575,2009,10
85738179535,85738179535,0,2932,3680,10
85739488390,85739488390,0,876,1427,10
85744719643,85744719641,-2,1262,2232,10
85745978891,85745978894,3,1201,786,10
85748648593,85748648589,-4,1675,2718,10
85751164419,85751164418,-1,1024,2537,10
85760487644,85760487642,-2,1249,1976,10
85762306102,85762306102,0,942,1842,10
85764001235,85764001234,-1,981,2447,10
85764694673,85764694668,-5,964,3220,10
85765082779,85765082778,-1,1035,1648,10
85767773411,85767773410,-1,1486,2110,10
85773704645,85773704626,-19,1811,1890,10
85776663843,85776663842,-1,955,1724,10
85777239870,85777239873,3,2890,3192,10
85777537909,85777537909,0,1004,1975,10
85780073871,85780073870,-1,1245,2681,10
85781276413,85781276412,-1,1377,1960,10
85781638496,85781638494,-2,1255,1692,10
85783554704,85783554702,-2,919,1798,10
85784247225,85784247218,-7,1284,2317,10
85784335631,85784335629,-2,1520,2507,10
85786823567,85786823570,3,1087,1080,10
85793241572,85793241571,-1,1044,1554,10
85798388666,85798388661,-5,922,4095,10
85799051250,85799051247,-3,1041,1837,10
85800455312,85800455315,3,2037,1245,10
85801557469,85801557466,-3,1482,1901,10
85801835474,85801835470,-4,961,1717,10
85806211875,85806211874,-1,1374,2123,10
85807873990,85807873989,-1,1467,1997,10
85808238795,85808238792,-3,1105,1606,10
85808689089,85808689087,-2,1427,2214,10
85809435822,85809435819,-3,1134,2007,10
85812243958,85812243957,-1,1312,3048,10
85812437137,85812437136,-1,1553,2509,10
85812900343,85812900343,0,1932,2536,10
85813153171,85813153170,-1,1227,2150,10
85814215310,85814215308,-2,1136,2720,10
85815262574,85815262574,0,681,1186,10
85818303627,85818303626,-1,1749,2400,10
85823562023,85823562023,0,987,1808,10
85830558327,85830558327,0,639,765,10
85832299483,85832299482,-1,654,1430,10
85833583363,85833583369,6,1640,1052,10
85835764015,85835764014,-1,1166,3001,10
85836599814,85836599814,0,957,1769,10
85837262854,85837262858,4,3703,2107,10
85838955967,85838955966,-1,654,1529,10
85844956119,85844956118,-1,891,1679,10
85847124878,85847124875,-3,831,1803,10
85855424373,85855424370,-3,1208,1767,10
85863371962,85863371962,0,1391,1588,10
85866267771,85866267770,-1,770,1842,10
85867895310,85867895309,-1,887,1836,10
85872642257,85872642250,-7,1742,6730,10
85872910872,85872910871,-1,945,2119,10
85873669529,85873669526,-3,1445,2200,10
85878742351,85878742350,-1,943,1502,10
85881738473,85881738474,1,1484,2025,10
85882601779,85882601778,-1,979,1450,10
85884771734,85884771730,-4,1386,2370,10
85888658853,85888658854,1,916,2170,10
85889061877,85889061877,0,1310,1992,10
85890210731,85890210733,2,1255,1286,10
85890956306,85890956305,-1,1546,1564,10
85892224881,85892224878,-3,860,1611,10
85892740619,85892740602,-17,1452,1580,10
85896750058,85896750057,-1,1723,2684,10
85897127791,85897127789,-2,1256,2559,10
85898169006,85898169007,1,1173,2098,10
85898335632,85898335654,22,1169,1338,10
85905628434,85905628434,0,1202,2588,10
85905913570,85905913574,4,1920,1166,10
85906277569,85906277569,0,1201,1956,10
85907639329,85907639326,-3,1202,1865,10
85912934215,85912934214,-1,1034,2019,10
85915893105,85915893104,-1,1311,2143,10
85916627664,85916627664,0,1136,1752,10
85923745963,85923745960,-3,1134,2563,10
85925567904,85925567897,-7,1174,5066,10
85927872715,85927872713,-2,849,1586,10
85933877917,85933877910,-7,1027,4754,10
85935409711,85935409707,-4,777,1223,10
85935716741,85935716740,-1,1351,1494,10
85939131749,85939131749,0,1254,2297,10
85939674349,85939674348,-1,754,1895,10
85942711719,85942711718,-1,1147,1616,10
85942833273,85942833291,18,851,1005,10
85943065057,85943065054,-3,1333,2275,10
85949860018,85949860018,0,1264,1501,10
85950101402,85950101400,-2,1199,2510,10
85950919662,85950919661,-1,1365,1677,10
85951455026,85951455016,-10,1103,1909,10
85952519850,85952519850,0,1253,2856,10
85954972536,85954972534,-2,1457,1312,10
85957060181,85957060178,-3,1109,2242,10
85957437918,85957437918,0,1267,1565,10
85961369126,85961369125,-1,1146,1689,10
85963198180,85963198177,-3,1792,2216,10
85964937955,85964937950,-5,1066,1648,10
85968554217,85968554218,1,1936,2935,10
85969646534,85969646531,-3,1114,2416,10
85972433940,85972433935,-5,1279,1854,10
85974780180,85974780177,-3,1037,1329,10
85975070891,85975070869,-22,909,1834,10
85975310798,85975310795,-3,1237,2281,10
85977101668,85977101667,-1,1504,2080,10
85978004642,85978004662,20,1451,2477,10
85980134264,85980134265,1,1319,1600,10
85991475065,85991475062,-3,1230,1474,10
85991558512,85991558510,-2,1373,2706,10
85995470650,85995470650,0,979,1930,10
85996959871,85996959868,-3,1308,1981,10
85998960144,85998960143,-1,1573,2938,10
86000435202,86000435197,-5,1023,3399,10
86002196728,86002196727,-1,967,1402,10
86002277738,86002277735,-3,953,1302,10
86004165042,86004165041,-1,1485,1885,10
86004855689,86004855689,0,1221,1975,10
86005817666,86005817665,-1,1832,2134,10
86007997628,86007997622,-6,2000,8928,10
86010443863,86010443861,-2,1634,1978,10
86013157399,86013157400,1,1428,1475,10
86014277321,86014277319,-2,1086,1471,10
86021063175,86021063173,-2,1215,1881,10
86022325251,86022325250,-1,1504,2680,10
86023126439,86023126438,-1,1062,1665,10
86025467882,86025467880,-2,1824,1940,10
86030036547,86030036549,2,1666,1300,10
86032545429,86032545433,4,1022,804,10
86035711804,86035711821,17,355,826,10
86042320417,86042320413,-4,25585,14265,10
86045650399,86045650403,4,1972,1467,10
86045911745,86045911743,-2,935,2139,10
86046188919,86046188917,-2,717,2484,10
86047327378,86047327377,-1,1066,1876,10
86047453363,86047453361,-2,704,2261,10
86050211578,86050211572,-6,1300,5941,10
86054717116,86054717117,1,1105,1729,10
86057883933,86057883930,-3,1253,1971,10
86059394844,86059394845,1,1390,2286,10
86063972487,86063972485,-2,1059,1575,10
86064517485,86064517484,-1,841,1682,10
86065209886,86065209884,-2,1333,1848,10
86065496979,86065496977,-2,1032,2189,10
86066799502,86066799501,-1,1107,2000,10
86072751350,86072751349,-1,1152,1321,10
86079824439,86079824435,-4,819,1559,10
86083904025,86083904022,-3,1097,2313,10
86084416117,86084416111,-6,2181,6747,10
86086715478,86086715477,-1,964,1803,10
86089118497,86089118497,0,1860,2439,10
86095315779,86095315777,-2,1149,2048,10
86097501431,86097501431,0,1262,1955,10
86102724524,86102724517,-7,1603,4206,10
86103051810,86103051829,19,322,851,10
86106998014,86106998013,-1,1278,2480,10
86111141378,86111141378,0,1099,1851,10
86114173179,86114173177,-2,1222,1362,10
86114468694,86114468693,-1,1267,1675,10
86119513298,86119513298,0,1352,1706,10
86119650203,86119650202,-1,1185,1223,10
86120918114,86120918114,0,1345,1431,10
86121462945,86121462950,5,4783,2519,10
86123490570,86123490571,1,1708,1881,10
86125009675,86125009674,-1,935,1396,10
86125186499,86125186499,0,1360,2840,10
86126209246,86126209245,-1,1517,1478,10
86126945331,86126945330,-1,637,1031,10
86127162874,86127162871,-3,1026,1597,10
86128699246,86128699242,-4,1404,3901,10
86132185663,86132185661,-2,898,1583,10
86135740626,86135740626,0,1477,1254,10
86136844635,86136844633,-2,911,1824,10
86142426553,86142426550,-3,1433,2946,10
86144089839,86144089835,-4,998,2331,10
86147380730,86147380727,-3,1400,2235,10
86152056321,86152056323,2,1890,1743,10
86154375731,86154375729,-2,884,1467,10
86156517660,86156517659,-1,1184,1550,10
86157557507,86157557507,0,1055,1408,10
86162659786,86162659786,0,1429,1721,10
86165035351,86165035347,-4,1253,3530,10
86166611464,86166611465,1,1521,2369,10
86167540381,86167540381,0,810,1689,10
86168552225,86168552227,2,1084,1148,10
86169213533,86169213530,-3,741,1542,10
86169493077,86169493077,0,1554,2039,10
86170846750,86170846749,-1,1461,2127,10
86171783288,86171783285,-3,1722,2743,10
86172624691,86172624690,-1,807,1291,10
86173121986,86173121982,-4,1152,2263,10
86174946358,86174946364,6,13246,6716,10
86179194902,86179194900,-2,1155,2195,10
86180781217,86180781218,1,10451,12993,10
86182867683,86182867684,1,1066,1664,10
86183167041,86183167041,0,973,2042,10
86187371855,86187371855,0,2167,3077,10
86187977549,86187977546,-3,1159,2341,10
86198219354,86198219349,-5,547,2639,10
86203445797,86203445796,-1,1047,1378,10
86216730547,86216730546,-1,929,1625,10
86217062335,86217062333,-2,1478,2210,10
86218850392,86218850389,-3,1069,2575,10
86219424745,86219424744,-1,1611,2270,10
86220724133,86220724130,-3,1207,2261,10
86220966039,86220966038,-1,1108,1598,10
86221083867,86221083866,-1,763,1824,10
86223414678,86223414677,-1,986,1467,10
86224077449,86224077448,-1,968,2098,10
86224511705,86224511702,-3,1413,2733,10
86229606755,86229606755,0,1599,2631,10
86231416257,86231416256,-1,1614,2132,10
86235724785,86235724784,-1,1146,1692,10
86239523697,86239523694,-3,1265,2032,10
86241749554,86241749552,-2,961,1572,10
86242833218,86242833215,-3,1997,3047,10
86243288149,86243288146,-3,1590,2565,10
86247869631,86247869626,-5,1115,1840,10
86248381950,86248381954,4,2305,1892,10
86251621443,86251621442,-1,1177,1086,10
86252824285,86252824284,-1,1510,2940,10
86256101671,86256101665,-6,1244,3038,10
86259444543,86259444542,-1,839,1154,10
86265788889,86265788887,-2,1047,1820,10
86266803554,86266803558,4,1453,1122,10
86267851686,86267851685,-1,1344,1491,10
86270059427,86270059424,-3,1048,1370,10
86274338202,86274338202,0,1415,2263,10
86275100120,86275100118,-2,1443,2570,10
86279355815,86279355812,-3,613,1218,10
86280944715,86280944713,-2,879,1895,10
86281000038,86281000041,3,1197,1877,10
86281401840,86281401838,-2,1099,1796,10
86281651791,86281651790,-1,1171,1313,10
86281838219,86281838217,-2,1470,2774,10
86282130420,86282130435,15,711,1588,10
86283708682,86283708681,-1,1430,2282,10
86284050924,86284050922,-2,1685,2801,10
86287006133,86287006130,-3,1233,2442,10
86287187154,86287187157,3,39280,32674,10
86288816153,86288816153,0,1012,1531,10
86291048984,86291048984,0,1332,2045,10
86295220096,86295220095,-1,1583,2006,10
86295248828,86295248847,19,1410,1952,10
86301360500,86301360519,19,16511,37313,10
86301444779,86301444779,0,719,1382,10
86303778849,86303778846,-3,1135,1689,10
86304801810,86304801810,0,956,2446,10
86306120582,86306120580,-2,1090,1552,10
86309624228,86309624226,-2,1303,2154,10
86315397738,86315397740,2,9029,19388,10
86316780286,86316780285,-1,907,1296,10
86321495134,86321495134,0,1357,2188,10
86324626269,86324626268,-1,1769,2030,10
86325696649,86325696660,11,903,1351,10
86339649270,86339649269,-1,1692,2103,10
86340583875,86340583874,-1,1086,1718,10
86342844666,86342844665,-1,1434,1751,10
86343742051,86343742051,0,1083,2574,10
86347510712,86347510715,3,1678,1135,10
86353332006,86353332005,-1,850,1910,10
86354328772,86354328761,-11,39090,19192,10
86359058947,86359058946,-1,1026,1337,10
86359824854,86359824850,-4,1029,2926,10
86362356553,86362356553,0,1140,2088,10
86362589766,86362589765,-1,1328,2346,10
86362722995,86362722993,-2,2995,4596,10
86367555756,86367555754,-2,1079,2692,10
86370243666,86370243663,-3,1088,2626,10
86372039994,86372039994,0,1535,1128,10
86373227494,86373227493,-1,1301,1450,10
86377249454,86377249453,-1,1085,2403,10
86377621761,86377621749,-12,1387,1623,10
86381319218,86381319215,-3,1376,2824,10
86381601830,86381601828,-2,1183,1941,10
86381762583,86381762582,-1,1141,1587,10
86382183768,86382183764,-4,2290,5400,10
86384983255,86384983254,-1,1698,1887,10
86386868664,86386868668,4,25127,18819,10
86390133726,86390133742,16,741,1086,10
86393528287,86393528284,-3,1003,2061,10
86397541091,86397541087,-4,861,2187,10
86399370345,86399370345,0,1124,1710,10
86400457246,86400457247,1,1066,1701,10
86402952717,86402952715,-2,1229,2738,10
86413814732,86413814730,-2,1344,2084,10
86422278063,86422278062,-1,932,1603,10
86427095091,86427095090,-1,1878,2274,10
86428910011,86428910008,-3,1133,2004,10
86429138585,86429138582,-3,946,2232,10
86431169178,86431169177,-1,1039,2229,10
86433437858,86433437861,3,2360,1895,10
86434971066,86434971071,5,1974,1130,10
86437545627,86437545626,-1,873,1905,10
86437855828,86437855841,13,280,843,10
86439719798,86439719799,1,962,1804,10
86440835211,86440835210,-1,1127,1739,10
86442844665,86442844663,-2,1579,2375,10
86443395298,86443395317,19,1122,4896,10
86443767510,86443767511,1,1398,1915,10
86444269878,86444269877,-1,1451,2626,10
86445936438,86445936437,-1,1153,1570,10
86448366679,86448366695,16,1061,1771,10
86450020757,86450020749,-8,956,3458,10
86451696603,86451696600,-3,868,1505,10
86452762921,86452762920,-1,1368,1836,10
86454636125,86454636127,2,856,1064,10
86454802890,86454802890,0,1155,2514,10
86461747139,86461747130,-9,28011,15515,10
86467257098,86467257097,-1,1519,1751,10
86477340727,86477340725,-2,907,1615,10
86477940506,86477940504,-2,827,1702,10
86478709954,86478709952,-2,862,1813,10
86480650654,86480650653,-1,891,1324,10
86484782294,86484782293,-1,1055,906,10
86485597955,86485597955,0,919,1587,10
86486618822,86486618821,-1,1308,2442,10
86489065787,86489065787,0,1429,1274,10
86491029146,86491029145,-1,1491,1675,10
86492476750,86492476751,1,974,1670,10
86492654623,86492654623,0,1516,1572,10
86493023602,86493023602,0,1576,1642,10
86493822870,86493822867,-3,1299,2333,10
86493943869,86493943867,-2,1150,1219,10
86501037902,86501037900,-2,1295,2557,10
86501814343,86501814338,-5,1303,1491,10
86505551585,86505551582,-3,1247,2698,10
86506692432,86506692432,0,1342,2201,10
86507656653,86507656651,-2,1358,2149,10
86508678862,86508678861,-1,1191,2258,10
86509478878,86509478877,-1,1594,2215,10
86518877258,86518877257,-1,1773,2307,10
86519234265,86519234262,-3,962,2211,10
86521216440,86521216442,2,1146,1690,10
86521896289,86521896311,22,816,1510,10
86524106374,86524106374,0,1025,1514,10
86524274347,86524274342,-5,2126,5952,10
86530207256,86530207245,-11,1502,1856,10
86531957074,86531957070,-4,1018,1068,10
86532790113,86532790113,0,1350,1685,10
86534372290,86534372297,7,13042,26604,10
86535627485,86535627486,1,1234,2171,10
86535792866,86535792886,20,1109,1989,10
86535899514,86535899534,20,1244,1989,10
86538430007,86538430010,3,1251,1449,10
86541367062,86541367077,15,13242,53525,10
86541504606,86541504602,-4,939,2465,10
86541657264,86541657265,1,96,433,10
86544334993,86544334989,-4,1035,1567,10
86546600694,86546600697,3,1018,1001,10
86547509601,86547509598,-3,1375,3216,10
86550190527,86550190526,-1,1125,1631,10
86550401565,86550401563,-2,634,1246,10
86551922375,86551922374,-1,1203,1667,10
86553643165,86553643159,-6,827,3583,10
86561265699,86561265697,-2,1679,2910,10
86562996269,86562996269,0,1032,1340,10
86567713810,86567713811,1,1035,1686,10
86572886746,86572886746,0,1469,1788,10
86576463007,86576463005,-2,758,2231,10
86577839811,86577839797,-14,811,1279,10
86579442366,86579442364,-2,1060,1546,10
86579948506,86579948508,2,1948,1486,10
86582341986,86582341985,-1,1305,2353,10
86583990137,86583990136,-1,1270,1720,10
86585100179,86585100175,-4,1581,2453,10
86585132303,86585132302,-1,1128,2231,10
86589140728,86589140726,-2,1398,2434,10
86591222163,86591222163,0,1011,1704,10
86592214910,86592214910,0,1334,1598,10
86596437615,86596437612,-3,1248,1491,10
86597240734,86597240734,0,973,1585,10
86597665366,86597665347,-19,4680,1800,10
86599017314,86599017312,-2,1173,2033,10
86601395640,86601395638,-2,1673,1961,10
86606220031,86606220028,-3,1157,2650,10
86607685119,86607685129,10,1091,1406,10
86610729066,86610729070,4,2427,1050,10
86612042552,86612042550,-2,1304,1860,10
86615613275,86615613274,-1,1960,2180,10
86615813372,86615813372,0,1117,1474,10
86617360011,86617360006,-5,926,1678,10
86618265442,86618265441,-1,1274,1354,10
86620742072,86620742071,-1,1374,3138,10
86622599551,86622599549,-2,1229,1943,10
86623113897,86623113896,-1,1300,1970,10
86628587349,86628587346,-3,1179,1697,10
86630142827,86630142825,-2,1351,2598,10
86633889027,86633889023,-4,1409,2765,10
86642505427,86642505427,0,970,1738,10
86642828062,86642828062,0,1257,1241,10
86644199295,86644199298,3,1088,1231,10
86647611154,86647611152,-2,1384,2314,10
86651432573,86651432572,-1,1273,1677,10
86654042631,86654042630,-1,1397,2418,10
86656173450,86656173450,0,1212,1613,10
86657995080,86657995081,1,1175,2235,10
86660408722,86660408718,-4,1168,2226,10
86660969061,86660969061,0,1060,1950,10
86661385822,86661385822,0,1084,2755,10
86664761722,86664761722,0,27676,19389,10
86665287897,86665287902,5,2212,1509,10
86665343509,86665343506,-3,1235,2329,10
86669053614,86669053611,-3,1244,1957,10
86682229386,86682229385,-1,1303,1730,10
86683009038,86683009038,0,814,1216,10
86688747435,86688747434,-1,1079,1998,10
86691791890,86691791889,-1,819,1556,10
86693258016,86693258014,-2,1115,2003,10
86698064775,86698064778,3,1303,1484,10
86700630126,86700630130,4,5633,21756,10
86702836656,86702836653,-3,39245,12913,10
86705768383,86705768382,-1,1385,2516,10
86709627546,86709627544,-2,1208,2353,10
86710362101,86710362099,-2,1398,1572,10
86713021289,86713021289,0,1396,1978,10
86714999053,86714999052,-1,1080,1455,10
86721339030,86721339029,-1,1127,1892,10
86729356500,86729356496,-4,1539,2671,10
86730462855,86730462855,0,1087,1579,10
86732568926,86732568925,-1,923,1635,10
86736797897,86736797894,-3,1546,1860,10
86737231002,86737231000,-2,996,2270,10
86738669828,86738669843,15,395,1178,10
86739232916,86739232914,-2,1647,2678,10
86741216734,86741216734,0,2023,2590,10
86741839717,86741839714,-3,2007,3489,10
86742249163,86742249162,-1,1470,1744,10
86747199054,86747199053,-1,1511,2435,10
86747906247,86747906247,0,1037,2308,10
86749149838,86749149818,-20,1143,2079,10
86750143388,86750143390,2,3260,3080,10
86750469852,86750469850,-2,1043,1432,10
86751914034,86751914033,-1,762,1644,10
86753821498,86753821499,1,767,889,10
86757421559,86757421557,-2,1205,1735,10
86757568684,86757568681,-3,915,2586,10
86760754396,86760754394,-2,1164,1584,10
86768562487,86768562485,-2,752,1776,10
86768645160,86768645180,20,502,1609,10
86774956947,86774956949,2,1174,1193,10
86779974906,86779974903,-3,1098,1523,10
86780951790,86780951789,-1,1507,1556,10
86782138510,86782138507,-3,938,1907,10
86782178671,86782178670,-1,1604,2170,10
86785106577,86785106574,-3,1534,2820,10
86785611336,86785611334,-2,47419,21260,10
86788314078,86788314076,-2,900,2391,10
86789932213,86789932213,0,1521,2451,10
86791921885,86791921882,-3,1060,2740,10
86793090327,86793090330,3,1229,1266,10
86793937380,86793937378,-2,2538,5516,10
86796836009,86796835992,-17,860,1218,10
86802479798,86802479795,-3,833,1716,10
86802599483,86802599479,-4,1290,1908,10
86804323578,86804323578,0,972,1890,10
86807364484,86807364482,-2,1021,1321,10
86808079225,86808079227,2,1752,2229,10
86808824639,86808824638,-1,1394,2654,10
86808923894,86808923899,5,2942,1578,10
86809547182,86809547181,-1,964,1835,10
86816487764,86816487763,-1,1758,1957,10
86818463253,86818463252,-1,1509,1403,10
86819644658,86819644656,-2,1758,1967,10
86827996522,86827996522,0,1087,1356,10
86833023170,86833023175,5,2226,1803,10
86836847617,86836847615,-2,891,2141,10
86841803174,86841803178,4,37876,30650,10
86843909008,86843909005,-3,798,1754,10
86844207763,86844207764,1,1408,2266,10
86845739538,86845739538,0,1171,2339,10
86847565054,86847565053,-1,1478,2770,10
86848463527,86848463531,4,1279,1562,10
86848865163,86848865162,-1,987,1386,10
86849957708,86849957706,-2,1686,2545,10
86852303621,86852303618,-3,1373,2471,10
86855249978,86855249979,1,1576,1991,10
86858875705,86858875705,0,1225,1643,10
86859871947,86859871947,0,1095,1789,10
86861525419,86861525418,-1,1174,1296,10
86861758624,86861758631,7,4604,1956,10
86863508099,86863508098,-1,1297,1965,10
86865004698,86865004697,-1,821,1584,10
86865742351,86865742349,-2,1040,2064,10
86867861045,86867861042,-3,1119,2861,10
86872713035,86872713035,0,832,1021,10
86874566144,86874566166,22,202,1674,10
86874649850,86874649842,-8,242,838,10
86883729361,86883729360,-1,1555,2089,10
86884547301,86884547303,2,1727,1555,10
86884698151,86884698150,-1,1141,2674,10
86886516172,86886516171,-1,985,2533,10
86886655662,86886655662,0,1116,1512,10
86888689025,86888689024,-1,932,1504,10
86889379109,86889379106,-3,893,1982,10
86890426925,86890426923,-2,1613,1463,10
86894112843,86894112840,-3,1738,2129,10
86899859553,86899859551,-2,1531,1611,10
86900057835,86900057833,-2,1189,1670,10
86903743601,86903743597,-4,1131,3413,10
86910524730,86910524727,-3,1592,2341,10
86915819050,86915819050,0,682,1362,10
86917350377,86917350375,-2,1027,1873,10
86918868451,86918868451,0,1093,1488,10
86919491079,86919491073,-6,1071,3305,10
86923171294,86923171289,-5,1023,4049,10
86923406368,86923406349,-19,1037,1591,10
86925856597,86925856597,0,1397,2129,10
86929164981,86929164979,-2,1845,2489,10
86929441851,86929441854,3,2032,1686,10
86933119837,86933119833,-4,1439,2432,10
86933242782,86933242783,1,1438,1746,10
86938072333,86938072332,-1,1214,2710,10
86941840237,86941840230,-7,977,4433,10
86946155729,86946155731,2,1155,1572,10
86949740761,86949740759,-2,1176,1583,10
86953954997,86953954997,0,1263,1957,10
86954121024,86954121021,-3,1656,1357,10
86956294739,86956294737,-2,1215,2032,10
86957209462,86957209460,-2,1224,1919,10
86959093779,86959093777,-2,1182,2515,10
86967453127,86967453126,-1,753,1875,10
86967835487,86967835486,-1,1206,2331,10
86972180241,86972180242,1,1660,2201,10
86988733139,86988733135,-4,1443,2759,10
86991207037,86991207034,-3,1050,2466,10
86992465339,86992465338,-1,1409,2939,10
87003712187,87003712184,-3,35360,27564,10
87010583297,87010583294,-3,1596,2801,10
87016047719,87016047715,-4,1346,1851,10
87016277135,87016277132,-3,1275,2873,10
87022871130,87022871130,0,1717,1746,10
87027538643,87027538643,0,1093,1969,10
87031559614,87031559613,-1,1182,1380,10
87036415450,87036415445,-5,1341,1614,10
87037893125,87037893123,-2,1079,2081,10
87040333274,87040333274,0,906,1548,10
87043064890,87043064888,-2,1171,2095,10
87045756072,87045756065,-7,950,3981,10
87048476256,87048476253,-3,974,961,10
87048922686,87048922685,-1,1473,1933,10
87049407925,87049407925,0,592,1281,10
87051777857,87051777853,-4,1398,2769,10
87057618113,87057618110,-3,1350,1842,10
87058223078,87058223078,0,1023,1277,10
87060020919,87060020922,3,1994,1711,10
87060327962,87060327962,0,991,1385,10
87060659947,87060659946,-1,1097,1564,10
87062042566,87062042565,-1,1708,2197,10
87062258286,87062258285,-1,1173,1485,10
87062408979,87062408963,-16,882,1466,10
87062551324,87062551341,17,743,1686,10
87062689276,87062689274,-2,1089,1424,10
87068532122,87068532116,-6,901,3202,10
87070422175,87070422175,0,985,1682,10
87071317946,87071317946,0,1574,1256,10
87071778044,87071778044,0,1801,1740,10
87071900770,87071900766,-4,1369,1941,10
87073485486,87073485482,-4,998,1747,10
87073616802,87073616802,0,1206,1714,10
87074718455,87074718453,-2,1046,1825,10
87077572611,87077572610,-1,1074,2051,10
87079535894,87079535894,0,700,1466,10
87082181338,87082181337,-1,1297,2085,10
87082688515,87082688512,-3,1262,2160,10
87083488109,87083488115,6,2188,1296,10
87084022655,87084022654,-1,985,1552,10
87084603192,87084603197,5,2334,1258,10
87086852717,87086852716,-1,1347,2255,10
87088692542,87088692537,-5,1176,2029,10
87093458805,87093458810,5,2199,1230,10
87096330254,87096330253,-1,1111,2112,10
87102306933,87102306931,-2,1225,2081,10
87104925395,87104925394,-1,1105,1825,10
87105358067,87105358066,-1,1387,2355,10
87109575639,87109575637,-2,797,1514,10
87110565569,87110565565,-4,1004,3518,10
87111248331,87111248330,-1,1368,2082,10
87114167845,87114167845,0,1303,2045,10
87117687493,87117687493,0,1357,1207,10
87121046023,87121046022,-1,1202,1754,10
87131386327,87131386326,-1,1051,2498,10
87132782197,87132782197,0,1393,3082,10
87134436236,87134436234,-2,1228,3092,10
87135112772,87135112765,-7,2233,8585,10
87136842029,87136842031,2,1290,976,10
87137216509,87137216508,-1,1175,1738,10
87138757302,87138757310,8,3749,1467,10
87139500252,87139500252,0,1380,1300,10
87141579567,87141579565,-2,1161,1542,10
87142158683,87142158681,-2,1338,2083,10
87144525334,87144525332,-2,1336,1764,10
87146776515,87146776515,0,1665,2692,10
87148831417,87148831417,0,1220,2107,10
87149770959,87149770958,-1,1354,1453,10
87150349630,87150349638,8,11517,34440,10
87151576390,87151576387,-3,862,1421,10
87152591386,87152591386,0,949,1846,10
87158348818,87158348817,-1,1492,2266,10
87161271559,87161271562,3,1291,1927,10
87166204962,87166204959,-3,1928,2869,10
87167877742,87167877759,17,800,2251,10
87168479663,87168479660,-3,864,1730,10
87169383674,87169383694,20,590,2193,10
87169463354,87169463353,-1,1847,3157,10
87170429939,87170429944,5,1523,1022,10
87172350014,87172350000,-14,936,1768,10
87173466850,87173466849,-1,1282,1894,10
87176023203,87176023203,0,1044,2343,10
87176303270,87176303270,0,1580,3028,10
87177499486,87177499489,3,3917,3489,10
87178158550,87178158550,0,785,1186,10
87188945323,87188945321,-2,1435,1783,10
87193388142,87193388140,-2,1410,2956,10
87201164187,87201164186,-1,1029,1565,10
87201344270,87201344275,5,568,861,10
87201949051,87201949050,-1,1402,2094,10
87206262978,87206262978,0,1031,2041,10
87207450327,87207450325,-2,997,1347,10
87210669114,87210669112,-2,916,2509,10
87212197953,87212197954,1,1704,1748,10
87221960794,87221960795,1,1627,1388,10
87225921327,87225921327,0,1367,1920,10
87225983891,87225983890,-1,1329,2010,10
87226866898,87226866895,-3,1476,2358,10
87228275615,87228275617,2,668,752,10
87229763533,87229763531,-2,1036,1889,10
87231040295,87231040293,-2,1109,2140,10
87232447282,87232447282,0,860,1945,10
87235653771,87235653780,9,2433,1512,10
87238018570,87238018569,-1,1142,2718,10
87240136397,87240136396,-1,1560,2812,10
87241585273,87241585272,-1,1606,2578,10
87244691207,87244691206,-1,912,1464,10
87248756961,87248756962,1,1213,1599,10
87248919906,87248919903,-3,1056,1736,10
87249101611,87249101627,16,374,1400,10
87252892186,87252892186,0,1218,957,10
87253736429,87253736428,-1,1187,1184,10
87255050698,87255050682,-16,717,1903,10
87261693391,87261693389,-2,947,2173,10
87264524037,87264524037,0,1357,1773,10
87265276665,87265276663,-2,905,1294,10
87268421775,87268421774,-1,1143,1468,10
87278128893,87278128894,1,1296,1911,10
87279685210,87279685210,0,1390,1285,10
87281576127,87281576126,-1,820,1869,10
87284703075,87284703075,0,1172,1609,10
87286184708,87286184707,-1,1653,3138,10
87287815809,87287815806,-3,1606,2908,10
87292471146,87292471143,-3,1035,1529,10
87295676555,87295676549,-6,1420,2209,10
87297374204,87297374203,-1,1112,2178,10
87302441693,87302441690,-3,996,1944,10
87303372560,87303372558,-2,1552,2288,10
87304464580,87304464586,6,2678,1269,10
87305399854,87305399850,-4,1062,1741,10
87308922445,87308922442,-3,826,1831,10
87310662534,87310662535,1,1055,1493,10
87312948439,87312948438,-1,1018,1518,10
87316826414,87316826414,0,877,1818,10
87316876930,87316876929,-1,1496,2037,10
87317915314,87317915314,0,948,1562,10
87318000454,87318000450,-4,1025,1362,10
87319608721,87319608719,-2,1056,1507,10
87321694662,87321694662,0,2327,2462,10
87323768671,87323768678,7,2173,1034,10
87324840783,87324840782,-1,1026,2313,10
87326905365,87326905364,-1,1522,2644,10
87329943614,87329943613,-1,1203,1950,10
87331940733,87331940746,13,11004,48808,10
87338799760,87338799757,-3,1419,2097,10
87340465564,87340465562,-2,1589,1640,10
87342211003,87342211002,-1,1544,1606,10
87344724783,87344724783,0,1150,1842,10
87344958610,87344958627,17,893,1876,10
87345424426,87345424425,-1,1106,1549,10
87345516547,87345516545,-2,1075,2786,10
87346181599,87346181597,-2,1176,1881,10
87347215808,87347215809,1,1256,1646,10
87347347853,87347347851,-2,1328,2332,10
87350098451,87350098451,0,825,1044,10
87356182987,87356182988,1,1126,1374,10
87356841969,87356841966,-3,1091,2462,10
87356869353,87356869352,-1,1053,1811,10
87357285238,87357285233,-5,1088,1177,10
87358440072,87358440071,-1,1063,1980,10
87361379701,87361379698,-3,1136,1865,10
87361546053,87361546053,0,1145,1106,10
87362401041,87362401034,-7,1245,6705,10
87362692345,87362692346,1,523,1151,10
87364649454,87364649459,5,1471,1225,10
87365850133,87365850129,-4,4497,12400,10
87368673463,87368673463,0,1476,1829,10
87368747098,87368747095,-3,1437,2257,10
87373242090,87373242090,0,1482,1844,10
87374487945,87374487943,-2,1102,2155,10
87374773561,87374773579,18,1023,2397,10
87376039171,87376039169,-2,1132,1827,10
87378359966,87378359965,-1,994,1873,10
87386231493,87386231492,-1,837,2078,10
87387168753,87387168750,-3,1099,2198,10
87388999757,87388999755,-2,1292,2243,10
87391629109,87391629107,-2,1177,1793,10
87392250803,87392250796,-7,1339,4608,10
87394513001,87394512999,-2,1609,2259,10
87394738623,87394738623,0,1725,2373,10
87396796862,87396796862,0,1474,2147,10
87398764693,87398764690,-3,1113,1914,10
87401687738,87401687737,-1,1747,1444,10
87406751922,87406751918,-4,1227,1931,10
87408799926,87408799922,-4,21215,15362,10
87423548607,87423548605,-2,1203,2186,10
87424435476,87424435479,3,1077,1115,10
87427610986,87427610985,-1,790,1838,10
87428192068,87428192066,-2,1191,2498,10
87429267918,87429267915,-3,1080,1942,10
87430289053,87430289052,-1,1199,1943,10
87438569794,87438569790,-4,1206,2044,10
87440665597,87440665598,1,1555,941,10
87441048726,87441048706,-20,2174,1520,10
87441973894,87441973891,-3,1306,1733,10
87442408809,87442408807,-2,1455,2389,10
87442898436,87442898426,-10,1453,1964,10
87446697962,87446697961,-1,808,1530,10
87447535010,87447535007,-3,810,1307,10
87452964227,87452964228,1,1273,1783,10
87453423369,87453423367,-2,1110,1859,10
87457509094,87457509092,-2,1361,2225,10
87459909138,87459909138,0,1503,897,10
87463050405,87463050404,-1,1331,1906,10
87463557235,87463557233,-2,972,3037,10
87464852743,87464852745,2,1540,2232,10
87467809453,87467809458,5,3892,1483,10
87469729862,87469729859,-3,2326,3558,10
87473277158,87473277154,-4,971,1932,10
87477541816,87477541815,-1,1004,2401,10
87477627283,87477627266,-17,1009,1180,10
87482216641,87482216639,-2,1160,1862,10
87488509573,87488509574,1,3085,3713,10
87490642078,87490642077,-1,1157,1583,10
87494733449,87494733448,-1,1596,1969,10
87497342415,87497342414,-1,1656,1605,10
87498076119,87498076121,2,833,2201,10
87498769249,87498769249,0,1258,1791,10
87498993542,87498993542,0,1713,2119,10
87499801856,87499801856,0,1526,2304,10
87501574469,87501574472,3,2062,2019,10
87502598011,87502598009,-2,1327,1593,10
87503469671,87503469669,-2,836,1491,10
87505744264,87505744263,-1,1561,1994,10
87507041302,87507041299,-3,1717,2861,10
87508286077,87508286082,5,2575,997,10
87509643210,87509643210,0,1378,2352,10
87510859650,87510859647,-3,598,1298,10
87513819647,87513819645,-2,838,2789,10
87516932619,87516932619,0,756,1635,10
87518505903,87518505901,-2,1214,1183,10
87519288138,87519288137,-1,1187,2078,10
87523680429,87523680426,-3,930,1427,10
87535586054,87535586053,-1,1275,2345,10
87536317619,87536317615,-4,857,2331,10
87536565386,87536565384,-2,1280,1834,10
87540657422,87540657422,0,639,1482,10
87543203379,87543203377,-2,1288,1833,10
87544770673,87544770675,2,1684,2314,10
87545496607,87545496586,-21,940,1288,10
87547758321,87547758325,4,1607,1065,10
87547967675,87547967666,-9,679,1651,10
87556022528,87556022526,-2,1039,2292,10
87556574603,87556574595,-8,686,971,10
87559668436,87559668435,-1,1657,1907,10
87560218012,87560218010,-2,1339,2165,10
87560477302,87560477301,-1,1810,2620,10
87563138104,87563138102,-2,1547,2462,10
87566145630,87566145630,0,1126,1868,10
87566896675,87566896669,-6,1922,7796,10
87567063539,87567063539,0,1448,2463,10
87568252949,87568252949,0,1182,1586,10
87569350059,87569350058,-1,1720,2252,10
87570334956,87570334955,-1,1384,2399,10
87570493273,87570493271,-2,996,2062,10
87573659026,87573659022,-4,983,2700,10
87575459627,87575459617,-10,102,512,10
87576102940,87576102936,-4,999,2011,10
87578305935,87578305933,-2,963,1873,10
87578614307,87578614307,0,896,1885,10
87580204301,87580204298,-3,820,1538,10
87580874466,87580874473,7,6072,2583,10
87585243398,87585243401,3,3396,2070,10
87586820379,87586820383,4,1863,1945,10
87586846683,87586846681,-2,1318,3014,10
87587969205,87587969222,17,1132,1679,10
87592923779,87592923779,0,1294,1713,10
87594962016,87594962014,-2,1071,1378,10
87595393707,87595393706,-1,686,1194,10
87598393182,87598393182,0,1043,2038,10
87598624848,87598624842,-6,1390,2634,10
87600020630,87600020630,0,1122,1758,10
87603688209,87603688208,-1,1149,1671,10
87609644874,87609644871,-3,1334,1305,10
87610066122,87610066121,-1,1275,2412,10
87615997502,87615997496,-6,1616,7606,10
87617336121,87617336114,-7,964,3355,10
87618675278,87618675278,0,1182,2095,10
87619037397,87619037397,0,1227,1376,10
87632749769,87632749766,-3,1433,1867,10
87633802313,87633802311,-2,1745,2253,10
87637153758,87637153759,1,786,1232,10
87638550253,87638550254,1,924,1193,10
87641672038,87641672038,0,1154,2069,10
87642108667,87642108666,-1,1154,1110,10
87643107889,87643107888,-1,1054,1373,10
87644608250,87644608251,1,1833,2508,10
87644889603,87644889602,-1,2326,2426,10
87645095225,87645095224,-1,1190,2703,10
87645615281,87645615300,19,957,1918,10
87645846371,87645846369,-2,597,1539,10
87647596705,87647596705,0,1313,1725,10
87650392652,87650392650,-2,1868,1805,10
87654121534,87654121532,-2,1152,1771,10
87655267997,87655267995,-2,991,2699,10
87657929787,87657929785,-2,847,1669,10
87661594164,87661594171,7,3742,1656,10
87671243026,87671243015,-11,2862,20685,10
87672005603,87672005599,-4,941,2623,10
87672883553,87672883550,-3,1616,3207,10
87672939614,87672939614,0,1392,2020,10
87674348645,87674348644,-1,1215,1500,10
87676475186,87676475183,-3,1102,1843,10
87677367452,87677367458,6,3368,1699,10
87678662131,87678662130,-1,1093,2032,10
87682485138,87682485136,-2,1746,2269,10
87684258203,87684258201,-2,1510,2313,10
87686712145,87686712142,-3,1194,2261,10
87687975319,87687975318,-1,1192,1707,10
87689972326,87689972325,-1,841,1510,10
87693615752,87693615751,-1,935,1826,10
87696952323,87696952322,-1,1250,2101,10
87699630713,87699630714,1,551,1791,10
87699880874,87699880873,-1,1372,2160,10
87700021721,87700021719,-2,1138,2169,10
87703083089,87703083087,-2,934,2015,10
87706936591,87706936589,-2,671,1515,10
87707659896,87707659894,-2,1274,1691,10
87709016962,87709016961,-1,1078,2100,10
87709172314,87709172314,0,1445,2802,10
87712600699,87712600699,0,1624,3192,10
87719319686,87719319682,-4,930,2381,10
87719568598,87719568596,-2,1305,2845,10
87726356355,87726356354,-1,1243,2839,10
87726582181,87726582181,0,1356,2725,10
87732081637,87732081635,-2,869,2094,10
87735738734,87735738732,-2,806,1743,10
87737304895,87737304894,-1,979,1947,10
87739086094,87739086092,-2,1035,1707,10
87740264183,87740264187,4,1667,1997,10
87747535174,87747535170,-4,1112,1638,10
87751679718,87751679714,-4,1488,2177,10
87751944118,87751944117,-1,716,1324,10
87753798132,87753798129,-3,1382,2788,10
87766995367,87766995367,0,1437,2361,10
87768797319,87768797325,6,1177,1725,10
87773226726,87773226732,6,833,1287,10
87780878287,87780878285,-2,854,2412,10
87786478051,87786478049,-2,898,1425,10
87788397026,87788397025,-1,1142,1721,10
87790845789,87790845788,-1,677,1968,10
87791651270,87791651270,0,1084,1788,10
87796721027,87796721024,-3,1170,1585,10
87800236262,87800236262,0,1870,16240,10
87802722924,87802722925,1,1211,1305,10
87804974635,87804974633,-2,1650,2747,10
87806407607,87806407606,-1,937,1442,10
87807093043,87807093034,-9,1289,1859,10
87808733477,87808733475,-2,1464,2382,10
87810892250,87810892247,-3,1796,2598,10
87814283937,87814283937,0,1050,1811,10
87825946723,87825946722,-1,826,1197,10
87828232607,87828232605,-2,1076,1611,10
87828480523,87828480512,-11,1464,1912,10
87831883501,87831883502,1,1449,1092,10
87833880351,87833880351,0,1528,2234,10
87835961786,87835961783,-3,1537,2194,10
87838571407,87838571404,-3,1811,5792,10
87838720834,87838720849,15,1293,948,10
87840291706,87840291705,-1,843,2231,10
87840385809,87840385811,2,1583,1780,10
87841092517,87841092516,-1,725,1736,10
87841432745,87841432745,0,1217,1469,10
87849148970,87849148969,-1,1307,2048,10
87852584853,87852584853,0,1072,1934,10
87853225798,87853225790,-8,1818,6479,10
87853741445,87853741444,-1,795,1717,10
87854203586,87854203586,0,1172,1963,10
87854883174,87854883172,-2,1259,1505,10
87857109085,87857109082,-3,1343,2220,10
87858543818,87858543814,-4,1304,2155,10
87859149435,87859149433,-2,913,2017,10
87860685694,87860685692,-2,1057,2035,10
87863490327,87863490326,-1,965,1749,10
87865729510,87865729506,-4,1044,1947,10
87874368942,87874368939,-3,1151,2175,10
87874907506,87874907505,-1,1295,1538,10
87878108910,87878108911,1,1060,2272,10
87878710289,87878710289,0,1143,1985,10
87883567525,87883567525,0,1306,1615,10
87885884767,87885884761,-6,852,1494,10
87890314072,87890314069,-3,1326,2259,10
87891106766,87891106766,0,1158,1863,10
87897114541,87897114538,-3,1918,3673,10
87898045334,87898045331,-3,1382,1811,10
87911199322,87911199320,-2,848,2321,10
87911810925,87911810923,-2,1441,2185,10
87915338402,87915338409,7,2079,1266,10
87915494581,87915494578,-3,910,1523,10
87918765144,87918765146,2,1433,1625,10
87923696942,87923696942,0,1093,2495,10
87924038262,87924038262,0,1047,1692,10
87930568338,87930568339,1,1265,1746,10
87931000333,87931000333,0,1317,2039,10
87932120930,87932120937,7,4577,2509,10
87932295199,87932295198,-1,1466,1710,10
87933716933,87933716939,6,2664,1076,10
87934391205,87934391205,0,1380,1786,10
87937578822,87937578821,-1,1557,1589,10
87939874711,87939874709,-2,1223,1959,10
87941645344,87941645341,-3,1479,2485,10
87948044301,87948044298,-3,1285,2661,10
87949808694,87949808692,-2,997,1802,10
87954587389,87954587387,-2,1955,2698,10
87955759688,87955759687,-1,1957,2499,10
87959822105,87959822104,-1,978,2007,10
87960206678,87960206675,-3,1172,1842,10
87964966582,87964966581,-1,1394,1977,10
87966020667,87966020665,-2,976,1810,10
87971452283,87971452287,4,2827,1594,10
87971767357,87971767357,0,1423,2239,10
87972176758,87972176758,0,1599,1864,10
87975051605,87975051604,-1,1184,1963,10
87976465110,87976465109,-1,1291,1887,10
87976668286,87976668289,3,6610,7120,10
87977421866,87977421865,-1,1963,2746,10
87981314933,87981314931,-2,1109,1880,10
87981765710,87981765708,-2,1559,1766,10
87982819604,87982819602,-2,1402,2172,10
87985346737,87985346734,-3,1671,2225,10
87987668735,87987668733,-2,1276,1675,10
87989354697,87989354695,-2,898,1119,10
87995303977,87995303975,-2,2028,2714,10
87995402011,87995402009,-2,1497,2888,10
88000380610,88000380610,0,1348,1651,10
88002656370,88002656370,0,1211,1571,10
88003716595,88003716590,-5,1206,2905,10
88008223882,88008223881,-1,1256,1451,10
88009030511,88009030511,0,1313,1913,10
88009488938,88009488936,-2,986,1529,10
88016406417,88016406415,-2,1252,1706,10
88016945969,88016945967,-2,1093,1556,10
88017446017,88017446015,-2,1484,1895,10
88019721262,88019721262,0,1218,2260,10
88027370196,88027370194,-2,863,1535,10
88029332181,88029332182,1,2033,2239,10
88033533034,88033533022,-12,1323,2090,10
88035502365,88035502362,-3,892,1186,10
88039448479,88039448478,-1,1175,2063,10
88040913887,88040913883,-4,806,1293,10
88044666898,88044666898,0,1141,1915,10
88048980532,88048980535,3,1559,1541,10
88054928039,88054928037,-2,1541,1534,10
88061427649,88061427651,2,1194,1778,10
88061989394,88061989384,-10,1163,2362,10
88062260233,88062260218,-15,1373,2030,10
88065873401,88065873397,-4,1016,2067,10
88067469521,88067469521,0,924,2257,10
88068383706,88068383727,21,892,1797,10
88070823234,88070823231,-3,1676,2521,10
88075427983,88075427982,-1,1488,2083,10
88078141811,88078141811,0,1214,1995,10
88081940070,88081940067,-3,907,1578,10
88083021365,88083021365,0,1300,2509,10
88085312994,88085312991,-3,810,1679,10
88086470239,88086470239,0,989,1887,10
88090369330,88090369329,-1,864,2045,10
88097187001,88097187001,0,1335,1753,10
88098531085,88098531078,-7,864,5764,10
88098690265,88098690263,-2,1286,1665,10
88100497207,88100497213,6,2676,1381,10
88101349435,88101349433,-2,946,2248,10
88103931838,88103931836,-2,996,1744,10
88107591950,88107591946,-4,1183,3540,10
88109708599,88109708599,0,971,1950,10
88110414690,88110414689,-1,834,1931,10
88110618148,88110618146,-2,857,2443,10
88110936607,88110936623,16,24701,59740,10
88111171931,88111171928,-3,1020,1466,10
88113887775,88113887772,-3,830,1312,10
88115826763,88115826762,-1,1200,1600,10
88117574937,88117574938,1,1371,2210,10
88120784723,88120784721,-2,821,1587,10
88121056348,88121056347,-1,1074,1631,10
88122682222,88122682217,-5,21597,12779,10
88125204183,88125204183,0,1493,1863,10
88125768447,88125768432,-15,440,230,10
88127648879,88127648879,0,1057,1402,10
88130758027,88130758026,-1,1024,1784,10
88131437199,88131437199,0,1199,2247,10
88132517770,88132517770,0,1461,1380,10
88141643523,88141643521,-2,1225,2004,10
88147738851,88147738850,-1,1351,1704,10
88148518371,88148518369,-2,1370,2301,10
88148856796,88148856801,5,2346,1160,10
88148942877,88148942877,0,1351,1995,10
88149720730,88149720726,-4,1099,2525,10
88150343511,88150343510,-1,1178,2297,10
88156185457,88156185456,-1,1479,2558,10
88158537071,88158537071,0,1431,1762,10
88161636533,88161636539,6,2991,1202,10
88163672402,88163672398,-4,442,2287,10
88164575379,88164575377,-2,1369,2215,10
88177856198,88177856193,-5,1492,3998,10
88179226405,88179226403,-2,2304,3232,10
88181259801,88181259798,-3,899,1296,10
88182602535,88182602536,1,1467,1269,10
88184048122,88184048121,-1,853,1595,10
88187942993,88187942986,-7,890,3133,10
88188056122,88188056121,-1,766,1811,10
88188395378,88188395373,-5,1714,5010,10
88189507980,88189507979,-1,1624,2715,10
88191459959,88191459963,4,1476,1444,10
88191621014,88191621014,0,1515,2401,10
88194943165,88194943163,-2,821,1300,10
88197714230,88197714233,3,2696,2349,10
88198322305,88198322298,-7,1609,6782,10
88199546507,88199546507,0,1381,1544,10
88201059266,88201059262,-4,2167,4746,10
88201734436,88201734436,0,898,1332,10
88204231887,88204231886,-1,1025,1008,10
88204511978,88204511974,-4,1689,2821,10
88205762688,88205762686,-2,893,1837,10
88208079954,88208079952,-2,1679,2558,10
88211391194,88211391194,0,1615,2011,10
88215844123,88215844121,-2,944,2016,10
88217132123,88217132119,-4,1440,2313,10
88217919042,88217919051,9,9168,2418,10
88224006349,88224006350,1,1842,2063,10
88224089988,88224090004,16,656,1579,10
88227518362,88227518360,-2,1031,1972,10
88228383830,88228383829,-1,1056,1722,10
88231335771,88231335770,-1,734,1366,10
88231693685,88231693686,1,926,865,10
88232258736,88232258739,3,1729,1142,10
88233992402,88233992410,8,3825,1463,10
88234103074,88234103074,0,1224,1804,10
88234403272,88234403271,-1,1153,1349,10
88239719382,88239719378,-4,2665,6432,10
88240987660,88240987662,2,1332,1535,10
88241837439,88241837437,-2,1040,1705,10
88243457803,88243457801,-2,1452,2239,10
88244357833,88244357832,-1,1116,2104,10
88245959371,88245959369,-2,748,1346,10
88249079814,88249079813,-1,1126,1864,10
88251037035,88251037041,6,2262,1024,10
88251997422,88251997425,3,2150,2060,10
88255707707,88255707705,-2,1109,1543,10
88256583727,88256583724,-3,936,2203,10
88256899878,88256899878,0,1077,1431,10
88257576045,88257576041,-4,1176,2182,10
88268099593,88268099594,1,1011,2011,10
88268602975,88268602974,-1,1047,1063,10
88268952938,88268952938,0,1321,2214,10
88275251331,88275251334,3,994,1684,10
88281947553,88281947551,-2,741,987,10
88285057242,88285057239,-3,944,1946,10
88285768034,88285768033,-1,1350,1928,10
88292424708,88292424706,-2,1586,2840,10
88297168928,88297168925,-3,1597,2387,10
88299412748,88299412746,-2,1049,1762,10
88301990556,88301990556,0,1426,1583,10
88302246991,88302246991,0,1231,1972,10
88302835320,88302835319,-1,765,828,10
88305204754,88305204754,0,951,1568,10
88306803509,88306803510,1,1164,1486,10
88311107003,88311107002,-1,1740,2399,10
88316922385,88316922377,-8,36397,12030,10
88322668302,88322668302,0,1012,2220,10
88324275687,88324275683,-4,21572,9386,10
88326101970,88326101969,-1,1267,1994,10
88328038103,88328038102,-1,924,1378,10
88331811958,88331811957,-1,1251,1664,10
88332361858,88332361856,-2,1666,1967,10
88333951671,88333951670,-1,1230,2394,10
88334206079,88334206076,-3,1348,2340,10
88334667178,88334667177,-1,1169,2220,10
88335016071,88335016070,-1,1903,2726,10
88340547997,88340547996,-1,1180,1593,10
88344088823,88344088822,-1,661,1448,10
88346602460,88346602460,0,1168,2232,10
88348155379,88348155377,-2,1144,1270,10
88351717671,88351717671,0,1375,1780,10
88354602117,88354602114,-3,993,1997,10
88355988591,88355988589,-2,1174,2223,10
88356140865,88356140885,20,849,1516,10
88356464707,88356464702,-5,924,2421,10
88362261263,88362261272,9,1878,1024,10
88364068353,88364068353,0,1222,1122,10
88365990559,88365990556,-3,873,1491,10
88370514222,88370514222,0,1374,2350,10
88371206738,88371206737,-1,994,2516,10
88374588249,88374588245,-4,1264,1724,10
88380869143,88380869141,-2,1112,2295,10
88389314674,88389314669,-5,812,2587,10
88393521040,88393521040,0,1284,1481,10
88394322725,88394322724,-1,1037,1963,10
88400156082,88400156081,-1,1237,2157,10
88401321638,88401321638,0,1295,1859,10
88402201783,88402201782,-1,1074,2458,10
88414126598,88414126596,-2,1531,2357,10
88417186103,88417186099,-4,1128,2419,10
88418596055,88418596053,-2,962,1818,10
88419723674,88419723675,1,2103,2238,10
88420651109,88420651106,-3,1063,1985,10
88422157577,88422157575,-2,1391,2311,10
88426127410,88426127419,9,3851,1466,10
88427684283,88427684276,-7,1081,2430,10
88428823889,88428823889,0,1338,1822,10
88429361435,88429361433,-2,959,1424,10
88437199549,88437199554,5,2281,1444,10
88437724873,88437724870,-3,866,1248,10
88438532901,88438532915,14,9477,42410,10
88443469673,88443469670,-3,1647,2128,10
88445015933,88445015930,-3,1443,2076,10
88447347855,88447347858,3,1137,948,10
88457928592,88457928590,-2,1196,2291,10
88460465133,88460465132,-1,1738,2077,10
88462285286,88462285286,0,1101,1647,10
88467627002,88467627001,-1,1721,2074,10
88469718023,88469718021,-2,1736,2239,10
88470001128,88470001126,-2,1570,1700,10
88470811512,88470811517,5,2600,1894,10
88472928190,88472928195,5,3230,1339,10
88473070912,88473070912,0,1569,1694,10
88476019571,88476019566,-5,1395,3644,10
88477519713,88477519709,-4,1392,2631,10
88480024954,88480024971,17,815,2587,10
88480618159,88480618158,-1,806,1365,10
88481890290,88481890290,0,945,2050,10
88483288442,88483288441,-1,1064,1962,10
88483933723,88483933720,-3,1107,1964,10
88485706938,88485706937,-1,1263,2385,10
88487853938,88487853937,-1,1368,1580,10
88497677225,88497677225,0,1149,1825,10
88498314075,88498314076,1,1330,1300,10
88498420960,88498420959,-1,1409,1979,10
88499041102,88499041084,-18,960,1378,10
88500016494,88500016491,-3,1284,1753,10
88504855238,88504855239,1,922,1115,10
88514357746,88514357745,-1,1267,1887,10
88515906243,88515906250,7,4969,2099,10
88517875982,88517875980,-2,1352,2018,10
88520185975,88520185974,-1,1056,1918,10
88521776618,88521776618,0,1485,2583,10
88525758821,88525758824,3,2039,1960,10
88528329489,88528329498,9,873,1584,10
88530364598,88530364597,-1,940,2090,10
88531773653,88531773659,6,3499,1279,10
88531900746,88531900743,-3,1227,2943,10
88534005740,88534005739,-1,1458,1950,10
88534690962,88534690961,-1,1239,1882,10
88535267030,88535267033,3,1584,1527,10
88543093083,88543093062,-21,1377,1632,10
88544635611,88544635612,1,1414,1685,10
88545008610,88545008609,-1,1017,1580,10
88547846918,88547846918,0,1746,1613,10
88549044332,88549044331,-1,1610,2624,10
88554895027,88554895025,-2,1487,1577,10
88558804516,88558804517,1,2217,1757,10
88564760071,88564760073,2,1466,1480,10
88566255324,88566255322,-2,1109,1455,10
88566849627,88566849627,0,1061,1547,10
88575096541,88575096541,0,785,2327,10
88576508254,88576508253,-1,1511,2192,10
88580514806,88580514803,-3,772,1982,10
88589469269,88589469270,1,1652,2083,10
88595989735,88595989735,0,1363,1846,10
88596182959,88596182958,-1,1188,1900,10
88598464946,88598464945,-1,1024,1937,10
88598614246,88598614242,-4,1448,1874,10
88605778525,88605778522,-3,1294,2060,10
88606835927,88606835926,-1,1135,2491,10
88608050218,88608050218,0,1516,1883,10
88608481094,88608481094,0,987,1291,10
88608680434,88608680434,0,938,1138,10
88610227549,88610227548,-1,1373,1896,10
88611584321,88611584321,0,1807,2005,10
88611936578,88611936576,-2,1268,2256,10
88613034348,88613034351,3,2347,1989,10
88613409468,88613409467,-1,1193,1897,10
88613851686,88613851687,1,718,2511,10
88614876711,88614876709,-2,1266,1873,10
88617338482,88617338484,2,1579,1189,10
88618326377,88618326364,-13,1114,1629,10
88618880529,88618880533,4,1609,1325,10
88619250466,88619250462,-4,1417,2444,10
88623823185,88623823184,-1,1122,1796,10
88624214047,88624214049,2,1207,1781,10
88626249141,88626249139,-2,3037,4859,10
88626943034,88626943033,-1,1052,1843,10
88630201853,88630201849,-4,1081,1446,10
88631320379,88631320376,-3,991,1957,10
88632297650,88632297650,0,1265,1906,10
88632514126,88632514126,0,1488,1979,10
88639647014,88639647013,-1,996,1776,10
88645292054,88645292050,-4,1350,2009,10
88649247371,88649247373,2,1345,1752,10
88650373292,88650373291,-1,1244,2536,10
88654698885,88654698886,1,1195,1182,10
88658186563,88658186557,-6,1139,4117,10
88659691769,88659691769,0,1178,1905,10
88660347579,88660347587,8,1681,1400,10
88664885246,88664885244,-2,1634,2302,10
88668486160,88668486158,-2,792,1204,10
88669579226,88669579226,0,1172,1839,10
88675746778,88675746777,-1,1425,2792,10
88677255119,88677255118,-1,762,1075,10
88679832595,88679832594,-1,1649,2347,10
88681619455,88681619451,-4,1507,2399,10
88689678660,88689678658,-2,1064,1802,10
88690343786,88690343790,4,1006,1162,10
88693443928,88693443925,-3,1212,1665,10
88694960156,88694960153,-3,1441,2656,10
88697810178,88697810177,-1,1028,2845,10
88700703521,88700703518,-3,2357,5219,10
88706981086,88706981090,4,311,981,10
88707362329,88707362324,-5,1257,1728,10
88708115642,88708115641,-1,1458,1721,10
88708491915,88708491914,-1,1386,1565,10
88709526097,88709526097,0,1346,1716,10
88710460093,88710460106,13,16126,5267,10
88711557947,88711557944,-3,1309,2657,10
88714202333,88714202333,0,1642,2325,10
88715410294,88715410293,-1,1599,2083,10
88718623094,88718623093,-1,1181,2065,10
88719743407,88719743411,4,2215,1569,10
88720181662,88720181654,-8,1638,8297,10
88723688746,88723688745,-1,1049,1781,10
88725857576,88725857574,-2,1513,2032,10
88727725970,88727725969,-1,1444,2368,10
88729593117,88729593115,-2,866,1339,10
88729839599,88729839598,-1,1243,1971,10
88732403972,88732403970,-2,1468,1886,10
88738018373,88738018369,-4,1153,3033,10
88738162776,88738162761,-15,976,1961,10
88743960801,88743960799,-2,1253,2664,10
88744147259,88744147267,8,365,822,10
88745778738,88745778738,0,1783,2775,10
88747284130,88747284113,-17,1084,375,10
88756305396,88756305395,-1,793,2051,10
88757395190,88757395187,-3,1069,2296,10
88758702072,88758702071,-1,1251,1905,10
88759849294,88759849306,12,15661,29163,10
88764446523,88764446522,-1,1232,2196,10
88767512706,88767512704,-2,1295,2956,10
88768396127,88768396125,-2,1260,2673,10
88768862861,88768862859,-2,977,1401,10
88779018281,88779018281,0,1219,1298,10
88780395936,88780395931,-5,1015,1739,10
88783451150,88783451149,-1,1648,2497,10
88790436280,88790436277,-3,1481,2090,10
88790936078,88790936078,0,1920,2373,10
88791316219,88791316217,-2,1411,2818,10
88792234980,88792234975,-5,2030,4419,10
88794436916,88794436916,0,1092,2326,10
88795205991,88795205989,-2,585,1767,10
88795777651,88795777650,-1,1316,2006,10
88796509725,88796509723,-2,973,2239,10
88800778023,88800778022,-1,589,1917,10
88800858011,88800858031,20,1232,1922,10
88805370545,88805370539,-6,968,4451,10
88806506671,88806506672,1,1544,2968,10
88808740174,88808740166,-8,1368,6293,10
88809920313,88809920313,0,1160,2208,10
88810073267,88810073266,-1,1634,2719,10
88814373147,88814373146,-1,688,1313,10
88819909297,88819909298,1,1647,1622,10
88833326993,88833326993,0,1290,1251,10
88833650152,88833650175,23,534,1276,10
88834471865,88834471870,5,2487,1608,10
88834866767,88834866765,-2,1285,2242,10
88838079854,88838079856,2,563,1097,10
88843875951,88843875950,-1,1090,1630,10
88844016033,88844016051,18,247,1718,10
88844635423,88844635422,-1,903,1696,10
88846043735,88846043742,7,1826,940,10
88850950018,88850950017,-1,992,885,10
88852228502,88852228501,-1,1575,1913,10
88852867246,88852867254,8,2530,979,10
88856104025,88856104023,-2,1753,2182,10
88856740490,88856740488,-2,939,1257,10
88860109892,88860109892,0,1938,2514,10
88866088811,88866088808,-3,896,1868,10
88866674252,88866674249,-3,963,1901,10
88873625741,88873625741,0,1283,1977,10
88876883565,88876883562,-3,929,1779,10
88877301383,88877301378,-5,1293,3853,10
88877695758,88877695754,-4,871,2298,10
88877950562,88877950549,-13,1219,1722,10
88878484443,88878484429,-14,266,1276,10
88887745743,88887745741,-2,1627,1464,10
88890962852,88890962850,-2,1308,2573,10
88891103608,88891103626,18,152,630,10
88892452591,88892452591,0,1313,2803,10
88893901894,88893901893,-1,1775,2773,10
88893946939,88893946937,-2,1030,1549,10
88894621316,88894621315,-1,1157,1546,10
88898168559,88898168559,0,1013,1311,10
88899223635,88899223633,-2,1184,3075,10
88901378005,88901378004,-1,1110,2274,10
88902570656,88902570655,-1,1234,1935,10
88902998946,88902998946,0,882,1533,10
88903303493,88903303495,2,968,2446,10
88903986717,88903986714,-3,986,2337,10
88907855255,88907855264,9,1105,1743,10
88909265926,88909265935,9,11165,25464,10
88909460345,88909460350,5,3540,1719,10
88914906651,88914906647,-4,1322,2058,10
88920502513,88920502517,4,2329,1468,10
88921140925,88921140939,14,1194,1433,10
88925055195,88925055195,0,1354,1155,10
88926207835,88926207836,1,1179,1689,10
88928927995,88928927995,0,1148,1507,10
88929774669,88929774666,-3,982,1590,10
88930221414,88930221414,0,1144,2101,10
88931269231,88931269230,-1,1260,1809,10
88931623387,88931623384,-3,1154,2318,10
88931805959,88931805960,1,1243,1452,10
88935526319,88935526318,-1,1028,2111,10
88936026742,88936026751,9,7331,30490,10
88939817621,88939817620,-1,1599,2721,10
88941613582,88941613581,-1,1177,1636,10
88942611372,88942611376,4,34746,98911,10
88946552554,88946552553,-1,1426,1920,10
88947729558,88947729550,-8,559,2188,10
88953379473,88953379472,-1,695,1556,10
88957234735,88957234730,-5,948,2749,10
88959342666,88959342667,1,1804,1287,10
88961040030,88961040030,0,973,2228,10
88966728022,88966728019,-3,1254,1459,10
88968870975,88968870973,-2,2419,5946,10
88972296606,88972296605,-1,1478,1968,10
88979124185,88979124184,-1,1453,2344,10
88981927130,88981927127,-3,1214,2312,10
88985641506,88985641505,-1,1355,2499,10
88988304341,88988304339,-2,1394,2271,10
88989436595,88989436595,0,1158,1381,10
88989680222,88989680222,0,1414,1762,10
88989997138,88989997158,20,444,1143,10
88990311062,88990311059,-3,1032,1853,10
88994147571,88994147570,-1,793,2148,10
89001855373,89001855371,-2,1508,2257,10
89006154939,89006154938,-1,1512,1221,10
89007366361,89007366342,-19,1378,2117,10
89008905838,89008905833,-5,1293,2789,10
89010790717,89010790714,-3,975,2043,10
89011894835,89011894815,-20,1046,1227,10
89014066440,89014066439,-1,1343,1629,10
89016185776,89016185775,-1,987,2100,10
89021624599,89021624599,0,1175,1940,10
89024053396,89024053387,-9,1023,2131,10
89026069602,89026069600,-2,1096,1542,10
89035426283,89035426281,-2,989,2219,10
89037437763,89037437764,1,1127,1432,10
89038632301,89038632299,-2,1074,1187,10
89038679042,89038679046,4,5656,23897,10
89042407096,89042407094,-2,1229,2474,10
89044909508,89044909508,0,1235,1712,10
89046822378,89046822377,-1,1252,1689,10
89050465676,89050465674,-2,1087,2300,10
89052288918,89052288917,-1,1094,1345,10
89052321579,89052321577,-2,868,1691,10
89054503310,89054503309,-1,1478,1628,10
89054858289,89054858288,-1,1280,2090,10
89056763697,89056763703,6,2754,1299,10
89056960475,89056960472,-3,997,1637,10
89057983369,89057983366,-3,1792,2462,10
89058256179,89058256169,-10,301,911,10
89064307706,89064307706,0,2095,2419,10
89066609205,89066609203,-2,1041,1387,10
89066795666,89066795665,-1,1091,2232,10
89073378593,89073378589,-4,1199,2769,10
89081896705,89081896703,-2,1313,2216,10
89083390649,89083390647,-2,1204,1622,10
89087745593,89087745594,1,1085,1963,10
89088800170,89088800170,0,2043,2513,10
89091037738,89091037738,0,1409,2098,10
89092376303,89092376307,4,3913,2988,10
89092542759,89092542757,-2,1293,2402,10
89102855088,89102855088,0,1337,2948,10
89106428986,89106428983,-3,1077,1943,10
89106985664,89106985647,-17,1289,2538,10
89109965862,89109965866,4,2169,1658,10
89112424695,89112424693,-2,958,1588,10
89115435594,89115435592,-2,1555,2554,10
89116555522,89116555529,7,2391,1199,10
89118277673,89118277671,-2,915,1230,10
89122301889,89122301887,-2,1088,2007,10
89127717221,89127717219,-2,1283,2469,10
89128236974,89128236979,5,3368,1036,10
89129290086,89129290085,-1,1286,1843,10
89131590765,89131590762,-3,842,1487,10
89134216738,89134216738,0,1079,1946,10
89134870953,89134870949,-4,20196,17449,10
89139139727,89139139725,-2,960,1752,10
89139272569,89139272569,0,1307,1777,10
89141421276,89141421277,1,1240,1553,10
89142259986,89142259984,-2,957,2046,10
89143810065,89143810065,0,1471,1855,10
89145577585,89145577582,-3,1092,1545,10
89146314159,89146314158,-1,1161,2430,10
89146354545,89146354544,-1,1434,2189,10
89150704543,89150704543,0,1208,2050,10
89151556941,89151556943,2,2184,1398,10
89156263525,89156263523,-2,1292,3221,10
89156905017,89156905035,18,1387,2581,10
89157833719,89157833717,-2,1424,1778,10
89160563658,89160563657,-1,1165,1972,10
89161689094,89161689093,-1,1080,1065,10
89161773403,89161773402,-1,921,1539,10
89164026387,89164026396,9,2313,1217,10
89165608733,89165608732,-1,1335,1445,10
89166071816,89166071815,-1,1156,1577,10
89171115842,89171115841,-1,1193,1565,10
89172988726,89172988726,0,1189,1300,10
89176413469,89176413476,7,3891,1592,10
89176864742,89176864741,-1,1232,1618,10
89180441176,89180441176,0,960,1282,10
89182737996,89182737995,-1,1486,1444,10
89185314445,89185314444,-1,675,1365,10
89185982358,89185982357,-1,738,1837,10
89186135606,89186135606,0,1444,2539,10
89186166231,89186166231,0,1104,2074,10
89187861122,89187861118,-4,1295,2089,10
89188303954,89188303953,-1,1081,1927,10
89190534373,89190534374,1,1311,2683,10
89192208624,89192208625,1,2007,1588,10
89192854010,89192854007,-3,893,1617,10
89192946676,89192946676,0,1396,1664,10
89196270295,89196270291,-4,1381,3111,10
89196866132,89196866131,-1,1307,1892,10
89198142682,89198142678,-4,1088,3022,10
89200686230,89200686236,6,11691,26491,10
89204109160,89204109154,-6,1070,2234,10
89205569551,89205569551,0,968,1663,10
89215553958,89215553956,-2,1415,2308,10
89224765572,89224765569,-3,967,2392,10
89227326101,89227326106,5,3251,1301,10
89227447738,89227447741,3,1554,1708,10
89230960400,89230960402,2,1625,1938,10
89239983130,89239983130,0,959,1881,10
89240581274,89240581273,-1,865,1375,10
89240731599,89240731597,-2,953,2478,10
89242702834,89242702830,-4,1206,1970,10
89257675575,89257675579,4,1500,1240,10
89258562602,89258562601,-1,834,1238,10
89258825862,89258825863,1,1514,1809,10
89260832721,89260832720,-1,1023,2936,10
89264512037,89264512036,-1,1677,2034,10
89264928169,89264928154,-15,226,1128,10
89265864262,89265864261,-1,1160,2080,10
89267859776,89267859775,-1,1170,1340,10
89269080429,89269080430,1,722,776,10
89269852219,89269852218,-1,1107,1557,10
89270499127,89270499126,-1,1180,2343,10
89270982525,89270982522,-3,1657,1297,10
89279418385,89279418392,7,16746,24001,10
89281374465,89281374465,0,1420,1790,10
89288287187,89288287186,-1,1364,2399,10
89291998830,89291998828,-2,2161,3119,10
89292771543,89292771542,-1,1688,1590,10
89296649288,89296649286,-2,1516,2450,10
89298579406,89298579402,-4,1480,2993,10
89300193110,89300193109,-1,1278,2019,10
89305706467,89305706465,-2,901,1268,10
89309910655,89309910655,0,1383,1810,10
89312030525,89312030522,-3,1676,2092,10
89312771647,89312771642,-5,1020,2893,10
89314865227,89314865226,-1,1299,2452,10
89317881858,89317881855,-3,1042,2099,10
89322794883,89322794879,-4,1428,2182,10
89323020251,89323020250,-1,1111,2043,10
89323932583,89323932582,-1,1318,1879,10
89326501367,89326501367,0,1102,1196,10
89326612752,89326612746,-6,1050,1946,10
89330141386,89330141389,3,1679,2443,10
89331075093,89331075091,-2,1124,1492,10
89332187154,89332187166,12,1657,1777,10
89334029383,89334029383,0,1615,1702,10
89335051904,89335051902,-2,906,1279,10
89337125306,89337125314,8,5546,1670,10
89341245802,89341245807,5,868,1617,10
89342008303,89342008301,-2,855,1635,10
89346725309,89346725310,1,1476,1758,10
89349130854,89349130853,-1,938,2282,10
89350291327,89350291326,-1,971,1759,10
89353958970,89353958964,-6,968,3851,10
89355723154,89355723153,-1,1110,1266,10
89358082495,89358082494,-1,903,1318,10
89368337048,89368337046,-2,1750,2498,10
89370450790,89370450792,2,1092,1629,10
89371134859,89371134858,-1,951,1716,10
89379610986,89379610985,-1,1066,2214,10
89381746122,89381746118,-4,902,2550,10
89385076873,89385076873,0,1383,2123,10
89387839590,89387839590,0,855,1561,10
89388812348,89388812346,-2,1238,1645,10
89391003548,89391003546,-2,1060,2801,10
89396304809,89396304821,12,609,1203,10
89396849572,89396849591,19,639,1766,10
89397267234,89397267234,0,1036,2623,10
89398415317,89398415314,-3,898,2339,10
89399520991,89399520986,-5,1105,1550,10
89399934026,89399934033,7,4242,1455,10
89403571195,89403571194,-1,1136,1899,10
89404847202,89404847202,0,1316,2614,10
89406627702,89406627699,-3,1040,1772,10
89406840702,89406840699,-3,940,1963,10
89407780071,89407780069,-2,1041,1100,10
89409219739,89409219736,-3,895,1635,10
89409487590,89409487590,0,1141,2030,10
89415964553,89415964551,-2,1305,2256,10
89418727673,89418727678,5,1265,1409,10
89419967362,89419967366,4,2338,1351,10
89420643230,89420643229,-1,1130,2208,10
89424301991,89424301989,-2,1445,2026,10
89431935738,89431935740,2,1635,1684,10
89433465694,89433465693,-1,1150,1980,10
89434426246,89434426245,-1,1057,2164,10
89435331557,89435331562,5,2199,1542,10
89440266133,89440266133,0,1053,2864,10
89442016194,89442016192,-2,1510,1872,10
89442210817,89442210815,-2,1844,2597,10
89444340206,89444340206,0,1286,1527,10
89446696701,89446696701,0,1229,1664,10
89446832945,89446832966,21,917,2049,10
89451576189,89451576183,-6,652,2609,10
89452339891,89452339878,-13,1170,2422,10
89461004963,89461004961,-2,1143,1919,10
89461328955,89461328954,-1,1086,2251,10
89462838430,89462838426,-4,951,1922,10
89465388389,89465388391,2,2056,1826,10
89468488268,89468488266,-2,1586,2294,10
89471239495,89471239493,-2,1317,1692,10
89473294718,89473294715,-3,1099,2123,10
89474506714,89474506711,-3,1129,2121,10
89474882378,89474882375,-3,1439,2204,10
89479369711,89479369709,-2,1199,1628,10
89490551431,89490551430,-1,1217,3081,10
89491555879,89491555881,2,1368,2306,10
89495413147,89495413146,-1,1226,2380,10
89500374642,89500374642,0,1513,2377,10
89500462267,89500462264,-3,1333,2097,10
89501417739,89501417737,-2,1449,2182,10
89504133605,89504133602,-3,1240,1755,10
89508032437,89508032434,-3,1280,2033,10
89513682657,89513682657,0,1227,2289,10
89517989918,89517989917,-1,1427,2042,10
89518367869,89518367869,0,1139,1440,10
89518833209,89518833206,-3,978,1989,10
89521338673,89521338669,-4,963,1828,10
89534178863,89534178862,-1,959,1499,10
89535313562,89535313561,-1,1023,2055,10
89535674810,89535674809,-1,927,1417,10
89536421547,89536421546,-1,1055,1679,10
89541099606,89541099608,2,1079,1841,10
89542609898,89542609898,0,1500,2321,10
89545195038,89545195037,-1,960,1596,10
89547351622,89547351621,-1,2006,3158,10
89552534675,89552534681,6,4719,2370,10
89558438730,89558438730,0,1187,1743,10
89560820015,89560820015,0,1409,1956,10
89561475972,89561475971,-1,955,1989,10
89567418762,89567418763,1,1528,1407,10
89569068345,89569068345,0,1413,1484,10
89569955911,89569955911,0,1503,1919,10
89577551011,89577551009,-2,771,1089,10
89579061799,89579061797,-2,853,1574,10
89579160714,89579160727,13,731,1184,10
89582754606,89582754605,-1,664,877,10
89584572466,89584572470,4,1742,1778,10
89588185139,89588185138,-1,992,1746,10
89593126648,89593126645,-3,1080,1981,10
89595576207,89595576206,-1,1281,1838,10
89597429331,89597429327,-4,1143,1758,10
89597955448,89597955446,-2,1361,1311,10
89598821651,89598821658,7,3611,1415,10
89606191786,89606191786,0,1025,1533,10
89606339731,89606339730,-1,1669,1953,10
89612466798,89612466795,-3,1258,2080,10
89614665366,89614665364,-2,1263,3160,10
89616825343,89616825342,-1,908,1825,10
89618608374,89618608374,0,1547,1864,10
89618702011,89618702010,-1,1153,1989,10
89626177050,89626177049,-1,1088,2087,10
89627486943,89627486943,0,1144,1642,10
89629089258,89629089263,5,3406,2300,10
89630432174,89630432174,0,991,2061,10
89632312254,89632312250,-4,711,2726,10
89632511808,89632511831,23,1050,2265,10
89637882648,89637882648,0,828,2257,10
89639093105,89639093102,-3,1017,2391,10
89645997631,89645997630,-1,1013,2146,10
89647163656,89647163653,-3,1289,2095,10
89648705561,89648705558,-3,798,2448,10
89651137052,89651137051,-1,1287,1579,10
89651665781,89651665778,-3,1693,2450,10
89654370922,89654370921,-1,1749,1875,10
89655262205,89655262205,0,2959,2992,10
89655525027,89655525025,-2,1231,2584,10
89656099679,89656099677,-2,915,2199,10
89656273905,89656273902,-3,1325,1550,10
89659666540,89659666543,3,18934,14702,10
89660604312,89660604306,-6,733,1703,10
89661440394,89661440381,-13,1186,2093,10
89664427505,89664427506,1,1591,1808,10
89667821553,89667821553,0,1648,2082,10
89667965990,89667965987,-3,1185,1795,10
89670592074,89670592072,-2,1103,1641,10
89671337716,89671337714,-2,1688,1923,10
89673326730,89673326730,0,985,1956,10
89673646316,89673646299,-17,765,1498,10
89674114003,89674114001,-2,1430,2424,10
89675515945,89675515943,-2,1455,1675,10
89675653500,89675653505,5,2797,1062,10
89677876442,89677876441,-1,1475,1885,10
89680043584,89680043582,-2,1248,1630,10
89682981116,89682981117,1,1228,1725,10
89685717358,89685717353,-5,749,1833,10
89692674288,89692674288,0,1126,1700,10
89694809343,89694809343,0,993,1594,10
89702564122,89702564122,0,1705,2004,10
89702913826,89702913844,18,1003,2076,10
89703349129,89703349124,-5,1027,2653,10
89706268298,89706268295,-3,1015,2151,10
89707008369,89707008366,-3,1337,3050,10
89708728430,89708728432,2,1368,2447,10
89708910198,89708910198,0,1851,1958,10
89711391970,89711391967,-3,1777,1958,10
89716531851,89716531849,-2,1454,2915,10
89716777506,89716777506,0,1596,1422,10
89717445065,89717445067,2,1593,2242,10
89722065250,89722065245,-5,1070,1442,10
89722489169,89722489168,-1,1500,2556,10
89724216966,89724216965,-1,1142,2968,10
89726757151,89726757150,-1,983,1650,10
89729199941,89729199942,1,1155,1541,10
89733538201,89733538203,2,1296,1750,10
89736150282,89736150282,0,1307,2079,10
89737650774,89737650771,-3,801,1253,10
89738363702,89738363701,-1,1393,1962,10
89738602446,89738602442,-4,919,2014,10
89748408512,89748408510,-2,1614,2271,10
89751162126,89751162125,-1,979,1753,10
89752239147,89752239146,-1,1099,2685,10
89761224776,89761224796,20,1089,2220,10
89762025024,89762025024,0,27660,37245,10
89764578338,89764578338,0,975,2058,10
89769565601,89769565594,-7,22321,14518,10
89771474152,89771474149,-3,926,1410,10
89772707039,89772707035,-4,926,2388,10
89773342576,89773342574,-2,1298,1737,10
89775051202,89775051200,-2,1006,2632,10
89777175170,89777175169,-1,1133,1699,10
89781467529,89781467525,-4,1215,2515,10
89783517509,89783517509,0,935,1749,10
89786199405,89786199402,-3,1220,1546,10
89791517205,89791517202,-3,1255,2445,10
89796953959,89796953958,-1,1180,2378,10
89798889934,89798889934,0,811,2202,10
89799408807,89799408806,-1,700,1518,10
89802188930,89802188929,-1,1178,1692,10
89805127032,89805127026,-6,3029,12229,10
89810067919,89810067920,1,924,1481,10
89811292434,89811292433,-1,621,1984,10
89811341563,89811341581,18,1279,2754,10
89814481163,89814481164,1,1105,2085,10
89815480594,89815480591,-3,769,1023,10
89816197451,89816197461,10,302,7963,10
89817849503,89817849501,-2,1161,1686,10
89818277646,89818277645,-1,1132,1999,10
89821012843,89821012838,-5,1230,4509,10
89823742674,89823742674,0,1742,1959,10
89824281972,89824281968,-4,1336,2611,10
89826246975,89826246970,-5,790,2792,10
89827111899,89827111898,-1,1000,1698,10
89829735206,89829735205,-1,1483,2141,10
89834574679,89834574678,-1,775,1515,10
89837038517,89837038514,-3,927,1590,10
89838191615,89838191615,0,1772,2539,10
89839145754,89839145751,-3,1124,1609,10
89845228408,89845228410,2,892,1729,10
89847914772,89847914770,-2,1578,2441,10
89848085402,89848085401,-1,1240,1852,10
89849229246,89849229246,0,1237,1660,10
89850444441,89850444439,-2,876,1691,10
89850686902,89850686901,-1,793,1600,10
89851354885,89851354881,-4,1351,2199,10
89851567897,89851567895,-2,819,1474,10
89852533249,89852533241,-8,1273,2020,10
89862414534,89862414532,-2,1345,1562,10
89864866749,89864866749,0,1306,2578,10
89865305239,89865305239,0,1146,1986,10
89869092755,89869092754,-1,1474,2192,10
89872147450,89872147447,-3,746,1735,10
89883347058,89883347058,0,1576,1453,10
89883746397,89883746395,-2,735,1613,10
89885224915,89885224914,-1,1130,1877,10
89890013528,89890013545,17,125,4578,10
89890934474,89890934470,-4,1180,3203,10
89892468258,89892468255,-3,1523,2421,10
89898349301,89898349303,2,898,1447,10
89903654509,89903654507,-2,1324,2511,10
89903702688,89903702692,4,11393,8012,10
89905013655,89905013654,-1,924,1927,10
89911463263,89911463260,-3,1141,2858,10
89912035942,89912035938,-4,1349,1781,10
89913619891,89913619889,-2,1115,1263,10
89913724759,89913724756,-3,1867,2898,10
89916601567,89916601574,7,1108,553,10
89917991352,89917991350,-2,777,1179,10
89926926683,89926926679,-4,674,1239,10
89930107049,89930107049,0,1709,1684,10
89931115982,89931115981,-1,1073,1622,10
89933169890,89933169888,-2,1030,2173,10
89933751974,89933751971,-3,917,2133,10
89935242934,89935242932,-2,947,1783,10
89936636097,89936636096,-1,1619,1865,10
89938236051,89938236050,-1,1214,2044,10
89940170058,89940170055,-3,952,1415,10
89940739795,89940739794,-1,1235,2253,10
89942339657,89942339657,0,1354,1675,10
89942682112,89942682103,-9,304,1331,10
89948772478,89948772478,0,1392,1967,10
89950584049,89950584054,5,3516,2165,10
89954497622,89954497622,0,1188,1659,10
89955655702,89955655702,0,1144,1432,10
89958720527,89958720527,0,1413,1719,10
89959129314,89959129311,-3,1035,1578,10
89959308862,89959308865,3,2463,2263,10
89962992394,89962992395,1,1111,1565,10
89964801538,89964801536,-2,1071,2291,10
89967958441,89967958435,-6,1999,6273,10
89968327393,89968327379,-14,12,1198,10
89968802069,89968802068,-1,697,1474,10
89970009098,89970009090,-8,1489,2246,10
89970981111,89970981110,-1,1191,2290,10
89973923759,89973923757,-2,808,1104,10
89974104911,89974104910,-1,1727,2612,10
89977504072,89977504078,6,2262,1985,10
89978440547,89978440546,-1,743,1189,10
89980246922,89980246929,7,2581,1285,10
89983081786,89983081785,-1,1451,2333,10
89985884118,89985884118,0,1271,2003,10
89986917496,89986917491,-5,2286,5822,10
89986955910,89986955909,-1,1301,2012,10
89988335973,89988335979,6,5891,2633,10
89989910194,89989910199,5,2600,1976,10
89992155475,89992155475,0,1915,2835,10
89994858771,89994858766,-5,862,3604,10
89995004258,89995004258,0,1492,2002,10
89996879703,89996879702,-1,918,1682,10
89998232859,89998232857,-2,1391,2357,10
89998939027,89998939023,-4,874,1909,10
90001784175,90001784174,-1,1456,2093,10
90005567323,90005567317,-6,21946,17581,10
90006810863,90006810863,0,916,1751,10
90008032269,90008032269,0,1056,2351,10
90009846526,90009846525,-1,1140,1758,10
90010474499,90010474498,-1,1439,1931,10
90010892558,90010892552,-6,1202,2544,10
90012994285,90012994284,-1,1195,2841,10
90014127434,90014127435,1,1972,1459,10
90017304350,90017304347,-3,1479,1775,10
90018993700,90018993699,-1,1260,1770,10
90019599024,90019599008,-16,259,1193,10
90021903506,90021903502,-4,1066,2563,10
90022546632,90022546627,-5,1053,1984,10
90024782141,90024782145,4,1301,1086,10
90026039415,90026039412,-3,1540,1962,10
90027709393,90027709391,-2,1219,1508,10
90030765871,90030765870,-1,912,1185,10
90032956478,90032956478,0,907,1636,10
90036258114,90036258110,-4,1280,2186,10
90038349242,90038349240,-2,1292,2305,10
90040607958,90040607954,-4,1355,1896,10
90043216753,90043216752,-1,941,1711,10
90047568528,90047568526,-2,1138,2185,10
90051151111,90051151110,-1,1012,1814,10
90052229201,90052229197,-4,2660,6322,10
90057035606,90057035603,-3,1711,2769,10
90060569114,90060569111,-3,967,1499,10
90060812602,90060812598,-4,1236,1444,10
90063148061,90063148061,0,1242,1269,10
90069347696,90069347694,-2,1429,2882,10
90072121282,90072121281,-1,1149,1663,10
90072426382,90072426381,-1,1178,1918,10
90074759658,90074759655,-3,1471,1947,10
90075069878,90075069878,0,1379,3007,10
90076933877,90076933876,-1,1178,1241,10
90082085035,90082085033,-2,1078,1867,10
90084237747,90084237752,5,5026,2652,10
90086552363,90086552366,3,981,1298,10
90089863371,90089863370,-1,1195,2167,10
90094024230,90094024227,-3,1407,1519,10
90094063835,90094063835,0,696,1312,10
90096641508,90096641506,-2,1486,1652,10
90096810410,90096810410,0,1216,2120,10
90097429092,90097429093,1,1152,1381,10
90097921834,90097921833,-1,277,723,10
90100325887,90100325885,-2,831,1945,10
90103120166,90103120165,-1,1340,1598,10
90104774618,90104774616,-2,1720,3027,10
90105636310,90105636307,-3,1270,2352,10
90105956952,90105956949,-3,1373,2198,10
90115515349,90115515351,2,2148,1534,10
90126141249,90126141250,1,1439,1930,10
90127219508,90127219506,-2,2140,2823,10
90130677754,90130677753,-1,1178,1824,10
90131274236,90131274233,-3,1412,1887,10
90135406367,90135406369,2,902,1165,10
90136557821,90136557827,6,4308,2318,10
90138070943,90138070941,-2,1323,1995,10
90138105445,90138105443,-2,877,1228,10
90143373574,90143373573,-1,1055,2259,10
90144979212,90144979212,0,1435,2193,10
90145365870,90145365863,-7,1407,5876,10
90150261404,90150261403,-1,1770,1686,10
90155530215,90155530214,-1,1024,2037,10
90157702861,90157702858,-3,2010,5289,10
90160627358,90160627355,-3,1322,2450,10
90161030326,90161030325,-1,549,2173,10
90169024753,90169024750,-3,1085,4244,10
90171338502,90171338499,-3,1274,2884,10
90179418491,90179418491,0,1180,1909,10
90183568032,90183568030,-2,1594,2056,10
90185289041,90185289037,-4,1300,1612,10
90187266549,90187266547,-2,1085,1905,10
90188139906,90188139907,1,1349,2006,10
90189989970,90189989970,0,1134,2004,10
90190213940,90190213938,-2,997,1687,10
90192647546,90192647542,-4,1416,1361,10
90196573407,90196573409,2,1287,1654,10
90199027845,90199027843,-2,1592,2340,10
90200630759,90200630758,-1,1387,2297,10
90202083700,90202083695,-5,1322,2150,10
90203478323,90203478322,-1,1297,1667,10
90204972238,90204972238,0,1413,1035,10
90205356699,90205356702,3,1341,975,10
90209994245,90209994242,-3,1051,1993,10
90214208487,90214208484,-3,1408,2423,10
90214368597,90214368597,0,1535,2227,10
90214962395,90214962390,-5,1524,3211,10
90215539543,90215539542,-1,1471,2534,10
90215732988,90215732986,-2,1291,2402,10
90220113574,90220113574,0,1492,1476,10
90221367853,90221367850,-3,2637,3378,10
90222125557,90222125554,-3,1322,2711,10
90222291919,90222291918,-1,979,1856,10
90222442095,90222442097,2,1364,1652,10
90223703071,90223703070,-1,1077,1928,10
90224033745,90224033742,-3,1295,2470,10
90224499745,90224499742,-3,1423,1989,10
90225395415,90225395414,-1,1231,1638,10
90226351528,90226351527,-1,1366,1650,10
90228891469,90228891454,-15,411,981,10
90232440030,90232440030,0,1315,2117,10
90235466411,90235466409,-2,1133,1271,10
90237031927,90237031926,-1,806,1297,10
90237723714,90237723713,-1,1087,2133,10
90239177755,90239177750,-5,707,1323,10
90242528161,90242528157,-4,1268,1819,10
90247928918,90247928917,-1,1072,2440,10
90252686616,90252686613,-3,1037,2077,10
90252887119,90252887118,-1,739,1611,10
90256753008,90256753006,-2,1010,2110,10
90261360954,90261360954,0,1329,2209,10
90261823412,90261823431,19,782,1786,10
90265194250,90265194250,0,1249,1526,10
90270227165,90270227165,0,1231,1726,10
90273422736,90273422735,-1,1077,2316,10
90273698617,90273698607,-10,1427,1699,10
90279999379,90279999379,0,878,2019,10
90282111932,90282111931,-1,1351,1593,10
90286753895,90286753895,0,958,1979,10
90287072743,90287072742,-1,1216,1945,10
90295764739,90295764738,-1,1244,2165,10
90299437322,90299437322,0,1326,1492,10
90306490212,90306490210,-2,1388,2701,10
90312898193,90312898192,-1,1405,1439,10
90316727224,90316727221,-3,1146,2214,10
90317547551,90317547550,-1,1199,1973,10
90317787956,90317787971,15,1489,6034,10
90319771719,90319771719,0,1175,2013,10
90320109953,90320109952,-1,1397,2078,10
90323664858,90323664857,-1,1591,1471,10
90324370439,90324370442,3,2518,1307,10
90324519070,90324519070,0,2226,3615,10
90330527233,90330527238,5,2865,2436,10
90331025768,90331025766,-2,1214,1492,10
90333982009,90333982009,0,825,1547,10
90342983654,90342983653,-1,1075,1598,10
90343648069,90343648064,-5,1046,1731,10
90344999132,90344999130,-2,1780,2810,10
90345814441,90345814440,-1,1319,1592,10
90345995773,90345995771,-2,1281,1551,10
90349117244,90349117247,3,1745,1200,10
90349314613,90349314611,-2,1343,1534,10
90350729580,90350729579,-1,1158,1544,10
90355171315,90355171300,-15,32803,14685,10
90361931010,90361931009,-1,1530,2090,10
90368990766,90368990767,1,1275,2082,10
90369223106,90369223105,-1,1727,2577,10
90369295007,90369295006,-1,1842,1961,10
90373302363,90373302360,-3,1219,1262,10
90376535257,90376535257,0,776,1347,10
90377452977,90377452977,0,1377,1364,10
90378445377,90378445373,-4,730,778,10
90379082422,90379082421,-1,872,2152,10
90379247849,90379247845,-4,1362,1807,10
90382111826,90382111824,-2,1714,2310,10
90382497922,90382497929,7,6580,2663,10
90385722461,90385722480,19,1275,1679,10
90393251802,90393251801,-1,1179,1937,10
90395848266,90395848269,3,2623,1460,10
90399049711,90399049711,0,1907,2178,10
90399320065,90399320059,-6,622,910,10
90402157667,90402157666,-1,1964,2907,10
90402388162,90402388161,-1,1116,2080,10
90402550137,90402550157,20,819,1849,10
90407530718,90407530718,0,1459,1602,10
90408865242,90408865242,0,1127,1247,10
90409284762,90409284747,-15,758,1010,10
90410851263,90410851262,-1,1258,2143,10
90412131032,90412131043,11,1260,1642,10
90412725507,90412725505,-2,788,2205,10
90414067625,90414067629,4,2221,1847,10
90417169026,90417169026,0,1346,2018,10
90421518686,90421518685,-1,1052,2208,10
90424054429,90424054428,-1,1665,1906,10
90425636569,90425636566,-3,1260,2231,10
90425967674,90425967674,0,1508,2069,10
90429501478,90429501476,-2,1279,2617,10
90431773747,90431773746,-1,1178,1742,10
90435320965,90435320958,-7,1342,4692,10
90436542450,90436542453,3,1360,1062,10
90437979920,90437979919,-1,1425,1971,10
90438585804,90438585822,18,655,1262,10
90439191376,90439191373,-3,1604,3773,10
90449120265,90449120262,-3,1559,1601,10
90452068016,90452068015,-1,869,1902,10
90454940410,90454940406,-4,1191,2453,10
90467004218,90467004218,0,2037,2449,10
90473804010,90473804006,-4,1445,2242,10
90474534947,90474534946,-1,881,1572,10
90481547575,90481547574,-1,1323,1573,10
90484437018,90484437017,-1,1574,2129,10
90491001470,90491001469,-1,1242,916,10
90494784271,90494784270,-1,905,1537,10
90495867652,90495867651,-1,1063,1116,10
90496308310,90496308310,0,1038,1907,10
90496399138,90496399138,0,1070,2529,10
90500642409,90500642408,-1,1128,1878,10
90504496873,90504496871,-2,869,1640,10
90506346521,90506346519,-2,1363,1991,10
90507697362,90507697351,-11,328,936,10
90515352895,90515352894,-1,1011,1804,10
90515658891,90515658891,0,1050,2213,10
90518622667,90518622666,-1,1827,3171,10
90518816800,90518816798,-2,1588,2196,10
90519202567,90519202564,-3,788,2460,10
90519325753,90519325733,-20,942,1890,10
90519388754,90519388738,-16,370,1153,10
90525020714,90525020709,-5,1651,3006,10
90525901708,90525901710,2,1191,1921,10
90525927794,90525927793,-1,1603,1479,10
90527822447,90527822447,0,988,1718,10
90529154481,90529154486,5,1519,2490,10
90532994063,90532994064,1,1127,1949,10
90533846898,90533846894,-4,1079,2486,10
90534929109,90534929106,-3,1052,2999,10
90535816163,90535816162,-1,1832,3090,10
90537282555,90537282555,0,1128,1891,10
90537782353,90537782371,18,230,682,10
90537959754,90537959773,19,1073,2152,10
90538281872,90538281894,22,1197,3374,10
90538671626,90538671626,0,1195,1940,10
90538963498,90538963497,-1,1345,2295,10
90541104566,90541104564,-2,1772,2711,10
90545358266,90545358266,0,1079,1075,10
90551847141,90551847140,-1,1186,1546,10
90552424874,90552424873,-1,1423,1557,10
90553949886,90553949884,-2,874,1012,10
90555646226,90555646219,-7,864,2423,10
90555809610,90555809611,1,960,1848,10
90559813218,90559813217,-1,1414,2043,10
90562805422,90562805422,0,1064,1318,10
90564873001,90564872998,-3,1764,2976,10
90566074721,90566074718,-3,1180,1940,10
90566463993,90566463992,-1,995,2005,10
90567761397,90567761378,-19,1454,444,10
90570185964,90570185963,-1,903,1435,10
90572664721,90572664720,-1,1639,1427,10
90572730799,90572730797,-2,1465,2197,10
90573396083,90573396081,-2,1033,1836,10
90573861946,90573861946,0,1754,2088,10
90581906022,90581906022,0,2098,2919,10
90582114931,90582114933,2,2460,2613,10
90586378858,90586378858,0,746,1789,10
90588901239,90588901233,-6,985,3368,10
90596034670,90596034667,-3,1064,2910,10
90598436751,90598436751,0,917,1428,10
90601291691,90601291690,-1,1374,2782,10
90601577123,90601577122,-1,964,1686,10
90602419883,90602419883,0,1183,2330,10
90604372341,90604372339,-2,1174,2222,10
90605011825,90605011822,-3,1272,1597,10
90606762256,90606762256,0,1602,2664,10
90609174605,90609174604,-1,1415,1576,10
90614188642,90614188638,-4,1202,2496,10
90614892405,90614892404,-1,1052,1557,10
90618153415,90618153413,-2,753,1493,10
90622168390,90622168389,-1,1412,1865,10
90623648264,90623648261,-3,1261,1841,10
90632964174,90632964174,0,1488,2638,10
90633425447,90633425447,0,1243,1683,10
90635202145,90635202142,-3,1683,2341,10
90637626427,90637626426,-1,1405,1879,10
90638769515,90638769512,-3,1188,1753,10
90641754553,90641754550,-3,1145,1237,10
90642453837,90642453835,-2,1568,2515,10
90648787614,90648787614,0,780,1161,10
90649446818,90649446818,0,1202,1782,10
90650787240,90650787257,17,686,2148,10
90650830341,90650830344,3,2637,1352,10
90651015926,90651015925,-1,1234,2008,10
90651684975,90651684969,-6,1381,2441,10
90652020227,90652020219,-8,1434,2235,10
90653667681,90653667685,4,9634,32358,10
90656480670,90656480669,-1,789,1546,10
90657552810,90657552811,1,1023,914,10
90661573658,90661573655,-3,1331,2285,10
90663136927,90663136928,1,778,1603,10
90668718826,90668718824,-2,1477,2459,10
90673647601,90673647601,0,1682,2800,10
90674963622,90674963620,-2,1412,2095,10
90676869377,90676869374,-3,938,2774,10
90679933812,90679933811,-1,1002,1706,10
90685766135,90685766132,-3,1248,1655,10
90687249261,90687249257,-4,1310,3935,10
90687450208,90687450229,21,1053,2020,10
90689403575,90689403574,-1,970,2139,10
90690069332,90690069330,-2,1316,2074,10
90693467078,90693467096,18,1048,2059,10
90694674021,90694674015,-6,2446,10515,10
90695938575,90695938576,1,1388,2935,10
90697272149,90697272147,-2,1363,2251,10
90697590568,90697590566,-2,1502,1963,10
90700016108,90700016110,2,1902,1637,10
90700332714,90700332714,0,1186,1953,10
90700471076,90700471075,-1,1038,1638,10
90701047487,90701047490,3,884,1439,10
90704658505,90704658505,0,1945,1869,10
90707850441,90707850439,-2,1083,1854,10
90709631307,90709631305,-2,1099,1767,10
90709939019,90709939017,-2,1629,2476,10
90710912867,90710912866,-1,1517,2211,10
90714380949,90714380950,1,1084,1529,10
90718167560,90718167547,-13,22780,25807,10
90718404418,90718404416,-2,1066,1859,10
90720295859,90720295857,-2,1542,1970,10
90725548076,90725548073,-3,1476,1997,10
90725806265,90725806263,-2,1761,2680,10
90726147443,90726147441,-2,1294,2741,10
90726755560,90726755558,-2,1178,1414,10
90726834357,90726834361,4,30578,22334,10
90727660303,90727660301,-2,1283,1730,10
90730783506,90730783504,-2,1680,2104,10
90733555470,90733555469,-1,1219,1966,10
90735013954,90735013954,0,1313,2013,10
90735791409,90735791408,-1,1115,1498,10
90738626610,90738626607,-3,834,1616,10
90739821450,90739821450,0,1713,1571,10
90740346291,90740346290,-1,1412,2018,10
90744562418,90744562423,5,2010,1046,10
90745449382,90745449387,5,1207,1279,10
90748690791,90748690793,2,1437,1703,10
90752409690,90752409690,0,1330,2161,10
90752962783,90752962782,-1,1384,1815,10
90756331265,90756331265,0,1556,2078,10
90757292772,90757292769,-3,1095,1804,10
90757753929,90757753930,1,3488,3690,10
90761912170,90761912166,-4,1527,5830,10
90763111330,90763111330,0,914,1805,10
90764783245,90764783238,-7,969,5154,10
90765820042,90765820043,1,945,1814,10
90766020106,90766020113,7,2473,1492,10
90770917563,90770917564,1,1655,2851,10
90772395251,90772395249,-2,1661,2407,10
90772786595,90772786594,-1,1219,1642,10
90774754371,90774754368,-3,1174,2227,10
90776265441,90776265438,-3,1589,2578,10
90776586645,90776586643,-2,1035,1225,10
90777961530,90777961531,1,800,2067,10
90780538509,90780538507,-2,1652,2416,10
90782442634,90782442627,-7,1585,5792,10
90782877255,90782877251,-4,1035,1971,10
90784113534,90784113513,-21,902,1538,10
90788350818,90788350818,0,1349,2028,10
90802268376,90802268375,-1,1116,2409,10
90803199794,90803199791,-3,1101,3140,10
90807370741,90807370739,-2,1264,1070,10
90809780863,90809780862,-1,910,1753,10
90813318980,90813318978,-2,887,1772,10
90818366378,90818366377,-1,1418,2414,10
90818878121,90818878120,-1,1542,2113,10
90819277354,90819277352,-2,1098,1465,10
90820856710,90820856707,-3,1157,2410,10
90821842162,90821842162,0,1151,1559,10
90824989572,90824989570,-2,1389,2331,10
90831222173,90831222172,-1,1434,2263,10
90835734547,90835734546,-1,1238,2424,10
90836256957,90836256954,-3,1349,2175,10
90837186497,90837186495,-2,763,1462,10
90837661530,90837661544,14,146,1509,10
90838015773,90838015769,-4,1057,1935,10
90839480385,90839480383,-2,1420,2098,10
90840116147,90840116145,-2,1138,2507,10
90842159300,90842159298,-2,2197,4277,10
90842231907,90842231907,0,804,999,10
90846864934,90846864932,-2,1081,1945,10
90853147345,90853147342,-3,1144,1696,10
90855209372,90855209371,-1,1405,2197,10
90856838422,90856838421,-1,951,1964,10
90861657544,90861657549,5,2551,1485,10
90862199409,90862199407,-2,956,1959,10
90862857836,90862857835,-1,2334,2375,10
90865562175,90865562175,0,1258,2375,10
90866425421,90866425419,-2,590,864,10
90867768570,90867768569,-1,1273,2473,10
90872758046,90872758045,-1,801,1233,10
90874063568,90874063577,9,317,937,10
90874795929,90874795926,-3,1263,2704,10
90877255466,90877255465,-1,1225,1860,10
90885491077,90885491078,1,1313,2178,10
90885770634,90885770633,-1,1553,1971,10
90891286355,90891286355,0,1577,2418,10
90895312025,90895312022,-3,897,3027,10
90897390111,90897390109,-2,1388,2588,10
90897512977,90897512977,0,815,1895,10
90902195999,90902195998,-1,1070,2412,10
90902229520,90902229514,-6,2631,10493,10
90903090527,90903090526,-1,1044,1381,10
90906533169,90906533166,-3,1194,2407,10
90914920343,90914920342,-1,1690,2066,10
90917595922,90917595921,-1,1063,1547,10
90923037019,90923037019,0,1322,2285,10
90927419135,90927419138,3,2990,2423,10
90927672874,90927672872,-2,1241,2044,10
90928700775,90928700773,-2,1065,2245,10
90937668717,90937668715,-2,1056,1800,10
90947093200,90947093214,14,869,1170,10
90949502137,90949502137,0,1205,1358,10
90949908430,90949908427,-3,1436,2859,10
90950378802,90950378802,0,1688,2363,10
90950929451,90950929447,-4,1253,1912,10
90953362959,90953362958,-1,1147,1431,10
90955058699,90955058698,-1,1159,1474,10
90955294519,90955294515,-4,1415,2157,10
90959236855,90959236854,-1,1139,1381,10
90959828324,90959828322,-2,1327,2000,10
90963693522,90963693522,0,821,1533,10
90965043601,90965043601,0,1119,1882,10
90967243992,90967243985,-7,1014,5371,10
90967564096,90967564094,-2,1200,1339,10
90970291473,90970291473,0,1035,2036,10
90971184501,90971184499,-2,1346,2101,10
90980130389,90980130387,-2,1486,1608,10
90981903710,90981903710,0,1312,2223,10
90988264663,90988264659,-4,1120,1915,10
90988756870,90988756869,-1,1516,1891,10
90992114065,90992114063,-2,1725,2067,10
90992157895,90992157895,0,1171,1415,10
90995739244,90995739241,-3,833,1562,10
90999519939,90999519939,0,1147,1885,10
91002360121,91002360119,-2,1360,1905,10
91004771674,91004771671,-3,858,1818,10
91004893927,91004893925,-2,903,2117,10
91007107035,91007107034,-1,1064,2104,10
91010028701,91010028699,-2,1198,1841,10
91010861131,91010861127,-4,1050,2677,10
91012116034,91012116034,0,1351,2270,10
91012875708,91012875706,-2,1686,2585,10
91014328290,91014328283,-7,1480,11747,10
91021408776,91021408773,-3,1204,1365,10
91021624401,91021624399,-2,920,1009,10
91021726475,91021726461,-14,1353,1988,10
91024594306,91024594303,-3,1400,2263,10
91029032909,91029032909,0,1722,1973,10
91034852275,91034852275,0,1489,2049,10
91038857142,91038857139,-3,800,1583,10
91043094894,91043094895,1,1768,2402,10
91043805698,91043805699,1,1297,2209,10
91043891305,91043891291,-14,236,1095,10
91052274351,91052274347,-4,1213,2637,10
91057297495,91057297494,-1,1132,1718,10
91061133731,91061133731,0,1322,1828,10
91064039746,91064039743,-3,1513,3254,10
91065756749,91065756746,-3,1795,2665,10
91073605378,91073605373,-5,1107,3643,10
91076959959,91076959958,-1,1220,1275,10
91079656904,91079656903,-1,1430,1768,10
91083359089,91083359087,-2,1229,2906,10
91086099216,91086099216,0,1834,2412,10
91088908559,91088908557,-2,1506,3377,10
91091140245,91091140242,-3,1017,1664,10
91094724195,91094724197,2,1578,1712,10
91095778925,91095778925,0,1896,2445,10
91097643194,91097643194,0,1359,2387,10
91098457633,91098457615,-18,1012,2024,10
91099654193,91099654193,0,1455,1926,10
91104978250,91104978245,-5,911,1932,10
91107405315,91107405314,-1,1021,2049,10
91111540879,91111540879,0,1273,2174,10
91116176751,91116176754,3,3564,2785,10
91117342393,91117342394,1,2302,2194,10
91123432581,91123432583,2,2062,1929,10
91123813234,91123813235,1,1787,1322,10
91128173303,91128173301,-2,786,1827,10
91131552851,91131552850,-1,1378,2426,10
91131986197,91131986194,-3,1181,2364,10
91135343503,91135343503,0,1170,1835,10
91137284037,91137284037,0,1043,2265,10
91138139777,91138139776,-1,1103,1700,10
91141979389,91141979391,2,1246,1112,10
91143438034,91143438033,-1,1710,1785,10
91146637330,91146637327,-3,764,1230,10
91148599847,91148599846,-1,1281,2298,10
91150325430,91150325430,0,1460,1745,10
91153027413,91153027414,1,771,901,10
91153985190,91153985190,0,710,1998,10
91159273046,91159273045,-1,1136,2053,10
91161142958,91161142955,-3,1550,2401,10
91164286601,91164286601,0,1387,1673,10
91165434863,91165434859,-4,883,2101,10
91177093204,91177093201,-3,1268,1938,10
91177549419,91177549418,-1,1096,1959,10
91181319903,91181319902,-1,1328,1781,10
91189203789,91189203788,-1,1443,2651,10
91191048897,91191048900,3,1277,1351,10
91193266771,91193266758,-13,1566,2982,10
91205053427,91205053427,0,996,1707,10
91207343715,91207343714,-1,646,1006,10
91208839012,91208839008,-4,48828,21177,10
91213493183,91213493181,-2,6489,11968,10
91214725034,91214725033,-1,1574,2346,10
91215032502,91215032501,-1,1492,2211,10
91216369581,91216369581,0,882,1009,10
91217522785,91217522785,0,1642,2548,10
91219104301,91219104299,-2,1197,2136,10
91222137830,91222137828,-2,1377,2159,10
91222472790,91222472787,-3,1535,2790,10
91222739613,91222739611,-2,1510,2838,10
91224309583,91224309584,1,960,1822,10
91226095518,91226095517,-1,1384,1865,10
91228195638,91228195635,-3,879,2071,10
91230318303,91230318302,-1,1080,1427,10
91231969965,91231969963,-2,1598,2523,10
91232758801,91232758798,-3,1285,1379,10
91233951445,91233951443,-2,1180,2720,10
91235060990,91235060991,1,1879,1731,10
91235854777,91235854777,0,1243,1986,10
91243144190,91243144185,-5,1045,4875,10
91243831235,91243831229,-6,748,1790,10
91244095844,91244095842,-2,1162,1730,10
91254095648,91254095653,5,115,687,10
91259171322,91259171321,-1,1613,2119,10
91264416062,91264416062,0,1024,1450,10
91265771859,91265771858,-1,1825,2551,10
91272384366,91272384367,1,1329,1958,10
91272444782,91272444778,-4,898,1093,10
91276478939,91276478936,-3,1265,1763,10
91277646810,91277646812,2,1177,1857,10
91277908650,91277908648,-2,1069,2019,10
91285818825,91285818824,-1,1217,2181,10
91289389201,91289389199,-2,1156,1556,10
91289454562,91289454562,0,1405,1673,10
91291738317,91291738315,-2,1504,1841,10
91292362843,91292362842,-1,1000,2188,10
91296735852,91296735862,10,17804,15006,10
91297225106,91297225107,1,1403,1841,10
91298732386,91298732385,-1,1129,2730,10
91305149150,91305149150,0,1301,1656,10
91305187328,91305187321,-7,765,1189,10
91320179848,91320179854,6,2095,1382,10
91321491146,91321491143,-3,1112,1634,10
91321670886,91321670884,-2,1684,2053,10
91322615976,91322615998,22,1281,1681,10
91323822894,91323822894,0,1518,1951,10
91335148460,91335148458,-2,1330,2118,10
91338483859,91338483857,-2,852,1717,10
91342242974,91342242973,-1,1429,2051,10
91343828010,91343828009,-1,1334,1643,10
91344634641,91344634642,1,1063,1648,10
91348302315,91348302314,-1,1263,2712,10
91350010156,91350010160,4,10696,6666,10
91350119662,91350119675,13,14490,41292,10
91353490212,91353490210,-2,1529,2017,10
91358258711,91358258709,-2,1152,2511,10
91358386034,91358386032,-2,1572,2630,10
91362199949,91362199945,-4,1583,1675,10
91364565664,91364565658,-6,1413,4719,10
91368136028,91368136027,-1,1408,2455,10
91368171522,91368171541,19,545,1687,10
91368898942,91368898939,-3,1502,2477,10
91369182796,91369182794,-2,1612,2340,10
91370163430,91370163429,-1,1135,1931,10
91370791054,91370791054,0,1592,1455,10
91371658387,91371658386,-1,1050,1396,10
91373183306,91373183306,0,1154,1137,10
91377014546,91377014546,0,1320,1864,10
91378208037,91378208042,5,1669,1142,10
91382569467,91382569466,-1,1774,1671,10
91383720913,91383720911,-2,990,1043,10
91389510462,91389510458,-4,1087,2164,10
91393181332,91393181330,-2,1051,2437,10
91394496891,91394496891,0,1290,1315,10
91397885140,91397885138,-2,1103,2060,10
91400059827,91400059826,-1,1440,1497,10
91402443275,91402443280,5,4492,2857,10
91402518805,91402518805,0,1430,1854,10
91403156382,91403156380,-2,1114,1513,10
91403652827,91403652825,-2,1332,2351,10
91403893753,91403893753,0,1302,1337,10
91404288890,91404288888,-2,1071,1694,10
91405185809,91405185806,-3,2091,5399,10
91406162789,91406162786,-3,1527,2103,10
91407587674,91407587673,-1,1501,1686,10
91409568102,91409568101,-1,1289,1501,10
91410588671,91410588665,-6,1235,3375,10
91411697778,91411697799,21,149,550,10
91413648639,91413648637,-2,1228,1890,10
91415172898,91415172890,-8,263,728,10
91419673186,91419673186,0,1661,1801,10
91420909512,91420909510,-2,1454,2530,10
91422081947,91422081944,-3,1064,2285,10
91425840867,91425840865,-2,1387,1886,10
91427536622,91427536622,0,1206,1262,10
91433584943,91433584942,-1,1129,1736,10
91437535069,91437535066,-3,1249,2152,10
91440898794,91440898793,-1,1367,2005,10
91441200361,91441200359,-2,1549,2710,10
91443013386,91443013381,-5,22895,13870,10
91443429767,91443429771,4,1209,1280,10
91450909982,91450909982,0,1512,2381,10
91451700035,91451700034,-1,953,1438,10
91459841927,91459841926,-1,917,1958,10
91461106638,91461106634,-4,1207,1924,10
91464261345,91464261347,2,2289,1924,10
91464779374,91464779371,-3,1345,1907,10
91466024408,91466024406,-2,1369,2560,10
91466222651,91466222650,-1,1300,1258,10
91472102633,91472102633,0,1626,2069,10
91479427167,91479427165,-2,1343,2193,10
91481173096,91481173095,-1,1797,2042,10
91482835041,91482835038,-3,1430,1960,10
91484784667,91484784668,1,1327,2142,10
91487988454,91487988453,-1,1154,1892,10
91501638595,91501638594,-1,1286,2591,10
91502161598,91502161597,-1,1425,2135,10
91505416234,91505416233,-1,1156,2065,10
91507701890,91507701889,-1,953,1600,10
91507878038,91507878037,-1,1700,2084,10
91509889130,91509889130,0,932,1345,10
91510330096,91510330094,-2,1083,1671,10
91512029345,91512029345,0,1565,2801,10
91515941870,91515941868,-2,1335,2194,10
91518932659,91518932658,-1,1621,2792,10
91526161966,91526161966,0,1688,2120,10
91526463340,91526463336,-4,1136,2458,10
91526509442,91526509459,17,1016,1947,10
91531215023,91531215021,-2,1547,2000,10
91531795418,91531795418,0,1082,1666,10
91550224910,91550224909,-1,1387,1976,10
91555520963,91555520960,-3,1653,2660,10
91555584871,91555584870,-1,1344,2061,10
91556575405,91556575405,0,1495,1574,10
91558885222,91558885223,1,921,1343,10
91564696142,91564696143,1,1829,2096,10
91568254155,91568254155,0,967,2002,10
91568473732,91568473730,-2,1307,2347,10
91569186058,91569186070,12,14722,22138,10
91569675447,91569675441,-6,1428,5041,10
91569867594,91569867594,0,1438,1410,10
91570410496,91570410487,-9,1288,1889,10
91570764767,91570764766,-1,1214,1736,10
91571993390,91571993383,-7,1039,5280,10
91573009460,91573009458,-2,1414,1850,10
91574839684,91574839682,-2,1288,2266,10
91575774094,91575774093,-1,1329,1195,10
91576595656,91576595641,-15,1000,1799,10
91577607380,91577607367,-13,18085,21323,10
91580661510,91580661507,-3,1515,2229,10
91581342259,91581342258,-1,1623,2204,10
91584536498,91584536498,0,1164,1633,10
91589225366,91589225366,0,964,2745,10
91590926442,91590926442,0,1530,1865,10
91593407187,91593407185,-2,1092,1748,10
91604417985,91604417984,-1,1394,2793,10
91613967078,91613967077,-1,1103,1755,10
91621736270,91621736267,-3,1265,2356,10
91627444767,91627444765,-2,1375,1785,10
91627670874,91627670874,0,935,1919,10
91631057200,91631057198,-2,1049,1873,10
91631905382,91631905377,-5,804,2355,10
91632990040,91632990038,-2,1446,1917,10
91635685682,91635685681,-1,807,1731,10
91636408858,91636408858,0,924,2065,10
91640549949,91640549952,3,1184,1151,10
91641942635,91641942634,-1,976,2082,10
91648256585,91648256583,-2,1165,1542,10
91649196630,91649196629,-1,1275,1800,10
91655492674,91655492673,-1,1397,2342,10
91658624620,91658624620,0,1118,1634,10
91665108726,91665108725,-1,1235,2663,10
91670120435,91670120434,-1,1211,1798,10
91673527348,91673527328,-20,1271,1891,10
91678351421,91678351418,-3,892,1796,10
91680355697,91680355695,-2,1181,1924,10
91681010280,91681010278,-2,1318,2569,10
91681525041,91681525041,0,1322,1662,10
91684080957,91684080957,0,1180,2182,10
91685149935,91685149935,0,3274,12710,10
91688786418,91688786423,5,4965,2908,10
91695335364,91695335361,-3,1781,2600,10
91696059209,91696059210,1,1469,2063,10
91696707563,91696707565,2,35477,33810,10
91700331546,91700331545,-1,1040,2053,10
91703122620,91703122619,-1,1724,2500,10
91703270733,91703270733,0,1179,1866,10
91707152694,91707152683,-11,970,435,10
91707742732,91707742730,-2,1606,1895,10
91712071244,91712071241,-3,1112,1661,10
91712743082,91712743086,4,4368,3037,10
91714779187,91714779186,-1,2434,3078,10
91717159331,91717159337,6,3482,1997,10
91719431373,91719431374,1,909,1886,10
91720092007,91720092006,-1,1763,2142,10
91722286051,91722286049,-2,1023,1483,10
91726035637,91726035633,-4,1758,6127,10
91726738067,91726738053,-14,32898,17854,10
91732551933,91732551949,16,799,1634,10
91735357283,91735357281,-2,943,2082,10
91735552043,91735552062,19,590,2252,10
91737332573,91737332572,-1,849,1544,10
91741236840,91741236837,-3,1394,1597,10
91741294901,91741294899,-2,1514,2536,10
91743039305,91743039302,-3,1688,2179,10
91744674595,91744674594,-1,1278,1894,10
91747719046,91747719045,-1,1441,1798,10
91748306563,91748306562,-1,1015,1726,10
91750006849,91750006846,-3,993,1978,10
91751704500,91751704496,-4,1716,2836,10
91752729650,91752729649,-1,966,2501,10
91753614403,91753614399,-4,1727,2192,10
91754800425,91754800424,-1,1017,1312,10
91755554192,91755554181,-11,1041,2159,10
91756189769,91756189767,-2,729,1685,10
91757565650,91757565649,-1,1196,1474,10
91758025071,91758025071,0,1061,1812,10
91759998851,91759998851,0,1295,2390,10
91765607177,91765607175,-2,1882,1807,10
91766517725,91766517726,1,1213,1562,10
91770359465,91770359463,-2,1122,1902,10
91771039124,91771039142,18,1156,1730,10
91771169345,91771169343,-2,1000,1649,10
91772108189,91772108186,-3,1571,2558,10
91772313271,91772313266,-5,1080,1666,10
91772833006,91772833004,-2,706,957,10
91775333963,91775333962,-1,1406,2118,10
91775846431,91775846429,-2,1191,1713,10
91776186163,91776186162,-1,822,1853,10
91785641574,91785641573,-1,1250,2170,10
91786850909,91786850906,-3,1239,2074,10
91786894466,91786894462,-4,143,2138,10
91786931787,91786931806,19,833,1367,10
91788029076,91788029075,-1,1011,1611,10
91789525430,91789525427,-3,887,1611,10
91791844743,91791844742,-1,1106,2202,10
91795465251,91795465250,-1,1427,2168,10
91798572513,91798572510,-3,1130,2138,10
91799344725,91799344724,-1,1354,2532,10
91802695776,91802695775,-1,1520,2752,10
91805621731,91805621731,0,1036,1480,10
91809256848,91809256845,-3,1593,2355,10
91810080058,91810080054,-4,897,1979,10
91810396689,91810396680,-9,124,329,10
91810971653,91810971651,-2,901,1466,10
91811215843,91811215842,-1,1066,1710,10
91812581702,91812581702,0,1019,1047,10
91815838949,91815838946,-3,1518,2484,10
91816220762,91816220760,-2,1555,2900,10
91818265793,91818265814,21,287,835,10
91819131846,91819131844,-2,663,987,10
91820491290,91820491306,16,297,586,10
91826965567,91826965566,-1,1392,2271,10
91828565863,91828565862,-1,1698,2445,10
91835246171,91835246175,4,2085,1314,10
91835456396,91835456395,-1,1138,1928,10
91835971810,91835971806,-4,981,1692,10
91836476155,91836476154,-1,1611,1902,10
91838682130,91838682125,-5,1108,5791,10
91841787422,91841787429,7,5575,1716,10
91843710295,91843710296,1,604,1209,10
91852825103,91852825101,-2,1202,1788,10
91852867906,91852867906,0,1309,1576,10
91854046774,91854046773,-1,1081,1887,10
91855223614,91855223610,-4,1416,2442,10
91859659000,91859658997,-3,1265,2437,10
91863001094,91863001092,-2,1084,1901,10
91865222179,91865222179,0,1203,1172,10
91867607386,91867607385,-1,1134,1390,10
91870661302,91870661301,-1,1287,2442,10
91876037646,91876037624,-22,1358,2226,10
91876849806,91876849812,6,1004,2237,10
91877945754,91877945753,-1,1247,1808,10
91879057206,91879057203,-3,1238,2064,10
91879438107,91879438105,-2,709,1932,10
91879696690,91879696691,1,988,952,10
91880710628,91880710626,-2,1486,1769,10
91882389341,91882389338,-3,1038,3613,10
91883332653,91883332649,-4,1229,1491,10
91886764290,91886764289,-1,1317,2215,10
91887357810,91887357804,-6,829,2171,10
91889010752,91889010758,6,1994,1388,10
91889251352,91889251374,22,167,1064,10
91892059452,91892059450,-2,1791,2593,10
91892529524,91892529521,-3,1299,1560,10
91894500335,91894500333,-2,1639,3030,10
91895022689,91895022686,-3,691,1908,10
91895872674,91895872671,-3,1259,1778,10
91896099542,91896099542,0,1579,2311,10
91900661739,91900661738,-1,1041,1304,10
91905139974,91905139971,-3,1049,2125,10
91905478272,91905478269,-3,1065,1756,10
91906107001,91906106999,-2,1122,2333,10
91912811590,91912811588,-2,1562,2524,10
91914769319,91914769317,-2,999,2985,10
91915209212,91915209230,18,664,1134,10
91915741949,91915741956,7,896,1057,10
91917251915,91917251910,-5,1514,5067,10
91923173437,91923173430,-7,32765,12825,10
91925091975,91925091974,-1,970,1817,10
91925455789,91925455787,-2,949,2004,10
91927878654,91927878653,-1,1098,1572,10
91929494048,91929494043,-5,994,1522,10
91930298719,91930298720,1,509,1362,10
91930958086,91930958086,0,1017,1085,10
91935740915,91935740914,-1,1065,1298,10
91937109306,91937109305,-1,1299,2395,10
91942478879,91942478881,2,1257,1917,10
91946827530,91946827529,-1,1012,1715,10
91947569167,91947569170,3,1513,1230,10
91947943495,91947943498,3,1385,1504,10
91950304774,91950304770,-4,1630,2954,10
91956646572,91956646570,-2,1217,1864,10
91957591202,91957591202,0,841,1841,10
91958384242,91958384238,-4,1241,2022,10
91962435291,91962435287,-4,708,1641,10
91965853182,91965853179,-3,1137,1927,10
91969708715,91969708714,-1,1063,1645,10
91972342581,91972342581,0,650,1315,10
91972889199,91972889197,-2,1172,2310,10
91978051640,91978051644,4,5127,2349,10
91982305768,91982305773,5,3267,1351,10
91983164651,91983164649,-2,1329,2610,10
91985739700,91985739701,1,1501,1638,10
91988973970,91988973968,-2,1258,1810,10
91991605069,91991605068,-1,1246,1453,10
91992278126,91992278124,-2,1066,1690,10
91992985967,91992985967,0,1110,1661,10
91994834583,91994834581,-2,1148,2548,10
91995674419,91995674414,-5,814,1388,10
91997993427,91997993426,-1,1266,2118,10
91998612606,91998612605,-1,1059,1938,10
92002142807,92002142806,-1,1052,1705,10
92002579777,92002579777,0,1399,1754,10
92003220824,92003220827,3,1063,1937,10
92005182614,92005182610,-4,964,1223,10
92005598694,92005598694,0,1077,2181,10
92005799378,92005799375,-3,1450,2230,10
92006358411,92006358410,-1,1098,2133,10
92010414410,92010414407,-3,1000,1241,10
92010861491,92010861490,-1,1457,2637,10
92011040957,92011040957,0,1457,1852,10
92015432890,92015432895,5,2336,1371,10
92015539424,92015539446,22,970,2980,10
92015576282,92015576302,20,406,1374,10
92015903338,92015903337,-1,1288,2159,10
92017053660,92017053678,18,1629,1993,10
92017284586,92017284585,-1,1135,2243,10
92024178257,92024178262,5,2196,1319,10
92026615949,92026615950,1,1650,2439,10
92034272484,92034272482,-2,1115,1660,10
92036673112,92036673110,-2,1047,2042,10
92039040985,92039040983,-2,1290,1936,10
92040375109,92040375106,-3,778,1727,10
92043032367,92043032368,1,1488,2345,10
92048459161,92048459160,-1,1038,1426,10
92052787824,92052787824,0,1287,2356,10
92053009672,92053009670,-2,952,1839,10
92053674115,92053674103,-12,875,1613,10
92054251572,92054251570,-2,1313,2135,10
92063207922,92063207922,0,1850,2323,10
92064382590,92064382589,-1,998,1450,10
92065306179,92065306168,-11,1365,1778,10
92066651240,92066651238,-2,932,1862,10
92066838660,92066838661,1,1358,1876,10
92070952530,92070952530,0,1630,2653,10
92072429783,92072429782,-1,897,1107,10
92072678568,92072678579,11,1447,2099,10
92073984618,92073984617,-1,1760,2265,10
92074703891,92074703889,-2,946,1618,10
92074775363,92074775362,-1,953,1611,10
92082056938,92082056938,0,1092,1916,10
92087932267,92087932265,-2,856,2274,10
92090435428,92090435451,23,826,1287,10
92091408307,92091408306,-1,1173,2301,10
92091643015,92091643014,-1,1249,2531,10
92091940005,92091940004,-1,1087,2681,10
92092557354,92092557351,-3,1174,2094,10
92094709598,92094709597,-1,1084,1875,10
92096316939,92096316938,-1,1325,2148,10
92097044298,92097044297,-1,1187,2662,10
92098189686,92098189687,1,1060,1461,10
92100853566,92100853564,-2,1404,1891,10
92104708810,92104708809,-1,1267,2162,10
92107899938,92107899938,0,1322,2011,10
92108384319,92108384319,0,937,1167,10
92108479571,92108479550,-21,1160,944,10
92110929664,92110929662,-2,2015,2519,10
92124704075,92124704073,-2,1469,2473,10
92124979810,92124979813,3,39,1024,10
92125792357,92125792358,1,1572,2217,10
92133476471,92133476474,3,286,1096,10
92134547343,92134547341,-2,1333,2147,10
92138311609,92138311609,0,374,583,10
92138630981,92138630981,0,2010,2622,10
92138706054,92138706054,0,1278,2333,10
92147325439,92147325438,-1,1091,1824,10
92149097021,92149097016,-5,4777,15612,10
92149709202,92149709219,17,1261,1995,10
92150666266,92150666287,21,196,985,10
92151258845,92151258843,-2,1419,2427,10
92153112869,92153112864,-5,1780,5495,10
92153919746,92153919747,1,1003,1882,10
92155114599,92155114594,-5,990,2240,10
92158120718,92158120717,-1,1928,2210,10
92159232070,92159232070,0,1203,1806,10
92161419821,92161419820,-1,1520,2278,10
92164180544,92164180544,0,1802,2309,10
92165390866,92165390866,0,811,2104,10
92165480122,92165480121,-1,976,2254,10
92170161030,92170161028,-2,1170,1546,10
92175752461,92175752458,-3,1228,1838,10
92178248528,92178248529,1,1893,1747,10
92179095315,92179095311,-4,1198,3228,10
92180577894,92180577893,-1,1466,2136,10
92185130907,92185130906,-1,1225,2718,10
92189140125,92189140125,0,718,1540,10
92191094011,92191094010,-1,830,1049,10
92193194934,92193194930,-4,1556,2873,10
92193854017,92193854018,1,6146,21281,10
92196156962,92196156962,0,1185,1921,10
92196801838,92196801837,-1,1111,2763,10
92197807551,92197807551,0,1049,1526,10
92199938279,92199938276,-3,1314,2130,10
92201501129,92201501131,2,1162,2108,10
92207424816,92207424814,-2,1463,2069,10
92209573473,92209573470,-3,936,1355,10
92213966674,92213966671,-3,906,1290,10
92214397599,92214397598,-1,955,1766,10
92216282687,92216282686,-1,1244,1722,10
92220128257,92220128254,-3,1716,2373,10
92220659399,92220659394,-5,1066,3862,10
92224898606,92224898606,0,1200,1478,10
92227055933,92227055929,-4,1687,2349,10
92234814235,92234814234,-1,1279,1832,10
92236076350,92236076349,-1,1023,1495,10
92238150686,92238150687,1,1312,1703,10
92240217602,92240217601,-1,1051,1940,10
92241364142,92241364162,20,1825,1758,10
92241512413,92241512410,-3,1130,2232,10
92242773270,92242773268,-2,1831,2709,10
92242975825,92242975823,-2,1193,2483,10
92244295081,92244295080,-1,1050,1754,10
92244775014,92244775012,-2,1401,1756,10
92245627299,92245627298,-1,1184,1610,10
92245701198,92245701201,3,1596,1606,10
92249994246,92249994244,-2,1351,1517,10
92251044961,92251044958,-3,2413,5018,10
92253050984,92253050985,1,979,1585,10
92254865884,92254865881,-3,1063,2946,10
92257799658,92257799656,-2,1394,2249,10
92258648080,92258648078,-2,1063,1974,10
92259397992,92259397990,-2,1391,2318,10
92262838619,92262838617,-2,1307,2584,10
92264773239,92264773239,0,1472,2822,10
92266534198,92266534198,0,1403,2207,10
92269783263,92269783264,1,873,1296,10
92271105001,92271104997,-4,1212,1621,10
92271856555,92271856555,0,1413,2016,10
92272781750,92272781750,0,1277,1953,10
92273847016,92273847015,-1,1227,1280,10
92274234113,92274234133,20,1220,1849,10
92277209371,92277209370,-1,1208,1866,10
92279363606,92279363607,1,1203,1482,10
92280571655,92280571652,-3,1000,1720,10
92280884886,92280884882,-4,1229,2123,10
92283187891,92283187891,0,816,1617,10
92284424551,92284424550,-1,992,1337,10
92284935993,92284935993,0,1092,1280,10
92287126458,92287126458,0,822,1286,10
92287412339,92287412337,-2,1302,2032,10
92292288678,92292288674,-4,1375,1847,10
92292932289,92292932289,0,903,1383,10
92294711458,92294711457,-1,1346,1729,10
92297922422,92297922420,-2,984,1650,10
92298404995,92298404992,-3,1373,1797,10
92298674110,92298674107,-3,1492,2420,10
92304203821,92304203830,9,1331,1659,10
92304785018,92304785018,0,1218,1855,10
92309490066,92309490065,-1,1165,1416,10
92310729789,92310729784,-5,921,1948,10
92311869718,92311869717,-1,1070,1515,10
92312440157,92312440157,0,1392,2527,10
92316785678,92316785677,-1,1122,1207,10
92318349450,92318349450,0,1181,1495,10
92319644924,92319644922,-2,1592,2269,10
92324264471,92324264470,-1,1054,1985,10
92327874922,92327874914,-8,1171,2123,10
92330108346,92330108340,-6,2001,10009,10
92330414190,92330414190,0,1108,2010,10
92332606511,92332606522,11,11985,36364,10
92334979110,92334979109,-1,984,1945,10
92335069470,92335069475,5,1775,1994,10
92339430307,92339430306,-1,1688,1976,10
92349064909,92349064907,-2,1519,2033,10
92349244926,92349244922,-4,1588,2080,10
92351240455,92351240453,-2,1114,1879,10
92351811403,92351811401,-2,932,1398,10
92354225866,92354225869,3,3472,3238,10
92355095471,92355095469,-2,996,1974,10
92358943710,92358943710,0,563,1160,10
92359464054,92359464052,-2,1326,2421,10
92362203431,92362203430,-1,463,586,10
92362962342,92362962341,-1,1620,1712,10
92363670888,92363670886,-2,1602,2031,10
92363799699,92363799698,-1,672,1320,10
92366395082,92366395081,-1,1301,2176,10
92366979453,92366979453,0,1049,1869,10
92367012593,92367012613,20,913,1527,10
92368848649,92368848641,-8,2021,7089,10
92369407705,92369407706,1,1385,2420,10
92369719583,92369719583,0,1318,2367,10
92371571891,92371571890,-1,1246,1543,10
92374087463,92374087462,-1,1241,2096,10
92376814968,92376814967,-1,908,1900,10
92377700765,92377700758,-7,1295,2484,10
92378052639,92378052638,-1,1310,1634,10
92378942694,92378942692,-2,1174,1534,10
92381676339,92381676338,-1,1462,2118,10
92385900137,92385900137,0,1365,2696,10
92388328572,92388328571,-1,1319,2046,10
92389129903,92389129904,1,1557,1972,10
92390653693,92390653692,-1,1696,2328,10
92392089622,92392089622,0,1126,1296,10
92392890255,92392890255,0,1065,2083,10
92393340507,92393340500,-7,1978,9368,10
92397336271,92397336269,-2,1478,2452,10
92398022020,92398022019,-1,2049,1961,10
92406384590,92406384590,0,1245,1975,10
92406649197,92406649194,-3,1020,1196,10
92412531250,92412531255,5,2421,1324,10
92413587958,92413587958,0,1381,2459,10
92413830643,92413830643,0,1184,1932,10
92416105376,92416105370,-6,580,4133,10
92418252813,92418252811,-2,1650,2649,10
92423319427,92423319427,0,1412,2689,10
92425373893,92425373891,-2,1211,1643,10
92426965664,92426965683,19,1398,1802,10
92427324070,92427324070,0,1139,1665,10
92429915960,92429915958,-2,1323,2189,10
92430735830,92430735826,-4,1178,2443,10
92433190829,92433190830,1,1948,2495,10
92437150767,92437150767,0,1183,1233,10
92437728566,92437728562,-4,807,969,10
92443356991,92443356989,-2,1000,1858,10
92444158493,92444158491,-2,1336,2304,10
92444927056,92444927050,-6,806,4308,10
92445930414,92445930412,-2,1251,1998,10
92449919941,92449919940,-1,1166,1797,10
92452035403,92452035406,3,1520,1785,10
92454110231,92454110227,-4,697,786,10
92457043869,92457043870,1,1364,2140,10
92458963372,92458963369,-3,1498,2659,10
92459696850,92459696849,-1,743,1105,10
92461347706,92461347703,-3,1143,1870,10
92463599439,92463599437,-2,1253,1808,10
92464357141,92464357138,-3,1325,1843,10
92466257395,92466257395,0,1171,2346,10
92474777166,92474777167,1,1193,1874,10
92477331446,92477331446,0,1188,2181,10
92477887258,92477887259,1,975,2044,10
92490737710,92490737710,0,1193,2475,10
92491976478,92491976477,-1,1117,1556,10
92492661162,92492661162,0,1208,1705,10
92492860310,92492860309,-1,684,1059,10
92493879655,92493879654,-1,927,1890,10
92495916243,92495916241,-2,1082,1670,10
92497648338,92497648337,-1,1352,2549,10
92499365839,92499365838,-1,1277,1931,10
92499816550,92499816549,-1,1744,2112,10
92505440395,92505440396,1,1296,1986,10
92509832490,92509832487,-3,1132,1632,10
92510802094,92510802091,-3,918,3265,10
92511318053,92511318051,-2,1061,1297,10
92512323134,92512323134,0,1531,1614,10
92512922298,92512922295,-3,1154,2455,10
92516966394,92516966390,-4,801,1771,10
92517281974,92517281974,0,714,1582,10
92518907886,92518907884,-2,1267,2102,10
92519280960,92519280959,-1,980,960,10
92520010922,92520010922,0,1516,1917,10
92520890066,92520890065,-1,1767,2327,10
92521758530,92521758531,1,635,1260,10
92522819210,92522819210,0,1230,1822,10
92523375145,92523375145,0,1134,1922,10
92523457770,92523457768,-2,1228,1714,10
92525712390,92525712391,1,1721,2504,10
92526266105,92526266101,-4,1207,2077,10
92528796987,92528796986,-1,1050,1583,10
92529970667,92529970665,-2,657,1457,10
92530314791,92530314806,15,866,2325,10
92537477195,92537477194,-1,1673,1863,10
92542899281,92542899281,0,1676,2249,10
92548819368,92548819368,0,1555,2297,10
92550352322,92550352321,-1,900,2003,10
92550501150,92550501151,1,1014,1346,10
92551233687,92551233687,0,729,1500,10
92561639555,92561639553,-2,1689,1387,10
92565646662,92565646662,0,1160,1292,10
92566875594,92566875592,-2,1639,2130,10
92570951643,92570951642,-1,1532,2060,10
92572667021,92572667018,-3,1477,2746,10
92575009858,92575009848,-10,9239,16712,10
92579233518,92579233518,0,1181,1959,10
92580010110,92580010110,0,1307,2673,10
92584085866,92584085866,0,1148,1975,10
92594925751,92594925749,-2,1257,1781,10
92595969960,92595969948,-12,1081,1497,10
92601417016,92601417014,-2,1230,1895,10
92601867573,92601867570,-3,1208,2044,10
92606777570,92606777569,-1,1250,1862,10
92610323768,92610323774,6,3520,1608,10
92611645174,92611645170,-4,1707,3278,10
92612186347,92612186355,8,268,726,10
92613481286,92613481286,0,1191,1570,10
92615435761,92615435755,-6,2328,7914,10
92616339619,92616339619,0,1377,1877,10
92625088747,92625088744,-3,861,2269,10
92625428332,92625428334,2,1128,1805,10
92633134666,92633134662,-4,1134,3447,10
92633623495,92633623494,-1,1372,2491,10
92636745134,92636745132,-2,1220,2313,10
92641424382,92641424382,0,1286,1330,10
92643930399,92643930395,-4,1261,1807,10
92644895042,92644895041,-1,1157,2581,10
92650141679,92650141681,2,1158,1596,10
92651066313,92651066312,-1,986,1855,10
92653832887,92653832886,-1,1798,2415,10
92658365874,92658365874,0,1197,2312,10
92666018187,92666018185,-2,823,2102,10
92675304350,92675304349,-1,1395,2342,10
92676427875,92676427871,-4,1032,1672,10
92677919190,92677919189,-1,1496,2432,10
92678450683,92678450681,-2,1083,1298,10
92678559770,92678559770,0,1205,1905,10
92679294049,92679294047,-2,1539,1975,10
92682361138,92682361138,0,19648,30225,10
92683650046,92683650045,-1,1725,2217,10
92686957138,92686957133,-5,1057,3504,10
92691441801,92691441798,-3,864,1963,10
92693593401,92693593398,-3,1154,2676,10
92699581359,92699581355,-4,1455,2250,10
92701908643,92701908642,-1,1850,1480,10
92706337657,92706337658,1,1116,1948,10
92708032182,92708032178,-4,1050,2827,10
92712686826,92712686826,0,655,1548,10
92715304498,92715304497,-1,1435,1926,10
92716089470,92716089468,-2,987,1913,10
92716378742,92716378740,-2,1495,1455,10
92726018750,92726018749,-1,1107,1658,10
92728512677,92728512676,-1,937,1689,10
92729132264,92729132266,2,1121,1653,10
92731381374,92731381373,-1,1717,2949,10
92732092504,92732092499,-5,1094,2372,10
92733211833,92733211836,3,2365,1764,10
92733251663,92733251662,-1,995,2032,10
92735749926,92735749936,10,17114,30420,10
92735864391,92735864390,-1,1274,2190,10
92736701241,92736701239,-2,1416,1489,10
92739411109,92739411102,-7,610,1850,10
92740982339,92740982333,-6,840,3673,10
92748907330,92748907326,-4,839,2961,10
92748991419,92748991418,-1,1297,2030,10
92751189647,92751189645,-2,1493,3291,10
92752245034,92752245035,1,1285,2427,10
92755833962,92755833958,-4,1269,1855,10
92759390714,92759390713,-1,858,1700,10
92766495798,92766495795,-3,1531,1652,10
92778337662,92778337661,-1,1698,2556,10
92782193518,92782193517,-1,1009,2019,10
92783696863,92783696863,0,880,1719,10
92785428374,92785428373,-1,1340,1641,10
92789584932,92789584930,-2,1419,2079,10
92796699752,92796699749,-3,1341,1639,10
92800228434,92800228431,-3,1473,2702,10
92801477963,92801477962,-1,1087,1661,10
92802018339,92802018338,-1,1146,1553,10
92803259969,92803259967,-2,1257,1657,10
92804128642,92804128638,-4,1705,2550,10
92804919553,92804919551,-2,1260,2747,10
92807254862,92807254866,4,1592,1308,10
92807704941,92807704938,-3,961,1989,10
92808053725,92808053726,1,1423,1907,10
92812783641,92812783642,1,1458,2288,10
92813983102,92813983103,1,1170,1831,10
92814426158,92814426158,0,1463,2582,10
92815513989,92815513984,-5,811,3279,10
92815929880,92815929876,-4,108,932,10
92816602792,92816602794,2,3349,4375,10
92816930977,92816930974,-3,1602,1607,10
92819008466,92819008470,4,1058,1886,10
92819441174,92819441174,0,1370,2246,10
92830448582,92830448581,-1,1544,2084,10
92831095843,92831095841,-2,1273,1965,10
92831834178,92831834177,-1,1231,1727,10
92835873499,92835873502,3,1715,1318,10
92837081331,92837081330,-1,1155,1939,10
92840203066,92840203063,-3,1222,2874,10
92842192233,92842192233,0,1181,1866,10
92846892517,92846892515,-2,1399,2111,10
92849513525,92849513525,0,1490,1918,10
92850743214,92850743213,-1,1210,2335,10
92853901871,92853901866,-5,1291,1898,10
92854793387,92854793385,-2,1221,1655,10
92854929653,92854929649,-4,971,2112,10
92856174483,92856174483,0,1484,1497,10
92863706175,92863706174,-1,1586,1567,10
92865088901,92865088899,-2,724,1300,10
92871427427,92871427422,-5,855,1971,10
92871851643,92871851642,-1,1423,1700,10
92877972840,92877972839,-1,1685,1681,10
92879371202,92879371182,-20,2153,1329,10
92879862954,92879862953,-1,1569,2093,10
92880302054,92880302053,-1,1337,2282,10
92880371827,92880371827,0,1449,2150,10
92880446194,92880446191,-3,856,1904,10
92882045635,92882045636,1,894,836,10
92884123174,92884123173,-1,1303,1808,10
92886288274,92886288276,2,8524,22236,10
92887634059,92887634059,0,1299,1792,10
92889163958,92889163937,-21,1527,1589,10
92890935807,92890935804,-3,1510,2781,10
92891069169,92891069166,-3,1675,2750,10
92894055182,92894055178,-4,583,981,10
92895411241,92895411234,-7,660,1456,10
92897310174,92897310173,-1,1183,1801,10
92899985865,92899985866,1,1215,1472,10
92901602802,92901602801,-1,1048,1532,10
92902923919,92902923918,-1,1250,1831,10
92904750267,92904750265,-2,1776,1529,10
92906682194,92906682194,0,1079,1650,10
92907044458,92907044457,-1,1312,2641,10
92909853183,92909853183,0,1521,3527,10
92915207182,92915207187,5,2314,1900,10
92916236307,92916236306,-1,1594,2710,10
92916922150,92916922149,-1,773,1223,10
92923109746,92923109744,-2,1264,2023,10
92925314257,92925314255,-2,1500,1817,10
92925772885,92925772886,1,1668,1413,10
92929169591,92929169598,7,5554,1582,10
92930744598,92930744594,-4,1241,2559,10
92932827366,92932827365,-1,1450,1311,10
92933514360,92933514365,5,33896,126322,10
92934022014,92934022014,0,816,1305,10
92940589949,92940589950,1,1658,1763,10
92942110850,92942110850,0,856,2329,10
92942942691,92942942689,-2,786,1595,10
92953549087,92953549088,1,1520,1567,10
92956876802,92956876807,5,2094,1395,10
92960245587,92960245585,-2,1172,1898,10
92965180849,92965180848,-1,931,1812,10
92967223510,92967223509,-1,1296,1815,10
92968582117,92968582115,-2,940,1908,10
92969768616,92969768612,-4,1003,1627,10
92970709779,92970709777,-2,1419,2141,10
92971761714,92971761713,-1,1143,1952,10
92976910139,92976910138,-1,616,1687,10
92978076897,92978076894,-3,1313,2322,10
92979265307,92979265306,-1,1246,1724,10
92980083121,92980083121,0,1250,1930,10
92982687415,92982687411,-4,945,3365,10
92986042694,92986042689,-5,1257,1911,10
92986433193,92986433175,-18,288,911,10
92989796421,92989796421,0,1191,1445,10
92990638158,92990638158,0,1483,1698,10
92993694095,92993694090,-5,918,1547,10
92995618565,92995618566,1,1128,1008,10
92997020053,92997020050,-3,981,1505,10
92999049601,92999049598,-3,1259,1843,10
93000516278,93000516279,1,1141,1301,10
93001102858,93001102852,-6,964,2619,10
93001856765,93001856764,-1,1767,2493,10
93002375326,93002375326,0,1362,2252,10
93006607973,93006607973,0,1385,1543,10
93007204398,93007204385,-13,1169,2143,10
93007755463,93007755459,-4,1072,1678,10
93016088912,93016088911,-1,1171,1995,10
93019986422,93019986443,21,950,2610,10
93021928072,93021928070,-2,1282,1688,10
93026035975,93026035976,1,2089,2323,10
93030592680,93030592679,-1,1627,2595,10
93032585042,93032585042,0,985,1004,10
93033932270,93033932269,-1,1582,2311,10
93034927995,93034927993,-2,1378,2209,10
93046197264,93046197262,-2,1009,1411,10
93047501834,93047501835,1,1117,1982,10
93048268304,93048268301,-3,1264,2256,10
93053033749,93053033755,6,6396,2384,10
93054190647,93054190645,-2,1382,2467,10
93055221799,93055221798,-1,1284,1980,10
93056788029,93056788026,-3,1332,2490,10
93058193824,93058193812,-12,1485,2020,10
93061463415,93061463414,-1,1259,2300,10
93061533917,93061533914,-3,1214,1848,10
93065311213,93065311194,-19,20549,41255,10
93066910238,93066910238,0,902,1415,10
93067271364,93067271346,-18,1176,2155,10
93070827225,93070827223,-2,1190,2463,10
93071341361,93071341360,-1,1081,1762,10
93074292330,93074292326,-4,773,2460,10
93075716531,93075716529,-2,1965,2515,10
93082497769,93082497769,0,1241,2051,10
93083429262,93083429261,-1,1222,1711,10
93085047643,93085047639,-4,1155,1293,10
93089415847,93089415843,-4,1310,2006,10
93089916405,93089916405,0,995,1903,10
93092808667,93092808662,-5,959,2057,10
93099520031,93099520027,-4,1243,1963,10
93099661649,93099661667,18,394,795,10
93101967683,93101967682,-1,1280,1812,10
93104355794,93104355810,16,825,2162,10
93106832969,93106832969,0,14346,17841,10
93110752093,93110752092,-1,1411,1405,10
93110850138,93110850137,-1,1179,2238,10
93110929365,93110929371,6,36629,16558,10
93111701168,93111701169,1,1661,1594,10
93112474933,93112474930,-3,1401,3397,10
93112645866,93112645865,-1,922,1865,10
93116498818,93116498818,0,1244,1689,10
93119203733,93119203731,-2,1364,2598,10
93119935751,93119935751,0,1142,1634,10
93125944585,93125944583,-2,1313,2208,10
93126077686,93126077689,3,1386,1010,10
93126780407,93126780406,-1,1355,2251,10
93130841603,93130841603,0,975,1709,10
93134161582,93134161581,-1,1148,2173,10
93134536987,93134536988,1,1414,2133,10
93135425153,93135425135,-18,988,1773,10
93142383750,93142383745,-5,1195,1069,10
93143520109,93143520106,-3,1136,2575,10
93146473190,93146473186,-4,1150,2797,10
93149943347,93149943346,-1,1419,2036,10
93156873622,93156873622,0,739,1051,10
93157229111,93157229110,-1,942,1553,10
93158590709,93158590707,-2,2209,2161,10
93161813866,93161813865,-1,1195,1589,10
93163083479,93163083478,-1,883,1260,10
93164376811,93164376793,-18,1307,1937,10
93168324370,93168324370,0,1500,1637,10
93171339859,93171339857,-2,1113,2317,10
93172853870,93172853869,-1,1660,2679,10
93173911558,93173911559,1,761,1971,10
93175781532,93175781533,1,1086,2746,10
93176149492,93176149491,-1,812,619,10
93179966222,93179966224,2,1294,1860,10
93182739718,93182739717,-1,1183,2486,10
93184147666,93184147667,1,1291,1427,10
93189183730,93189183730,0,1698,1937,10
93189380967,93189380965,-2,1361,2710,10
93190730006,93190730007,1,1174,1578,10
93192352122,93192352121,-1,1212,1682,10
93201529294,93201529293,-1,1119,2662,10
93201721914,93201721907,-7,1500,5877,10
93202583878,93202583878,0,1171,1853,10
93203836965,93203836963,-2,1571,2380,10
93204965851,93204965843,-8,853,1582,10
93207089531,93207089529,-2,820,2976,10
93209244752,93209244753,1,1426,1810,10
93210792171,93210792170,-1,1099,1321,10
93212020137,93212020134,-3,886,2228,10
93212664901,93212664898,-3,1018,1481,10
93215465829,93215465829,0,1407,1800,10
93223077187,93223077186,-1,1367,2305,10
93226039819,93226039823,4,2242,1194,10
93228941894,93228941894,0,1552,2184,10
93230846772,93230846771,-1,1196,2288,10
93233043362,93233043362,0,1080,1880,10
93234195810,93234195808,-2,1470,1621,10
93235943418,93235943417,-1,1242,1861,10
93236187058,93236187057,-1,1136,2047,10
93236543743,93236543741,-2,1245,1379,10
93241756175,93241756174,-1,957,1998,10
93247404203,93247404204,1,1605,1251,10
93252476599,93252476595,-4,1152,1402,10
93254413194,93254413193,-1,1188,2441,10
93254772434,93254772433,-1,1209,1914,10
93261287735,93261287734,-1,1055,1416,10
93268469362,93268469359,-3,1083,1555,10
93269840053,93269840051,-2,2678,3632,10
93271673486,93271673486,0,955,2175,10
93272218263,93272218259,-4,860,2121,10
93274555530,93274555533,3,1171,1580,10
93274606784,93274606783,-1,1316,2226,10
93276457968,93276457969,1,1161,1574,10
93278238595,93278238590,-5,1855,4877,10
93280271830,93280271829,-1,812,1359,10
93280317787,93280317775,-12,1641,2345,10
93282818033,93282818031,-2,1336,1739,10
93283502585,93283502599,14,457,1218,10
93284283979,93284283978,-1,1281,2147,10
93287344700,93287344701,1,1268,1943,10
93288938294,93288938293,-1,1298,1731,10
93290489853,93290489866,13,11341,46819,10
93290741331,93290741330,-1,1042,2197,10
93293103086,93293103085,-1,1068,2467,10
93293315891,93293315907,16,815,925,10
93296451347,93296451348,1,747,2021,10
93297269583,93297269582,-1,1391,2135,10
93299686480,93299686479,-1,1204,1950,10
93300079061,93300079061,0,1314,1039,10
93301095037,93301095042,5,6033,2379,10
93301818906,93301818906,0,1382,1825,10
93304861295,93304861293,-2,1651,2765,10
93310952226,93310952225,-1,1185,1617,10
93313133463,93313133462,-1,1202,1911,10
93313277286,93313277285,-1,1109,2264,10
93313616289,93313616288,-1,984,2009,10
93314039777,93314039773,-4,1207,3005,10
93319458878,93319458877,-1,1469,1893,10
93334768688,93334768689,1,1995,2176,10
93336229506,93336229502,-4,1122,1529,10
93338089237,93338089237,0,1897,2933,10
93339142655,93339142655,0,1103,2760,10
93343332654,93343332652,-2,1353,3070,10
93343871310,93343871304,-6,1748,7380,10
93345704097,93345704095,-2,1746,2414,10
93350002539,93350002543,4,1810,1241,10
93353004294,93353004293,-1,1674,2635,10
93353827174,93353827171,-3,1458,2572,10
93357086104,93357086103,-1,933,1969,10
93358084130,93358084130,0,1733,2144,10
93358235655,93358235654,-1,643,1023,10
93367419239,93367419237,-2,1631,2298,10
93367866821,93367866819,-2,1296,2236,10
93368826563,93368826562,-1,1190,1716,10
93369511134,93369511133,-1,1405,2027,10
93378458566,93378458565,-1,928,1774,10
93381846147,93381846144,-3,1301,2148,10
93385039551,93385039548,-3,1583,2055,10
93389783359,93389783358,-1,1306,2221,10
93399817996,93399817996,0,1356,1978,10
93402500396,93402500399,3,1441,1364,10
93403320661,93403320663,2,1063,992,10
93408776014,93408776014,0,961,2038,10
93411747573,93411747573,0,1080,1571,10
93412718446,93412718443,-3,1622,2380,10
93414953469,93414953469,0,1209,1659,10
93415533203,93415533201,-2,1086,1215,10
93418507005,93418507003,-2,1450,1520,10
93419518909,93419518905,-4,1091,2215,10
93420079599,93420079599,0,1367,1483,10
93421156982,93421156979,-3,1127,1870,10
93423635313,93423635313,0,1404,1819,10
93424495357,93424495360,3,1721,31480,10
93426189226,93426189228,2,1755,2178,10
93427022441,93427022448,7,2898,1249,10
93427304073,93427304067,-6,1760,6197,10
93436154203,93436154201,-2,869,1825,10
93441353246,93441353244,-2,1282,1952,10
93441405634,93441405653,19,851,1868,10
93441595499,93441595498,-1,1324,1688,10
93444945218,93444945218,0,1400,2128,10
93445586531,93445586529,-2,1166,2407,10
93447071619,93447071618,-1,1048,2302,10
93447901899,93447901885,-14,751,1559,10
93450707507,93450707506,-1,1541,1586,10
93451900474,93451900474,0,1000,2307,10
93452225843,93452225846,3,43,686,10
93457375433,93457375431,-2,1276,2104,10
93461433519,93461433522,3,1260,773,10
93462325101,93462325099,-2,1290,1956,10
93463743046,93463743045,-1,1148,2098,10
93463818372,93463818379,7,1828,1559,10
93464350317,93464350340,23,817,68,10
93466849694,93466849687,-7,697,1486,10
93468022848,93468022847,-1,1539,1916,10
93468404074,93468404072,-2,1389,1616,10
93473602995,93473602994,-1,1112,1707,10
93474218595,93474218595,0,1654,2402,10
93476929041,93476929040,-1,920,1307,10
93480233650,93480233652,2,1118,1875,10
93498575571,93498575567,-4,1161,1092,10
93507989580,93507989579,-1,1508,2363,10
93511805147,93511805145,-2,1250,2069,10
93525022250,93525022248,-2,879,2112,10
93527304683,93527304683,0,1059,1832,10
93527366250,93527366253,3,1621,1564,10
93527858073,93527858074,1,1515,1946,10
93535241806,93535241806,0,1283,2069,10
93537181714,93537181713,-1,876,1914,10
93537904717,93537904716,-1,949,1995,10
93542394317,93542394317,0,1834,2405,10
93544380386,93544380382,-4,1207,2004,10
93549528272,93549528271,-1,1641,1917,10
93551497830,93551497830,0,1598,2138,10
93551853722,93551853708,-14,1293,2485,10
93553294839,93553294840,1,896,1921,10
93553565213,93553565212,-1,1294,1967,10
93555493992,93555493991,-1,1886,2732,10
93555748132,93555748129,-3,1153,1426,10
93560508569,93560508567,-2,1492,1561,10
93564559854,93564559853,-1,1799,1977,10
93567816486,93567816483,-3,1266,2219,10
93570024127,93570024125,-2,964,2100,10
93570466344,93570466339,-5,908,1576,10
93572936536,93572936534,-2,1774,2131,10
93578367669,93578367666,-3,1122,2092,10
93585218414,93585218413,-1,1436,3308,10
93586756018,93586756016,-2,1173,1728,10
93591065674,93591065672,-2,971,2214,10
93591933651,93591933650,-1,1185,1923,10
93595518147,93595518146,-1,1268,2171,10
93596195971,93596195977,6,3064,1493,10
93597369775,93597369762,-13,1530,451,10
93601069080,93601069079,-1,1520,2212,10
93602347403,93602347405,2,1192,1451,10
93606874853,93606874852,-1,1045,1148,10
93612529212,93612529209,-3,822,1540,10
93613634293,93613634291,-2,1921,2726,10
93615457840,93615457838,-2,839,1653,10
93617500374,93617500374,0,1666,2134,10
93619361683,93619361682,-1,1303,2181,10
93621074823,93621074823,0,1173,2018,10
93624305057,93624305055,-2,1333,2786,10
93624404601,93624404592,-9,35604,15730,10
93624451587,93624451585,-2,1369,2609,10
93629845541,93629845538,-3,1670,2396,10
93631461311,93631461308,-3,1497,2289,10
93632231014,93632231013,-1,783,1726,10
93632917349,93632917350,1,2120,1842,10
93633680906,93633680906,0,674,1352,10
93642992391,93642992390,-1,1595,2274,10
93648266947,93648266945,-2,1975,2630,10
93655142749,93655142749,0,1451,1939,10
93655784538,93655784535,-3,1085,1791,10
93656883099,93656883098,-1,1396,2646,10
93660205422,93660205420,-2,1506,1607,10
93661197950,93661197948,-2,1028,1238,10
93668857413,93668857412,-1,1414,1660,10
93670855535,93670855533,-2,1231,1888,10
93673329859,93673329858,-1,904,1375,10
93673519123,93673519122,-1,1191,2179,10
93673800718,93673800717,-1,855,1459,10
93676096711,93676096711,0,1244,1025,10
93676810984,93676810981,-3,957,2079,10
93676882819,93676882838,19,434,474,10
93680231487,93680231485,-2,1509,1900,10
93682329822,93682329822,0,1106,2727,10
93682699873,93682699853,-20,1382,1781,10
93684056088,93684056087,-1,1595,2006,10
93686198302,93686198299,-3,1803,4117,10
93686383162,93686383160,-2,1159,2227,10
93687560794,93687560793,-1,1199,2214,10
93688048193,93688048192,-1,1626,2060,10
93689147306,93689147310,4,2928,2169,10
93689209010,93689209008,-2,10768,15456,10
93691358617,93691358618,1,1026,2307,10
93696147331,93696147330,-1,1391,1302,10
93697180006,93697180003,-3,1360,1633,10
93698573895,93698573894,-1,1254,2477,10
93702602742,93702602741,-1,1432,1985,10
93702671418,93702671418,0,1106,1650,10
93716664614,93716664615,1,955,1305,10
93719553866,93719553864,-2,1192,2074,10
93719922411,93719922411,0,1184,1508,10
93722181633,93722181631,-2,789,2285,10
93724654086,93724654086,0,1020,1464,10
93724814742,93724814748,6,53,1087,10
93726028019,93726028017,-2,935,2156,10
93726386951,93726386949,-2,1471,2090,10
93726445144,93726445141,-3,1308,1516,10
93727240079,93727240078,-1,664,961,10
93727696523,93727696521,-2,1578,2762,10
93727891598,93727891598,0,1558,2119,10
93728824895,93728824897,2,2030,2308,10
93729151523,93729151519,-4,1276,1968,10
93732509268,93732509269,1,1215,2331,10
93733340210,93733340208,-2,1150,1385,10
93737337459,93737337458,-1,953,2224,10
93738249259,93738249253,-6,1566,9809,10
93741344442,93741344442,0,1367,2161,10
93741430805,93741430802,-3,1478,2838,10
93742077392,93742077390,-2,1739,2522,10
93742709266,93742709265,-1,1472,2255,10
93744073885,93744073882,-3,997,1823,10
93754665395,93754665393,-2,1890,2626,10
93755440305,93755440306,1,1194,1574,10
93760475897,93760475898,1,1310,1711,10
93761847737,93761847737,0,950,1488,10
93765261168,93765261171,3,2561,2511,10
93769675031,93769675030,-1,715,1158,10
93771248735,93771248734,-1,1148,1249,10
93775066102,93775066100,-2,1123,1746,10
93776513498,93776513498,0,1409,1628,10
93777597505,93777597506,1,1133,2060,10
93778970273,93778970272,-1,911,1781,10
93780617461,93780617461,0,1380,1964,10
93782794418,93782794417,-1,990,2213,10
93788070109,93788070107,-2,986,1517,10
93790409570,93790409568,-2,1209,2041,10
93795212994,93795212993,-1,1628,2302,10
93797597749,93797597749,0,1956,2607,10
93804337834,93804337833,-1,974,1382,10
93806683822,93806683818,-4,986,1835,10
93809542610,93809542608,-2,1103,2144,10
93810882457,93810882441,-16,1080,1849,10
93812286255,93812286248,-7,891,1707,10
93813116627,93813116627,0,1315,1991,10
93814362733,93814362730,-3,1011,1466,10
93815580034,93815580033,-1,1122,2244,10
93818349518,93818349515,-3,1192,1818,10
93818473063,93818473057,-6,893,1615,10
93822910614,93822910613,-1,1392,1582,10
93827086788,93827086786,-2,1088,2062,10
93830565317,93830565319,2,1167,2070,10
93836666825,93836666830,5,1714,1224,10
93838037545,93838037542,-3,1471,2171,10
93838546698,93838546696,-2,813,1548,10
93842147806,93842147805,-1,1147,2008,10
93846521306,93846521303,-3,1700,2886,10
93848929307,93848929303,-4,1117,2097,10
93856362981,93856362977,-4,1306,2419,10
93857609553,93857609553,0,1637,2414,10
93861458969,93861458967,-2,1117,1322,10
93861545201,93861545191,-10,1770,1189,10
93864302165,93864302164,-1,914,1588,10
93869174266,93869174265,-1,1588,2337,10
93871934235,93871934233,-2,1224,1806,10
93873132895,93873132893,-2,1067,2141,10
93877248478,93877248475,-3,1271,1818,10
93880871282,93880871282,0,976,1975,10
93881342462,93881342460,-2,1263,3128,10
93881582723,93881582723,0,1018,1771,10
93886258610,93886258609,-1,687,1647,10
93893862622,93893862621,-1,1528,1827,10
93896193785,93896193782,-3,1179,1651,10
93898365594,93898365591,-3,1330,2554,10
93900520690,93900520687,-3,1097,1881,10
93901627501,93901627499,-2,1653,2151,10
93902721580,93902721577,-3,1127,1932,10
93903863754,93903863753,-1,1233,1782,10
93906360569,93906360569,0,1548,1977,10
93914395763,93914395765,2,1195,1107,10
93917125367,93917125367,0,1621,1186,10
93920425024,93920425021,-3,841,2264,10
93923117353,93923117354,1,666,1284,10
93925013430,93925013429,-1,1150,1823,10
93926279926,93926279926,0,1681,2066,10
93929059939,93929059936,-3,1151,1946,10
93932346391,93932346392,1,1403,1556,10
93937080493,93937080491,-2,1155,2352,10
93937556508,93937556509,1,951,2006,10
93937808209,93937808209,0,1610,1534,10
93938476319,93938476317,-2,1033,1552,10
93942503322,93942503321,-1,1450,1956,10
93950824560,93950824558,-2,911,1045,10
93952275982,93952275981,-1,1399,1923,10
93952930221,93952930218,-3,1194,1714,10
93953115933,93953115931,-2,1724,2203,10
93956804170,93956804169,-1,1382,1760,10
93958955883,93958955883,0,1043,1558,10
93960513130,93960513129,-1,1632,2642,10
93964169964,93964169962,-2,1521,1779,10
93966245846,93966245846,0,1663,1847,10
93966659222,93966659219,-3,831,1239,10
93973057182,93973057180,-2,1494,2948,10
93975782540,93975782538,-2,1549,2111,10
93978451137,93978451137,0,958,1512,10
93986414727,93986414726,-1,1910,1764,10
93986535650,93986535650,0,1155,1976,10
93986857225,93986857224,-1,1177,2200,10
93990741417,93990741413,-4,747,2979,10
93991307567,93991307567,0,1181,1977,10
93992053875,93992053873,-2,1182,2593,10
93996609445,93996609444,-1,1391,2109,10
93997201868,93997201865,-3,1477,1971,10
93997530523,93997530522,-1,957,1525,10
94001160749,94001160747,-2,1194,1983,10
94001772471,94001772469,-2,1177,2001,10
94003743313,94003743311,-2,1310,1965,10
94012316471,94012316470,-1,1078,2074,10
94012718357,94012718356,-1,1087,1598,10
94014670060,94014670060,0,1094,2277,10
94014958929,94014958934,5,1866,1681,10
94015153366,94015153370,4,2924,1753,10
94019038919,94019038918,-1,2154,2853,10
94019247066,94019247063,-3,1227,2323,10
94022253094,94022253094,0,1087,2238,10
94023951876,94023951874,-2,1151,1519,10
94024111609,94024111607,-2,1418,2591,10
94025783489,94025783486,-3,1616,2376,10
94026148941,94026148941,0,995,1517,10
94027959352,94027959358,6,2535,1807,10
94030345541,94030345541,0,606,2329,10
94030888393,94030888393,0,1341,2281,10
94036357654,94036357651,-3,957,1930,10
94044420719,94044420717,-2,862,1884,10
94045768513,94045768510,-3,1124,1873,10
94048079106,94048079103,-3,749,1487,10
94049059963,94049059981,18,295,1980,10
94051216934,94051216933,-1,1121,1900,10
94052294041,94052294041,0,1595,2340,10
94053371946,94053371946,0,729,998,10
94055360605,94055360605,0,1152,1559,10
94057019146,94057019145,-1,761,2298,10
94057707107,94057707088,-19,1219,1912,10
94062290499,94062290497,-2,917,2192,10
94063277218,94063277218,0,1139,1716,10
94071139314,94071139313,-1,962,2149,10
94074560467,94074560468,1,2019,1955,10
94075485710,94075485710,0,912,1264,10
94077286178,94077286178,0,1109,1993,10
94078487527,94078487523,-4,830,2218,10
94079325016,94079325014,-2,1339,1593,10
94080919922,94080919923,1,1387,1802,10
94082850433,94082850432,-1,1130,2226,10
94085002457,94085002454,-3,1385,2050,10
94087362235,94087362236,1,1248,1931,10
94088709694,94088709693,-1,1188,1502,10
94091492434,94091492434,0,642,1211,10
94093176610,94093176611,1,1300,1359,10
94094297834,94094297833,-1,1505,1927,10
94095251011,94095251013,2,1000,1971,10
94098462228,94098462227,-1,1286,1849,10
94098865379,94098865378,-1,638,1376,10
94100640522,94100640519,-3,1234,1596,10
94100754786,94100754807,21,1716,2571,10
94105018098,94105018099,1,1041,1027,10
94109296623,94109296622,-1,1628,2182,10
94110623338,94110623335,-3,19543,14868,10
94117700980,94117700977,-3,1426,1344,10
94118115893,94118115893,0,1223,1458,10
94119000286,94119000286,0,1057,1372,10
94119490530,94119490508,-22,312,7258,10
94122799161,94122799159,-2,1499,1626,10
94126309366,94126309366,0,973,2012,10
94128826596,94128826596,0,1089,1944,10
94129202333,94129202337,4,1811,1662,10
94132157753,94132157751,-2,1533,2881,10
94135697090,94135697091,1,1429,1478,10
94136384821,94136384818,-3,1621,2032,10
94138433409,94138433407,-2,1981,2567,10
94139678415,94139678416,1,1602,1966,10
94146236319,94146236318,-1,867,1493,10
94152132878,94152132877,-1,1227,2612,10
94153694576,94153694575,-1,1194,2347,10
94154619698,94154619696,-2,1318,1883,10
94159683494,94159683493,-1,1032,2227,10
94159976414,94159976410,-4,938,1574,10
94160715050,94160715048,-2,940,1786,10
94166360224,94166360221,-3,1385,2198,10
94166550566,94166550580,14,12681,52985,10
94170889838,94170889837,-1,1560,2220,10
94172745413,94172745410,-3,893,1466,10
94174157179,94174157178,-1,1435,2638,10
94174454909,94174454906,-3,996,1699,10
94175887650,94175887647,-3,1151,2132,10
94177395659,94177395658,-1,1166,1790,10
94177996069,94177996067,-2,1199,2260,10
94183259181,94183259177,-4,1545,2532,10
94185310293,94185310291,-2,1247,1439,10
94188464894,94188464893,-1,890,1503,10
94194435699,94194435697,-2,1078,1801,10
94194832617,94194832616,-1,1031,1506,10
94195393710,94195393709,-1,1393,1750,10
94202886903,94202886901,-2,1212,1549,10
94203611241,94203611238,-3,1395,2978,10
94204798399,94204798397,-2,954,1627,10
94205260011,94205260008,-3,1469,3732,10
94213056587,94213056586,-1,1259,1635,10
94219428496,94219428494,-2,1280,1803,10
94222399012,94222399010,-2,831,1632,10
94222512793,94222512774,-19,1202,2187,10
94227381895,94227381891,-4,1310,1974,10
94227809404,94227809422,18,1218,1897,10
94228412866,94228412865,-1,1261,1916,10
94228534999,94228534994,-5,765,1411,10
94232666798,94232666797,-1,555,1534,10
94233597218,94233597217,-1,1499,2362,10
94242422499,94242422497,-2,1335,2359,10
94242450639,94242450638,-1,872,2436,10
94243239949,94243239948,-1,904,1654,10
94244201295,94244201294,-1,837,1609,10
94244662142,94244662141,-1,1050,1430,10
94249487818,94249487825,7,2414,1268,10
94254247671,94254247668,-3,1094,1573,10
94255525202,94255525201,-1,655,1508,10
94256693406,94256693405,-1,1342,2658,10
94258824886,94258824884,-2,1062,1936,10
94259523798,94259523797,-1,958,1232,10
94261989943,94261989941,-2,1185,1769,10
94264004241,94264004238,-3,1340,2307,10
94264083468,94264083486,18,1139,3223,10
94264373214,94264373213,-1,1030,2115,10
94265679053,94265679051,-2,980,1607,10
94266413457,94266413451,-6,901,4408,10
94268290903,94268290911,8,1444,1809,10
94270821074,94270821094,20,573,2195,10
94273787538,94273787535,-3,1152,1644,10
94278193905,94278193904,-1,1108,1976,10
94283693877,94283693879,2,1575,2238,10
94293265550,94293265550,0,962,1728,10
94294041778,94294041775,-3,1572,1838,10
94295645907,94295645906,-1,1153,1689,10
94296601410,94296601408,-2,1263,2098,10
94299575207,94299575206,-1,1353,3066,10
94301892262,94301892262,0,1230,1509,10
94303411911,94303411909,-2,1300,2106,10
94307451064,94307451070,6,5160,2018,10
94307554015,94307554013,-2,2451,3477,10
94311013751,94311013752,1,638,1195,10
94312017882,94312017882,0,1494,1956,10
94313677474,94313677473,-1,1319,1613,10
94314344159,94314344158,-1,1638,1702,10
94322479103,94322479100,-3,830,1647,10
94326085670,94326085667,-3,1299,2280,10
94328700494,94328700494,0,1273,2152,10
94329091041,94329091042,1,2188,1743,10
94333848602,94333848601,-1,1982,2027,10
94336781067,94336781066,-1,1231,2192,10
94344870926,94344870926,0,1126,1628,10
94349502614,94349502617,3,1204,993,10
94351861286,94351861283,-3,1281,2562,10
94354391417,94354391416,-1,1191,1535,10
94355042899,94355042898,-1,1763,1863,10
94358266711,94358266711,0,1016,1929,10
94359450118,94359450124,6,3634,2217,10
94367400062,94367400058,-4,1733,2545,10
94368082111,94368082107,-4,1404,2785,10
94370432570,94370432570,0,1208,1779,10
94372208573,94372208573,0,792,1580,10
94376233162,94376233162,0,1189,1676,10
94377217300,94377217295,-5,1315,4234,10
94379992326,94379992320,-6,891,2716,10
94385115118,94385115122,4,1577,634,10
94388845338,94388845336,-2,752,1395,10
94391823667,94391823665,-2,1052,1644,10
94391994094,94391994092,-2,1750,2122,10
94397954350,94397954357,7,2069,1234,10
94399249002,94399249002,0,787,1287,10
94408468015,94408468012,-3,1082,1802,10
94411528363,94411528361,-2,1388,2325,10
94412964066,94412964065,-1,1348,2153,10
94417783098,94417783098,0,1101,2060,10
94418548286,94418548284,-2,1450,2808,10
94425284880,94425284878,-2,1228,2761,10
94425322922,94425322928,6,4753,2305,10
94430454131,94430454127,-4,1125,3237,10
94431171565,94431171565,0,853,2002,10
94431847144,94431847142,-2,1513,2484,10
94434231689,94434231686,-3,994,1751,10
94440949200,94440949194,-6,1130,6053,10
94448862099,94448862099,0,1418,1422,10
94449289753,94449289749,-4,1753,2401,10
94449844693,94449844692,-1,1535,2690,10
94451558179,94451558179,0,1568,2442,10
94452236168,94452236167,-1,1723,2754,10
94453558009,94453558006,-3,821,2724,10
94456727946,94456727944,-2,1148,1612,10
94458474362,94458474359,-3,1008,1983,10
94464441627,94464441626,-1,1391,1662,10
94467619341,94467619338,-3,1085,2504,10
94467909969,94467909967,-2,720,1123,10
94471648515,94471648509,-6,1145,3160,10
94474142507,94474142505,-2,1751,1878,10
94474901806,94474901806,0,1284,2220,10
94481336911,94481336910,-1,839,1494,10
94484476794,94484476794,0,1108,2293,10
94486106108,94486106112,4,2401,1556,10
94491376364,94491376370,6,2816,1288,10
94494466543,94494466544,1,1166,1443,10
94496576232,94496576228,-4,1234,2392,10
94496811792,94496811781,-11,308,553,10
94501122687,94501122686,-1,1476,1703,10
94506085770,94506085765,-5,25133,11773,10
94509417114,94509417113,-1,1409,2070,10
94509841362,94509841340,-22,1127,2608,10
94510370619,94510370618,-1,1071,2084,10
94517652367,94517652363,-4,917,2849,10
94518480464,94518480462,-2,1490,1752,10
94519265144,94519265145,1,1396,2249,10
94519479955,94519479953,-2,1207,2233,10
94519647539,94519647539,0,898,1493,10
94519999653,94519999650,-3,1202,2044,10
94522033143,94522033142,-1,1298,1704,10
94522907506,94522907505,-1,1218,1794,10
94524486939,94524486936,-3,1318,2032,10
94524679673,94524679670,-3,1272,1732,10
94530124177,94530124174,-3,877,1471,10
94532077659,94532077641,-18,1187,1779,10
94533147724,94533147723,-1,973,1501,10
94533605730,94533605727,-3,1394,1751,10
94535190732,94535190731,-1,901,1681,10
94537033337,94537033337,0,1259,1651,10
94539406070,94539406066,-4,1243,2866,10
94539564933,94539564930,-3,1692,2268,10
94539691146,94539691146,0,1215,1809,10
94539886867,94539886866,-1,1361,2049,10
94541216805,94541216814,9,13211,29248,10
94544277646,94544277644,-2,1701,1826,10
94546313854,94546313854,0,1254,1578,10
94546442514,94546442513,-1,1010,1620,10
94550349854,94550349853,-1,1601,3078,10
94551760648,94551760647,-1,1256,1933,10
94551827125,94551827123,-2,954,1550,10
94551871661,94551871661,0,6030,19609,10
94552370089,94552370091,2,1538,1886,10
94554774295,94554774294,-1,1277,2007,10
94556399214,94556399215,1,1143,1887,10
94557651869,94557651865,-4,1391,1761,10
94563057894,94563057898,4,1235,620,10
94563478101,94563478101,0,1189,2103,10
94563635515,94563635496,-19,1169,1896,10
94564751929,94564751926,-3,997,1870,10
94566448738,94566448737,-1,922,1390,10
94569365161,94569365159,-2,935,2301,10
94571930486,94571930485,-1,1397,1324,10
94574671922,94574671921,-1,1366,2360,10
94576731559,94576731559,0,1458,1630,10
94579432529,94579432527,-2,1587,2407,10
94579887158,94579887156,-2,1464,2402,10
94581354697,94581354700,3,1325,2617,10
94581467579,94581467577,-2,1561,1969,10
94583552916,94583552913,-3,568,838,10
94585007082,94585007082,0,855,1619,10
94585889418,94585889418,0,1410,2437,10
94589116273,94589116271,-2,1118,2429,10
94589789608,94589789607,-1,1063,1427,10
94590531830,94590531827,-3,1231,1928,10
94591442234,94591442230,-4,1150,1871,10
94591958422,94591958418,-4,1023,2914,10
94596170056,94596170056,0,1789,1816,10
94600715724,94600715723,-1,1435,1843,10
94603190816,94603190814,-2,1660,2395,10
94604487197,94604487197,0,915,1332,10
94609973545,94609973545,0,887,1770,10
94611383542,94611383541,-1,1262,2119,10
94614127290,94614127289,-1,1392,2240,10
94625360513,94625360506,-7,2770,8763,10
94626518495,94626518494,-1,1858,2146,10
94630934997,94630934994,-3,1305,1926,10
94631457174,94631457171,-3,1324,2099,10
94633146238,94633146236,-2,1173,2285,10
94634365710,94634365709,-1,1508,2862,10
94636345105,94636345104,-1,1141,1779,10
94637063106,94637063105,-1,782,1401,10
94642306373,94642306369,-4,1049,1426,10
94646210894,94646210896,2,1577,1223,10
94650466917,94650466917,0,1443,1839,10
94651615668,94651615666,-2,1380,1984,10
94656980274,94656980274,0,689,1082,10
94659718350,94659718348,-2,1180,2456,10
94669388587,94669388588,1,1558,1882,10
94671876059,94671876060,1,1369,1375,10
94673274953,94673274952,-1,832,2069,10
94676287806,94676287805,-1,1340,2224,10
94678118093,94678118098,5,2170,1303,10
94680879879,94680879879,0,1860,2345,10
94683833709,94683833723,14,1253,1313,10
94687065613,94687065609,-4,892,2575,10
94688543390,94688543389,-1,1172,1691,10
94691019323,94691019321,-2,957,1551,10
94693431938,94693431939,1,900,2115,10
94695551196,94695551199,3,2132,1323,10
94698437310,94698437308,-2,1235,2204,10
94700502402,94700502401,-1,1421,2380,10
94701991051,94701991048,-3,1446,2324,10
94702358101,94702358098,-3,1194,1861,10
94704355633,94704355632,-1,1418,3317,10
94705769206,94705769206,0,1878,2599,10
94707335060,94707335057,-3,1517,3885,10
94708025343,94708025341,-2,1026,1787,10
94710360942,94710360938,-4,883,1480,10
94713137789,94713137788,-1,1219,1678,10
94714841430,94714841429,-1,995,1989,10
94715243290,94715243289,-1,1790,2229,10
94719148777,94719148774,-3,1358,3440,10
94720389446,94720389449,3,1079,1480,10
94721765585,94721765586,1,1005,1508,10
94722426886,94722426886,0,1304,1942,10
94722607856,94722607854,-2,1152,2223,10
94724265070,94724265067,-3,939,1888,10
94724817690,94724817687,-3,975,2473,10
94725157874,94725157873,-1,1753,2904,10
94725407949,94725407946,-3,963,1580,10
94726504722,94726504719,-3,717,2277,10
94727827434,94727827432,-2,1061,2301,10
94728818518,94728818517,-1,1977,1783,10
94732222121,94732222120,-1,1117,1670,10
94732612614,94732612614,0,1331,2318,10
94734768910,94734768909,-1,1162,1451,10
94734915370,94734915374,4,2814,1984,10
94742911442,94742911442,0,1378,2529,10
94744485042,94744485039,-3,886,2071,10
94747716601,94747716595,-6,1465,3129,10
94755523527,94755523520,-7,833,5320,10
94756593563,94756593562,-1,1016,1832,10
94764794806,94764794804,-2,1626,2445,10
94764905490,94764905490,0,1311,1545,10
94765339331,94765339331,0,982,1183,10
94771473528,94771473533,5,4179,2383,10
94777253160,94777253158,-2,1830,1976,10
94781599085,94781599085,0,1140,2246,10
94785520266,94785520259,-7,1894,10317,10
94786379661,94786379661,0,1572,2138,10
94793565549,94793565547,-2,1394,2183,10
94800105773,94800105771,-2,1347,2369,10
94801806642,94801806642,0,1080,1799,10
94806582910,94806582909,-1,1162,1817,10
94806613890,94806613888,-2,1380,1927,10
94812280582,94812280586,4,2268,980,10
94813407058,94813407059,1,1102,1955,10
94815127646,94815127644,-2,1351,1991,10
94817625673,94817625673,0,1419,1317,10
94818033267,94818033266,-1,1268,2364,10
94820156022,94820156020,-2,1551,2333,10
94822353422,94822353421,-1,1662,2145,10
94822550590,94822550591,1,580,1294,10
94823681860,94823681862,2,1326,1123,10
94824162346,94824162346,0,1234,2277,10
94828488883,94828488882,-1,842,1282,10
94838691384,94838691381,-3,1308,3259,10
94843631481,94843631482,1,1545,2346,10
94844528489,94844528489,0,1564,1888,10
94853852214,94853852213,-1,1020,1498,10
94860719706,94860719702,-4,651,3292,10
94868038327,94868038327,0,1253,2294,10
94869191366,94869191366,0,1269,2762,10
94871561402,94871561401,-1,666,1263,10
94874524107,94874524104,-3,495,1146,10
94877230771,94877230773,2,1233,1655,10
94877615430,94877615426,-4,973,1426,10
94878397165,94878397164,-1,1277,1788,10
94878429681,94878429681,0,1773,1622,10
94879008735,94879008736,1,1151,1557,10
94880778595,94880778594,-1,1225,1862,10
94881137098,94881137100,2,949,1272,10
94884959339,94884959338,-1,952,1874,10
94888419698,94888419699,1,969,1584,10
94890368951,94890368951,0,1589,2644,10
94896217797,94896217797,0,1488,1637,10
94898008254,94898008254,0,605,2512,10
94898929875,94898929873,-2,1252,2432,10
94899856398,94899856394,-4,1009,2915,10
94902048327,94902048322,-5,1060,1030,10
94905245784,94905245781,-3,1125,1833,10
94906339146,94906339143,-3,1253,1977,10
94907317885,94907317886,1,2074,2524,10
94907714403,94907714402,-1,1780,2574,10
94908319539,94908319540,1,1052,1588,10
94908788366,94908788365,-1,1011,1818,10
94910568358,94910568365,7,2568,947,10
94911443070,94911443068,-2,945,1826,10
94922843030,94922843030,0,1341,1496,10
94923121770,94923121770,0,1326,2289,10
94924395944,94924395925,-19,1464,1519,10
94926116808,94926116806,-2,1028,1746,10
94927189679,94927189684,5,5584,3346,10
94928680931,94928680929,-2,1093,1780,10
94929028934,94929028932,-2,1347,2401,10
94933203098,94933203093,-5,1128,1597,10
94943932439,94943932439,0,1254,1558,10
94945066990,94945066986,-4,1273,1961,10
94946220234,94946220219,-15,1487,1687,10
94952523158,94952523157,-1,1481,2281,10
94954097380,94954097375,-5,1259,4065,10
94958768842,94958768837,-5,797,2309,10
94960743867,94960743867,0,1657,2056,10
94960807703,94960807702,-1,1908,2881,10
94963558721,94963558722,1,865,880,10
94965781422,94965781420,-2,883,1990,10
94971301399,94971301397,-2,1111,1536,10
94972817217,94972817215,-2,1386,1814,10
94973292140,94973292141,1,2008,1746,10
94978323623,94978323624,1,1296,2087,10
94978887989,94978887986,-3,1044,2085,10
94979627111,94979627109,-2,1522,2076,10
94980155513,94980155510,-3,1752,2352,10
94981101793,94981101792,-1,1282,1862,10
94982582064,94982582063,-1,1024,2288,10
94983898824,94983898823,-1,1211,1999,10
94998889295,94998889294,-1,1285,2473,10
94999966458,94999966456,-2,972,1878,10
95003423122,95003423122,0,980,1008,10
95004372599,95004372599,0,1609,1768,10
95012874330,95012874331,1,1590,1727,10
95013069736,95013069736,0,882,1875,10
95014562066,95014562065,-1,735,1954,10
95015794243,95015794245,2,894,1130,10
95016386680,95016386678,-2,1411,1886,10
95017496241,95017496237,-4,957,2520,10
95019508817,95019508814,-3,3679,8143,10
95019580022,95019580020,-2,1040,1938,10
95024000350,95024000350,0,1308,1863,10
95027873490,95027873487,-3,1462,2721,10
95028959733,95028959730,-3,1252,1243,10
95031352174,95031352174,0,1557,2128,10
95033552077,95033552077,0,25502,25737,10
95034246403,95034246404,1,1416,1857,10
95035971312,95035971309,-3,1174,1739,10
95038118378,95038118379,1,1229,1481,10
95038887631,95038887625,-6,1109,3233,10
95043197795,95043197794,-1,1252,1943,10
95043528323,95043528322,-1,1295,2160,10
95051145403,95051145402,-1,842,1332,10
95055126726,95055126725,-1,1178,1637,10
95057674451,95057674450,-1,851,1612,10
95061847081,95061847067,-14,1026,2182,10
95066348503,95066348501,-2,1108,2319,10
95066709241,95066709263,22,1093,2142,10
95067517601,95067517605,4,1683,926,10
95068079002,95068079001,-1,1369,1855,10
95074337824,95074337826,2,1920,1638,10
95075093929,95075093929,0,958,1697,10
95075590430,95075590428,-2,1241,1595,10
95080756276,95080756276,0,1592,1881,10
95090204882,95090204882,0,833,1684,10
95090248353,95090248352,-1,1514,1214,10
95093549858,95093549858,0,938,1399,10
95096252788,95096252786,-2,802,1777,10
95097496059,95097496058,-1,836,1739,10
95097605223,95097605222,-1,944,1574,10
95098429820,95098429820,0,1335,1870,10
95102052680,95102052677,-3,1334,2293,10
95105622696,95105622694,-2,875,2055,10
95108420053,95108420050,-3,1477,1921,10
95110654749,95110654752,3,3205,1923,10
95111012283,95111012286,3,1574,1763,10
95113086249,95113086250,1,1694,1869,10
95114056339,95114056337,-2,1394,2753,10
95114455962,95114455962,0,1025,1660,10
95115443659,95115443658,-1,1457,2014,10
95116281789,95116281789,0,1085,1952,10
95116721022,95116721021,-1,1155,1123,10
95122207731,95122207729,-2,719,1824,10
95122843843,95122843843,0,1200,1531,10
95129287651,95129287646,-5,888,1361,10
95130381481,95130381480,-1,1560,1942,10
95130756145,95130756135,-10,262,1147,10
95131724453,95131724455,2,1455,1419,10
95132762365,95132762366,1,1502,2118,10
95134902485,95134902498,13,1322,1697,10
95139030226,95139030225,-1,1164,1304,10
95141719058,95141719061,3,4386,4027,10
95142067755,95142067754,-1,733,1427,10
95143596080,95143596072,-8,816,2163,10
95144320722,95144320720,-2,1124,1653,10
95145150686,95145150685,-1,1961,2264,10
95146011523,95146011524,1,975,1386,10
95148222001,95148221998,-3,1232,2551,10
95148773310,95148773309,-1,1513,2110,10
95150213872,95150213869,-3,1289,2445,10
95151113063,95151113060,-3,1099,1704,10
95155646616,95155646617,1,1318,2310,10
95155689897,95155689896,-1,1255,2236,10
95156550853,95156550852,-1,967,1846,10
95163083483,95163083478,-5,1223,3557,10
95170049461,95170049461,0,1233,1538,10
95172746102,95172746102,0,1382,1317,10
95177019850,95177019848,-2,1041,2255,10
95178649639,95178649638,-1,975,1790,10
95179302082,95179302078,-4,1456,2008,10
95181142955,95181142953,-2,1143,1991,10
95182949354,95182949353,-1,1184,2039,10
95184018395,95184018394,-1,1015,2466,10
95184139934,95184139932,-2,1456,2036,10
95186736347,95186736347,0,1762,2604,10
95189949085,95189949083,-2,1346,1606,10
95191024619,95191024619,0,935,2109,10
95194628743,95194628742,-1,1059,2174,10
95199122054,95199122054,0,1326,1348,10
95201093199,95201093198,-1,952,2107,10
95203889290,95203889291,1,1268,1585,10
95205217685,95205217685,0,1263,1702,10
95206793328,95206793334,6,1342,675,10
95217019818,95217019824,6,2947,1006,10
95217497233,95217497233,0,791,1583,10
95219328023,95219328021,-2,908,1770,10
95219702508,95219702506,-2,775,1855,10
95220261594,95220261594,0,1111,1930,10
95221225719,95221225717,-2,1102,2030,10
95222688542,95222688540,-2,1319,2399,10
95223144910,95223144909,-1,875,1375,10
95227385323,95227385322,-1,960,1563,10
95232732141,95232732161,20,596,1508,10
95236820212,95236820211,-1,1229,1907,10
95237963704,95237963703,-1,1517,2373,10
95238004575,95238004574,-1,1017,1678,10
95240174350,95240174350,0,1258,1425,10
95241984542,95241984541,-1,1620,1732,10
95242206627,95242206627,0,910,2522,10
95243672599,95243672598,-1,960,1793,10
95246907538,95246907536,-2,1027,1709,10
95249531691,95249531690,-1,1124,1661,10
95250042962,95250042961,-1,579,1637,10
95253859031,95253859030,-1,1221,1895,10
95262445326,95262445325,-1,1268,1833,10
95262473520,95262473539,19,701,1512,10
95264019836,95264019838,2,2817,2492,10
95266631278,95266631278,0,1927,3006,10
95269904721,95269904721,0,1906,2528,10
95272167183,95272167181,-2,1299,1694,10
95278622627,95278622626,-1,1093,1769,10
95278847241,95278847259,18,795,1055,10
95285384634,95285384634,0,1359,2183,10
95290042231,95290042229,-2,898,1715,10
95290232382,95290232382,0,997,1959,10
95293846606,95293846604,-2,2139,3506,10
95295231461,95295231461,0,1617,1948,10
95295442522,95295442520,-2,972,1911,10
95298015983,95298015982,-1,2004,2844,10
95299217672,95299217670,-2,1461,2052,10
95301039691,95301039696,5,2603,1289,10
95304394855,95304394853,-2,702,1531,10
95306742574,95306742572,-2,2063,2506,10
95308907763,95308907761,-2,949,1953,10
95309400216,95309400196,-20,1441,1856,10
95313148515,95313148513,-2,1525,2462,10
95316356819,95316356817,-2,1004,2371,10
95317679245,95317679242,-3,991,1538,10
95318815219,95318815217,-2,1507,3163,10
95323986371,95323986366,-5,2506,7039,10
95327636756,95327636755,-1,1417,1980,10
95327931371,95327931371,0,1633,1975,10
95333971962,95333971958,-4,1359,3414,10
95334430651,95334430650,-1,1125,2199,10
95335943465,95335943465,0,818,1788,10
95338048046,95338048041,-5,1290,4942,10
95338351531,95338351530,-1,850,1290,10
95346741225,95346741225,0,2646,2972,10
95346772815,95346772814,-1,1003,1367,10
95348082142,95348082138,-4,1005,1226,10
95350990010,95350990014,4,1058,1158,10
95352069473,95352069479,6,2481,1136,10
95353199029,95353199028,-1,1000,1750,10
95355613057,95355613057,0,960,1582,10
95360158907,95360158906,-1,1296,2324,10
95366212165,95366212167,2,1381,808,10
95366389263,95366389262,-1,1350,2390,10
95369822249,95369822248,-1,1794,2270,10
95372049378,95372049377,-1,958,1731,10
95376732611,95376732610,-1,1285,1891,10
95380358598,95380358594,-4,1109,1932,10
95380490526,95380490526,0,1139,1433,10
95380732900,95380732901,1,1607,1816,10
95381487827,95381487827,0,1739,1636,10
95384725121,95384725119,-2,991,1177,10
95385002969,95385002969,0,1136,2125,10
95388388914,95388388913,-1,1349,2494,10
95392889109,95392889107,-2,1306,1837,10
95395225743,95395225742,-1,1423,2643,10
95401143754,95401143752,-2,1127,1980,10
95403536306,95403536305,-1,1296,2173,10
95403819319,95403819318,-1,1298,1881,10
95403959872,95403959871,-1,1028,2014,10
95405338226,95405338226,0,1237,2004,10
95405819563,95405819561,-2,1247,2000,10
95406153387,95406153386,-1,1248,1654,10
95409223562,95409223559,-3,1613,1942,10
95409610195,95409610194,-1,820,1792,10
95410074906,95410074892,-14,250,934,10
95412713581,95412713578,-3,1249,2479,10
95414350464,95414350462,-2,909,2229,10
95419654237,95419654238,1,1114,1433,10
95420611419,95420611419,0,1393,2172,10
95421927478,95421927478,0,1288,2245,10
95423456862,95423456841,-21,1354,2180,10
95427084909,95427084909,0,2111,1798,10
95428270410,95428270409,-1,948,1918,10
95428605154,95428605154,0,1194,1567,10
95433279147,95433279149,2,1209,1540,10
95434021986,95434021984,-2,1363,2366,10
95440701806,95440701805,-1,1409,2421,10
95442924515,95442924513,-2,792,1862,10
95443569181,95443569181,0,1293,1173,10
95453015189,95453015189,0,1079,2004,10
95455736934,95455736930,-4,1269,1839,10
95458022052,95458022070,18,345,1016,10
95460523999,95460523998,-1,451,498,10
95462271639,95462271638,-1,1571,1777,10
95464814618,95464814621,3,1713,1475,10
95465937044,95465937041,-3,1176,1388,10
95465987274,95465987273,-1,1449,2511,10
95466721694,95466721700,6,3361,13707,10
95469055198,95469055198,0,1254,2166,10
95469536425,95469536423,-2,1190,1719,10
95471606036,95471606035,-1,1248,1793,10
95474098970,95474098951,-19,1315,1535,10
95476526295,95476526294,-1,1224,2412,10
95478567867,95478567867,0,1223,1701,10
95480778643,95480778641,-2,1084,1191,10
95487900942,95487900941,-1,646,1210,10
95488396327,95488396328,1,1735,1265,10
95493446245,95493446245,0,1476,2660,10
95496935685,95496935683,-2,1055,2309,10
95503233174,95503233170,-4,1234,2612,10
95505998678,95505998688,10,11065,48262,10
95506148594,95506148594,0,820,1412,10
95506375438,95506375438,0,1556,1835,10
95508157814,95508157813,-1,773,1542,10
95509576491,95509576490,-1,1768,3151,10
95510288371,95510288373,2,1162,1612,10
95520157761,95520157757,-4,808,2544,10
95520822635,95520822634,-1,1383,2579,10
95521326519,95521326518,-1,1165,1523,10
95521525410,95521525406,-4,742,1840,10
95522848546,95522848545,-1,2168,1655,10
95524396841,95524396838,-3,1377,3141,10
95524747697,95524747694,-3,1471,2382,10
95525843338,95525843338,0,1152,1737,10
95527926206,95527926203,-3,1054,1534,10
95532923870,95532923869,-1,1592,2210,10
95533055455,95533055454,-1,872,1349,10
95533924087,95533924085,-2,1227,1875,10
95535154154,95535154156,2,1565,1674,10
95535335468,95535335467,-1,314,868,10
95537420519,95537420518,-1,1303,2225,10
95545965382,95545965383,1,1702,2274,10
95546855886,95546855892,6,10860,29943,10
95552510090,95552510090,0,891,1590,10
95552804569,95552804553,-16,800,1150,10
95553054706,95553054705,-1,1806,3045,10
95554117698,95554117693,-5,1181,5002,10
95556479585,95556479585,0,799,2062,10
95557433287,95557433285,-2,1420,2168,10
95558106558,95558106553,-5,1068,3746,10
95558168709,95558168706,-3,1081,2089,10
95561766091,95561766090,-1,1642,1465,10
95562324383,95562324379,-4,891,1490,10
95563232975,95563232974,-1,724,2384,10
95564713698,95564713694,-4,1343,1988,10
95566371533,95566371535,2,2858,4121,10
95572605365,95572605364,-1,1321,2000,10
95573370843,95573370841,-2,1634,1712,10
95575011469,95575011467,-2,1211,2261,10
95577419027,95577419027,0,987,1557,10
95578067062,95578067061,-1,1637,2192,10
95579376408,95579376406,-2,1499,2024,10
95580045667,95580045667,0,780,2054,10
95581616105,95581616106,1,951,1181,10
95588712233,95588712233,0,1024,1823,10
95589846475,95589846460,-15,1433,2042,10
95594032327,95594032326,-1,1134,1747,10
95595836520,95595836521,1,1611,1644,10
95605291130,95605291130,0,1182,1767,10
95610148227,95610148225,-2,1179,2467,10
95611641041,95611641041,0,1070,1331,10
95613331858,95613331856,-2,1397,2190,10
95613987108,95613987107,-1,1404,2146,10
95616742650,95616742648,-2,1147,1957,10
95618347758,95618347758,0,952,1665,10
95618394370,95618394372,2,1585,1194,10
95622063463,95622063460,-3,1346,4036,10
95623203282,95623203281,-1,1589,1942,10
95626119850,95626119847,-3,1212,2791,10
95626218591,95626218585,-6,867,3811,10
95631171499,95631171496,-3,1039,2367,10
95631619105,95631619102,-3,1025,1208,10
95633323281,95633323281,0,1342,2243,10
95641873145,95641873142,-3,125630,54135,10
95648342875,95648342873,-2,1128,2540,10
95649164067,95649164065,-2,1069,2076,10
95649270410,95649270411,1,1382,2122,10
95650276488,95650276486,-2,695,1004,10
95653942207,95653942209,2,1144,1824,10
95655292550,95655292549,-1,1630,2602,10
95657026631,95657026631,0,1242,1251,10
95658821134,95658821133,-1,950,2250,10
95659371763,95659371759,-4,1056,3752,10
95659529299,95659529299,0,1082,1937,10
95660280302,95660280303,1,1346,1549,10
95660385995,95660385993,-2,1211,1306,10
95661500741,95661500738,-3,1498,3409,10
95664158539,95664158539,0,858,2057,10
95664640387,95664640405,18,812,1130,10
95667352664,95667352662,-2,985,1903,10
95668070284,95668070282,-2,899,1761,10
95668342755,95668342749,-6,1171,2420,10
95669637278,95669637274,-4,1243,2477,10
95671755585,95671755584,-1,1602,2307,10
95672629257,95672629277,20,337,597,10
95673337587,95673337587,0,1159,1891,10
95675949422,95675949421,-1,1316,2094,10
95676463814,95676463810,-4,1117,3188,10
95677519560,95677519558,-2,1459,1823,10
95678952838,95678952838,0,1470,1513,10
95680667419,95680667417,-2,1100,2239,10
95683458964,95683458972,8,3079,1408,10
95684237163,95684237162,-1,1449,1848,10
95685276913,95685276912,-1,1481,2035,10
95687882167,95687882166,-1,1906,2576,10
95689075434,95689075433,-1,924,1380,10
95689468002,95689467999,-3,1179,2154,10
95689644526,95689644525,-1,1043,2205,10
95691785759,95691785758,-1,1023,1136,10
95692673044,95692673043,-1,26649,42654,10
95692833140,95692833136,-4,1198,2233,10
95695146418,95695146418,0,1479,2115,10
95699642819,95699642817,-2,1234,1830,10
95708929467,95708929470,3,1792,2116,10
95709357607,95709357606,-1,1203,1294,10
95717847265,95717847262,-3,1251,2622,10
95718742647,95718742646,-1,1035,1491,10
95727600690,95727600689,-1,965,2319,10
95728267086,95728267083,-3,1132,2079,10
95728700311,95728700309,-2,1130,1544,10
95728829642,95728829642,0,1433,1827,10
95731131381,95731131381,0,949,1671,10
95732643835,95732643835,0,2386,3019,10
95732693215,95732693215,0,1418,1838,10
95735278630,95735278628,-2,1177,1531,10
95735694774,95735694768,-6,1414,5786,10
95736658943,95736658942,-1,1215,2474,10
95738330070,95738330069,-1,1160,1807,10
95750603270,95750603267,-3,1096,1816,10
95751795894,95751795890,-4,1460,2318,10
95753676384,95753676379,-5,2092,7195,10
95756154998,95756154994,-4,1622,3037,10
95757883754,95757883751,-3,989,1463,10
95757972922,95757972920,-2,1501,2501,10
95765355965,95765355963,-2,1190,2025,10
95773300062,95773300063,1,1528,1900,10
95775974348,95775974346,-2,1302,2480,10
95777068574,95777068573,-1,1261,1427,10
95778626799,95778626798,-1,1259,2347,10
95778802235,95778802233,-2,988,1609,10
95779650342,95779650335,-7,1208,2952,10
95781033579,95781033578,-1,900,1686,10
95782588277,95782588275,-2,22643,53603,10
95786216149,95786216147,-2,2261,2344,10
95788358781,95788358781,0,1264,1817,10
95788744000,95788744022,22,1094,2323,10
95796535052,95796535051,-1,1331,1479,10
95800498074,95800498074,0,1144,873,10
95801856185,95801856183,-2,1150,2104,10
95803230930,95803230930,0,1137,1298,10
95803581922,95803581927,5,3489,1918,10
95807018321,95807018317,-4,911,851,10
95808041439,95808041437,-2,1001,1473,10
95811035198,95811035195,-3,1277,1652,10
95812735984,95812735983,-1,1548,2212,10
95813079155,95813079155,0,1061,1443,10
95814353909,95814353908,-1,1209,2218,10
95815290213,95815290217,4,1649,985,10
95815652891,95815652889,-2,940,1566,10
95816479826,95816479826,0,1030,1781,10
95821143519,95821143516,-3,1235,1968,10
95821676236,95821676233,-3,884,1624,10
95823364208,95823364208,0,1467,2274,10
95823768525,95823768525,0,847,2113,10
95826863306,95826863305,-1,1601,2593,10
95828148597,95828148596,-1,1281,2041,10
95829185546,95829185543,-3,1391,1490,10
95835131930,95835131928,-2,924,984,10
95835423531,95835423518,-13,1779,2653,10
95836176192,95836176190,-2,896,1679,10
95840867187,95840867185,-2,1541,1610,10
95845020434,95845020431,-3,1262,2686,10
95846058233,95846058231,-2,1458,2087,10
95846992190,95846992189,-1,1946,2798,10
95852360379,95852360377,-2,878,1621,10
95854576007,95854576006,-1,1223,2221,10
95859298090,95859298090,0,1054,1462,10
95859942937,95859942938,1,2740,2477,10
95869770416,95869770415,-1,1436,1892,10
95869893882,95869893879,-3,1178,2273,10
95870365879,95870365878,-1,1487,3168,10
95876899718,95876899717,-1,906,1709,10
95879854223,95879854243,20,3036,1296,10
95880603347,95880603347,0,1080,1949,10
95883887257,95883887255,-2,1481,2306,10
95887272595,95887272594,-1,1083,2238,10
95889253137,95889253137,0,1954,2416,10
95889516983,95889516988,5,1900,1952,10
95891683746,95891683745,-1,1130,1376,10
95897012497,95897012495,-2,1135,1718,10
95901407079,95901407078,-1,1471,1566,10
95902051030,95902051024,-6,1306,3439,10
95905027567,95905027569,2,1169,1606,10
95907350512,95907350511,-1,1036,1519,10
95910170155,95910170154,-1,1142,2025,10
95911143501,95911143499,-2,879,1953,10
95915075022,95915075022,0,1027,2196,10
95917660012,95917660011,-1,877,1770,10
95918824128,95918824127,-1,1309,1813,10
95925560020,95925560019,-1,1423,2346,10
95925933653,95925933650,-3,1236,1789,10
95935355427,95935355427,0,860,1476,10
95938868572,95938868571,-1,703,2090,10
95943482214,95943482212,-2,951,2319,10
95943822217,95943822203,-14,1015,1684,10
95946150210,95946150208,-2,1225,2652,10
95946720185,95946720179,-6,724,1329,10
95949443671,95949443671,0,1334,1841,10
95950803722,95950803721,-1,1073,1423,10
95953165843,95953165847,4,3319,1989,10
95958241377,95958241375,-2,1081,2805,10
95959291654,95959291653,-1,1539,1842,10
95960057501,95960057498,-3,1556,2412,10
95962156207,95962156204,-3,1269,1982,10
95962291638,95962291637,-1,864,1519,10
95968111042,95968111040,-2,1918,2566,10
95970034678,95970034677,-1,1297,2649,10
95970734334,95970734334,0,1227,1991,10
95971244838,95971244841,3,36851,91638,10
95973862481,95973862479,-2,1134,2487,10
95974281645,95974281644,-1,953,1460,10
95975460746,95975460744,-2,1209,2444,10
95977278999,95977278998,-1,1390,2461,10
95984037892,95984037893,1,1343,1455,10
95986892752,95986892750,-2,973,1551,10
95988336717,95988336715,-2,1135,1626,10
95992820279,95992820278,-1,1219,1918,10
95994962014,95994962009,-5,891,2190,10
95995859969,95995859970,1,1054,1615,10
95999270282,95999270281,-1,1189,1995,10
95999402935,95999402932,-3,1208,1918,10
96003300658,96003300657,-1,1658,2607,10
96007678066,96007678063,-3,986,1660,10
96008719086,96008719086,0,1508,1701,10
96009397958,96009397958,0,649,1625,10
96009709478,96009709475,-3,905,2140,10
96013432322,96013432318,-4,1143,1740,10
96014319266,96014319266,0,1288,2668,10
96015339816,96015339817,1,1187,2050,10
96019487882,96019487882,0,812,1338,10
96019702714,96019702714,0,1296,2220,10
96023416649,96023416650,1,2846,2782,10
96027625998,96027625994,-4,1082,2242,10
96031334176,96031334177,1,1972,1509,10
96031461218,96031461218,0,1390,2182,10
96033007389,96033007387,-2,1409,1611,10
96033280720,96033280720,0,1375,1523,10
96034389170,96034389168,-2,975,1117,10
96034676555,96034676555,0,1239,1392,10
96034945529,96034945530,1,1205,1776,10
96035545571,96035545569,-2,1028,2721,10
96038858610,96038858607,-3,1015,1663,10
96042201273,96042201273,0,1136,1303,10
96045377261,96045377260,-1,1372,2152,10
96046934094,96046934091,-3,1132,1966,10
96047050043,96047050041,-2,1630,2237,10
96049762202,96049762202,0,1063,1627,10
96059253935,96059253934,-1,1041,1940,10
96061863562,96061863562,0,1115,1523,10
96063119487,96063119481,-6,2063,9809,10
96072069182,96072069179,-3,19632,14188,10
96072844419,96072844421,2,1455,1856,10
96073780282,96073780283,1,883,1614,10
96073842714,96073842713,-1,1115,1569,10
96074625144,96074625142,-2,1501,2360,10
96076351122,96076351118,-4,1228,1811,10
96078954390,96078954389,-1,744,2128,10
96081081720,96081081718,-2,1035,1774,10
96082459547,96082459546,-1,1189,1793,10
96084395628,96084395627,-1,1178,1580,10
96086815340,96086815347,7,2946,955,10
96091650297,96091650305,8,2353,1286,10
96093067667,96093067668,1,1680,1137,10
96093564143,96093564141,-2,1337,2266,10
96093682450,96093682450,0,1199,2285,10
96095652795,96095652794,-1,809,1603,10
96097439470,96097439467,-3,972,1692,10
96108713522,96108713519,-3,755,1643,10
96110137031,96110137032,1,1641,2183,10
96114334014,96114334014,0,1340,1866,10
96114472409,96114472406,-3,934,1562,10
96116702287,96116702285,-2,1568,2901,10
96121654244,96121654243,-1,1133,1612,10
96122139738,96122139735,-3,944,2550,10
96125468705,96125468703,-2,351,2104,10
96128385758,96128385758,0,1089,1810,10
96130056603,96130056602,-1,845,1460,10
96133424446,96133424458,12,1118,1635,10
96136180970,96136180966,-4,1088,2408,10
96136385722,96136385729,7,2172,1508,10
96137334174,96137334174,0,1261,2068,10
96138494758,96138494755,-3,1496,2771,10
96143652984,96143652982,-2,1237,2041,10
96144191667,96144191646,-21,17,1358,10
96145906669,96145906667,-2,863,1256,10
96149016273,96149016270,-3,1567,2502,10
96149957013,96149957018,5,5563,2823,10
96154726600,96154726598,-2,509,1897,10
96156266553,96156266552,-1,1220,1539,10
96158719205,96158719204,-1,1295,2038,10
96159276514,96159276513,-1,1121,2288,10
96160937235,96160937233,-2,930,2083,10
96161610094,96161610094,0,823,1538,10
96166708250,96166708249,-1,1150,1859,10
96174344991,96174344990,-1,1473,2917,10
96174962622,96174962618,-4,1289,2529,10
96181005286,96181005283,-3,1621,2228,10
96182104010,96182104007,-3,1138,2287,10
96185323313,96185323312,-1,1337,1677,10
96187752686,96187752685,-1,1059,1691,10
96188775191,96188775195,4,976,880,10
96192124206,96192124204,-2,1539,2128,10
96194604554,96194604553,-1,1072,2338,10
96195652003,96195652002,-1,1653,1809,10
96198610297,96198610302,5,1952,1279,10
96199327746,96199327742,-4,1134,2137,10
96204794989,96204794981,-8,1595,7117,10
96205226192,96205226191,-1,1738,2264,10
96205630127,96205630126,-1,592,1013,10
96206015358,96206015357,-1,1238,1671,10
96209082771,96209082773,2,1438,2336,10
96211415715,96211415713,-2,1523,1837,10
96212959098,96212959097,-1,9723,14959,10
96215743518,96215743513,-5,1206,2211,10
96216554732,96216554730,-2,1345,2224,10
96217277927,96217277926,-1,1254,2935,10
96217545663,96217545662,-1,1330,2482,10
96218462266,96218462265,-1,1421,2297,10
96219953810,96219953809,-1,1402,2170,10
96220239051,96220239049,-2,998,1598,10
96221669230,96221669229,-1,1622,2614,10
96221766945,96221766946,1,845,1661,10
96222912149,96222912147,-2,1449,2205,10
96225960890,96225960886,-4,1764,2391,10
96228273161,96228273159,-2,1280,2719,10
96232787671,96232787666,-5,1162,2376,10
96237191687,96237191685,-2,1214,1078,10
96237894535,96237894533,-2,1525,2715,10
96239208575,96239208574,-1,1310,2052,10
96243971105,96243971102,-3,1059,1985,10
96244828827,96244828825,-2,1114,2384,10
96244928275,96244928273,-2,1016,2297,10
96247315925,96247315923,-2,1192,1871,10
96247444296,96247444294,-2,972,1721,10
96249536993,96249536992,-1,1514,2260,10
96249933186,96249933183,-3,811,1488,10
96251857330,96251857329,-1,1949,2205,10
96253440778,96253440774,-4,1370,4873,10
96254986146,96254986144,-2,1484,2169,10
96255110636,96255110634,-2,1280,2302,10
96256135950,96256135947,-3,1096,1466,10
96259420309,96259420308,-1,1008,1655,10
96266155045,96266155046,1,971,1474,10
96267757744,96267757744,0,1678,2480,10
96267783738,96267783734,-4,1055,2044,10
96274087337,96274087337,0,1620,2772,10
96275103918,96275103930,12,1409,1721,10
96275720809,96275720808,-1,4686,5820,10
96275843132,96275843131,-1,1449,2444,10
96276056802,96276056803,1,239,1708,10
96277165685,96277165686,1,850,1500,10
96287739275,96287739274,-1,944,1906,10
96293108264,96293108267,3,2252,2679,10
96293850113,96293850110,-3,1228,1958,10
96296472205,96296472201,-4,1177,1946,10
96298290238,96298290237,-1,1190,1971,10
96298465138,96298465137,-1,1190,2104,10
96299423390,96299423390,0,1258,1490,10
96308736305,96308736305,0,1397,2043,10
96309241171,96309241168,-3,1069,1941,10
96313259174,96313259174,0,1201,1925,10
96313882099,96313882097,-2,1052,3056,10
96314038034,96314038038,4,8824,26462,10
96317843317,96317843311,-6,1355,1985,10
96319391659,96319391656,-3,1208,1634,10
96323032929,96323032926,-3,1357,2299,10
96325368107,96325368105,-2,1034,2723,10
96326923578,96326923577,-1,954,2211,10
96328444466,96328444466,0,1213,1908,10
96334006198,96334006197,-1,1460,2472,10
96334785927,96334785924,-3,1774,2531,10
96336074975,96336074973,-2,994,1905,10
96337288361,96337288367,6,3124,1384,10
96339792134,96339792134,0,1007,1690,10
96343497007,96343497007,0,1611,1955,10
96344196703,96344196703,0,1167,2000,10
96344340499,96344340497,-2,1141,1317,10
96346069735,96346069733,-2,1267,2146,10
96349533772,96349533770,-2,1471,2721,10
96351996463,96351996462,-1,1042,2112,10
96356012522,96356012519,-3,1146,1518,10
96356758975,96356758973,-2,1099,1887,10
96358370865,96358370859,-6,2033,5782,10
96361196898,96361196897,-1,1228,2417,10
96361875916,96361875918,2,1149,1922,10
96364644747,96364644754,7,4336,1697,10
96368456178,96368456174,-4,909,1143,10
96376473007,96376473005,-2,1154,1476,10
96379005860,96379005856,-4,674,1374,10
96379898930,96379898930,0,1649,2281,10
96380248646,96380248646,0,1142,2105,10
96382411709,96382411709,0,955,2015,10
96383284338,96383284338,0,1663,2873,10
96387253602,96387253602,0,1451,2184,10
96387925491,96387925484,-7,40858,19077,10
96392476607,96392476607,0,1419,1908,10
96392890769,96392890763,-6,1433,1951,10
96395425793,96395425792,-1,923,2134,10
96401985194,96401985192,-2,896,1980,10
96402671106,96402671105,-1,1203,1748,10
96403052950,96403052950,0,1531,2118,10
96403380645,96403380642,-3,1236,2246,10
96409473125,96409473122,-3,1270,2224,10
96416735690,96416735686,-4,1939,6197,10
96418932667,96418932668,1,888,1670,10
96421333814,96421333814,0,1589,1978,10
96421582738,96421582736,-2,1275,2193,10
96422408600,96422408597,-3,870,2554,10
96422859872,96422859888,16,681,215,10
96424828851,96424828833,-18,1385,2356,10
96426711215,96426711214,-1,851,1418,10
96427951095,96427951094,-1,1725,2478,10
96429736014,96429736014,0,1680,2239,10
96431466538,96431466542,4,1470,1349,10
96435453862,96435453861,-1,1853,1278,10
96435720713,96435720712,-1,1722,2063,10
96437129822,96437129821,-1,1226,1748,10
96441803638,96441803637,-1,424,685,10
96443941295,96443941294,-1,757,1268,10
96444621220,96444621219,-1,1361,1647,10
96445707525,96445707525,0,1034,2292,10
96447413675,96447413676,1,1110,1850,10
96449127360,96449127358,-2,1039,1297,10
96449194826,96449194806,-20,1221,1752,10
96453103486,96453103481,-5,1000,2433,10
96455705091,96455705087,-4,1956,3924,10
96457034546,96457034547,1,1723,2303,10
96460091342,96460091338,-4,1150,2377,10
96465348195,96465348194,-1,1145,1583,10
96468936474,96468936473,-1,1497,2537,10
96469278934,96469278935,1,1674,1507,10
96472847423,96472847423,0,1428,2108,10
96474099110,96474099110,0,1195,1394,10
96474252891,96474252889,-2,1345,1673,10
96474683233,96474683227,-6,1258,2443,10
96477513410,96477513407,-3,1477,2101,10
96477808010,96477808008,-2,981,1507,10
96478015200,96478015200,0,1536,2140,10
96483634296,96483634293,-3,1930,2659,10
96486024675,96486024673,-2,634,1416,10
96486380322,96486380321,-1,1155,1988,10
96487025162,96487025161,-1,1135,2110,10
96489915582,96489915581,-1,1241,1958,10
96490982803,96490982802,-1,1228,2111,10
96491056778,96491056778,0,1102,1395,10
96491099665,96491099653,-12,1120,2370,10
96491195726,96491195730,4,1893,1294,10
96492747378,96492747377,-1,1585,2468,10
96493120416,96493120414,-2,850,2383,10
96493439908,96493439908,0,821,1475,10
96498153463,96498153462,-1,1010,1357,10
96502287997,96502287989,-8,1200,6178,10
96502700435,96502700455,20,548,979,10
96503244270,96503244269,-1,1076,1691,10
96503479675,96503479674,-1,1103,1723,10
96504960998,96504960998,0,1767,1530,10
96506290518,96506290511,-7,1051,4740,10
96507008967,96507008963,-4,1591,5841,10
96508834018,96508834016,-2,1165,1863,10
96509161304,96509161326,22,488,998,10
96509484182,96509484179,-3,1479,2785,10
96512874579,96512874578,-1,1207,1924,10
96513111921,96513111920,-1,1183,1655,10
96513182439,96513182438,-1,1028,1691,10
96516443795,96516443792,-3,2878,6070,10
96518373767,96518373766,-1,970,1707,10
96519660941,96519660938,-3,1338,1943,10
96522589620,96522589616,-4,1200,3184,10
96525089780,96525089769,-11,1350,2476,10
96526337282,96526337289,7,3186,1139,10
96526375765,96526375765,0,1358,2282,10
96526991240,96526991233,-7,1176,1852,10
96530319667,96530319665,-2,985,1820,10
96530475641,96530475630,-11,1133,2197,10
96533625251,96533625250,-1,1354,1752,10
96533949231,96533949230,-1,1963,2578,10
96534286805,96534286802,-3,803,1574,10
96534346645,96534346643,-2,1665,2667,10
96536085969,96536085968,-1,1090,1205,10
96540102771,96540102770,-1,1034,2077,10
96540832853,96540832846,-7,36074,14043,10
96543525558,96543525555,-3,1292,2504,10
96546141692,96546141687,-5,1781,3367,10
96549460127,96549460125,-2,849,1170,10
96550657673,96550657674,1,1331,1251,10
96555966710,96555966710,0,831,1639,10
96559441501,96559441497,-4,1606,2316,10
96559901583,96559901582,-1,1050,1597,10
96560402974,96560402972,-2,1174,1273,10
96561212370,96561212369,-1,1235,1339,10
96563016517,96563016515,-2,1029,2231,10
96563590743,96563590744,1,21748,23781,10
96565993106,96565993105,-1,895,994,10
96567015803,96567015802,-1,1318,2732,10
96571903962,96571903956,-6,1127,2800,10
96573216696,96573216693,-3,1729,2495,10
96574505152,96574505153,1,1557,1350,10
96580843210,96580843208,-2,1667,2616,10
96582588575,96582588573,-2,2040,2815,10
96583499587,96583499586,-1,1397,1650,10
96584967829,96584967830,1,1129,2080,10
96585274513,96585274511,-2,1416,2583,10
96587196385,96587196383,-2,1070,2460,10
96595212814,96595212813,-1,1135,2092,10
96596856573,96596856577,4,2057,1135,10
96596933773,96596933773,0,1272,1908,10
96597325678,96597325677,-1,992,1645,10
96598482623,96598482621,-2,984,1414,10
96601999289,96601999295,6,2989,1438,10
96605027730,96605027729,-1,1238,1496,10
96608770498,96608770504,6,2480,1487,10
96610691839,96610691835,-4,771,1903,10
96611853835,96611853833,-2,1422,2526,10
96613817031,96613817031,0,437,1000,10
96615174277,96615174275,-2,1231,1600,10
96617190016,96617190013,-3,1413,2654,10
96623375591,96623375588,-3,924,1886,10
96625651368,96625651372,4,1544,1551,10
96628154418,96628154418,0,1492,1899,10
96629206390,96629206371,-19,1041,1965,10
96630066350,96630066353,3,1652,1237,10
96630696482,96630696482,0,1770,2919,10
96633639081,96633639081,0,1219,1893,10
96634416532,96634416535,3,1234,1408,10
96635974515,96635974515,0,1024,1749,10
96639761041,96639761039,-2,1285,2192,10
96640433949,96640433951,2,1720,1198,10
96644435614,96644435613,-1,1086,2236,10
96647513539,96647513539,0,1449,1470,10
96651925514,96651925513,-1,1427,1990,10
96653916854,96653916850,-4,1241,2257,10
96654716160,96654716160,0,1471,1519,10
96655767430,96655767426,-4,918,1776,10
96656714791,96656714789,-2,993,1819,10
96657862859,96657862858,-1,1100,2114,10
96660730622,96660730623,1,949,1497,10
96662742286,96662742285,-1,1024,1852,10
96662897670,96662897680,10,10321,45519,10
96663958409,96663958408,-1,1454,1714,10
96666116869,96666116868,-1,1294,2163,10
96668880472,96668880475,3,1534,1047,10
96670802004,96670802001,-3,1193,2473,10
96671337935,96671337934,-1,1095,2159,10
96671562393,96671562393,0,1030,2042,10
96672184153,96672184157,4,15603,8304,10
96674431394,96674431393,-1,807,1575,10
96679331833,96679331831,-2,1277,1304,10
96685242625,96685242626,1,959,1664,10
96692925072,96692925088,16,968,352,10
96695278004,96695278003,-1,622,1532,10
96697035803,96697035801,-2,777,1472,10
96699094096,96699094095,-1,1404,1750,10
96702302370,96702302365,-5,1226,1850,10
96704041812,96704041811,-1,1197,1396,10
96707481562,96707481563,1,725,1041,10
96707898129,96707898122,-7,1553,1579,10
96710330193,96710330191,-2,1138,1698,10
96710779248,96710779246,-2,1145,1606,10
96724206863,96724206859,-4,680,1656,10
96725112827,96725112826,-1,1151,2051,10
96726019871,96726019870,-1,874,1276,10
96726764561,96726764561,0,1530,1775,10
96726921509,96726921510,1,2047,1602,10
96730951233,96730951232,-1,999,1340,10
96733470438,96733470434,-4,5894,13642,10
96735574938,96735574935,-3,1205,2387,10
96737355443,96737355442,-1,1460,1795,10
96737502771,96737502773,2,2241,1705,10
96738512497,96738512495,-2,1244,1771,10
96741557378,96741557378,0,1157,2005,10
96745144313,96745144314,1,1894,1902,10
96745557326,96745557326,0,1369,2189,10
96748331178,96748331178,0,1077,2218,10
96750749164,96750749161,-3,1325,1882,10
96750915042,96750915040,-2,1433,2162,10
96754042591,96754042590,-1,933,2421,10
96756573222,96756573221,-1,1951,2308,10
96762763978,96762763975,-3,1534,2058,10
96762977458,96762977470,12,612,3480,10
96763091422,96763091421,-1,968,1562,10
96764474561,96764474560,-1,1049,1511,10
96766573151,96766573149,-2,1441,2127,10
96768543510,96768543509,-1,1166,2282,10
96768894219,96768894239,20,1493,1876,10
96777050000,96777049997,-3,1245,2638,10
96779492725,96779492726,1,1310,1593,10
96783364998,96783364997,-1,1593,2065,10
96783726710,96783726714,4,2912,2270,10
96784369807,96784369807,0,1180,1386,10
96787059099,96787059098,-1,1243,1807,10
96790425741,96790425739,-2,1052,1241,10
96796467235,96796467234,-1,1236,1630,10
96799480934,96799480931,-3,1276,1737,10
96801214842,96801214840,-2,1063,2068,10
96802936197,96802936195,-2,1741,2634,10
96803326251,96803326248,-3,1119,2295,10
96803621055,96803621053,-2,1067,1400,10
96803790370,96803790369,-1,4717,8345,10
96804386862,96804386860,-2,1261,2159,10
96806258884,96806258881,-3,1234,1863,10
96809219506,96809219503,-3,1732,2738,10
96810645457,96810645455,-2,812,1222,10
96813045537,96813045538,1,729,1163,10
96814016422,96814016422,0,895,1166,10
96816503833,96816503832,-1,1068,1734,10
96819920401,96819920385,-16,1175,1595,10
96821918046,96821918045,-1,1136,1521,10
96822740410,96822740409,-1,1324,1743,10
96823296409,96823296408,-1,1243,1968,10
96825790257,96825790257,0,1727,2350,10
96827968304,96827968310,6,2042,1502,10
96828241862,96828241860,-2,1267,1826,10
96831139402,96831139405,3,1363,1626,10
96832811301,96832811299,-2,783,1937,10
96838124942,96838124942,0,1609,1753,10
96843155489,96843155505,16,1153,1852,10
96850863121,96850863122,1,1411,1931,10
96853792487,96853792485,-2,1057,2287,10
96854692951,96854692950,-1,891,1488,10
96857855627,96857855625,-2,1237,2214,10
96858023172,96858023171,-1,1226,2877,10
96859668405,96859668405,0,1779,1287,10
96859950295,96859950293,-2,1407,2156,10
96861927297,96861927297,0,863,1962,10
96862266449,96862266447,-2,1927,2645,10
96863355592,96863355593,1,1859,1817,10
96866384210,96866384210,0,1551,1571,10
96867465826,96867465826,0,1124,1806,10
96870538103,96870538104,1,1486,2374,10
96871155760,96871155758,-2,1202,2050,10
96873278094,96873278091,-3,1223,2123,10
96875973703,96875973703,0,874,1574,10
96876012270,96876012268,-2,1225,1765,10
96878648214,96878648210,-4,1240,3806,10
96880881498,96880881497,-1,647,1494,10
96882772190,96882772187,-3,956,919,10
96886016183,96886016181,-2,1697,2789,10
96887082710,96887082707,-3,1182,2148,10
96887710193,96887710191,-2,1768,2025,10
96890902606,96890902607,1,1871,1419,10
96892424243,96892424241,-2,1187,2208,10
96899035703,96899035701,-2,1368,2263,10
96900058238,96900058235,-3,966,2147,10
96901173501,96901173502,1,894,1503,10
96903256599,96903256597,-2,1078,2146,10
96904392591,96904392590,-1,1291,1820,10
96907236094,96907236094,0,1430,1756,10
96908643458,96908643459,1,1160,1498,10
96912630650,96912630649,-1,1229,2087,10
96914988014,96914988014,0,1457,1881,10
96917430575,96917430572,-3,760,1874,10
96918711779,96918711778,-1,1359,1475,10
96922635533,96922635533,0,1427,2254,10
96923411618,96923411637,19,772,1642,10
96923827035,96923827033,-2,1223,2473,10
96933848770,96933848770,0,913,1901,10
96935729653,96935729654,1,1468,1769,10
96936538571,96936538571,0,1370,2218,10
96944704335,96944704337,2,1553,1291,10
96950139637,96950139639,2,1840,1719,10
96951346490,96951346490,0,1113,1808,10
96952170729,96952170729,0,1290,2868,10
96962872993,96962872990,-3,1207,1666,10
96963575306,96963575307,1,837,1406,10
96965854953,96965854950,-3,585,1185,10
96966978299,96966978291,-8,899,1393,10
96967101828,96967101842,14,1030,2163,10
96968838366,96968838364,-2,1599,2642,10
96971365178,96971365176,-2,1241,1582,10
96973544049,96973544055,6,2714,1061,10
96975053286,96975053287,1,1103,1840,10
96978330967,96978330966,-1,550,790,10
96981030407,96981030400,-7,1250,4936,10
96981439410,96981439410,0,975,1551,10
96983473095,96983473098,3,2283,2059,10
96984203051,96984203050,-1,1355,2363,10
96985206800,96985206798,-2,1151,1718,10
96985507945,96985507946,1,2415,2725,10
96986999731,96986999729,-2,2112,3246,10
96990285058,96990285055,-3,1250,1877,10
96991547346,96991547346,0,931,1222,10
96992501553,96992501551,-2,1856,2427,10
96993859230,96993859223,-7,882,5192,10
96996038581,96996038582,1,1727,2252,10
96997978494,96997978495,1,902,1598,10
96998771183,96998771182,-1,1079,2013,10
97001579206,97001579210,4,1607,1057,10
97004233497,97004233493,-4,1467,4022,10
97007062726,97007062726,0,1247,1981,10
97011286694,97011286695,1,903,1094,10
97015792804,97015792802,-2,1310,1567,10
97021236987,97021236986,-1,1083,1670,10
97026162583,97026162580,-3,1319,2033,10
97026313381,97026313378,-3,1068,1749,10
97027216842,97027216842,0,2165,2905,10
97029128370,97029128374,4,2506,2025,10
97036078090,97036078086,-4,1020,2559,10
97037692142,97037692142,0,1069,1689,10
97040328646,97040328644,-2,1800,2287,10
97044182979,97044182978,-1,1385,2109,10
97045092824,97045092822,-2,829,1153,10
97046407634,97046407634,0,1731,3006,10
97052076794,97052076794,0,1160,2196,10
97052279545,97052279544,-1,783,2230,10
97057497330,97057497329,-1,1019,1975,10
97058314087,97058314085,-2,963,1722,10
97058721673,97058721685,12,257,949,10
97060798724,97060798722,-2,929,1640,10
97062590460,97062590458,-2,1845,2135,10
97063558383,97063558380,-3,1127,2106,10
97064584995,97064584992,-3,1470,2334,10
97066269446,97066269445,-1,1979,2600,10
97066705623,97066705620,-3,1358,3523,10
97066826506,97066826506,0,1120,1812,10
97067216177,97067216175,-2,1235,2284,10
97069652734,97069652734,0,1134,1875,10
97071196175,97071196177,2,1775,2439,10
97072450727,97072450726,-1,1368,2114,10
97075320114,97075320114,0,928,1558,10
97075839679,97075839681,2,1108,1878,10
97077873051,97077873049,-2,841,2601,10
97079198991,97079198970,-21,699,1254,10
97079396170,97079396154,-16,1038,1911,10
97081302265,97081302270,5,4262,1637,10
97081725513,97081725511,-2,1259,2063,10
97084229037,97084229037,0,1069,1701,10
97087888995,97087888992,-3,19590,9033,10
97091403396,97091403394,-2,666,2511,10
97091819630,97091819629,-1,1353,3353,10
97093514707,97093514704,-3,1322,2502,10
97096132757,97096132755,-2,1528,2348,10
97100155490,97100155472,-18,1592,531,10
97100878507,97100878513,6,1596,1135,10
97111476145,97111476141,-4,1049,2076,10
97116386944,97116386942,-2,1536,2219,10
97116638359,97116638357,-2,1207,2379,10
97117896202,97117896202,0,1190,2113,10
97121977299,97121977299,0,1202,1942,10
97122145478,97122145475,-3,827,1960,10
97125085086,97125085093,7,3859,1340,10
97125199154,97125199152,-2,1519,2185,10
97125663338,97125663318,-20,729,2354,10
97126796998,97126796997,-1,1368,2169,10
97129100123,97129100123,0,1597,2075,10
97129241987,97129241970,-17,1291,2301,10
97130535515,97130535515,0,939,1729,10
97139618381,97139618377,-4,786,1261,10
97141137001,97141136990,-11,17648,42802,10
97146323636,97146323634,-2,1223,2079,10
97146437879,97146437878,-1,1701,1862,10
97146863645,97146863642,-3,1071,2063,10
97148328731,97148328729,-2,1168,1910,10
97149211083,97149211082,-1,784,1541,10
97149986099,97149986101,2,1791,1670,10
97154094944,97154094950,6,5068,2140,10
97157070555,97157070552,-3,1433,2897,10
97157932058,97157932061,3,3848,2640,10
97158277302,97158277298,-4,991,2320,10
97158896834,97158896831,-3,1242,2644,10
97161503889,97161503886,-3,1818,3405,10
97163394338,97163394341,3,1427,1313,10
97165795018,97165795018,0,1335,2163,10
97168424146,97168424147,1,1534,2301,10
97169508173,97169508173,0,904,1876,10
97170344525,97170344522,-3,952,2364,10
97172711356,97172711353,-3,1207,2835,10
97173639234,97173639234,0,1436,1617,10
97173670937,97173670958,21,682,1309,10
97175735499,97175735498,-1,1017,1568,10
97183285261,97183285257,-4,1149,2624,10
97188758759,97188758758,-1,1312,2280,10
97190783457,97190783455,-2,1341,2011,10
97192287565,97192287581,16,14768,54965,10
97192800093,97192800079,-14,1843,13768,10
97193502066,97193502066,0,1447,1385,10
97193814138,97193814136,-2,961,1626,10
97196984589,97196984593,4,2949,1421,10
97198759045,97198759043,-2,1250,2364,10
97199999074,97199999073,-1,1223,2258,10
97201729174,97201729178,4,4907,3044,10
97201897926,97201897920,-6,685,3742,10
97203910758,97203910758,0,888,1258,10
97206773346,97206773346,0,867,1616,10
97207324038,97207324035,-3,1154,1289,10
97211621755,97211621758,3,2127,1664,10
97215315653,97215315652,-1,1373,1859,10
97216406347,97216406344,-3,850,1681,10
97218878910,97218878910,0,1368,1449,10
97223795983,97223795981,-2,1568,2855,10
97223878247,97223878247,0,1447,1592,10
97224362588,97224362585,-3,1608,2845,10
97227840191,97227840189,-2,1056,2487,10
97228345289,97228345287,-2,1451,1766,10
97232052247,97232052247,0,1437,2023,10
97232944202,97232944202,0,1916,2748,10
97233682971,97233682969,-2,1117,2160,10
97234449220,97234449217,-3,1659,2949,10
97237576657,97237576658,1,1543,1842,10
97239768935,97239768934,-1,1329,2018,10
97240730766,97240730762,-4,1212,2255,10
97242181999,97242181993,-6,1856,5530,10
97245002454,97245002453,-1,1141,2653,10
97247432510,97247432510,0,856,1199,10
97247555123,97247555120,-3,1014,1884,10
97252985387,97252985384,-3,1357,2541,10
97253461630,97253461628,-2,1542,2393,10
97254753290,97254753289,-1,1498,2575,10
97256043471,97256043466,-5,1407,2730,10
97256579029,97256579029,0,1550,2182,10
97260218767,97260218769,2,1596,1717,10
97260699667,97260699667,0,1352,1893,10
97263137421,97263137420,-1,1118,1999,10
97266034328,97266034330,2,1651,1163,10
97266174261,97266174258,-3,1211,2079,10
97267164383,97267164382,-1,1316,1567,10
97269867285,97269867284,-1,1366,2096,10
97270218633,97270218630,-3,1083,2684,10
97270273091,97270273096,5,185,768,10
97271908827,97271908826,-1,975,1214,10
97272033283,97272033283,0,1030,1565,10
97273724945,97273724950,5,2644,1345,10
97274635725,97274635722,-3,1220,1864,10
97274780181,97274780177,-4,1189,2081,10
97275223442,97275223443,1,1156,1707,10
97276301919,97276301918,-1,1129,1513,10
97276558114,97276558098,-16,796,1697,10
97276706805,97276706806,1,801,1325,10
97277269157,97277269156,-1,1556,2374,10
97278167063,97278167062,-1,1047,1784,10
97280279967,97280279967,0,1251,1430,10
97281500338,97281500339,1,1165,1295,10
97282622050,97282622050,0,823,2176,10
97282753743,97282753740,-3,1498,2592,10
97286882681,97286882679,-2,1513,1757,10
97288631299,97288631298,-1,1086,2153,10
97292878647,97292878645,-2,989,1878,10
97293446463,97293446461,-2,1108,2045,10
97304272810,97304272809,-1,1320,1980,10
97307286593,97307286594,1,1839,1314,10
97308347238,97308347237,-1,1100,2270,10
97310068785,97310068785,0,1173,1527,10
97311656374,97311656374,0,1170,1263,10
97314114814,97314114812,-2,588,1685,10
97315072556,97315072554,-2,1494,2140,10
97316429680,97316429678,-2,981,1991,10
97318725251,97318725254,3,1633,1712,10
97327229677,97327229676,-1,1615,2122,10
97328762648,97328762649,1,1064,1602,10
97331216061,97331216062,1,1976,1356,10
97332891433,97332891429,-4,1116,2378,10
97333268789,97333268785,-4,1086,1500,10
97336453623,97336453627,4,80371,67045,10
97336803148,97336803149,1,1493,1876,10
97338404543,97338404542,-1,1151,2642,10
97339867594,97339867592,-2,1640,2590,10
97340412714,97340412710,-4,767,2011,10
97346390987,97346390986,-1,829,1711,10
97348884746,97348884750,4,6644,19867,10
97350868703,97350868703,0,1171,2192,10
97351226065,97351226063,-2,1734,3172,10
97351966629,97351966627,-2,842,1297,10
97353755287,97353755286,-1,1385,2861,10
97357382668,97357382666,-2,975,1680,10
97358913998,97358914000,2,1153,1599,10
97359731841,97359731841,0,1281,2721,10
97363399595,97363399596,1,50022,54088,10
97364972213,97364972210,-3,1192,2041,10
97372967263,97372967265,2,1690,1775,10
97375927383,97375927383,0,1156,2013,10
97378944195,97378944192,-3,967,2175,10
97380083542,97380083542,0,1062,2195,10
97380607846,97380607844,-2,878,1304,10
97382385047,97382385049,2,2619,2240,10
97383326291,97383326287,-4,1574,2035,10
97387116321,97387116317,-4,1090,3351,10
97389599141,97389599138,-3,1059,1877,10
97390031496,97390031482,-14,1297,1938,10
97391514662,97391514661,-1,1567,2611,10
97392081710,97392081709,-1,1609,2088,10
97394426504,97394426510,6,4750,2249,10
97395032657,97395032655,-2,1032,1643,10
97406311855,97406311859,4,985,1089,10
97406432941,97406432941,0,1334,1584,10
97411523119,97411523118,-1,891,1712,10
97412054167,97412054165,-2,1070,2216,10
97412100274,97412100273,-1,961,2165,10
97413648578,97413648578,0,942,1830,10
97414505784,97414505807,23,1206,1889,10
97415763187,97415763185,-2,1509,3072,10
97415876753,97415876754,1,1334,2316,10
97417740573,97417740574,1,544,1123,10
97427799165,97427799162,-3,1297,1472,10
97434790830,97434790827,-3,803,1972,10
97434926880,97434926902,22,1308,2576,10
97437619289,97437619288,-1,1346,2513,10
97442115733,97442115738,5,2218,1115,10
97448109301,97448109298,-3,1229,2366,10
97452317211,97452317210,-1,1168,1799,10
97452920098,97452920095,-3,1309,1979,10
97453021290,97453021289,-1,917,2172,10
97455305022,97455305021,-1,1035,1768,10
97458405591,97458405589,-2,1425,1805,10
97462766067,97462766068,1,8277,31377,10
97463001742,97463001741,-1,1204,2313,10
97464460329,97464460327,-2,1509,2102,10
97466258429,97466258430,1,866,1860,10
97469479122,97469479121,-1,1717,2400,10
97470132434,97470132432,-2,1373,2203,10
97471075792,97471075791,-1,1033,2084,10
97472047761,97472047763,2,1936,1536,10
97472350250,97472350247,-3,2328,3954,10
97472760851,97472760851,0,1873,2154,10
97476014991,97476014990,-1,1210,1569,10
97479190497,97479190494,-3,1333,2656,10
97480228868,97480228870,2,1064,1570,10
97480745402,97480745400,-2,1321,2722,10
97483064188,97483064185,-3,957,1413,10
97485487633,97485487633,0,1484,2160,10
97487294537,97487294537,0,1229,1763,10
97488753499,97488753498,-1,1378,2116,10
97490826302,97490826306,4,1534,1495,10
97494147170,97494147174,4,2459,1955,10
97495069465,97495069465,0,1286,1997,10
97496301730,97496301729,-1,1498,1822,10
97503676354,97503676354,0,1562,1963,10
97504569965,97504569962,-3,1572,2117,10
97510048528,97510048524,-4,1550,2634,10
97514038394,97514038394,0,1334,1800,10
97517444186,97517444181,-5,787,1836,10
97520661434,97520661433,-1,1159,1778,10
97526806554,97526806561,7,2570,964,10
97527486850,97527486849,-1,1105,1924,10
97532151330,97532151330,0,1262,1916,10
97534621783,97534621780,-3,968,2088,10
97541423555,97541423554,-1,1164,2444,10
97545512627,97545512626,-1,430,8152,10
97549457267,97549457263,-4,980,2907,10
97551187314,97551187313,-1,697,1024,10
97552061185,97552061186,1,1309,1859,10
97557077848,97557077844,-4,875,1480,10
97559318065,97559318064,-1,1456,2221,10
97560420711,97560420708,-3,1538,1668,10
97562232473,97562232470,-3,785,1703,10
97564610507,97564610504,-3,1275,2141,10
97567447855,97567447855,0,848,2223,10
97568685839,97568685837,-2,986,1979,10
97574916744,97574916747,3,7067,5079,10
97575092330,97575092330,0,1233,1674,10
97577218686,97577218686,0,1163,2143,10
97578885403,97578885403,0,1349,1142,10
97579321718,97579321718,0,988,1524,10
97579668770,97579668770,0,1158,2109,10
97582169872,97582169874,2,1734,1621,10
97584075371,97584075371,0,371,741,10
97585240932,97585240929,-3,869,1740,10
97586602172,97586602190,18,778,1908,10
97587022691,97587022690,-1,1081,1661,10
97590835433,97590835430,-3,1416,2753,10
97591115691,97591115690,-1,972,1127,10
97599201730,97599201727,-3,1379,2464,10
97601492678,97601492677,-1,1255,1768,10
97607175676,97607175681,5,42213,3084,10
97615133700,97615133699,-1,1535,2777,10
97617165188,97617165186,-2,1249,1792,10
97621185106,97621185099,-7,1023,8134,10
97627162700,97627162698,-2,1217,2564,10
97627410069,97627410068,-1,1121,1375,10
97631119053,97631119051,-2,1231,1755,10
97635539465,97635539471,6,3073,1306,10
97636777170,97636777150,-20,1554,1782,10
97641098294,97641098293,-1,1091,1451,10
97649917354,97649917350,-4,1100,2872,10
97653682054,97653682050,-4,1314,2022,10
97665103590,97665103590,0,1673,2808,10
97670692580,97670692579,-1,1282,2118,10
97672332467,97672332466,-1,1183,2139,10
97672961061,97672961059,-2,1094,2714,10
97674855203,97674855202,-1,1329,2468,10
97675160603,97675160600,-3,1027,2994,10
97675705743,97675705742,-1,1218,2287,10
97676189591,97676189578,-13,2141,12685,10
97681739618,97681739618,0,760,1767,10
97688231965,97688231963,-2,760,1937,10
97688279652,97688279671,19,281,697,10
97690806265,97690806263,-2,1243,2224,10
97692643310,97692643310,0,1336,1724,10
97692962699,97692962697,-2,1397,2610,10
97695182989,97695182990,1,1366,1733,10
97695667514,97695667513,-1,1433,1814,10
97697758351,97697758351,0,1384,1732,10
97699702987,97699702985,-2,1046,2828,10
97702162099,97702162098,-1,1600,1830,10
97708254243,97708254243,0,1208,1896,10
97709044715,97709044713,-2,1955,2443,10
97709204578,97709204577,-1,1164,2224,10
97714767338,97714767342,4,1308,1156,10
97717325002,97717324999,-3,6848,12944,10
97725160247,97725160246,-1,789,1225,10
97735907995,97735907993,-2,1158,2026,10
97737669833,97737669833,0,1656,2332,10
97739135242,97739135239,-3,19499,7266,10
97742332749,97742332746,-3,1549,2546,10
97743955535,97743955531,-4,985,1858,10
97744744546,97744744546,0,1076,1803,10
97747576652,97747576653,1,1239,1406,10
97750842947,97750842943,-4,1019,2053,10
97751939758,97751939755,-3,1245,1952,10
97753432041,97753432040,-1,1419,1863,10
97756277860,97756277858,-2,1344,1588,10
97767682807,97767682808,1,1670,2158,10
97767912579,97767912576,-3,1052,1696,10
97768781215,97768781215,0,1209,1392,10
97771217383,97771217380,-3,1363,2379,10
97774045594,97774045594,0,1309,1803,10
97774529294,97774529295,1,1389,1922,10
97776695898,97776695897,-1,926,1985,10
97777632974,97777632973,-1,1267,1638,10
97783277240,97783277238,-2,1338,2168,10
97788561846,97788561851,5,17,753,10
97792161695,97792161694,-1,1216,2058,10
97796518430,97796518432,2,9253,10693,10
97799743870,97799743869,-1,1311,1300,10
97800619501,97800619499,-2,1535,1644,10
97805226430,97805226429,-1,1355,3301,10
97811686066,97811686065,-1,1052,1238,10
97811767739,97811767737,-2,793,1538,10
97813466440,97813466438,-2,953,1933,10
97816679566,97816679566,0,1463,1302,10
97819698655,97819698654,-1,1521,1694,10
97824222511,97824222511,0,1016,1750,10
97825293611,97825293611,0,794,1452,10
97826212728,97826212729,1,1604,3107,10
97827882247,97827882247,0,1035,1619,10
97828733323,97828733321,-2,1070,2162,10
97829039542,97829039542,0,1058,2065,10
97829123050,97829123049,-1,1715,2251,10
97834801232,97834801230,-2,1158,1903,10
97836276850,97836276849,-1,1289,2218,10
97839629287,97839629286,-1,723,1180,10
97839926682,97839926681,-1,1972,2185,10
97844341455,97844341454,-1,1412,1549,10
97848410493,97848410491,-2,1348,1952,10
97852843611,97852843608,-3,1001,2199,10
97854012782,97854012782,0,877,2356,10
97860149614,97860149610,-4,918,2345,10
97865115814,97865115809,-5,959,1321,10
97865279131,97865279129,-2,1488,2703,10
97865531291,97865531290,-1,888,1595,10
97867691658,97867691657,-1,1038,2255,10
97882279857,97882279855,-2,1386,1934,10
97882890510,97882890509,-1,1117,1562,10
97885039427,97885039426,-1,907,1499,10
97887435982,97887435979,-3,1281,2021,10
97889102436,97889102433,-3,1787,3402,10
97890408883,97890408882,-1,1113,1965,10
97893528218,97893528218,0,1155,2502,10
97898341670,97898341670,0,845,1260,10
97899621437,97899621450,13,18830,6765,10
97912685148,97912685146,-2,1528,3444,10
97912831894,97912831894,0,1196,1340,10
97915300362,97915300361,-1,1354,2107,10
97919102566,97919102582,16,783,1572,10
97923494778,97923494777,-1,713,1565,10
97925061941,97925061930,-11,157,708,10
97932097645,97932097643,-2,1149,2697,10
97934574822,97934574820,-2,673,1497,10
97941680300,97941680298,-2,1538,2380,10
97945185394,97945185394,0,879,1229,10
97946358506,97946358502,-4,1399,2297,10
97946428081,97946428079,-2,997,1522,10
97949948755,97949948756,1,1569,2526,10
97951174894,97951174893,-1,1260,1234,10
97951901419,97951901414,-5,1504,3092,10
97952122881,97952122880,-1,1527,1864,10
97957653074,97957653071,-3,1211,2353,10
97960952789,97960952787,-2,1404,2700,10
97963374109,97963374110,1,1468,2107,10
97969663273,97969663272,-1,797,1708,10
97973484731,97973484731,0,1133,1755,10
97975368713,97975368711,-2,1014,2165,10
97981668083,97981668082,-1,1345,1462,10
97981879822,97981879821,-1,1005,2822,10
97985855686,97985855685,-1,1120,1948,10
97986797904,97986797902,-2,1183,1498,10
97987676142,97987676139,-3,1378,2161,10
97996937283,97996937284,1,1055,1823,10
97997990949,97997990947,-2,1411,2694,10
97998998415,97998998413,-2,1320,2106,10
97999074286,97999074285,-1,1400,2796,10
98002274671,98002274669,-2,1304,2258,10
98002815755,98002815754,-1,1814,2594,10
98008342180,98008342170,-10,1366,1922,10
98008832083,98008832083,0,724,1345,10
98010855397,98010855395,-2,1715,1989,10
98013164476,98013164470,-6,1511,5627,10
98017795855,98017795854,-1,1258,2067,10
98018077269,98018077276,7,6562,2704,10
98023243277,98023243274,-3,1198,1856,10
98025158727,98025158725,-2,1030,1871,10
98025755483,98025755501,18,1543,2472,10
98025857329,98025857326,-3,943,1545,10
98026477445,98026477442,-3,1329,1505,10
98026782262,98026782261,-1,1289,1573,10
98028624757,98028624758,1,1442,1903,10
98031720654,98031720655,1,1323,1217,10
98034355825,98034355826,1,3022,2096,10
98035411092,98035411093,1,1156,1896,10
98043677472,98043677470,-2,1358,2092,10
98044103163,98044103147,-16,24,558,10
98044706803,98044706802,-1,1240,1965,10
98045344739,98045344738,-1,919,1935,10
98051096892,98051096890,-2,1274,2060,10
98051423505,98051423504,-1,1369,1499,10
98054154871,98054154866,-5,1413,1780,10
98055580738,98055580737,-1,1177,2601,10
98058745146,98058745146,0,1351,1792,10
98059286471,98059286465,-6,1101,7194,10
98061164022,98061164016,-6,1880,4982,10
98064322013,98064322011,-2,1314,2188,10
98068402938,98068402937,-1,978,2137,10
98073451512,98073451509,-3,1330,2748,10
98086267324,98086267327,3,4175,2741,10
98087484059,98087484058,-1,1523,1625,10
98087954795,98087954794,-1,1109,1237,10
98088599339,98088599359,20,1412,1812,10
98093422027,98093422026,-1,958,1940,10
98094944906,98094944901,-5,879,1433,10
98095696262,98095696260,-2,1431,2061,10
98097623091,98097623091,0,1575,2482,10
98099843146,98099843145,-1,1277,1547,10
98103405745,98103405747,2,3018,2333,10
98110562805,98110562801,-4,1169,1714,10
98110869245,98110869243,-2,1320,2498,10
98111512812,98111512810,-2,944,2077,10
98112285242,98112285241,-1,1266,2082,10
98114912906,98114912913,7,3454,1204,10
98116985525,98116985523,-2,1035,1873,10
98118171192,98118171189,-3,1342,2207,10
98119622489,98119622489,0,1284,1912,10
98120819842,98120819837,-5,1008,1265,10
98136264499,98136264495,-4,870,2660,10
98138338800,98138338797,-3,1086,1987,10
98138812762,98138812761,-1,859,1395,10
98145194081,98145194081,0,1291,1625,10
98147026917,98147026913,-4,1057,2451,10
98147977003,98147977003,0,984,1838,10
98148037373,98148037372,-1,1468,1701,10
98150431127,98150431126,-1,1165,1808,10
98152410490,98152410486,-4,1263,1351,10
98152587470,98152587467,-3,1770,2280,10
98158811083,98158811082,-1,1376,1802,10
98159836032,98159836015,-17,971,1438,10
98162102334,98162102333,-1,1239,1512,10
98169361427,98169361425,-2,1018,1935,10
98170387630,98170387627,-3,1242,2094,10
98171197582,98171197580,-2,1255,2296,10
98171913821,98171913820,-1,939,1569,10
98174377566,98174377566,0,941,1103,10
98177779068,98177779067,-1,1035,1350,10
98180734475,98180734474,-1,1013,2287,10
98184774279,98184774278,-1,1454,1467,10
98187697075,98187697072,-3,1281,3092,10
98188962417,98188962416,-1,1396,2547,10
98192187896,98192187896,0,1435,2051,10
98193755006,98193755006,0,1589,2263,10
98194991187,98194991187,0,344,901,10
98200327718,98200327714,-4,789,1419,10
98200422494,98200422490,-4,1463,1979,10
98201647313,98201647310,-3,798,1613,10
98203411823,98203411822,-1,967,2005,10
98205512684,98205512683,-1,1361,1640,10
98209632407,98209632405,-2,917,2465,10
98210728957,98210728956,-1,991,1654,10
98211484397,98211484395,-2,898,2380,10
98211630676,98211630680,4,128,827,10
98213042673,98213042670,-3,984,2112,10
98213370058,98213370074,16,1100,2149,10
98213583542,98213583540,-2,674,1462,10
98215042714,98215042734,20,940,4251,10
98218268817,98218268818,1,1434,1525,10
98218833423,98218833421,-2,1533,2389,10
98234235599,98234235599,0,1157,2363,10
98235320964,98235320962,-2,905,1419,10
98242462561,98242462559,-2,1498,1751,10
98244921591,98244921589,-2,1584,2740,10
98247933657,98247933655,-2,1102,2458,10
98260415512,98260415515,3,1417,1050,10
98264491110,98264491111,1,1399,1963,10
98274498934,98274498935,1,825,1470,10
98275444602,98275444590,-12,976,1635,10
98275512404,98275512421,17,637,3001,10
98275838385,98275838382,-3,1354,2257,10
98276708722,98276708720,-2,1450,2416,10
98283146790,98283146789,-1,1068,1971,10
98286776658,98286776655,-3,1523,2069,10
98287490491,98287490489,-2,1614,2486,10
98294613368,98294613368,0,1238,1785,10
98295437363,98295437360,-3,1925,2588,10
98295708870,98295708867,-3,1169,2179,10
98297656706,98297656703,-3,805,1367,10
98303016059,98303016057,-2,797,1452,10
98307696231,98307696232,1,1096,2034,10
98310805898,98310805898,0,2099,2164,10
98310904591,98310904590,-1,1225,2335,10
98315357556,98315357556,0,1223,2658,10
98316862476,98316862473,-3,1104,2615,10
98317141070,98317141070,0,1252,999,10
98319402190,98319402189,-1,1286,1979,10
98322102822,98322102825,3,1259,1392,10
98322274998,98322274994,-4,1388,1880,10
98322838462,98322838459,-3,1200,2185,10
98324483548,98324483545,-3,1030,1727,10
98324831006,98324831004,-2,1152,2095,10
98333027614,98333027634,20,758,1122,10
98333388428,98333388423,-5,2851,6548,10
98334013875,98334013869,-6,1244,3507,10
98335496470,98335496470,0,1333,1140,10
98338671035,98338671035,0,1442,1980,10
98351228809,98351228809,0,1377,2429,10
98352957103,98352957101,-2,947,1550,10
98354768366,98354768377,11,1376,955,10
98357543378,98357543377,-1,1239,2063,10
98358563741,98358563739,-2,1640,1988,10
98359916161,98359916160,-1,1200,2902,10
98362606302,98362606302,0,1576,2015,10
98363879422,98363879421,-1,1656,2247,10
98364810362,98364810362,0,1036,1752,10
98369461441,98369461446,5,1873,1155,10
98370405590,98370405587,-3,1384,1892,10
98370581159,98370581158,-1,1332,2240,10
98371736615,98371736610,-5,763,968,10
98373586675,98373586673,-2,1289,1806,10
98373853833,98373853832,-1,1555,2178,10
98376327337,98376327337,0,911,1076,10
98400380074,98400380075,1,1120,1952,10
98403123124,98403123123,-1,1563,2290,10
98404767258,98404767257,-1,1025,2050,10
98405556949,98405556954,5,2785,1496,10
98406328413,98406328410,-3,1113,2120,10
98407716519,98407716518,-1,1124,2180,10
98408944298,98408944295,-3,1363,2346,10
98410917050,98410917050,0,1718,2104,10
98411236069,98411236067,-2,1493,2022,10
98412345526,98412345524,-2,1115,2093,10
98414514029,98414514027,-2,1246,2007,10
98414957332,98414957315,-17,355,10025,10
98415924479,98415924478,-1,1190,1437,10
98419035431,98419035427,-4,901,2282,10
98424078025,98424078022,-3,1998,4464,10
98425829790,98425829789,-1,1150,2705,10
98431432710,98431432707,-3,842,1486,10
98431746423,98431746421,-2,849,1528,10
98432028720,98432028712,-8,1985,9847,10
98433563911,98433563910,-1,1811,2459,10
98434861279,98434861279,0,1248,1655,10
98434931570,98434931568,-2,872,2267,10
98435626138,98435626136,-2,1552,1767,10
98438750481,98438750481,0,1043,1308,10
98443734050,98443734049,-1,1236,2260,10
98443911193,98443911213,20,1341,2966,10
98444175187,98444175179,-8,14,622,10
98446722426,98446722423,-3,1433,1971,10
98450239851,98450239829,-22,1098,1655,10
98450790438,98450790437,-1,797,1384,10
98451833267,98451833266,-1,882,1801,10
98453728533,98453728534,1,1472,1900,10
98454688338,98454688338,0,1096,1952,10
98454967926,98454967925,-1,1309,1630,10
98467563521,98467563521,0,825,1175,10
98469131676,98469131673,-3,1286,1988,10
98476493469,98476493486,17,526,1819,10
98483835727,98483835726,-1,1023,1495,10
98487717731,98487717729,-2,1029,2282,10
98488224791,98488224797,6,2332,1494,10
98489082545,98489082544,-1,1044,2128,10
98489745662,98489745663,1,1044,1539,10
98490935862,98490935857,-5,1556,3946,10
98491229131,98491229128,-3,881,1591,10
98494829021,98494829022,1,1326,2256,10
98495064564,98495064564,0,24126,17420,10
98496903578,98496903576,-2,1550,1849,10
98498324309,98498324306,-3,1361,1763,10
98501788554,98501788550,-4,1981,4683,10
98503633309,98503633305,-4,1321,1853,10
98504185938,98504185938,0,1634,2172,10
98505330923,98505330918,-5,1039,4636,10
98507511504,98507511502,-2,1529,2257,10
98508257937,98508257934,-3,1469,2529,10
98509141528,98509141526,-2,790,1429,10
98510840230,98510840238,8,3080,1690,10
98511789295,98511789294,-1,1102,1339,10
98514845955,98514845953,-2,1202,1661,10
98517667078,98517667078,0,1052,1659,10
98518662839,98518662838,-1,1700,2502,10
98519138223,98519138223,0,1202,1606,10
98521865103,98521865098,-5,998,2780,10
98522425328,98522425350,22,234,534,10
98523596581,98523596579,-2,868,2340,10
98523945242,98523945241,-1,1396,2491,10
98525678296,98525678297,1,1390,1719,10
98529575782,98529575783,1,1153,1666,10
98539176707,98539176705,-2,969,2316,10
98540074189,98540074186,-3,1363,2124,10
98544100483,98544100482,-1,1369,1910,10
98545084588,98545084584,-4,2646,5532,10
98547217411,98547217410,-1,850,1951,10
98551191410,98551191409,-1,940,1701,10
98559091353,98559091350,-3,1550,2931,10
98562163386,98562163384,-2,1353,1807,10
98562916626,98562916627,1,819,2234,10
98563692697,98563692694,-3,1607,2689,10
98565094004,98565094005,1,1291,1840,10
98565320539,98565320522,-17,350,724,10
98569042493,98569042501,8,3518,1431,10
98570755573,98570755571,-2,1088,2047,10
98571450773,98571450772,-1,746,1555,10
98571813159,98571813158,-1,1559,2295,10
98577274358,98577274358,0,1915,2065,10
98577630887,98577630884,-3,831,1678,10
98579030214,98579030214,0,1062,1920,10
98580239902,98580239901,-1,1073,2126,10
98582680898,98582680897,-1,1414,1590,10
98583372484,98583372482,-2,1075,1693,10
98586931014,98586931015,1,1311,1953,10
98588751902,98588751901,-1,1351,1693,10
98589617118,98589617118,0,1111,1387,10
98600832775,98600832775,0,1069,1868,10
98601557650,98601557650,0,929,1823,10
98604157542,98604157540,-2,1221,1796,10
98604898243,98604898242,-1,1437,2000,10
98607582557,98607582554,-3,1066,1262,10
98608651842,98608651838,-4,1389,2219,10
98613071401,98613071397,-4,922,2421,10
98613257533,98613257531,-2,1365,1433,10
98617077638,98617077636,-2,1173,1791,10
98622221669,98622221667,-2,1639,1775,10
98624231895,98624231894,-1,1048,1554,10
98624299834,98624299855,21,1186,1871,10
98624701406,98624701403,-3,1350,2297,10
98628673642,98628673642,0,1100,1459,10
98636157782,98636157764,-18,1071,1912,10
98637238504,98637238514,10,14547,23633,10
98637694673,98637694670,-3,2021,3345,10
98642009014,98642009012,-2,2013,2727,10
98645125907,98645125905,-2,1212,1762,10
98646190597,98646190597,0,1680,2948,10
98646838457,98646838456,-1,1205,2659,10
98646884190,98646884189,-1,1003,1744,10
98647555234,98647555233,-1,893,1524,10
98649748023,98649748016,-7,1939,11643,10
98651022102,98651022101,-1,1448,2450,10
98653145407,98653145406,-1,676,1763,10
98655818331,98655818339,8,3566,1159,10
98657440143,98657440141,-2,1463,2565,10
98659952445,98659952442,-3,1430,2527,10
98660349407,98660349408,1,854,1404,10
98663488266,98663488264,-2,1225,1569,10
98670022371,98670022370,-1,1020,2280,10
98675584086,98675584085,-1,2193,3599,10
98678708454,98678708455,1,1123,1876,10
98678782347,98678782329,-18,1097,2221,10
98681098695,98681098694,-1,1227,1317,10
98681429194,98681429213,19,844,1811,10
98685609244,98685609246,2,1744,2258,10
98687011114,98687011112,-2,1389,2543,10
98688356933,98688356931,-2,1597,3318,10
98691373339,98691373338,-1,1163,1942,10
98692587966,98692587971,5,2106,1106,10
98693423268,98693423269,1,893,1206,10
98695899180,98695899180,0,1273,2825,10
98699779645,98699779643,-2,1218,1456,10
98705599618,98705599618,0,1224,1532,10
98706344677,98706344676,-1,1452,2669,10
98711437870,98711437868,-2,1127,2336,10
98712845147,98712845148,1,1141,1731,10
98713037362,98713037365,3,1295,1295,10
98714351424,98714351423,-1,1252,1407,10
98715814695,98715814689,-6,1111,2852,10
98720310741,98720310741,0,1358,1545,10
98721014970,98721014966,-4,1050,1968,10
98727751908,98727751907,-1,1334,1962,10
98730587093,98730587091,-2,1419,1823,10
98735273591,98735273586,-5,982,3368,10
98736763655,98736763652,-3,1033,1775,10
98736850369,98736850367,-2,1061,1912,10
98737575868,98737575885,17,991,1697,10
98737871316,98737871314,-2,1196,1365,10
98739063925,98739063922,-3,1419,2148,10
98739441966,98739441965,-1,814,2465,10
98740175491,98740175486,-5,1175,2420,10
98741041964,98741041982,18,462,988,10
98741474061,98741474062,1,2086,1448,10
98742235985,98742235986,1,1727,1906,10
98742932334,98742932338,4,1806,989,10
98743809856,98743809855,-1,1401,1935,10
98744184945,98744184945,0,1235,1542,10
98744900551,98744900550,-1,1111,1715,10
98745685514,98745685519,5,1300,1476,10
98746042134,98746042134,0,1712,2165,10
98746833206,98746833204,-2,868,1633,10
98750879132,98750879137,5,1873,957,10
98753519363,98753519364,1,1430,1327,10
98754139027,98754139026,-1,1031,1765,10
98755588145,98755588142,-3,996,1802,10
98756852561,98756852561,0,1128,2093,10
98759925586,98759925590,4,1855,995,10
98762009185,98762009182,-3,1341,1911,10
98763731173,98763731166,-7,1282,3439,10
98764499835,98764499834,-1,1085,2202,10
98765097191,98765097189,-2,748,1929,10
98773814006,98773814006,0,1337,1802,10
98789190553,98789190550,-3,1429,2355,10
98791203414,98791203408,-6,661,2062,10
98796998539,98796998538,-1,1094,2254,10
98797746586,98797746582,-4,1650,3047,10
98797927450,98797927451,1,1217,1944,10
98798432768,98798432763,-5,864,1553,10
98799282342,98799282342,0,1220,1905,10
98800667672,98800667671,-1,1322,1886,10
98804732868,98804732868,0,1656,1886,10
98808567726,98808567723,-3,1303,1823,10
98817635260,98817635258,-2,1401,1796,10
98818089678,98818089675,-3,1780,2156,10
98818816206,98818816207,1,1355,1861,10
98818842243,98818842259,16,1332,5142,10
98819323072,98819323070,-2,1170,2143,10
98821246645,98821246642,-3,1746,2670,10
98822904569,98822904566,-3,1053,2158,10
98826045417,98826045413,-4,1282,2684,10
98826990965,98826990966,1,1276,2329,10
98827108775,98827108774,-1,919,1386,10
98830338857,98830338856,-1,1385,2029,10
98831414231,98831414229,-2,1266,1931,10
98832945774,98832945775,1,996,1355,10
98833784643,98833784630,-13,1320,2088,10
98835159908,98835159931,23,1511,2229,10
98840210184,98840210181,-3,4066,14604,10
98840574625,98840574622,-3,1768,3350,10
98841638702,98841638699,-3,1467,2190,10
98844050086,98844050087,1,965,1658,10
98844417683,98844417681,-2,1384,2195,10
98844956538,98844956536,-2,1113,1898,10
98850678603,98850678598,-5,1139,4112,10
98852053103,98852053104,1,1274,1764,10
98858873839,98858873837,-2,1285,1916,10
98864163858,98864163838,-20,800,2098,10
98867677882,98867677891,9,1398,721,10
98867956382,98867956382,0,1489,2637,10
98873027118,98873027117,-1,1218,2083,10
98875441290,98875441289,-1,1231,2032,10
98875953756,98875953756,0,1082,1742,10
98887441399,98887441401,2,883,1419,10
98898221309,98898221309,0,1381,1519,10
98898897047,98898897046,-1,1169,1245,10
98903245772,98903245765,-7,1149,1884,10
98903457234,98903457225,-9,1333,4280,10
98904581507,98904581507,0,654,1805,10
98904921274,98904921262,-12,1388,1918,10
98905545566,98905545565,-1,904,2008,10
98909281577,98909281577,0,1055,1696,10
98910378875,98910378875,0,1137,2381,10
98911191583,98911191582,-1,1107,1647,10
98911640474,98911640473,-1,1432,1447,10
98911995237,98911995234,-3,848,984,10
98914497651,98914497650,-1,1094,1530,10
98916536026,98916536026,0,923,1574,10
98919023803,98919023802,-1,1278,2287,10
98920164489,98920164486,-3,1042,2164,10
98922490737,98922490758,21,81,1075,10
98925988196,98925988195,-1,1302,1397,10
98927421850,98927421849,-1,1215,1870,10
98927514486,98927514487,1,1726,1418,10
98929538103,98929538097,-6,991,2795,10
98930066328,98930066327,-1,1430,1310,10
98931742255,98931742254,-1,1652,1968,10
98932398535,98932398533,-2,640,805,10
98935335697,98935335694,-3,1220,1335,10
98941162682,98941162681,-1,1513,1798,10
98944428102,98944428101,-1,1490,1971,10
98945114074,98945114074,0,946,1659,10
98945950752,98945950750,-2,1468,2799,10
98946432535,98946432534,-1,1480,2122,10
98946869005,98946869004,-1,871,1575,10
98948240023,98948240021,-2,1080,1941,10
98948393782,98948393779,-3,1276,1542,10
98956025330,98956025329,-1,1570,2609,10
98956188136,98956188135,-1,908,1538,10
98956791634,98956791633,-1,1587,2197,10
98957438082,98957438082,0,1211,1370,10
98965323121,98965323104,-17,1883,966,10
98966318823,98966318822,-1,1560,2601,10
98968877930,98968877934,4,1791,1219,10
98970970470,98970970470,0,926,1784,10
98971465545,98971465542,-3,1818,3885,10
98975417670,98975417669,-1,1222,2128,10
98976369049,98976369045,-4,1435,2362,10
98980837202,98980837197,-5,977,1950,10
98983191451,98983191449,-2,1386,1750,10
98984059719,98984059717,-2,1410,1927,10
98984650137,98984650158,21,1380,1786,10
98985793917,98985793915,-2,1260,2131,10
98985841939,98985841918,-21,302,846,10
98988887038,98988887038,0,1306,1032,10
98989372841,98989372862,21,1618,2438,10
98990382373,98990382372,-1,777,1780,10
98991888006,98991888005,-1,1258,1875,10
98994414099,98994414100,1,790,1882,10
98998311925,98998311922,-3,1230,2218,10
98999376599,98999376598,-1,702,1356,10
98999728902,98999728906,4,1332,1611,10
99005120787,99005120784,-3,1260,3215,10
99006314659,99006314657,-2,1005,1745,10
99007054234,99007054233,-1,1693,2948,10
99007486949,99007486949,0,1535,2319,10
99010259397,99010259397,0,24820,36927,10
99010958818,99010958818,0,2519,2354,10
99017881234,99017881234,0,1278,2330,10
99023179522,99023179522,0,1176,2044,10
99025313583,99025313581,-2,724,1552,10
99025828005,99025828002,-3,1429,1844,10
99026633051,99026633049,-2,1180,2114,10
99027776979,99027776974,-5,977,2944,10
99028269450,99028269448,-2,837,2331,10
99029886006,99029886003,-3,642,2620,10
99034493775,99034493773,-2,1286,2036,10
99035004131,99035004146,15,2754,10262,10
99035173166,99035173163,-3,1470,1970,10
99036142280,99036142279,-1,1297,1746,10
99037627370,99037627369,-1,652,1927,10
99040098078,99040098075,-3,801,2023,10
99042348410,99042348408,-2,924,1955,10
99045382950,99045382955,5,5612,3245,10
99048641115,99048641106,-9,771,2022,10
99050002793,99050002796,3,1072,1492,10
99052487494,99052487493,-1,1649,2404,10
99052707805,99052707806,1,1064,1672,10
99053206559,99053206558,-1,1101,1557,10
99053358450,99053358445,-5,1360,5230,10
99053694441,99053694438,-3,1305,2561,10
99055846407,99055846407,0,1050,2219,10
99060480119,99060480119,0,1482,2297,10
99061377146,99061377146,0,935,1786,10
99061587804,99061587802,-2,1236,1575,10
99061906674,99061906675,1,1394,1841,10
99066004439,99066004437,-2,1589,2152,10
99071541753,99071541752,-1,1111,1270,10
99081310782,99081310789,7,3639,1674,10
99083607499,99083607500,1,765,1284,10
99084170719,99084170717,-2,1301,2262,10
99091070490,99091070490,0,1326,1684,10
99094346861,99094346859,-2,973,1300,10
99097390450,99097390447,-3,1323,1192,10
99098290671,99098290670,-1,1398,1651,10
99099468487,99099468487,0,870,1211,10
99103108293,99103108289,-4,1270,1830,10
99104975171,99104975167,-4,1204,2434,10
99108046382,99108046381,-1,1182,1895,10
99111992307,99111992305,-2,1118,1274,10
99114072791,99114072789,-2,1246,2065,10
99114598522,99114598518,-4,1320,2050,10
99114752388,99114752385,-3,1211,2099,10
99117285287,99117285285,-2,1392,1728,10
99121519591,99121519592,1,940,2191,10
99123530506,99123530505,-1,1086,2055,10
99124311953,99124311952,-1,1355,2041,10
99129134512,99129134511,-1,1021,1799,10
99136348973,99136348979,6,5804,1674,10
99144548227,99144548226,-1,1151,2213,10
99145604531,99145604539,8,7376,1456,10
99145778039,99145778038,-1,1143,1972,10
99150700395,99150700394,-1,1704,1948,10
99152241587,99152241588,1,1587,2459,10
99155524357,99155524354,-3,1086,905,10
99159091410,99159091409,-1,901,1297,10
99160146713,99160146733,20,1183,1972,10
99162483403,99162483419,16,1250,1713,10
99164136157,99164136155,-2,1157,2047,10
99164606487,99164606486,-1,1538,1518,10
99180118363,99180118362,-1,1300,2248,10
99183378930,99183378927,-3,1109,1682,10
99184889754,99184889751,-3,1287,1987,10
99188074842,99188074842,0,1268,1736,10
99189459219,99189459215,-4,997,1853,10
99190101594,99190101593,-1,1331,1999,10
99193320242,99193320241,-1,1619,2056,10
99196955684,99196955681,-3,919,1405,10
99198829767,99198829766,-1,1369,1622,10
99199415769,99199415765,-4,1467,1602,10
99200486033,99200486033,0,1134,2140,10
99206479737,99206479736,-1,1416,2675,10
99207004582,99207004581,-1,1038,1138,10
99208593296,99208593294,-2,1431,1814,10
99209578050,99209578054,4,1309,1099,10
99213993498,99213993498,0,1407,2230,10
99215874961,99215874959,-2,1128,2213,10
99216430525,99216430526,1,927,1120,10
99222238907,99222238905,-2,1502,2455,10
99223780094,99223780098,4,1412,1211,10
99224155601,99224155600,-1,968,1627,10
99228826271,99228826269,-2,1231,1688,10
99229240830,99229240830,0,1252,1682,10
99231437690,99231437687,-3,1117,2542,10
99231961198,99231961197,-1,1325,2373,10
99233436676,99233436679,3,3034,2000,10
99234423795,99234423792,-3,1403,1628,10
99236068679,99236068678,-1,1350,2364,10
99236102701,99236102700,-1,1568,2111,10
99237489395,99237489389,-6,1297,6343,10
99245099286,99245099286,0,976,1229,10
99246850490,99246850490,0,1359,1627,10
99247695825,99247695829,4,11652,7200,10
99252600443,99252600445,2,1073,2229,10
99256725793,99256725792,-1,998,1565,10
99264713985,99264713982,-3,735,1108,10
99265413443,99265413427,-16,249,449,10
99270112859,99270112858,-1,1136,1513,10
99270293717,99270293714,-3,4275,8598,10
99272640383,99272640382,-1,1536,1972,10
99272673760,99272673778,18,370,855,10
99274477214,99274477214,0,1080,1795,10
99274596913,99274596910,-3,871,1163,10
99278991806,99278991805,-1,1726,2831,10
99280279300,99280279297,-3,1158,1654,10
99286283934,99286283935,1,1367,1837,10
99286852215,99286852213,-2,1054,2124,10
99289786577,99289786574,-3,1417,1605,10
99296614716,99296614712,-4,1293,1736,10
99302999784,99302999781,-3,1044,2458,10
99308864905,99308864904,-1,1671,2148,10
99311171617,99311171620,3,1862,1238,10
99313346070,99313346068,-2,1337,2306,10
99314657930,99314657951,21,617,3488,10
99315285327,99315285327,0,1220,1512,10
99322183491,99322183490,-1,1802,2184,10
99322241246,99322241244,-2,898,1314,10
99324754989,99324754990,1,1710,1580,10
99327476327,99327476326,-1,1454,2655,10
99329379583,99329379581,-2,1166,1971,10
99330067563,99330067562,-1,1018,2506,10
99339768407,99339768405,-2,1094,2410,10
99340112746,99340112744,-2,1552,1756,10
99340160656,99340160654,-2,1980,2527,10
99344177526,99344177526,0,901,1315,10
99346131835,99346131833,-2,1196,2527,10
99349213441,99349213439,-2,992,2435,10
99353858594,99353858594,0,1272,1848,10
99355027157,99355027155,-2,1507,3349,10
99356404914,99356404913,-1,1561,2287,10
99356618891,99356618891,0,1357,2309,10
99360913970,99360913969,-1,1326,1880,10
99361249298,99361249297,-1,1673,2946,10
99361471454,99361471452,-2,1178,2426,10
99362970854,99362970853,-1,1591,2616,10
99365719320,99365719320,0,1441,2197,10
99367744982,99367744974,-8,1207,5447,10
99375792575,99375792575,0,850,1137,10
99379111914,99379111914,0,1740,2341,10
99379171344,99379171348,4,1477,1459,10
99383634974,99383634974,0,919,2005,10
99383967303,99383967307,4,2420,1809,10
99387781112,99387781110,-2,1300,1692,10
99390052380,99390052379,-1,1301,2597,10
99390327430,99390327424,-6,1370,4978,10
99393680850,99393680848,-2,1133,1912,10
99393824790,99393824788,-2,1016,1902,10
99394830712,99394830709,-3,1494,2888,10
99400402678,99400402679,1,1117,2935,10
99405184872,99405184870,-2,1158,1873,10
99406204049,99406204047,-2,1519,2487,10
99407043947,99407043943,-4,830,2380,10
99407787492,99407787503,11,206,1366,10
99410274145,99410274142,-3,882,1689,10
99411645914,99411645913,-1,1160,2143,10
99425144702,99425144701,-1,1601,1870,10
99425886758,99425886754,-4,1285,1691,10
99426740762,99426740761,-1,1365,2799,10
99433247455,99433247453,-2,1198,1624,10
99435761275,99435761270,-5,694,1417,10
99436350067,99436350074,7,455,1489,10
99438698586,99438698586,0,1292,1225,10
99440532566,99440532567,1,1014,1635,10
99442803120,99442803117,-3,1359,1883,10
99446711071,99446711071,0,1140,1931,10
99448741638,99448741636,-2,1070,2218,10
99449984081,99449984078,-3,1550,2074,10
99450166936,99450166934,-2,915,1875,10
99460006762,99460006760,-2,877,1986,10
99462220690,99462220686,-4,957,2604,10
99468197018,99468197015,-3,1319,1490,10
99470753528,99470753519,-9,965,1483,10
99471185457,99471185445,-12,82,1614,10
99479523736,99479523735,-1,1436,1981,10
99483033066,99483033064,-2,1020,2022,10
99485130602,99485130603,1,1144,1990,10
99485384878,99485384876,-2,1222,1998,10
99489592024,99489592020,-4,1425,2603,10
99490955560,99490955559,-1,1525,2618,10
99492165277,99492165276,-1,756,1402,10
99492495154,99492495151,-3,1434,2434,10
99498439574,99498439570,-4,1469,2370,10
99499513949,99499513943,-6,1541,2986,10
99501428023,99501428021,-2,1031,1414,10
99507816557,99507816555,-2,1137,2030,10
99508727885,99508727884,-1,1312,2101,10
99509688715,99509688718,3,1419,865,10
99509871304,99509871306,2,1963,1733,10
99513985377,99513985375,-2,1066,1548,10
99516883539,99516883539,0,1249,1655,10
99517534705,99517534705,0,1860,2648,10
99519380477,99519380475,-2,1821,2639,10
99522044671,99522044669,-2,1093,2818,10
99523222954,99523222953,-1,1095,1726,10
99523826003,99523826002,-1,1508,1429,10
99527446336,99527446331,-5,1280,2644,10
99531669971,99531669970,-1,1272,1683,10
99533104651,99533104650,-1,1558,2060,10
99534518431,99534518430,-1,1402,2556,10
99536124355,99536124352,-3,1188,1986,10
99536894885,99536894889,4,2529,1430,10
99538437214,99538437211,-3,1026,2123,10
99538822050,99538822049,-1,1399,1756,10
99541079348,99541079346,-2,1389,1762,10
99542874948,99542874947,-1,1211,2309,10
99547668060,99547668054,-6,1199,6996,10
99553786028,99553786027,-1,1207,1936,10
99554223873,99554223873,0,1637,2532,10
99556519650,99556519649,-1,1080,2594,10
99559110253,99559110250,-3,1193,2358,10
99559266402,99559266402,0,1622,2377,10
99561836405,99561836406,1,1851,2422,10
99562135470,99562135470,0,1087,2150,10
99565605451,99565605450,-1,1038,1927,10
99565926115,99565926119,4,442,2165,10
99566856865,99566856871,6,2714,1314,10
99570604340,99570604339,-1,858,1658,10
99571750486,99571750485,-1,1180,2101,10
99571842570,99571842549,-21,930,1283,10
99574409787,99574409785,-2,1131,1808,10
99577191218,99577191218,0,650,1338,10
99580692335,99580692333,-2,1024,2064,10
99584170086,99584170087,1,1023,1081,10
99589045450,99589045450,0,929,1358,10
99591974607,99591974606,-1,1575,1868,10
99592474603,99592474602,-1,1073,2002,10
99594070265,99594070263,-2,965,1805,10
99597357701,99597357700,-1,1311,1971,10
99598535401,99598535399,-2,1000,2103,10
99601981872,99601981870,-2,1114,1365,10
99603411134,99603411133,-1,982,1582,10
99604150883,99604150881,-2,1235,2492,10
99611276478,99611276474,-4,1210,3361,10
99611325011,99611325010,-1,574,1531,10
99612907594,99612907591,-3,1145,2854,10
99615091136,99615091134,-2,1297,2164,10
99616408070,99616408064,-6,26265,12102,10
99618849094,99618849091,-3,1069,1772,10
99619407734,99619407734,0,1316,1606,10
99621615362,99621615362,0,1415,2003,10
99621996986,99621997007,21,1178,1923,10
99624920866,99624920861,-5,1128,2032,10
99626724071,99626724069,-2,1262,2064,10
99627423074,99627423070,-4,1514,3406,10
99629336115,99629336114,-1,1105,2307,10
99634212962,99634212961,-1,1658,2414,10
99638231035,99638231016,-19,1259,1664,10
99638678357,99638678356,-1,1523,2146,10
99640791905,99640791901,-4,1664,3125,10
99641257135,99641257134,-1,1261,2428,10
99643346360,99643346360,0,1767,2309,10
99644710290,99644710311,21,350,762,10
99646966367,99646966369,2,1234,1367,10
99648636017,99648636014,-3,964,2096,10
99649386534,99649386535,1,1538,1520,10
99650370446,99650370441,-5,1705,5404,10
99651551733,99651551733,0,1604,1791,10
99658604397,99658604401,4,1349,1178,10
99659742860,99659742857,-3,1398,2001,10
99660429827,99660429826,-1,1422,1492,10
99660555394,99660555394,0,1277,1877,10
99665439138,99665439139,1,764,1500,10
99666548282,99666548283,1,943,1644,10
99667422463,99667422463,0,1355,1421,10
99670458525,99670458518,-7,830,3081,10
99672075161,99672075162,1,1182,1373,10
99672762899,99672762898,-1,1488,2673,10
99674009821,99674009819,-2,1272,1471,10
99674055649,99674055646,-3,1265,1530,10
99674684580,99674684578,-2,1089,1517,10
99675697041,99675697038,-3,1422,2067,10
99678551466,99678551464,-2,1124,1452,10
99678794835,99678794833,-2,1338,2396,10
99679782885,99679782884,-1,1457,2208,10
99681288931,99681288936,5,2900,1674,10
99682182477,99682182476,-1,952,1300,10
99683046371,99683046369,-2,1070,2021,10
99683566937,99683566938,1,1165,1972,10
99691227905,99691227902,-3,891,2197,10
99691971397,99691971395,-2,1133,1678,10
99694851476,99694851477,1,1437,2213,10
99695415069,99695415062,-7,1675,5912,10
99700740126,99700740121,-5,1209,1999,10
99702091229,99702091233,4,2235,1426,10
99702134071,99702134066,-5,744,2181,10
99703272602,99703272623,21,1120,1739,10
99703599919,99703599918,-1,836,1799,10
99704041807,99704041803,-4,1295,2070,10
99704120178,99704120177,-1,1093,1952,10
99704726831,99704726832,1,1190,1664,10
99706362113,99706362113,0,943,1291,10
99707405471,99707405466,-5,1292,2514,10
99709674851,99709674853,2,1533,750,10
99712687366,99712687367,1,1585,2351,10
99712793398,99712793394,-4,1483,1887,10
99713173443,99713173441,-2,1671,2581,10
99714108127,99714108120,-7,1073,3233,10
99718787823,99718787822,-1,1228,1868,10
99719591461,99719591458,-3,1160,1600,10
99721582310,99721582313,3,17800,32470,10
99721621354,99721621354,0,1024,1700,10
99724955414,99724955418,4,4233,2229,10
99725378118,99725378118,0,973,1634,10
99729353966,99729353965,-1,986,2056,10
99729646373,99729646372,-1,1458,2260,10
99731776992,99731776990,-2,1559,2204,10
99732637675,99732637676,1,1855,2185,10
99737419792,99737419793,1,1162,1998,10
99741462474,99741462473,-1,1247,1823,10
99745299049,99745299055,6,4078,1236,10
99745562579,99745562578,-1,889,1467,10
99748322831,99748322828,-3,801,1675,10
99751461929,99751461930,1,1137,2368,10
99755243694,99755243688,-6,1187,4262,10
99761641319,99761641318,-1,1181,2259,10
99763725826,99763725825,-1,1515,1899,10
99764784833,99764784834,1,1338,1618,10
99765947238,99765947233,-5,853,1685,10
99769095604,99769095603,-1,944,2516,10
99770051922,99770051920,-2,1246,1470,10
99770439707,99770439706,-1,1120,1721,10
99771732920,99771732917,-3,1628,2772,10
99772198341,99772198342,1,810,2295,10
99776832170,99776832169,-1,1192,1566,10
99778511835,99778511834,-1,902,1806,10
99779438454,99779438453,-1,937,1863,10
99782336156,99782336159,3,1711,1197,10
99783221687,99783221687,0,1146,1970,10
99785623779,99785623778,-1,1598,2756,10
99786217555,99786217554,-1,1164,1620,10
99786661052,99786661067,15,251,643,10
99786990689,99786990687,-2,1514,2087,10
99788063051,99788063063,12,1004,1492,10
99790957656,99790957654,-2,1252,2386,10
99791337263,99791337261,-2,1433,1919,10
99792056292,99792056290,-2,1103,1964,10
99792287555,99792287556,1,693,1772,10
99792502897,99792502896,-1,927,1676,10
99793040173,99793040170,-3,1452,1588,10
99793425646,99793425645,-1,1613,2151,10
99796198570,99796198569,-1,1766,2309,10
99796517597,99796517599,2,1525,1635,10
99800040701,99800040698,-3,1240,2920,10
99802635063,99802635067,4,1636,1742,10
99803120610,99803120605,-5,706,1338,10
99804823428,99804823427,-1,1061,1791,10
99805712442,99805712437,-5,1598,1918,10
99811362907,99811362903,-4,795,2249,10
99812442657,99812442654,-3,1363,1907,10
99815132779,99815132778,-1,1046,2080,10
99817600856,99817600864,8,2491,1027,10
99818725009,99818725010,1,1471,2230,10
99827196886,99827196881,-5,964,2125,10
99829632015,99829632014,-1,1473,2929,10
99831000229,99831000234,5,3217,1066,10
99831661419,99831661415,-4,1455,3276,10
99831858517,99831858516,-1,38617,18018,10
99832648403,99832648402,-1,1323,1879,10
99836369175,99836369174,-1,1316,1538,10
99842475555,99842475556,1,741,1670,10
99843924070,99843924074,4,2527,1168,10
99844368264,99844368263,-1,1201,1677,10
99845103027,99845103006,-21,1343,1972,10
99846956250,99846956248,-2,1075,1650,10
99848708089,99848708088,-1,1246,2127,10
99850282621,99850282618,-3,1222,2349,10
99852436092,99852436089,-3,562,1481,10
99857155530,99857155527,-3,1773,2175,10
99857234977,99857234974,-3,1208,2069,10
99857938853,99857938851,-2,824,1370,10
99859232052,99859232052,0,2022,3265,10
99861787774,99861787774,0,1425,2021,10
99862145906,99862145897,-9,1235,6171,10
99870228095,99870228094,-1,861,1932,10
99871474791,99871474790,-1,1336,2156,10
99872783573,99872783574,1,1640,1202,10
99882517773,99882517771,-2,1098,2123,10
99885987018,99885987014,-4,1219,2282,10
99890603967,99890603965,-2,1340,2898,10
99892914906,99892914905,-1,1390,2473,10
99896961717,99896961714,-3,1500,2000,10
99897438329,99897438309,-20,91,653,10
99897706678,99897706679,1,2092,1523,10
99899014210,99899014210,0,1255,2390,10
99910140414,99910140412,-2,1196,2850,10
99915231599,99915231594,-5,1048,1630,10
99917930844,99917930839,-5,846,2698,10
99918365041,99918365041,0,1471,2514,10
99919755595,99919755593,-2,899,1577,10
99921078461,99921078458,-3,1508,1768,10
99922376102,99922376103,1,1062,1332,10
99923611661,99923611658,-3,939,1901,10
99928904463,99928904462,-1,900,1563,10
99928950683,99928950681,-2,1380,2822,10
99929557197,99929557197,0,1260,2348,10
99931428472,99931428469,-3,876,1878,10
99934859616,99934859621,5,2764,1968,10
99935209134,99935209134,0,1351,2237,10
99939318870,99939318872,2,1705,2351,10
99940063926,99940063925,-1,1446,2021,10
99941600369,99941600369,0,34504,35983,10
99943473857,99943473861,4,1277,913,10
99947086218,99947086217,-1,1407,2035,10
99947330954,99947330952,-2,1713,2094,10
99951195882,99951195881,-1,1043,1634,10
99951699522,99951699521,-1,1274,1906,10
99953617353,99953617350,-3,1559,1521,10
99956901633,99956901630,-3,811,1821,10
99964602891,99964602890,-1,1429,3062,10
99972169661,99972169658,-3,838,1121,10
99972241017,99972241016,-1,943,1781,10
99973021051,99973021050,-1,944,2407,10
99978644143,99978644141,-2,1242,2012,10
99980388237,99980388234,-3,1443,2132,10
99980741105,99980741099,-6,1551,5516,10
99980788443,99980788441,-2,1147,1586,10
99982377230,99982377226,-4,1153,2378,10
99985835054,99985835061,7,1759,790,10
99986291598,99986291596,-2,1249,2284,10
99986662873,99986662873,0,1010,1602,10
99987007438,99987007437,-1,1191,1689,10
99991193393,99991193391,-2,1462,2712,10
99993681975,99993681974,-1,1538,2247,10
99994708079,99994708079,0,1701,2492,10
99995736877,99995736874,-3,169,463,10
99996057537,99996057541,4,1657,1337,10
99996722318,99996722316,-2,1130,1703,10
99999461017,99999461015,-2,1863,1890,10
99999699856,99999699854,-2,1195,2218,10
100006183676,100006183673,-3,1466,2762,10
100007052544,100007052530,-14,1117,1603,10
100010857323,100010857323,0,1433,2244,10
100011900728,100011900729,1,1118,1913,10
100015457212,100015457210,-2,1150,2605,10
100017163597,100017163596,-1,985,2019,10
100019114550,100019114550,0,1307,1278,10
100026632946,100026632943,-3,941,2184,10
100029665737,100029665737,0,944,1689,10
100031369600,100031369598,-2,980,1532,10
100033237852,100033237849,-3,1654,1850,10
100037272302,100037272302,0,751,2047,10
100038150305,100038150306,1,1200,2172,10
100039727540,100039727538,-2,1698,1812,10
100040386433,100040386429,-4,1285,1958,10
100041663262,100041663279,17,15192,21372,10
100042149945,100042149941,-4,1319,1957,10
100042196052,100042196050,-2,813,1676,10
100045285418,100045285418,0,1465,3075,10
100049376003,100049376002,-1,1052,1907,10
100050357515,100050357514,-1,1081,1377,10
100051363367,100051363366,-1,978,1130,10
100051936003,100051936007,4,2672,1276,10
100052254555,100052254553,-2,945,1776,10
100053699389,100053699385,-4,1133,2543,10
100057243060,100057243056,-4,901,3384,10
100058469117,100058469117,0,996,2046,10
100059729044,100059729042,-2,1640,2321,10
100060776355,100060776353,-2,1401,2034,10
100061849273,100061849261,-12,5,1281,10
100063064499,100063064499,0,1415,2508,10
100065920850,100065920830,-20,1759,2007,10
100068223665,100068223663,-2,1200,1575,10
100069508130,100069508129,-1,1394,1920,10
100071995062,100071995063,1,860,1574,10
100072577339,100072577338,-1,1309,1494,10
100073279675,100073279673,-2,1108,1672,10
100074207206,100074207205,-1,1113,2652,10
100075052041,100075052039,-2,1288,1999,10
100075925390,100075925390,0,915,1494,10
100079420646,100079420645,-1,1092,2102,10
100079887266,100079887264,-2,546,1704,10
100082119022,100082119021,-1,1113,1994,10
100082901977,100082901977,0,1607,2596,10
100086557730,100086557729,-1,1013,1693,10
100087965667,100087965666,-1,1512,1608,10
100092892499,100092892498,-1,1218,2021,10
100093197610,100093197630,20,1399,2233,10
100094850923,100094850922,-1,1320,2101,10
100094918558,100094918559,1,2065,1883,10
100095168457,100095168460,3,1245,1287,10
100098174551,100098174551,0,1293,1840,10
100100411718,100100411717,-1,1328,1536,10
100102602905,100102602904,-1,951,1420,10
100104460885,100104460888,3,1694,2030,10
100105904658,100105904658,0,835,1451,10
100112989486,100112989485,-1,1586,2899,10
100115310682,100115310682,0,1582,1752,10
100115796470,100115796470,0,1196,1825,10
100116404265,100116404283,18,898,1883,10
100116591971,100116591967,-4,1276,2422,10
100117011699,100117011697,-2,808,1865,10
100117499589,100117499593,4,2122,1943,10
100118263719,100118263717,-2,1381,1721,10
100120089536,100120089538,2,2306,2025,10
100121192131,100121192132,1,1252,2442,10
100121900786,100121900786,0,1318,2698,10
100126301001,100126301001,0,703,1606,10
100130757261,100130757260,-1,1468,2685,10
100131146306,100131146305,-1,1441,2486,10
100134714671,100134714677,6,2211,905,10
100138635914,100138635914,0,666,1444,10
100141016090,100141016090,0,1083,1683,10
100145318434,100145318433,-1,1924,2371,10
100147181002,100147181001,-1,1371,1798,10
100147278309,100147278309,0,1244,1897,10
100150940355,100150940357,2,1074,1878,10
100151586176,100151586175,-1,995,1233,10
100152418374,100152418375,1,1625,2648,10
100154666248,100154666252,4,2732,1520,10
100161579747,100161579751,4,2488,1988,10
100161627665,100161627672,7,3414,1236,10
100163102412,100163102410,-2,1573,2144,10
100165014362,100165014362,0,1173,1920,10
100165050387,100165050383,-4,1085,1491,10
100165991307,100165991306,-1,1479,2273,10
100168455640,100168455639,-1,592,1476,10
100172878709,100172878708,-1,1435,1744,10
100173473989,100173473986,-3,1055,1434,10
100175713243,100175713241,-2,968,2896,10
100177518514,100177518514,0,741,1163,10
100183762988,100183762988,0,1161,1694,10
100185092205,100185092210,5,636,1127,10
100186571063,100186571062,-1,1233,1592,10
100186808637,100186808635,-2,1589,2396,10
100187923006,100187923006,0,825,868,10
100189934828,100189934826,-2,972,1564,10
100190447385,100190447383,-2,1034,1615,10
100194581170,100194581170,0,1200,1486,10
100198430042,100198430038,-4,1020,1759,10
100215470607,100215470610,3,1986,783,10
100215606562,100215606543,-19,1298,2403,10
100217225602,100217225601,-1,1047,1372,10
100219535413,100219535413,0,1429,1999,10
100219945210,100219945199,-11,917,1948,10
100221432369,100221432367,-2,1162,1604,10
100221751068,100221751083,15,956,1845,10
100221984385,100221984406,21,364,1007,10
100224513514,100224513514,0,767,1712,10
100231951531,100231951531,0,1165,1545,10
100232124066,100232124066,0,1449,2193,10
100233183486,100233183485,-1,796,1144,10
100233688584,100233688606,22,883,1748,10
100238133806,100238133806,0,1252,2208,10
100238701630,100238701629,-1,1181,1906,10
100239089082,100239089082,0,1056,1569,10
100240988626,100240988625,-1,1186,1536,10
100241174360,100241174342,-18,1223,2340,10
100243486634,100243486630,-4,1019,1494,10
100244383931,100244383930,-1,918,2167,10
100246800084,100246800083,-1,1644,1635,10
100247262424,100247262421,-3,1086,2112,10
100261360746,100261360746,0,1210,2666,10
100261397593,100261397594,1,1327,1127,10
100262273481,100262273482,1,1341,1876,10
100267211760,100267211758,-2,1332,2419,10
100267895290,100267895288,-2,1635,1867,10
100269498845,100269498840,-5,1031,2913,10
100270157332,100270157344,12,179,1095,10
100271211455,100271211455,0,1466,1837,10
100274589400,100274589398,-2,1064,1906,10
100276539684,100276539677,-7,619,3172,10
100280334878,100280334874,-4,2050,3508,10
100280821171,100280821169,-2,1551,2598,10
100281450504,100281450507,3,361,505,10
100281903689,100281903690,1,12480,13014,10
100282390126,100282390125,-1,955,1743,10
100286166252,100286166254,2,1947,1614,10
100288025922,100288025921,-1,1298,2082,10
100288850560,100288850557,-3,1277,1651,10
100291099244,100291099242,-2,1647,2498,10
100293373715,100293373723,8,4023,1397,10
100302138566,100302138572,6,1966,1458,10
100304502812,100304502812,0,1170,2152,10
100306778954,100306778952,-2,1305,1842,10
100315134439,100315134438,-1,1253,2160,10
100315159752,100315159732,-20,1426,1488,10
100316742145,100316742142,-3,1109,1583,10
100320628971,100320628970,-1,1266,2105,10
100322244767,100322244765,-2,1264,1981,10
100323450342,100323450340,-2,1479,1970,10
100327546618,100327546617,-1,1172,1364,10
100331144638,100331144638,0,1220,1684,10
100331229498,100331229497,-1,1318,2309,10
100331327646,100331327647,1,32026,35029,10
100332107981,100332107986,5,1298,994,10
100333271003,100333271023,20,1065,2383,10
100334058358,100334058360,2,1156,1964,10
100338436835,100338436834,-1,1394,2142,10
100339218156,100339218154,-2,1639,2878,10
100339667890,100339667911,21,1465,2739,10
100339923394,100339923394,0,965,1626,10
100340421306,100340421306,0,1127,2211,10
100341254892,100341254889,-3,888,2301,10
100343338318,100343338317,-1,1106,1612,10
100345667265,100345667266,1,1468,1753,10
100348335395,100348335395,0,717,1035,10
100349157593,100349157591,-2,1218,2765,10
100351328432,100351328430,-2,1596,2055,10
100352504219,100352504197,-22,11,852,10
100352916354,100352916354,0,2183,2712,10
100354403457,100354403457,0,1143,1452,10
100360739894,100360739892,-2,1812,2650,10
100363328638,100363328636,-2,1554,1845,10
100367869024,100367869022,-2,1643,2501,10
100368787275,100368787276,1,1151,2126,10
100368918569,100368918566,-3,1097,1930,10
100370371129,100370371134,5,5967,2172,10
100372275606,100372275604,-2,1126,2182,10
100374195110,100374195106,-4,814,1293,10
100379848478,100379848477,-1,1093,2134,10
100382451233,100382451233,0,1408,1906,10
100382655067,100382655086,19,466,1135,10
100383478202,100383478199,-3,1323,1974,10
100388989029,100388989028,-1,750,1223,10
100390493550,100390493549,-1,1529,2294,10
100391630604,100391630605,1,1342,1304,10
100394413548,100394413547,-1,1044,1550,10
100395224823,100395224822,-1,1231,1990,10
100396180372,100396180370,-2,1318,2041,10
100397842319,100397842317,-2,766,1150,10
100399786410,100399786411,1,1341,1289,10
100400352674,100400352674,0,885,2328,10
100406007106,100406007105,-1,722,1371,10
100409011742,100409011741,-1,1232,1707,10
100409754234,100409754233,-1,1762,2839,10
100411917150,100411917149,-1,945,1874,10
100412369318,100412369317,-1,913,1389,10
100412654026,100412654022,-4,1194,3475,10
100415564617,100415564617,0,1207,1509,10
100417214790,100417214790,0,1935,2134,10
100420830371,100420830369,-2,1159,1303,10
100421255766,100421255766,0,1022,1218,10
100422723693,100422723694,1,1380,1625,10
100423666257,100423666255,-2,15560,15484,10
100424449231,100424449236,5,1553,1089,10
100427774145,100427774145,0,692,1461,10
100427830426,100427830404,-22,1468,1895,10
100432775124,100432775120,-4,1551,3267,10
100437499641,100437499640,-1,1433,1812,10
100439627069,100439627062,-7,1936,6529,10
100443659617,100443659615,-2,1254,2335,10
100450667542,100450667541,-1,1169,1369,10
100453356930,100453356928,-2,1146,1420,10
100457447542,100457447541,-1,1163,2011,10
100459405550,100459405548,-2,954,1557,10
100461206428,100461206427,-1,1049,1851,10
100462053172,100462053170,-2,1042,2437,10
100462902881,100462902880,-1,1787,2356,10
100463032686,100463032685,-1,769,1218,10
100466039828,100466039826,-2,1059,2564,10
100474971613,100474971614,1,1224,1948,10
100475090514,100475090514,0,698,1636,10
100476671259,100476671259,0,1325,1829,10
100476950770,100476950768,-2,1437,1681,10
100482894907,100482894903,-4,1222,2255,10
100486382936,100486382943,7,3141,1917,10
100486507902,100486507896,-6,1077,5046,10
100488036630,100488036629,-1,689,1563,10
100489560761,100489560760,-1,1464,2130,10
100490169853,100490169853,0,1377,2478,10
100492654043,100492654042,-1,1408,2242,10
100494159218,100494159211,-7,1773,8720,10
100496594442,100496594441,-1,921,1386,10
100498629128,100498629126,-2,1911,3237,10
100498799024,100498799026,2,1963,1486,10
100499174288,100499174286,-2,1635,2642,10
100506723688,100506723686,-2,1401,2406,10
100507750373,100507750371,-2,925,1492,10
100511008924,100511008922,-2,1427,2222,10
100511212566,100511212564,-2,1176,2093,10
100513848468,100513848466,-2,786,1953,10
100514420410,100514420429,19,916,2094,10
100514845057,100514845055,-2,1123,1997,10
100517547215,100517547209,-6,1048,3187,10
100519337621,100519337618,-3,1099,2121,10
100521624861,100521624858,-3,1056,2221,10
100521729431,100521729430,-1,1231,2316,10
100530290822,100530290823,1,1443,1497,10
100532270847,100532270844,-3,609,2502,10
100533200111,100533200114,3,1080,1880,10
100534968010,100534968005,-5,2100,7710,10
100539622846,100539622848,2,1749,1489,10
100540784426,100540784425,-1,1413,1985,10
100545840744,100545840742,-2,1513,2340,10
100548224278,100548224274,-4,1035,1943,10
100548917639,100548917638,-1,814,2483,10
100550418000,100550417997,-3,1316,1818,10
100551465380,100551465377,-3,873,2289,10
100551945522,100551945522,0,1516,2169,10
100555925525,100555925522,-3,799,856,10
100560145648,100560145647,-1,1204,2024,10
100562571065,100562571063,-2,1113,1745,10
100569630415,100569630414,-1,1173,1992,10
100572788910,100572788907,-3,1353,2177,10
100575577675,100575577678,3,1261,2072,10
100575847194,100575847192,-2,1219,2116,10
100577412542,100577412537,-5,908,5134,10
100578012767,100578012763,-4,1014,1312,10
100581345489,100581345490,1,1571,1963,10
100583458457,100583458457,0,1322,1931,10
100584126090,100584126089,-1,922,1171,10
100585822323,100585822319,-4,1408,2677,10
100592952611,100592952610,-1,1776,2832,10
100593913379,100593913378,-1,1822,1800,10
100597895882,100597895881,-1,1891,2752,10
100599186849,100599186846,-3,1412,1646,10
100600601139,100600601138,-1,1111,1920,10
100603460264,100603460265,1,1067,1608,10
100605101429,100605101429,0,1414,2128,10
100606129362,100606129366,4,2357,1196,10
100609297572,100609297573,1,1403,1270,10
100612897594,100612897594,0,1179,2185,10
100616458182,100616458181,-1,943,2165,10
100617340299,100617340318,19,883,1335,10
100617535069,100617535066,-3,1318,1947,10
100620145849,100620145847,-2,991,1238,10
100620926960,100620926957,-3,1334,2066,10
100621862062,100621862062,0,1341,1520,10
100623257869,100623257869,0,1532,2440,10
100625626114,100625626113,-1,1640,1823,10
100625849857,100625849857,0,1224,1414,10
100627232939,100627232937,-2,1376,2176,10
100628443373,100628443373,0,1135,2149,10
100629188431,100629188430,-1,878,1212,10
100630608319,100630608318,-1,1366,2397,10
100631427265,100631427286,21,787,1646,10
100631782581,100631782579,-2,1655,3674,10
100633706566,100633706565,-1,1556,2075,10
100640676762,100640676761,-1,1605,1549,10
100640819494,100640819497,3,1280,1354,10
100643312903,100643312902,-1,1268,1730,10
100645342990,100645342987,-3,1380,1827,10
100646501386,100646501400,14,1493,332,10
100647908399,100647908398,-1,1013,1581,10
100649704902,100649704899,-3,1767,5752,10
100649784244,100649784245,1,1402,1975,10
100650359017,100650359016,-1,723,1482,10
100653021044,100653021043,-1,1727,1891,10
100654173398,100654173397,-1,1472,1917,10
100654933489,100654933489,0,1750,2087,10
100655105762,100655105762,0,1203,1792,10
100655783290,100655783290,0,1020,2153,10
100655839664,100655839679,15,329,1233,10
100658617397,100658617397,0,1078,1679,10
100662430849,100662430849,0,1498,2827,10
100665359902,100665359899,-3,1877,2382,10
100665542852,100665542849,-3,1478,2475,10
100669355136,100669355134,-2,1271,2750,10
100675393107,100675393106,-1,2072,2516,10
100678472889,100678472870,-19,1196,600,10
100679392982,100679392981,-1,724,1974,10
100682128962,100682128961,-1,1259,2366,10
100682742983,100682742985,2,1466,2048,10
100684784768,100684784766,-2,1632,1688,10
100686549892,100686549890,-2,1149,1904,10
100689999854,100689999850,-4,1689,1916,10
100691588919,100691588916,-3,1375,1943,10
100692068223,100692068219,-4,1131,1949,10
100695236755,100695236753,-2,1106,2452,10
100695333452,100695333452,0,1162,2442,10
100705579523,100705579522,-1,1008,1989,10
100712606967,100712606965,-2,1190,2607,10
100713833035,100713833033,-2,1483,2124,10
100721483363,100721483362,-1,709,1547,10
100723840659,100723840658,-1,1583,2121,10
100724156581,100724156590,9,1117,1012,10
100728802728,100728802726,-2,1196,2925,10
100735419713,100735419719,6,1971,847,10
100739321399,100739321399,0,1262,2080,10
100746219111,100746219110,-1,894,1212,10
100750354991,100750354988,-3,1133,1596,10
100752510127,100752510125,-2,1398,1935,10
100759349405,100759349402,-3,1445,2240,10
100761748775,100761748774,-1,1466,2532,10
100766314899,100766314897,-2,1395,2442,10
100769405599,100769405598,-1,1775,2004,10
100769584322,100769584306,-16,1040,1409,10
100770113806,100770113806,0,1156,1960,10
100774305001,100774304999,-2,1195,2355,10
100774715009,100774715015,6,2941,1473,10
100779024261,100779024262,1,1392,1946,10
100779091921,100779091919,-2,1618,2773,10
100779759711,100779759710,-1,955,1987,10
100783235587,100783235586,-1,861,1108,10
100784151914,100784151913,-1,902,2207,10
100787888979,100787888977,-2,1170,2907,10
100795506385,100795506383,-2,1158,1916,10
100796452186,100796452185,-1,1312,2354,10
100798527347,100798527343,-4,1092,1443,10
100799166691,100799166690,-1,1358,1943,10
100801315186,100801315186,0,1157,1688,10
100801949289,100801949287,-2,1374,2029,10
100805608550,100805608547,-3,1148,2327,10
100812443607,100812443607,0,1160,2917,10
100821016366,100821016366,0,1500,2448,10
100822722014,100822722011,-3,837,2021,10
100827821315,100827821318,3,2214,1365,10
100830575069,100830575067,-2,888,1387,10
100830791381,100830791377,-4,1688,5397,10
100831697197,100831697195,-2,1462,1802,10
100834497754,100834497754,0,1199,1465,10
100843720731,100843720733,2,1501,2287,10
100844737666,100844737665,-1,1010,1384,10
100845039807,100845039804,-3,917,2015,10
100846017951,100846017949,-2,1539,2083,10
100851381249,100851381251,2,1557,1852,10
100851667894,100851667893,-1,1327,1569,10
100854404353,100854404351,-2,1310,2693,10
100854929417,100854929417,0,1274,1830,10
100856152245,100856152243,-2,1069,2734,10
100857699662,100857699662,0,1365,1798,10
100860125757,100860125755,-2,1365,1562,10
100862731250,100862731249,-1,1382,2633,10
100863708939,100863708936,-3,890,1614,10
100864990878,100864990899,21,1672,1535,10
100872475943,100872475938,-5,786,1892,10
100874343661,100874343659,-2,1219,1958,10
100879595598,100879595597,-1,1348,2519,10
100882573458,100882573455,-3,1880,2042,10
100884093200,100884093196,-4,870,2416,10
100886080634,100886080631,-3,1055,1711,10
100886398849,100886398846,-3,1109,1419,10
100901137775,100901137773,-2,1127,1946,10
100903675434,100903675433,-1,25799,36646,10
100904705963,100904705963,0,1266,1708,10
100905035786,100905035785,-1,1210,1834,10
100912958063,100912958061,-2,970,2036,10
100919126540,100919126538,-2,1384,1949,10
100925533811,100925533809,-2,1197,1552,10
100925666665,100925666666,1,1125,1333,10
100925724450,100925724448,-2,1196,2086,10
100925944522,100925944520,-2,1796,2449,10
100926592878,100926592876,-2,1409,2288,10
100931139249,100931139248,-1,1106,1812,10
100935394399,100935394398,-1,1722,2140,10
100940052171,100940052174,3,1027,1544,10
100940629573,100940629575,2,2569,1612,10
100943219927,100943219928,1,1218,1805,10
100946158671,100946158670,-1,6534,10663,10
100948432811,100948432809,-2,1647,2656,10
100948613283,100948613282,-1,660,1513,10
100952586453,100952586452,-1,935,1634,10
100955266077,100955266077,0,1291,2276,10
100957286389,100957286386,-3,1030,2106,10
100958922875,100958922874,-1,1196,2399,10
100959523133,100959523135,2,1064,1629,10
100959806082,100959806080,-2,951,1625,10
100966854222,100966854220,-2,1480,3154,10
100967287686,100967287694,8,18936,54961,10
100968884468,100968884462,-6,1924,7637,10
100975924329,100975924327,-2,1178,2676,10
100978022587,100978022587,0,1457,1914,10
100978908375,100978908372,-3,1337,2534,10
100979732533,100979732530,-3,1645,1817,10
100989492740,100989492738,-2,1310,2103,10
100994200498,100994200498,0,1043,2284,10
100996073074,100996073072,-2,1068,1732,10
100998698338,100998698337,-1,1555,2410,10
101000856938,101000856938,0,1184,1101,10
101001471848,101001471847,-1,950,2077,10
101004303566,101004303565,-1,1109,2316,10
101006279732,101006279729,-3,843,2056,10
101008438684,101008438688,4,954,1443,10
101012854809,101012854810,1,1101,1855,10
101013870242,101013870242,0,1036,1746,10
101014765875,101014765873,-2,1307,2146,10
101016783565,101016783562,-3,1522,2444,10
101017048233,101017048234,1,1241,1560,10
101019024074,101019024073,-1,1691,1849,10
101019441135,101019441139,4,1124,1366,10
101024548434,101024548432,-2,1419,2424,10
101025478247,101025478246,-1,896,1921,10
101026193637,101026193634,-3,1191,2072,10
101026339243,101026339240,-3,976,2632,10
101034437405,101034437404,-1,1068,1994,10
101040188104,101040188104,0,1007,1350,10
101041942334,101041942333,-1,1472,2272,10
101042450155,101042450153,-2,1159,1518,10
101044307472,101044307470,-2,1389,2009,10
101047447295,101047447294,-1,1043,2289,10
101049072887,101049072885,-2,1246,2357,10
101049159705,101049159705,0,1421,1773,10
101049659875,101049659875,0,1294,1722,10
101050353113,101050353095,-18,1165,1588,10
101052183199,101052183197,-2,1310,1974,10
101052556127,101052556130,3,23977,37852,10
101054299243,101054299240,-3,1044,2108,10
101057758533,101057758532,-1,1399,2463,10
101058445232,101058445231,-1,1157,2097,10
101058915806,101058915801,-5,901,1979,10
101059286454,101059286449,-5,1174,2483,10
101060692267,101060692264,-3,1132,2148,10
101062031997,101062031993,-4,1297,2102,10
101065101251,101065101251,0,1223,2262,10
101066456982,101066456981,-1,588,1682,10
101067975416,101067975413,-3,678,1217,10
101068727896,101068727913,17,1678,2059,10
101068995903,101068995901,-2,1447,2887,10
101071198287,101071198286,-1,1070,1686,10
101072308915,101072308914,-1,1048,2059,10
101078723674,101078723672,-2,1391,2068,10
101079509449,101079509447,-2,1164,1889,10
101081709953,101081709955,2,1014,1566,10
101087454735,101087454739,4,1590,892,10
101097962639,101097962640,1,1466,1764,10
101103978501,101103978498,-3,925,2044,10
101104549253,101104549238,-15,32,681,10
101110867673,101110867671,-2,984,1091,10
101113157296,101113157294,-2,1930,2566,10
101113380892,101113380894,2,1151,2028,10
101114846224,101114846221,-3,1298,1797,10
101115827751,101115827753,2,1257,1862,10
101116535759,101116535758,-1,1007,2438,10
101117557125,101117557123,-2,1751,2361,10
101118254677,101118254676,-1,1122,1860,10
101120507410,101120507421,11,11854,44739,10
101120663491,101120663511,20,1490,1970,10
101122119854,101122119853,-1,1454,2313,10
101122367072,101122367069,-3,1040,1348,10
101124508408,101124508406,-2,1684,2280,10
101124926779,101124926779,0,893,1591,10
101126927798,101126927802,4,7499,28406,10
101127386161,101127386159,-2,1415,2376,10
101129558077,101129558077,0,955,2378,10
101136987058,101136987058,0,1431,2140,10
101140678711,101140678710,-1,970,1970,10
101141191537,101141191536,-1,1120,1317,10
101141828136,101141828135,-1,1117,1847,10
101144610414,101144610412,-2,1414,2686,10
101147479675,101147479675,0,1052,1709,10
101152316106,101152316106,0,1563,2133,10
101152800463,101152800462,-1,1022,1411,10
101157100165,101157100164,-1,953,1428,10
101159808477,101159808473,-4,1465,4818,10
101160973198,101160973197,-1,1527,1984,10
101163911799,101163911797,-2,1393,2626,10
101166317016,101166317014,-2,987,2072,10
101173398362,101173398367,5,1395,1023,10
101176949858,101176949857,-1,1123,2385,10
101181264044,101181264043,-1,827,1580,10
101182833357,101182833362,5,4514,2623,10
101183504803,101183504804,1,1037,1590,10
101185239198,101185239195,-3,1270,2638,10
101186178806,101186178807,1,1490,1417,10
101187102918,101187102916,-2,1474,1836,10
101189567107,101189567106,-1,1644,2897,10
101192858021,101192858019,-2,2097,2373,10
101193588374,101193588374,0,1307,2497,10
101198863318,101198863317,-1,1367,1778,10
101199229432,101199229430,-2,1089,2211,10
101201222255,101201222254,-1,1788,2446,10
101202580337,101202580342,5,3147,1163,10
101204329879,101204329875,-4,939,1292,10
101206625686,101206625683,-3,1909,3582,10
101209556186,101209556185,-1,872,1299,10
101210513254,101210513252,-2,756,1300,10
101210545049,101210545035,-14,26,1351,10
101214392676,101214392674,-2,1114,1986,10
101218378209,101218378206,-3,915,1685,10
101224484659,101224484657,-2,1295,2062,10
101229042557,101229042553,-4,1608,2092,10
101231561872,101231561870,-2,939,1668,10
101231622729,101231622726,-3,952,1030,10
101232927195,101232927195,0,1726,1718,10
101234161353,101234161352,-1,950,1539,10
101234883563,101234883566,3,1111,1677,10
101235652612,101235652610,-2,1726,1800,10
101236660374,101236660371,-3,1282,2243,10
101241931680,101241931683,3,2695,2816,10
101244019775,101244019756,-19,781,730,10
101244865899,101244865899,0,801,1508,10
101248229372,101248229370,-2,1324,2067,10
101249226047,101249226045,-2,1186,2490,10
101250588836,101250588834,-2,1928,2392,10
101250838506,101250838506,0,1313,1842,10
101251199115,101251199114,-1,1454,2178,10
101251430264,101251430263,-1,1017,1960,10
101252691877,101252691876,-1,1353,1795,10
101252965714,101252965714,0,1132,1904,10
101253140031,101253140032,1,921,1395,10
101255105877,101255105877,0,1598,1815,10
101257690346,101257690353,7,2803,1726,10
101262392146,101262392145,-1,1702,2372,10
101263164112,101263164109,-3,1175,2431,10
101263213511,101263213507,-4,1109,1664,10
101263489351,101263489349,-2,1876,2819,10
101265026868,101265026868,0,1005,1421,10
101266684413,101266684410,-3,1275,2568,10
101268314883,101268314881,-2,1010,2078,10
101271609313,101271609316,3,1423,1515,10
101271946645,101271946650,5,1593,879,10
101275851325,101275851324,-1,1413,1276,10
101279636510,101279636509,-1,1216,2060,10
101281671979,101281671977,-2,1527,1485,10
101283729844,101283729842,-2,1112,2178,10
101284255571,101284255571,0,987,1804,10
101286531982,101286531976,-6,2108,7456,10
101289268595,101289268573,-22,1326,1981,10
101290976055,101290976050,-5,1239,1753,10
101291490277,101291490272,-5,977,2391,10
101293765136,101293765135,-1,1269,1478,10
101294488643,101294488644,1,1860,1853,10
101297849274,101297849273,-1,931,1868,10
101304944861,101304944859,-2,1710,2233,10
101305085862,101305085856,-6,1162,3703,10
101307983256,101307983253,-3,1094,2154,10
101311760512,101311760516,4,1748,1385,10
101311925700,101311925705,5,1730,999,10
101318910349,101318910349,0,987,1477,10
101321782774,101321782773,-1,997,2071,10
101323210194,101323210193,-1,1572,2179,10
101325373185,101325373186,1,1206,1734,10
101325890134,101325890134,0,1053,2232,10
101330419416,101330419409,-7,1324,1441,10
101333060467,101333060464,-3,1261,2038,10
101334114041,101334114023,-18,736,1200,10
101335133698,101335133693,-5,811,1629,10
101335173095,101335173094,-1,878,1529,10
101337435875,101337435872,-3,926,1606,10
101339815035,101339815034,-1,1433,1900,10
101341341555,101341341551,-4,1406,1944,10
101341884791,101341884787,-4,736,1896,10
101342683737,101342683734,-3,1506,2380,10
101343030202,101343030201,-1,925,1734,10
101347079154,101347079150,-4,1193,2396,10
101347759120,101347759120,0,1237,1612,10
101348060686,101348060684,-2,1087,1772,10
101348263168,101348263168,0,1438,2175,10
101349064314,101349064312,-2,1206,1982,10
101351574111,101351574106,-5,1118,2146,10
101353228052,101353228051,-1,2031,2142,10
101355681001,101355681000,-1,1521,2376,10
101356531634,101356531626,-8,34,466,10
101359653993,101359653992,-1,1250,1652,10
101363122722,101363122718,-4,864,1867,10
101364201753,101364201753,0,1316,1520,10
101365412290,101365412291,1,2713,2484,10
101368452707,101368452707,0,1025,1960,10
101371246326,101371246331,5,4654,2120,10
101373975445,101373975442,-3,1305,1237,10
101376193825,101376193824,-1,1624,1918,10
101378777641,101378777641,0,1409,1818,10
101381565118,101381565117,-1,1219,2012,10
101383194290,101383194289,-1,1143,2172,10
101388233997,101388233998,1,959,1824,10
101388323729,101388323727,-2,1494,2681,10
101388706883,101388706883,0,1106,1474,10
101389364702,101389364701,-1,1030,2095,10
101389975043,101389975039,-4,1272,1599,10
101401173271,101401173271,0,1129,1939,10
101401370546,101401370545,-1,1794,1895,10
101402901201,101402901200,-1,1329,2637,10
101406611932,101406611919,-13,1540,2418,10
101407516942,101407516942,0,959,2294,10
101407757262,101407757260,-2,1826,2728,10
101408192749,101408192748,-1,1355,2683,10
101409449938,101409449934,-4,477,1162,10
101411117218,101411117222,4,1836,1589,10
101412914475,101412914472,-3,1336,1983,10
101413695969,101413695967,-2,1433,2681,10
101416216639,101416216638,-1,1424,1726,10
101419550311,101419550309,-2,1185,1789,10
101420663770,101420663766,-4,923,1268,10
101424750908,101424750907,-1,1501,2426,10
101427661970,101427661969,-1,1252,2307,10
101428174658,101428174655,-3,1322,1692,10
101435005673,101435005670,-3,647,1272,10
101436960098,101436960097,-1,1243,2317,10
101441525887,101441525884,-3,980,2900,10
101444147379,101444147378,-1,1477,2349,10
101448185407,101448185405,-2,1083,2004,10
101449941412,101449941418,6,3948,1308,10
101450969589,101450969588,-1,1632,2657,10
101459896506,101459896506,0,842,1256,10
101460073427,101460073426,-1,1091,1803,10
101464048545,101464048543,-2,1117,1596,10
101465495815,101465495814,-1,1800,2060,10
101471294957,101471294956,-1,961,2029,10
101474776931,101474776919,-12,198,550,10
101478270562,101478270561,-1,1233,1999,10
101479719863,101479719862,-1,1257,1502,10
101484950284,101484950282,-2,1280,2163,10
101485775217,101485775211,-6,1792,6986,10
101490434208,101490434206,-2,1228,1547,10
101490521065,101490521084,19,829,3010,10
101491931187,101491931185,-2,1028,1803,10
101494300762,101494300762,0,1276,2034,10
101495932588,101495932586,-2,932,1674,10
101499728058,101499728058,0,2006,2286,10
101499773585,101499773605,20,1147,1660,10
101500675652,101500675652,0,1879,1925,10
101502918825,101502918825,0,920,2043,10
101504457210,101504457210,0,1639,1715,10
101506206239,101506206238,-1,1384,1821,10
101507871559,101507871559,0,1791,2253,10
101513262386,101513262382,-4,1488,2024,10
101518022460,101518022462,2,1701,1460,10
101531557715,101531557716,1,1383,2058,10
101537136569,101537136567,-2,699,1976,10
101537834624,101537834621,-3,1251,1999,10
101538310438,101538310436,-2,1396,2006,10
101538386494,101538386489,-5,754,980,10
101540759666,101540759667,1,826,1402,10
101545821917,101545821914,-3,1194,1953,10
101547261935,101547261934,-1,775,1109,10
101566782771,101566782771,0,1028,1558,10
101568631241,101568631242,1,1305,1417,10
101569278385,101569278382,-3,1064,2174,10
101569415400,101569415415,15,368,1052,10
101571344386,101571344382,-4,1163,2253,10
101572019126,101572019125,-1,1122,1448,10
101574662976,101574662962,-14,989,1658,10
101575673891,101575673890,-1,1411,2485,10
101576153742,101576153740,-2,1583,2043,10
101577067965,101577067963,-2,1756,1970,10
101577119226,101577119225,-1,1925,3108,10
101577928790,101577928787,-3,1191,2209,10
101578264585,101578264584,-1,1251,2465,10
101578848490,101578848490,0,1477,1696,10
101580516619,101580516621,2,647,1494,10
101581242186,101581242186,0,1890,2215,10
101585114219,101585114222,3,619,1354,10
101585528355,101585528355,0,1456,1893,10
101587519036,101587519023,-13,759,1838,10
101589663478,101589663476,-2,1392,1774,10
101590680058,101590680058,0,864,1337,10
101594779811,101594779810,-1,1330,1967,10
101596318517,101596318514,-3,1990,2968,10
101597695791,101597695788,-3,924,1850,10
101600926261,101600926263,2,1465,1851,10
101601977114,101601977113,-1,1270,2291,10
101605627539,101605627539,0,1114,1240,10
101611601534,101611601534,0,1474,1683,10
101612488425,101612488422,-3,1411,2522,10
101614524978,101614524978,0,1439,2281,10
101617699314,101617699314,0,1195,1409,10
101618783715,101618783713,-2,1264,2363,10
101620099902,101620099906,4,3549,1838,10
101622878575,101622878574,-1,808,1343,10
101623352784,101623352783,-1,2338,3512,10
101623885757,101623885755,-2,1230,1636,10
101626863383,101626863387,4,2505,1802,10
101627487109,101627487106,-3,1460,1841,10
101630495708,101630495709,1,1583,1476,10
101633039912,101633039909,-3,1199,2676,10
101636020885,101636020885,0,1033,1845,10
101636540744,101636540767,23,1224,1820,10
101638442263,101638442262,-1,1168,2234,10
101640130682,101640130680,-2,1178,1982,10
101642285873,101642285869,-4,1908,3023,10
101643366426,101643366425,-1,1378,1840,10
101645193721,101645193726,5,2099,1485,10
101645285359,101645285358,-1,1919,2418,10
101647028711,101647028710,-1,1206,2154,10
101647715396,101647715394,-2,1312,1883,10
101649776733,101649776731,-2,1650,2448,10
101652312506,101652312506,0,1009,1534,10
101652932715,101652932714,-1,932,1356,10
101653958158,101653958157,-1,1365,2020,10
101653989843,101653989840,-3,1214,1487,10
101654706393,101654706392,-1,1064,1917,10
101655663869,101655663866,-3,1152,2084,10
101664757545,101664757545,0,1353,2028,10
101668385554,101668385554,0,1499,1818,10
101669400286,101669400282,-4,1795,2104,10
101670754774,101670754781,7,5114,1341,10
101671699491,101671699489,-2,1167,1450,10
101677133000,101677132998,-2,1033,1921,10
101680276335,101680276331,-4,1057,3647,10
101680728257,101680728255,-2,1524,1996,10
101682909300,101682909298,-2,1140,1986,10
101684915446,101684915446,0,1149,1597,10
101690114123,101690114119,-4,1407,2629,10
101694287422,101694287417,-5,1652,5053,10
101696911649,101696911648,-1,1460,1981,10
101697809783,101697809781,-2,1876,2943,10
101702325863,101702325856,-7,917,2201,10
101702408498,101702408494,-4,2832,5359,10
101702669195,101702669195,0,696,1648,10
101707436926,101707436926,0,1146,2030,10
101708571742,101708571747,5,4926,2559,10
101710107132,101710107129,-3,1249,2681,10
101710433246,101710433265,19,1617,1245,10
101711005454,101711005453,-1,1377,1540,10
101713970319,101713970318,-1,1721,2605,10
101715085221,101715085218,-3,1311,2161,10
101717224674,101717224672,-2,1231,1987,10
101719909450,101719909457,7,786,1500,10
101722538082,101722538083,1,776,912,10
101723776075,101723776078,3,1510,1396,10
101730973006,101730973005,-1,1579,2781,10
101731337997,101731337995,-2,930,2162,10
101735779894,101735779890,-4,808,2161,10
101736850083,101736850082,-1,1356,1914,10
101738934568,101738934569,1,1498,1578,10
101744062973,101744062972,-1,1668,2060,10
101744986627,101744986630,3,2928,1828,10
101745322558,101745322557,-1,536,1358,10
101746182302,101746182302,0,1599,2693,10
101746981894,101746981895,1,3501,2938,10
101753579106,101753579106,0,1059,1772,10
101754148500,101754148498,-2,1210,2458,10
101755452166,101755452164,-2,1082,1317,10
101757478127,101757478127,0,1448,2993,10
101759707911,101759707910,-1,1116,1847,10
101762729493,101762729493,0,1089,1589,10
101762975255,101762975254,-1,1414,1993,10
101765339854,101765339854,0,988,1513,10
101766619862,101766619862,0,1433,2398,10
101769247545,101769247542,-3,1356,2487,10
101772352955,101772352954,-1,2032,2472,10
101773423626,101773423626,0,664,1532,10
101778185408,101778185406,-2,1768,2438,10
101786899203,101786899222,19,1120,1633,10
101788118994,101788118992,-2,982,2025,10
101789222109,101789222110,1,1139,1310,10
101790212923,101790212920,-3,1578,2426,10
101790426551,101790426548,-3,1359,2636,10
101794444996,101794444994,-2,1231,1706,10
101797644458,101797644449,-9,959,3935,10
101798470385,101798470383,-2,1353,1770,10
101804796446,101804796445,-1,1249,2736,10
101804864133,101804864129,-4,1210,1050,10
101805293274,101805293295,21,1214,1838,10
101809568111,101809568110,-1,1145,2204,10
101809620930,101809620934,4,3118,1930,10
101816278155,101816278154,-1,1110,1521,10
101817401293,101817401293,0,1054,1797,10
101818949998,101818949996,-2,1336,2482,10
101820935915,101820935908,-7,1096,6465,10
101828983910,101828983908,-2,1023,1661,10
101830416219,101830416219,0,876,1728,10
101832013650,101832013650,0,1415,2042,10
101839998419,101839998418,-1,1161,1934,10
101842728545,101842728545,0,3241,3763,10
101843411582,101843411581,-1,1048,2034,10
101843456912,101843456911,-1,516,1228,10
101843938078,101843938077,-1,1299,1415,10
101844250487,101844250486,-1,948,1516,10
101844869765,101844869762,-3,1162,1709,10
101847151947,101847151952,5,5373,2431,10
101848235215,101848235215,0,1122,1976,10
101850577767,101850577767,0,1247,1052,10
101854533677,101854533678,1,1144,2143,10
101856536269,101856536273,4,2072,1821,10
101857268378,101857268377,-1,1092,2137,10
101858496415,101858496416,1,2808,3934,10
101861432072,101861432070,-2,1362,1639,10
101861809457,101861809474,17,623,1411,10
101862516144,101862516138,-6,1152,5356,10
101865976785,101865976783,-2,1210,1963,10
101869446594,101869446593,-1,1238,1227,10
101870415701,101870415699,-2,1026,2238,10
101874784334,101874784333,-1,853,1698,10
101874971792,101874971815,23,1377,1770,10
101875593353,101875593350,-3,1117,2142,10
101876433094,101876433091,-3,1330,1713,10
101880491975,101880491973,-2,1027,1319,10
101884081367,101884081366,-1,1290,2629,10
101887616154,101887616160,6,5467,2733,10
101889843282,101889843282,0,1147,2471,10
101890314103,101890314100,-3,1415,1839,10
101891258015,101891257995,-20,1863,1581,10
101894157898,101894157905,7,3498,1012,10
101899162555,101899162553,-2,1186,2082,10
101905126416,101905126414,-2,1587,2350,10
101909034004,101909034002,-2,973,1615,10
101912469653,101912469650,-3,1340,2273,10
101912748862,101912748862,0,1323,2261,10
101916617474,101916617472,-2,1170,1696,10
101921772930,101921772928,-2,774,1599,10
101921811500,101921811517,17,1483,2128,10
101922730975,101922730974,-1,2111,2006,10
101922771691,101922771689,-2,1027,1773,10
101925137513,101925137512,-1,1029,1152,10
101928130341,101928130334,-7,2488,6336,10
101928801141,101928801137,-4,1987,4232,10
101928958089,101928958089,0,1372,2375,10
101930140838,101930140837,-1,1153,1486,10
101930895834,101930895833,-1,1047,2073,10
101932243663,101932243660,-3,778,1607,10
101933174939,101933174939,0,949,1072,10
101936389191,101936389184,-7,990,4942,10
101936594665,101936594663,-2,965,2271,10
101937825623,101937825620,-3,861,1474,10
101940163158,101940163174,16,1209,1296,10
101940813037,101940813036,-1,1365,2784,10
101943417730,101943417728,-2,1555,2193,10
101945602085,101945602084,-1,1205,1900,10
101949001373,101949001375,2,1405,1199,10
101952524166,101952524162,-4,1152,2478,10
101954216799,101954216798,-1,1320,2163,10
101956516769,101956516759,-10,2259,715,10
101957637322,101957637322,0,1264,1484,10
101962516005,101962516003,-2,1370,1979,10
101963003382,101963003381,-1,1061,1641,10
101965797794,101965797795,1,1646,1510,10
101966496781,101966496779,-2,876,1791,10
101975268918,101975268915,-3,1250,1847,10
101980587966,101980587965,-1,1307,1868,10
101986089098,101986089097,-1,1402,2000,10
101986841910,101986841910,0,1163,2857,10
101989229494,101989229491,-3,755,1803,10
101990319743,101990319742,-1,796,1059,10
101994068627,101994068626,-1,1520,1441,10
101994122558,101994122558,0,764,1110,10
101995294774,101995294786,12,743,1112,10
101996138858,101996138856,-2,1470,2962,10
101996569262,101996569262,0,704,1407,10
101998924669,101998924661,-8,1433,6108,10
102003450017,102003450016,-1,1354,1887,10
102007566592,102007566590,-2,1485,1327,10
102013211456,102013211456,0,981,1537,10
102018922727,102018922726,-1,1224,1580,10
102021782200,102021782182,-18,962,1724,10
102027559625,102027559622,-3,1620,1426,10
102033313881,102033313879,-2,1421,2543,10
102033373238,102033373237,-1,1356,2315,10
102033533256,102033533253,-3,1709,1639,10
102045189298,102045189305,7,7085,2568,10
102046251751,102046251750,-1,813,1171,10
102047274447,102047274444,-3,997,1398,10
102047877086,102047877087,1,1253,2197,10
102048516416,102048516397,-19,1011,2134,10
102051110652,102051110651,-1,1560,2051,10
102054809830,102054809831,1,1552,1893,10
102055309495,102055309492,-3,957,1685,10
102058507382,102058507381,-1,1736,3427,10
102061998793,102061998791,-2,1053,1797,10
102064128134,102064128133,-1,1761,2248,10
102068216499,102068216497,-2,1017,1681,10
102076032929,102076032934,5,2324,1603,10
102078384702,102078384701,-1,888,1971,10
102082847364,102082847363,-1,1246,1755,10
102088043827,102088043823,-4,1507,2299,10
102091575291,102091575290,-1,1455,1832,10
102092317967,102092317967,0,1667,1776,10
102092997062,102092997059,-3,1535,2749,10
102093499642,102093499641,-1,1456,1890,10
102095555629,102095555626,-3,1470,1877,10
102099132049,102099132058,9,1921,861,10
102101582076,102101582072,-4,416,2366,10
102104041363,102104041362,-1,1369,1892,10
102107922553,102107922551,-2,1199,2676,10
102110383377,102110383374,-3,1618,2281,10
102121213763,102121213762,-1,1547,1895,10
102124755633,102124755632,-1,1447,1859,10
102128045177,102128045175,-2,1799,2201,10
102128569669,102128569669,0,1661,2175,10
102131206587,102131206586,-1,1289,1535,10
102134053582,102134053574,-8,1441,6950,10
102134741551,102134741550,-1,1179,2561,10
102136385339,102136385338,-1,1137,1993,10
102137483168,102137483166,-2,1106,2264,10
102142315897,102142315895,-2,1412,2124,10
102142987678,102142987678,0,1067,2273,10
102145616151,102145616151,0,539,1232,10
102160600498,102160600494,-4,1080,1993,10
102161516751,102161516749,-2,628,1480,10
102161704695,102161704694,-1,1315,2200,10
102165763507,102165763501,-6,815,1189,10
102165976795,102165976794,-1,1537,1835,10
102166248206,102166248206,0,863,1551,10
102167855156,102167855155,-1,1473,2189,10
102170040274,102170040272,-2,925,1592,10
102170698314,102170698312,-2,1008,2057,10
102172545027,102172545026,-1,1523,1947,10
102172732183,102172732179,-4,1164,2221,10
102173876342,102173876341,-1,17956,7433,10
102190280509,102190280506,-3,1309,2075,10
102195520238,102195520241,3,1622,1399,10
102196856954,102196856953,-1,1259,1330,10
102196969929,102196969927,-2,1014,1778,10
102200153953,102200153950,-3,2174,5775,10
102202203143,102202203142,-1,1008,2705,10
102202772911,102202772910,-1,947,1836,10
102202858430,102202858430,0,1028,1990,10
102215761155,102215761153,-2,1356,1758,10
102217245485,102217245482,-3,960,1498,10
102218490329,102218490329,0,1175,1828,10
102222138776,102222138774,-2,1327,2136,10
102232686721,102232686718,-3,1086,1710,10
102232873641,102232873639,-2,978,2122,10
102237096280,102237096274,-6,1094,4196,10
102239207715,102239207713,-2,1041,1831,10
102242862885,102242862883,-2,1052,2221,10
102245509293,102245509293,0,1559,1739,10
102245721067,102245721063,-4,1013,2018,10
102248617042,102248617040,-2,1576,2490,10
102256453222,102256453202,-20,1354,1919,10
102257221222,102257221221,-1,1262,2267,10
102261260139,102261260137,-2,1166,1995,10
102261929586,102261929583,-3,2415,5145,10
102262683382,102262683381,-1,21106,2596,10
102263845562,102263845562,0,1403,2185,10
102264588287,102264588285,-2,1091,1745,10
102265260014,102265260012,-2,1467,1809,10
102266279730,102266279730,0,1226,1186,10
102268599015,102268599013,-2,1155,1353,10
102269225518,102269225518,0,1400,2068,10
102269519854,102269519850,-4,1236,1999,10
102270912195,102270912201,6,4073,2056,10
102271360677,102271360678,1,1171,2514,10
102271661739,102271661738,-1,1260,2003,10
102272275489,102272275511,22,682,1258,10
102272463945,102272463942,-3,1246,1239,10
102288424546,102288424546,0,1038,2622,10
102292353691,102292353688,-3,766,1656,10
102292825379,102292825375,-4,1054,1691,10
102295274153,102295274152,-1,1448,2996,10
102296391802,102296391801,-1,1662,3485,10
102297373326,102297373326,0,1111,2249,10
102300730064,102300730057,-7,2523,6204,10
102304579261,102304579257,-4,995,2673,10
102312559906,102312559905,-1,1184,2176,10
102312965899,102312965899,0,1078,1606,10
102313458454,102313458450,-4,1578,2769,10
102316750533,102316750533,0,1384,2436,10
102318850282,102318850281,-1,1110,1257,10
102321808895,102321808893,-2,1314,2091,10
102326367979,102326367979,0,1839,2052,10
102329567118,102329567122,4,1524,2135,10
102333081767,102333081766,-1,1130,1894,10
102338621408,102338621415,7,3430,1293,10
102340587077,102340587077,0,1048,1667,10
102342155639,102342155638,-1,1127,1263,10
102343919931,102343919930,-1,931,1749,10
102344904360,102344904358,-2,1243,3127,10
102344930302,102344930302,0,1658,2369,10
102347297455,102347297454,-1,1503,2159,10
102348021196,102348021194,-2,1387,2629,10
102349564097,102349564096,-1,1642,2124,10
102351362322,102351362318,-4,1441,3341,10
102353045764,102353045762,-2,1266,1638,10
102353218393,102353218390,-3,1486,2511,10
102353531201,102353531202,1,1626,2243,10
102357468226,102357468224,-2,1593,2032,10
102358321268,102358321266,-2,832,2149,10
102359142043,102359142063,20,787,1292,10
102359811782,102359811780,-2,1327,1744,10
102361073518,102361073518,0,907,1334,10
102361417058,102361417057,-1,1523,2719,10
102362190696,102362190703,7,3148,1229,10
102369507839,102369507838,-1,1220,1859,10
102370469295,102370469291,-4,814,1630,10
102373704673,102373704674,1,1114,1372,10
102376508004,102376508001,-3,1247,1673,10
102377838448,102377838450,2,1878,1572,10
102378446907,102378446906,-1,882,1951,10
102379985411,102379985410,-1,1310,1855,10
102383911910,102383911910,0,1269,1935,10
102385270367,102385270365,-2,1615,2245,10
102386476407,102386476403,-4,666,1516,10
102387338981,102387338981,0,1380,1665,10
102388454159,102388454151,-8,1391,3622,10
102389213984,102389213981,-3,1001,2747,10
102389854616,102389854606,-10,1289,1762,10
102391492543,102391492542,-1,1049,2003,10
102391614279,102391614274,-5,1069,2885,10
102392671577,102392671574,-3,1531,2602,10
102392901715,102392901712,-3,1026,2250,10
102400179345,102400179343,-2,615,1075,10
102401163170,102401163169,-1,1393,2014,10
102402006667,102402006663,-4,1241,2229,10
102403075666,102403075665,-1,1171,2401,10
102413440149,102413440146,-3,1298,2884,10
102416320322,102416320321,-1,1383,2199,10
102417101112,102417101110,-2,1479,1999,10
102417758178,102417758185,7,4089,1403,10
102417931655,102417931653,-2,658,2551,10
102419331840,102419331843,3,1256,1094,10
102422773191,102422773189,-2,1040,1433,10
102434345082,102434345080,-2,1927,2156,10
102436088425,102436088423,-2,1343,2158,10
102436197138,102436197137,-1,1419,2309,10
102445476465,102445476458,-7,576,1712,10
102446946044,102446946042,-2,922,1655,10
102449630239,102449630238,-1,964,1521,10
102453354806,102453354803,-3,1140,2744,10
102459649002,102459649006,4,2246,1384,10
102460570755,102460570753,-2,1899,2587,10
102464094975,102464094973,-2,1153,1537,10
102467261015,102467261016,1,1502,2669,10
102468529166,102468529165,-1,1310,2457,10
102473860519,102473860517,-2,954,2176,10
102477284782,102477284780,-2,1445,2764,10
102478259249,102478259270,21,218,1787,10
102483099511,102483099510,-1,783,1464,10
102488197872,102488197876,4,26386,57212,10
102490053179,102490053178,-1,1081,1926,10
102491716595,102491716593,-2,1252,1540,10
102496084558,102496084555,-3,769,1389,10
102498726970,102498726975,5,841,622,10
102500011062,102500011059,-3,1387,2293,10
102501558822,102501558819,-3,554,1379,10
102503154695,102503154693,-2,917,2336,10
102503235928,102503235950,22,1229,3401,10
102504585442,102504585438,-4,856,1498,10
102505927190,102505927172,-18,5902,2918,10
102507176233,102507176215,-18,5412,2521,10
102507674192,102507674195,3,1327,1349,10
102507924491,102507924470,-21,1110,1417,10
102508220946,102508220945,-1,745,1568,10
102509757388,102509757409,21,598,1921,10
102510960327,102510960327,0,1115,2260,10
102512218137,102512218135,-2,1464,2767,10
102514122665,102514122662,-3,1017,2199,10
102516505013,102516505018,5,1836,1194,10
102519353598,102519353604,6,2321,1378,10
102520781118,102520781118,0,1137,1464,10
102521697371,102521697371,0,1223,1243,10
102522011631,102522011634,3,1120,1385,10
102523477830,102523477827,-3,983,1980,10
102524097856,102524097853,-3,1111,1448,10
102527919767,102527919765,-2,2187,1977,10
102528552714,102528552713,-1,1272,1567,10
102531410677,102531410675,-2,1450,1801,10
102538110590,102538110586,-4,1276,2343,10
102540159995,102540159993,-2,1142,2036,10
102542828094,102542828091,-3,952,1913,10
102544077378,102544077375,-3,1107,1830,10
102545120944,102545120943,-1,1198,1145,10
102545594203,102545594201,-2,888,1374,10
102546547765,102546547758,-7,1378,3387,10
102548110154,102548110153,-1,1397,2385,10
102548981763,102548981765,2,1275,2056,10
102549342555,102549342535,-20,263,1691,10
102555835233,102555835232,-1,1661,1972,10
102557308511,102557308511,0,1377,1784,10
102560744488,102560744486,-2,1134,1599,10
102561548046,102561548045,-1,1154,3547,10
102566387093,102566387091,-2,1033,1071,10
102566685801,102566685797,-4,42742,16639,10
102569021617,102569021617,0,1479,2123,10
102570697654,102570697653,-1,1081,1851,10
102572637335,102572637334,-1,1392,1614,10
102574130426,102574130425,-1,782,1627,10
102575194266,102575194266,0,1108,1798,10
102575373906,102575373905,-1,801,1500,10
102575431425,102575431425,0,1297,1941,10
102576800486,102576800486,0,1275,938,10
102578598307,102578598305,-2,854,1564,10
102583225934,102583225934,0,1515,1741,10
102584738593,102584738590,-3,5210,11428,10
102584874958,102584874958,0,994,2822,10
102588962982,102588962978,-4,1013,1622,10
102589803636,102589803633,-3,1630,2280,10
102594653521,102594653521,0,1084,1415,10
102596701191,102596701192,1,880,1334,10
102597311370,102597311369,-1,1113,1493,10
102599152523,102599152523,0,1065,1441,10
102600957290,102600957286,-4,1090,3411,10
102601495200,102601495199,-1,1005,1712,10
102603749313,102603749312,-1,953,1640,10
102608003099,102608003101,2,1709,1582,10
102615303886,102615303885,-1,1193,2194,10
102620732975,102620732975,0,2726,2719,10
102621981823,102621981822,-1,1258,2731,10
102622971332,102622971330,-2,1031,1610,10
102627934994,102627934990,-4,1442,2665,10
102628588455,102628588454,-1,1346,1824,10
102629040292,102629040291,-1,1496,1754,10
102632018047,102632018045,-2,1199,1597,10
102633430319,102633430318,-1,1418,2564,10
102635627720,102635627720,0,1061,1836,10
102636651534,102636651532,-2,998,1594,10
102641398711,102641398708,-3,893,2090,10
102641760782,102641760781,-1,920,1557,10
102643261822,102643261822,0,1442,1880,10
102643398289,102643398290,1,1256,1413,10
102648257605,102648257603,-2,1849,2243,10
102651849174,102651849169,-5,961,1853,10
102653731754,102653731754,0,826,1748,10
102653792883,102653792883,0,872,1921,10
102654791234,102654791235,1,741,1189,10
102665869081,102665869080,-1,1315,2437,10
102666720329,102666720329,0,1687,3054,10
102668811668,102668811687,19,878,2484,10
102668911452,102668911450,-2,864,1852,10
102670636188,102670636181,-7,1268,2903,10
102673615304,102673615302,-2,1518,1999,10
102674552169,102674552170,1,1082,1370,10
102680967562,102680967561,-1,903,2330,10
102683886619,102683886617,-2,1043,1311,10
102685576294,102685576291,-3,1102,1602,10
102689868943,102689868938,-5,1313,4178,10
102690716630,102690716630,0,1545,2290,10
102697512666,102697512663,-3,1367,2404,10
102702403141,102702403139,-2,977,2175,10
102702531322,102702531312,-10,1575,2365,10
102702660801,102702660822,21,846,973,10
102703248056,102703248055,-1,1156,1595,10
102708302163,102708302161,-2,1427,1687,10
102709252020,102709252018,-2,786,1341,10
102709865722,102709865712,-10,1213,1648,10
102711063123,102711063122,-1,1378,2555,10
102711198172,102711198173,1,968,1835,10
102713301361,102713301359,-2,1717,2055,10
102715793458,102715793462,4,5841,2922,10
102716616390,102716616390,0,1134,1508,10
102726752561,102726752562,1,1062,1920,10
102727609907,102727609904,-3,1300,1511,10
102729549695,102729549695,0,1102,2063,10
102731131274,102731131271,-3,1825,4338,10
102732619398,102732619397,-1,1045,1763,10
102733895147,102733895146,-1,2174,2547,10
102741820801,102741820798,-3,1059,1130,10
102744489708,102744489706,-2,1291,2185,10
102745431243,102745431241,-2,1104,1723,10
102750568251,102750568249,-2,1273,2589,10
102751677966,102751677963,-3,1059,1837,10
102753104391,102753104387,-4,554,1981,10
102756335182,102756335182,0,1118,2057,10
102758045290,102758045286,-4,1167,2002,10
102759845413,102759845410,-3,1140,1795,10
102765759981,102765759977,-4,967,1490,10
102770903025,102770903023,-2,2150,2030,10
102771678301,102771678287,-14,1602,370,10
102774937528,102774937525,-3,23638,11118,10
102776971902,102776971902,0,1069,1042,10
102778095854,102778095850,-4,1772,2794,10
102780329114,102780329114,0,1119,2181,10
102783695976,102783695974,-2,1337,2088,10
102785307487,102785307482,-5,1044,3734,10
102787062186,102787062194,8,1690,891,10
102788562879,102788562877,-2,1112,1095,10
102788939582,102788939581,-1,1555,1998,10
102790004759,102790004758,-1,1326,1864,10
102790433754,102790433752,-2,1117,1757,10
102792460582,102792460581,-1,1016,1600,10
102794272840,102794272847,7,2601,1400,10
102799734405,102799734403,-2,1678,1386,10
102800004537,102800004538,1,1142,1849,10
102802928418,102802928417,-1,2018,1728,10
102807912511,102807912511,0,1519,2728,10
102813656726,102813656723,-3,1216,1639,10
102814860668,102814860669,1,1550,2257,10
102817053366,102817053373,7,3096,1545,10
102821060178,102821060177,-1,1786,4589,10
102822796706,102822796705,-1,1198,2027,10
102826128089,102826128087,-2,902,1418,10
102826791248,102826791245,-3,1256,2056,10
102829113498,102829113492,-6,1230,316,10
102832875604,102832875610,6,3686,1171,10
102833859722,102833859722,0,655,1184,10
102835631766,102835631763,-3,1312,2795,10
102837146216,102837146214,-2,1587,1612,10
102839405454,102839405453,-1,602,1844,10
102840736069,102840736067,-2,1134,2056,10
102841289727,102841289745,18,39474,18149,10
102842393162,102842393162,0,1055,1978,10
102843160295,102843160294,-1,479,1518,10
102845816659,102845816657,-2,1189,1971,10
102846099785,102846099784,-1,1387,2383,10
102846787614,102846787614,0,886,1281,10
102848511162,102848511149,-13,897,2883,10
102848562498,102848562484,-14,1013,1753,10
102851836075,102851836075,0,1659,2666,10
102851913775,102851913774,-1,903,1693,10
102852317505,102852317503,-2,1289,1320,10
102853923450,102853923447,-3,1060,1840,10
102858014783,102858014782,-1,942,2648,10
102860234441,102860234447,6,3553,3608,10
102861324894,102861324894,0,707,1350,10
102863957519,102863957515,-4,1151,1534,10
102864526362,102864526362,0,957,2176,10
102868490482,102868490483,1,1723,2050,10
102868875894,102868875892,-2,1319,3074,10
102869459227,102869459226,-1,1629,1675,10
102870882034,102870882039,5,2862,1201,10
102871568217,102871568216,-1,1494,3250,10
102872975985,102872975982,-3,1695,1996,10
102877859478,102877859481,3,1674,1037,10
102879844642,102879844643,1,1375,978,10
102881786377,102881786381,4,1680,1697,10
102883129650,102883129650,0,1559,1698,10
102883570103,102883570102,-1,983,2433,10
102891620561,102891620559,-2,1081,1914,10
102893912469,102893912467,-2,1261,1605,10
102895435038,102895435033,-5,740,3005,10
102895778460,102895778457,-3,1031,2560,10
102896454847,102896454844,-3,849,1697,10
102898148531,102898148528,-3,1406,2457,10
102900130926,102900130926,0,1093,1742,10
102902327036,102902327034,-2,1432,1456,10
102902596463,102902596463,0,1307,1392,10
102902772071,102902772069,-2,778,1567,10
102904176328,102904176325,-3,1331,1998,10
102904627691,102904627688,-3,1426,2888,10
102905155710,102905155709,-1,1325,2306,10
102905378265,102905378262,-3,1249,1958,10
102907101134,102907101132,-2,1283,1934,10
102909570279,102909570281,2,1654,869,10
102909819151,102909819150,-1,1516,2302,10
102913360497,102913360496,-1,1174,2236,10
102916186367,102916186366,-1,884,1344,10
102917428017,102917428015,-2,1997,2497,10
102918075649,102918075650,1,930,1339,10
102918434257,102918434255,-2,1092,1976,10
102921817062,102921817061,-1,1087,2374,10
102924566047,102924566047,0,1263,2305,10
102926553570,102926553569,-1,1236,2210,10
102931099983,102931099982,-1,1162,2170,10
102931513399,102931513399,0,1650,2039,10
102932409687,102932409681,-6,993,1981,10
102933597098,102933597094,-4,990,1427,10
102936373523,102936373523,0,1207,1590,10
102936738879,102936738878,-1,740,2066,10
102939380569,102939380571,2,1213,1347,10
102942728104,102942728102,-2,1051,1903,10
102943516775,102943516774,-1,1895,2577,10
102946478718,102946478718,0,1253,2234,10
102946703054,102946703053,-1,1396,1475,10
102946734657,102946734657,0,130,1020,10
102952642735,102952642733,-2,797,1856,10
102958395270,102958395270,0,1739,2232,10
102958592670,102958592670,0,1260,2097,10
102958679119,102958679114,-5,754,1122,10
102959941960,102959941953,-7,20122,17842,10
102964073211,102964073210,-1,1674,1991,10
102964571955,102964571953,-2,1826,2416,10
102966691099,102966691098,-1,974,2002,10
102967078543,102967078542,-1,1140,1711,10
102970258594,102970258592,-2,1395,1977,10
102971613950,102971613950,0,1012,1657,10
102975947697,102975947695,-2,1213,2161,10
102978483922,102978483924,2,3795,2818,10
102980625838,102980625837,-1,1199,2032,10
102983201630,102983201629,-1,1564,1541,10
102988134710,102988134706,-4,1178,1387,10
102994949434,102994949434,0,1171,2329,10
103007502810,103007502810,0,1007,1712,10
103009698502,103009698500,-2,1931,2927,10
103010204365,103010204363,-2,1031,1739,10
103010366498,103010366494,-4,1837,2009,10
103013133367,103013133366,-1,1114,1474,10
103013407202,103013407210,8,7253,29166,10
103013841443,103013841442,-1,858,1198,10
103018958240,103018958239,-1,1137,1355,10
103019337925,103019337923,-2,1536,2218,10
103022935110,103022935110,0,1998,1780,10
103023794808,103023794806,-2,1414,2257,10
103024452584,103024452583,-1,1218,2347,10
103025296230,103025296237,7,6665,2471,10
103026515267,103026515272,5,1058,1422,10
103032150693,103032150691,-2,1309,2263,10
103032177385,103032177382,-3,951,1657,10
103034926347,103034926347,0,2965,3097,10
103035502235,103035502232,-3,1090,2782,10
103035891021,103035891013,-8,1647,305,10
103037853782,103037853782,0,1209,1941,10
103043403351,103043403350,-1,745,1378,10
103044004765,103044004762,-3,1044,2044,10
103045641681,103045641694,13,88,1131,10
103047908298,103047908297,-1,1061,1270,10
103050498362,103050498363,1,1323,1723,10
103051480747,103051480745,-2,917,1615,10
103051530938,103051530947,9,17360,26166,10
103054237827,103054237826,-1,1297,1978,10
103054923890,103054923891,1,1627,2381,10
103057758266,103057758262,-4,1459,1841,10
103058003763,103058003766,3,2344,1607,10
103066484524,103066484523,-1,1303,1328,10
103069306592,103069306587,-5,1399,3034,10
103071671658,103071671657,-1,10036,15193,10
103074053037,103074053037,0,1073,1564,10
103078633134,103078633134,0,1113,1768,10
103080948898,103080948898,0,1349,2104,10
103081506434,103081506433,-1,808,1830,10
103083927763,103083927762,-1,1558,1801,10
103085132323,103085132318,-5,1099,2132,10
103087946958,103087946957,-1,923,1504,10
103090004563,103090004558,-5,1237,2466,10
103097241303,103097241302,-1,1165,1648,10
103098090586,103098090566,-20,1471,2383,10
103102913985,103102913986,1,1489,1200,10
103105573591,103105573590,-1,1226,2678,10
103112599725,103112599723,-2,1404,2678,10
103113240586,103113240584,-2,666,1142,10
103118680279,103118680276,-3,872,1605,10
103119564567,103119564566,-1,4399,8300,10
103127188612,103127188609,-3,1104,2112,10
103129607982,103129607978,-4,1310,1810,10
103130789568,103130789584,16,1258,2082,10
103132274902,103132274900,-2,2109,3823,10
103140164494,103140164494,0,1008,1605,10
103141788148,103141788146,-2,1318,1892,10
103141884205,103141884203,-2,1680,2274,10
103142438758,103142438756,-2,1351,1477,10
103146610147,103146610146,-1,4326,7059,10
103148482034,103148482033,-1,1304,2418,10
103151772111,103151772110,-1,1425,2285,10
103155403432,103155403431,-1,990,1086,10
103156233216,103156233214,-2,1385,2726,10
103157255077,103157255073,-4,972,1803,10
103159492619,103159492618,-1,1127,2090,10
103161479775,103161479774,-1,1190,1275,10
103161735613,103161735607,-6,1700,5321,10
103161971593,103161971590,-3,1214,2488,10
103173734862,103173734866,4,2404,1275,10
103173981783,103173981783,0,1017,1554,10
103179265027,103179265025,-2,1036,1814,10
103180881998,103180881997,-1,1680,2163,10
103181953927,103181953925,-2,1330,2125,10
103182210602,103182210620,18,1043,2335,10
103183990362,103183990359,-3,1238,2346,10
103185208591,103185208591,0,691,1780,10
103187779362,103187779361,-1,937,2148,10
103188211121,103188211118,-3,1373,1714,10
103188294042,103188294038,-4,1260,2446,10
103190061713,103190061710,-3,949,1810,10
103191889090,103191889087,-3,1726,2548,10
103194386622,103194386622,0,839,1489,10
103194823680,103194823662,-18,435,994,10
103195202030,103195202029,-1,988,1619,10
103199551000,103199551003,3,1629,1553,10
103200377633,103200377650,17,754,940,10
103200635367,103200635386,19,1183,1916,10
103201075805,103201075803,-2,1411,1906,10
103202933667,103202933666,-1,1219,1952,10
103204288546,103204288546,0,1411,1989,10
103206622713,103206622714,1,1196,2143,10
103211702045,103211702045,0,1100,1637,10
103214833801,103214833801,0,1297,1486,10
103218247438,103218247438,0,1298,1963,10
103218882356,103218882357,1,1436,1740,10
103232180511,103232180510,-1,1369,2096,10
103233509894,103233509893,-1,1315,2704,10
103233572687,103233572686,-1,1514,1851,10
103235122097,103235122096,-1,1011,2780,10
103236527961,103236527961,0,1250,1917,10
103237158035,103237158015,-20,1498,1658,10
103238596099,103238596097,-2,1108,1974,10
103244744488,103244744490,2,962,805,10
103248088703,103248088703,0,1425,1677,10
103248402671,103248402667,-4,1120,1974,10
103251863298,103251863296,-2,1695,1918,10
103253954603,103253954603,0,1513,1469,10
103254902827,103254902826,-1,767,1886,10
103255857406,103255857403,-3,2681,5258,10
103262008547,103262008545,-2,1462,2220,10
103264799211,103264799208,-3,1009,2014,10
103265253255,103265253254,-1,1376,2815,10
103268576921,103268576920,-1,870,1487,10
103268960037,103268960034,-3,1495,1490,10
103271954474,103271954475,1,1775,1249,10
103272153907,103272153906,-1,1108,1540,10
103272633837,103272633843,6,2079,855,10
103281701274,103281701273,-1,1289,2282,10
103282892842,103282892830,-12,2532,342,10
103282945926,103282945926,0,1754,2678,10
103284312010,103284312010,0,1420,1821,10
103284684599,103284684596,-3,36506,24518,10
103290101567,103290101566,-1,1259,1519,10
103290215539,103290215558,19,846,1116,10
103294005250,103294005251,1,1780,1976,10
103296998818,103296998817,-1,1130,1927,10
103299814625,103299814624,-1,1310,2040,10
103300649449,103300649445,-4,1285,2175,10
103301157622,103301157621,-1,1013,1498,10
103301265064,103301265081,17,446,1469,10
103303143664,103303143660,-4,1300,2833,10
103304908942,103304908943,1,1630,1810,10
103305456380,103305456380,0,1047,1504,10
103305859912,103305859910,-2,1126,1479,10
103307331675,103307331675,0,927,1511,10
103316292818,103316292817,-1,1122,2644,10
103316871689,103316871688,-1,1639,2383,10
103317814267,103317814267,0,1162,1933,10
103318506154,103318506153,-1,1146,1694,10
103320295887,103320295885,-2,1699,2969,10
103322631909,103322631903,-6,1117,3137,10
103322750778,103322750767,-11,1187,1604,10
103323453763,103323453762,-1,1236,1544,10
103325191579,103325191578,-1,906,1795,10
103326628347,103326628342,-5,1141,2017,10
103334129683,103334129681,-2,1014,1972,10
103339469758,103339469755,-3,1003,1961,10
103342105310,103342105308,-2,1266,3481,10
103344978679,103344978678,-1,971,1549,10
103348553349,103348553346,-3,1354,2211,10
103350438671,103350438669,-2,1547,2471,10
103355707324,103355707327,3,2021,1610,10
103357691974,103357691974,0,1156,1344,10
103357937107,103357937105,-2,1340,1539,10
103358627417,103358627417,0,904,1578,10
103360095726,103360095725,-1,1156,1876,10
103363593424,103363593426,2,1710,845,10
103363923064,103363923086,22,787,1725,10
103365223165,103365223167,2,1365,1923,10
103366503393,103366503391,-2,1072,2117,10
103368069939,103368069935,-4,667,1335,10
103368504556,103368504574,18,1094,3277,10
103373069514,103373069511,-3,1581,2892,10
103374842702,103374842702,0,1780,1826,10
103380071310,103380071310,0,1086,1879,10
103384669134,103384669133,-1,1493,2570,10
103384702148,103384702153,5,2526,1369,10
103385943232,103385943230,-2,1336,2638,10
103389391009,103389391007,-2,1139,2852,10
103390366485,103390366482,-3,1462,2749,10
103392711043,103392711042,-1,1352,2060,10
103396054755,103396054753,-2,1252,2258,10
103397693852,103397693850,-2,3537,7235,10
103398072410,103398072409,-1,1180,2017,10
103398199626,103398199621,-5,1496,3437,10
103401695593,103401695590,-3,1554,2313,10
103402251888,103402251886,-2,1022,1437,10
103402515745,103402515726,-19,187,5586,10
103404270271,103404270272,1,1358,2080,10
103405539626,103405539625,-1,719,1258,10
103412396236,103412396235,-1,1127,1816,10
103412767941,103412767942,1,988,1267,10
103413498846,103413498844,-2,1367,2537,10
103414616116,103414616115,-1,1028,1642,10
103415890219,103415890222,3,1345,1425,10
103416296942,103416296940,-2,823,1441,10
103417819130,103417819126,-4,782,1613,10
103419325875,103419325873,-2,1080,1726,10
103421077797,103421077793,-4,1584,3283,10
103423762005,103423762005,0,1517,1476,10
103424085124,103424085124,0,1623,2228,10
103425109176,103425109199,23,555,1451,10
103428801733,103428801735,2,1064,1577,10
103429330991,103429330990,-1,888,1724,10
103432587754,103432587752,-2,1070,2240,10
103432987969,103432987964,-5,1010,2637,10
103434976108,103434976108,0,1334,1411,10
103440274420,103440274419,-1,1849,2300,10
103440936046,103440936044,-2,1213,2898,10
103444190965,103444190963,-2,738,1266,10
103444503920,103444503920,0,1366,2030,10
103446110810,103446110810,0,942,1875,10
103448123061,103448123071,10,708,1383,10
103449589361,103449589361,0,1133,1355,10
103456154896,103456154898,2,1317,1082,10
103459324267,103459324266,-1,1617,2657,10
103461022874,103461022881,7,550,601,10
103461858841,103461858840,-1,969,2173,10
103462284655,103462284662,7,6322,19709,10
103466481898,103466481897,-1,825,1701,10
103468795891,103468795889,-2,1229,2328,10
103471882405,103471882403,-2,1002,2175,10
103478306865,103478306862,-3,6151,12913,10
103482226126,103482226125,-1,962,1956,10
103482880440,103482880439,-1,1397,2737,10
103483935835,103483935836,1,1269,2370,10
103485138793,103485138791,-2,1889,2255,10
103485609018,103485609017,-1,1146,1965,10
103487534059,103487534058,-1,923,1914,10
103488938199,103488938198,-1,1219,1860,10
103493426407,103493426407,0,1346,2637,10
103494956879,103494956878,-1,1329,1789,10
103498623644,103498623644,0,1618,1839,10
103498861414,103498861414,0,1599,1897,10
103498900479,103498900477,-2,1494,1883,10
103502231605,103502231608,3,3583,2619,10
103502602510,103502602508,-2,891,1779,10
103508230178,103508230177,-1,872,2206,10
103508505435,103508505426,-9,1173,2253,10
103508832923,103508832920,-3,1908,2604,10
103511329476,103511329466,-10,782,2375,10
103511870651,103511870649,-2,1136,2077,10
103513706726,103513706724,-2,958,1895,10
103518784451,103518784449,-2,1034,2497,10
103523720909,103523720914,5,4204,2248,10
103527478858,103527478857,-1,1120,2258,10
103528666617,103528666617,0,1252,1877,10
103530841111,103530841110,-1,1282,2160,10
103533613995,103533613990,-5,856,2063,10
103533682538,103533682541,3,8012,7945,10
103537014471,103537014471,0,1378,1441,10
103538989468,103538989468,0,994,2300,10
103539270529,103539270551,22,530,1128,10
103542950450,103542950447,-3,1791,2860,10
103543498141,103543498138,-3,1276,2337,10
103546072338,103546072338,0,1043,1693,10
103559069869,103559069874,5,3282,2001,10
103559456206,103559456206,0,642,1100,10
103560216630,103560216630,0,1376,1810,10
103561084790,103561084787,-3,1332,1848,10
103568456527,103568456526,-1,1508,2375,10
103568924143,103568924140,-3,1008,1843,10
103569197106,103569197104,-2,1125,1898,10
103569429545,103569429525,-20,279,556,10
103571548766,103571548765,-1,1396,2177,10
103572301786,103572301783,-3,1284,2129,10
103578525747,103578525746,-1,942,1695,10
103579127383,103579127382,-1,1381,1527,10
103585763817,103585763817,0,1260,1568,10
103585870834,103585870817,-17,823,1802,10
103590042396,103590042392,-4,825,2662,10
103593990014,103593990012,-2,1048,1361,10
103594838509,103594838510,1,1501,1230,10
103599840658,103599840663,5,2981,1201,10
103602123271,103602123270,-1,1378,2706,10
103602921711,103602921710,-1,947,1820,10
103603139481,103603139478,-3,1242,2123,10
103605562641,103605562649,8,2848,1068,10
103607406412,103607406410,-2,1060,2270,10
103608330466,103608330466,0,1212,1806,10
103608655334,103608655333,-1,1197,1823,10
103611936989,103611936990,1,823,1941,10
103620547950,103620547949,-1,1095,1573,10
103623959893,103623959890,-3,1103,1723,10
103624824911,103624824910,-1,915,2843,10
103633108894,103633108894,0,1380,1380,10
103634047531,103634047531,0,1011,1925,10
103638864569,103638864568,-1,1404,2126,10
103639265247,103639265245,-2,1503,1607,10
103639994697,103639994697,0,1085,1828,10
103641554505,103641554502,-3,1706,2527,10
103642961579,103642961582,3,1407,2136,10
103644716220,103644716219,-1,1547,2516,10
103647102998,103647102998,0,1207,1548,10
103650383383,103650383383,0,672,1282,10
103650743787,103650743767,-20,1159,1869,10
103658034766,103658034765,-1,1259,2242,10
103660240622,103660240621,-1,1774,2555,10
103664924018,103664924014,-4,1312,2391,10
103670540265,103670540262,-3,1226,2126,10
103677965775,103677965773,-2,1191,2099,10
103678337867,103678337865,-2,1314,1788,10
103681938250,103681938259,9,9048,23418,10
103685684270,103685684266,-4,1821,2550,10
103685905490,103685905490,0,1323,1333,10
103687835165,103687835166,1,1008,1700,10
103692938022,103692938022,0,1540,1975,10
103699777159,103699777154,-5,1436,3484,10
103709757669,103709757666,-3,1015,1577,10
103711355650,103711355649,-1,1329,1611,10
103718485501,103718485498,-3,1178,2040,10
103719770526,103719770525,-1,1145,1397,10
103720561964,103720561958,-6,1745,5835,10
103721785249,103721785246,-3,1198,1697,10
103722440181,103722440177,-4,973,2008,10
103727148955,103727148954,-1,869,1408,10
103729636593,103729636591,-2,1722,2576,10
103731724602,103731724600,-2,3003,4812,10
103731849007,103731849007,0,1247,1248,10
103733009775,103733009774,-1,929,1697,10
103740863406,103740863402,-4,2289,5059,10
103741992627,103741992633,6,4634,874,10
103743261815,103743261813,-2,1092,2240,10
103747212839,103747212840,1,882,1526,10
103747689444,103747689442,-2,1605,1523,10
103751804246,103751804245,-1,6998,10519,10
103757500021,103757500021,0,1370,1925,10
103757827320,103757827322,2,1216,2034,10
103759720885,103759720884,-1,1108,3264,10
103762515924,103762515921,-3,1418,2257,10
103764022183,103764022182,-1,1351,1739,10
103766049421,103766049422,1,1467,2110,10
103769770973,103769770966,-7,2571,11199,10
103772789814,103772789814,0,1181,1925,10
103773171301,103773171305,4,1430,1634,10
103773968498,103773968495,-3,1375,2271,10
103775764878,103775764877,-1,1260,2145,10
103776900298,103776900295,-3,1448,2408,10
103783756342,103783756340,-2,1337,2397,10
103788002758,103788002756,-2,1048,2330,10
103788943737,103788943737,0,1162,2349,10
103790643754,103790643753,-1,1130,2043,10
103791354806,103791354809,3,1818,1426,10
103792359329,103792359328,-1,1383,2043,10
103793535422,103793535422,0,904,1639,10
103798819442,103798819438,-4,30946,12025,10
103802586366,103802586365,-1,752,1366,10
103808450049,103808450047,-2,1371,1644,10
103812200097,103812200093,-4,1516,3218,10
103813710385,103813710383,-2,1222,1780,10
103818703782,103818703782,0,966,1878,10
103819409371,103819409370,-1,1004,1489,10
103828671819,103828671819,0,1328,2281,10
103830620962,103830620962,0,1516,1509,10
103833623302,103833623302,0,1727,2380,10
103835901253,103835901254,1,1042,1587,10
103836054779,103836054777,-2,1169,1920,10
103838007082,103838007080,-2,1238,2316,10
103844849666,103844849682,16,965,5267,10
103848120287,103848120289,2,1180,1441,10
103851156155,103851156156,1,1860,1573,10
103851286814,103851286814,0,1658,1765,10
103851705631,103851705635,4,3508,2237,10
103851955736,103851955734,-2,912,1982,10
103852391659,103852391655,-4,791,1396,10
103853264218,103853264218,0,1107,2166,10
103854927841,103854927839,-2,1523,3044,10
103857059362,103857059359,-3,1267,1897,10
103858113323,103858113341,18,717,1708,10
103859052119,103859052118,-1,1577,1871,10
103859876567,103859876564,-3,1336,2219,10
103861574760,103861574761,1,1173,1768,10
103864832850,103864832850,0,1038,1893,10
103864945435,103864945437,2,189,1109,10
103867609979,103867609978,-1,1314,2163,10
103868930346,103868930344,-2,1195,2167,10
103868993306,103868993305,-1,1033,2273,10
103869325203,103869325201,-2,1400,2301,10
103870466522,103870466519,-3,1893,2955,10
103870636162,103870636162,0,939,1485,10
103875217250,103875217250,0,1029,1945,10
103877657050,103877657047,-3,1056,2545,10
103878141708,103878141708,0,1389,1765,10
103879100234,103879100237,3,1305,1516,10
103879815783,103879815782,-1,1176,1737,10
103897349284,103897349282,-2,939,1190,10
103900411439,103900411436,-3,1173,1957,10
103901782703,103901782701,-2,1091,1734,10
103905206471,103905206474,3,1101,1525,10
103909310199,103909310200,1,833,1608,10
103910235510,103910235506,-4,1292,3506,10
103912256335,103912256334,-1,1086,2628,10
103912568619,103912568615,-4,602,1150,10
103920010458,103920010458,0,58254,62065,10
103921430348,103921430348,0,1743,2125,10
103921898241,103921898241,0,1084,1347,10
103925331720,103925331719,-1,869,1556,10
103930257175,103930257174,-1,1008,1736,10
103934368547,103934368550,3,1342,1767,10
103935354914,103935354915,1,939,2283,10
103936396601,103936396603,2,3645,3330,10
103940967788,103940967786,-2,1021,1960,10
103941395442,103941395441,-1,1117,1730,10
103941704821,103941704822,1,885,1299,10
103958517792,103958517790,-2,1818,2560,10
103960551243,103960551241,-2,969,1716,10
103960919721,103960919718,-3,1450,1581,10
103961036298,103961036298,0,1254,1697,10
103962867015,103962867016,1,986,2072,10
103964576069,103964576066,-3,1732,3287,10
103967537541,103967537541,0,1335,1599,10
103973251389,103973251387,-2,879,1620,10
103975117015,103975117013,-2,1128,2053,10
103975355702,103975355698,-4,1564,2332,10
103983354433,103983354435,2,1104,1044,10
103983496149,103983496149,0,800,1229,10
103986530231,103986530230,-1,1009,1759,10
103988787455,103988787454,-1,1561,2341,10
103988894930,103988894929,-1,594,1871,10
103988974488,103988974491,3,120,473,10
103992380587,103992380585,-2,1440,1891,10
103993867874,103993867873,-1,1340,2306,10
103994298462,103994298462,0,1125,1305,10
103995373554,103995373553,-1,893,1590,10
104000900401,104000900398,-3,1418,2531,10
104001949038,104001949037,-1,795,1723,10
104005636471,104005636472,1,1851,2520,10
104005883288,104005883287,-1,1155,2002,10
104007584637,104007584636,-1,1049,2106,10
104010277467,104010277466,-1,881,1560,10
104014189129,104014189128,-1,1100,2505,10
104014906751,104014906749,-2,1383,2321,10
104017836971,104017836973,2,1487,1725,10
104019029429,104019029429,0,1480,2637,10
104029315481,104029315479,-2,1304,1592,10
104029728259,104029728260,1,3465,3255,10
104030004674,104030004674,0,1345,2084,10
104037079306,104037079306,0,1364,2277,10
104039552426,104039552423,-3,1384,1944,10
104042891401,104042891399,-2,1428,2428,10
104044320673,104044320671,-2,1257,1248,10
104050075419,104050075421,2,10199,8870,10
104052347526,104052347527,1,1427,1630,10
104052657097,104052657094,-3,983,2174,10
104056130870,104056130873,3,1188,1462,10
104060946514,104060946510,-4,1457,1946,10
104063330382,104063330382,0,851,2948,10
104071130707,104071130705,-2,975,2105,10
104074092871,104074092871,0,1154,1696,10
104079400515,104079400519,4,19356,23605,10
104082461731,104082461730,-1,1295,2305,10
104083454757,104083454755,-2,986,1665,10
104085138814,104085138818,4,1690,1408,10
104091443503,104091443505,2,1239,1617,10
104096076698,104096076696,-2,1101,1799,10
104102703038,104102703039,1,1080,2018,10
104103012635,104103012634,-1,1013,1819,10
104105704278,104105704275,-3,1175,1785,10
104107186691,104107186690,-1,971,2031,10
104107641993,104107641972,-21,363,742,10
104108275885,104108275884,-1,1339,1892,10
104108858149,104108858148,-1,859,1762,10
104111900312,104111900310,-2,1105,1841,10
104116017830,104116017830,0,2406,2881,10
104116515994,104116515992,-2,1056,2019,10
104119583355,104119583353,-2,1336,1843,10
104120191938,104120191938,0,1030,1283,10
104120522633,104120522623,-10,1736,2208,10
104121034402,104121034402,0,1469,2732,10
104121761533,104121761526,-7,2190,7087,10
104123953189,104123953187,-2,1424,2398,10
104129008160,104129008159,-1,1254,2613,10
104131144214,104131144210,-4,1073,2546,10
104133161051,104133161049,-2,1472,2419,10
104133613378,104133613376,-2,914,2434,10
104138722021,104138722020,-1,930,1589,10
104139824083,104139824081,-2,1045,1967,10
104140482910,104140482910,0,1033,1706,10
104140750294,104140750292,-2,2073,3942,10
104144058954,104144058951,-3,1190,2289,10
104144930866,104144930862,-4,1021,1943,10
104149400560,104149400562,2,1085,1336,10
104152972987,104152972987,0,1000,2109,10
104158087679,104158087678,-1,957,2115,10
104162534670,104162534671,1,1173,1748,10
104165115824,104165115823,-1,981,1909,10
104166119111,104166119109,-2,1016,1825,10
104172293275,104172293276,1,1579,1510,10
104173430067,104173430071,4,1578,1205,10
104182960877,104182960883,6,4589,2185,10
104185580938,104185580934,-4,1440,1337,10
104190912383,104190912382,-1,1426,2603,10
104191267341,104191267339,-2,1421,2604,10
104194088762,104194088761,-1,1273,1858,10
104198581239,104198581237,-2,1287,2263,10
104198896585,104198896582,-3,992,2703,10
104200408002,104200408003,1,1285,1789,10
104207493192,104207493192,0,1469,1622,10
104207669829,104207669826,-3,967,1620,10
104208966043,104208966044,1,1197,1237,10
104210295783,104210295777,-6,1308,2057,10
104210683098,104210683097,-1,1187,1724,10
104215315727,104215315724,-3,1115,2196,10
104216714681,104216714679,-2,1117,2092,10
104217995133,104217995130,-3,2088,4735,10
104219081398,104219081398,0,1622,1727,10
104223207028,104223207021,-7,1153,5617,10
104223969830,104223969829,-1,1386,1708,10
104224693527,104224693525,-2,1628,2787,10
104225771015,104225771014,-1,1201,1408,10
104230645767,104230645765,-2,762,1307,10
104232965275,104232965273,-2,1561,3668,10
104233436854,104233436855,1,1004,1092,10
104234145956,104234145975,19,1115,3821,10
104235039870,104235039863,-7,1514,4536,10
104238517370,104238517368,-2,1118,1317,10
104238551859,104238551858,-1,1138,1728,10
104240575448,104240575448,0,1426,1991,10
104240650692,104240650711,19,799,2043,10
104242990491,104242990490,-1,3052,3992,10
104246258062,104246258061,-1,1152,1649,10
104257164919,104257164918,-1,1124,1602,10
104258800345,104258800343,-2,1055,1886,10
104268280122,104268280118,-4,875,1884,10
104274521543,104274521551,8,4223,1393,10
104276108139,104276108140,1,1126,2291,10
104277264317,104277264316,-1,1327,2889,10
104278806238,104278806238,0,1021,1506,10
104281329202,104281329201,-1,1540,1918,10
104281901727,104281901728,1,1423,1628,10
104282086527,104282086526,-1,1860,2118,10
104282324665,104282324667,2,1474,1113,10
104289385735,104289385734,-1,1344,1543,10
104291848698,104291848697,-1,531,1517,10
104292200898,104292200880,-18,907,1547,10
104294825789,104294825787,-2,1164,2824,10
104296467366,104296467366,0,1078,1867,10
104296604666,104296604666,0,1022,1203,10
104298459106,104298459105,-1,1110,2071,10
104301950949,104301950950,1,753,1105,10
104304019646,104304019646,0,890,2028,10
104306309382,104306309385,3,1473,793,10
104309124013,104309124011,-2,1326,2015,10
104309355491,104309355473,-18,115,1152,10
104315066909,104315066909,0,987,1469,10
104316127839,104316127834,-5,932,2443,10
104317063219,104317063226,7,2893,1408,10
104317433771,104317433771,0,714,1571,10
104319497989,104319497995,6,2340,1104,10
104323567771,104323567773,2,1407,2125,10
104327568891,104327568898,7,11485,27972,10
104328385387,104328385387,0,1028,1997,10
104328513040,104328513063,23,1134,2144,10
104328821842,104328821843,1,1374,1532,10
104329628002,104329627999,-3,653,2158,10
104331988026,104331988025,-1,418,949,10
104333330669,104333330670,1,1193,2117,10
104334861278,104334861275,-3,1212,2036,10
104337979882,104337979880,-2,1281,2234,10
104338264939,104338264936,-3,1014,1614,10
104338298801,104338298783,-18,1149,1884,10
104343895957,104343895955,-2,1019,1688,10
104345313270,104345313268,-2,1215,2167,10
104346861907,104346861907,0,1196,2157,10
104351356779,104351356778,-1,1696,2448,10
104352042859,104352042858,-1,1073,1867,10
104353049103,104353049103,0,1112,1375,10
104353400939,104353400921,-18,1146,1547,10
104355620162,104355620162,0,999,1654,10
104355811967,104355811971,4,1692,1283,10
104357261842,104357261837,-5,728,1497,10
104358028832,104358028831,-1,1646,2864,10
104359531029,104359531025,-4,1316,3591,10
104362498941,104362498942,1,1042,999,10
104368965234,104368965231,-3,1423,2547,10
104379198169,104379198166,-3,1244,1939,10
104379682478,104379682477,-1,1150,1768,10
104385295077,104385295078,1,1661,1780,10
104386321650,104386321646,-4,964,2701,10
104386465960,104386465954,-6,1284,2094,10
104387734615,104387734615,0,859,2170,10
104387847962,104387847961,-1,1197,2122,10
104389678091,104389678090,-1,1417,1747,10
104392910790,104392910785,-5,1207,3640,10
104396118955,104396118953,-2,2071,5231,10
104399850823,104399850822,-1,758,1259,10
104401328102,104401328101,-1,1109,1658,10
104403517577,104403517570,-7,2306,9023,10
104404403660,104404403669,9,14593,26683,10
104407081313,104407081311,-2,987,2620,10
104410304826,104410304829,3,1338,1452,10
104410971802,104410971811,9,647,1540,10
104413047310,104413047306,-4,1027,1772,10
104416545951,104416545947,-4,1232,1962,10
104416757658,104416757654,-4,1381,3843,10
104418289184,104418289182,-2,929,1641,10
104418988900,104418988899,-1,1335,2376,10
104421628655,104421628653,-2,1578,2160,10
104421657451,104421657448,-3,1109,2408,10
104428204240,104428204240,0,1036,1516,10
104431163235,104431163231,-4,1487,2446,10
104432418337,104432418351,14,817,1764,10
104433376446,104433376443,-3,1215,2565,10
104433525428,104433525426,-2,752,1917,10
104438808158,104438808157,-1,890,2055,10
104439246277,104439246290,13,2739,1359,10
104441129398,104441129397,-1,1038,1609,10
104447888935,104447888934,-1,1569,2268,10
104453852766,104453852765,-1,1514,1472,10
104454413048,104454413049,1,1076,1295,10
104454990866,104454990865,-1,1231,1362,10
104457322827,104457322826,-1,1501,2291,10
104457962655,104457962654,-1,1028,2453,10
104458920114,104458920113,-1,876,1561,10
104465314253,104465314260,7,1066,1739,10
104467598288,104467598286,-2,1388,2287,10
104467796332,104467796330,-2,1299,1961,10
104472927846,104472927833,-13,1079,1484,10
104474512850,104474512849,-1,1787,2366,10
104475572314,104475572319,5,1036,1108,10
104477463638,104477463637,-1,712,1641,10
104481920761,104481920759,-2,1056,2941,10
104483950622,104483950619,-3,1637,2143,10
104489872342,104489872342,0,1410,1720,10
104490445567,104490445567,0,1345,1881,10
104491437410,104491437410,0,1065,1227,10
104493372499,104493372498,-1,1031,1863,10
104494610318,104494610315,-3,1037,3024,10
104495045273,104495045266,-7,976,4895,10
104496819216,104496819215,-1,1266,2098,10
104500079527,104500079527,0,969,1687,10
104501636853,104501636853,0,1081,2404,10
104501997899,104501997900,1,1236,1910,10
104504441377,104504441376,-1,1191,2971,10
104504848724,104504848719,-5,1007,2077,10
104506079275,104506079273,-2,1419,2036,10
104507673453,104507673451,-2,1243,2490,10
104511163915,104511163912,-3,877,1514,10
104512310046,104512310052,6,2012,1472,10
104514091677,104514091672,-5,1292,3400,10
104518432129,104518432129,0,1605,2622,10
104518712368,104518712366,-2,946,1785,10
104518861924,104518861921,-3,1046,2583,10
104519262928,104519262926,-2,1802,2563,10
104528353765,104528353765,0,1269,1932,10
104535034705,104535034705,0,1163,1333,10
104535578928,104535578928,0,1411,2195,10
104539278646,104539278645,-1,885,2013,10
104542975058,104542975058,0,1381,2710,10
104543935143,104543935142,-1,976,1985,10
104544208042,104544208038,-4,1019,1438,10
104546903684,104546903682,-2,1329,2496,10
104549389833,104549389829,-4,1085,1802,10
104553663397,104553663395,-2,1352,1940,10
104554998134,104554998129,-5,706,1221,10
104555739432,104555739429,-3,1543,1990,10
104557317686,104557317685,-1,1267,2163,10
104558166824,104558166822,-2,32,1083,10
104563426859,104563426856,-3,1518,1891,10
104564251325,104564251326,1,1410,1543,10
104567899355,104567899356,1,969,1663,10
104568294535,104568294533,-2,920,1898,10
104572596960,104572596961,1,1249,1903,10
104574442582,104574442579,-3,1134,2524,10
104575828043,104575828041,-2,1321,1918,10
104578841738,104578841737,-1,865,1535,10
104581374685,104581374676,-9,24943,47855,10
104583570770,104583570768,-2,1248,1889,10
104585117209,104585117206,-3,1630,1607,10
104588768910,104588768916,6,1556,1463,10
104590742295,104590742298,3,2335,2162,10
104596733323,104596733320,-3,1060,2076,10
104602963257,104602963256,-1,787,2092,10
104604904790,104604904786,-4,541,1201,10
104608387806,104608387805,-1,1096,2174,10
104611675203,104611675201,-2,964,1925,10
104613493391,104613493389,-2,1083,1998,10
104614138415,104614138421,6,11609,18918,10
104614337435,104614337434,-1,958,1834,10
104614708784,104614708805,21,1188,2024,10
104616717079,104616717078,-1,1072,1524,10
104617105866,104617105869,3,2686,2700,10
104624240570,104624240569,-1,1149,1785,10
104627104993,104627104977,-16,1244,2808,10
104627362214,104627362216,2,4927,22930,10
104628743869,104628743869,0,1323,2360,10
104630587594,104630587577,-17,726,256,10
104631689002,104631689001,-1,1005,1606,10
104631935638,104631935637,-1,1216,1986,10
104632443913,104632443913,0,1310,1782,10
104638678677,104638678677,0,1367,2374,10
104655853041,104655853038,-3,4967,10779,10
104661564909,104661564906,-3,990,1329,10
104662666165,104662666162,-3,908,2475,10
104667009639,104667009634,-5,1353,2687,10
104667419023,104667419021,-2,1378,1604,10
104668521347,104668521346,-1,1367,2004,10
104668611438,104668611438,0,906,1635,10
104670899298,104670899297,-1,1037,2086,10
104675009499,104675009493,-6,809,2351,10
104678482759,104678482759,0,1156,1169,10
104681796038,104681796043,5,2475,1146,10
104681976687,104681976686,-1,1554,1499,10
104682249935,104682249933,-2,1098,1762,10
104684301647,104684301646,-1,1103,1540,10
104684514098,104684514095,-3,1246,2031,10
104686692265,104686692262,-3,1214,2173,10
104689805782,104689805780,-2,1651,1927,10
104690966766,104690966764,-2,949,1809,10
104691090340,104691090359,19,1463,1997,10
104698788917,104698788915,-2,1320,1835,10
104699759342,104699759322,-20,1420,1787,10
104717443419,104717443415,-4,1526,1988,10
104718674818,104718674818,0,1270,2036,10
104718761299,104718761293,-6,450,1470,10
104723265253,104723265254,1,940,647,10
104724904333,104724904333,0,1141,1710,10
104729734265,104729734263,-2,1046,1478,10
104730216074,104730216073,-1,1629,1518,10
104730709973,104730709971,-2,1016,2063,10
104732525150,104732525147,-3,1349,2032,10
104735118379,104735118389,10,2565,1737,10
104737496578,104737496574,-4,1521,2492,10
104743011817,104743011815,-2,1577,1625,10
104743212797,104743212794,-3,1202,1736,10
104744612230,104744612229,-1,1125,1625,10
104744678594,104744678599,5,1093,963,10
104745353394,104745353400,6,15238,28299,10
104746596370,104746596367,-3,1315,2176,10
104746737948,104746737961,13,282,8789,10
104748588061,104748588068,7,2016,1170,10
104749393114,104749393109,-5,585,1473,10
104750302365,104750302366,1,848,1729,10
104750503170,104750503166,-4,1728,6243,10
104754954790,104754954790,0,1284,1980,10
104760553059,104760553058,-1,1116,2134,10
104768126466,104768126461,-5,1178,4098,10
104770959346,104770959344,-2,972,2124,10
104772735274,104772735293,19,818,1322,10
104774215775,104774215783,8,428,1371,10
104774251322,104774251321,-1,1383,1978,10
104774535427,104774535426,-1,1563,2490,10
104777829722,104777829721,-1,1407,2742,10
104778869182,104778869181,-1,958,2506,10
104780699387,104780699387,0,1654,2612,10
104781005847,104781005847,0,1145,1911,10
104781363786,104781363785,-1,1440,1897,10
104783796434,104783796430,-4,1336,2445,10
104793376578,104793376579,1,1121,2056,10
104793781896,104793781895,-1,1134,2078,10
104796425299,104796425298,-1,1260,2252,10
104798041938,104798041939,1,1084,1390,10
104802959354,104802959355,1,1379,2300,10
104805363453,104805363453,0,1881,1468,10
104810693430,104810693429,-1,1262,1024,10
104814094846,104814094842,-4,1347,2834,10
104817432870,104817432869,-1,1395,2131,10
104817546186,104817546185,-1,1140,1838,10
104819995489,104819995490,1,1013,1613,10
104823176121,104823176121,0,1291,2404,10
104826001394,104826001390,-4,1137,3179,10
104828361220,104828361215,-5,1811,2303,10
104835386351,104835386349,-2,820,1921,10
104838561579,104838561577,-2,1072,2030,10
104839113853,104839113869,16,14671,55248,10
104840229585,104840229583,-2,1229,1673,10
104841955815,104841955813,-2,1219,1798,10
104842076219,104842076203,-16,693,1510,10
104844648852,104844648851,-1,1314,1551,10
104845633400,104845633397,-3,1148,1494,10
104846534237,104846534236,-1,1333,1428,10
104848050453,104848050457,4,2542,1204,10
104851734211,104851734212,1,1582,2059,10
104852393451,104852393451,0,1011,1950,10
104855752403,104855752402,-1,1231,2073,10
104857034039,104857034037,-2,988,1927,10
104858322358,104858322361,3,1626,1274,10
104858464327,104858464324,-3,1485,2416,10
104861177633,104861177638,5,17004,6796,10
104862160930,104862160926,-4,962,1873,10
104862207276,104862207275,-1,1109,1437,10
104863379115,104863379116,1,1261,2220,10
104864210167,104864210167,0,1658,1850,10
104864922528,104864922526,-2,882,1189,10
104877037193,104877037190,-3,2035,2682,10
104879483197,104879483194,-3,1255,1650,10
104879771185,104879771183,-2,1550,1596,10
104881382527,104881382525,-2,692,1326,10
104890128270,104890128262,-8,28363,14954,10
104891291410,104891291407,-3,1608,2107,10
104892275369,104892275366,-3,1002,1369,10
104893940693,104893940692,-1,1177,2401,10
104898645612,104898645611,-1,1549,2671,10
104901269214,104901269214,0,1441,2197,10
104903968375,104903968373,-2,1332,2101,10
104908973057,104908973057,0,1399,1848,10
104913994018,104913994017,-1,1033,1265,10
104914346059,104914346058,-1,895,1638,10
104915536278,104915536274,-4,1030,2266,10
104916448478,104916448475,-3,624,1198,10
104921161998,104921161991,-7,1125,4628,10
104921259984,104921259979,-5,1560,2498,10
104922594842,104922594842,0,982,1323,10
104926493458,104926493457,-1,1082,1814,10
104933904082,104933904081,-1,1371,2027,10
104934299062,104934299060,-2,1485,2128,10
104935267667,104935267665,-2,808,1321,10
104940321507,104940321505,-2,1086,1782,10
104943606951,104943606948,-3,7198,16603,10
104944827341,104944827337,-4,917,917,10
104944977682,104944977675,-7,1142,2961,10
104948881489,104948881487,-2,1087,2057,10
104951187646,104951187646,0,814,1041,10
104955824211,104955824210,-1,893,1212,10
104956428945,104956428943,-2,1305,1841,10
104961190082,104961190082,0,1152,1795,10
104963755597,104963755594,-3,1214,2420,10
104964960641,104964960636,-5,1464,2483,10
104970040696,104970040694,-2,1047,1954,10
104970139673,104970139670,-3,1321,2810,10
104970852930,104970852928,-2,698,1161,10
104971478702,104971478700,-2,1149,1885,10
104973268995,104973268993,-2,699,1586,10
104974937095,104974937095,0,979,1775,10
104975758999,104975758999,0,1244,1593,10
104976027795,104976027794,-1,1505,2468,10
104977128015,104977128014,-1,1576,1803,10
104977970061,104977970066,5,1115,452,10
104978284322,104978284321,-1,1538,2889,10
104980392697,104980392698,1,1747,1657,10
104981106742,104981106740,-2,786,1420,10
104982535754,104982535753,-1,1233,2436,10
104983433655,104983433655,0,1175,2064,10
104990684396,104990684394,-2,1247,2118,10
104992393367,104992393365,-2,1054,1684,10
104994827937,104994827934,-3,1674,2712,10
105000797163,105000797161,-2,920,1865,10
105001799905,105001799900,-5,1011,2559,10
105005769762,105005769763,1,1058,2058,10
105006318993,105006318990,-3,1538,2928,10
105019032508,105019032501,-7,3664,13693,10
105019431480,105019431478,-2,1048,2120,10
105021879674,105021879674,0,1676,2128,10
105022721480,105022721477,-3,651,1146,10
105029455785,105029455782,-3,839,1181,10
105030451939,105030451937,-2,896,1626,10
105033822027,105033822026,-1,1595,1679,10
105034253001,105034252998,-3,1201,1471,10
105034799290,105034799289,-1,960,1616,10
105040580554,105040580557,3,2522,1560,10
105041916118,105041916118,0,914,1650,10
105042754319,105042754317,-2,1043,2006,10
105042916633,105042916633,0,986,1469,10
105045291275,105045291275,0,1286,2007,10
105045751299,105045751298,-1,1337,2294,10
105050329702,105050329701,-1,1300,1708,10
105051455491,105051455492,1,1217,2198,10
105053693371,105053693370,-1,1994,2367,10
105054189398,105054189397,-1,1580,2220,10
105054698432,105054698430,-2,1021,2218,10
105061750182,105061750183,1,1384,2005,10
105067615608,105067615606,-2,1161,1850,10
105069863421,105069863418,-3,1262,1391,10
105074865758,105074865760,2,1526,1265,10
105076924371,105076924370,-1,851,1174,10
105083101206,105083101204,-2,1422,2979,10
105086966532,105086966531,-1,2062,2353,10
105089608214,105089608213,-1,380,1100,10
105090388131,105090388130,-1,1052,1998,10
105090902773,105090902770,-3,938,1946,10
105091560286,105091560299,13,112,210,10
105096523390,105096523386,-4,1227,2663,10
105098909147,105098909144,-3,779,1672,10
105101141460,105101141459,-1,1150,1754,10
105101270950,105101270950,0,1493,1378,10
105102784629,105102784628,-1,1268,2401,10
105106627062,105106627061,-1,1063,1566,10
105109740907,105109740901,-6,1125,4499,10
105113710985,105113710982,-3,1119,1445,10
105119128207,105119128212,5,1820,1243,10
105119224429,105119224427,-2,1391,2220,10
105121667385,105121667383,-2,1360,2263,10
105122099196,105122099194,-2,1372,1886,10
105123055332,105123055350,18,1082,876,10
105126022551,105126022550,-1,1089,2409,10
105128903911,105128903910,-1,966,2342,10
105132663681,105132663681,0,1389,1275,10
105134091997,105134091995,-2,1402,1761,10
105136291921,105136291916,-5,1002,1711,10
105143254038,105143254037,-1,1233,2179,10
105145514450,105145514450,0,1715,2524,10
105148016377,105148016378,1,1247,1602,10
105149596570,105149596571,1,845,1799,10
105151311232,105151311232,0,1136,1629,10
105152959982,105152959987,5,2325,939,10
105166693865,105166693870,5,2374,1017,10
105167827105,105167827104,-1,1190,2159,10
105168269567,105168269566,-1,1138,1867,10
105170092386,105170092406,20,349,559,10
105172439974,105172439971,-3,1140,2093,10
105173614101,105173614100,-1,797,2233,10
105174669412,105174669409,-3,1052,1850,10
105176655808,105176655808,0,1314,1852,10
105178902467,105178902465,-2,29154,25527,10
105180888514,105180888510,-4,1032,2644,10
105184171758,105184171756,-2,1354,2237,10
105185733360,105185733350,-10,1254,1464,10
105186330782,105186330780,-2,1033,1758,10
105188194442,105188194440,-2,1068,1167,10
105189044434,105189044432,-2,928,2178,10
105195393947,105195393947,0,1273,1268,10
105195473331,105195473330,-1,1177,1394,10
105197823102,105197823102,0,1222,1805,10
105201285103,105201285098,-5,963,1276,10
105203572311,105203572311,0,1894,1925,10
105204056837,105204056840,3,3576,2077,10
105204418361,105204418361,0,1155,1619,10
105208122236,105208122234,-2,983,1889,10
105208641235,105208641253,18,1227,2366,10
105211121202,105211121200,-2,1273,2115,10
105213021285,105213021286,1,1356,1448,10
105217250308,105217250304,-4,1307,4096,10
105217886435,105217886435,0,819,1710,10
105218393243,105218393241,-2,1429,2698,10
105218937714,105218937714,0,710,1026,10
105221925335,105221925333,-2,1483,1614,10
105223609233,105223609233,0,1227,2032,10
105223663607,105223663609,2,1473,1763,10
105224030306,105224030304,-2,1000,2412,10
105224183832,105224183830,-2,1023,1684,10
105224682966,105224682967,1,2030,2195,10
105229462935,105229462934,-1,918,1637,10
105229853052,105229853070,18,714,1164,10
105230180291,105230180291,0,1733,2605,10
105230491398,105230491399,1,772,1072,10
105230972835,105230972830,-5,286,1042,10
105240771749,105240771751,2,1539,1986,10
105242456011,105242456008,-3,980,1821,10
105242550549,105242550546,-3,949,2321,10
105246894855,105246894853,-2,1114,1973,10
105249936040,105249936043,3,1182,1148,10
105250135165,105250135165,0,1402,1715,10
105252252635,105252252634,-1,1418,1816,10
105253226074,105253226073,-1,1171,1991,10
105258817107,105258817108,1,1637,2120,10
105259146990,105259146990,0,1730,2683,10
105260460355,105260460352,-3,1204,1932,10
105265297857,105265297857,0,1420,1556,10
105269050571,105269050570,-1,1771,2402,10
105269255514,105269255513,-1,996,1421,10
105275555204,105275555206,2,1093,1489,10
105282007742,105282007741,-1,996,2017,10
105282098960,105282098959,-1,1186,2011,10
105286594090,105286594089,-1,1432,1286,10
105289247975,105289247973,-2,936,1718,10
105294829912,105294829906,-6,1190,2370,10
105295236035,105295236030,-5,1133,2154,10
105300581642,105300581643,1,1056,1296,10
105302215207,105302215208,1,1084,2024,10
105303940427,105303940425,-2,1375,1886,10
105304463313,105304463298,-15,1138,2027,10
105306386554,105306386554,0,1101,1672,10
105306615016,105306615013,-3,673,1904,10
105307071190,105307071188,-2,857,1536,10
105314096714,105314096715,1,1713,1950,10
105316522518,105316522518,0,1319,2002,10
105323001368,105323001369,1,1046,1757,10
105323962147,105323962147,0,1619,1381,10
105324668979,105324668977,-2,959,1014,10
105328652418,105328652436,18,1022,959,10
105331070791,105331070787,-4,952,2128,10
105331865822,105331865826,4,1366,1676,10
105332205435,105332205431,-4,1341,2808,10
105338708750,105338708746,-4,1279,2180,10
105340811883,105340811883,0,1142,2387,10
105344952687,105344952686,-1,1286,1256,10
105347639905,105347639906,1,958,1766,10
105348154155,105348154136,-19,178,593,10
105349298934,105349298936,2,1200,1464,10
105351011920,105351011922,2,2133,1812,10
105352895086,105352895090,4,758,1152,10
105354214603,105354214601,-2,1417,2138,10
105358094007,105358094007,0,1149,1868,10
105362843828,105362843826,-2,1111,2240,10
105363157675,105363157673,-2,764,870,10
105366642195,105366642193,-2,969,1400,10
105367379763,105367379760,-3,1000,2353,10
105371353053,105371353051,-2,1042,2400,10
105372894523,105372894522,-1,989,1806,10
105374340723,105374340730,7,10748,31704,10
105376705708,105376705721,13,298,587,10
105378668589,105378668585,-4,1156,3918,10
105381518067,105381518067,0,1046,1741,10
105384386842,105384386839,-3,922,1873,10
105387845838,105387845835,-3,1844,3293,10
105389297058,105389297055,-3,1102,1673,10
105390331085,105390331080,-5,1423,4180,10
105391423111,105391423110,-1,977,1714,10
105391878046,105391878044,-2,598,1372,10
105392386145,105392386143,-2,555,10027,10
105395093977,105395093974,-3,1351,2104,10
105400420742,105400420742,0,972,1496,10
105400849718,105400849721,3,2457,1815,10
105400943218,105400943219,1,1249,1579,10
105404370966,105404370964,-2,1102,2258,10
105405906311,105405906317,6,4364,1533,10
105407001982,105407001981,-1,1653,2059,10
105412887785,105412887782,-3,996,1932,10
105413550026,105413550023,-3,1450,2142,10
105414872293,105414872293,0,1942,2438,10
105416462731,105416462724,-7,1006,4675,10
105419927266,105419927265,-1,1092,1825,10
105422027923,105422027921,-2,1073,1883,10
105423066550,105423066550,0,1523,2002,10
105427763927,105427763925,-2,857,1844,10
105431744853,105431744858,5,3076,2377,10
105432530150,105432530151,1,1120,2188,10
105433976858,105433976855,-3,1348,2006,10
105436038370,105436038368,-2,1220,1888,10
105438583926,105438583927,1,2462,1463,10
105440006502,105440006506,4,2227,1215,10
105440733143,105440733138,-5,925,1703,10
105444810611,105444810609,-2,1334,2501,10
105447730694,105447730691,-3,772,2155,10
105450599018,105450598996,-22,1486,2922,10
105462297737,105462297735,-2,1012,3143,10
105462979395,105462979394,-1,1240,1889,10
105466123879,105466123879,0,888,2300,10
105467295498,105467295497,-1,1152,1974,10
105470862198,105470862198,0,1154,1987,10
105473865728,105473865726,-2,1635,2361,10
105474816275,105474816278,3,1734,1611,10
105475089136,105475089138,2,1492,1490,10
105475528794,105475528793,-1,1207,2198,10
105476421793,105476421792,-1,1151,2311,10
105478883567,105478883567,0,1394,1802,10
105480053354,105480053351,-3,1595,2363,10
105480733515,105480733514,-1,1764,2101,10
105484400734,105484400734,0,809,1940,10
105484485332,105484485351,19,536,700,10
105489009902,105489009901,-1,1092,2487,10
105493491346,105493491346,0,1092,2043,10
105494671995,105494671994,-1,3140,3982,10
105494739214,105494739214,0,1636,1941,10
105494866115,105494866113,-2,1435,2859,10
105501122478,105501122478,0,1217,2310,10
105504450866,105504450873,7,4940,2094,10
105507178418,105507178413,-5,1669,3303,10
105512508960,105512508959,-1,1058,1543,10
105513340655,105513340654,-1,1149,1181,10
105514850167,105514850164,-3,875,1705,10
105515155365,105515155363,-2,1274,2871,10
105515909443,105515909442,-1,1565,2788,10
105517423409,105517423406,-3,1109,1701,10
105517903468,105517903466,-2,1714,1734,10
105521198566,105521198559,-7,904,2457,10
105521671288,105521671280,-8,783,1389,10
105524969354,105524969352,-2,1189,1406,10
105527368220,105527368219,-1,787,1826,10
105529553987,105529553986,-1,921,1359,10
105531862050,105531862055,5,1183,1342,10
105532929498,105532929497,-1,819,2356,10
105533861019,105533861020,1,1541,2273,10
105534164168,105534164169,1,949,1647,10
105535666436,105535666437,1,23788,20851,10
105537586378,105537586377,-1,1089,2397,10
105539043773,105539043772,-1,927,1664,10
105540304379,105540304377,-2,963,1936,10
105541207815,105541207814,-1,1053,1499,10
105541577098,105541577098,0,1918,2499,10
105542546905,105542546902,-3,1432,2003,10
105545661012,105545661015,3,1971,1649,10
105548646763,105548646760,-3,1002,2287,10
105567400966,105567400964,-2,902,1816,10
105567963424,105567963422,-2,629,1445,10
105568180925,105568180924,-1,1606,2827,10
105568395268,105568395265,-3,1345,2294,10
105570286859,105570286857,-2,1565,2457,10
105570433476,105570433487,11,213,1262,10
105576083028,105576083028,0,1213,1768,10
105576448949,105576448953,4,2116,1739,10
105578413875,105578413869,-6,1087,5228,10
105580112303,105580112302,-1,1071,2165,10
105580370334,105580370334,0,1495,1785,10
105588275060,105588275057,-3,19638,11985,10
105597389781,105597389778,-3,1261,3045,10
105597910482,105597910481,-1,1350,2156,10
105599704568,105599704575,7,316,823,10
105601015093,105601015091,-2,1407,1825,10
105603476366,105603476365,-1,1319,2485,10
105611113187,105611113189,2,3711,3272,10
105612437073,105612437071,-2,1456,1807,10
105614940166,105614940166,0,1196,1495,10
105618358489,105618358489,0,1581,2668,10
105618648634,105618648637,3,1317,1705,10
105620376130,105620376131,1,1372,2166,10
105627814075,105627814076,1,1226,2585,10
105629807862,105629807860,-2,1119,2400,10
105632376820,105632376818,-2,1358,1788,10
105632592459,105632592478,19,507,3279,10
105637042998,105637042995,-3,1047,1484,10
105640024981,105640024980,-1,1150,1861,10
105640694518,105640694518,0,1467,1522,10
105643012998,105643012998,0,1315,1923,10
105646589991,105646589990,-1,1409,2707,10
105648956339,105648956340,1,1468,2156,10
105654119263,105654119263,0,1395,1511,10
105654596901,105654596901,0,1460,2174,10
105658085271,105658085272,1,1421,1596,10
105658905938,105658905938,0,1433,1791,10
105665939312,105665939310,-2,1274,1656,10
105666866590,105666866589,-1,830,1209,10
105670730474,105670730471,-3,1388,2092,10
105671528639,105671528639,0,981,1662,10
105672317096,105672317094,-2,1329,1939,10
105678060342,105678060348,6,11998,30473,10
105678499793,105678499790,-3,1536,2986,10
105680258301,105680258301,0,2113,3677,10
105687851342,105687851342,0,802,2271,10
105689571261,105689571259,-2,1591,1799,10
105690931046,105690931045,-1,1179,1952,10
105696672945,105696672942,-3,1317,1672,10
105697320820,105697320820,0,1503,2048,10
105701124202,105701124201,-1,1131,1923,10
105701541922,105701541942,20,1017,1154,10
105702762694,105702762691,-3,1180,2306,10
105707783318,105707783317,-1,1341,1883,10
105708596667,105708596666,-1,1093,2005,10
105710795222,105710795220,-2,1217,2220,10
105713099299,105713099299,0,1062,1684,10
105716916537,105716916536,-1,1019,2085,10
105724477662,105724477660,-2,1133,4295,10
105726477690,105726477690,0,1064,2087,10
105729318356,105729318353,-3,1810,1973,10
105729496091,105729496090,-1,747,2331,10
105729819394,105729819395,1,868,1377,10
105732419360,105732419352,-8,1404,2144,10
105733187640,105733187638,-2,1906,3332,10
105734048347,105734048345,-2,909,2152,10
105734382965,105734382963,-2,1076,2010,10
105739509611,105739509607,-4,919,1567,10
105740435586,105740435587,1,2340,1497,10
105741266762,105741266761,-1,936,1501,10
105741944608,105741944609,1,1507,1759,10
105743798776,105743798775,-1,1006,932,10
105746911851,105746911850,-1,1317,2105,10
105750418858,105750418857,-1,1741,2497,10
105751294356,105751294354,-2,1339,1973,10
105751586889,105751586889,0,897,1866,10
105753506610,105753506610,0,1647,1900,10
105756726179,105756726179,0,1570,2354,10
105759568938,105759568936,-2,1035,1823,10
105761139814,105761139813,-1,1598,2578,10
105762209815,105762209813,-2,979,1964,10
105763011629,105763011626,-3,859,1548,10
105763824501,105763824497,-4,987,2602,10
105770297956,105770297958,2,42708,17631,10
105770666525,105770666528,3,1882,2272,10
105779403081,105779403079,-2,1089,1741,10
105785104917,105785104918,1,1947,1497,10
105785254082,105785254083,1,1305,1498,10
105788922122,105788922122,0,1430,2208,10
105795501487,105795501482,-5,1260,1947,10
105796053133,105796053133,0,1565,2130,10
105799028904,105799028904,0,1502,1871,10
105802205190,105802205190,0,1321,1580,10
105807625386,105807625383,-3,1834,3155,10
105808771914,105808771913,-1,1217,1613,10
105817621141,105817621139,-2,1537,2152,10
105820055454,105820055455,1,1653,2211,10
105821338214,105821338214,0,2066,2538,10
105821599185,105821599185,0,3568,4737,10
105821778690,105821778688,-2,1725,2347,10
105824349070,105824349068,-2,1622,2111,10
105825740779,105825740778,-1,961,1190,10
105829831061,105829831061,0,795,1883,10
105837032471,105837032470,-1,1784,1871,10
105837313586,105837313586,0,1468,1397,10
105839015232,105839015228,-4,1091,2243,10
105846078352,105846078351,-1,1456,1700,10
105847182714,105847182714,0,1329,1405,10
105854440482,105854440483,1,1637,1949,10
105856676683,105856676683,0,1449,2080,10
105857626182,105857626178,-4,942,1779,10
105858967679,105858967681,2,1607,2004,10
105859234201,105859234211,10,18714,49258,10
105860818539,105860818538,-1,1687,2788,10
105862745554,105862745560,6,3622,2633,10
105869897725,105869897722,-3,1051,2386,10
105870146499,105870146498,-1,644,1661,10
105870840671,105870840669,-2,925,1633,10
105876615463,105876615464,1,1201,1768,10
105880138717,105880138714,-3,1155,1465,10
105880906666,105880906666,0,1350,1580,10
105886171961,105886171959,-2,1635,2035,10
105889846494,105889846493,-1,1451,2126,10
105890385678,105890385669,-9,1654,10846,10
105892804130,105892804130,0,932,1083,10
105894557930,105894557950,20,529,1976,10
105894962994,105894962995,1,770,1312,10
105898682685,105898682681,-4,1029,2259,10
105901360692,105901360691,-1,1174,1652,10
105904326903,105904326903,0,886,783,10
105908719826,105908719826,0,845,1969,10
105910297394,105910297413,19,1222,2251,10
105911405442,105911405441,-1,1040,1329,10
105911554466,105911554465,-1,1126,1735,10
105918383730,105918383729,-1,1929,3801,10
105919901573,105919901575,2,1204,1782,10
105924235621,105924235619,-2,1563,2913,10
105924871010,105924871009,-1,1402,2463,10
105928015617,105928015615,-2,1533,2432,10
105928679154,105928679152,-2,1169,2470,10
105929049659,105929049664,5,682,1057,10
105929912504,105929912503,-1,1358,2645,10
105930283439,105930283438,-1,947,2490,10
105930656278,105930656279,1,1690,2848,10
105930916570,105930916569,-1,1515,1510,10
105931833598,105931833598,0,1463,1572,10
105932169382,105932169382,0,1308,1156,10
105936012290,105936012286,-4,1113,1621,10
105937804460,105937804459,-1,706,1500,10
105938489354,105938489352,-2,1638,2984,10
105940722183,105940722183,0,1884,1664,10
105941364170,105941364169,-1,1380,2202,10
105941527050,105941527050,0,1611,2047,10
105943044266,105943044264,-2,1013,1393,10
105948516423,105948516422,-1,1140,1517,10
105953170591,105953170591,0,1476,1928,10
105961765303,105961765300,-3,1262,2404,10
105962623437,105962623437,0,1315,2440,10
105966761901,105966761901,0,1635,1784,10
105966895358,105966895357,-1,1438,2588,10
105970197070,105970197072,2,1677,2055,10
105972323215,105972323210,-5,1289,2455,10
105972590355,105972590367,12,325,1680,10
105973559885,105973559885,0,979,1811,10
105975721574,105975721579,5,2129,1197,10
105976912326,105976912325,-1,986,1679,10
105979340187,105979340185,-2,1465,2030,10
105982032268,105982032269,1,1695,2231,10
105982141929,105982141928,-1,1300,2116,10
105983028522,105983028519,-3,1826,2537,10
105983728547,105983728547,0,1204,2619,10
105985011998,105985011997,-1,15466,18925,10
105985594317,105985594313,-4,969,1573,10
105989429883,105989429882,-1,1144,1776,10
105990497341,105990497338,-3,1100,1627,10
105992673600,105992673598,-2,1237,2268,10
105996818944,105996818944,0,1426,2012,10
106000524914,106000524913,-1,1139,1445,10
106013370637,106013370633,-4,1452,2008,10
106018979674,106018979673,-1,1246,1636,10
106021562282,106021562283,1,1259,1145,10
106022299784,106022299780,-4,1120,2026,10
106025125488,106025125488,0,1440,1749,10
106028374951,106028374952,1,1088,1503,10
106030961931,106030961930,-1,1299,1992,10
106036154535,106036154533,-2,1145,1360,10
106043417851,106043417848,-3,1050,2343,10
106044127045,106044127042,-3,1553,2509,10
106046251275,106046251274,-1,1095,2106,10
106047315975,106047315973,-2,1012,915,10
106049329271,106049329272,1,1469,2509,10
106050254053,106050254050,-3,785,2218,10
106059488871,106059488870,-1,942,1649,10
106071023863,106071023861,-2,1120,2117,10
106071175852,106071175870,18,621,1078,10
106072600059,106072600059,0,1134,1517,10
106072704175,106072704174,-1,1376,2027,10
106073018927,106073018922,-5,1139,4712,10
106075749471,106075749470,-1,1009,1940,10
106078865263,106078865261,-2,1109,1744,10
106079011313,106079011316,3,1801,2507,10
106079510580,106079510581,1,1052,1664,10
106079706983,106079706982,-1,1029,1681,10
106082177746,106082177746,0,986,1462,10
106084981618,106084981622,4,1779,1081,10
106085312670,106085312670,0,1004,2001,10
106086417087,106086417085,-2,1558,1927,10
106086514303,106086514306,3,848,1434,10
106090800938,106090800935,-3,1454,2485,10
106091656078,106091656082,4,1717,1312,10
106092803683,106092803682,-1,1228,2717,10
106093531482,106093531479,-3,1507,1381,10
106099935318,106099935320,2,1504,1300,10
106101992730,106101992730,0,1239,2267,10
106102215874,106102215873,-1,1342,1832,10
106102515278,106102515277,-1,1177,1857,10
106105539736,106105539733,-3,982,1972,10
106108151815,106108151814,-1,1131,1815,10
106109294360,106109294361,1,32283,27670,10
106111183211,106111183211,0,1301,1766,10
106113559899,106113559898,-1,887,1571,10
106114504901,106114504902,1,925,1285,10
106114769344,106114769344,0,3268,4187,10
106118853282,106118853277,-5,2066,6885,10
106118893242,106118893226,-16,1512,1730,10
106119435669,106119435675,6,1154,779,10
106121477460,106121477460,0,1245,1824,10
106122653850,106122653849,-1,1340,1556,10
106125904964,106125904970,6,3115,1062,10
106127539560,106127539557,-3,1445,2261,10
106127740992,106127740985,-7,1198,1823,10
106129396505,106129396501,-4,1129,1974,10
106130693362,106130693357,-5,779,1851,10
106133652478,106133652478,0,1409,2168,10
106134535755,106134535754,-1,985,2355,10
106135165174,106135165171,-3,1046,1538,10
106135545962,106135545977,15,523,694,10
106136967506,106136967503,-3,734,2197,10
106141643315,106141643314,-1,1364,2122,10
106144770674,106144770673,-1,1415,1761,10
106145855026,106145855026,0,1959,2991,10
106147137290,106147137291,1,1226,1423,10
106148546129,106148546128,-1,1422,2244,10
106151639954,106151639954,0,1238,1334,10
106157300938,106157300935,-3,618,971,10
106157907018,106157907016,-2,1668,2459,10
106165644535,106165644534,-1,1140,2465,10
106170523418,106170523416,-2,1371,1658,10
106172122602,106172122601,-1,1407,2643,10
106172280907,106172280906,-1,1480,1371,10
106175701519,106175701513,-6,20660,15938,10
106178194736,106178194733,-3,1095,1083,10
106181722589,106181722588,-1,1793,2537,10
106182088832,106182088830,-2,1012,2120,10
106182283836,106182283851,15,576,2037,10
106186635362,106186635361,-1,891,1421,10
106189365371,106189365370,-1,1180,2178,10
106193761256,106193761256,0,1052,1820,10
106194748534,106194748534,0,904,1176,10
106195451491,106195451489,-2,830,1792,10
106196789441,106196789438,-3,1406,1745,10
106197363063,106197363061,-2,780,1199,10
106198526301,106198526298,-3,1469,2135,10
106201398459,106201398462,3,2392,2247,10
106201490559,106201490557,-2,1275,2132,10
106203964597,106203964592,-5,1572,2248,10
106208468986,106208468994,8,2642,1061,10
106210631493,106210631492,-1,1494,2633,10
106223576614,106223576613,-1,1347,1684,10
106224851386,106224851385,-1,1806,2291,10
106226016808,106226016813,5,2657,928,10
106226327622,106226327620,-2,1200,2042,10
106229513076,106229513074,-2,1684,2269,10
106236553506,106236553502,-4,669,1014,10
106236931626,106236931635,9,443,1352,10
106242786355,106242786355,0,1039,1798,10
106244423175,106244423169,-6,625,1961,10
106248856119,106248856114,-5,1448,2185,10
106250050896,106250050895,-1,839,1375,10
106254218330,106254218329,-1,1119,2038,10
106256606501,106256606501,0,1085,1337,10
106259593154,106259593155,1,1071,1876,10
106259769443,106259769443,0,1282,1242,10
106262364586,106262364587,1,1337,1948,10
106262783696,106262783713,17,570,1699,10
106263115834,106263115830,-4,771,1306,10
106264631554,106264631551,-3,1604,1410,10
106274228883,106274228881,-2,1267,1885,10
106274914019,106274914014,-5,1102,2026,10
106275995583,106275995580,-3,986,1779,10
106278436082,106278436082,0,1212,1382,10
106281646123,106281646122,-1,1957,2730,10
106282201882,106282201881,-1,1056,1915,10
106282606772,106282606770,-2,7530,13692,10
106283412948,106283412947,-1,1295,2126,10
106286172623,106286172625,2,1584,1864,10
106286819203,106286819203,0,977,1100,10
106288241991,106288241990,-1,648,1339,10
106293492784,106293492784,0,1221,1776,10
106294949197,106294949194,-3,548,1248,10
106296844510,106296844509,-1,999,1910,10
106297927090,106297927090,0,1132,1724,10
106304696545,106304696545,0,1524,2268,10
106310054073,106310054070,-3,1553,2180,10
106310153888,106310153907,19,1054,1551,10
106310538621,106310538621,0,1750,1954,10
106313971907,106313971905,-2,1230,2190,10
106316953325,106316953325,0,1411,2040,10
106319090469,106319090467,-2,953,1349,10
106324447262,106324447261,-1,1817,1555,10
106325039547,106325039546,-1,1152,1784,10
106327712983,106327712981,-2,615,1616,10
106336500364,106336500362,-2,1438,2273,10
106336944054,106336944051,-3,1453,2357,10
106340876839,106340876838,-1,1291,2107,10
106341202920,106341202924,4,3392,1517,10
106343678275,106343678274,-1,919,1592,10
106344659777,106344659777,0,1614,2214,10
106345481421,106345481420,-1,1285,2215,10
106346944517,106346944516,-1,1578,1774,10
106354950557,106354950557,0,1697,2340,10
106355270476,106355270476,0,1284,1904,10
106355878824,106355878822,-2,2336,2787,10
106356164671,106356164673,2,973,1547,10
106356309342,106356309342,0,1040,1620,10
106356593237,106356593235,-2,1179,1566,10
106357815454,106357815452,-2,1119,1833,10
106360131355,106360131353,-2,979,1763,10
106362837129,106362837126,-3,941,3065,10
106363908610,106363908602,-8,1421,2055,10
106364307313,106364307310,-3,1299,2344,10
106366891199,106366891186,-13,1489,1805,10
106368066739,106368066737,-2,999,1707,10
106374036828,106374036825,-3,1940,3039,10
106374506222,106374506225,3,39531,30974,10
106375403594,106375403591,-3,1233,1469,10
106375488057,106375488058,1,1387,837,10
106378151789,106378151789,0,1091,1824,10
106390219338,106390219338,0,1286,2432,10
106392483746,106392483745,-1,1585,2033,10
106393984262,106393984265,3,1905,1513,10
106394593128,106394593126,-2,1417,1962,10
106394638000,106394637998,-2,1360,2148,10
106395281397,106395281397,0,1139,2133,10
106395524110,106395524108,-2,1262,1584,10
106399726434,106399726434,0,1051,1646,10
106400175775,106400175773,-2,1428,2135,10
106402089631,106402089629,-2,1168,2096,10
106402595618,106402595621,3,364,1130,10
106403775070,106403775068,-2,978,1868,10
106408710613,106408710613,0,1299,2309,10
106410377305,106410377302,-3,1252,1984,10
106410808477,106410808478,1,2017,1231,10
106412256697,106412256705,8,772,1888,10
106412445058,106412445078,20,492,1031,10
106414983981,106414983978,-3,1344,2354,10
106415171884,106415171882,-2,1529,2565,10
106421904550,106421904548,-2,1377,2182,10
106423512347,106423512358,11,935,1458,10
106423772238,106423772251,13,1002,2105,10
106426713821,106426713819,-2,1476,2578,10
106427447314,106427447313,-1,1367,2223,10
106435881255,106435881254,-1,1357,1657,10
106436578553,106436578554,1,1211,1996,10
106438892485,106438892482,-3,819,1920,10
106438930569,106438930581,12,551,2102,10
106439877798,106439877797,-1,1298,2062,10
106440325067,106440325066,-1,1110,1479,10
106443699576,106443699570,-6,1655,8443,10
106447636401,106447636399,-2,1320,2335,10
106454715338,106454715338,0,505,1046,10
106457225814,106457225814,0,1504,1754,10
106457289777,106457289776,-1,1891,2295,10
106457398234,106457398233,-1,1237,1823,10
106462101339,106462101337,-2,792,1482,10
106462527391,106462527396,5,1528,758,10
106464614210,106464614217,7,4237,1851,10
106466735190,106466735186,-4,2085,4685,10
106467057266,106467057266,0,1257,1529,10
106475599282,106475599283,1,837,1852,10
106476650279,106476650279,0,1457,1790,10
106477749020,106477749018,-2,1107,1680,10
106479527526,106479527525,-1,1178,2168,10
106482259122,106482259122,0,1321,1343,10
106484561797,106484561798,1,1211,1970,10
106487051239,106487051237,-2,1067,1106,10
106487340648,106487340638,-10,197,588,10
106488484503,106488484499,-4,1348,2324,10
106488839966,106488839965,-1,1685,2259,10
106489391218,106489391215,-3,1046,1900,10
106491484785,106491484785,0,1289,2016,10
106493907335,106493907334,-1,1538,2208,10
106494279022,106494279019,-3,789,1179,10
106499112815,106499112813,-2,1147,2043,10
106500097963,106500097960,-3,1233,1712,10
106502978116,106502978115,-1,1324,2509,10
106504376171,106504376169,-2,1057,1586,10
106506181153,106506181154,1,1034,1401,10
106507838798,106507838798,0,1723,2239,10
106507913108,106507913106,-2,1461,1319,10
106511628909,106511628906,-3,1695,2670,10
106512163715,106512163716,1,1300,1337,10
106518343459,106518343457,-2,835,1975,10
106519479227,106519479231,4,1981,1793,10
106524522009,106524522008,-1,1419,1726,10
106528662949,106528662947,-2,1279,1802,10
106528893176,106528893175,-1,1666,2197,10
106530624802,106530624801,-1,1201,1913,10
106532576147,106532576143,-4,1849,1768,10
106533527569,106533527569,0,1145,1602,10
106534110361,106534110383,22,338,812,10
106535655906,106535655905,-1,943,1813,10
106541400474,106541400473,-1,1957,2827,10
106541914143,106541914141,-2,1224,1806,10
106543137223,106543137223,0,1577,2709,10
106543181602,106543181601,-1,899,1332,10
106543732551,106543732550,-1,2081,1958,10
106545450230,106545450233,3,837,1764,10
106546315031,106546315029,-2,1794,2130,10
106548238755,106548238750,-5,969,2055,10
106556519079,106556519078,-1,1316,1532,10
106560120175,106560120175,0,1179,1772,10
106565818730,106565818725,-5,1082,3674,10
106566163899,106566163893,-6,1653,6393,10
106566258246,106566258244,-2,1143,1671,10
106566625189,106566625190,1,1764,2725,10
106566882178,106566882176,-2,1383,1252,10
106567273426,106567273424,-2,966,2318,10
106567715623,106567715623,0,532,1188,10
106569949220,106569949221,1,1575,1696,10
106570705477,106570705475,-2,1205,1990,10
106573082395,106573082389,-6,1185,4958,10
106573204857,106573204856,-1,1476,2385,10
106581121599,106581121600,1,1643,2122,10
106581414767,106581414763,-4,1200,2385,10
106585600123,106585600122,-1,1098,1689,10
106587148637,106587148634,-3,934,1522,10
106588822999,106588822997,-2,1291,1688,10
106594200955,106594200954,-1,1245,2173,10
106595690528,106595690526,-2,1366,2045,10
106597528911,106597528910,-1,888,1789,10
106597703025,106597703009,-16,1185,1788,10
106602200971,106602200969,-2,1164,1774,10
106602621906,106602621904,-2,1303,1656,10
106602923645,106602923641,-4,871,1432,10
106603189686,106603189686,0,1320,1944,10
106604332299,106604332289,-10,1077,2873,10
106607323067,106607323069,2,850,1472,10
106607443070,106607443063,-7,20753,13303,10
106608694127,106608694126,-1,1007,2151,10
106609874328,106609874329,1,30043,23089,10
106610220246,106610220241,-5,1114,2689,10
106611922545,106611922544,-1,1512,2462,10
106613224568,106613224551,-17,950,2232,10
106615341450,106615341449,-1,899,1632,10
106621983970,106621983970,0,1307,2178,10
106627963275,106627963272,-3,1354,2263,10
106628093932,106628093931,-1,1118,2561,10
106629313813,106629313813,0,1524,2896,10
106631294655,106631294650,-5,1091,2305,10
106635365522,106635365520,-2,1120,2976,10
106637972138,106637972138,0,793,1459,10
106639566186,106639566186,0,1078,1597,10
106640654649,106640654648,-1,1044,1927,10
106641074162,106641074160,-2,1190,2892,10
106641484302,106641484301,-1,1197,1893,10
106641575002,106641575005,3,1276,1448,10
106652792152,106652792151,-1,1541,2568,10
106653970521,106653970521,0,916,1901,10
106657220575,106657220574,-1,1333,2253,10
106658635260,106658635262,2,1244,2225,10
106663571940,106663571942,2,1536,1529,10
106665683857,106665683855,-2,1318,2894,10
106665748131,106665748127,-4,633,1467,10
106665933051,106665933038,-13,1145,1646,10
106671235618,106671235618,0,1052,1435,10
106678887805,106678887805,0,867,1485,10
106679912481,106679912483,2,1083,1575,10
106681633742,106681633743,1,823,1885,10
106682715747,106682715746,-1,936,1857,10
106685216318,106685216324,6,1631,1108,10
106685641147,106685641147,0,1239,1938,10
106687537155,106687537153,-2,1194,1923,10
106688288585,106688288583,-2,1351,2260,10
106689067871,106689067870,-1,1424,2211,10
106690718147,106690718152,5,1976,1041,10
106695743675,106695743673,-2,1327,2044,10
106701304849,106701304848,-1,982,1892,10
106701518775,106701518772,-3,1183,2116,10
106705719475,106705719474,-1,928,2417,10
106707890319,106707890320,1,1197,1724,10
106710777080,106710777079,-1,1190,1468,10
106712120544,106712120546,2,1878,1561,10
106716641639,106716641641,2,1154,1879,10
106720528854,106720528850,-4,826,1564,10
106721870042,106721870028,-14,180,1744,10
106722847459,106722847457,-2,1011,1608,10
106732242496,106732242492,-4,1230,3129,10
106733464146,106733464145,-1,1189,2019,10
106736631359,106736631360,1,1779,1612,10
106738766153,106738766152,-1,1056,1498,10
106746740769,106746740768,-1,2032,2639,10
106755786362,106755786359,-3,1247,1580,10
106756172410,106756172406,-4,950,2725,10
106758457181,106758457187,6,1417,891,10
106759961867,106759961856,-11,962,1641,10
106763840658,106763840655,-3,2245,2339,10
106764618014,106764618010,-4,1246,2135,10
106764742779,106764742777,-2,574,1151,10
106771364367,106771364365,-2,1002,2476,10
106772011281,106772011270,-11,1111,1589,10
106772453901,106772453907,6,2615,1391,10
106772538826,106772538825,-1,1033,1725,10
106774542009,106774542007,-2,981,1233,10
106782713344,106782713343,-1,1635,1825,10
106789067286,106789067284,-2,1167,2337,10
106791693123,106791693122,-1,1438,2494,10
106796129789,106796129791,2,1132,1209,10
106796708321,106796708321,0,1163,2219,10
106805094694,106805094691,-3,1169,2046,10
106807131299,106807131297,-2,1135,1994,10
106808300983,106808300981,-2,872,1228,10
106809378240,106809378240,0,1065,2236,10
106810531002,106810531001,-1,1248,2449,10
106810764803,106810764802,-1,1209,1502,10
106812090267,106812090264,-3,1262,1670,10
106814683388,106814683385,-3,1893,3499,10
106815226061,106815226058,-3,1251,2575,10
106818114185,106818114185,0,1403,1385,10
106827882960,106827882967,7,3143,1149,10
106827996687,106827996685,-2,1026,1958,10
106830786149,106830786148,-1,1175,1675,10
106833359718,106833359714,-4,1939,2104,10
106833500306,106833500302,-4,1238,2669,10
106836028200,106836028198,-2,1118,1752,10
106836186470,106836186470,0,1177,1648,10
106836553191,106836553190,-1,1047,1476,10
106838184253,106838184249,-4,965,2153,10
106841458818,106841458815,-3,1211,1828,10
106843597475,106843597474,-1,1446,2409,10
106845105158,106845105158,0,850,1498,10
106845490386,106845490385,-1,669,1040,10
106856303280,106856303279,-1,1124,1629,10
106858478623,106858478622,-1,1134,1942,10
106861179961,106861179958,-3,1457,3623,10
106870639251,106870639248,-3,1141,1176,10
106871205379,106871205377,-2,901,1813,10
106872721682,106872721681,-1,852,1766,10
106873364137,106873364130,-7,1112,1611,10
106887339010,106887339009,-1,891,1384,10
106893220310,106893220309,-1,731,1334,10
106894642514,106894642513,-1,1353,2799,10
106897092631,106897092627,-4,1191,2079,10
106897324845,106897324845,0,1224,2055,10
106898460925,106898460924,-1,1338,2986,10
106903479945,106903479944,-1,1396,2012,10
106906591122,106906591121,-1,1608,2432,10
106906719675,106906719673,-2,997,1751,10
106911219426,106911219426,0,1613,1897,10
106912346828,106912346820,-8,11781,17822,10
106912565741,106912565740,-1,1308,2309,10
106918204502,106918204501,-1,966,1375,10
106918738006,106918738003,-3,974,1954,10
106923223030,106923223030,0,1394,2108,10
106923294239,106923294237,-2,1598,2148,10
106923690169,106923690166,-3,1334,1701,10
106927008006,106927008004,-2,1258,2452,10
106928487427,106928487428,1,1193,1486,10
106931509535,106931509534,-1,1131,1939,10
106932335490,106932335489,-1,1091,2233,10
106933959726,106933959723,-3,1091,1791,10
106935208126,106935208126,0,1021,2026,10
106935851573,106935851577,4,20184,25853,10
106936734831,106936734830,-1,1414,2233,10
106941585445,106941585442,-3,932,1713,10
106946505331,106946505330,-1,1071,2088,10
106948307017,106948307015,-2,1332,2414,10
106948375366,106948375367,1,2137,1716,10
106949254603,106949254602,-1,1124,1589,10
106950884199,106950884199,0,1339,1552,10
106951504535,106951504534,-1,1196,1383,10
106952127162,106952127181,19,196,761,10
106952951462,106952951465,3,885,1064,10
106954507675,106954507674,-1,766,876,10
106958516788,106958516787,-1,1415,2477,10
106959842169,106959842172,3,1123,1811,10
106960981464,106960981465,1,1630,2545,10
106961315617,106961315604,-13,1453,1879,10
106961425656,106961425662,6,2812,1234,10
106963452578,106963452577,-1,1259,1972,10
106966516909,106966516908,-1,1411,2123,10
106971966715,106971966714,-1,1417,2226,10
106972219015,106972219012,-3,1056,1782,10
106977530999,106977530997,-2,1173,3047,10
106979770434,106979770443,9,2118,1080,10
106980748750,106980748749,-1,561,662,10
106982283371,106982283371,0,1582,1727,10
106986151146,106986151142,-4,1407,2339,10
106987780491,106987780489,-2,945,1671,10
106988995597,106988995592,-5,914,3448,10
106989875222,106989875221,-1,1284,1637,10
106990772890,106990772887,-3,1396,2554,10
106997173490,106997173488,-2,531,1031,10
106997806113,106997806113,0,1129,2062,10
107000351583,107000351582,-1,1027,1418,10
107002440754,107002440760,6,1631,1061,10
107005507409,107005507413,4,64,1294,10
107006359102,107006359103,1,1596,2097,10
107007060104,107007060103,-1,1329,2486,10
107011076072,107011076071,-1,1144,1923,10
107014649429,107014649434,5,6167,2348,10
107017693627,107017693625,-2,1310,1740,10
107023439251,107023439249,-2,1150,2197,10
107023933541,107023933547,6,4284,2019,10
107026324952,107026324950,-2,1392,2597,10
107029904385,107029904383,-2,1427,1956,10
107037690407,107037690406,-1,863,2141,10
107038708939,107038708922,-17,276,1701,10
107040141830,107040141834,4,1171,1010,10
107042819318,107042819318,0,1390,1644,10
107043452545,107043452545,0,1121,2068,10
107043646238,107043646238,0,1180,1842,10
107050660384,107050660383,-1,1752,1601,10
107060366478,107060366479,1,743,1279,10
107063912962,107063912961,-1,1187,2038,10
107068295590,107068295587,-3,1922,2315,10
107071656067,107071656066,-1,1087,1848,10
107075211048,107075211046,-2,928,2484,10
107075397459,107075397448,-11,1282,2548,10
107077865555,107077865554,-1,876,1650,10
107080124234,107080124231,-3,1335,2269,10
107082139154,107082139143,-11,797,2214,10
107084141065,107084141063,-2,1019,1525,10
107089315292,107089315289,-3,806,2075,10
107093495539,107093495537,-2,1145,2045,10
107096322681,107096322679,-2,796,2182,10
107097898731,107097898729,-2,1540,1804,10
107108322215,107108322214,-1,910,1356,10
107109641075,107109641076,1,1425,1775,10
107112394528,107112394525,-3,1357,2104,10
107114251720,107114251718,-2,1125,1932,10
107115178495,107115178493,-2,1170,2293,10
107115536995,107115536995,0,1305,1584,10
107116124027,107116124025,-2,1343,2014,10
107117783507,107117783507,0,775,1474,10
107125187389,107125187388,-1,1574,2073,10
107125495048,107125495047,-1,1211,1480,10
107135329350,107135329349,-1,1253,2752,10
107137757676,107137757674,-2,1027,2121,10
107139245636,107139245637,1,1312,1881,10
107140927078,107140927077,-1,1133,2168,10
107144853995,107144853989,-6,1183,2389,10
107149143059,107149143058,-1,1574,1284,10
107154388485,107154388486,1,1758,2106,10
107154821701,107154821700,-1,1435,3065,10
107154969638,107154969634,-4,1384,1994,10
107155220848,107155220848,0,1628,2300,10
107155956951,107155956949,-2,1088,1788,10
107157189417,107157189439,22,1015,1404,10
107157695665,107157695648,-17,1237,2647,10
107160614463,107160614461,-2,3152,3176,10
107163113428,107163113430,2,1514,1930,10
107165203435,107165203434,-1,1370,2365,10
107167813502,107167813502,0,938,1725,10
107169085316,107169085315,-1,1166,1766,10
107170312331,107170312325,-6,947,3486,10
107171242871,107171242869,-2,1577,1597,10
107173061038,107173061039,1,1982,2217,10
107174334312,107174334312,0,1114,2097,10
107175774777,107175774777,0,1359,2479,10
107176053641,107176053636,-5,2262,5406,10
107176496110,107176496109,-1,1441,1715,10
107178412124,107178412123,-1,1479,2071,10
107181728094,107181728091,-3,825,1576,10
107182148413,107182148414,1,991,1184,10
107183083826,107183083823,-3,1060,2018,10
107184326361,107184326363,2,1045,1805,10
107184820294,107184820291,-3,800,1578,10
107188492447,107188492445,-2,1493,3084,10
107188977997,107188977997,0,815,1221,10
107192916934,107192916930,-4,1236,2059,10
107193118178,107193118178,0,1269,1696,10
107194651554,107194651554,0,1164,1326,10
107199024565,107199024562,-3,632,1417,10
107199603389,107199603387,-2,1069,1480,10
107202426285,107202426282,-3,1433,2042,10
107204194090,107204194090,0,1110,2137,10
107205183162,107205183161,-1,792,2057,10
107208114317,107208114315,-2,1362,2097,10
107208191673,107208191671,-2,1208,1789,10
107209506275,107209506274,-1,1304,2299,10
107209708764,107209708768,4,1545,1291,10
107210028583,107210028581,-2,909,1795,10
107211294346,107211294366,20,1214,1870,10
107211472368,107211472361,-7,227,2760,10
107213313868,107213313861,-7,2539,6282,10
107214785223,107214785224,1,1842,1786,10
107218130223,107218130222,-1,1436,1993,10
107223891618,107223891615,-3,1073,2996,10
107225162488,107225162486,-2,1384,2622,10
107228669254,107228669253,-1,1362,1916,10
107228903118,107228903117,-1,1282,1870,10
107229560785,107229560767,-18,637,1345,10
107235942681,107235942680,-1,1363,1725,10
107237688074,107237688074,0,1502,2228,10
107238705887,107238705888,1,1054,2337,10
107239765383,107239765381,-2,1281,2259,10
107244443430,107244443427,-3,953,2021,10
107246510738,107246510736,-2,1111,2415,10
107252734915,107252734914,-1,882,2157,10
107253075182,107253075182,0,555,824,10
107254305113,107254305105,-8,49391,4114,10
107263368142,107263368141,-1,1319,2236,10
107264647835,107264647838,3,2771,1859,10
107265644945,107265644943,-2,1031,2120,10
107265897695,107265897693,-2,1172,1884,10
107266274098,107266274097,-1,1092,1441,10
107267595650,107267595650,0,850,1962,10
107275254457,107275254450,-7,1725,6271,10
107276077338,107276077337,-1,858,1758,10
107277775524,107277775520,-4,926,1723,10
107278965797,107278965794,-3,1494,2371,10
107283240941,107283240940,-1,670,1817,10
107284605683,107284605681,-2,1083,1551,10
107291898853,107291898851,-2,1329,1772,10
107296531602,107296531601,-1,2221,4119,10
107296937220,107296937220,0,1138,1945,10
107302452230,107302452230,0,1139,1977,10
107302962254,107302962251,-3,1047,2860,10
107303239120,107303239118,-2,1490,2181,10
107303405982,107303405981,-1,915,1963,10
107307382547,107307382531,-16,3293,1379,10
107307413158,107307413158,0,1098,1685,10
107309240556,107309240554,-2,1260,2509,10
107309284401,107309284417,16,1113,4799,10
107311436238,107311436238,0,1052,1789,10
107312057847,107312057845,-2,1222,2182,10
107314454114,107314454113,-1,1021,1589,10
107321887062,107321887061,-1,1361,2051,10
107325275889,107325275890,1,898,1551,10
107329890142,107329890141,-1,1001,1768,10
107342285155,107342285153,-2,1212,1512,10
107347994878,107347994874,-4,1151,2385,10
107349298391,107349298390,-1,1032,1544,10
107349755918,107349755917,-1,789,1631,10
107350413681,107350413703,22,1104,1744,10
107352907102,107352907102,0,1258,1708,10
107353621617,107353621616,-1,1643,2429,10
107357046246,107357046242,-4,980,2179,10
107358798802,107358798799,-3,32469,20581,10
107360597455,107360597453,-2,1190,2543,10
107363116330,107363116330,0,2436,1952,10
107364180706,107364180705,-1,963,1095,10
107366852028,107366852027,-1,1349,1182,10
107369581587,107369581585,-2,1119,2006,10
107372988047,107372988044,-3,926,2255,10
107374089520,107374089539,19,214,1093,10
107377132794,107377132791,-3,1059,1454,10
107381357817,107381357814,-3,1489,1577,10
107383902883,107383902878,-5,1203,2749,10
107384742623,107384742625,2,1438,2281,10
107384860823,107384860819,-4,2906,4677,10
107387606521,107387606522,1,1692,1607,10
107387670980,107387670983,3,2569,1722,10
107387961777,107387961773,-4,1612,2936,10
107389380395,107389380392,-3,1218,1956,10
107393560954,107393560951,-3,509,1520,10
107394596842,107394596841,-1,1347,1711,10
107396250350,107396250351,1,1589,1984,10
107398156871,107398156870,-1,1259,1991,10
107399556067,107399556065,-2,1096,2043,10
107400764453,107400764450,-3,1641,2310,10
107405485501,107405485502,1,1961,2646,10
107410385866,107410385865,-1,1356,1577,10
107411779054,107411779054,0,1034,1385,10
107416499775,107416499774,-1,763,1275,10
107418289258,107418289266,8,3802,1426,10
107418423906,107418423905,-1,976,1872,10
107420201530,107420201526,-4,902,1720,10
107420284162,107420284176,14,399,1857,10
107420654850,107420654849,-1,987,1718,10
107420976062,107420976061,-1,932,1062,10
107422566198,107422566198,0,1195,1900,10
107423816454,107423816454,0,1311,2112,10
107423871434,107423871431,-3,1021,1717,10
107425792474,107425792473,-1,1210,2188,10
107427898830,107427898828,-2,1036,2064,10
107432478912,107432478911,-1,808,1782,10
107433602347,107433602344,-3,1223,2556,10
107434016618,107434016616,-2,1109,1792,10
107437854454,107437854453,-1,1723,2273,10
107441778523,107441778518,-5,2595,3643,10
107442998580,107442998577,-3,1273,2078,10
107443916185,107443916182,-3,1660,2732,10
107445352229,107445352226,-3,1248,1959,10
107445626578,107445626577,-1,1477,1866,10
107446160563,107446160563,0,1402,1755,10
107446826839,107446826837,-2,1250,2054,10
107448045055,107448045053,-2,1298,2546,10
107458344082,107458344081,-1,1404,1902,10
107463598339,107463598337,-2,1548,2219,10
107465822908,107465822907,-1,1187,2025,10
107470053795,107470053795,0,826,1280,10
107470203874,107470203871,-3,973,1435,10
107471698052,107471698049,-3,793,1358,10
107477604883,107477604886,3,1472,1751,10
107478359904,107478359897,-7,987,3186,10
107478419401,107478419397,-4,1304,2516,10
107479962258,107479962257,-1,1171,2772,10
107480531609,107480531630,21,817,1459,10
107487453804,107487453803,-1,1529,1793,10
107491567986,107491567984,-2,1304,2070,10
107493170847,107493170846,-1,1215,1095,10
107496594711,107496594708,-3,1298,1908,10
107498257417,107498257417,0,994,2141,10
107498646930,107498646929,-1,1064,1493,10
107500177301,107500177299,-2,1149,1660,10
107501275517,107501275515,-2,1135,1988,10
107501492215,107501492215,0,1121,1499,10
107501530401,107501530400,-1,666,1493,10
107502921314,107502921313,-1,1409,1420,10
107504040583,107504040583,0,730,1581,10
107506956034,107506956034,0,1014,1845,10
107508908073,107508908071,-2,928,2203,10
107510868875,107510868874,-1,1364,2136,10
107512730091,107512730107,16,1230,1226,10
107515316254,107515316253,-1,1120,1769,10
107515673542,107515673542,0,1260,2231,10
107521041533,107521041534,1,1527,1984,10
107521084082,107521084080,-2,1212,2382,10
107527066225,107527066222,-3,1300,2710,10
107530298979,107530298978,-1,1134,1595,10
107531405893,107531405893,0,1096,1571,10
107532057348,107532057347,-1,1228,2343,10
107533300133,107533300133,0,1285,1913,10
107536498818,107536498818,0,1337,1616,10
107544106728,107544106727,-1,1475,2545,10
107548551299,107548551303,4,4063,2212,10
107555438466,107555438466,0,988,1855,10
107559694314,107559694314,0,1281,2159,10
107560016572,107560016570,-2,1171,1345,10
107560980296,107560980302,6,2953,1855,10
107562263627,107562263626,-1,1141,1935,10
107567956423,107567956422,-1,1340,2252,10
107572515945,107572515942,-3,1241,1925,10
107573762766,107573762768,2,2470,2396,10
107581047574,107581047573,-1,1398,2543,10
107583026770,107583026773,3,964,1264,10
107583090587,107583090581,-6,659,8764,10
107587895160,107587895158,-2,486,620,10
107588105758,107588105757,-1,1137,2052,10
107589681182,107589681180,-2,1033,1671,10
107592273847,107592273846,-1,1293,2331,10
107594288623,107594288622,-1,1577,2267,10
107596820810,107596820810,0,1386,1431,10
107598692127,107598692129,2,1751,1928,10
107599282970,107599282970,0,1420,3176,10
107600344098,107600344097,-1,1173,1536,10
107601791938,107601791938,0,1117,1891,10
107606235177,107606235177,0,1479,2346,10
107608322761,107608322758,-3,773,1986,10
107610411050,107610411045,-5,20034,15477,10
107622027190,107622027187,-3,1040,2012,10
107625926790,107625926786,-4,3962,11992,10
107628110239,107628110239,0,1539,1309,10
107628547454,107628547455,1,759,1350,10
107629368934,107629368932,-2,1156,1773,10
107629520078,107629520077,-1,1198,1802,10
107630058128,107630058134,6,1719,1191,10
107631016045,107631016042,-3,1069,2284,10
107635767298,107635767297,-1,1340,1656,10
107637610587,107637610586,-1,1261,2084,10
107637754574,107637754571,-3,1175,1779,10
107638901465,107638901462,-3,1100,1715,10
107642198333,107642198334,1,2614,1892,10
107644103031,107644103031,0,1609,1722,10
107644854174,107644854173,-1,1488,1918,10
107654268498,107654268496,-2,1480,1379,10
107656480991,107656480991,0,1509,1533,10
107657573362,107657573359,-3,938,1323,10
107663038753,107663038750,-3,1054,2190,10
107663275587,107663275587,0,1183,1511,10
107664470336,107664470336,0,1407,1776,10
107666007323,107666007321,-2,1192,1486,10
107668250310,107668250308,-2,943,1420,10
107673354218,107673354213,-5,1953,5073,10
107674735233,107674735233,0,932,1808,10
107675221017,107675220998,-19,262,779,10
107677052247,107677052247,0,1309,2108,10
107679390750,107679390752,2,1003,1438,10
107687186418,107687186418,0,1872,2232,10
107687221387,107687221387,0,1078,1999,10
107691347890,107691347888,-2,1261,1811,10
107692826942,107692826938,-4,1219,1143,10
107696278207,107696278206,-1,1242,2107,10
107699017991,107699017991,0,1305,2168,10
107700832797,107700832795,-2,1368,2154,10
107705157666,107705157665,-1,1502,2168,10
107710088183,107710088182,-1,986,1754,10
107711266055,107711266045,-10,1219,1734,10
107711968224,107711968222,-2,931,1551,10
107712689147,107712689145,-2,798,1190,10
107719531482,107719531488,6,1870,1807,10
107720237215,107720237213,-2,1510,2864,10
107724689510,107724689509,-1,1235,1828,10
107740964879,107740964874,-5,1090,3701,10
107743567126,107743567127,1,1139,2375,10
107751462686,107751462686,0,1557,2204,10
107751633153,107751633175,22,665,1841,10
107752398307,107752398305,-2,1130,1819,10
107753783560,107753783545,-15,1070,2278,10
107761312754,107761312758,4,1488,1523,10
107763166754,107763166752,-2,862,986,10
107764258175,107764258173,-2,940,2399,10
107764332883,107764332876,-7,34586,12349,10
107765389797,107765389797,0,964,1557,10
107766091058,107766091057,-1,1292,1486,10
107768689746,107768689745,-1,948,1756,10
107770374566,107770374566,0,1055,1801,10
107771646825,107771646846,21,1084,1373,10
107773559874,107773559874,0,1416,2174,10
107775044289,107775044287,-2,1150,1569,10
107784480669,107784480666,-3,1149,1685,10
107785716780,107785716781,1,1418,1726,10
107793889173,107793889171,-2,1108,1712,10
107796612538,107796612536,-2,1447,2443,10
107800589278,107800589276,-2,1230,1678,10
107803250560,107803250560,0,1438,2252,10
107809428338,107809428336,-2,1358,1729,10
107809838426,107809838445,19,910,1143,10
107811998699,107811998698,-1,1645,2712,10
107812534928,107812534926,-2,1394,2009,10
107817082763,107817082762,-1,653,1424,10
107820953265,107820953263,-2,2104,2539,10
107823622438,107823622437,-1,1380,2091,10
107826065494,107826065489,-5,1122,3805,10
107828251162,107828251162,0,1392,2296,10
107828351425,107828351425,0,946,1745,10
107828825078,107828825077,-1,1352,1699,10
107828894312,107828894301,-11,1331,1384,10
107830063773,107830063773,0,1230,1343,10
107834365710,107834365710,0,948,1771,10
107835181870,107835181870,0,1069,1842,10
107835764502,107835764502,0,919,1908,10
107835829801,107835829821,20,534,1296,10
107842241901,107842241897,-4,1080,2644,10
107842346363,107842346360,-3,1409,2088,10
107842445917,107842445939,22,1016,1515,10
107843636722,107843636722,0,1242,2088,10
107845739838,107845739838,0,896,2893,10
107846535702,107846535702,0,1124,1155,10
107853721419,107853721418,-1,1566,1521,10
107859550775,107859550774,-1,1005,1675,10
107864892339,107864892338,-1,1211,2015,10
107865431227,107865431226,-1,1322,2147,10
107871234143,107871234142,-1,1114,2363,10
107871649479,107871649479,0,1295,1874,10
107872321203,107872321202,-1,1934,3439,10
107875045293,107875045294,1,1310,1907,10
107875317158,107875317158,0,1600,2250,10
107875548118,107875548116,-2,1518,2713,10
107880434727,107880434725,-2,1186,1914,10
107881693550,107881693550,0,1281,1742,10
107886760839,107886760837,-2,1086,2332,10
107889141640,107889141639,-1,1533,2760,10
107893009588,107893009587,-1,1679,2546,10
107899617086,107899617085,-1,1599,1754,10
107900177719,107900177716,-3,1405,2625,10
107903129659,107903129658,-1,1489,2058,10
107904871574,107904871572,-2,1174,2379,10
107909541842,107909541841,-1,831,956,10
107911193935,107911193935,0,1797,2192,10
107911268992,107911268986,-6,1909,5952,10
107916417972,107916417971,-1,1261,1940,10
107916726538,107916726537,-1,603,1478,10
107917758849,107917758849,0,933,1986,10
107918278537,107918278534,-3,1403,2077,10
107919511745,107919511740,-5,1958,8513,10
107920192525,107920192519,-6,1297,4797,10
107926438342,107926438337,-5,2124,6589,10
107928404138,107928404135,-3,843,1328,10
107928655014,107928655013,-1,1801,1887,10
107929013134,107929013142,8,2820,1396,10
107933673174,107933673175,1,1610,2185,10
107943176233,107943176239,6,1355,1130,10
107943580426,107943580422,-4,15331,52046,10
107950205793,107950205792,-1,1027,1879,10
107950516422,107950516421,-1,325,1347,10
107956015679,107956015678,-1,1017,1806,10
107956451026,107956451025,-1,1195,1907,10
107957772177,107957772176,-1,730,895,10
107961741871,107961741875,4,1370,1212,10
107969777854,107969777851,-3,1351,2963,10
107977190490,107977190489,-1,1281,2073,10
107977842241,107977842238,-3,1455,2716,10
107983405083,107983405083,0,1528,2910,10
107988191750,107988191751,1,2501,1951,10
107990566734,107990566733,-1,1213,1524,10
107994203030,107994203028,-2,1091,1927,10
107998151493,107998151487,-6,2619,7562,10
107998464518,107998464514,-4,1011,1952,10
108002711201,108002711199,-2,1258,2129,10
108003469926,108003469926,0,1138,2199,10
108004869272,108004869269,-3,767,1747,10
108007724099,108007724095,-4,830,2313,10
108010479244,108010479241,-3,1058,2610,10
108011105343,108011105338,-5,1167,5506,10
108014444587,108014444585,-2,1630,1452,10
108018125369,108018125368,-1,1004,2162,10
108019401474,108019401474,0,991,1998,10
108024720654,108024720652,-2,1214,1934,10
108027431863,108027431862,-1,1403,2156,10
108031335674,108031335674,0,1269,1800,10
108037731829,108037731836,7,4351,1513,10
108040221157,108040221154,-3,1207,2452,10
108045920881,108045920881,0,16768,22895,10
108047603078,108047603077,-1,1756,2492,10
108051206862,108051206861,-1,1043,2065,10
108054448738,108054448742,4,3013,1233,10
108056149087,108056149086,-1,1133,2060,10
108057743669,108057743666,-3,1099,2825,10
108059487126,108059487119,-7,1207,3531,10
108067063995,108067063992,-3,1118,2434,10
108067354062,108067354066,4,1445,1459,10
108069125136,108069125136,0,1546,2306,10
108072826457,108072826454,-3,1202,1666,10
108073618783,108073618786,3,1485,1673,10
108076775809,108076775814,5,5877,3044,10
108079857415,108079857413,-2,1976,2294,10
108081430342,108081430340,-2,946,1877,10
108081712713,108081712710,-3,1106,2444,10
108082832155,108082832154,-1,1317,1661,10
108086323274,108086323274,0,1215,2002,10
108086501771,108086501772,1,1145,1042,10
108089677527,108089677530,3,1659,1338,10
108089777392,108089777390,-2,1243,1389,10
108094211591,108094211589,-2,1250,2040,10
108095520230,108095520226,-4,1600,2465,10
108098128142,108098128139,-3,1549,1820,10
108099220787,108099220788,1,1251,1645,10
108102617683,108102617682,-1,1053,1259,10
108104160194,108104160193,-1,1358,3574,10
108106589095,108106589093,-2,1035,1912,10
108107582723,108107582722,-1,1255,2005,10
108109237578,108109237577,-1,1110,1565,10
108112435487,108112435484,-3,1314,2418,10
108114688209,108114688206,-3,609,1709,10
108117218658,108117218657,-1,1018,1917,10
108118848801,108118848798,-3,1632,1731,10
108119348383,108119348382,-1,1074,1647,10
108119400974,108119400974,0,1822,2381,10
108119830808,108119830811,3,3958,3403,10
108120330481,108120330478,-3,1079,2234,10
108121020230,108121020226,-4,1400,1704,10
108121338722,108121338722,0,1635,1784,10
108121763459,108121763459,0,1304,1647,10
108126840487,108126840500,13,2287,956,10
108130327104,108130327101,-3,1456,2165,10
108131902094,108131902093,-1,1003,1697,10
108138451982,108138451981,-1,1230,1865,10
108146171703,108146171702,-1,1237,869,10
108149425010,108149425007,-3,1341,1737,10
108151513071,108151513069,-2,1307,2141,10
108153400669,108153400668,-1,1626,2272,10
108153631481,108153631479,-2,1396,2905,10
108155950347,108155950346,-1,1258,1809,10
108156067879,108156067878,-1,1097,1964,10
108157888263,108157888260,-3,1255,2227,10
108159418191,108159418192,1,1299,1701,10
108160966938,108160966937,-1,1514,1629,10
108161252099,108161252096,-3,1556,2183,10
108162147179,108162147174,-5,878,1735,10
108167872286,108167872285,-1,1451,2346,10
108171217842,108171217844,2,1218,1760,10
108171553032,108171553031,-1,1716,1992,10
108174943898,108174943897,-1,921,2227,10
108176601337,108176601334,-3,1223,1952,10
108177213034,108177213034,0,1005,1616,10
108178952868,108178952869,1,1399,1384,10
108179755863,108179755862,-1,1743,1982,10
108181842279,108181842274,-5,1080,3337,10
108183700115,108183700114,-1,843,1617,10
108190793430,108190793426,-4,1436,3273,10
108191714945,108191714944,-1,1628,1936,10
108192590907,108192590906,-1,1056,1503,10
108194547655,108194547653,-2,954,2128,10
108198147080,108198147078,-2,851,1706,10
108200302803,108200302801,-2,841,1035,10
108202914813,108202914813,0,1266,1585,10
108205586334,108205586326,-8,2456,8702,10
108208386905,108208386903,-2,1027,1765,10
108210597909,108210597906,-3,23537,15271,10
108211132000,108211131999,-1,978,1755,10
108213418177,108213418183,6,3834,1374,10
108220574253,108220574249,-4,1043,1984,10
108220857521,108220857514,-7,872,1192,10
108222161274,108222161274,0,2024,3251,10
108227530751,108227530750,-1,1731,1981,10
108227634893,108227634890,-3,1838,2239,10
108228634894,108228634892,-2,1459,2326,10
108229752021,108229752020,-1,1000,1895,10
108230684955,108230684953,-2,371,849,10
108233128879,108233128879,0,2015,2258,10
108234121275,108234121275,0,1213,1610,10
108235917138,108235917135,-3,1031,1728,10
108237987330,108237987329,-1,1046,1701,10
108238437571,108238437570,-1,691,1513,10
108239188510,108239188509,-1,1184,1128,10
108241990244,108241990237,-7,2345,7201,10
108242178542,108242178546,4,1956,1963,10
108247027950,108247027957,7,3365,1717,10
108253632558,108253632554,-4,922,2134,10
108253878727,108253878725,-2,1266,2178,10
108256041509,108256041505,-4,981,2588,10
108256846387,108256846386,-1,1119,1687,10
108260076558,108260076555,-3,1253,1937,10
108260139697,108260139717,20,377,928,10
108265026199,108265026196,-3,1015,1515,10
108266380331,108266380330,-1,1272,1888,10
108266885237,108266885231,-6,1044,4573,10
108273755895,108273755893,-2,811,2179,10
108281067403,108281067400,-3,1301,1719,10
108282516921,108282516927,6,2271,1864,10
108286322990,108286322992,2,9197,25563,10
108286837474,108286837473,-1,1176,2046,10
108289731906,108289731907,1,996,1364,10
108291343961,108291343958,-3,1295,2096,10
108295580587,108295580582,-5,763,1131,10
108298787291,108298787290,-1,1332,2067,10
108308362322,108308362321,-1,1745,2685,10
108314242946,108314242943,-3,1162,1811,10
108314814954,108314814934,-20,1524,639,10
108316632078,108316632077,-1,1005,2331,10
108316886929,108316886908,-21,987,2089,10
108317225049,108317225050,1,1382,1265,10
108319176219,108319176218,-1,1057,1123,10
108322857665,108322857663,-2,951,2057,10
108326813120,108326813112,-8,1133,10048,10
108328986298,108328986296,-2,926,1917,10
108334636850,108334636846,-4,1483,1526,10
108334922711,108334922710,-1,1102,2006,10
108343206526,108343206523,-3,1226,2611,10
108349762626,108349762626,0,1064,2055,10
108350752827,108350752826,-1,589,1717,10
108359454854,108359454851,-3,1093,2096,10
108360045429,108360045430,1,1013,1494,10
108361710563,108361710575,12,12623,36830,10
108364966880,108364966879,-1,1633,2606,10
108365852006,108365852004,-2,1360,2144,10
108368433017,108368433014,-3,1187,1664,10
108372096278,108372096278,0,946,2004,10
108382917607,108382917607,0,1256,2358,10
108383086523,108383086519,-4,1133,1727,10
108383128774,108383128773,-1,946,2175,10
108384173091,108384173090,-1,1477,1796,10
108388704381,108388704377,-4,800,2305,10
108390333063,108390333063,0,1040,1636,10
108391860054,108391860054,0,2607,2950,10
108392729394,108392729393,-1,1596,2183,10
108396892578,108396892577,-1,1239,1898,10
108397042769,108397042765,-4,1253,1706,10
108399494399,108399494398,-1,1155,1581,10
108400570542,108400570541,-1,1231,2134,10
108402108709,108402108710,1,1752,1455,10
108402943334,108402943332,-2,1497,1686,10
108404337094,108404337098,4,1979,1334,10
108404405201,108404405198,-3,992,2726,10
108406116995,108406116990,-5,723,2023,10
108406810162,108406810161,-1,1756,1811,10
108409333175,108409333174,-1,1455,1723,10
108411248494,108411248491,-3,1423,1794,10
108412313628,108412313628,0,1713,2688,10
108415000798,108415000794,-4,974,4062,10
108416317109,108416317107,-2,1134,2761,10
108417238353,108417238354,1,1297,2038,10
108417458979,108417458971,-8,1193,7417,10
108419748382,108419748374,-8,1983,6517,10
108422107446,108422107446,0,1485,2215,10
108423253459,108423253458,-1,1299,1958,10
108428706462,108428706461,-1,1215,1815,10
108430993739,108430993737,-2,1373,2836,10
108431568501,108431568501,0,1707,2390,10
108433464122,108433464117,-5,1074,2507,10
108448549965,108448549966,1,954,825,10
108451331674,108451331673,-1,1172,1687,10
108451716818,108451716814,-4,1371,2076,10
108453261342,108453261340,-2,1110,2258,10
108453537410,108453537410,0,1740,2031,10
108455205207,108455205205,-2,1176,2028,10
108456960188,108456960186,-2,2415,2431,10
108457695041,108457695044,3,2445,1879,10
108459964745,108459964744,-1,1245,1800,10
108463843598,108463843594,-4,1306,1623,10
108470117158,108470117156,-2,1034,1905,10
108478119795,108478119794,-1,1368,1962,10
108481074074,108481074074,0,1019,1778,10
108481528125,108481528126,1,1016,1784,10
108484426074,108484426071,-3,1144,1708,10
108484522603,108484522602,-1,1223,1857,10
108484795745,108484795743,-2,1274,1768,10
108486161810,108486161803,-7,1097,5987,10
108488825871,108488825870,-1,1090,1326,10
108491392037,108491392035,-2,978,2236,10
108493510049,108493510046,-3,1188,2037,10
108498464039,108498464036,-3,1179,2067,10
108499548334,108499548334,0,1026,1785,10
108500876477,108500876462,-15,3370,1340,10
108501084726,108501084725,-1,1367,2945,10
108501575292,108501575289,-3,1025,2157,10
108503363005,108503363007,2,1875,1343,10
108504543166,108504543169,3,2220,2530,10
108506288474,108506288474,0,869,1096,10
108508833202,108508833201,-1,1045,2022,10
108515759167,108515759166,-1,1811,2859,10
108524693534,108524693534,0,1186,1879,10
108528566818,108528566819,1,1741,1972,10
108531831600,108531831597,-3,1713,2761,10
108536934451,108536934450,-1,1153,1839,10
108538687979,108538687978,-1,1675,2177,10
108541311453,108541311443,-10,1011,1367,10
108542076266,108542076263,-3,1222,2409,10
108542783838,108542783835,-3,1287,2873,10
108543135677,108543135678,1,813,1473,10
108546701283,108546701282,-1,1858,2143,10
108548651363,108548651360,-3,1299,1924,10
108553352547,108553352545,-2,956,1477,10
108554214055,108554214054,-1,1160,1912,10
108558789684,108558789685,1,2810,2383,10
108562435966,108562435968,2,953,1823,10
108563026074,108563026072,-2,1274,2032,10
108563390482,108563390483,1,1047,1141,10
108563900953,108563900940,-13,3786,356,10
108565534434,108565534431,-3,741,1908,10
108568180816,108568180814,-2,1187,2112,10
108570495162,108570495161,-1,936,1700,10
108571549882,108571549881,-1,1261,1866,10
108573262013,108573262011,-2,1704,2128,10
108574412434,108574412433,-1,1486,1960,10
108577229413,108577229409,-4,1275,4000,10
108579153319,108579153318,-1,1185,2153,10
108584503415,108584503414,-1,978,1793,10
108589043883,108589043882,-1,1285,2434,10
108589191686,108589191685,-1,1334,2096,10
108590503461,108590503459,-2,1425,1959,10
108590855944,108590855950,6,142,809,10
108595339916,108595339922,6,1874,1247,10
108596199098,108596199097,-1,1448,1790,10
108598544163,108598544148,-15,954,2320,10
108604252463,108604252463,0,773,977,10
108604885959,108604885957,-2,1022,1485,10
108609786229,108609786227,-2,1360,1775,10
108610245187,108610245185,-2,1270,1971,10
108610500758,108610500758,0,1514,1446,10
108612229768,108612229767,-1,1573,1822,10
108616406070,108616406068,-2,1171,1585,10
108617492635,108617492634,-1,1753,1895,10
108619925259,108619925260,1,1103,1852,10
108626895580,108626895576,-4,1263,3392,10
108628008832,108628008829,-3,1320,2053,10
108630273346,108630273344,-2,1018,2170,10
108635492872,108635492870,-2,1328,1247,10
108635959043,108635959041,-2,1311,1446,10
108636266658,108636266657,-1,1745,2705,10
108641730887,108641730886,-1,1404,1758,10
108650006905,108650006898,-7,836,4032,10
108650798642,108650798639,-3,888,2213,10
108652009348,108652009347,-1,1185,2179,10
108652425471,108652425469,-2,990,1804,10
108658055770,108658055767,-3,1181,1446,10
108662165448,108662165452,4,8912,5021,10
108665578959,108665578957,-2,1242,1486,10
108675196142,108675196138,-4,1628,2399,10
108684560059,108684560061,2,1739,1851,10
108684691804,108684691802,-2,1159,2978,10
108685226654,108685226654,0,1370,1894,10
108688794326,108688794327,1,979,1676,10
108691475802,108691475803,1,876,1748,10
108691731543,108691731546,3,1250,1102,10
108693203307,108693203308,1,2000,2432,10
108693572470,108693572467,-3,848,2636,10
108696086202,108696086199,-3,1796,2361,10
108696996019,108696996018,-1,1314,1823,10
108697744198,108697744196,-2,788,1514,10
108699804886,108699804864,-22,894,2237,10
108701628432,108701628432,0,1272,2276,10
108701973051,108701973051,0,1336,1967,10
108706429789,108706429788,-1,1260,1841,10
108706707726,108706707726,0,1491,1898,10
108707587507,108707587506,-1,1181,1411,10
108709435107,108709435107,0,1322,1754,10
108709744461,108709744460,-1,1624,2845,10
108709816405,108709816401,-4,866,2240,10
108719953545,108719953542,-3,1316,2120,10
108723189034,108723189030,-4,819,2665,10
108724274470,108724274470,0,1411,1833,10
108725498115,108725498115,0,1176,2288,10
108726714907,108726714906,-1,1832,2726,10
108728714873,108728714872,-1,1127,1986,10
108729130193,108729130190,-3,1371,2257,10
108730198615,108730198613,-2,1053,1837,10
108731185437,108731185436,-1,1173,1964,10
108731304174,108731304175,1,1494,1918,10
108732707963,108732707961,-2,1161,2379,10
108733890306,108733890314,8,15415,27012,10
108735435814,108735435812,-2,940,2161,10
108736511183,108736511181,-2,1784,2658,10
108736963019,108736963018,-1,1191,1589,10
108738852961,108738852959,-2,794,1767,10
108740057411,108740057409,-2,1178,2338,10
108740737724,108740737725,1,1412,1374,10
108741887781,108741887778,-3,1169,1862,10
108742568110,108742568110,0,1495,1725,10
108743243149,108743243150,1,4751,4524,10
108743712402,108743712402,0,1043,1657,10
108745440762,108745440762,0,1252,1618,10
108747605844,108747605844,0,1215,1823,10
108750897534,108750897535,1,926,1965,10
108751343397,108751343396,-1,1235,1630,10
108753823959,108753823961,2,1217,1353,10
108760897797,108760897796,-1,1352,2276,10
108763183226,108763183226,0,3375,3983,10
108763835470,108763835466,-4,1229,1696,10
108766259314,108766259313,-1,1225,1596,10
108769366231,108769366238,7,1117,527,10
108769929338,108769929337,-1,911,1509,10
108770377955,108770377955,0,1413,1256,10
108774561098,108774561095,-3,1266,1944,10
108776976218,108776976217,-1,1440,2391,10
108777452321,108777452321,0,1454,2130,10
108781673247,108781673243,-4,1383,1978,10
108786168289,108786168287,-2,1155,1728,10
108787009385,108787009385,0,1380,2214,10
108789845135,108789845133,-2,1381,2215,10
108790520225,108790520227,2,1528,1498,10
108790665661,108790665658,-3,891,1533,10
108793401965,108793401964,-1,1078,1815,10
108793506727,108793506726,-1,1350,1377,10
108794319789,108794319789,0,1192,1620,10
108795195981,108795195978,-3,1126,2610,10
108799310112,108799310112,0,1780,1925,10
108802101333,108802101331,-2,1653,1947,10
108807876637,108807876642,5,2115,1322,10
108808274349,108808274346,-3,1280,2676,10
108812890344,108812890343,-1,1110,1819,10
108818872652,108818872650,-2,1714,3034,10
108820512139,108820512138,-1,1076,2400,10
108821025366,108821025365,-1,1428,1993,10
108822830992,108822830990,-2,1191,1595,10
108826154838,108826154835,-3,838,1604,10
108826611098,108826611096,-2,760,2197,10
108830957621,108830957619,-2,1361,2236,10
108833534944,108833534945,1,852,870,10
108835342793,108835342786,-7,1052,3485,10
108837340219,108837340218,-1,1117,1580,10
108839600690,108839600689,-1,854,1490,10
108839893135,108839893133,-2,1034,2306,10
108839982933,108839982930,-3,1239,1494,10
108840491654,108840491650,-4,1262,2454,10
108841714327,108841714326,-1,1298,2157,10
108842363437,108842363435,-2,1324,2174,10
108842492634,108842492634,0,1578,1568,10
108847758775,108847758775,0,988,2080,10
108851652811,108851652810,-1,1608,2159,10
108852424138,108852424138,0,1210,1996,10
108855288227,108855288223,-4,1134,2574,10
108857027083,108857027081,-2,1128,2457,10
108857401245,108857401246,1,1152,1291,10
108858785235,108858785232,-3,895,1978,10
108859332827,108859332825,-2,1591,1887,10
108861665970,108861665969,-1,591,1545,10
108863936849,108863936848,-1,848,1878,10
108867872753,108867872753,0,1191,1834,10
108869667974,108869667972,-2,1261,1983,10
108869945482,108869945499,17,656,1131,10
108870462014,108870462014,0,890,1971,10
108876876007,108876876009,2,1099,2282,10
108881114759,108881114755,-4,1135,2011,10
108884222040,108884222038,-2,1642,2035,10
108886725068,108886725066,-2,1578,2247,10
108887986063,108887986061,-2,1189,1871,10
108888081507,108888081499,-8,1064,1557,10
108888365283,108888365281,-2,837,1703,10
108889044563,108889044560,-3,995,2009,10
108889796364,108889796363,-1,1472,1764,10
108891074313,108891074312,-1,1629,2581,10
108893931709,108893931707,-2,1226,2567,10
108897664645,108897664645,0,983,1608,10
108901188970,108901188966,-4,1343,1820,10
108901337395,108901337390,-5,40680,21883,10
108901723505,108901723502,-3,1267,1858,10
108902038459,108902038438,-21,823,1561,10
108902866902,108902866901,-1,1372,2562,10
108908388126,108908388126,0,2073,2061,10
108911883450,108911883449,-1,1386,3269,10
108912498545,108912498545,0,1275,1904,10
108919292501,108919292501,0,1414,2066,10
108919317797,108919317818,21,1307,1588,10
108920358250,108920358249,-1,1678,2651,10
108921503499,108921503498,-1,1390,1466,10
108921596376,108921596382,6,7857,2015,10
108926767471,108926767470,-1,983,1493,10
108926978707,108926978705,-2,1099,1544,10
108927669810,108927669811,1,912,1314,10
108927947131,108927947116,-15,1469,2076,10
108928077378,108928077359,-19,44,526,10
108929711070,108929711069,-1,1698,1486,10
108931897427,108931897426,-1,1244,1997,10
108933817477,108933817475,-2,1379,2200,10
108934648057,108934648055,-2,1127,1775,10
108938808138,108938808136,-2,1430,1878,10
108942183822,108942183817,-5,1473,4758,10
108942710966,108942710966,0,1028,1596,10
108942827205,108942827205,0,1618,1770,10
108946559625,108946559629,4,18606,24116,10
108948701637,108948701636,-1,892,2021,10
108949159336,108949159316,-20,136,368,10
108949773606,108949773605,-1,1063,2015,10
108951843682,108951843682,0,1365,1809,10
108962168166,108962168156,-10,1095,1753,10
108964849753,108964849753,0,1310,1985,10
108965730734,108965730733,-1,1085,1883,10
108969647460,108969647458,-2,1240,1967,10
108969810204,108969810222,18,444,2572,10
108970139762,108970139775,13,177,574,10
108971981236,108971981235,-1,1855,1894,10
108973268142,108973268144,2,745,1428,10
108976166435,108976166431,-4,1270,1886,10
108976421529,108976421525,-4,1779,2277,10
108982525438,108982525437,-1,1137,2387,10
108982740449,108982740431,-18,1296,1181,10
108987375513,108987375510,-3,1622,1894,10
108987426751,108987426749,-2,977,1945,10
108988815291,108988815289,-2,1095,2316,10
108991256600,108991256598,-2,1009,2309,10
108992159110,108992159118,8,5945,1475,10
108993720782,108993720779,-3,624,1460,10
108995133329,108995133329,0,1447,1612,10
108996403023,108996403004,-19,1432,1821,10
108996625934,108996625933,-1,1165,1636,10
108996752819,108996752806,-13,125,820,10
108997237531,108997237530,-1,1492,2289,10
108998917736,108998917734,-2,1424,2866,10
108999955203,108999955197,-6,1043,2859,10
109001398070,109001398066,-4,1053,2566,10
109005042837,109005042836,-1,1254,1828,10
109005271138,109005271135,-3,1260,1701,10
109006441430,109006441427,-3,1121,1888,10
109007288700,109007288698,-2,1813,2577,10
109010574734,109010574737,3,1782,1144,10
109014442418,109014442417,-1,1328,1682,10
109014991635,109014991634,-1,1481,1729,10
109017025536,109017025536,0,1601,2292,10
109017976495,109017976491,-4,1385,3063,10
109019917759,109019917757,-2,1706,1926,10
109021896610,109021896609,-1,1941,3018,10
109022052402,109022052406,4,1986,1508,10
109023321861,109023321860,-1,2185,3160,10
109029878438,109029878435,-3,1052,1780,10
109030713708,109030713714,6,2828,799,10
109031074488,109031074508,20,1049,1564,10
109031738575,109031738573,-2,1266,2127,10
109035262849,109035262855,6,3839,1478,10
109036684330,109036684326,-4,1207,2232,10
109038189138,109038189137,-1,1159,2098,10
109040215550,109040215543,-7,1059,1087,10
109040587284,109040587301,17,1293,1932,10
109041556614,109041556610,-4,812,1416,10
109050726636,109050726635,-1,1310,1784,10
109050880986,109050880983,-3,1688,3008,10
109052351858,109052351857,-1,1240,2230,10
109059951457,109059951461,4,2416,1905,10
109063279210,109063279210,0,1583,2659,10
109063613068,109063613066,-2,1068,1977,10
109064538244,109064538245,1,1620,1644,10
109070884811,109070884811,0,778,1180,10
109082048406,109082048405,-1,1764,2890,10
109082790926,109082790926,0,1489,2349,10
109086129782,109086129777,-5,1570,6369,10
109086935021,109086935021,0,1029,2141,10
109088468398,109088468399,1,1461,1491,10
109093315257,109093315257,0,2033,2596,10
109095477545,109095477541,-4,1404,3136,10
109096934358,109096934354,-4,674,1720,10
109102605874,109102605874,0,1334,2352,10
109103536186,109103536185,-1,1468,1825,10
109106319791,109106319789,-2,937,1727,10
109110633998,109110633997,-1,1157,1537,10
109113018950,109113018950,0,924,1353,10
109117361342,109117361341,-1,1034,1621,10
109118180023,109118180022,-1,1942,2348,10
109120111910,109120111911,1,2749,2039,10
109123616553,109123616555,2,1125,1526,10
109124138954,109124138954,0,29966,19672,10
109124588978,109124588977,-1,768,1269,10
109125778918,109125778915,-3,1162,3113,10
109126632552,109126632554,2,1699,1047,10
109129675927,109129675926,-1,1307,1926,10
109129849471,109129849470,-1,1105,1305,10
109131431078,109131431078,0,1999,2569,10
109131587337,109131587337,0,1537,1418,10
109133491520,109133491522,2,1423,1766,10
109134569606,109134569602,-4,1082,1912,10
109136226282,109136226282,0,1272,2222,10
109137061041,109137061038,-3,1307,1959,10
109138361694,109138361696,2,642,212,10
109139102131,109139102127,-4,1175,1734,10
109140259657,109140259656,-1,973,2529,10
109146497634,109146497629,-5,650,2525,10
109147221320,109147221318,-2,1258,1589,10
109147915385,109147915384,-1,963,1554,10
109148615522,109148615522,0,1983,3104,10
109150724522,109150724520,-2,1477,2320,10
109151537151,109151537150,-1,1309,1516,10
109151773373,109151773378,5,2062,894,10
109151831916,109151831918,2,2214,1832,10
109152529854,109152529854,0,1400,1860,10
109154608046,109154608045,-1,1421,1935,10
109156055866,109156055864,-2,1593,2999,10
109158743306,109158743305,-1,959,1439,10
109159070724,109159070723,-1,1342,2048,10
109161730060,109161730081,21,967,993,10
109162744666,109162744665,-1,1153,2709,10
109164540854,109164540852,-2,1091,2165,10
109164635589,109164635587,-2,1288,1351,10
109166590745,109166590742,-3,1346,1563,10
109168508639,109168508638,-1,1002,1545,10
109169855598,109169855597,-1,1771,1981,10
109173066586,109173066584,-2,819,2322,10
109174064646,109174064645,-1,1137,3105,10
109174727789,109174727786,-3,1288,1841,10
109175312086,109175312093,7,281,1078,10
109176760898,109176760898,0,1278,1795,10
109177104188,109177104187,-1,857,1066,10
109177763481,109177763479,-2,955,1246,10
109179878542,109179878540,-2,1339,1753,10
109181288663,109181288658,-5,1303,3112,10
109181922246,109181922246,0,832,2259,10
109182803546,109182803539,-7,1022,1997,10
109183816478,109183816476,-2,1049,2670,10
109184535969,109184535961,-8,933,1572,10
109189779158,109189779157,-1,1356,1559,10
109191379426,109191379425,-1,929,1588,10
109193517919,109193517916,-3,1067,1842,10
109193743827,109193743818,-9,293,6344,10
109195198998,109195198997,-1,1076,1977,10
109195728523,109195728519,-4,1363,1705,10
109196260721,109196260719,-2,1417,2466,10
109197082262,109197082258,-4,837,1214,10
109200258446,109200258446,0,1263,1052,10
109203660505,109203660505,0,1189,1747,10
109204133977,109204133975,-2,980,1535,10
109205576298,109205576295,-3,1340,2569,10
109207868237,109207868236,-1,1202,2533,10
109220460775,109220460775,0,1714,2689,10
109220858818,109220858818,0,1494,1975,10
109224119167,109224119166,-1,1463,2136,10
109226096459,109226096459,0,1645,1513,10
109228953483,109228953476,-7,1529,6243,10
109232312301,109232312306,5,2002,2035,10
109232385978,109232385982,4,4893,2259,10
109234144777,109234144775,-2,1838,2195,10
109244396250,109244396250,0,974,1420,10
109247275087,109247275085,-2,897,2013,10
109250881007,109250881007,0,834,1883,10
109251504599,109251504598,-1,1091,1556,10
109253448059,109253448056,-3,1059,1776,10
109255476140,109255476138,-2,820,1949,10
109255803291,109255803291,0,1845,2696,10
109255914245,109255914238,-7,1521,9103,10
109257362570,109257362564,-6,929,4615,10
109259699054,109259699053,-1,1115,1473,10
109268780043,109268780042,-1,1188,1812,10
109271504480,109271504479,-1,1502,2881,10
109275656671,109275656671,0,1744,2358,10
109277818787,109277818785,-2,1008,1929,10
109278049808,109278049809,1,1274,2031,10
109280614758,109280614753,-5,1748,4010,10
109282049994,109282049991,-3,1656,2946,10
109282609000,109282609001,1,1162,1791,10
109288768465,109288768463,-2,1397,2978,10
109290255947,109290255947,0,1142,2221,10
109295068543,109295068543,0,1007,2673,10
109298005652,109298005649,-3,817,1737,10
109299206138,109299206134,-4,1112,1682,10
109299790824,109299790822,-2,1338,1987,10
109302592930,109302592931,1,1318,1846,10
109305812327,109305812325,-2,1408,3170,10
109307501443,109307501443,0,1272,1010,10
109309534086,109309534085,-1,1409,2196,10
109309629054,109309629059,5,1853,1111,10
109310753434,109310753434,0,1407,1727,10
109311272064,109311272065,1,894,1871,10
109311875699,109311875698,-1,1059,1184,10
109312119419,109312119418,-1,26601,22698,10
109313356343,109313356342,-1,1338,1704,10
109319065670,109319065669,-1,1174,2295,10
109321633290,109321633288,-2,1375,2037,10
109323697730,109323697728,-2,1641,2534,10
109325220334,109325220335,1,1430,1917,10
109327140062,109327140058,-4,1079,2212,10
109327247186,109327247186,0,1480,2185,10
109329894028,109329894026,-2,1363,2002,10
109331888841,109331888841,0,1232,1885,10
109332552287,109332552285,-2,1290,2689,10
109334983883,109334983882,-1,1072,1660,10
109337205310,109337205310,0,873,1455,10
109338719481,109338719480,-1,1877,2375,10
109339064613,109339064613,0,1131,2131,10
109340900170,109340900171,1,1157,966,10
109342327662,109342327662,0,1142,2258,10
109343459290,109343459290,0,1321,1437,10
109344004449,109344004441,-8,1081,2282,10
109344729870,109344729870,0,1571,2162,10
109344826318,109344826316,-2,1180,1782,10
109346858126,109346858126,0,1302,1886,10
109354948167,109354948163,-4,983,2588,10
109356712171,109356712169,-2,1037,1781,10
109360144033,109360144033,0,1058,1947,10
109361154341,109361154338,-3,1982,2905,10
109373250807,109373250806,-1,1035,1240,10
109373453438,109373453425,-13,26269,15510,10
109374984758,109374984758,0,1775,1571,10
109377338861,109377338859,-2,866,1853,10
109378820431,109378820426,-5,1576,2145,10
109379309717,109379309716,-1,1457,1882,10
109381561514,109381561513,-1,1617,2126,10
109386228398,109386228397,-1,1493,1830,10
109391763071,109391763074,3,1284,1891,10
109394494904,109394494902,-2,1114,1697,10
109399064901,109399064916,15,1662,1898,10
109401665964,109401665962,-2,968,1275,10
109403218179,109403218174,-5,1104,3483,10
109405732157,109405732161,4,1657,1244,10
109406478170,109406478169,-1,1527,2009,10
109410630574,109410630573,-1,1209,1956,10
109410827874,109410827894,20,777,1281,10
109411211917,109411211918,1,1697,1929,10
109414742947,109414742947,0,695,1086,10
109417683078,109417683073,-5,892,1505,10
109422615086,109422615084,-2,2453,2659,10
109438628681,109438628678,-3,675,2374,10
109446092947,109446092946,-1,1148,1831,10
109447033968,109447033970,2,1731,2007,10
109455779113,109455779113,0,1345,2123,10
109457062903,109457062902,-1,993,1512,10
109457529537,109457529543,6,2142,697,10
109460115416,109460115414,-2,636,1553,10
109468230807,109468230804,-3,1046,1567,10
109469649343,109469649342,-1,1453,2003,10
109470196143,109470196142,-1,1048,1587,10
109471237166,109471237166,0,1144,2031,10
109472792929,109472792928,-1,1519,1660,10
109474895910,109474895915,5,1531,1353,10
109475159790,109475159788,-2,1807,2198,10
109478837987,109478837987,0,1899,2692,10
109479532278,109479532278,0,1255,1940,10
109482536942,109482536941,-1,952,1496,10
109482937247,109482937249,2,1668,1564,10
109488739988,109488739989,1,1042,1198,10
109491271300,109491271300,0,1357,1611,10
109492397821,109492397814,-7,29555,14841,10
109495098487,109495098480,-7,806,2990,10
109497301222,109497301220,-2,1009,1916,10
109500923761,109500923759,-2,1166,2597,10
109503608898,109503608896,-2,1640,2602,10
109504030806,109504030806,0,876,946,10
109504539625,109504539646,21,581,1028,10
109505537386,109505537381,-5,1271,4260,10
109508067217,109508067215,-2,842,1795,10
109508640394,109508640392,-2,1715,3644,10
109511191507,109511191486,-21,986,2020,10
109511367317,109511367310,-7,1291,4064,10
109513611935,109513611933,-2,1289,2329,10
109518942162,109518942161,-1,1277,2012,10
109523503272,109523503267,-5,55872,19101,10
109524758781,109524758785,4,1411,1333,10
109527450323,109527450323,0,910,1080,10
109529683367,109529683363,-4,1168,2331,10
109529911766,109529911765,-1,974,2507,10
109531291258,109531291257,-1,1358,1927,10
109531804490,109531804489,-1,1038,1787,10
109533873136,109533873137,1,1388,1871,10
109536563219,109536563218,-1,1115,2374,10
109539935059,109539935058,-1,1300,2267,10
109540212186,109540212181,-5,1133,1700,10
109542376055,109542376052,-3,1081,1403,10
109543142428,109543142426,-2,1189,1420,10
109544849159,109544849154,-5,1419,2827,10
109548500834,109548500831,-3,1060,1963,10
109551542495,109551542491,-4,960,1529,10
109553518494,109553518493,-1,742,1241,10
109553660906,109553660926,20,583,1507,10
109554987938,109554987937,-1,1149,1881,10
109556845873,109556845873,0,1197,2021,10
109557646875,109557646858,-17,115,612,10
109558575346,109558575348,2,24455,42090,10
109561368482,109561368482,0,1387,1826,10
109564666350,109564666345,-5,1169,3271,10
109566951286,109566951285,-1,850,1560,10
109575923926,109575923929,3,1400,1585,10
109576261899,109576261897,-2,1153,1551,10
109577763025,109577763025,0,1127,1304,10
109581419187,109581419186,-1,1317,2268,10
109582675977,109582675974,-3,1325,1883,10
109583425623,109583425622,-1,29416,56217,10
109590451316,109590451318,2,3215,1677,10
109592926769,109592926766,-3,1198,2167,10
109593513942,109593513942,0,834,1787,10
109593638043,109593638042,-1,1782,2186,10
109596274142,109596274141,-1,1160,2251,10
109596490928,109596490950,22,880,1493,10
109597741518,109597741518,0,917,1609,10
109598315515,109598315518,3,2197,1787,10
109600641561,109600641558,-3,1528,2834,10
109606343730,109606343729,-1,719,1899,10
109609061445,109609061443,-2,1328,1888,10
109612598886,109612598883,-3,1144,2155,10
109615669163,109615669162,-1,1294,1965,10
109618285858,109618285855,-3,1259,1892,10
109620811975,109620811976,1,1170,1605,10
109621842573,109621842571,-2,1337,1949,10
109623412371,109623412369,-2,910,1865,10
109626176319,109626176319,0,978,2098,10
109627345381,109627345382,1,861,1133,10
109627765775,109627765775,0,1677,2242,10
109629724674,109629724670,-4,1170,1755,10
109635552660,109635552658,-2,1145,2590,10
109636338108,109636338106,-2,1311,1900,10
109636608408,109636608405,-3,910,2452,10
109644626482,109644626483,1,1219,2146,10
109645093121,109645093120,-1,1416,1916,10
109645454345,109645454332,-13,1028,2652,10
109648012505,109648012499,-6,1755,4868,10
109648209017,109648209009,-8,810,5020,10
109649469103,109649469101,-2,1284,2185,10
109649996065,109649996061,-4,942,1515,10
109650126168,109650126168,0,1714,2052,10
109655754921,109655754919,-2,1401,1901,10
109656022218,109656022219,1,1341,1677,10
109657510714,109657510713,-1,939,1429,10
109660765422,109660765419,-3,615,1768,10
109666029223,109666029221,-2,1547,2792,10
109666260274,109666260274,0,1139,2012,10
109668343488,109668343486,-2,1482,2510,10
109669364413,109669364413,0,1675,2560,10
109670076458,109670076457,-1,1270,1933,10
109676930675,109676930674,-1,839,1373,10
109680513009,109680513008,-1,1390,1937,10
109686904338,109686904339,1,1076,1489,10
109687252859,109687252858,-1,1164,1940,10
109695146926,109695146927,1,1224,1509,10
109700055889,109700055890,1,926,1455,10
109701552038,109701552039,1,1312,1629,10
109704546914,109704546912,-2,1812,2331,10
109709646672,109709646668,-4,840,2047,10
109718450622,109718450623,1,1677,2088,10
109719344531,109719344527,-4,1305,1518,10
109722153034,109722153031,-3,727,1503,10
109724382525,109724382523,-2,1356,1789,10
109729642859,109729642857,-2,1141,1672,10
109731536200,109731536200,0,1293,1808,10
109732059291,109732059289,-2,1406,1911,10
109732651000,109732650998,-2,1310,1785,10
109733338530,109733338549,19,1245,2119,10
109736400068,109736400078,10,14842,20297,10
109740149192,109740149192,0,1372,2128,10
109742083158,109742083158,0,1916,2226,10
109742853021,109742853019,-2,1622,2390,10
109743617588,109743617587,-1,1181,1850,10
109744261254,109744261254,0,1625,2856,10
109745403817,109745403815,-2,1217,2099,10
109745572418,109745572418,0,1768,2161,10
109746415070,109746415068,-2,1514,2444,10
109748157741,109748157746,5,2204,1429,10
109748378330,109748378329,-1,1237,2440,10
109749403365,109749403363,-2,1546,2296,10
109749969837,109749969852,15,1246,1655,10
109755613489,109755613484,-5,1022,2455,10
109755738173,109755738169,-4,1075,1146,10
109756632700,109756632699,-1,3443,4062,10
109757224164,109757224162,-2,1430,1855,10
109760304990,109760304989,-1,1135,1834,10
109768462590,109768462587,-3,1086,1705,10
109769972629,109769972627,-2,942,1546,10
109770651038,109770651034,-4,1379,2796,10
109772565315,109772565315,0,1300,2252,10
109772655653,109772655658,5,1784,1337,10
109773657285,109773657278,-7,137,952,10
109775064906,109775064906,0,1046,1412,10
109776228458,109776228455,-3,1047,2028,10
109777777041,109777777041,0,1243,1497,10
109786604616,109786604614,-2,1489,2519,10
109790157161,109790157150,-11,788,275,10
109793393356,109793393360,4,1058,1477,10
109797100478,109797100477,-1,1041,1991,10
109797391809,109797391808,-1,1475,2215,10
109804209077,109804209074,-3,944,1686,10
109807433603,109807433602,-1,1248,1737,10
109807461469,109807461469,0,1235,2490,10
109810581865,109810581865,0,1619,2366,10
109811468793,109811468792,-1,893,2075,10
109814101257,109814101255,-2,1127,1722,10
109817319723,109817319725,2,2936,3320,10
109819475016,109819475015,-1,1637,2857,10
109819673073,109819673071,-2,1122,1170,10
109822579181,109822579181,0,1228,1700,10
109824718406,109824718406,0,1602,1678,10
109826281717,109826281717,0,1677,2525,10
109826522066,109826522064,-2,1255,2245,10
109829619939,109829619938,-1,1207,2205,10
109831538934,109831538932,-2,742,1662,10
109834514207,109834514206,-1,1137,1868,10
109836855975,109836855990,15,136,601,10
109838101082,109838101078,-4,615,981,10
109841898229,109841898227,-2,1183,1329,10
109844104236,109844104235,-1,938,1601,10
109846727730,109846727726,-4,1111,2394,10
109851137783,109851137785,2,3595,2459,10
109860484650,109860484650,0,1391,2032,10
109861289997,109861289993,-4,1105,2355,10
109863812402,109863812402,0,1382,1469,10
109867708545,109867708544,-1,1884,2250,10
109868178763,109868178761,-2,1342,2380,10
109873986866,109873986865,-1,1231,1712,10
109877580974,109877580974,0,815,1938,10
109879233625,109879233623,-2,1017,1751,10
109880370584,109880370582,-2,1367,2117,10
109889954386,109889954387,1,1009,978,10
109892597342,109892597362,20,1792,1267,10
109894088675,109894088674,-1,1126,1468,10
109896312894,109896312893,-1,1021,2429,10
109898311175,109898311170,-5,1473,4048,10
109903294474,109903294473,-1,1113,1873,10
109903564573,109903564571,-2,1047,2341,10
109904372009,109904372009,0,1310,3387,10
109905355431,109905355432,1,1089,1179,10
109912299939,109912299938,-1,1136,2475,10
109916036011,109916035991,-20,27088,28257,10
109916567373,109916567373,0,769,1637,10
109921590302,109921590302,0,1278,1509,10
109922133446,109922133459,13,18254,25217,10
109923542613,109923542594,-19,817,147,10
109925129219,109925129218,-1,862,1482,10
109930313498,109930313497,-1,1220,2751,10
109939162697,109939162696,-1,1100,1610,10
109947214434,109947214431,-3,863,2298,10
109947808434,109947808434,0,1350,1378,10
109952058122,109952058120,-2,1308,2104,10
109952384626,109952384623,-3,1255,1908,10
109956520918,109956520917,-1,1770,2390,10
109960091122,109960091121,-1,911,1219,10
109964638246,109964638246,0,1213,1173,10
109966047174,109966047179,5,3031,2244,10
109976054926,109976054923,-3,1142,1758,10
109976479850,109976479850,0,1587,1975,10
109976967174,109976967173,-1,1171,1004,10
109980111845,109980111844,-1,1116,1472,10
109986108814,109986108812,-2,1107,2580,10
109989876635,109989876633,-2,901,1717,10
109997369881,109997369881,0,1133,1502,10
109998297134,109998297135,1,1035,1336,10
110000123174,110000123171,-3,1295,2469,10
110000448943,110000448941,-2,1358,2336,10
110009951001,110009950998,-3,1241,1973,10
110012369650,110012369648,-2,868,1623,10
110012866491,110012866489,-2,1082,2656,10
110014944739,110014944738,-1,1524,2413,10
110018635890,110018635887,-3,1189,1514,10
110020560966,110020560963,-3,1529,3119,10
110024240721,110024240721,0,975,1605,10
110025296654,110025296654,0,1513,1969,10
110027124161,110027124160,-1,1730,2739,10
110027509393,110027509391,-2,1318,2321,10
110029166906,110029166904,-2,781,1387,10
110032347395,110032347394,-1,1250,1789,10
110036071658,110036071657,-1,1343,2062,10
110038886389,110038886385,-4,1409,3097,10
110038982518,110038982515,-3,1409,1746,10
110039449359,110039449357,-2,1127,1805,10
110042998982,110042998980,-2,1330,1995,10
110044628554,110044628574,20,663,1223,10
110048651906,110048651905,-1,1145,1931,10
110053119905,110053119902,-3,1008,1348,10
110054183422,110054183436,14,1553,1619,10
110054668015,110054668010,-5,1121,2775,10
110055731320,110055731318,-2,920,1196,10
110057287847,110057287845,-2,1271,2670,10
110058068901,110058068898,-3,1289,1898,10
110059495861,110059495858,-3,1146,1694,10
110062316369,110062316373,4,1645,1750,10
110062988302,110062988301,-1,1598,2282,10
110064149643,110064149641,-2,1473,1768,10
110066256674,110066256670,-4,1426,1746,10
110069143598,110069143599,1,1332,1541,10
110070526339,110070526337,-2,1310,2618,10
110070688998,110070688997,-1,1494,1850,10
110080657253,110080657251,-2,1049,1557,10
110084812577,110084812576,-1,2017,3082,10
110085743821,110085743819,-2,1231,2239,10
110090741227,110090741226,-1,948,2283,10
110093213242,110093213239,-3,1167,2260,10
110097488927,110097488926,-1,1265,2141,10
110098551243,110098551245,2,2192,2418,10
110099907618,110099907617,-1,1086,1538,10
110100442235,110100442237,2,1118,1338,10
110101122814,110101122809,-5,1171,2265,10
110103893178,110103893178,0,1565,2186,10
110104187274,110104187273,-1,1660,2164,10
110104249257,110104249255,-2,1059,2204,10
110111550682,110111550678,-4,859,1923,10
110113870966,110113870964,-2,894,1414,10
110113932141,110113932144,3,2780,1431,10
110118156041,110118156034,-7,1441,3380,10
110118252371,110118252371,0,1009,1306,10
110122087579,110122087577,-2,1493,2002,10
110123249853,110123249851,-2,1172,1763,10
110123692212,110123692217,5,1274,969,10
110127272596,110127272594,-2,1343,1877,10
110129061789,110129061787,-2,1018,2077,10
110131387250,110131387247,-3,1328,2147,10
110132469479,110132469479,0,1308,2568,10
110132504233,110132504231,-2,1960,2403,10
110132679405,110132679402,-3,1125,2294,10
110136456435,110136456430,-5,1027,2664,10
110136789242,110136789227,-15,1339,1581,10
110137814821,110137814823,2,990,530,10
110147386870,110147386869,-1,1059,1682,10
110149990655,110149990655,0,1357,1692,10
110151860481,110151860481,0,1330,1741,10
110155029613,110155029611,-2,1321,2767,10
110158758658,110158758655,-3,1514,2414,10
110159704286,110159704294,8,1260,955,10
110162957987,110162957986,-1,1006,2314,10
110163697499,110163697498,-1,1360,2879,10
110167038169,110167038167,-2,1698,2413,10
110167140444,110167140441,-3,1482,2696,10
110170208047,110170208046,-1,1182,2062,10
110171047243,110171047241,-2,1091,1751,10
110171750408,110171750408,0,25504,21162,10
110172672571,110172672570,-1,1180,2226,10
110173432459,110173432458,-1,728,1943,10
110178514393,110178514391,-2,1000,2652,10
110180733540,110180733539,-1,979,1982,10
110181266404,110181266408,4,1813,1090,10
110182792529,110182792526,-3,925,1978,10
110184932077,110184932076,-1,997,1858,10
110191325118,110191325118,0,1586,2886,10
110197207934,110197207935,1,1529,1519,10
110197787253,110197787251,-2,1075,2231,10
110200341617,110200341616,-1,1214,1981,10
110202441821,110202441827,6,15017,18449,10
110203560747,110203560742,-5,1414,2355,10
110204400820,110204400813,-7,1795,7510,10
110211670303,110211670301,-2,1069,1976,10
110212152486,110212152481,-5,1220,6319,10
110215458798,110215458794,-4,1407,1597,10
110217142022,110217142022,0,1583,2068,10
110217540433,110217540431,-2,1184,1990,10
110218720657,110218720656,-1,1070,1832,10
110220330514,110220330514,0,1137,1974,10
110223608598,110223608606,8,17400,21525,10
110225124485,110225124484,-1,1591,1688,10
110229592837,110229592837,0,1710,2018,10
110230116227,110230116225,-2,1011,1610,10
110232669045,110232669046,1,1330,2291,10
110235879577,110235879586,9,12268,23296,10
110238862082,110238862078,-4,1165,2086,10
110240003738,110240003759,21,1278,1865,10
110240264706,110240264694,-12,188,783,10
110241412455,110241412456,1,1755,2595,10
110243513448,110243513442,-6,910,2085,10
110244985867,110244985869,2,1423,1680,10
110249101540,110249101538,-2,1971,2859,10
110250429994,110250429992,-2,1322,1805,10
110250570764,110250570763,-1,1003,1512,10
110254552186,110254552182,-4,981,1047,10
110254604038,110254604043,5,1823,1640,10
110259171338,110259171337,-1,1055,2302,10
110260971919,110260971918,-1,1393,2364,10
110267053442,110267053442,0,1432,1402,10
110268813103,110268813097,-6,1173,2760,10
110270408449,110270408450,1,1137,1978,10
110270785373,110270785370,-3,1348,2655,10
110272855124,110272855122,-2,1742,2771,10
110273294670,110273294670,0,1282,1789,10
110273524555,110273524552,-3,1210,2887,10
110276476579,110276476579,0,1024,1877,10
110277802025,110277802009,-16,1229,1435,10
110279917899,110279917899,0,1032,2186,10
110280764646,110280764644,-2,1132,2382,10
110282116059,110282116041,-18,681,1365,10
110282898177,110282898178,1,1805,1973,10
110283197378,110283197374,-4,1547,2541,10
110284541250,110284541249,-1,1548,2295,10
110284805666,110284805672,6,4134,2317,10
110291635392,110291635375,-17,184,777,10
110295561619,110295561620,1,1214,1667,10
110299095915,110299095915,0,1279,1524,10
110299999835,110299999834,-1,1545,2317,10
110305282990,110305282991,1,1596,933,10
110307226123,110307226121,-2,1004,1500,10
110309808692,110309808690,-2,1709,2240,10
110311981667,110311981666,-1,1256,1661,10
110313868906,110313868906,0,921,1717,10
110316249749,110316249753,4,1422,1918,10
110316857293,110316857290,-3,918,1593,10
110321517212,110321517211,-1,1908,2704,10
110322199439,110322199438,-1,1109,1702,10
110322876402,110322876402,0,1162,1539,10
110325874051,110325874050,-1,849,956,10
110327057610,110327057600,-10,726,69,10
110329119294,110329119291,-3,1295,1694,10
110331994026,110331994024,-2,1243,2349,10
110333462594,110333462593,-1,923,1878,10
110335451166,110335451166,0,835,1444,10
110335837971,110335837990,19,859,1432,10
110343983964,110343983962,-2,1056,1427,10
110345952804,110345952801,-3,30323,23786,10
110346559420,110346559418,-2,614,1195,10
110346772462,110346772461,-1,1127,2178,10
110347421743,110347421741,-2,1302,1212,10
110351517842,110351517842,0,1587,1555,10
110352494117,110352494116,-1,1727,1452,10
110355448690,110355448690,0,1322,2157,10
110358359048,110358359052,4,2068,1297,10
110359985219,110359985216,-3,1363,2081,10
110360548418,110360548417,-1,1552,2272,10
110364033289,110364033286,-3,1176,2931,10
110364609322,110364609321,-1,1404,2533,10
110371421883,110371421883,0,940,1216,10
110372586518,110372586518,0,1441,1794,10
110374552109,110374552111,2,2745,2366,10
110378768487,110378768486,-1,1196,2151,10
110378918158,110378918155,-3,1438,2695,10
110380073957,110380073957,0,1000,951,10
110380825734,110380825733,-1,1477,2039,10
110393800511,110393800508,-3,863,1907,10
110396937069,110396937068,-1,1622,1889,10
110401443045,110401443043,-2,1345,1634,10
110405063390,110405063388,-2,1133,1481,10
110407595292,110407595290,-2,1275,1548,10
110409061188,110409061189,1,2187,1503,10
110409390870,110409390868,-2,1486,2018,10
110412907218,110412907218,0,1417,1721,10
110413067991,110413067989,-2,851,1369,10
110416076311,110416076309,-2,1236,1458,10
110417889202,110417889202,0,2959,3158,10
110420060971,110420060970,-1,1174,2549,10
110421426722,110421426724,2,1164,1868,10
110440305565,110440305567,2,2207,1783,10
110443076592,110443076589,-3,1910,2736,10
110445643685,110445643686,1,1023,1154,10
110455345579,110455345578,-1,932,1257,10
110457947913,110457947911,-2,1127,2649,10
110460754099,110460754108,9,2579,1101,10
110468440099,110468440098,-1,1145,1734,10
110468565550,110468565550,0,38112,21014,10
110469198650,110469198650,0,904,1597,10
110473507753,110473507753,0,963,1167,10
110481105500,110481105498,-2,1141,2583,10
110482315955,110482315954,-1,1347,1859,10
110482402289,110482402289,0,1710,2476,10
110485862386,110485862384,-2,1551,2806,10
110486202574,110486202575,1,1456,1953,10
110487307610,110487307615,5,1805,1522,10
110491672650,110491672654,4,2190,1688,10
110492686181,110492686175,-6,2367,8861,10
110495364543,110495364540,-3,1092,2352,10
110499924166,110499924164,-2,1134,2359,10
110502386129,110502386127,-2,1268,1903,10
110505766502,110505766500,-2,1287,1845,10
110511876665,110511876667,2,2333,1959,10
110515068738,110515068737,-1,1549,2636,10
110516521194,110516521192,-2,1065,1905,10
110517630843,110517630842,-1,882,1390,10
110518469914,110518469911,-3,851,1509,10
110518674419,110518674404,-15,1068,2116,10
110521609322,110521609321,-1,1339,2096,10
110523925550,110523925551,1,1198,1691,10
110524539150,110524539143,-7,1215,11167,10
110526772022,110526772019,-3,1577,2316,10
110527225496,110527225511,15,593,1362,10
110528959835,110528959834,-1,1043,2684,10
110536035787,110536035785,-2,982,1356,10
110538041657,110538041656,-1,1205,2404,10
110538315566,110538315566,0,1063,1737,10
110541695481,110541695485,4,2644,1709,10
110544541902,110544541903,1,1462,1958,10
110550500274,110550500267,-7,877,3308,10
110551196160,110551196162,2,2104,1383,10
110552710184,110552710182,-2,1129,2040,10
110554181869,110554181869,0,1321,2294,10
110558022878,110558022879,1,764,1464,10
110559654064,110559654046,-18,517,1559,10
110568030905,110568030904,-1,983,1871,10
110569706450,110569706449,-1,1406,2131,10
110573405519,110573405518,-1,1293,2342,10
110573616799,110573616794,-5,2856,5409,10
110573786817,110573786818,1,1340,1408,10
110575139943,110575139941,-2,954,1182,10
110576026555,110576026555,0,1032,248,10
110577152426,110577152426,0,1339,1571,10
110582046730,110582046729,-1,1823,1949,10
110583970297,110583970295,-2,1122,2085,10
110584829358,110584829357,-1,1038,1784,10
110587841310,110587841306,-4,1375,2657,10
110591163160,110591163159,-1,1317,2486,10
110592128287,110592128286,-1,1604,1352,10
110592561075,110592561073,-2,1210,1360,10
110594034146,110594034146,0,1178,1629,10
110596965911,110596965910,-1,1266,2069,10
110597287925,110597287925,0,1578,2716,10
110601235409,110601235407,-2,1970,3367,10
110601593263,110601593261,-2,1669,3043,10
110602560937,110602560934,-3,1274,1723,10
110606163160,110606163177,17,866,1502,10
110606818110,110606818109,-1,927,2061,10
110607906595,110607906594,-1,1342,1669,10
110608670547,110608670545,-2,1332,2411,10
110613439403,110613439399,-4,1083,1842,10
110615850465,110615850466,1,1167,1347,10
110616561158,110616561159,1,969,1934,10
110624678896,110624678895,-1,1596,1674,10
110624778568,110624778554,-14,883,1350,10
110629880338,110629880358,20,1290,2642,10
110630889737,110630889735,-2,1531,2346,10
110632400683,110632400681,-2,1235,2689,10
110634028734,110634028730,-4,1316,2059,10
110634207794,110634207773,-21,211,542,10
110635381155,110635381159,4,161,762,10
110640430746,110640430745,-1,1350,1974,10
110640684450,110640684450,0,1283,2005,10
110640900244,110640900243,-1,1408,2900,10
110644308257,110644308259,2,8469,6721,10
110646108139,110646108137,-2,1186,1880,10
110649447674,110649447674,0,1444,2203,10
110653345031,110653345033,2,2314,2660,10
110655587594,110655587594,0,1250,1662,10
110655977761,110655977752,-9,1437,1894,10
110661207997,110661207996,-1,1569,1872,10
110663382916,110663382915,-1,1458,1688,10
110665523938,110665523937,-1,1015,1561,10
110668847533,110668847530,-3,1039,2206,10
110669054941,110669054939,-2,1585,2707,10
110669565970,110669565969,-1,652,884,10
110673472979,110673472978,-1,1050,1279,10
110678182371,110678182369,-2,894,1809,10
110678389370,110678389350,-20,732,1093,10
110679635099,110679635097,-2,954,1838,10
110680306210,110680306206,-4,1381,2746,10
110680913728,110680913726,-2,1489,1085,10
110682374438,110682374435,-3,1235,2704,10
110684833531,110684833530,-1,1035,2386,10
110685116636,110685116634,-2,1546,1506,10
110685659957,110685659955,-2,1090,2011,10
110686626396,110686626396,0,1098,1453,10
110687285538,110687285534,-4,1261,2320,10
110688404041,110688404040,-1,985,1792,10
110689888482,110689888484,2,1386,1700,10
110690489530,110690489529,-1,1196,1025,10
110691581006,110691581005,-1,1416,1981,10
110692699030,110692699030,0,1124,1840,10
110693966889,110693966887,-2,1373,1991,10
110694720816,110694720817,1,1297,2022,10
110695479387,110695479386,-1,1015,1717,10
110696150873,110696150873,0,1468,2598,10
110696489958,110696489979,21,959,1500,10
110699685326,110699685326,0,1040,2007,10
110700951639,110700951637,-2,1121,1698,10
110705584677,110705584674,-3,1358,1860,10
110705675007,110705675005,-2,1262,1705,10
110706296215,110706296214,-1,1047,1784,10
110706880665,110706880662,-3,1169,2039,10
110711181323,110711181321,-2,1717,2476,10
110712510663,110712510641,-22,1475,1850,10
110717839195,110717839195,0,1186,2032,10
110719207835,110719207835,0,1307,1873,10
110720746592,110720746590,-2,1207,1526,10
110725613215,110725613214,-1,1280,2133,10
110729852421,110729852419,-2,1454,1954,10
110729902945,110729902946,1,294,1900,10
110731569593,110731569593,0,1646,2621,10
110737236540,110737236539,-1,1140,2214,10
110737480815,110737480813,-2,1230,2013,10
110740277252,110740277250,-2,1139,1818,10
110742053514,110742053524,10,673,1218,10
110748668014,110748668013,-1,1149,1891,10
110749775578,110749775578,0,1358,2333,10
110751536766,110751536764,-2,1202,1508,10
110755377605,110755377605,0,1304,2006,10
110759343942,110759343942,0,1168,1410,10
110760734939,110760734937,-2,671,1277,10
110763878154,110763878152,-2,885,1864,10
110764867018,110764867017,-1,993,1699,10
110766039421,110766039416,-5,1882,6321,10
110766525810,110766525808,-2,908,1132,10
110770983131,110770983131,0,1248,1435,10
110774528576,110774528576,0,2665,2558,10
110778456973,110778456972,-1,1491,2171,10
110781429212,110781429210,-2,1366,2838,10
110781759680,110781759681,1,2427,1541,10
110784654779,110784654778,-1,1202,2332,10
110785563431,110785563432,1,1373,1599,10
110788271889,110788271886,-3,945,1390,10
110791060504,110791060505,1,1125,2076,10
110792698533,110792698530,-3,1624,2194,10
110793253045,110793253028,-17,978,184,10
110798388308,110798388306,-2,1308,2058,10
110802121898,110802121898,0,1190,1359,10
110808479184,110808479180,-4,785,1956,10
110809498210,110809498214,4,3221,2090,10
110816176114,110816176109,-5,1070,3442,10
110817048505,110817048506,1,1048,1317,10
110822235827,110822235844,17,1275,2034,10
110823640761,110823640760,-1,1506,2322,10
110826424530,110826424531,1,1470,1838,10
110831216490,110831216488,-2,1166,2152,10
110832790821,110832790818,-3,1725,2508,10
110833966351,110833966346,-5,1099,1791,10
110834499851,110834499849,-2,1190,1766,10
110837642561,110837642559,-2,1589,1749,10
110841674306,110841674305,-1,1184,2529,10
110843784785,110843784785,0,1389,1853,10
110847346258,110847346255,-3,1220,1940,10
110847391808,110847391811,3,1746,1774,10
110848642354,110848642357,3,1176,1247,10
110858167847,110858167844,-3,1065,2175,10
110858384105,110858384094,-11,1234,1890,10
110861236130,110861236128,-2,1050,1905,10
110863160458,110863160456,-2,1087,2237,10
110864604345,110864604348,3,1250,1764,10
110865550959,110865550955,-4,594,1167,10
110865842770,110865842748,-22,859,2573,10
110866372186,110866372180,-6,1079,1349,10
110866547986,110866547973,-13,1270,2161,10
110867751142,110867751141,-1,1121,2382,10
110868779609,110868779608,-1,1945,2480,10
110869712097,110869712095,-2,1539,2413,10
110876970214,110876970211,-3,973,2233,10
110878221974,110878221972,-2,1018,1973,10
110882547996,110882547993,-3,1130,3536,10
110882704640,110882704661,21,557,1151,10
110883328938,110883328937,-1,994,2117,10
110885001666,110885001665,-1,2090,2354,10
110887039907,110887039906,-1,1374,1446,10
110891142369,110891142370,1,939,1568,10
110891460887,110891460882,-5,1327,2115,10
110891989145,110891989142,-3,1300,2892,10
110893238250,110893238250,0,1179,1902,10
110895116808,110895116806,-2,1444,2195,10
110896127879,110896127874,-5,743,2282,10
110897812081,110897812081,0,1185,2155,10
110898531787,110898531786,-1,906,1415,10
110900388418,110900388416,-2,1091,2106,10
110901587676,110901587676,0,1444,2654,10
110902432446,110902432444,-2,1369,2850,10
110904066782,110904066784,2,3727,3365,10
110904902618,110904902615,-3,1313,1996,10
110909178154,110909178150,-4,823,1483,10
110909621579,110909621578,-1,1285,1819,10
110909814235,110909814233,-2,752,983,10
110912630617,110912630615,-2,1041,2440,10
110913034077,110913034077,0,1483,1527,10
110913826277,110913826277,0,1238,1930,10
110916014571,110916014567,-4,1977,2800,10
110920434860,110920434858,-2,814,1670,10
110920523027,110920523023,-4,1003,3163,10
110921562575,110921562573,-2,1163,1496,10
110921748187,110921748184,-3,993,1955,10
110924039535,110924039537,2,1601,973,10
110926726855,110926726857,2,1952,2085,10
110929202849,110929202854,5,3097,1361,10
110930351250,110930351249,-1,1416,2101,10
110931820874,110931820873,-1,1030,1804,10
110933097903,110933097904,1,1891,2407,10
110940331354,110940331353,-1,1131,1726,10
110940737939,110940737959,20,287,914,10
110941404136,110941404135,-1,1465,2034,10
110942351159,110942351157,-2,1084,2060,10
110947003162,110947003161,-1,957,1805,10
110947110210,110947110227,17,974,1550,10
110947524346,110947524363,17,1630,3078,10
110948303811,110948303810,-1,1328,2222,10
110950408608,110950408607,-1,1304,2938,10
110950475942,110950475940,-2,1402,1771,10
110951728262,110951728259,-3,881,1343,10
110952857387,110952857387,0,1561,2373,10
110955689799,110955689798,-1,1322,2077,10
110957672966,110957672962,-4,1311,1840,10
110963168927,110963168925,-2,1045,1708,10
110965145414,110965145410,-4,1090,1835,10
110969740315,110969740316,1,828,1819,10
110971325562,110971325579,17,536,1991,10
110971352142,110971352140,-2,975,1806,10
110971615839,110971615841,2,1208,1048,10
110972085398,110972085398,0,1254,1653,10
110977774047,110977774059,12,635,1397,10
110978109555,110978109553,-2,1634,2469,10
110981799660,110981799658,-2,911,1744,10
110983071722,110983071722,0,819,1798,10
110983969250,110983969243,-7,1117,1941,10
110985920722,110985920722,0,1376,1606,10
110988463219,110988463200,-19,977,1598,10
110989440399,110989440396,-3,858,1720,10
110989551558,110989551562,4,2610,1400,10
110994214021,110994214021,0,1052,1596,10
110999622354,110999622354,0,1171,1685,10
111003043082,111003043082,0,1299,1760,10
111006401831,111006401831,0,774,837,10
111010185752,111010185750,-2,1080,1455,10
111010484532,111010484514,-18,725,1235,10
111010904239,111010904238,-1,1602,2092,10
111012192722,111012192721,-1,1114,2024,10
111023514561,111023514559,-2,1036,1734,10
111024686841,111024686861,20,538,1376,10
111024781291,111024781294,3,2423,2014,10
111025810639,111025810637,-2,1087,1674,10
111025957923,111025957940,17,1071,2173,10
111027140947,111027140946,-1,1013,2077,10
111038250243,111038250245,2,691,1354,10
111039927610,111039927608,-2,1521,2335,10
111043610446,111043610446,0,2010,3555,10
111044369319,111044369317,-2,1405,2082,10
111048046638,111048046637,-1,1904,2057,10
111049838141,111049838142,1,1457,1503,10
111051098769,111051098768,-1,1714,2051,10
111051983350,111051983351,1,2041,1147,10
111052206272,111052206271,-1,1354,2232,10
111058234393,111058234393,0,1699,2396,10
111058702889,111058702887,-2,1043,2262,10
111061542889,111061542887,-2,2019,2947,10
111068404719,111068404720,1,2010,1937,10
111070464758,111070464764,6,2118,1359,10
111074837702,111074837702,0,1046,1212,10
111077389018,111077389014,-4,1149,3498,10
111078578549,111078578548,-1,1625,1792,10
111082309735,111082309733,-2,1053,2411,10
111088968702,111088968698,-4,2268,5661,10
111089107079,111089107077,-2,1466,2255,10
111095183253,111095183254,1,1242,1184,10
111096268828,111096268824,-4,1392,1669,10
111098588031,111098588031,0,1561,2205,10
111099350432,111099350433,1,1430,2005,10
111101244478,111101244478,0,754,936,10
111102154959,111102154959,0,1344,2417,10
111104231371,111104231381,10,787,252,10
111106296701,111106296698,-3,1324,1684,10
111108100765,111108100764,-1,1100,1904,10
111108701771,111108701770,-1,752,1759,10
111109479446,111109479452,6,2906,1867,10
111109877850,111109877851,1,1349,1660,10
111110500449,111110500447,-2,1476,1900,10
111124133498,111124133498,0,1595,2104,10
111126338007,111126338004,-3,1338,2272,10
111126635680,111126635682,2,1724,2297,10
111129258767,111129258766,-1,1460,2826,10
111130967439,111130967436,-3,1515,2320,10
111145628330,111145628328,-2,701,1289,10
111149391820,111149391823,3,1282,1181,10
111150169038,111150169038,0,1187,886,10
111152124082,111152124079,-3,1288,2248,10
111152616923,111152616942,19,934,1237,10
111153515307,111153515305,-2,1148,2145,10
111165225127,111165225127,0,1360,1687,10
111171030350,111171030354,4,2317,1503,10
111172513249,111172513248,-1,1014,1341,10
111172680336,111172680334,-2,989,1844,10
111173324054,111173324054,0,1264,1753,10
111176181238,111176181237,-1,1895,2596,10
111179889193,111179889193,0,1464,2113,10
111180947803,111180947800,-3,998,1716,10
111183685471,111183685470,-1,2458,4916,10
111187024210,111187024210,0,2922,3418,10
111190146083,111190146083,0,1150,1799,10
111190312172,111190312170,-2,1033,2851,10
111190856656,111190856679,23,1417,2325,10
111191838680,111191838677,-3,1584,2036,10
111195383630,111195383630,0,1406,1236,10
111197111439,111197111438,-1,1006,1845,10
111198962822,111198962823,1,1436,1947,10
111200080814,111200080813,-1,1382,2143,10
111201341403,111201341401,-2,1769,2270,10
111202188118,111202188116,-2,1072,1017,10
111202900781,111202900782,1,881,1312,10
111203542378,111203542383,5,1157,831,10
111205055726,111205055723,-3,2273,4089,10
111205178007,111205178005,-2,1352,2337,10
111206219777,111206219774,-3,1470,2251,10
111208021571,111208021575,4,1707,675,10
111208901063,111208901062,-1,837,1711,10
111213735083,111213735082,-1,1279,2237,10
111214260903,111214260901,-2,1008,1951,10
111215286770,111215286768,-2,1147,1732,10
111215723706,111215723702,-4,1040,1121,10
111216004403,111216004402,-1,1291,1867,10
111217690018,111217690018,0,1131,1636,10
111218058920,111218058918,-2,1309,2685,10
111219706441,111219706443,2,1860,1120,10
111219769009,111219769009,0,1326,2010,10
111222352349,111222352344,-5,1519,2715,10
111222574043,111222574043,0,978,1865,10
111223307465,111223307463,-2,1744,2365,10
111227342566,111227342563,-3,1113,2102,10
111231123005,111231123002,-3,1472,1987,10
111232018135,111232018134,-1,1299,2010,10
111232498814,111232498814,0,1488,1700,10
111233073894,111233073895,1,1058,1678,10
111233948783,111233948782,-1,1218,2559,10
111236232054,111236232054,0,1275,1873,10
111238256741,111238256739,-2,1221,2288,10
111239022889,111239022887,-2,1316,1398,10
111242769834,111242769832,-2,908,1666,10
111243250567,111243250567,0,1427,2007,10
111246016025,111246016022,-3,1294,2607,10
111247337906,111247337905,-1,951,1587,10
111249813106,111249813102,-4,1020,2148,10
111252173019,111252173016,-3,1064,1698,10
111254726569,111254726566,-3,967,2296,10
111257493283,111257493280,-3,557,1070,10
111258574862,111258574862,0,1438,2309,10
111258815071,111258815072,1,1134,1115,10
111261667218,111261667216,-2,920,2014,10
111266133720,111266133717,-3,1150,1561,10
111271791466,111271791466,0,1154,1593,10
111272749638,111272749636,-2,1921,5432,10
111277655104,111277655106,2,1664,1588,10
111281500909,111281500910,1,1384,1896,10
111283939468,111283939474,6,5452,3035,10
111284093282,111284093278,-4,22955,11122,10
111284831458,111284831457,-1,1301,1977,10
111285897349,111285897347,-2,1601,2624,10
111286694967,111286694966,-1,970,1424,10
111291169826,111291169824,-2,1067,2348,10
111292157227,111292157224,-3,1332,1739,10
111294180107,111294180106,-1,1072,1794,10
111296171311,111296171310,-1,1154,2273,10
111296629693,111296629692,-1,1384,823,10
111297451107,111297451105,-2,1020,1809,10
111299277009,111299277009,0,1247,1663,10
111302143715,111302143709,-6,26527,11038,10
111305049511,111305049507,-4,867,1382,10
111309300046,111309300045,-1,1737,1820,10
111313320514,111313320513,-1,1170,1976,10
111315422166,111315422166,0,1315,2439,10
111320041865,111320041862,-3,934,2010,10
111321594107,111321594105,-2,1128,2165,10
111326320958,111326320957,-1,1113,1567,10
111327351005,111327351002,-3,1239,2082,10
111328377159,111328377157,-2,1019,1732,10
111329557335,111329557334,-1,1179,2200,10
111334275253,111334275251,-2,880,1759,10
111335765769,111335765790,21,1372,1704,10
111339488663,111339488658,-5,1177,2155,10
111340085435,111340085434,-1,1125,1528,10
111342571781,111342571778,-3,1122,2054,10
111344114303,111344114302,-1,925,1260,10
111348128747,111348128744,-3,756,1761,10
111348478645,111348478646,1,991,1402,10
111349218207,111349218206,-1,1628,2251,10
111350642214,111350642215,1,1828,2912,10
111356970930,111356970931,1,1355,1310,10
111357106670,111357106668,-2,1125,1788,10
111358033462,111358033461,-1,1023,1589,10
111361196311,111361196306,-5,820,3025,10
111361973578,111361973577,-1,1275,2039,10
111364520322,111364520311,-11,16682,27068,10
111368883693,111368883693,0,1113,1734,10
111370048653,111370048654,1,1902,1823,10
111373966307,111373966305,-2,970,2102,10
111374639117,111374639113,-4,809,874,10
111376657181,111376657179,-2,2013,3055,10
111377256866,111377256866,0,810,1518,10
111388556619,111388556614,-5,721,1538,10
111393438479,111393438478,-1,1034,1185,10
111397629355,111397629354,-1,850,1209,10
111403417254,111403417254,0,1082,1498,10
111405209210,111405209208,-2,1116,1945,10
111406138236,111406138234,-2,1221,1886,10
111411869457,111411869454,-3,1042,1827,10
111412397512,111412397512,0,1528,2268,10
111416044544,111416044539,-5,834,1634,10
111416287307,111416287301,-6,1503,2559,10
111416563205,111416563201,-4,1452,1699,10
111424688551,111424688551,0,1397,1988,10
111428430460,111428430459,-1,1437,2419,10
111430376891,111430376890,-1,735,2146,10
111430585233,111430585218,-15,769,897,10
111432599648,111432599650,2,1354,2084,10
111437045346,111437045342,-4,956,1470,10
111443851746,111443851745,-1,1032,1337,10
111447602538,111447602537,-1,1604,1920,10
111448620408,111448620406,-2,1754,2584,10
111449638002,111449638001,-1,2381,4452,10
111452813209,111452813192,-17,1495,914,10
111452991513,111452991510,-3,1403,2774,10
111455006127,111455006126,-1,1631,2150,10
111455656006,111455656003,-3,1316,2221,10
111455707201,111455707200,-1,1114,1236,10
111462903582,111462903577,-5,883,916,10
111465287143,111465287142,-1,1478,2195,10
111466692125,111466692122,-3,1207,2028,10
111471428566,111471428563,-3,329,1473,10
111471915619,111471915618,-1,1840,2197,10
111473184617,111473184616,-1,1315,2559,10
111477032335,111477032333,-2,1146,1858,10
111480131206,111480131206,0,924,1948,10
111480646730,111480646730,0,1167,1449,10
111480999001,111480999009,8,6823,2462,10
111487252231,111487252233,2,947,1584,10
111492021258,111492021257,-1,1119,2432,10
111492306075,111492306081,6,2431,1210,10
111501133794,111501133793,-1,1410,2296,10
111505423546,111505423545,-1,919,2109,10
111509708719,111509708718,-1,1337,1931,10
111511540085,111511540086,1,1563,1316,10
111513288037,111513288036,-1,1175,1234,10
111514839809,111514839809,0,1102,1809,10
111523436866,111523436867,1,1087,1791,10
111524614648,111524614645,-3,2160,3503,10
111529691119,111529691118,-1,1115,1484,10
111536743086,111536743085,-1,1408,1723,10
111539995529,111539995526,-3,1248,2581,10
111542181014,111542181013,-1,555,1224,10
111542664086,111542664084,-2,1005,1986,10
111543155580,111543155577,-3,1667,2777,10
111545893886,111545893892,6,3985,1355,10
111549265179,111549265177,-2,921,920,10
111552101282,111552101282,0,1727,2001,10
111553860596,111553860594,-2,1240,1645,10
111560727514,111560727513,-1,1586,1925,10
111563607075,111563607072,-3,872,2025,10
111565780422,111565780422,0,1643,1699,10
111567292939,111567292936,-3,3473,12141,10
111568272121,111568272119,-2,1037,1407,10
111572689578,111572689575,-3,1121,1763,10
111573031921,111573031920,-1,1171,1917,10
111583036979,111583036974,-5,1194,2371,10
111586866455,111586866454,-1,1453,2308,10
111588870401,111588870398,-3,1619,2261,10
111589098270,111589098267,-3,781,1748,10
111590598184,111590598183,-1,1301,2352,10
111593035258,111593035257,-1,9017,12331,10
111593670046,111593670045,-1,1427,2277,10
111593702795,111593702795,0,1220,1825,10
111600078371,111600078368,-3,1098,1883,10
111600613054,111600613053,-1,1454,2401,10
111601205915,111601205913,-2,1286,2504,10
111601431223,111601431223,0,1083,2157,10
111606343074,111606343073,-1,890,2161,10
111609504747,111609504743,-4,675,2204,10
111610251506,111610251504,-2,664,1091,10
111610588506,111610588502,-4,810,1997,10
111617637829,111617637822,-7,2237,8403,10
111618051051,111618051053,2,1963,2019,10
111620516590,111620516591,1,1515,2074,10
111622802863,111622802863,0,1271,1655,10
111629123526,111629123525,-1,1239,1527,10
111630071565,111630071562,-3,1011,1146,10
111631167890,111631167889,-1,1074,2255,10
111632415874,111632415874,0,1030,1632,10
111635504546,111635504543,-3,1398,1849,10
111637738037,111637738037,0,1117,1312,10
111639231540,111639231538,-2,1236,2414,10
111642804122,111642804128,6,2655,1191,10
111644703230,111644703231,1,1128,2048,10
111647603243,111647603240,-3,1206,1495,10
111657281659,111657281658,-1,1028,1394,10
111661176898,111661176898,0,964,1623,10
111663048258,111663048257,-1,1191,1667,10
111663242213,111663242226,13,594,749,10
111666612983,111666612979,-4,1416,1520,10
111667769400,111667769399,-1,843,2049,10
111673350878,111673350878,0,1099,1892,10
111674803482,111674803481,-1,1086,1508,10
111677002435,111677002434,-1,1635,2248,10
111678408610,111678408608,-2,924,1709,10
111679604103,111679604101,-2,1172,2127,10
111681390245,111681390245,0,1447,2090,10
111681986698,111681986698,0,1234,1575,10
111683877165,111683877162,-3,1219,1953,10
111684122236,111684122232,-4,935,2136,10
111684556751,111684556750,-1,1233,1592,10
111689022784,111689022783,-1,820,1216,10
111690194587,111690194593,6,3072,1287,10
111691532752,111691532749,-3,1175,1725,10
111694255271,111694255269,-2,1016,1621,10
111703700326,111703700326,0,1398,2001,10
111704186745,111704186744,-1,1242,2513,10
111704542495,111704542494,-1,712,1296,10
111708869715,111708869722,7,2605,1264,10
111713181870,111713181869,-1,1035,2003,10
111718504559,111718504554,-5,2335,5246,10
111720060426,111720060426,0,777,1380,10
111723438726,111723438725,-1,801,1617,10
111728150854,111728150860,6,8058,40119,10
111728950250,111728950250,0,1302,2162,10
111729392115,111729392134,19,429,1192,10
111731846401,111731846398,-3,1717,2697,10
111732062552,111732062549,-3,1341,2134,10
111736754185,111736754184,-1,523,1687,10
111749881857,111749881854,-3,1047,2918,10
111751281082,111751281066,-16,1478,2548,10
111752640209,111752640206,-3,1462,3225,10
111758878743,111758878740,-3,1096,2232,10
111761650781,111761650782,1,1471,1460,10
111762970584,111762970583,-1,1225,2368,10
111764470114,111764470110,-4,13539,14579,10
111764654506,111764654506,0,1398,1856,10
111768340566,111768340566,0,1514,1811,10
111768396272,111768396272,0,1432,1692,10
111770913560,111770913559,-1,1618,1608,10
111776212035,111776212041,6,2613,1681,10
111776299810,111776299799,-11,1302,1655,10
111777065546,111777065544,-2,1602,1769,10
111778443994,111778443991,-3,1196,1663,10
111779627954,111779627953,-1,1254,2288,10
111783047083,111783047081,-2,996,1675,10
111787003650,111787003648,-2,1128,2167,10
111789386256,111789386260,4,1581,1119,10
111790584211,111790584211,0,1281,1426,10
111791035849,111791035866,17,835,1798,10
111792583298,111792583297,-1,751,1216,10
111795282366,111795282364,-2,1617,2378,10
111806817423,111806817423,0,1501,1446,10
111814895981,111814895985,4,2055,1504,10
111815181951,111815181950,-1,1420,2341,10
111817809478,111817809484,6,3359,1930,10
111821924534,111821924519,-15,1109,2180,10
111826376411,111826376408,-3,999,1717,10
111827259702,111827259701,-1,1417,2503,10
111828129213,111828129211,-2,1285,2336,10
111828773903,111828773900,-3,1227,1864,10
111831255494,111831255492,-2,1262,1709,10
111831707441,111831707439,-2,1254,2115,10
111832886755,111832886758,3,2373,1689,10
111835482371,111835482371,0,1020,1240,10
111836631010,111836631008,-2,1410,1967,10
111837273742,111837273742,0,1375,1808,10
111841678597,111841678598,1,712,1160,10
111844666609,111844666609,0,1210,1313,10
111849685403,111849685402,-1,780,1351,10
111851713070,111851713070,0,1076,1764,10
111855462350,111855462349,-1,1532,2071,10
111856621370,111856621369,-1,1693,1493,10
111861546341,111861546322,-19,820,1752,10
111863234946,111863234945,-1,1294,2168,10
111865951753,111865951751,-2,1467,1997,10
111867189726,111867189724,-2,1259,2448,10
111869815742,111869815742,0,1248,1677,10
111871088744,111871088740,-4,1911,3137,10
111877501565,111877501564,-1,765,1205,10
111877979250,111877979248,-2,1221,2183,10
111879256645,111879256644,-1,1568,2102,10
111879413457,111879413457,0,1227,2546,10
111881139430,111881139430,0,1217,2472,10
111882065702,111882065700,-2,2171,3131,10
111882529029,111882529031,2,1149,1636,10
111887652017,111887652015,-2,1543,2532,10
111893203074,111893203073,-1,877,1714,10
111894778500,111894778501,1,1392,2191,10
111899021627,111899021626,-1,1465,1793,10
111899489147,111899489147,0,897,2189,10
111900194023,111900194021,-2,514,956,10
111900591301,111900591308,7,3009,1132,10
111904311056,111904311058,2,962,1546,10
111906942454,111906942459,5,1276,546,10
111909620858,111909620857,-1,1406,2681,10
111913501703,111913501702,-1,1048,1907,10
111915756957,111915756958,1,1344,1115,10
111917384442,111917384428,-14,864,1595,10
111918053523,111918053520,-3,1106,1973,10
111918691755,111918691738,-17,1467,2146,10
111920776897,111920776902,5,1145,1352,10
111923986811,111923986810,-1,1473,1768,10
111926582340,111926582338,-2,1320,2021,10
111929472854,111929472851,-3,1416,1768,10
111929704856,111929704877,21,61,1040,10
111931222201,111931222200,-1,1617,2199,10
111932244822,111932244818,-4,1154,2146,10
111932842000,111932841998,-2,1065,2442,10
111932870250,111932870249,-1,1407,1965,10
111933531896,111933531896,0,1392,1771,10
111937553174,111937553173,-1,1602,1832,10
111941412059,111941412058,-1,1128,1881,10
111941563755,111941563753,-2,973,2359,10
111947724328,111947724326,-2,1661,1974,10
111948252729,111948252729,0,1013,1706,10
111949697258,111949697264,6,4275,2271,10
111951158115,111951158115,0,865,1109,10
111951860211,111951860210,-1,1203,1551,10
111953146191,111953146186,-5,1157,3324,10
111953825784,111953825783,-1,1283,1582,10
111954479041,111954479063,22,1316,1786,10
111958760628,111958760626,-2,1793,1626,10
111967778166,111967778167,1,1288,1956,10
111970013883,111970013889,6,3349,2353,10
111970601638,111970601637,-1,1194,1615,10
111980944519,111980944518,-1,1003,2147,10
111982422066,111982422066,0,1350,1324,10
111989939935,111989939936,1,1458,2802,10
111997060815,111997060814,-1,1459,1580,10
111997947246,111997947244,-2,1175,2246,10
111998578918,111998578917,-1,1067,1542,10
111999684282,111999684281,-1,998,2180,10
112003973646,112003973646,0,1540,2252,10
112004623550,112004623552,2,931,1037,10
112008441014,112008441014,0,742,1392,10
112010420142,112010420141,-1,1916,2594,10
112012459630,112012459631,1,800,1445,10
112014684949,112014684949,0,974,2000,10
112023818531,112023818530,-1,2104,3328,10
112026128275,112026128270,-5,21830,5699,10
112028871778,112028871781,3,2262,1361,10
112031759974,112031759972,-2,1616,2281,10
112032571413,112032571400,-13,1314,304,10
112033906467,112033906466,-1,960,1556,10
112034124570,112034124571,1,1419,2544,10
112035469823,112035469828,5,2036,1441,10
112037171870,112037171869,-1,1096,2315,10
112038570262,112038570263,1,1259,1614,10
112044128539,112044128538,-1,1102,2054,10
112046140283,112046140282,-1,1109,1937,10
112050803886,112050803885,-1,1465,2489,10
112051560050,112051560049,-1,1618,1901,10
112052862475,112052862476,1,930,1540,10
112052961206,112052961204,-2,973,1803,10
112057808002,112057808000,-2,1475,2324,10
112058140126,112058140123,-3,1120,2369,10
112058812283,112058812283,0,1559,3207,10
112059795119,112059795118,-1,1553,2693,10
112059859198,112059859199,1,1319,2164,10
112060829534,112060829531,-3,1094,1243,10
112061695906,112061695926,20,1151,1896,10
112063172631,112063172632,1,1298,1364,10
112063221634,112063221644,10,11650,47451,10
112065118553,112065118552,-1,1441,2293,10
112069088670,112069088670,0,1321,1050,10
112075884114,112075884118,4,1314,1729,10
112075964514,112075964511,-3,1027,1689,10
112080590385,112080590387,2,1918,2117,10
112082989118,112082989137,19,1271,1250,10
112084525750,112084525749,-1,1179,1347,10
112091850147,112091850146,-1,1075,1999,10
112092834251,112092834248,-3,1230,3246,10
112102101707,112102101706,-1,1055,1619,10
112109791546,112109791552,6,2992,1475,10
112112306352,112112306356,4,3044,1610,10
112113170761,112113170763,2,3604,3129,10
112114723303,112114723301,-2,1436,2370,10
112121870858,112121870858,0,1180,1967,10
112126619787,112126619786,-1,684,1669,10
112129378757,112129378762,5,1875,1165,10
112129496175,112129496174,-1,1168,1664,10
112130602972,112130602970,-2,1065,2491,10
112138178486,112138178486,0,1299,1777,10
112139110355,112139110355,0,790,1209,10
112142516649,112142516646,-3,1242,2478,10
112144337561,112144337557,-4,1625,2117,10
112144934547,112144934547,0,883,973,10
112147501082,112147501081,-1,1016,2121,10
112151911165,112151911165,0,1286,2263,10
112153166757,112153166756,-1,1378,1695,10
112154273084,112154273081,-3,23432,22799,10
112158100048,112158100046,-2,2000,2114,10
112158867551,112158867551,0,1479,1758,10
112162340983,112162340982,-1,1200,1878,10
112165085583,112165085576,-7,844,3904,10
112165998400,112165998400,0,1464,1777,10
112166863550,112166863548,-2,1372,2128,10
112168229416,112168229415,-1,1824,3002,10
112169662462,112169662459,-3,1264,1603,10
112172387594,112172387593,-1,1438,2530,10
112175229290,112175229286,-4,1135,3223,10
112176183839,112176183837,-2,1557,1557,10
112176501779,112176501778,-1,872,1107,10
112177455779,112177455778,-1,1240,2261,10
112178728078,112178728076,-2,1240,1460,10
112181957510,112181957510,0,1333,1791,10
112185530309,112185530305,-4,899,1479,10
112190103792,112190103791,-1,938,2058,10
112195831816,112195831814,-2,1175,2095,10
112197466297,112197466283,-14,5888,27678,10
112197595635,112197595640,5,2430,1513,10
112199064712,112199064734,22,889,1598,10
112203285505,112203285504,-1,1333,2078,10
112207204207,112207204207,0,28622,16739,10
112211154715,112211154714,-1,1046,1125,10
112211546808,112211546807,-1,1423,2793,10
112215687002,112215687001,-1,1127,1745,10
112221750198,112221750196,-2,1043,1272,10
112224632833,112224632832,-1,1074,2241,10
112228949392,112228949399,7,2689,1423,10
112236579327,112236579328,1,1701,2037,10
112236901242,112236901240,-2,818,1648,10
112243980262,112243980262,0,1511,2188,10
112245012462,112245012462,0,966,2276,10
112246736751,112246736749,-2,1177,2079,10
112247373557,112247373554,-3,1196,2337,10
112248423541,112248423541,0,1126,2756,10
112248836541,112248836538,-3,1198,2295,10
112249233713,112249233712,-1,1902,2838,10
112260943715,112260943714,-1,1369,2388,10
112261955441,112261955442,1,1270,1477,10
112263845722,112263845721,-1,754,1664,10
112266703778,112266703777,-1,1026,1670,10
112275049491,112275049491,0,1255,1908,10
112275439703,112275439701,-2,1296,2262,10
112278633270,112278633268,-2,1278,1920,10
112279668506,112279668526,20,1361,1779,10
112281660901,112281660900,-1,813,2361,10
112286310462,112286310462,0,1801,2653,10
112289800934,112289800933,-1,1053,1523,10
112291044773,112291044770,-3,802,1539,10
112291370473,112291370471,-2,223,2094,10
112298107133,112298107133,0,1028,1742,10
112300828441,112300828438,-3,1289,1825,10
112303070207,112303070205,-2,1122,2108,10
112304337287,112304337285,-2,950,2024,10
112307021252,112307021249,-3,1138,1248,10
112307413721,112307413739,18,1034,2678,10
112309984246,112309984242,-4,1334,2095,10
112310629735,112310629731,-4,726,1677,10
112314692605,112314692602,-3,1267,1981,10
112315068137,112315068133,-4,15254,14573,10
112325016250,112325016256,6,2077,1255,10
112328864535,112328864534,-1,1116,1745,10
112329994727,112329994722,-5,961,2317,10
112336363143,112336363138,-5,738,1763,10
112336415290,112336415277,-13,1311,1598,10
112336630688,112336630670,-18,1071,2670,10
112338345329,112338345328,-1,1228,2014,10
112341873138,112341873137,-1,1710,1749,10
112343844981,112343844978,-3,1358,1973,10
112344877287,112344877287,0,993,1407,10
112345046981,112345046978,-3,1121,2575,10
112348807381,112348807383,2,1191,1110,10
112350927570,112350927570,0,1278,1628,10
112353124910,112353124909,-1,1004,1454,10
112357308877,112357308884,7,4112,1552,10
112357538945,112357538943,-2,1090,2226,10
112360581798,112360581794,-4,1235,2346,10
112361337015,112361337013,-2,1074,1786,10
112363972286,112363972283,-3,1456,2544,10
112365125038,112365125038,0,1358,2031,10
112365626018,112365626020,2,951,1053,10
112368393806,112368393805,-1,1504,2385,10
112369246201,112369246199,-2,1384,1704,10
112369806710,112369806709,-1,355,1353,10
112370072798,112370072796,-2,1250,1419,10
112371778998,112371779000,2,1195,2181,10
112375385026,112375385024,-2,1158,2572,10
112375871722,112375871713,-9,1113,1280,10
112376718222,112376718224,2,959,1106,10
112381279888,112381279872,-16,1309,2010,10
112381811098,112381811099,1,1829,1942,10
112383381362,112383381358,-4,932,2246,10
112385300122,112385300121,-1,1644,2245,10
112387654437,112387654438,1,1366,1504,10
112390873130,112390873126,-4,1233,2337,10
112391530319,112391530317,-2,960,2062,10
112393504333,112393504326,-7,1550,4843,10
112396781168,112396781166,-2,1506,2217,10
112398167458,112398167456,-2,1341,2021,10
112402491618,112402491619,1,1524,2620,10
112403410155,112403410153,-2,1492,2175,10
112403609535,112403609533,-2,1248,2654,10
112403879471,112403879469,-2,982,1721,10
112404382678,112404382676,-2,1121,2244,10
112404995802,112404995822,20,283,952,10
112406276910,112406276905,-5,835,2946,10
112408254041,112408254038,-3,1895,2307,10
112410896126,112410896118,-8,940,3774,10
112413888703,112413888700,-3,1026,1906,10
112419748105,112419748103,-2,1124,1654,10
112422132947,112422132945,-2,934,1848,10
112424292830,112424292830,0,1355,2134,10
112425055745,112425055743,-2,1802,2571,10
112427879547,112427879546,-1,1151,2384,10
112430912209,112430912205,-4,1295,3174,10
112431160774,112431160773,-1,1668,2083,10
112439740251,112439740250,-1,1768,2077,10
112441319979,112441319985,6,1144,599,10
112442140257,112442140263,6,3122,1735,10
112445662322,112445662321,-1,1361,2122,10
112448156525,112448156525,0,1085,1697,10
112452207707,112452207706,-1,1024,2243,10
112453303572,112453303571,-1,232,939,10
112454401663,112454401662,-1,1079,2488,10
112455392753,112455392753,0,1488,1781,10
112456752198,112456752195,-3,975,1434,10
112460970773,112460970770,-3,1316,2560,10
112461895661,112461895664,3,1161,1007,10
112465183766,112465183766,0,1731,2340,10
112465303193,112465303190,-3,731,1225,10
112467191514,112467191511,-3,1159,2315,10
112477270790,112477270789,-1,1092,1440,10
112477996730,112477996728,-2,788,1403,10
112478233190,112478233191,1,21730,24929,10
112480497506,112480497502,-4,1965,5132,10
112488650221,112488650214,-7,1757,11211,10
112489001739,112489001739,0,1513,1699,10
112489801084,112489801082,-2,1620,2156,10
112491390065,112491390054,-11,888,1176,10
112494653295,112494653295,0,1440,2868,10
112495028582,112495028578,-4,997,1575,10
112495650810,112495650810,0,805,1327,10
112496592782,112496592783,1,829,1266,10
112497375151,112497375150,-1,1437,2514,10
112497537535,112497537536,1,1076,2143,10
112497827967,112497827965,-2,1207,1789,10
112499275983,112499275983,0,1135,1667,10
112501570817,112501570819,2,1223,1436,10
112501857457,112501857455,-2,1235,1617,10
112506346369,112506346368,-1,1535,1893,10
112507991102,112507991102,0,1426,1595,10
112508303572,112508303571,-1,1374,1952,10
112509763481,112509763478,-3,1817,2082,10
112511426462,112511426462,0,1162,1649,10
112515772050,112515772047,-3,1268,1393,10
112519815050,112519815049,-1,1505,3023,10
112521108722,112521108722,0,916,1793,10
112521297193,112521297191,-2,1311,1608,10
112521613107,112521613105,-2,684,1140,10
112522828386,112522828384,-2,899,2061,10
112540808528,112540808533,5,2219,1086,10
112543892879,112543892876,-3,1046,1805,10
112545498151,112545498151,0,1322,2014,10
112547124334,112547124333,-1,1092,1381,10
112548062814,112548062811,-3,1201,1831,10
112553818457,112553818454,-3,1317,1587,10
112558604059,112558604058,-1,1454,2484,10
112560788935,112560788932,-3,2253,2314,10
112563229462,112563229461,-1,1149,1914,10
112564742098,112564742095,-3,1695,1946,10
112564857707,112564857706,-1,666,1039,10
112573271795,112573271793,-2,1227,1961,10
112574008669,112574008668,-1,1353,1929,10
112576688646,112576688643,-3,1417,2020,10
112578270977,112578270974,-3,1248,1189,10
112583627331,112583627329,-2,1493,1515,10
112585504946,112585504951,5,1456,780,10
112586448038,112586448037,-1,866,2491,10
112587841664,112587841666,2,1612,1633,10
112587980639,112587980640,1,1364,1574,10
112588524335,112588524334,-1,1045,1738,10
112590269885,112590269885,0,1283,1710,10
112593097473,112593097478,5,2935,1733,10
112593345945,112593345944,-1,946,1201,10
112594061026,112594061026,0,1168,2124,10
112598295749,112598295745,-4,1539,2171,10
112598330157,112598330154,-3,866,1388,10
112602178780,112602178778,-2,1031,1337,10
112605193985,112605193983,-2,858,987,10
112605604835,112605604834,-1,1179,1768,10
112614685094,112614685090,-4,1041,1744,10
112616264268,112616264287,19,141,597,10
112616955247,112616955251,4,918,908,10
112617026652,112617026652,0,862,1233,10
112617584402,112617584402,0,883,2004,10
112617754814,112617754814,0,1207,2540,10
112622408010,112622408009,-1,1187,1820,10
112623240049,112623240051,2,1097,2112,10
112629946787,112629946786,-1,3720,5046,10
112632832870,112632832868,-2,1310,1758,10
112635503885,112635503882,-3,1215,1498,10
112635633378,112635633379,1,490,940,10
112641895342,112641895341,-1,1209,1702,10
112643833179,112643833179,0,2593,3118,10
112645472505,112645472504,-1,953,1280,10
112647461277,112647461277,0,1066,2055,10
112650932083,112650932082,-1,815,1623,10
112657455580,112657455579,-1,1015,1332,10
112659020142,112659020138,-4,773,2223,10
112659319876,112659319891,15,1050,1792,10
112660442235,112660442233,-2,1008,2422,10
112664535490,112664535490,0,894,1715,10
112668108730,112668108726,-4,1081,1694,10
112670475363,112670475362,-1,1717,2706,10
112672867010,112672867009,-1,1430,1988,10
112673716534,112673716533,-1,864,1676,10
112676611277,112676611275,-2,1144,1785,10
112677211115,112677211113,-2,1248,2232,10
112679218401,112679218402,1,1948,2210,10
112683953030,112683953030,0,930,1640,10
112685922155,112685922156,1,1256,1515,10
112687551410,112687551408,-2,773,1438,10
112689883202,112689883200,-2,1170,1745,10
112694382992,112694382990,-2,1639,2360,10
112698033019,112698033018,-1,875,1545,10
112698189570,112698189553,-17,1041,1823,10
112698875551,112698875567,16,681,1507,10
112700571727,112700571726,-1,622,1419,10
112701789238,112701789238,0,1743,1378,10
112705387807,112705387805,-2,959,1698,10
112705584977,112705584978,1,1055,1476,10
112707073921,112707073921,0,1798,2075,10
112708297075,112708297073,-2,1321,3160,10
112709825691,112709825690,-1,1099,1378,10
112711057335,112711057334,-1,1169,1947,10
112711702351,112711702348,-3,1389,2334,10
112712596882,112712596881,-1,1310,1591,10
112717176648,112717176647,-1,1661,2159,10
112720568906,112720568907,1,1436,1185,10
112721818511,112721818509,-2,1294,2379,10
112722141145,112722141144,-1,1515,2620,10
112722730033,112722730033,0,1051,1521,10
112723228443,112723228443,0,1514,1714,10
112724093180,112724093179,-1,1476,1302,10
112724144818,112724144818,0,1577,2134,10
112726805850,112726805849,-1,1054,1582,10
112726963651,112726963646,-5,827,1185,10
112729121286,112729121279,-7,896,2134,10
112729697209,112729697195,-14,674,1423,10
112737022687,112737022685,-2,1478,2375,10
112737521310,112737521309,-1,1474,1535,10
112745012549,112745012543,-6,2833,8758,10
112746387433,112746387431,-2,1633,2142,10
112747962164,112747962165,1,1490,1856,10
112749547062,112749547059,-3,1203,2529,10
112749648330,112749648325,-5,1097,3642,10
112751381023,112751381021,-2,1053,2529,10
112756344494,112756344491,-3,1167,2106,10
112757768742,112757768740,-2,1304,1914,10
112760152653,112760152652,-1,2840,4422,10
112763705343,112763705340,-3,1211,2620,10
112764956947,112764956944,-3,1323,2885,10
112768327457,112768327458,1,1148,1521,10
112768482283,112768482298,15,519,3679,10
112768527429,112768527427,-2,1556,2806,10
112770202317,112770202316,-1,1133,2035,10
112770925400,112770925398,-2,1664,1569,10
112773757757,112773757758,1,1213,1960,10
112775419060,112775419071,11,167,844,10
112777847989,112777847990,1,805,1503,10
112780110886,112780110884,-2,1275,2095,10
112781299238,112781299237,-1,1059,1370,10
112786525146,112786525146,0,1088,1894,10
112788000338,112788000343,5,1805,898,10
112793021599,112793021598,-1,1433,1627,10
112798531760,112798531754,-6,1161,5038,10
112798954465,112798954461,-4,1214,1915,10
112799669601,112799669598,-3,1458,2908,10
112801412898,112801412897,-1,1700,1912,10
112801889237,112801889234,-3,1123,1676,10
112802680488,112802680495,7,134,845,10
112804628711,112804628709,-2,817,1841,10
112808143102,112808143100,-2,1376,2286,10
112809617586,112809617585,-1,879,1673,10
112809743615,112809743615,0,2011,2004,10
112809998390,112809998390,0,1292,2506,10
112812065734,112812065733,-1,1248,2915,10
112812733260,112812733258,-2,964,1922,10
112818484712,112818484710,-2,1030,1843,10
112819302452,112819302450,-2,1494,2440,10
112821520525,112821520526,1,1181,1833,10
112822733211,112822733209,-2,844,2551,10
112826835921,112826835918,-3,1157,2566,10
112829462219,112829462218,-1,779,1517,10
112829518418,112829518414,-4,1321,3547,10
112831010465,112831010462,-3,809,2146,10
112831115295,112831115294,-1,1466,2015,10
112831482753,112831482753,0,1431,2324,10
112831515470,112831515469,-1,1259,1890,10
112833588237,112833588234,-3,1231,2085,10
112839459523,112839459522,-1,1033,2051,10
112841505658,112841505658,0,856,1049,10
112842221221,112842221220,-1,749,1992,10
112848450300,112848450299,-1,878,1606,10
112850054256,112850054254,-2,1719,2517,10
112851874497,112851874493,-4,856,2202,10
112855825557,112855825555,-2,1564,1721,10
112856053771,112856053768,-3,754,2203,10
112857702074,112857702070,-4,1147,2888,10
112866679775,112866679770,-5,1169,3667,10
112867982027,112867982027,0,1385,1079,10
112869827603,112869827601,-2,984,1540,10
112874994592,112874994590,-2,1240,2384,10
112882651883,112882651882,-1,1652,2812,10
112883329582,112883329582,0,1274,2332,10
112883937233,112883937231,-2,1436,2639,10
112884943686,112884943687,1,805,1164,10
112888715567,112888715566,-1,687,1469,10
112890768749,112890768752,3,1811,2148,10
112890810242,112890810241,-1,1916,2651,10
112891158346,112891158344,-2,1310,1979,10
112892402203,112892402203,0,1054,1758,10
112901199810,112901199813,3,2801,2652,10
112902435888,112902435883,-5,1354,2563,10
112903549690,112903549689,-1,1326,2073,10
112912156374,112912156372,-2,669,1533,10
112913409682,112913409682,0,1602,1758,10
112919577054,112919577054,0,1346,1870,10
112922567214,112922567213,-1,1023,1695,10
112923981774,112923981771,-3,1173,3030,10
112924781639,112924781638,-1,1290,1323,10
112927493032,112927493037,5,2732,1308,10
112928351255,112928351254,-1,1149,1715,10
112929191378,112929191378,0,1423,1885,10
112931524532,112931524530,-2,1743,2098,10
112934580104,112934580102,-2,930,1693,10
112934936868,112934936874,6,179,932,10
112936663409,112936663410,1,1432,1480,10
112937869460,112937869457,-3,1390,3695,10
112939046836,112939046836,0,1258,2033,10
112945108883,112945108887,4,7279,5464,10
112947944126,112947944124,-2,1019,1382,10
112949849803,112949849802,-1,622,560,10
112951582514,112951582515,1,1161,2126,10
112954939954,112954939953,-1,1064,2277,10
112955052367,112955052369,2,1587,1876,10
112958335466,112958335471,5,4558,3543,10
112960389978,112960389974,-4,974,2796,10
112961208678,112961208676,-2,1072,1823,10
112962510217,112962510218,1,1292,1699,10
112963276093,112963276091,-2,1099,2083,10
112966923598,112966923597,-1,2538,4014,10
112968531059,112968531058,-1,1256,1744,10
112973083399,112973083395,-4,1056,2081,10
112973977174,112973977173,-1,1149,2611,10
112976400778,112976400778,0,1581,2524,10
112977323198,112977323195,-3,985,2077,10
112978085494,112978085493,-1,968,863,10
112978420521,112978420519,-2,851,2121,10
112978515787,112978515783,-4,1209,2558,10
112980286249,112980286249,0,1638,1823,10
112981380356,112981380353,-3,1116,2042,10
112981830522,112981830502,-20,86,1300,10
112982887429,112982887427,-2,2188,2470,10
112986078344,112986078366,22,1091,1838,10
112989339802,112989339801,-1,1231,2292,10
112993928990,112993928987,-3,1111,1235,10
113002555386,113002555382,-4,1219,2544,10
113008196255,113008196255,0,1147,1696,10
113008316139,113008316139,0,1408,1619,10
113010914350,113010914352,2,1771,2543,10
113015760039,113015760038,-1,1107,2116,10
113018192532,113018192515,-17,1297,2623,10
113022317940,113022317940,0,1695,2429,10
113024737442,113024737437,-5,1161,3293,10
113026973923,113026973921,-2,997,1428,10
113028629281,113028629281,0,885,1066,10
113035013021,113035013020,-1,1468,2457,10
113036281933,113036281935,2,2093,1675,10
113036831957,113036831956,-1,1496,1860,10
113039797015,113039797010,-5,19468,55836,10
113043049476,113043049478,2,1144,1483,10
113045399843,113045399841,-2,1119,2171,10
113046712102,113046712102,0,1399,1410,10
113047593146,113047593145,-1,1247,2095,10
113048561155,113048561154,-1,1279,1781,10
113048700232,113048700252,20,355,1595,10
113051867174,113051867177,3,1127,1402,10
113055527726,113055527725,-1,1620,2039,10
113058610377,113058610376,-1,1296,2068,10
113059353730,113059353730,0,1482,1505,10
113061657874,113061657874,0,1519,2150,10
113062006858,113062006878,20,1315,2132,10
113063124771,113063124765,-6,1099,2081,10
113065444895,113065444894,-1,1184,1751,10
113072165107,113072165102,-5,1217,1928,10
113074171317,113074171316,-1,1472,3038,10
113085731087,113085731086,-1,1003,1181,10
113090184572,113090184575,3,1783,1649,10
113091869534,113091869536,2,1567,2036,10
113095113409,113095113411,2,1429,1598,10
113095308466,113095308469,3,3092,1634,10
113095502664,113095502664,0,981,1678,10
113096198169,113096198168,-1,1238,2102,10
113097208802,113097208803,1,1531,1829,10
113101735827,113101735827,0,1140,2442,10
113103385658,113103385654,-4,1506,2286,10
113103522726,113103522727,1,1226,1106,10
113109363848,113109363846,-2,998,2008,10
113109568466,113109568465,-1,1282,3119,10
113110258723,113110258718,-5,664,3234,10
113112176698,113112176693,-5,980,3513,10
113114663955,113114663954,-1,1113,2132,10
113116095223,113116095222,-1,1256,2623,10
113117675202,113117675200,-2,940,1899,10
113119056495,113119056494,-1,921,2015,10
113120181547,113120181544,-3,1228,2308,10
113120231689,113120231685,-4,1438,4578,10
113126149431,113126149440,9,373,4121,10
113129667952,113129667944,-8,1066,2504,10
113132503802,113132503801,-1,1114,2011,10
113133937353,113133937353,0,1485,2085,10
113135030625,113135030626,1,1695,1604,10
113138362579,113138362578,-1,1865,2304,10
113145224577,113145224574,-3,1141,1815,10
113146054635,113146054635,0,1554,1859,10
113147107256,113147107253,-3,1535,2273,10
113149721323,113149721323,0,1354,2643,10
113149945168,113149945191,23,901,2010,10
113154972960,113154972957,-3,1084,1661,10
113162005095,113162005096,1,1455,1643,10
113164451934,113164451935,1,1333,1997,10
113167468305,113167468301,-4,1264,2256,10
113170740301,113170740303,2,1804,1181,10
113171254673,113171254672,-1,1952,3263,10
113175540382,113175540382,0,881,1643,10
113175937366,113175937360,-6,1432,9542,10
113177496401,113177496401,0,1398,1713,10
113178499810,113178499809,-1,1497,1962,10
113181799759,113181799757,-2,1196,2155,10
113182066745,113182066743,-2,1180,1813,10
113182933761,113182933760,-1,890,1195,10
113184435402,113184435401,-1,1216,1813,10
113185158653,113185158659,6,5819,2200,10
113186326847,113186326848,1,1573,2312,10
113188578610,113188578606,-4,1839,4321,10
113189404718,113189404717,-1,1281,2267,10
113189620152,113189620157,5,10221,35845,10
113189829867,113189829866,-1,603,1554,10
113191162103,113191162101,-2,1628,2627,10
113192944921,113192944920,-1,1315,1963,10
113193556838,113193556838,0,1024,2133,10
113193598198,113193598194,-4,1280,2708,10
113195596786,113195596786,0,1371,2238,10
113198848601,113198848584,-17,1060,1661,10
113199964436,113199964445,9,832,3737,10
113200817949,113200817948,-1,1178,1780,10
113201596480,113201596478,-2,1369,1353,10
113201840101,113201840101,0,2145,2736,10
113203374693,113203374692,-1,1353,1872,10
113204617124,113204617123,-1,1075,1708,10
113209977129,113209977130,1,1135,1667,10
113213148532,113213148530,-2,1331,1885,10
113213264201,113213264202,1,1115,1825,10
113213692775,113213692773,-2,1237,2309,10
113213957419,113213957437,18,974,1760,10
113214207947,113214207945,-2,1120,2534,10
113222687469,113222687468,-1,1298,1784,10
113226090046,113226090042,-4,1284,3736,10
113226844630,113226844629,-1,1132,1772,10
113231151185,113231151185,0,1056,1579,10
113232452687,113232452686,-1,1028,1953,10
113236620966,113236620962,-4,916,3001,10
113244346878,113244346875,-3,1170,2303,10
113247229382,113247229377,-5,1088,1930,10
113251898351,113251898354,3,1190,951,10
113253596784,113253596782,-2,1797,2308,10
113253754702,113253754702,0,1364,1988,10
113255030665,113255030659,-6,31826,14236,10
113257862803,113257862803,0,1751,8220,10
113261567119,113261567119,0,850,1445,10
113263156061,113263156062,1,1298,1913,10
113265664206,113265664214,8,1254,1602,10
113267053454,113267053451,-3,1206,2121,10
113270171103,113270171102,-1,1115,2082,10
113271317314,113271317321,7,3721,1521,10
113272281174,113272281173,-1,1454,2743,10
113272726130,113272726126,-4,1274,2130,10
113282516389,113282516392,3,1573,1431,10
113285817482,113285817481,-1,1434,2369,10
113287670146,113287670146,0,1086,1788,10
113291190833,113291190831,-2,1599,2511,10
113293250200,113293250198,-2,1131,2268,10
113293471538,113293471533,-5,1045,1787,10
113299447983,113299447981,-2,1360,2193,10
113299606017,113299606016,-1,1352,2709,10
113302993336,113302993333,-3,1007,2234,10
113303305090,113303305089,-1,1463,2290,10
113304920642,113304920642,0,1526,1913,10
113307650602,113307650599,-3,1220,2210,10
113309088800,113309088798,-2,1053,1935,10
113310314753,113310314751,-2,1284,1460,10
113313396561,113313396558,-3,1313,3220,10
113314779087,113314779087,0,1609,2474,10
113315119438,113315119439,1,1935,1713,10
113315199071,113315199067,-4,1188,1583,10
113317840555,113317840554,-1,1256,1747,10
113320576402,113320576406,4,2296,2095,10
113330440751,113330440749,-2,1099,1637,10
113337107844,113337107842,-2,2251,3796,10
113338719571,113338719570,-1,2572,4139,10
113340775957,113340775955,-2,1179,1941,10
113341409638,113341409636,-2,1062,2066,10
113343528773,113343528770,-3,942,2655,10
113345269766,113345269773,7,14678,25699,10
113348493015,113348493010,-5,927,1479,10
113349646298,113349646297,-1,1067,1422,10
113354611110,113354611110,0,1365,2789,10
113355517211,113355517209,-2,1133,2134,10
113356439040,113356439038,-2,1641,1689,10
113360545666,113360545666,0,906,1391,10
113366118943,113366118941,-2,1213,2216,10
113366287029,113366287029,0,1372,1888,10
113371632234,113371632239,5,6288,23485,10
113373215046,113373215046,0,1043,1520,10
113373778950,113373778947,-3,1378,1925,10
113376340331,113376340329,-2,2154,3869,10
113378194010,113378194009,-1,908,1862,10
113379775226,113379775226,0,1615,1792,10
113381270565,113381270563,-2,1225,1885,10
113385549372,113385549370,-2,1201,2366,10
113386557751,113386557751,0,1048,2048,10
113388606582,113388606602,20,802,1825,10
113390243446,113390243442,-4,806,2805,10
113390294217,113390294214,-3,1216,1751,10
113393412603,113393412601,-2,1182,1679,10
113395036615,113395036613,-2,1173,1427,10
113398774353,113398774351,-2,1048,1940,10
113399601921,113399601920,-1,955,2297,10
113402629642,113402629641,-1,1280,1681,10
113404363055,113404363054,-1,1359,2355,10
113406463270,113406463270,0,1005,1939,10
113407621643,113407621641,-2,1396,2502,10
113409444165,113409444151,-14,991,1044,10
113410662498,113410662494,-4,1129,2505,10
113413600169,113413600168,-1,1330,1849,10
113414490323,113414490319,-4,1037,3364,10
113415211740,113415211737,-3,1146,2016,10
113419058961,113419058959,-2,1281,2554,10
113422606757,113422606755,-2,706,1829,10
113423030113,113423030117,4,2190,1135,10
113423997944,113423997941,-3,1309,1764,10
113424583286,113424583284,-2,1137,1904,10
113428849882,113428849881,-1,1334,1485,10
113433154706,113433154706,0,1519,1510,10
113434847930,113434847929,-1,1073,1700,10
113438264632,113438264631,-1,1071,1609,10
113446109158,113446109152,-6,1123,1619,10
113448079889,113448079886,-3,1092,1905,10
113452232941,113452232939,-2,1283,2199,10
113454487803,113454487803,0,1457,2277,10
113457616454,113457616453,-1,855,1729,10
113461619040,113461619038,-2,1227,1999,10
113464487650,113464487646,-4,953,2066,10
113467769641,113467769641,0,885,1353,10
113472901729,113472901728,-1,1111,1775,10
113474772758,113474772755,-3,1395,2072,10
113475662234,113475662238,4,2053,1716,10
113476322399,113476322399,0,805,1806,10
113483130670,113483130670,0,3118,2879,10
113484167913,113484167913,0,1364,1984,10
113487820220,113487820217,-3,812,1870,10
113492091695,113492091694,-1,1108,2466,10
113492522098,113492522097,-1,1784,2008,10
113495013689,113495013688,-1,1715,3253,10
113495551514,113495551514,0,1352,1801,10
113500010415,113500010414,-1,808,1375,10
113501979050,113501979048,-2,873,1990,10
113502272414,113502272412,-2,1738,2175,10
113506400102,113506400102,0,1379,1350,10
113509868318,113509868318,0,1386,2196,10
113513407898,113513407897,-1,805,1508,10
113514647721,113514647722,1,1895,1491,10
113521922863,113521922862,-1,979,1369,10
113530630045,113530630043,-2,669,1165,10
113532624967,113532624966,-1,1055,1424,10
113535103749,113535103747,-2,1259,1890,10
113536408345,113536408346,1,1168,1340,10
113536903359,113536903358,-1,495,643,10
113539213485,113539213491,6,1205,1664,10
113540613391,113540613390,-1,1424,2480,10
113541004871,113541004871,0,1444,2197,10
113545019468,113545019466,-2,998,1671,10
113545140154,113545140154,0,1711,1657,10
113546154026,113546154025,-1,993,1908,10
113550210034,113550210031,-3,1634,1845,10
113550306253,113550306251,-2,1163,2089,10
113552706725,113552706723,-2,1447,2298,10
113553245901,113553245898,-3,1206,1834,10
113553513430,113553513429,-1,1319,2392,10
113559304382,113559304380,-2,1331,1770,10
113559771914,113559771912,-2,1723,2675,10
113561383194,113561383192,-2,1281,1249,10
113562772868,113562772867,-1,1245,1784,10
113569011163,113569011162,-1,950,1785,10
113569286662,113569286658,-4,644,1515,10
113569672314,113569672334,20,623,1593,10
113569854802,113569854804,2,947,2033,10
113573123898,113573123898,0,1200,1374,10
113580642518,113580642517,-1,753,1733,10
113586254783,113586254788,5,2546,1486,10
113592615597,113592615597,0,1144,1527,10
113592976299,113592976298,-1,1022,1809,10
113595720698,113595720696,-2,2139,3222,10
113596604865,113596604865,0,2605,3926,10
113596740199,113596740198,-1,1099,1468,10
113598809885,113598809868,-17,2511,1058,10
113599768715,113599768709,-6,991,2482,10
113601484025,113601484023,-2,996,1081,10
113603784344,113603784338,-6,1269,1957,10
113604052089,113604052085,-4,952,2235,10
113608099329,113608099328,-1,1567,2165,10
113608582967,113608582966,-1,1306,2253,10
113612786102,113612786109,7,6427,2632,10
113620912867,113620912867,0,1434,2408,10
113621530377,113621530378,1,1380,1531,10
113623075430,113623075430,0,1356,1588,10
113623368350,113623368345,-5,2383,6494,10
113624192260,113624192258,-2,1067,1934,10
113628273467,113628273454,-13,1749,767,10
113629981422,113629981422,0,1049,2140,10
113631496787,113631496785,-2,1135,2077,10
113632123128,113632123127,-1,2031,3172,10
113640543791,113640543790,-1,1043,1935,10
113642190060,113642190061,1,1275,1698,10
113645880530,113645880541,11,17568,22210,10
113648171954,113648171957,3,1443,1295,10
113648227226,113648227245,19,903,3608,10
113650339649,113650339646,-3,1252,2056,10
113651827340,113651827338,-2,1189,1954,10
113652282383,113652282382,-1,1099,1514,10
113655316811,113655316806,-5,1131,2470,10
113656082358,113656082367,9,4456,1211,10
113657967549,113657967549,0,1125,2228,10
113658441342,113658441339,-3,1165,2002,10
113660023769,113660023765,-4,1324,1360,10
113660366770,113660366769,-1,1064,1890,10
113665454166,113665454165,-1,971,1724,10
113666182366,113666182364,-2,1232,2724,10
113676743606,113676743606,0,1087,1040,10
113679206547,113679206546,-1,1518,2271,10
113679356178,113679356175,-3,1278,2167,10
113679655151,113679655149,-2,772,1903,10
113680315182,113680315183,1,768,1457,10
113681120970,113681120970,0,990,1697,10
113681899473,113681899472,-1,1456,2269,10
113682433784,113682433783,-1,1337,1340,10
113683236134,113683236134,0,667,1382,10
113687275495,113687275494,-1,1193,1686,10
113689666870,113689666867,-3,1169,1691,10
113691679453,113691679453,0,1513,2276,10
113692493829,113692493826,-3,1161,2444,10
113694642313,113694642316,3,2462,2538,10
113695125764,113695125762,-2,1310,2124,10
113699242946,113699242945,-1,1327,1854,10
113701706354,113701706353,-1,788,1361,10
113703574358,113703574357,-1,1562,1943,10
113704806690,113704806689,-1,1068,2819,10
113706142232,113706142229,-3,1460,2215,10
113708071230,113708071223,-7,1290,4335,10
113708337719,113708337719,0,1077,1297,10
113710321714,113710321707,-7,1680,6586,10
113712254211,113712254211,0,1097,1168,10
113713025643,113713025642,-1,1225,1606,10
113714040099,113714040090,-9,278,923,10
113714724744,113714724733,-11,1254,2973,10
113715793287,113715793287,0,1329,1632,10
113716240811,113716240815,4,1895,1614,10
113716939234,113716939232,-2,754,1962,10
113719719279,113719719273,-6,797,3665,10
113720560992,113720560989,-3,1298,2170,10
113721138652,113721138652,0,1271,1650,10
113722618202,113722618199,-3,733,1505,10
113724004498,113724004490,-8,1041,1765,10
113725325174,113725325173,-1,982,1571,10
113736387066,113736387071,5,3476,1211,10
113739314263,113739314261,-2,1011,1595,10
113741315590,113741315590,0,952,1255,10
113741603750,113741603751,1,2632,2065,10
113743874174,113743874169,-5,1279,4372,10
113745478625,113745478623,-2,1393,2030,10
113746469818,113746469810,-8,1887,10650,10
113752411471,113752411471,0,1508,1732,10
113754325486,113754325485,-1,1178,1514,10
113762824962,113762824961,-1,1164,1521,10
113775469354,113775469354,0,982,1757,10
113776221310,113776221307,-3,1134,1987,10
113776530257,113776530252,-5,1309,2168,10
113776914353,113776914350,-3,1377,1819,10
113778652753,113778652749,-4,1430,2982,10
113779590209,113779590207,-2,1072,1684,10
113781339681,113781339680,-1,1360,2064,10
113783051951,113783051950,-1,1342,1595,10
113786529487,113786529474,-13,8778,38372,10
113791072727,113791072745,18,1667,2377,10
113792967900,113792967898,-2,1344,2609,10
113796344856,113796344855,-1,1388,2101,10
113797134601,113797134599,-2,1567,2403,10
113798438795,113798438793,-2,914,2147,10
113800256877,113800256877,0,1216,2120,10
113801935665,113801935663,-2,1346,1706,10
113805004301,113805004298,-3,1453,2075,10
113810846032,113810846026,-6,1319,2961,10
113812364063,113812364062,-1,1055,1582,10
113813196163,113813196159,-4,995,2654,10
113815430913,113815430911,-2,1501,2023,10
113821340496,113821340498,2,3424,3190,10
113824159323,113824159322,-1,1452,1888,10
113836484547,113836484545,-2,1761,2524,10
113842885805,113842885805,0,1197,2238,10
113843487289,113843487289,0,1346,2522,10
113845755001,113845755002,1,1118,1996,10
113848355676,113848355674,-2,1011,1637,10
113858871267,113858871265,-2,1104,1507,10
113860522870,113860522869,-1,2020,2377,10
113863132667,113863132665,-2,1296,1866,10
113869187797,113869187796,-1,2862,4588,10
113870009158,113870009157,-1,1330,1719,10
113870454793,113870454790,-3,1405,1991,10
113870589730,113870589730,0,1316,1848,10
113872174450,113872174451,1,1454,1593,10
113872511943,113872511938,-5,860,1917,10
113878990868,113878990865,-3,1108,2004,10
113880812314,113880812320,6,57900,19421,10
113883313471,113883313470,-1,1403,1623,10
113888230663,113888230661,-2,788,1151,10
113889423570,113889423567,-3,1809,2701,10
113891072642,113891072642,0,1417,2321,10
113891672401,113891672396,-5,830,1485,10
113891927173,113891927174,1,1284,2325,10
113895389087,113895389085,-2,1379,2316,10
113899377710,113899377714,4,2125,1676,10
113900834811,113900834819,8,959,1290,10
113902471515,113902471514,-1,1376,1507,10
113903311654,113903311650,-4,1067,1780,10
113905847449,113905847447,-2,1194,1713,10
113906409662,113906409661,-1,1478,2666,10
113915765595,113915765594,-1,733,1534,10
113923383506,113923383503,-3,886,1790,10
113926278650,113926278651,1,1290,1255,10
113926304970,113926304979,9,1308,1359,10
113930702474,113930702473,-1,1325,1153,10
113931151926,113931151926,0,1776,2651,10
113931577249,113931577247,-2,1068,1292,10
113932612597,113932612595,-2,1334,2786,10
113932696328,113932696328,0,1701,1978,10
113939133478,113939133479,1,1368,1594,10
113943028429,113943028428,-1,1034,1662,10
113944139871,113944139870,-1,1204,2037,10
113947057261,113947057260,-1,1042,2301,10
113947770713,113947770709,-4,500,607,10
113951951206,113951951199,-7,2852,7946,10
113953877550,113953877549,-1,904,1482,10
113954505657,113954505657,0,1208,1828,10
113954624666,113954624665,-1,1375,1681,10
113958514474,113958514473,-1,1303,2422,10
113959432762,113959432761,-1,1197,1311,10
113960348410,113960348407,-3,1277,1635,10
113961539135,113961539135,0,1369,2099,10
113961807208,113961807208,0,1436,2081,10
113962043460,113962043458,-2,1444,2235,10
113963351286,113963351283,-3,1392,1468,10
113966277550,113966277550,0,1624,1575,10
113970352258,113970352257,-1,1220,1820,10
113979435919,113979435915,-4,1228,2253,10
113986177763,113986177761,-2,1199,1711,10
113987134799,113987134798,-1,963,2031,10
113989137133,113989137134,1,1492,1244,10
113989693523,113989693522,-1,1517,2593,10
113989762192,113989762192,0,1802,1900,10
113990460628,113990460626,-2,1198,1298,10
113990819819,113990819818,-1,1063,2729,10
113991326513,113991326511,-2,1083,2138,10
113997758222,113997758222,0,1046,1904,10
113998011799,113998011798,-1,1400,2582,10
113999782545,113999782545,0,1165,1934,10
114005198587,114005198587,0,1138,1403,10
114006114943,114006114946,3,1498,1271,10
114006442896,114006442894,-2,989,1419,10
114007632300,114007632298,-2,1233,1925,10
114009349852,114009349849,-3,1674,1758,10
114011443938,114011443937,-1,1152,2029,10
114019925457,114019925456,-1,1415,2489,10
114020058915,114020058914,-1,1259,1998,10
114021246618,114021246617,-1,1148,2063,10
114026027530,114026027528,-2,1880,2261,10
114029786941,114029786940,-1,1077,2153,10
114030362948,114030362947,-1,1222,1489,10
114031175257,114031175259,2,2345,2211,10
114037131703,114037131701,-2,1396,2116,10
114038626057,114038626057,0,1049,1475,10
114041754741,114041754741,0,767,1170,10
114046238640,114046238637,-3,799,1684,10
114048188808,114048188806,-2,1628,3177,10
114048228043,114048228042,-1,1266,2067,10
114051011370,114051011362,-8,656,2452,10
114054035177,114054035175,-2,1188,2399,10
114062454676,114062454670,-6,1633,2031,10
114070291325,114070291324,-1,1585,2194,10
114074872758,114074872755,-3,886,1972,10
114076774874,114076774873,-1,1099,1487,10
114077573394,114077573393,-1,1124,2951,10
114079920342,114079920341,-1,1289,1988,10
114080592959,114080592958,-1,823,1197,10
114081611562,114081611561,-1,1477,2404,10
114088483691,114088483687,-4,1594,2862,10
114089641049,114089641045,-4,671,1808,10
114090101811,114090101809,-2,1222,2830,10
114092995555,114092995555,0,1727,2813,10
114093206539,114093206536,-3,1682,2328,10
114097160418,114097160430,12,11294,46513,10
114102112852,114102112849,-3,1543,2656,10
114105986734,114105986732,-2,1508,2637,10
114109202418,114109202421,3,959,1572,10
114109819518,114109819507,-11,1750,683,10
114112743822,114112743821,-1,1102,2135,10
114113243319,114113243318,-1,1255,2154,10
114114359891,114114359890,-1,952,1592,10
114117863148,114117863146,-2,997,1353,10
114118982169,114118982167,-2,958,1565,10
114119632853,114119632853,0,1522,1735,10
114122354414,114122354416,2,1192,987,10
114124884476,114124884474,-2,1088,1573,10
114127633355,114127633352,-3,1314,3295,10
114132177242,114132177240,-2,1009,1387,10
114134566856,114134566853,-3,1060,2038,10
114137029426,114137029426,0,1726,2462,10
114141306052,114141306050,-2,822,1440,10
114143480675,114143480674,-1,897,1484,10
114144752898,114144752897,-1,1010,2334,10
114145098571,114145098589,18,1180,1184,10
114146454981,114146454981,0,1509,1646,10
114149236141,114149236138,-3,853,1679,10
114150592520,114150592518,-2,1409,2023,10
114152731950,114152731950,0,1415,1965,10
114157447894,114157447891,-3,805,1388,10
114158720383,114158720382,-1,935,1942,10
114165069073,114165069073,0,1030,2381,10
114171415289,114171415285,-4,1169,2544,10
114175766630,114175766631,1,1290,1689,10
114179367809,114179367804,-5,892,2127,10
114179667418,114179667423,5,1507,821,10
114186430718,114186430717,-1,1358,1979,10
114187117923,114187117919,-4,892,1983,10
114190881886,114190881887,1,1082,1909,10
114191828663,114191828661,-2,1101,2581,10
114193516958,114193516958,0,1923,1244,10
114196183422,114196183422,0,908,1595,10
114198098427,114198098426,-1,1550,2633,10
114200433135,114200433134,-1,1173,1647,10
114201011327,114201011325,-2,1190,1897,10
114202437733,114202437713,-20,1452,2065,10
114204138170,114204138167,-3,874,1768,10
114206266174,114206266171,-3,1324,1885,10
114207506916,114207506913,-3,758,1294,10
114208485519,114208485516,-3,1197,1962,10
114214015554,114214015552,-2,836,1658,10
114216224791,114216224790,-1,1069,1166,10
114219475661,114219475660,-1,1079,1968,10
114222730779,114222730778,-1,21729,25682,10
114222830966,114222830964,-2,1736,1633,10
114227624803,114227624802,-1,1244,1714,10
114230262876,114230262874,-2,1430,2738,10
114233426866,114233426866,0,1023,1565,10
114233831147,114233831163,16,1075,1694,10
114234461898,114234461895,-3,907,1848,10
114234528976,114234528962,-14,993,1654,10
114235498763,114235498762,-1,1394,2242,10
114238862140,114238862139,-1,1181,1083,10
114241364520,114241364518,-2,1051,2475,10
114246346061,114246346063,2,1359,1692,10
114250055286,114250055287,1,1918,1795,10
114250114818,114250114818,0,1386,1543,10
114250897596,114250897601,5,2118,1357,10
114255532815,114255532814,-1,1279,1570,10
114258323098,114258323098,0,1349,2308,10
114261092107,114261092106,-1,1450,1414,10
114261135157,114261135154,-3,1362,1713,10
114262209318,114262209324,6,31812,54840,10
114262355791,114262355789,-2,1232,2117,10
114272720529,114272720528,-1,1481,2002,10
114276357634,114276357631,-3,597,1139,10
114278718774,114278718767,-7,1095,4127,10
114280076162,114280076170,8,3164,1644,10
114290210116,114290210116,0,1928,2131,10
114292384283,114292384282,-1,1119,1981,10
114295775343,114295775342,-1,1322,1714,10
114295843222,114295843221,-1,970,1506,10
114296508837,114296508834,-3,1394,2586,10
114299703085,114299703084,-1,1358,1682,10
114307158613,114307158612,-1,1314,1962,10
114308980170,114308980170,0,1817,2977,10
114312857759,114312857757,-2,1166,2006,10
114314811558,114314811557,-1,1316,1980,10
114322920286,114322920291,5,5611,2172,10
114324238306,114324238305,-1,762,1452,10
114324976531,114324976531,0,1166,1681,10
114325829433,114325829432,-1,1402,2618,10
114327851455,114327851455,0,1400,2257,10
114329971429,114329971429,0,762,1570,10
114331609922,114331609919,-3,1076,2433,10
114331652511,114331652510,-1,857,1103,10
114333326963,114333326962,-1,1279,1904,10
114334668230,114334668230,0,1689,1986,10
114334964535,114334964531,-4,1001,1526,10
114338505453,114338505450,-3,1066,2175,10
114339022198,114339022202,4,1284,1192,10
114346955739,114346955733,-6,1415,4107,10
114348299573,114348299572,-1,910,1826,10
114352691967,114352691966,-1,1014,1841,10
114353898766,114353898763,-3,1406,2881,10
114354240409,114354240408,-1,1201,2284,10
114355180334,114355180333,-1,1250,1600,10
114356272917,114356272917,0,1271,1749,10
114356526947,114356526946,-1,1336,2062,10
114356593146,114356593145,-1,1223,1937,10
114357930751,114357930750,-1,1522,2851,10
114361912693,114361912688,-5,1003,1868,10
114362412805,114362412804,-1,1132,3069,10
114365841968,114365841965,-3,862,2394,10
114371313869,114371313866,-3,838,1313,10
114371939846,114371939843,-3,576,563,10
114379925503,114379925501,-2,1397,2871,10
114381856202,114381856198,-4,1005,3656,10
114383497042,114383497042,0,1606,2000,10
114386204465,114386204463,-2,1352,2758,10
114387600192,114387600192,0,1789,2653,10
114387696535,114387696533,-2,1464,2619,10
114388070427,114388070427,0,1221,1518,10
114393371730,114393371729,-1,1547,1557,10
114397231977,114397231973,-4,838,1779,10
114399935926,114399935926,0,1301,2238,10
114400109352,114400109351,-1,885,1993,10
114404284394,114404284394,0,1167,1595,10
114405591932,114405591932,0,58,568,10
114407478184,114407478172,-12,927,1688,10
114409931675,114409931674,-1,591,1328,10
114411305394,114411305394,0,1106,1969,10
114412896662,114412896662,0,1042,1452,10
114424520735,114424520734,-1,1504,2533,10
114425327859,114425327857,-2,1833,3254,10
114425696030,114425696030,0,1336,1425,10
114430703848,114430703849,1,1644,1817,10
114430943994,114430943990,-4,1155,1905,10
114431100346,114431100342,-4,1257,1881,10
114432979394,114432979398,4,1267,1124,10
114438516576,114438516574,-2,819,1647,10
114440257129,114440257132,3,1359,1339,10
114442557596,114442557603,7,2785,1295,10
114444390455,114444390453,-2,1300,2284,10
114449279530,114449279530,0,1593,1656,10
114449664519,114449664525,6,12134,24353,10
114450054698,114450054697,-1,1746,2511,10
114451128240,114451128238,-2,1338,2684,10
114451270942,114451270941,-1,1483,1338,10
114456600319,114456600320,1,1433,1776,10
114457745849,114457745850,1,1107,1164,10
114465019516,114465019509,-7,1159,3920,10
114465978212,114465978206,-6,1241,2266,10
114470040172,114470040169,-3,1195,1399,10
114471054071,114471054070,-1,1192,1917,10
114471577358,114471577358,0,1227,1421,10
114474080545,114474080542,-3,1261,2012,10
114474355915,114474355914,-1,1400,2052,10
114475407020,114475407018,-2,1453,1543,10
114476925035,114476925036,1,1129,1836,10
114478692369,114478692369,0,1754,2786,10
114478912968,114478912966,-2,1202,1316,10
114481211074,114481211073,-1,880,2131,10
114484052650,114484052649,-1,1194,2515,10
114485851249,114485851249,0,1058,2058,10
114489353274,114489353273,-1,963,1721,10
114491570711,114491570711,0,1093,1773,10
114495356345,114495356343,-2,730,1176,10
114496494679,114496494676,-3,1178,2610,10
114498100229,114498100230,1,1066,2414,10
114498735256,114498735254,-2,765,1719,10
114503474574,114503474571,-3,909,1292,10
114504535978,114504535974,-4,1090,2663,10
114507630594,114507630591,-3,885,1401,10
114509105186,114509105185,-1,1134,1606,10
114514272442,114514272446,4,1066,1142,10
114515446101,114515446098,-3,1230,2904,10
114515703413,114515703412,-1,1428,1907,10
114523513981,114523513977,-4,1618,2433,10
114523865815,114523865817,2,1509,1595,10
114526999072,114526999073,1,1074,1513,10
114529177366,114529177365,-1,1012,2083,10
114530859302,114530859302,0,1340,2414,10
114532410868,114532410865,-3,1348,1833,10
114546593698,114546593698,0,758,1107,10
114557466818,114557466822,4,4126,2794,10
114558014578,114558014577,-1,1019,2703,10
114562876665,114562876665,0,1309,1480,10
114565035636,114565035634,-2,987,1981,10
114567944453,114567944450,-3,2200,3767,10
114571244332,114571244327,-5,1409,4933,10
114574098738,114574098739,1,1267,2345,10
114575840223,114575840214,-9,1357,2446,10
114576964829,114576964827,-2,1360,1766,10
114580805151,114580805151,0,1722,2795,10
114582617873,114582617871,-2,1174,2271,10
114587926074,114587926087,13,9426,42376,10
114592870833,114592870832,-1,1702,2589,10
114595234555,114595234554,-1,1126,1791,10
114595653985,114595653981,-4,1321,2371,10
114597297449,114597297447,-2,1457,2094,10
114601740425,114601740425,0,1589,1591,10
114602602483,114602602483,0,1264,1327,10
114607674462,114607674469,7,17028,18462,10
114611567426,114611567425,-1,827,1544,10
114612727070,114612727066,-4,972,2446,10
114616079109,114616079105,-4,1201,2369,10
114619432380,114619432377,-3,1252,2507,10
114621449617,114621449622,5,3013,1427,10
114623069000,114623068997,-3,769,1560,10
114625156463,114625156463,0,1463,1609,10
114625536945,114625536945,0,1453,2009,10
114630901447,114630901447,0,1528,1875,10
114632510761,114632510773,12,7486,45662,10
114633259474,114633259470,-4,1085,2394,10
114633368577,114633368577,0,1153,1289,10
114635481473,114635481473,0,943,1803,10
114637104062,114637104062,0,882,1863,10
114645978164,114645978161,-3,1659,3036,10
114647384402,114647384399,-3,858,1633,10
114648063596,114648063597,1,1625,2171,10
114649274299,114649274292,-7,1415,4400,10
114650224333,114650224332,-1,893,1014,10
114651125697,114651125696,-1,1384,2237,10
114651550762,114651550754,-8,269,804,10
114653226999,114653226998,-1,1265,1919,10
114653498357,114653498355,-2,1140,1259,10
114659006477,114659006477,0,1599,2143,10
114660523308,114660523306,-2,1339,2431,10
114661739248,114661739257,9,12035,32611,10
114662727862,114662727861,-1,987,1450,10
114663465907,114663465890,-17,1301,1995,10
114664267929,114664267929,0,1384,1646,10
114664666814,114664666812,-2,824,1820,10
114667224251,114667224250,-1,2010,1866,10
114667688738,114667688735,-3,1227,1383,10
114668399499,114668399499,0,1107,1619,10
114678239908,114678239906,-2,1153,1949,10
114680843374,114680843372,-2,1571,2501,10
114681013991,114681013990,-1,1570,2415,10
114686305098,114686305095,-3,1408,2591,10
114686359460,114686359477,17,765,1409,10
114686431398,114686431402,4,941,1095,10
114687679403,114687679400,-3,706,861,10
114688079651,114688079650,-1,1167,1912,10
114688867351,114688867351,0,1716,1892,10
114691338730,114691338730,0,1284,2356,10
114695126370,114695126369,-1,1124,1845,10
114697450042,114697450051,9,2802,880,10
114698934190,114698934189,-1,814,1772,10
114701147610,114701147609,-1,1010,1592,10
114709858714,114709858715,1,1338,1540,10
114712258435,114712258438,3,19351,35406,10
114713204490,114713204486,-4,1119,2367,10
114715395718,114715395716,-2,1027,1459,10
114716990687,114716990686,-1,1430,2732,10
114721088715,114721088714,-1,914,1846,10
114727636200,114727636197,-3,942,2131,10
114728944958,114728944955,-3,1693,2586,10
114729452137,114729452137,0,1176,2006,10
114729885385,114729885364,-21,1424,1107,10
114732269015,114732269013,-2,1181,1807,10
114732621106,114732621105,-1,1442,1389,10
114734610671,114734610670,-1,1052,1253,10
114738998368,114738998365,-3,1322,1682,10
114744490086,114744490086,0,1403,2197,10
114751285026,114751285025,-1,740,1323,10
114751729893,114751729893,0,954,2152,10
114755877770,114755877769,-1,935,1746,10
114757675265,114757675262,-3,20828,7440,10
114758750482,114758750479,-3,814,1608,10
114761201440,114761201439,-1,1245,2223,10
114765491795,114765491793,-2,1099,1743,10
114766574565,114766574563,-2,1234,2044,10
114767232834,114767232834,0,1144,1981,10
114771109450,114771109449,-1,1050,2229,10
114776245541,114776245539,-2,1351,2109,10
114776819522,114776819521,-1,1128,1692,10
114779653382,114779653389,7,7766,2854,10
114782510182,114782510163,-19,1311,1874,10
114786043074,114786043073,-1,1277,1824,10
114801127714,114801127717,3,2132,1972,10
114802873183,114802873181,-2,1527,2253,10
114803088327,114803088325,-2,1245,2194,10
114808538318,114808538317,-1,1088,2209,10
114809725918,114809725918,0,1578,1661,10
114811263370,114811263367,-3,1219,2301,10
114811472306,114811472311,5,1353,1045,10
114817441966,114817441966,0,1741,2039,10
114817557671,114817557669,-2,1533,1847,10
114819614341,114819614340,-1,1282,2176,10
114820636830,114820636829,-1,1345,1860,10
114823273790,114823273788,-2,1080,1040,10
114826975439,114826975438,-1,695,1168,10
114829574516,114829574513,-3,1908,2824,10
114830051300,114830051307,7,6042,2585,10
114830159033,114830159031,-2,1197,1796,10
114833032126,114833032126,0,836,2349,10
114834106065,114834106063,-2,1256,2052,10
114838324819,114838324818,-1,393,1277,10
114839696078,114839696073,-5,1346,5336,10
114841354566,114841354565,-1,1345,1567,10
114848886953,114848886948,-5,1032,2315,10
114849398708,114849398727,19,494,840,10
114853700310,114853700306,-4,1153,1976,10
114854968674,114854968674,0,1126,1358,10
114858157060,114858157066,6,4790,1724,10
114859541095,114859541092,-3,1539,2506,10
114861639314,114861639309,-5,617,1759,10
114868638946,114868638945,-1,1160,1817,10
114869964089,114869964086,-3,958,1685,10
114872447509,114872447506,-3,967,1481,10
114872745003,114872745003,0,1031,1413,10
114876930428,114876930427,-1,1644,2268,10
114878303300,114878303299,-1,1956,2573,10
114879131050,114879131052,2,1075,1477,10
114883772546,114883772549,3,1443,1612,10
114884991557,114884991555,-2,1258,1707,10
114885516168,114885516176,8,13464,23930,10
114893830792,114893830790,-2,1377,2031,10
114895761175,114895761174,-1,1194,2508,10
114899174266,114899174275,9,769,1141,10
114903974375,114903974376,1,1232,2334,10
114908238135,114908238134,-1,967,1812,10
114908870699,114908870714,15,177,1270,10
114909590486,114909590485,-1,1824,2373,10
114909650437,114909650434,-3,1312,1963,10
114916074626,114916074621,-5,1009,3038,10
114917555583,114917555582,-1,1428,1749,10
114919725749,114919725746,-3,1382,2822,10
114923874611,114923874607,-4,946,2359,10
114924330815,114924330812,-3,1217,3530,10
114925053629,114925053627,-2,1352,2528,10
114930711968,114930711961,-7,1295,2546,10
114931638377,114931638376,-1,1877,2356,10
114933083098,114933083098,0,1505,1571,10
114937013211,114937013208,-3,926,1415,10
114938075789,114938075786,-3,765,1622,10
114940213342,114940213339,-3,1163,2047,10
114940543940,114940543921,-19,325,713,10
114940886017,114940886014,-3,1999,4292,10
114943710579,114943710579,0,792,1267,10
114944394417,114944394416,-1,1068,1961,10
114946123378,114946123375,-3,1729,2903,10
114951535851,114951535850,-1,917,2121,10
114953131535,114953131534,-1,1593,1812,10
114960396823,114960396822,-1,917,1980,10
114967773322,114967773321,-1,1078,1968,10
114968632546,114968632566,20,1128,1881,10
114971570106,114971570105,-1,1790,1966,10
114975683300,114975683298,-2,1448,1995,10
114977736434,114977736432,-2,977,2164,10
114980255358,114980255358,0,985,2414,10
114984296264,114984296260,-4,1247,2144,10
114986591525,114986591525,0,1334,1514,10
114989918576,114989918574,-2,606,1026,10
114991013056,114991013055,-1,1009,1830,10
114992254273,114992254271,-2,1600,1698,10
114993549118,114993549118,0,945,2219,10
114995634902,114995634899,-3,1072,1487,10
114997375918,114997375916,-2,812,1545,10
114998356002,114998356000,-2,1553,1741,10
115001956251,115001956249,-2,693,1559,10
115002321896,115002321895,-1,1289,1742,10
115002400547,115002400541,-6,1426,1866,10
115003802822,115003802815,-7,2123,13016,10
115006739158,115006739157,-1,1854,1917,10
115008698983,115008698982,-1,1182,1650,10
115008955608,115008955592,-16,1316,1382,10
115011535810,115011535808,-2,1514,3247,10
115012325500,115012325499,-1,959,1566,10
115015050227,115015050227,0,924,1699,10
115024883341,115024883343,2,1119,1501,10
115024978883,115024978867,-16,1052,1515,10
115027370089,115027370088,-1,1166,1688,10
115027843863,115027843863,0,1239,1795,10
115028734258,115028734257,-1,872,1626,10
115028790165,115028790163,-2,1203,1508,10
115032054797,115032054796,-1,1361,2026,10
115032413666,115032413666,0,1142,2232,10
115035322597,115035322597,0,1608,1724,10
115035827282,115035827280,-2,848,1199,10
115039779053,115039779050,-3,1447,1462,10
115040359953,115040359952,-1,1336,2180,10
115043053804,115043053802,-2,711,1561,10
115044238138,115044238134,-4,1241,2317,10
115048031669,115048031666,-3,1000,2151,10
115049754872,115049754868,-4,1353,2445,10
115050289256,115050289251,-5,1067,2471,10
115050577291,115050577287,-4,1030,1581,10
115053181300,115053181303,3,2020,1339,10
115054972929,115054972927,-2,814,1990,10
115055338527,115055338526,-1,879,2059,10
115056549279,115056549278,-1,1290,1856,10
115057113054,115057113054,0,1068,2505,10
115057645410,115057645406,-4,963,2637,10
115059999054,115059999045,-9,756,2591,10
115061801893,115061801899,6,2666,1256,10
115063412833,115063412834,1,1545,2675,10
115064761693,115064761693,0,1533,1617,10
115064904202,115064904202,0,1238,1266,10
115068727559,115068727558,-1,823,2093,10
115071369258,115071369257,-1,1176,2527,10
115072639283,115072639275,-8,767,2441,10
115074316987,115074316982,-5,1180,2645,10
115075638251,115075638250,-1,1074,2008,10
115076569509,115076569506,-3,1611,2060,10
115077281662,115077281661,-1,1174,2090,10
115082547463,115082547463,0,1181,2451,10
115091903357,115091903356,-1,1137,1756,10
115093863438,115093863438,0,979,523,10
115094825223,115094825222,-1,1305,1819,10
115095714468,115095714468,0,1077,1544,10
115106069330,115106069331,1,1330,1414,10
115107109342,115107109340,-2,1198,1820,10
115109284187,115109284186,-1,1450,2508,10
115115533490,115115533487,-3,1796,1625,10
115117911476,115117911479,3,1351,1419,10
115125438706,115125438705,-1,1340,1662,10
115127386231,115127386229,-2,1394,2902,10
115128806999,115128806998,-1,1167,1799,10
115129395517,115129395518,1,999,1364,10
115132311199,115132311196,-3,1260,1935,10
115136903048,115136903046,-2,1261,2974,10
115142965213,115142965211,-2,926,1497,10
115148098454,115148098453,-1,856,1728,10
115148228862,115148228859,-3,1519,2132,10
115154480742,115154480741,-1,866,1439,10
115156020078,115156020077,-1,968,1798,10
115156233410,115156233410,0,814,1723,10
115163704231,115163704228,-3,1570,1545,10
115170074518,115170074521,3,1509,1672,10
115170146430,115170146428,-2,1313,1829,10
115173064948,115173064945,-3,1137,2297,10
115173722270,115173722264,-6,2573,7711,10
115174004814,115174004814,0,1454,2517,10
115175587311,115175587310,-1,1030,1476,10
115178187001,115178187003,2,2361,1193,10
115181469542,115181469558,16,948,1722,10
115183125454,115183125452,-2,1094,2192,10
115187272875,115187272875,0,1704,2203,10
115189439327,115189439325,-2,1325,2001,10
115191034646,115191034645,-1,1273,2760,10
115193152706,115193152705,-1,945,1615,10
115200899885,115200899884,-1,1214,2080,10
115204269103,115204269100,-3,1024,2220,10
115204829150,115204829148,-2,1631,2842,10
115205318399,115205318399,0,1181,1855,10
115205846058,115205846078,20,806,2942,10
115209255701,115209255702,1,1097,1988,10
115214372864,115214372869,5,2140,1454,10
115224267982,115224267979,-3,1150,1874,10
115235809837,115235809834,-3,1194,2398,10
115237287113,115237287114,1,1997,2223,10
115238596298,115238596297,-1,1337,2018,10
115242531383,115242531378,-5,1025,2546,10
115244618308,115244618306,-2,1190,2449,10
115246411536,115246411534,-2,1337,1972,10
115246673513,115246673510,-3,1868,2410,10
115247043411,115247043410,-1,1344,2594,10
115247366942,115247366940,-2,1143,1975,10
115249142875,115249142876,1,1979,2875,10
115255930198,115255930197,-1,1549,2655,10
115257977665,115257977670,5,5635,2762,10
115258690010,115258690009,-1,1148,2218,10
115261240036,115261240037,1,1347,1884,10
115265296267,115265296262,-5,1353,2741,10
115268783128,115268783125,-3,1273,2308,10
115271964497,115271964495,-2,1311,2178,10
115275519614,115275519614,0,1045,2205,10
115280852382,115280852378,-4,888,992,10
115281787743,115281787723,-20,1065,1706,10
115283593593,115283593596,3,3043,2697,10
115283862319,115283862318,-1,1255,1726,10
115287518658,115287518658,0,1222,2063,10
115290106052,115290106050,-2,1702,2245,10
115291860956,115291860954,-2,1397,2033,10
115292881890,115292881911,21,1002,1373,10
115299155520,115299155518,-2,1707,2370,10
115299761940,115299761945,5,3568,1912,10
115299928882,115299928882,0,1304,2127,10
115302564274,115302564274,0,1190,1686,10
115306154681,115306154681,0,1587,1817,10
115307333998,115307333998,0,909,1668,10
115308908666,115308908664,-2,1269,2110,10
115313464789,115313464789,0,1646,2235,10
115316189810,115316189810,0,1682,1740,10
115316550141,115316550140,-1,1328,2313,10
115318066520,115318066518,-2,1344,2218,10
115318550965,115318550962,-3,1401,2426,10
115320431869,115320431869,0,1400,2772,10
115322092241,115322092238,-3,1588,2135,10
115323211107,115323211106,-1,801,1038,10
115325668644,115325668662,18,1162,1786,10
115326313682,115326313679,-3,1171,1677,10
115326538937,115326538937,0,1038,1696,10
115328434258,115328434258,0,1113,1608,10
115334747950,115334747950,0,790,1225,10
115339717855,115339717835,-20,670,427,10
115339963794,115339963793,-1,1239,1763,10
115341136590,115341136590,0,1501,2325,10
115341416355,115341416359,4,2271,1409,10
115349683105,115349683110,5,2999,1442,10
115351541869,115351541866,-3,1602,1728,10
115356402009,115356402007,-2,1510,2293,10
115357126871,115357126870,-1,1105,2259,10
115360994602,115360994594,-8,2247,13908,10
115362244917,115362244916,-1,812,1848,10
115364423593,115364423582,-11,1155,2361,10
115366145750,115366145751,1,1387,1222,10
115369242345,115369242341,-4,1175,1337,10
115372158139,115372158141,2,1371,1147,10
115373405351,115373405349,-2,929,1985,10
115373920854,115373920854,0,1446,1871,10
115379115530,115379115529,-1,1293,2214,10
115380700308,115380700305,-3,1074,1897,10
115381513306,115381513302,-4,858,3218,10
115384013446,115384013447,1,1259,1931,10
115385092970,115385092967,-3,1590,2825,10
115392407338,115392407336,-2,997,1257,10
115393236958,115393236957,-1,1210,1854,10
115394726503,115394726502,-1,1719,2598,10
115404857026,115404857026,0,1358,2499,10
115407168118,115407168118,0,1803,2699,10
115407524711,115407524709,-2,1209,2073,10
115409208619,115409208621,2,1523,1618,10
115424606191,115424606191,0,1220,1276,10
115426333696,115426333694,-2,1067,2145,10
115431623911,115431623911,0,1368,3136,10
115435413949,115435413948,-1,1161,2426,10
115438735038,115438735038,0,1367,1552,10
115439695989,115439695987,-2,626,1503,10
115440271628,115440271647,19,1552,2037,10
115442155270,115442155269,-1,1502,2293,10
115447294945,115447294942,-3,1339,1588,10
115448362079,115448362077,-2,1341,2777,10
115451401898,115451401898,0,1610,2189,10
115451997606,115451997608,2,2145,1717,10
115452628243,115452628241,-2,1263,1718,10
115454356227,115454356227,0,1482,2793,10
115455061730,115455061730,0,1154,1705,10
115459514577,115459514579,2,804,1006,10
115461374286,115461374285,-1,928,1791,10
115462224843,115462224842,-1,839,1672,10
115462282660,115462282679,19,728,1510,10
115464953079,115464953079,0,1466,2138,10
115466955711,115466955707,-4,1009,3294,10
115469645390,115469645389,-1,1373,1489,10
115480771742,115480771742,0,1263,1665,10
115482983307,115482983307,0,1199,2067,10
115483735740,115483735746,6,1305,1007,10
115491086579,115491086578,-1,1301,1673,10
115492019661,115492019660,-1,1209,1478,10
115497636153,115497636150,-3,1233,2522,10
115499250866,115499250866,0,1305,2291,10
115502424734,115502424730,-4,1328,1851,10
115504314483,115504314483,0,984,1782,10
115507800181,115507800182,1,1275,1366,10
115514735686,115514735687,1,1303,1048,10
115518688575,115518688576,1,943,2002,10
115525204499,115525204501,2,5470,5120,10
115527454453,115527454452,-1,899,1427,10
115535184146,115535184145,-1,1375,2211,10
115540490713,115540490708,-5,1264,2667,10
115540966027,115540966030,3,3206,2536,10
115541017727,115541017721,-6,1715,4397,10
115542319047,115542319045,-2,1316,1594,10
115545142132,115545142130,-2,948,1729,10
115554107131,115554107129,-2,1406,2105,10
115555310522,115555310521,-1,1450,1989,10
115556044109,115556044102,-7,1639,7737,10
115556910962,115556910959,-3,1313,2628,10
115560601377,115560601375,-2,1554,1931,10
115563794231,115563794249,18,306,1362,10
115565444677,115565444683,6,2518,814,10
115570885467,115570885467,0,890,1162,10
115573632082,115573632082,0,29082,21306,10
115576683820,115576683818,-2,977,1678,10
115578478564,115578478564,0,707,2389,10
115579048923,115579048902,-21,1557,3370,10
115580847556,115580847558,2,1507,1718,10
115583104741,115583104738,-3,992,1636,10
115585527256,115585527255,-1,1353,2139,10
115585585523,115585585522,-1,1285,2054,10
115585787434,115585787435,1,1283,2227,10
115587975698,115587975697,-1,1778,2497,10
115591101591,115591101590,-1,1359,2248,10
115592892746,115592892746,0,1101,1664,10
115595382433,115595382429,-4,1275,2884,10
115596978983,115596978981,-2,994,1550,10
115598487263,115598487262,-1,1033,1712,10
115600559721,115600559719,-2,1191,1612,10
115602637143,115602637143,0,1524,1684,10
115615188592,115615188587,-5,1129,1698,10
115615711000,115615710995,-5,149,597,10
115617546375,115617546374,-1,781,1837,10
115619531953,115619531951,-2,1114,1492,10
115621896616,115621896612,-4,1142,2726,10
115623087043,115623087042,-1,932,1214,10
115629264729,115629264729,0,1454,1852,10
115630892513,115630892510,-3,1334,1976,10
115633618651,115633618650,-1,806,2138,10
115634405557,115634405558,1,1210,1607,10
115636466434,115636466450,16,999,2241,10
115638325872,115638325871,-1,1337,1381,10
115642178033,115642178030,-3,1202,2257,10
115643434917,115643434918,1,1150,1741,10
115643527117,115643527124,7,3717,1297,10
115647633204,115647633202,-2,1064,1650,10
115651177078,115651177078,0,602,1131,10
115652060323,115652060323,0,1164,1639,10
115655609888,115655609883,-5,1324,1976,10
115659086449,115659086446,-3,870,1043,10
115661727268,115661727266,-2,1933,4304,10
115665987683,115665987682,-1,1503,2138,10
115667520782,115667520782,0,1333,1793,10
115670872194,115670872193,-1,1351,2187,10
115670941647,115670941649,2,1641,2271,10
115673744061,115673744062,1,800,1281,10
115675850643,115675850643,0,1189,2282,10
115676070815,115676070813,-2,1478,2833,10
115678601277,115678601276,-1,897,2268,10
115684113095,115684113097,2,654,601,10
115685607673,115685607670,-3,1367,2054,10
115689430922,115689430922,0,1660,2569,10
115690381403,115690381403,0,1333,976,10
115698687697,115698687695,-2,1430,2470,10
115703682883,115703682886,3,5739,4094,10
115709093952,115709093952,0,1675,2278,10
115709594135,115709594133,-2,1408,2311,10
115725322339,115725322338,-1,1223,2309,10
115730007613,115730007613,0,1250,1496,10
115733185373,115733185375,2,1468,1481,10
115736659381,115736659386,5,1693,1235,10
115738456076,115738456079,3,2624,1581,10
115738733386,115738733385,-1,915,1506,10
115741376187,115741376185,-2,940,975,10
115741543902,115741543903,1,1125,1381,10
115750345238,115750345237,-1,746,1142,10
115750631669,115750631666,-3,1229,2473,10
115752375837,115752375834,-3,1199,1729,10
115759742179,115759742180,1,1050,1743,10
115763068978,115763068981,3,1285,1823,10
115764481570,115764481568,-2,741,1190,10
115768575639,115768575638,-1,1779,2307,10
115771407078,115771407075,-3,1273,2602,10
115771767221,115771767220,-1,1324,1359,10
115772373816,115772373817,1,1538,2102,10
115773143530,115773143526,-4,971,1495,10
115777403271,115777403269,-2,1249,1396,10
115778496307,115778496311,4,965,1994,10
115788971350,115788971349,-1,1460,2097,10
115790067360,115790067356,-4,1025,2209,10
115790279883,115790279871,-12,987,1669,10
115791746061,115791746068,7,1207,934,10
115798292812,115798292812,0,1056,1905,10
115798968763,115798968761,-2,1216,1744,10
115799141861,115799141860,-1,1124,2431,10
115799920231,115799920229,-2,1481,2550,10
115802831855,115802831857,2,1508,2014,10
115806014206,115806014202,-4,1084,2002,10
115807961254,115807961253,-1,953,1872,10
115809450133,115809450132,-1,1208,2066,10
115810538126,115810538126,0,1121,1415,10
115816732255,115816732254,-1,1540,1763,10
115817399538,115817399538,0,1014,2695,10
115817871051,115817871050,-1,827,2016,10
115818344479,115818344478,-1,1214,1827,10
115821835846,115821835846,0,1817,1890,10
115835033889,115835033886,-3,1114,2780,10
115837718974,115837718979,5,1072,841,10
115840221053,115840221053,0,1465,1901,10
115842802666,115842802664,-2,1487,2533,10
115854091706,115854091706,0,1173,1805,10
115856656582,115856656580,-2,1110,1462,10
115859447683,115859447689,6,970,1638,10
115864446031,115864446028,-3,833,1655,10
115866475187,115866475186,-1,1077,1957,10
115868902014,115868902017,3,1597,1947,10
115871523839,115871523838,-1,1215,1027,10
115873605917,115873605915,-2,925,1563,10
115874516306,115874516311,5,5621,2516,10
115875271511,115875271509,-2,1421,2074,10
115878639722,115878639721,-1,1314,1508,10
115879028278,115879028278,0,1723,2248,10
115880606955,115880606953,-2,977,2161,10
115895787346,115895787344,-2,1443,3341,10
115898484658,115898484658,0,1204,2097,10
115907643550,115907643550,0,1003,1857,10
115911714183,115911714184,1,1680,2091,10
115914025766,115914025764,-2,1178,1736,10
115917684044,115917684039,-5,2085,4540,10
115923211986,115923211978,-8,1464,4859,10
115923406423,115923406422,-1,1055,1992,10
115930095294,115930095294,0,988,1151,10
115931900369,115931900367,-2,1494,1628,10
115935344422,115935344426,4,2018,1152,10
115935866142,115935866140,-2,1657,3147,10
115942154703,115942154701,-2,1532,2559,10
115942762766,115942762766,0,1579,1974,10
115944000150,115944000149,-1,1290,2011,10
115944212812,115944212810,-2,1504,2260,10
115945484908,115945484907,-1,1911,2537,10
115947046499,115947046497,-2,961,1857,10
115955097531,115955097530,-1,1480,2000,10
115955524757,115955524755,-2,698,1550,10
115958518895,115958518896,1,2078,1240,10
115960328925,115960328923,-2,1324,2059,10
115962416223,115962416224,1,936,1345,10
115962686972,115962686969,-3,827,1342,10
115962946055,115962946061,6,4098,1421,10
115964132395,115964132394,-1,1343,2249,10
115964827010,115964827010,0,1876,2087,10
115967072509,115967072506,-3,1025,2449,10
115968944149,115968944148,-1,1119,1344,10
115971843508,115971843506,-2,1140,1713,10
115972231529,115972231529,0,1175,1867,10
115973076251,115973076248,-3,1764,2802,10
115973250642,115973250643,1,892,1935,10
115975143304,115975143302,-2,1287,1971,10
115975579685,115975579682,-3,1338,2297,10
115977915319,115977915321,2,1508,1680,10
115979159694,115979159699,5,1821,1352,10
115983940466,115983940464,-2,1362,2164,10
115989610282,115989610281,-1,1173,2259,10
115989892649,115989892649,0,1534,2073,10
115991550097,115991550098,1,1036,1197,10
115995223926,115995223926,0,1043,1876,10
115995811645,115995811645,0,1161,2405,10
116000791437,116000791436,-1,1352,2323,10
116001139793,116001139779,-14,142,1333,10
116008103340,116008103337,-3,309,1568,10
116013292829,116013292829,0,1201,1806,10
116017092997,116017092995,-2,931,2208,10
116020168885,116020168882,-3,1322,2064,10
116021844142,116021844141,-1,1175,1767,10
116023894279,116023894281,2,2304,1973,10
116024751828,116024751826,-2,1714,2236,10
116025563883,116025563881,-2,1194,1837,10
116026457819,116026457818,-1,1204,1737,10
116026741816,116026741816,0,11160,16478,10
116028910967,116028910965,-2,1218,2117,10
116030091782,116030091779,-3,1220,2263,10
116034195965,116034195963,-2,1446,1625,10
116034658117,116034658116,-1,1280,2153,10
116036622767,116036622748,-19,1036,1800,10
116038622612,116038622612,0,3933,4074,10
116039895793,116039895801,8,3127,1396,10
116043032071,116043032070,-1,967,2101,10
116044567670,116044567666,-4,1380,2420,10
116048030763,116048030765,2,1139,1276,10
116049316983,116049316979,-4,805,1806,10
116056705446,116056705445,-1,1019,1708,10
116057520065,116057520070,5,2152,1453,10
116058034758,116058034764,6,1108,1818,10
116059255143,116059255141,-2,989,1401,10
116060530227,116060530234,7,9662,28484,10
116062137313,116062137310,-3,1552,2571,10
116062509385,116062509371,-14,1105,2635,10
116065420983,116065420983,0,930,1585,10
116066124109,116066124106,-3,1349,2708,10
116066210878,116066210877,-1,766,2410,10
116070214417,116070214418,1,682,1659,10
116077717845,116077717840,-5,1034,3068,10
116079445666,116079445668,2,1829,1625,10
116081479068,116081479066,-2,985,2195,10
116083094094,116083094092,-2,987,1742,10
116087511826,116087511825,-1,1342,1403,10
116095611701,116095611700,-1,1237,2095,10
116095842073,116095842091,18,1493,2900,10
116100829447,116100829445,-2,1203,2419,10
116103691834,116103691834,0,1161,1489,10
116104983730,116104983728,-2,988,1769,10
116105097755,116105097734,-21,1618,2453,10
116106231769,116106231768,-1,1155,1894,10
116109412871,116109412870,-1,829,1386,10
116109700195,116109700190,-5,967,2398,10
116110411470,116110411469,-1,1021,2011,10
116120003650,116120003651,1,806,1696,10
116121212746,116121212745,-1,1207,2317,10
116122738598,116122738598,0,770,1666,10
116124634671,116124634669,-2,1234,2144,10
116126480335,116126480336,1,1434,2109,10
116127920707,116127920706,-1,1322,1683,10
116128288423,116128288422,-1,1322,2683,10
116128997377,116128997373,-4,1181,1919,10
116131037927,116131037925,-2,853,2193,10
116132889337,116132889334,-3,1379,1653,10
116135010299,116135010296,-3,1400,1747,10
116138613187,116138613183,-4,1205,1718,10
116139505653,116139505657,4,1137,717,10
116141492393,116141492390,-3,1316,2448,10
116143604354,116143604353,-1,1434,2353,10
116144538397,116144538400,3,1474,1581,10
116149501077,116149501076,-1,1261,1545,10
116153643582,116153643580,-2,1303,1894,10
116157039455,116157039455,0,1430,1874,10
116160265099,116160265097,-2,1606,2176,10
116161304102,116161304100,-2,1038,1789,10
116165723798,116165723794,-4,1188,1928,10
116172507280,116172507278,-2,1188,1919,10
116175951658,116175951653,-5,1137,1922,10
116176785478,116176785475,-3,1288,1481,10
116178326438,116178326435,-3,1188,1858,10
116180210242,116180210240,-2,1219,2942,10
116186571881,116186571881,0,1057,1690,10
116189231437,116189231430,-7,1224,5354,10
116190930618,116190930617,-1,900,1276,10
116194689318,116194689317,-1,1642,1740,10
116195653011,116195653009,-2,1550,2450,10
116198732092,116198732091,-1,1080,1763,10
116200384190,116200384186,-4,1219,2333,10
116201589318,116201589317,-1,1128,1626,10
116216467753,116216467751,-2,1225,2194,10
116219169589,116219169587,-2,1568,2459,10
116224071302,116224071299,-3,1305,2324,10
116225388790,116225388788,-2,1579,2009,10
116230185809,116230185796,-13,989,1146,10
116231128348,116231128346,-2,1047,1765,10
116231948504,116231948520,16,1291,2069,10
116233915354,116233915355,1,1137,973,10
116237706494,116237706492,-2,1653,2023,10
116237833977,116237833974,-3,944,1168,10
116240653493,116240653491,-2,1158,2007,10
116242355649,116242355646,-3,990,1359,10
116248117298,116248117297,-1,1275,1383,10
116251246605,116251246606,1,1551,1970,10
116254017227,116254017227,0,1103,1672,10
116256158798,116256158795,-3,1350,1848,10
116262115690,116262115689,-1,1682,2287,10
116263306455,116263306453,-2,1214,2126,10
116265920934,116265920933,-1,875,2350,10
116266785002,116266784998,-4,1445,4162,10
116269103126,116269103124,-2,977,1487,10
116271014330,116271014330,0,1143,1706,10
116272283610,116272283609,-1,1784,2748,10
116274911909,116274911908,-1,1534,2567,10
116275353371,116275353369,-2,1445,1912,10
116276510235,116276510235,0,339,1374,10
116282260088,116282260084,-4,796,1638,10
116286760377,116286760375,-2,1491,2226,10
116288747173,116288747171,-2,1689,1192,10
116289262896,116289262899,3,1880,1205,10
116289518192,116289518191,-1,1183,1631,10
116292832198,116292832197,-1,1046,1282,10
116294963786,116294963785,-1,2907,2523,10
116297409828,116297409822,-6,808,1718,10
116298908000,116298907998,-2,998,1865,10
116300148849,116300148846,-3,1540,1881,10
116300597807,116300597805,-2,1408,2202,10
116302224495,116302224493,-2,1156,1669,10
116310482635,116310482634,-1,1238,1825,10
116311134165,116311134165,0,36988,53442,10
116312079239,116312079238,-1,941,1543,10
116314749683,116314749681,-2,1114,2056,10
116316907012,116316907009,-3,1223,1853,10
116320603946,116320603946,0,1076,1229,10
116323832084,116323832065,-19,898,2147,10
116324410108,116324410106,-2,1139,1907,10
116324871747,116324871734,-13,1158,2167,10
116325865118,116325865116,-2,1136,1906,10
116332060249,116332060247,-2,1354,1883,10
116334134658,116334134657,-1,968,1261,10
116336021030,116336021027,-3,1105,2341,10
116342037117,116342037115,-2,1124,1768,10
116343970851,116343970850,-1,1005,1624,10
116345591869,116345591850,-19,1090,583,10
116348033107,116348033107,0,1381,2495,10
116348972954,116348972952,-2,983,1689,10
116349992953,116349992951,-2,1320,2580,10
116350813800,116350813798,-2,1083,1836,10
116352707718,116352707718,0,1372,1829,10
116353663031,116353663033,2,2713,3148,10
116356875286,116356875287,1,1224,1217,10
116359331746,116359331742,-4,1342,2412,10
116362892870,116362892869,-1,1162,2735,10
116363719559,116363719554,-5,768,2314,10
116366326974,116366326974,0,1179,1764,10
116369302618,116369302616,-2,1365,2036,10
116370564462,116370564456,-6,2708,8082,10
116370694546,116370694543,-3,1376,2692,10
116373749007,116373749011,4,1542,1375,10
116374978022,116374978021,-1,1420,2238,10
116375681270,116375681270,0,2020,2561,10
116377022331,116377022331,0,935,1676,10
116379163166,116379163162,-4,1539,2268,10
116379234034,116379234033,-1,1746,3435,10
116379535954,116379535953,-1,853,2177,10
116382816582,116382816580,-2,1230,2289,10
116383580082,116383580082,0,1280,1716,10
116387665338,116387665337,-1,1285,1961,10
116389668398,116389668398,0,1280,1709,10
116390401542,116390401542,0,1031,1877,10
116395897128,116395897126,-2,1853,1876,10
116396674980,116396674980,0,1599,2394,10
116398361688,116398361696,8,1541,1123,10
116398696463,116398696462,-1,1113,2658,10
116399238218,116399238217,-1,1695,2476,10
116402574287,116402574285,-2,738,1518,10
116403171954,116403171954,0,1015,1652,10
116406947800,116406947797,-3,1402,2812,10
116416181060,116416181045,-15,1159,2479,10
116416282136,116416282147,11,14083,33133,10
116417153354,116417153350,-4,1254,1995,10
116418729891,116418729891,0,1193,1432,10
116419815593,116419815592,-1,1023,1509,10
116421339490,116421339488,-2,1662,2796,10
116429227687,116429227685,-2,1569,1822,10
116432010347,116432010346,-1,905,2138,10
116432560037,116432560033,-4,1348,3037,10
116434193260,116434193257,-3,735,1996,10
116434734682,116434734681,-1,1546,2338,10
116437430654,116437430653,-1,1311,1829,10
116437976155,116437976153,-2,1314,2075,10
116442492994,116442492990,-4,1350,2295,10
116442928138,116442928158,20,1407,2298,10
116443980223,116443980221,-2,956,1579,10
116444633499,116444633498,-1,888,1728,10
116447066023,116447066021,-2,1145,2269,10
116447761899,116447761899,0,1140,1929,10
116454440805,116454440802,-3,1070,1882,10
116455891242,116455891244,2,2052,1578,10
116458944715,116458944714,-1,1089,1247,10
116460901567,116460901566,-1,1220,1869,10
116461795350,116461795353,3,3339,3244,10
116463493509,116463493515,6,4717,1872,10
116467824552,116467824551,-1,1221,2306,10
116468953405,116468953405,0,1398,2547,10
116471489568,116471489566,-2,1183,2029,10
116475591405,116475591419,14,1216,2094,10
116478250393,116478250392,-1,907,2435,10
116481107489,116481107488,-1,1127,1987,10
116483099572,116483099569,-3,1699,4415,10
116483376189,116483376187,-2,1137,2138,10
116483650194,116483650188,-6,995,1494,10
116489677013,116489677012,-1,1476,2354,10
116494273298,116494273299,1,1131,1850,10
116495026494,116495026490,-4,1645,1835,10
116496214147,116496214146,-1,1561,1755,10
116500630741,116500630738,-3,1919,3961,10
116500864318,116500864318,0,1147,1450,10
116501076358,116501076357,-1,1983,2789,10
116503077980,116503077978,-2,1720,2391,10
116503413185,116503413177,-8,1571,1645,10
116509047450,116509047449,-1,1213,2072,10
116512721820,116512721819,-1,1226,1797,10
116515133137,116515133135,-2,812,1393,10
116517333990,116517333987,-3,1344,1798,10
116517652934,116517652930,-4,1235,2182,10
116522951502,116522951500,-2,1123,2811,10
116525863340,116525863337,-3,1235,1736,10
116530714752,116530714750,-2,872,1804,10
116535966702,116535966701,-1,1492,1552,10
116536562524,116536562525,1,1694,2388,10
116539309447,116539309445,-2,1031,1770,10
116540349246,116540349242,-4,1585,5784,10
116542093974,116542093974,0,1129,2136,10
116542349954,116542349951,-3,1200,1698,10
116543309018,116543309017,-1,954,1744,10
116543689190,116543689198,8,4217,1374,10
116546508379,116546508377,-2,1175,1218,10
116550763839,116550763838,-1,1219,2129,10
116558672734,116558672734,0,1302,1983,10
116559332437,116559332441,4,1524,1172,10
116559764421,116559764421,0,1592,2381,10
116562420466,116562420463,-3,1254,1973,10
116563436934,116563436934,0,1561,2693,10
116565049516,116565049513,-3,2316,3138,10
116566888841,116566888842,1,1022,1928,10
116574082835,116574082832,-3,922,2620,10
116576272273,116576272269,-4,1625,4401,10
116589071417,116589071413,-4,1472,2063,10
116589136448,116589136445,-3,1446,3211,10
116593521986,116593521986,0,1293,1644,10
116594416158,116594416155,-3,1067,2125,10
116594522897,116594522897,0,1093,1508,10
116595260274,116595260273,-1,1103,2049,10
116596946359,116596946358,-1,807,1622,10
116604181787,116604181782,-5,1767,2342,10
116606079739,116606079738,-1,1392,2385,10
116608217033,116608217031,-2,1563,1883,10
116608664771,116608664771,0,1074,1653,10
116610268381,116610268379,-2,1003,1780,10
116611043370,116611043368,-2,1402,1823,10
116616300366,116616300366,0,1083,1430,10
116618462773,116618462769,-4,582,227,10
116618918170,116618918170,0,1148,2234,10
116618998515,116618998515,0,937,2003,10
116619225970,116619225969,-1,1422,1614,10
116621336524,116621336521,-3,452,1322,10
116621798974,116621798972,-2,1279,2502,10
116622406443,116622406441,-2,1359,2028,10
116622918658,116622918657,-1,863,1387,10
116623348696,116623348694,-2,1240,2170,10
116623653460,116623653461,1,1649,1884,10
116626403815,116626403812,-3,1159,1289,10
116627900870,116627900868,-2,1418,1492,10
116628198542,116628198538,-4,1261,1965,10
116630479618,116630479614,-4,850,2036,10
116631229258,116631229270,12,291,766,10
116636877510,116636877509,-1,1155,2206,10
116638099991,116638099986,-5,1206,2564,10
116641222985,116641222982,-3,1446,3013,10
116641551545,116641551544,-1,1345,2052,10
116658103431,116658103430,-1,1312,1670,10
116661854710,116661854710,0,884,2245,10
116668099439,116668099438,-1,1159,1894,10
116668716171,116668716171,0,1150,1384,10
116672016627,116672016625,-2,1366,1612,10
116672872079,116672872078,-1,1308,1077,10
116676590688,116676590686,-2,2106,3424,10
116677405192,116677405188,-4,1270,2464,10
116677667077,116677667075,-2,1064,1773,10
116677759114,116677759099,-15,1826,2640,10
116679775511,116679775510,-1,1208,2726,10
116680273786,116680273793,7,11789,24040,10
116681217422,116681217421,-1,1587,2181,10
116681482657,116681482656,-1,780,2104,10
116681544752,116681544750,-2,1285,2008,10
116682052606,116682052605,-1,1078,2113,10
116682841560,116682841558,-2,1041,2932,10
116683729829,116683729827,-2,1157,2032,10
116685448317,116685448315,-2,1698,2161,10
116687828925,116687828921,-4,1061,2587,10
116688067132,116688067137,5,1994,1220,10
116689612079,116689612078,-1,1023,2342,10
116690697158,116690697162,4,1795,1400,10
116693409089,116693409087,-2,1586,2301,10
116694444219,116694444217,-2,1301,1918,10
116701166939,116701166938,-1,1669,2710,10
116704795454,116704795450,-4,1075,1569,10
116706485686,116706485685,-1,844,1993,10
116709794448,116709794448,0,1541,2208,10
116710138342,116710138339,-3,970,2821,10
116713417671,116713417670,-1,1485,2853,10
116714234182,116714234181,-1,1367,2070,10
116714792051,116714792050,-1,1080,1808,10
116717488885,116717488883,-2,2461,2787,10
116719679026,116719679026,0,1896,2203,10
116720820738,116720820737,-1,1362,1681,10
116721327249,116721327249,0,1153,2216,10
116721666200,116721666202,2,1391,1792,10
116722105947,116722105949,2,1564,1681,10
116723232190,116723232189,-1,1754,2010,10
116725905195,116725905193,-2,965,2015,10
116727705020,116727705018,-2,1476,2412,10
116735813635,116735813632,-3,1502,2821,10
116739390270,116739390273,3,1960,1384,10
116755296383,116755296383,0,1143,1912,10
116758595919,116758595915,-4,1350,2764,10
116763189519,116763189518,-1,1390,2530,10
116766251008,116766251007,-1,1169,1487,10
116771772883,116771772880,-3,1368,1619,10
116775413258,116775413258,0,1106,2509,10
116779936078,116779936077,-1,1003,1706,10
116781426352,116781426351,-1,1029,1660,10
116782105242,116782105240,-2,923,1832,10
116787713356,116787713357,1,5909,7911,10
116788502075,116788502073,-2,1558,1935,10
116789998323,116789998327,4,288,299,10
116790561362,116790561358,-4,1054,2482,10
116792377180,116792377179,-1,1218,1741,10
116793752883,116793752882,-1,1412,1794,10
116799348359,116799348356,-3,947,1721,10
116804419563,116804419562,-1,1897,2922,10
116808214694,116808214704,10,10350,47884,10
116810333927,116810333928,1,1840,2240,10
116815464903,116815464903,0,1706,1942,10
116818062439,116818062439,0,1006,2470,10
116818769359,116818769357,-2,1354,1726,10
116821109040,116821109038,-2,1208,1960,10
116821677933,116821677930,-3,1637,2066,10
116822704390,116822704390,0,980,859,10
116823356727,116823356729,2,2698,2057,10
116826550222,116826550221,-1,1259,2119,10
116827881862,116827881862,0,671,1302,10
116829645829,116829645827,-2,1415,2095,10
116832066547,116832066546,-1,1230,2063,10
116833356158,116833356156,-2,1113,1717,10
116837925350,116837925349,-1,1781,2404,10
116840101427,116840101426,-1,1122,1723,10
116843238419,116843238416,-3,1031,2063,10
116843453339,116843453343,4,2001,905,10
116844912818,116844912818,0,896,1911,10
116852860698,116852860699,1,930,1355,10
116855550254,116855550253,-1,1204,2214,10
116864020294,116864020294,0,963,1862,10
116864584890,116864584881,-9,999,2308,10
116865392890,116865392894,4,1240,1564,10
116866310190,116866310189,-1,953,1840,10
116866675677,116866675675,-2,1915,2731,10
116867396862,116867396862,0,1564,2346,10
116868346215,116868346215,0,986,1666,10
116868489309,116868489311,2,2049,2398,10
116868875466,116868875462,-4,1103,2863,10
116868946038,116868946037,-1,1030,1938,10
116870343677,116870343674,-3,968,1621,10
116871649839,116871649833,-6,693,3558,10
116876261284,116876261291,7,4699,1446,10
116877259881,116877259881,0,1240,1939,10
116878704274,116878704273,-1,1610,2630,10
116889625959,116889625957,-2,1607,1958,10
116891230747,116891230746,-1,1391,1944,10
116891894261,116891894283,22,1207,2740,10
116894279028,116894279029,1,1103,1401,10
116894688934,116894688933,-1,1432,2161,10
116898147946,116898147944,-2,874,1643,10
116898963499,116898963498,-1,1054,2031,10
116903538863,116903538866,3,2868,2230,10
116905955571,116905955570,-1,969,1440,10
116906659688,116906659685,-3,1378,1786,10
116907214228,116907214225,-3,1429,2894,10
116911962480,116911962485,5,753,2028,10
116913514750,116913514756,6,818,1375,10
116917922630,116917922627,-3,923,1294,10
116919571643,116919571642,-1,1045,2443,10
116920084914,116920084913,-1,1326,2255,10
116921382917,116921382910,-7,1234,5140,10
116922088763,116922088762,-1,1454,1961,10
116923342843,116923342841,-2,1155,2227,10
116924862575,116924862573,-2,1446,3514,10
116926564667,116926564666,-1,2239,3775,10
116927020228,116927020226,-2,961,2591,10
116930305928,116930305925,-3,1446,2499,10
116932966899,116932966898,-1,1144,2413,10
116933491814,116933491813,-1,964,1904,10
116933794877,116933794875,-2,1709,2777,10
116935209674,116935209674,0,1108,2159,10
116935942520,116935942518,-2,1378,1938,10
116939147911,116939147910,-1,1217,1708,10
116942006954,116942006954,0,1052,2136,10
116942103374,116942103373,-1,1027,2641,10
116943184737,116943184737,0,888,2039,10
116945726386,116945726389,3,1651,1365,10
116946508513,116946508512,-1,647,1244,10
116948027527,116948027525,-2,929,1941,10
116949552003,116949552002,-1,1471,1780,10
116950661774,116950661772,-2,972,1524,10
116951388294,116951388292,-2,1220,2434,10
116952747426,116952747427,1,1028,1272,10
116953260414,116953260414,0,1165,2080,10
116954158101,116954158099,-2,1177,1420,10
116955027647,116955027647,0,967,1135,10
116955090312,116955090310,-2,1515,1925,10
116955215659,116955215658,-1,881,1629,10
116955758651,116955758658,7,7009,3380,10
116959865701,116959865701,0,1636,1703,10
116961348544,116961348545,1,1779,1878,10
116965011871,116965011869,-2,1389,1724,10
116973427285,116973427284,-1,1439,1791,10
116979628631,116979628630,-1,1501,2185,10
116981996939,116981996943,4,3782,2625,10
116982790182,116982790184,2,1095,1830,10
116984577805,116984577803,-2,1204,1938,10
116991627794,116991627793,-1,1029,1692,10
116993544035,116993544034,-1,738,1619,10
116993677304,116993677287,-17,113,755,10
117004187846,117004187843,-3,1558,2648,10
117005291485,117005291483,-2,1439,2686,10
117005718949,117005718946,-3,878,1879,10
117006345448,117006345447,-1,1365,1750,10
117007481152,117007481150,-2,1666,2439,10
117007707054,117007707053,-1,1261,2633,10
117007868810,117007868809,-1,1182,1677,10
117009772402,117009772402,0,1055,2017,10
117010822712,117010822703,-9,511,371,10
117015554283,117015554282,-1,1377,1898,10
117015739771,117015739772,1,864,1196,10
117016142357,117016142357,0,1392,1690,10
117018340996,117018340997,1,5317,3764,10
117019756991,117019756971,-20,1005,1584,10
117020045694,117020045693,-1,916,904,10
117023775290,117023775290,0,1461,1394,10
117026239409,117026239407,-2,1266,1975,10
117027369974,117027369970,-4,1392,2049,10
117029530052,117029530055,3,780,1815,10
117029849132,117029849151,19,1364,1647,10
117035118043,117035118041,-2,1108,1756,10
117038293769,117038293769,0,1155,1328,10
117039120777,117039120775,-2,901,1979,10
117042990190,117042990190,0,994,1707,10
117046251803,117046251802,-1,1191,2066,10
117051608062,117051608063,1,890,1658,10
117054819951,117054819952,1,2624,2344,10
117059723915,117059723916,1,1369,1342,10
117060001201,117060001202,1,1404,1532,10
117060390858,117060390855,-3,1009,1769,10
117063152223,117063152222,-1,1026,2505,10
117063629011,117063629007,-4,1336,2537,10
117068573863,117068573860,-3,711,1761,10
117070684618,117070684618,0,1076,1355,10
117072655362,117072655361,-1,765,1783,10
117077201248,117077201250,2,1276,1747,10
117078328741,117078328739,-2,982,1150,10
117080203988,117080203987,-1,952,1310,10
117080784065,117080784063,-2,1411,2850,10
117081381211,117081381211,0,849,2041,10
117085886174,117085886170,-4,1192,2690,10
117086571102,117086571100,-2,1733,2743,10
117087503018,117087503022,4,910,1496,10
117088513454,117088513456,2,1466,2432,10
117093944221,117093944219,-2,707,874,10
117094627974,117094627973,-1,3441,4600,10
117094989148,117094989146,-2,1521,1903,10
117096246778,117096246774,-4,1395,2695,10
117096988759,117096988760,1,1205,1573,10
117098401650,117098401657,7,3855,1692,10
117103446861,117103446859,-2,837,1298,10
117107405983,117107405984,1,970,975,10
117108831579,117108831578,-1,944,1616,10
117110132839,117110132836,-3,2132,5546,10
117116863271,117116863270,-1,1143,1680,10
117118299487,117118299490,3,1417,917,10
117118484182,117118484181,-1,953,1564,10
117120652111,117120652110,-1,1319,1864,10
117120910042,117120910039,-3,1271,2364,10
117127094307,117127094302,-5,944,2012,10
117127370586,117127370585,-1,999,1849,10
117132300613,117132300611,-2,1126,2683,10
117135880067,117135880062,-5,1462,2365,10
117137974022,117137974031,9,11131,22975,10
117139260296,117139260302,6,2675,1517,10
117143490450,117143490450,0,1455,2310,10
117146540339,117146540338,-1,1257,1796,10
117147671883,117147671882,-1,860,1389,10
117148994787,117148994786,-1,1460,1671,10
117149899050,117149899068,18,973,952,10
117150218880,117150218879,-1,1701,2280,10
117150747817,117150747801,-16,329,1969,10
117150998863,117150998862,-1,1403,1660,10
117152840595,117152840593,-2,1026,1278,10
117154187402,117154187401,-1,1240,1647,10
117156669597,117156669594,-3,992,1445,10
117165776358,117165776357,-1,1661,3363,10
117167775778,117167775778,0,1247,2209,10
117169398642,117169398642,0,1247,1806,10
117171596423,117171596421,-2,658,905,10
117180280951,117180280950,-1,1509,2090,10
117180731105,117180731111,6,28232,42072,10
117181724182,117181724181,-1,1367,1888,10
117185773805,117185773803,-2,1626,2191,10
117188296093,117188296090,-3,1391,2774,10
117189673230,117189673229,-1,994,1757,10
117191636488,117191636487,-1,1100,2448,10
117192532835,117192532835,0,1722,2381,10
117195059183,117195059181,-2,924,1936,10
117196442874,117196442872,-2,1468,2330,10
117197408248,117197408244,-4,1062,2273,10
117203285730,117203285729,-1,1308,1701,10
117205106429,117205106427,-2,1299,1607,10
117208595393,117208595391,-2,836,1745,10
117214656087,117214656086,-1,1721,2521,10
117215854466,117215854463,-3,1346,2304,10
117217263006,117217263007,1,1121,1364,10
117222410745,117222410744,-1,1495,2402,10
117222645584,117222645607,23,1212,1908,10
117222973677,117222973678,1,1610,2505,10
117225201754,117225201754,0,782,2617,10
117225227099,117225227097,-2,838,1397,10
117225288515,117225288498,-17,1129,1877,10
117228039694,117228039694,0,1276,2413,10
117233778850,117233778850,0,1735,2892,10
117239603639,117239603638,-1,1326,2352,10
117241282979,117241282981,2,1578,1674,10
117261095778,117261095777,-1,702,1685,10
117262850534,117262850512,-22,22,988,10
117263405106,117263405105,-1,1060,2450,10
117264488698,117264488698,0,1964,2168,10
117270109770,117270109768,-2,1044,2296,10
117270823848,117270823855,7,6719,2386,10
117274082002,117274082001,-1,1033,2307,10
117280286843,117280286841,-2,1351,1914,10
117280690782,117280690779,-3,1332,3314,10
117280717009,117280717029,20,1143,2038,10
117284367646,117284367651,5,2972,1378,10
117287372025,117287372022,-3,1402,2202,10
117289273838,117289273836,-2,1147,2272,10
117290736371,117290736369,-2,1719,1781,10
117294645135,117294645133,-2,1367,1911,10
117296283613,117296283620,7,4625,1761,10
117298149141,117298149138,-3,1260,1852,10
117300609841,117300609838,-3,1369,2277,10
117300677665,117300677663,-2,1466,1549,10
117303485698,117303485697,-1,1388,2476,10
117304342999,117304342996,-3,1401,1921,10
117305811641,117305811642,1,799,1624,10
117308255779,117308255777,-2,1345,2845,10
117310095122,117310095122,0,911,1805,10
117310929049,117310929046,-3,1052,1662,10
117313888968,117313888966,-2,1534,1885,10
117314849035,117314849034,-1,1811,2801,10
117317150015,117317150013,-2,1044,1224,10
117319593214,117319593211,-3,1041,1961,10
117325169174,117325169185,11,1217,1569,10
117326937373,117326937371,-2,1077,1839,10
117328052547,117328052546,-1,1150,2691,10
117328425077,117328425074,-3,1219,2129,10
117329318473,117329318494,21,1252,2522,10
117331714358,117331714358,0,1809,3438,10
117339071510,117339071509,-1,909,1659,10
117344150317,117344150318,1,972,1229,10
117346611726,117346611723,-3,1330,1770,10
117346959549,117346959545,-4,1406,1851,10
117351504606,117351504609,3,3168,1807,10
117353271398,117353271398,0,1108,1588,10
117353976705,117353976704,-1,1053,2042,10
117361180414,117361180414,0,1017,2147,10
117370574707,117370574706,-1,1417,1781,10
117375708879,117375708878,-1,956,1780,10
117378912222,117378912220,-2,1528,2739,10
117380555820,117380555818,-2,792,1753,10
117382822050,117382822048,-2,1233,1454,10
117386648885,117386648890,5,1537,1034,10
117389818882,117389818883,1,1195,1638,10
117390267997,117390267995,-2,1450,1949,10
117391168176,117391168174,-2,977,1999,10
117394405374,117394405372,-2,982,2334,10
117395753938,117395753941,3,1833,2652,10
117398143448,117398143446,-2,1388,1876,10
117398191467,117398191462,-5,545,2180,10
117398678838,117398678837,-1,779,1950,10
117401415470,117401415466,-4,1245,2156,10
117401987790,117401987789,-1,1175,1895,10
117402210895,117402210894,-1,1893,2195,10
117407041240,117407041238,-2,1657,2364,10
117408983947,117408983946,-1,1261,2319,10
117409145020,117409145018,-2,981,1186,10
117413314250,117413314251,1,1381,2073,10
117414377401,117414377403,2,1326,1000,10
117415267272,117415267284,12,1413,1860,10
117417370402,117417370400,-2,786,1335,10
117417692156,117417692156,0,1130,2472,10
117418531719,117418531717,-2,1463,2739,10
117423047671,117423047667,-4,1249,1866,10
117427261236,117427261234,-2,1258,2307,10
117430896975,117430896972,-3,1389,2507,10
117434896375,117434896373,-2,992,1898,10
117437951925,117437951925,0,1581,2296,10
117439319009,117439319006,-3,871,1661,10
117442058790,117442058789,-1,858,1673,10
117444492271,117444492271,0,795,1316,10
117452709366,117452709365,-1,1070,2058,10
117453338871,117453338869,-2,1358,2019,10
117454799191,117454799170,-21,1546,2487,10
117455053059,117455053058,-1,1448,2388,10
117457351577,117457351574,-3,1368,3172,10
117457649858,117457649858,0,1749,2536,10
117458063369,117458063366,-3,1334,2405,10
117461859546,117461859546,0,1508,2001,10
117465984727,117465984726,-1,1246,1605,10
117467064758,117467064757,-1,1145,2656,10
117470966167,117470966166,-1,1123,1923,10
117472112745,117472112750,5,3431,2056,10
117473202243,117473202241,-2,1413,2732,10
117473985199,117473985198,-1,1213,1610,10
117474462261,117474462258,-3,1215,1856,10
117476165941,117476165941,0,18457,20660,10
117477583755,117477583754,-1,1742,2187,10
117477968390,117477968390,0,1684,1939,10
117479689808,117479689807,-1,1826,2305,10
117480346356,117480346355,-1,1900,2256,10
117480628762,117480628766,4,1113,1748,10
117481724369,117481724366,-3,1035,1773,10
117482241223,117482241218,-5,1074,4928,10
117488567666,117488567665,-1,1098,1411,10
117489347881,117489347877,-4,1193,2454,10
117491224370,117491224366,-4,1065,2030,10
117493049742,117493049739,-3,1157,2344,10
117495501062,117495501061,-1,1415,2377,10
117497687885,117497687885,0,1445,2418,10
117499397953,117499397959,6,4842,1618,10
117499463391,117499463390,-1,1375,1396,10
117499716132,117499716130,-2,1267,2267,10
117501235722,117501235722,0,1317,1912,10
117504522810,117504522808,-2,1453,2512,10
117508934134,117508934131,-3,1274,2009,10
117512463421,117512463421,0,1176,2105,10
117512767810,117512767791,-19,1335,1993,10
117520526854,117520526853,-1,973,1539,10
117523108476,117523108474,-2,1356,2080,10
117524625462,117524625462,0,1346,1945,10
117526992862,117526992858,-4,1240,6113,10
117527551562,117527551561,-1,1829,2812,10
117534191215,117534191214,-1,1327,2049,10
117536534946,117536534946,0,1102,1351,10
117544047098,117544047098,0,1276,1555,10
117544522831,117544522830,-1,1675,1620,10
117546115246,117546115245,-1,927,1411,10
117546517027,117546517010,-17,193,659,10
117557004419,117557004415,-4,726,1466,10
117558109634,117558109633,-1,1418,1810,10
117560218419,117560218419,0,1177,1970,10
117560999912,117560999909,-3,1654,3293,10
117561845021,117561845018,-3,1438,2122,10
117563164137,117563164134,-3,1519,1769,10
117563795706,117563795702,-4,2129,2454,10
117571845790,117571845795,5,3818,1771,10
117573324808,117573324805,-3,1643,2096,10
117573579582,117573579577,-5,1451,2924,10
117573700171,117573700165,-6,2930,7826,10
117574887483,117574887481,-2,1325,1843,10
117579576409,117579576409,0,1213,1457,10
117580531614,117580531616,2,1838,1817,10
117584814698,117584814701,3,1386,1562,10
117588827595,117588827593,-2,1401,1979,10
117591541793,117591541790,-3,1512,2950,10
117591939465,117591939461,-4,1105,1848,10
117592235145,117592235143,-2,1479,2457,10
117593653725,117593653723,-2,1488,2314,10
117594043166,117594043182,16,12520,31540,10
117597232767,117597232766,-1,1083,3112,10
117599156290,117599156289,-1,1428,2877,10
117600597815,117600597811,-4,2274,4462,10
117601911242,117601911240,-2,1031,2230,10
117603099795,117603099794,-1,1189,1517,10
117605200902,117605200901,-1,1459,2145,10
117608159265,117608159264,-1,820,1629,10
117611256191,117611256197,6,4191,1955,10
117611882454,117611882458,4,1200,1016,10
117612878541,117612878542,1,1605,2433,10
117613050791,117613050790,-1,1019,1972,10
117615044049,117615044048,-1,1750,2911,10
117618254130,117618254130,0,1158,1984,10
117618339314,117618339314,0,1120,2018,10
117619229317,117619229314,-3,1408,1702,10
117623246362,117623246358,-4,723,1726,10
117623872465,117623872464,-1,1193,2019,10
117625440258,117625440259,1,1175,2106,10
117627010446,117627010445,-1,1378,2432,10
117629707654,117629707652,-2,960,1775,10
117633221126,117633221124,-2,1261,2266,10
117639152419,117639152418,-1,1317,1872,10
117640839450,117640839450,0,989,1501,10
117649355110,117649355108,-2,1063,2041,10
117649880667,117649880666,-1,978,1807,10
117655367621,117655367621,0,1570,1996,10
117655419212,117655419210,-2,1691,2355,10
117657566443,117657566443,0,1634,1476,10
117666489109,117666489113,4,2348,1536,10
117666599711,117666599709,-2,1290,1761,10
117671494146,117671494148,2,1366,1791,10
117672320988,117672320982,-6,825,2939,10
117672808739,117672808758,19,1098,1934,10
117674891939,117674891936,-3,591,1320,10
117676616758,117676616757,-1,1360,1546,10
117677066603,117677066602,-1,909,1363,10
117677879449,117677879449,0,1153,1923,10
117681981335,117681981333,-2,1430,2468,10
117682186133,117682186132,-1,667,1813,10
117685371685,117685371685,0,1961,1797,10
117685414251,117685414250,-1,861,2421,10
117686886671,117686886669,-2,1305,1391,10
117688951199,117688951195,-4,742,1301,10
117689949163,117689949161,-2,9594,15839,10
117699679659,117699679658,-1,956,2305,10
117702577447,117702577446,-1,2013,2403,10
117703075103,117703075105,2,1374,2006,10
117710349914,117710349917,3,1488,1162,10
117710479313,117710479312,-1,1646,1962,10
117711049743,117711049742,-1,1040,1662,10
117728401439,117728401443,4,3028,1995,10
117729162718,117729162715,-3,1374,2410,10
117732972533,117732972531,-2,1201,1710,10
117734243884,117734243881,-3,918,2141,10
117736933641,117736933635,-6,819,2293,10
117738197603,117738197601,-2,993,1810,10
117738809483,117738809484,1,1191,1822,10
117738984971,117738984969,-2,1153,2432,10
117750773165,117750773163,-2,1308,2245,10
117752126962,117752126959,-3,1859,2971,10
117752207181,117752207180,-1,738,1663,10
117755122542,117755122543,1,1078,1176,10
117755860257,117755860262,5,15650,8527,10
117760819052,117760819051,-1,1537,1691,10
117762560158,117762560158,0,992,1900,10
117762668626,117762668644,18,1471,1627,10
117765214439,117765214438,-1,1334,2921,10
117765791227,117765791230,3,2838,2225,10
117767095577,117767095578,1,904,1720,10
117768036480,117768036476,-4,889,2621,10
117772826117,117772826117,0,1105,1515,10
117773548918,117773548918,0,1383,1802,10
117775268750,117775268750,0,1103,2191,10
117781733775,117781733776,1,1183,1332,10
117782833486,117782833485,-1,1086,2172,10
117783455275,117783455274,-1,1202,1881,10
117789004711,117789004712,1,1517,1595,10
117791267952,117791267949,-3,1000,2574,10
117791512681,117791512666,-15,1256,1909,10
117792011329,117792011328,-1,1665,2293,10
117793180235,117793180232,-3,1376,2392,10
117795038918,117795038920,2,1040,1524,10
117796264918,117796264915,-3,1213,2193,10
117798004929,117798004928,-1,1363,2425,10
117800873114,117800873113,-1,1304,2540,10
117800950099,117800950103,4,659,1326,10
117801487249,117801487246,-3,704,1844,10
117801872103,117801872102,-1,1617,2176,10
117802528033,117802528030,-3,1322,2852,10
117805919327,117805919327,0,1587,2273,10
117810978596,117810978594,-2,909,1683,10
117811979761,117811979758,-3,924,1934,10
117812510766,117812510763,-3,1079,1461,10
117819856082,117819856082,0,1266,1902,10
117820277587,117820277586,-1,1189,2644,10
117820653977,117820653970,-7,1207,2472,10
117822396413,117822396420,7,3633,1671,10
117823233420,117823233418,-2,768,1901,10
117824651169,117824651166,-3,1670,2210,10
117825008455,117825008453,-2,931,1565,10
117826202035,117826202035,0,1258,2113,10
117828759346,117828759343,-3,1296,1243,10
117829350026,117829350029,3,1212,913,10
117830443514,117830443511,-3,1247,2139,10
117830729349,117830729347,-2,1066,1380,10
117839468631,117839468630,-1,637,1662,10
117842597754,117842597754,0,1583,1996,10
117845902246,117845902241,-5,1403,2018,10
117850103138,117850103139,1,994,1338,10
117850823189,117850823189,0,2047,2304,10
117854815956,117854815956,0,1271,2145,10
117855021226,117855021243,17,788,1391,10
117855845647,117855845646,-1,1147,1544,10
117858472646,117858472644,-2,1503,2462,10
117859460727,117859460726,-1,1221,2280,10
117860340526,117860340522,-4,1008,1043,10
117865303285,117865303290,5,2133,1589,10
117869200930,117869200929,-1,1155,2022,10
117869479959,117869479957,-2,1360,2086,10
117869580498,117869580499,1,1238,1977,10
117870691482,117870691480,-2,1124,2116,10
117871334410,117871334412,2,613,1536,10
117872710830,117872710827,-3,994,1673,10
117875272636,117875272634,-2,1264,1851,10
117876269809,117876269808,-1,1047,1806,10
117879255131,117879255130,-1,988,1856,10
117879602450,117879602450,0,847,1494,10
117880682074,117880682072,-2,1273,1761,10
117885077527,117885077522,-5,768,1402,10
117885961423,117885961422,-1,1405,2371,10
117888460122,117888460121,-1,1122,1600,10
117888971167,117888971167,0,1725,1751,10
117890327161,117890327158,-3,770,1048,10
117896041738,117896041738,0,892,1371,10
117897857662,117897857661,-1,1452,1532,10
117900382058,117900382058,0,1176,2362,10
117903634631,117903634630,-1,995,1519,10
117907045161,117907045162,1,1309,1813,10
117910543627,117910543624,-3,931,1416,10
117911984274,117911984273,-1,1074,1711,10
117915418336,117915418334,-2,1343,1933,10
117915493117,117915493116,-1,1498,1535,10
117918125627,117918125633,6,3437,1339,10
117920590526,117920590526,0,1452,1921,10
117921768663,117921768661,-2,1544,2267,10
117924410031,117924410033,2,897,981,10
117925218449,117925218450,1,1369,1982,10
117926103619,117926103617,-2,1002,1626,10
117927330664,117927330648,-16,1181,2113,10
117927609619,117927609609,-10,1331,1788,10
117929376038,117929376038,0,1444,2108,10
117932941658,117932941655,-3,855,1807,10
117933774266,117933774264,-2,1498,2313,10
117936345207,117936345203,-4,1002,2797,10
117936927706,117936927707,1,1376,1608,10
117937085121,117937085119,-2,900,2137,10
117939927910,117939927913,3,2520,2046,10
117942456992,117942456984,-8,1336,5772,10
117942764604,117942764622,18,325,552,10
117943800867,117943800866,-1,856,1219,10
117945993459,117945993458,-1,793,1615,10
117948191265,117948191263,-2,1102,1701,10
117948622046,117948622046,0,1130,1722,10
117950699662,117950699663,1,969,1647,10
117954608145,117954608146,1,894,1673,10
117955445674,117955445673,-1,1250,2142,10
117955663471,117955663471,0,914,1855,10
117957217525,117957217529,4,13455,9727,10
117959670358,117959670353,-5,908,4137,10
117962458645,117962458638,-7,1466,2331,10
117962643083,117962643089,6,267,759,10
117963112183,117963112182,-1,1790,1716,10
117964710653,117964710659,6,2245,1282,10
117965723951,117965723950,-1,2000,2436,10
117966038845,117966038838,-7,650,2957,10
117974502108,117974502105,-3,1956,2067,10
117975041407,117975041407,0,1327,1760,10
117976987526,117976987522,-4,785,2210,10
117977341594,117977341594,0,983,1533,10
117980624666,117980624666,0,1182,1378,10
117982413073,117982413071,-2,1596,2954,10
117984077841,117984077839,-2,1179,2446,10
117984121601,117984121599,-2,1798,2796,10
117985605357,117985605356,-1,1403,1943,10
117986125399,117986125398,-1,1181,1265,10
117986579275,117986579269,-6,1063,1343,10
117989168567,117989168566,-1,1089,2624,10
117991801623,117991801622,-1,1073,1826,10
117995283803,117995283802,-1,1678,2537,10
117995774546,117995774528,-18,1181,505,10
117996987121,117996987119,-2,1399,1674,10
118003245707,118003245707,0,1394,2843,10
118005160511,118005160508,-3,1027,1978,10
118006324974,118006324974,0,1084,2143,10
118012572353,118012572351,-2,1093,1386,10
118017816382,118017816381,-1,822,1086,10
118021087399,118021087397,-2,1355,1811,10
118021255242,118021255240,-2,1088,2282,10
118022139135,118022139139,4,1503,1230,10
118023861995,118023861994,-1,1445,1541,10
118026246933,118026246933,0,1532,1935,10
118028326417,118028326420,3,3368,2640,10
118028453089,118028453090,1,1259,1953,10
118033390602,118033390599,-3,1010,1778,10
118034675368,118034675366,-2,1270,1719,10
118041680259,118041680258,-1,986,2015,10
118043681644,118043681644,0,786,1416,10
118043773464,118043773462,-2,1588,2998,10
118046319550,118046319550,0,1259,1755,10
118050594794,118050594794,0,979,2162,10
118054789365,118054789364,-1,1370,1430,10
118056827490,118056827482,-8,825,2083,10
118059522150,118059522149,-1,1983,2254,10
118060981434,118060981435,1,1152,924,10
118062521980,118062521978,-2,783,871,10
118063031979,118063031974,-5,1181,2539,10
118064151139,118064151139,0,1047,2145,10
118067640339,118067640337,-2,1600,2393,10
118068229605,118068229605,0,1096,1558,10
118068620601,118068620598,-3,1690,2553,10
118071063901,118071063900,-1,836,2244,10
118071141457,118071141457,0,1985,4327,10
118071609261,118071609258,-3,1008,2611,10
118074872895,118074872894,-1,1305,2098,10
118077577314,118077577314,0,1365,2321,10
118078941906,118078941904,-2,1545,2039,10
118082168432,118082168429,-3,1540,2575,10
118083142074,118083142073,-1,1346,1695,10
118086566093,118086566112,19,1604,1855,10
118090037606,118090037607,1,1233,1488,10
118091650307,118091650305,-2,948,1633,10
118092935139,118092935135,-4,1194,2688,10
118093684924,118093684939,15,847,1952,10
118095549863,118095549863,0,1573,1923,10
118097878532,118097878530,-2,1413,2369,10
118099043688,118099043688,0,1330,2045,10
118100155467,118100155468,1,1030,1958,10
118102641290,118102641289,-1,1168,2139,10
118103053954,118103053954,0,1503,1635,10
118110078363,118110078363,0,1221,2356,10
118112031733,118112031731,-2,1231,2277,10
118115723447,118115723444,-3,831,1657,10
118117837162,118117837162,0,1206,1345,10
118128150978,118128150975,-3,1730,2419,10
118131103800,118131103800,0,1151,2319,10
118133324672,118133324669,-3,781,1502,10
118134250587,118134250587,0,1118,2250,10
118137137193,118137137191,-2,1329,2254,10
118137390704,118137390697,-7,702,941,10
118142354035,118142354033,-2,1258,1411,10
118143552891,118143552888,-3,1272,1643,10
118144271762,118144271762,0,1373,1457,10
118144536211,118144536210,-1,916,1206,10
118146437085,118146437083,-2,1191,1825,10
118146992889,118146992889,0,1347,1557,10
118147865115,118147865114,-1,1334,1367,10
118149257394,118149257392,-2,1155,2017,10
118153749829,118153749827,-2,1384,2680,10
118153990088,118153990082,-6,1038,1991,10
118154611734,118154611731,-3,1757,2045,10
118158551682,118158551679,-3,993,2882,10
118158695896,118158695878,-18,1310,1336,10
118159056066,118159056047,-19,613,541,10
118159110243,118159110242,-1,1443,1662,10
118160217437,118160217436,-1,1042,1882,10
118160824147,118160824142,-5,1107,4127,10
118162177703,118162177699,-4,973,1247,10
118167373566,118167373546,-20,1563,1554,10
118167827127,118167827126,-1,981,2034,10
118168007940,118168007935,-5,1366,3379,10
118168528083,118168528082,-1,984,1150,10
118173839642,118173839642,0,1143,1924,10
118177567541,118177567537,-4,1029,1315,10
118179109951,118179109950,-1,728,1519,10
118183248385,118183248379,-6,1176,1771,10
118186282383,118186282383,0,1150,2916,10
118186913582,118186913583,1,804,1357,10
118190702229,118190702226,-3,1164,2443,10
118191549827,118191549827,0,881,1297,10
118192852350,118192852358,8,3297,1605,10
118195626752,118195626749,-3,1138,3110,10
118196253315,118196253314,-1,1381,2165,10
118196592060,118196592059,-1,1524,2608,10
118200212585,118200212589,4,2711,1794,10
118200629377,118200629376,-1,1161,1490,10
118201534011,118201534008,-3,1076,1194,10
118205146313,118205146313,0,1405,1646,10
118211841694,118211841692,-2,1494,2153,10
118212343406,118212343410,4,2867,1371,10
118213172250,118213172249,-1,642,1466,10
118216340832,118216340833,1,1150,1313,10
118217855124,118217855125,1,1494,1330,10
118219617232,118219617230,-2,853,1144,10
118220513857,118220513855,-2,1234,1440,10
118221360118,118221360118,0,1266,2014,10
118223698277,118223698278,1,1255,1666,10
118225316192,118225316189,-3,1691,2219,10
118226537502,118226537501,-1,1457,2224,10
118226569297,118226569293,-4,989,2051,10
118229299858,118229299855,-3,1107,1708,10
118232592882,118232592883,1,939,1472,10
118236298534,118236298533,-1,1663,3225,10
118238986630,118238986629,-1,1086,1511,10
118240323974,118240323975,1,702,1312,10
118243697388,118243697389,1,1357,1596,10
118244672846,118244672842,-4,1509,2309,10
118247402128,118247402126,-2,1263,2555,10
118250801461,118250801458,-3,1157,1994,10
118252135686,118252135688,2,1329,1648,10
118256518087,118256518087,0,1380,2045,10
118262013589,118262013586,-3,1255,1796,10
118263017967,118263017962,-5,873,2100,10
118265013563,118265013561,-2,1213,1895,10
118266351186,118266351186,0,1585,1705,10
118271342174,118271342174,0,1017,1548,10
118271833983,118271833982,-1,1213,2087,10
118271942623,118271942622,-1,1558,1352,10
118274250803,118274250801,-2,1161,2380,10
118277155974,118277155974,0,994,1561,10
118278145771,118278145769,-2,1006,2032,10
118278410388,118278410387,-1,1190,1725,10
118278519082,118278519078,-4,1282,2742,10
118286988434,118286988434,0,1817,1805,10
118288221848,118288221849,1,1138,1876,10
118288650239,118288650238,-1,910,1513,10
118291649028,118291649028,0,1369,2572,10
118291756429,118291756427,-2,839,1429,10
118293009398,118293009397,-1,868,1880,10
118299743664,118299743662,-2,1852,1854,10
118302971178,118302971177,-1,1282,2170,10
118304182174,118304182173,-1,1596,1425,10
118304258933,118304258931,-2,825,1439,10
118306451409,118306451409,0,1006,1474,10
118307807406,118307807404,-2,988,1983,10
118309848202,118309848201,-1,869,1554,10
118311491779,118311491773,-6,753,3109,10
118312006036,118312006034,-2,1333,2760,10
118314049679,118314049677,-2,1184,2270,10
118314928175,118314928176,1,854,1643,10
118316676838,118316676836,-2,821,1430,10
118320644730,118320644729,-1,1065,2233,10
118320670482,118320670481,-1,1107,1934,10
118322399140,118322399139,-1,1183,1655,10
118328364983,118328364977,-6,1242,4893,10
118329371758,118329371758,0,875,1400,10
118334903133,118334903133,0,1136,1926,10
118336294697,118336294701,4,2729,1474,10
118337206774,118337206771,-3,1010,1894,10
118340616881,118340616878,-3,1149,1990,10
118342182678,118342182678,0,1361,1587,10
118344490966,118344490964,-2,1375,2741,10
118356021507,118356021505,-2,1724,1386,10
118356338721,118356338714,-7,1648,5476,10
118356953893,118356953891,-2,1296,1610,10
118357322823,118357322825,2,2065,2440,10
118360391799,118360391794,-5,1091,2511,10
118362713225,118362713227,2,37097,36166,10
118363075726,118363075724,-2,839,1440,10
118364150770,118364150789,19,503,976,10
118366296565,118366296564,-1,941,2235,10
118369203869,118369203869,0,1182,1517,10
118370759862,118370759861,-1,1392,2055,10
118375702079,118375702086,7,11128,26769,10
118375829464,118375829463,-1,1296,1032,10
118377346210,118377346209,-1,1284,1656,10
118379561983,118379561982,-1,1474,1950,10
118380544945,118380544941,-4,1257,2528,10
118382632364,118382632362,-2,856,2841,10
118383570405,118383570404,-1,1584,2004,10
118383687037,118383687038,1,1182,2280,10
118384452622,118384452620,-2,899,1170,10
118385491531,118385491529,-2,1203,1925,10
118385930850,118385930849,-1,1503,1796,10
118387753848,118387753846,-2,1745,2577,10
118387976030,118387976030,0,1122,2031,10
118388109858,118388109855,-3,789,2048,10
118389297393,118389297393,0,976,1610,10
118391120953,118391120954,1,1676,1401,10
118391448963,118391448962,-1,1177,1358,10
118393080828,118393080823,-5,1099,2580,10
118393713698,118393713698,0,1195,1915,10
118394047227,118394047246,19,935,1786,10
118396384833,118396384830,-3,1303,2389,10
118399630113,118399630111,-2,1272,2549,10
118400114744,118400114746,2,306,898,10
118410057406,118410057406,0,799,1674,10
118414401057,118414401057,0,1278,2110,10
118416167187,118416167186,-1,955,1560,10
118418278137,118418278135,-2,1511,1788,10
118419256895,118419256894,-1,606,1271,10
118422927005,118422927005,0,1112,1746,10
118423006734,118423006733,-1,1370,2054,10
118424328961,118424328961,0,1704,2026,10
118429452826,118429452826,0,854,1499,10
118430106858,118430106857,-1,1386,1371,10
118439361106,118439361106,0,1712,2018,10
118441028517,118441028516,-1,798,1324,10
118442122724,118442122722,-2,869,2094,10
118443798783,118443798778,-5,696,2815,10
118446188509,118446188510,1,1174,1412,10
118446774359,118446774358,-1,1061,2120,10
118447744694,118447744693,-1,952,2035,10
118448150371,118448150370,-1,917,1213,10
118449842979,118449842977,-2,828,2014,10
118450435788,118450435786,-2,1739,2521,10
118452155927,118452155930,3,1541,21187,10
118453115352,118453115350,-2,1331,2147,10
118453391855,118453391855,0,1130,2257,10
118454420761,118454420758,-3,1407,1876,10
118454684375,118454684377,2,956,1806,10
118454941159,118454941159,0,984,1191,10
118456210095,118456210093,-2,1421,2347,10
118456311394,118456311381,-13,131,498,10
118459932951,118459932954,3,1242,1822,10
118467181693,118467181689,-4,1162,2544,10
118471427929,118471427929,0,1078,1664,10
118473055793,118473055791,-2,1262,1455,10
118476435478,118476435480,2,1494,1413,10
118477605844,118477605842,-2,1259,2156,10
118479697126,118479697125,-1,1080,1555,10
118483478758,118483478756,-2,1937,2931,10
118487451521,118487451519,-2,983,2189,10
118490825773,118490825772,-1,1521,1628,10
118494584170,118494584169,-1,1182,2742,10
118497201877,118497201875,-2,1393,2161,10
118497577497,118497577509,12,462,1941,10
118501256513,118501256510,-3,1142,1781,10
118501528215,118501528216,1,1669,1295,10
118509969773,118509969774,1,1384,2478,10
118511972889,118511972885,-4,1327,2343,10
118514263411,118514263407,-4,1284,2277,10
118514444883,118514444881,-2,1301,1988,10
118516642878,118516642878,0,769,1027,10
118519521039,118519521031,-8,1231,6503,10
118520116929,118520116929,0,2883,4623,10
118522166753,118522166751,-2,1386,2371,10
118522246168,118522246189,21,1250,2824,10
118524306344,118524306343,-1,976,1520,10
118528178263,118528178260,-3,1530,2778,10
118528660633,118528660615,-18,91,704,10
118530705589,118530705588,-1,1595,1945,10
118531181855,118531181858,3,2949,2780,10
118531290603,118531290598,-5,1411,3072,10
118531444131,118531444150,19,462,1017,10
118533358787,118533358785,-2,1507,2049,10
118534526103,118534526103,0,1137,1503,10
118536826229,118536826228,-1,1092,1550,10
118537361354,118537361350,-4,309,969,10
118540341985,118540341985,0,1390,2261,10
118544419125,118544419124,-1,1205,2339,10
118546432946,118546432946,0,1154,2203,10
118546476264,118546476286,22,1359,1875,10
118547097817,118547097817,0,1453,2204,10
118550184082,118550184078,-4,804,1801,10
118552032739,118552032747,8,5017,1051,10
118552535007,118552535005,-2,709,1329,10
118555108232,118555108230,-2,1954,1899,10
118557559178,118557559177,-1,942,1528,10
118560491367,118560491365,-2,1024,1292,10
118562378958,118562378956,-2,1168,2060,10
118563912319,118563912318,-1,1267,1594,10
118566378522,118566378522,0,1112,2026,10
118567405565,118567405571,6,3068,1962,10
118568698458,118568698458,0,1123,1376,10
118575182593,118575182594,1,1667,1706,10
118576760254,118576760254,0,1772,2223,10
118577099577,118577099575,-2,1387,2405,10
118577415583,118577415584,1,1396,1950,10
118581387410,118581387408,-2,1542,2593,10
118583577460,118583577457,-3,1408,4610,10
118584640226,118584640242,16,2021,9849,10
118586379978,118586379977,-1,1129,1601,10
118588707822,118588707821,-1,1046,2415,10
118589737831,118589737829,-2,1410,2014,10
118589773977,118589773975,-2,1106,2280,10
118593252842,118593252839,-3,1367,2244,10
118595711847,118595711846,-1,1481,1549,10
118599446851,118599446851,0,1102,2412,10
118602618546,118602618545,-1,1023,2083,10
118602892954,118602892953,-1,1057,2605,10
118611518612,118611518610,-2,1083,2304,10
118611670881,118611670880,-1,908,1983,10
118614240317,118614240313,-4,1237,3239,10
118620218066,118620218073,7,4163,1483,10
118621758995,118621758995,0,1426,1946,10
118622260291,118622260289,-2,1143,1036,10
118624733810,118624733807,-3,612,1184,10
118628928483,118628928481,-2,1290,1355,10
118635121397,118635121397,0,1545,2063,10
118640279308,118640279306,-2,1141,1820,10
118644714623,118644714618,-5,1523,2074,10
118645182870,118645182869,-1,944,1799,10
118645226350,118645226348,-2,1151,1685,10
118652059669,118652059669,0,1673,2353,10
118653475230,118653475228,-2,1051,1551,10
118659367198,118659367196,-2,973,1890,10
118665655101,118665655099,-2,994,2257,10
118667861236,118667861239,3,1957,1509,10
118669137206,118669137205,-1,1388,3104,10
118673423792,118673423792,0,1286,1638,10
118673626857,118673626863,6,121,744,10
118675465062,118675465062,0,1483,2378,10
118679406266,118679406265,-1,1061,1945,10
118679826015,118679826013,-2,1090,2280,10
118682697485,118682697485,0,862,1861,10
118686208497,118686208495,-2,1342,1423,10
118688192734,118688192730,-4,1222,2522,10
118690316522,118690316521,-1,1108,1352,10
118691710191,118691710189,-2,1303,2116,10
118694193958,118694193956,-2,1874,2339,10
118701853933,118701853930,-3,1159,2103,10
118704328099,118704328099,0,1118,1720,10
118706362772,118706362770,-2,1241,2196,10
118709296559,118709296558,-1,1348,1967,10
118710201690,118710201687,-3,1024,2117,10
118710241037,118710241034,-3,1274,2927,10
118712938770,118712938770,0,903,1373,10
118717260511,118717260511,0,1918,1680,10
118717778165,118717778165,0,1668,2027,10
118719789119,118719789118,-1,1151,2458,10
118722136554,118722136553,-1,1438,2303,10
118723104830,118723104829,-1,1160,1990,10
118723921607,118723921605,-2,943,1880,10
118728171134,118728171131,-3,1121,1908,10
118729796932,118729796930,-2,626,1541,10
118732947025,118732947022,-3,1072,1628,10
118734618677,118734618676,-1,1304,1830,10
118736662577,118736662580,3,6724,28987,10
118745235882,118745235885,3,1919,1481,10
118745510045,118745510042,-3,1099,2104,10
118747166083,118747166080,-3,1288,1833,10
118748099298,118748099299,1,1521,1391,10
118751804579,118751804577,-2,1182,1698,10
118755955179,118755955179,0,1267,2355,10
118756016933,118756016931,-2,1028,1188,10
118756480421,118756480419,-2,776,1210,10
118757610857,118757610854,-3,1488,2029,10
118762827437,118762827437,0,1122,1144,10
118769728378,118769728374,-4,767,1381,10
118770292895,118770292894,-1,1302,2037,10
118775413434,118775413431,-3,1649,2195,10
118775915031,118775915029,-2,1073,1876,10
118778648455,118778648453,-2,799,1611,10
118782257594,118782257594,0,1938,2427,10
118788834890,118788834886,-4,1089,2141,10
118789062263,118789062262,-1,1285,1576,10
118791557135,118791557136,1,745,2144,10
118793484946,118793484946,0,1112,1827,10
118795427623,118795427622,-1,1042,1441,10
118795673199,118795673199,0,1334,1726,10
118795866708,118795866726,18,720,1213,10
118800029182,118800029177,-5,2711,7639,10
118803130499,118803130498,-1,1257,2409,10
118803243918,118803243917,-1,1019,1508,10
118806550891,118806550890,-1,999,1586,10
118807495213,118807495210,-3,1332,2764,10
118808808642,118808808641,-1,1201,2353,10
118809764770,118809764767,-3,1353,2093,10
118815168666,118815168666,0,1499,1805,10
118817178405,118817178404,-1,1373,2029,10
118817896893,118817896893,0,1153,1641,10
118821539649,118821539649,0,1767,2591,10
118824179037,118824179038,1,3570,3276,10
118825167294,118825167293,-1,1294,1993,10
118825525753,118825525751,-2,1203,1680,10
118826570651,118826570650,-1,1309,2506,10
118826996215,118826996214,-1,1108,1822,10
118827995778,118827995778,0,1081,1427,10
118828324313,118828324334,21,823,1192,10
118839151641,118839151638,-3,881,1709,10
118840190979,118840190977,-2,1132,1633,10
118844257538,118844257539,1,1775,3182,10
118847668082,118847668081,-1,826,1639,10
118852819819,118852819816,-3,1280,2177,10
118852847290,118852847289,-1,1012,1860,10
118855912647,118855912641,-6,1102,1997,10
118858556201,118858556199,-2,1205,2117,10
118861413381,118861413379,-2,1312,2253,10
118864621494,118864621511,17,1982,1352,10
118865858907,118865858906,-1,1142,1486,10
118868531423,118868531422,-1,1164,2179,10
118868556979,118868556979,0,785,1209,10
118875163483,118875163482,-1,1345,2246,10
118876776405,118876776404,-1,1409,1935,10
118879329454,118879329456,2,1574,1955,10
118880046423,118880046422,-1,1490,1628,10
118880134765,118880134761,-4,1224,1612,10
118884350851,118884350854,3,1725,1203,10
118887349746,118887349743,-3,1467,2067,10
118891115502,118891115501,-1,740,1633,10
118891345358,118891345357,-1,1349,1696,10
118895306095,118895306092,-3,1303,1797,10
118896270885,118896270885,0,1198,1920,10
118903493238,118903493238,0,947,2022,10
118904534383,118904534382,-1,599,965,10
118908714918,118908714918,0,899,1642,10
118910198574,118910198573,-1,710,2101,10
118912108105,118912108104,-1,628,974,10
118916311266,118916311265,-1,1173,1921,10
118918299183,118918299182,-1,1119,1449,10
118922485378,118922485377,-1,1092,1912,10
118922985366,118922985367,1,996,1728,10
118923836815,118923836814,-1,1755,2742,10
118924582169,118924582166,-3,1341,1984,10
118929268039,118929268034,-5,1293,2381,10
118929865946,118929865927,-19,1341,1965,10
118930948718,118930948717,-1,697,953,10
118931376530,118931376528,-2,1494,2119,10
118931608057,118931608046,-11,1017,1641,10
118938032529,118938032525,-4,608,1598,10
118938845522,118938845522,0,1087,2347,10
118940431552,118940431553,1,758,1401,10
118943466089,118943466089,0,3194,3935,10
118946645050,118946645054,4,6157,4306,10
118951166776,118951166774,-2,1224,1890,10
118951245954,118951245950,-4,1067,2930,10
118951350281,118951350270,-11,1324,2234,10
118951623351,118951623353,2,1295,2297,10
118954214774,118954214770,-4,1281,2059,10
118954917858,118954917857,-1,1308,2327,10
118957079496,118957079495,-1,1261,2148,10
118958385548,118958385542,-6,1125,2124,10
118958665465,118958665463,-2,1356,2403,10
118961191481,118961191480,-1,1505,2873,10
118966399765,118966399763,-2,941,2261,10
118967850279,118967850278,-1,979,1771,10
118971296846,118971296847,1,1095,2150,10
118977977114,118977977112,-2,864,1618,10
118978868046,118978868043,-3,929,1807,10
118983763561,118983763559,-2,2242,2349,10
118987451295,118987451294,-1,820,2316,10
118988522234,118988522234,0,1651,2206,10
118988615569,118988615567,-2,1217,1735,10
118989024485,118989024483,-2,643,777,10
118990268182,118990268179,-3,1303,2406,10
118991721113,118991721111,-2,1082,1960,10
118994799478,118994799478,0,1175,1764,10
118996776117,118996776116,-1,1905,2152,10
118999577209,118999577207,-2,1059,2028,10
119002390101,119002390098,-3,776,1599,10
119003513521,119003513520,-1,1979,2919,10
119007345185,119007345181,-4,1337,3106,10
119007888074,119007888073,-1,897,1095,10
119019109003,119019109001,-2,959,1668,10
119020732313,119020732311,-2,1641,2151,10
119024718565,119024718564,-1,1296,1755,10
119025065085,119025065082,-3,1138,2007,10
119027002378,119027002385,7,12336,24573,10
119027245422,119027245421,-1,1586,2604,10
119032987570,119032987569,-1,1187,1487,10
119033694587,119033694589,2,1730,1500,10
119036378133,119036378129,-4,699,1245,10
119036543971,119036543970,-1,1347,1341,10
119042740822,119042740822,0,1540,2250,10
119047034337,119047034344,7,2665,1369,10
119049401652,119049401650,-2,824,1317,10
119049515347,119049515345,-2,1178,1656,10
119051474756,119051474757,1,1513,1375,10
119054185086,119054185084,-2,1435,2387,10
119055940002,119055940002,0,932,1369,10
119059074549,119059074549,0,466,800,10
119060212159,119060212157,-2,1140,1376,10
119063829620,119063829618,-2,1285,2586,10
119063953656,119063953654,-2,1172,2152,10
119064369603,119064369597,-6,1380,2509,10
119067206476,119067206474,-2,1382,1163,10
119067812859,119067812858,-1,911,1922,10
119068319760,119068319766,6,254,1290,10
119070128230,119070128225,-5,1268,4321,10
119071999513,119071999513,0,1125,2177,10
119072080871,119072080869,-2,1385,1873,10
119076509514,119076509513,-1,1243,1708,10
119081510567,119081510566,-1,1201,2570,10
119084689553,119084689549,-4,1330,2235,10
119089467176,119089467174,-2,968,1216,10
119092637694,119092637695,1,991,1929,10
119093813498,119093813498,0,1593,2177,10
119093998058,119093998064,6,3603,1186,10
119094862830,119094862829,-1,1121,2033,10
119097283239,119097283238,-1,1205,2201,10
119098139925,119098139923,-2,1166,2066,10
119098515210,119098515199,-11,1173,1848,10
119099433242,119099433244,2,1353,1537,10
119100850778,119100850774,-4,928,1917,10
119102363016,119102363012,-4,1132,1662,10
119103354110,119103354106,-4,946,1518,10
119104917133,119104917131,-2,1736,2036,10
119111194297,119111194318,21,797,1921,10
119111537874,119111537892,18,1111,2035,10
119114800287,119114800285,-2,1488,2178,10
119114997103,119114997104,1,1135,2204,10
119116546362,119116546363,1,1104,1734,10
119122825964,119122825966,2,1202,1845,10
119125262190,119125262189,-1,1008,1684,10
119126671696,119126671695,-1,1101,1856,10
119128076274,119128076273,-1,1438,2232,10
119129422543,119129422541,-2,1014,1444,10
119130895875,119130895872,-3,1181,3132,10
119131939642,119131939642,0,1321,2233,10
119133208537,119133208533,-4,961,2228,10
119135010483,119135010482,-1,1040,1916,10
119137098257,119137098257,0,1271,1906,10
119140557045,119140557043,-2,1631,3716,10
119141060161,119141060160,-1,1070,1495,10
119141476170,119141476170,0,1300,1624,10
119143691273,119143691271,-2,1648,2579,10
119149459502,119149459502,0,1229,1715,10
119149504048,119149504047,-1,1278,1918,10
119159029720,119159029721,1,1391,1461,10
