fTNear,fTFar,fDelT,fQNear,fQFar,d
118502617931,118502617939,8,66,85,-30
850402,850407,5,2230,1491,-30
2659582,2659587,5,2108,1018,-30
4782756,4782761,5,2312,1446,-30
5460014,5460020,6,1499,1563,-30
5967718,5967738,20,2564,1375,-30
6692958,6692965,7,4939,2019,-30
6969332,6969336,4,2759,1465,-30
9195673,9195678,5,2701,1999,-30
13128716,13128720,4,1710,1122,-30
14368488,14368493,5,2496,1314,-30
16530718,16530722,4,1583,1217,-30
17967508,17967511,3,2330,1496,-30
24862180,24862185,5,2649,1134,-30
27226759,27226764,5,3072,1459,-30
28399692,28399687,-5,1123,1371,-30
28755275,28755281,6,2001,1162,-30
29696774,29696780,6,2161,1683,-30
29872637,29872641,4,2216,1480,-30
33017602,33017605,3,1761,1084,-30
33946994,33946999,5,1873,1286,-30
34523893,34523896,3,1775,1346,-30
37230770,37230773,3,2807,1655,-30
38327319,38327318,-1,1116,1265,-30
39818636,39818642,6,2468,1147,-30
40985814,40985818,4,2662,1169,-30
43493394,43493401,7,1747,1089,-30
45709985,45709989,4,3487,1578,-30
54187650,54187652,2,2225,1596,-30
54750425,54750429,4,2369,1334,-30
55578195,55578199,4,2449,1138,-30
64640545,64640547,2,2068,1183,-30
70001576,70001581,5,2838,1327,-30
72047091,72047100,9,1965,1158,-30
72267211,72267206,-5,1212,4624,-30
72946157,72946162,5,1746,1548,-30
74284498,74284502,4,2231,1067,-30
76342599,76342603,4,1538,846,-30
76369707,76369714,7,3399,1037,-30
77077426,77077431,5,2413,1483,-30
78616949,78616951,2,1802,1715,-30
80367029,80367033,4,2919,1839,-30
80456966,80456970,4,2250,866,-30
82741920,82741925,5,2186,1083,-30
86248730,86248735,5,2650,1739,-30
86623242,86623246,4,1208,594,-30
87378123,87378125,2,1828,1440,-30
88418316,88418321,5,3008,1187,-30
92385457,92385461,4,2602,1438,-30
99317645,99317653,8,3641,1176,-30
100620369,100620374,5,1286,1410,-30
103089586,103089586,0,1104,1532,-30
107540974,107540979,5,1126,975,-30
108772433,108772439,6,2372,1234,-30
108883790,108883770,-20,1556,1386,-30
109246561,109246565,4,1418,1639,-30
110407642,110407645,3,2300,1312,-30
118677171,118677185,14,457,2421,-30
121029557,121029562,5,2049,923,-30
121722754,121722758,4,1385,794,-30
123381941,123381947,6,1791,1009,-30
128737175,128737178,3,2382,1212,-30
128971175,128971178,3,1072,822,-30
131920543,131920548,5,2449,1954,-30
132002293,132002298,5,1637,932,-30
135757587,135757593,6,2234,1423,-30
136081248,136081253,5,3343,1772,-30
137576882,137576885,3,1995,1358,-30
137766114,137766119,5,2158,1373,-30
141613945,141613950,5,2896,2155,-30
142569022,142569029,7,2060,1033,-30
143175241,143175246,5,2461,1391,-30
146599503,146599509,6,2303,976,-30
146724904,146724907,3,1909,1172,-30
148945829,148945835,6,3167,957,-30
149268918,149268898,-20,2493,1819,-30
153085786,153085793,7,3089,1141,-30
154066321,154066326,5,2259,1214,-30
157153178,157153182,4,2063,1456,-30
158780531,158780534,3,1154,1240,-30
158948958,158948940,-18,2135,1261,-30
163204317,163204321,4,2173,1544,-30
166001378,166001379,1,1507,946,-30
172894322,172894325,3,2185,1116,-30
174187697,174187702,5,2334,833,-30
179498383,179498388,5,2338,1460,-30
182659045,182659050,5,1159,960,-30
184893549,184893566,17,884,3536,-30
185205662,185205667,5,1764,1161,-30
188080444,188080450,6,2098,1462,-30
189449098,189449104,6,1893,1054,-30
190345496,190345498,2,6609,22945,-30
191103937,191103942,5,3256,1769,-30
192176558,192176562,4,1385,1261,-30
195871300,195871303,3,1958,1020,-30
196617194,196617197,3,2010,1616,-30
198960303,198960298,-5,1388,4163,-30
199374538,199374540,2,1796,1225,-30
203938750,203938754,4,2132,1323,-30
204123363,204123369,6,2709,1402,-30
205066363,205066362,-1,1112,2012,-30
205711845,205711851,6,1894,916,-30
206320086,206320089,3,2013,1211,-30
209042264,209042270,6,2541,1309,-30
218002849,218002853,4,2305,1443,-30
218588343,218588347,4,2486,1127,-30
219667587,219667567,-20,1202,820,-30
226743287,226743291,4,1067,995,-30
226855590,226855595,5,2332,1547,-30
229387409,229387414,5,4661,2248,-30
232696273,232696279,6,3135,1449,-30
233364605,233364611,6,2092,1183,-30
235455527,235455533,6,2502,1704,-30
241820051,241820055,4,1859,1443,-30
243002862,243002866,4,1329,1145,-30
244325075,244325079,4,2762,1173,-30
246225806,246225810,4,3485,1759,-30
246912706,246912708,2,2186,1332,-30
248162917,248162921,4,1980,1014,-30
251218864,251218870,6,2312,1106,-30
251758637,251758641,4,2189,1259,-30
258001667,258001670,3,1585,909,-30
260058004,260058007,3,2365,1276,-30
260786134,260786137,3,2296,1583,-30
265086169,265086175,6,1824,1232,-30
266214138,266214131,-7,1133,6233,-30
267839700,267839714,14,2179,1456,-30
269037345,269037348,3,2197,1531,-30
272007932,272007937,5,2299,1632,-30
276117334,276117338,4,1708,1303,-30
281527626,281527630,4,2134,1581,-30
283459950,283459954,4,1964,1539,-30
283748777,283748773,-4,1014,2566,-30
285107287,285107291,4,2762,1553,-30
287049933,287049935,2,1294,1140,-30
292505905,292505911,6,1964,1424,-30
299858794,299858798,4,1475,1607,-30
299905769,299905775,6,1980,1064,-30
300036933,300036937,4,1648,988,-30
306620585,306620589,4,8605,5061,-30
307518178,307518183,5,2086,1038,-30
308769831,308769836,5,2615,1472,-30
311010494,311010474,-20,2147,1363,-30
311805361,311805371,10,2614,1379,-30
312309030,312309011,-19,1880,880,-30
317417872,317417877,5,1666,1075,-30
322860018,322860022,4,1155,1016,-30
325780033,325780037,4,2222,1336,-30
326083370,326083376,6,2802,1624,-30
326539750,326539755,5,2846,1579,-30
327236254,327236258,4,1298,1206,-30
327557818,327557835,17,1081,629,-30
329940558,329940557,-1,2569,2825,-30
331116646,331116649,3,1617,1364,-30
335321837,335321841,4,2535,1288,-30
338483870,338483874,4,2618,1794,-30
343918174,343918180,6,14901,20235,-30
345710065,345710069,4,2581,1417,-30
345963356,345963340,-16,1369,309,-30
351035110,351035114,4,635,939,-30
355369606,355369613,7,6034,1828,-30
355611005,355611009,4,1634,1156,-30
356580638,356580643,5,1353,819,-30
357824533,357824538,5,2687,1374,-30
358146277,358146256,-21,3143,1800,-30
362681430,362681435,5,2712,1653,-30
363266842,363266846,4,1364,952,-30
364127586,364127574,-12,97,3391,-30
368146957,368146961,4,1504,1255,-30
381218034,381218035,1,1723,1241,-30
383286883,383286881,-2,1091,2399,-30
383944432,383944436,4,1829,1212,-30
387880393,387880398,5,2072,1086,-30
391968176,391968182,6,3421,1604,-30
392532350,392532355,5,1773,1523,-30
394356694,394356699,5,1996,1522,-30
395737081,395737087,6,2383,1334,-30
398541485,398541491,6,2304,1390,-30
402826285,402826289,4,1745,1101,-30
406806763,406806770,7,2167,1625,-30
409342965,409342973,8,2523,1605,-30
410648610,410648614,4,2521,1170,-30
414931201,414931206,5,2361,1133,-30
419967762,419967765,3,728,973,-30
423653751,423653751,0,1154,2014,-30
424564458,424564464,6,5945,2963,-30
427683878,427683878,0,7260,10314,-30
431672613,431672618,5,2439,1353,-30
434434118,434434122,4,1820,1007,-30
440487414,440487420,6,2864,1494,-30
442554858,442554862,4,2023,1120,-30
442746878,442746884,6,3114,1292,-30
448055589,448055594,5,2402,1237,-30
448484045,448484067,22,2064,1403,-30
448803212,448803195,-17,1788,914,-30
450570842,450570847,5,2348,1645,-30
452800437,452800442,5,1995,938,-30
455446808,455446814,6,2292,1045,-30
459394747,459394751,4,2666,2156,-30
459707288,459707293,5,24110,18208,-30
462660493,462660499,6,2337,1591,-30
468723870,468723874,4,2046,1525,-30
469163501,469163505,4,2081,1189,-30
469869403,469869407,4,1806,1187,-30
476519780,476519785,5,2734,1767,-30
478599920,478599907,-13,181,2195,-30
479608615,479608621,6,2974,1261,-30
480335428,480335434,6,3084,1616,-30
481692678,481692685,7,3347,1603,-30
484513492,484513498,6,2896,1930,-30
486510248,486510254,6,2425,1321,-30
489782204,489782207,3,1932,1097,-30
490695611,490695595,-16,2680,1681,-30
492911642,492911648,6,2727,1161,-30
493537682,493537689,7,1831,1387,-30
494270622,494270627,5,2965,1454,-30
495768037,495768041,4,2789,1238,-30
496017699,496017714,15,2812,1091,-30
496422726,496422713,-13,821,385,-30
496831231,496831235,4,4105,2465,-30
500371126,500371134,8,2309,1304,-30
503416630,503416636,6,2200,917,-30
506035790,506035795,5,2362,1114,-30
509027297,509027294,-3,1118,2080,-30
511975176,511975177,1,2040,2003,-30
514490742,514490747,5,1909,1674,-30
514807398,514807399,1,1573,2219,-30
515063132,515063134,2,1509,1141,-30
518318510,518318514,4,1652,1396,-30
519420020,519420026,6,2256,948,-30
522504252,522504259,7,1887,966,-30
524857556,524857555,-1,1070,1275,-30
525305959,525305975,16,2131,1110,-30
528029963,528029957,-6,910,2989,-30
528119089,528119094,5,2080,1181,-30
530291978,530291982,4,1285,1075,-30
533706175,533706169,-6,1156,4357,-30
543950251,543950255,4,2396,1078,-30
553163495,553163503,8,1615,1004,-30
554547526,554547507,-19,1558,1268,-30
556053398,556053404,6,3761,1696,-30
557367810,557367814,4,1504,1195,-30
558414051,558414055,4,2670,1659,-30
559461146,559461153,7,1370,1198,-30
562347065,562347070,5,1840,923,-30
564264842,564264844,2,2853,1411,-30
565580603,565580607,4,1629,1440,-30
567843893,567843898,5,2056,2411,-30
573142741,573142743,2,1704,1699,-30
575749734,575749737,3,1541,1006,-30
581958747,581958754,7,1445,1168,-30
582589931,582589937,6,2212,1376,-30
583093906,583093913,7,1886,1152,-30
583971906,583971911,5,1696,1334,-30
584379838,584379841,3,1921,1250,-30
585248320,585248318,-2,1341,2134,-30
590306988,590306994,6,2012,1389,-30
590935838,590935817,-21,2033,1097,-30
591197942,591197949,7,3450,1761,-30
593084100,593084107,7,1791,1012,-30
593832720,593832723,3,2494,1526,-30
598499557,598499562,5,2527,1257,-30
599948050,599948054,4,1219,879,-30
600716930,600716933,3,1774,1186,-30
604855506,604855511,5,2454,1422,-30
609775657,609775661,4,2714,1526,-30
612102886,612102892,6,1720,1023,-30
612299493,612299473,-20,1493,552,-30
618155105,618155110,5,2981,1724,-30
619084998,619085004,6,1313,670,-30
623870451,623870455,4,2017,1328,-30
624233670,624233688,18,1666,838,-30
624717392,624717408,16,3322,961,-30
629247114,629247119,5,2361,1502,-30
629493374,629493381,7,2307,1260,-30
630760686,630760691,5,1656,941,-30
631397594,631397578,-16,2510,790,-30
631465454,631465459,5,3001,1708,-30
632096397,632096401,4,2002,1246,-30
632554174,632554156,-18,2400,1092,-30
632599024,632599035,11,12927,28721,-30
633874294,633874297,3,2360,1709,-30
633936260,633936262,2,1784,1309,-30
634709530,634709535,5,2051,1880,-30
637986145,637986150,5,3313,2280,-30
642249739,642249745,6,2037,1143,-30
650333349,650333349,0,3880,5493,-30
653059514,653059517,3,2166,1461,-30
659352938,659352943,5,2140,1383,-30
661777958,661777964,6,2789,1628,-30
662081221,662081226,5,3931,1465,-30
665757130,665757134,4,2442,1564,-30
667786608,667786614,6,2532,1095,-30
674394346,674394351,5,1611,1387,-30
679117578,679117583,5,1869,1076,-30
679659295,679659301,6,2029,1125,-30
682898110,682898116,6,4882,1248,-30
684862186,684862191,5,3090,1809,-30
685306881,685306882,1,1610,2191,-30
689112246,689112251,5,2089,1074,-30
689140134,689140114,-20,826,284,-30
691190716,691190721,5,2190,1412,-30
691663822,691663828,6,2590,1592,-30
692854118,692854114,-4,824,1256,-30
693955849,693955856,7,3541,2230,-30
700321202,700321205,3,2393,1421,-30
703979194,703979198,4,2409,1239,-30
704391567,704391573,6,1664,1033,-30
705716269,705716249,-20,941,784,-30
707984992,707984994,2,1766,1283,-30
711028007,711028013,6,2846,1583,-30
716196861,716196865,4,2116,1022,-30
718120134,718120138,4,1794,1176,-30
719384746,719384751,5,2505,1362,-30
722019447,722019453,6,3171,1546,-30
726289620,726289626,6,2194,1212,-30
732384094,732384098,4,1978,1547,-30
737138594,737138600,6,2722,1782,-30
739681186,739681192,6,2478,1475,-30
739931110,739931115,5,1998,1058,-30
742264983,742264988,5,3037,1612,-30
742596835,742596841,6,1752,1129,-30
744025454,744025446,-8,1182,2685,-30
744150932,744150935,3,2485,1212,-30
744422735,744422739,4,1726,1428,-30
749569709,749569715,6,3172,1245,-30
750345737,750345741,4,1711,960,-30
750524032,750524035,3,1478,1130,-30
754291220,754291226,6,2077,1307,-30
755387953,755387957,4,1648,851,-30
760637446,760637451,5,2229,996,-30
760778838,760778843,5,2227,1370,-30
766786178,766786172,-6,1595,8797,-30
769962169,769962175,6,1993,958,-30
774491344,774491351,7,1932,945,-30
781310834,781310839,5,4337,3183,-30
785934782,785934786,4,2418,1736,-30
789460630,789460634,4,3080,1618,-30
789876407,789876386,-21,848,216,-30
802170808,802170813,5,2237,1505,-30
806337574,806337578,4,2484,1622,-30
806602659,806602665,6,1724,1356,-30
810148613,810148610,-3,20049,11389,-30
812825770,812825775,5,2608,1605,-30
814175904,814175909,5,1930,1012,-30
815515569,815515574,5,2513,1364,-30
816120184,816120200,16,1734,1033,-30
819222054,819222058,4,2836,1323,-30
820712878,820712883,5,3661,1601,-30
824564792,824564798,6,2134,1205,-30
824997422,824997442,20,2332,1320,-30
826756827,826756834,7,2710,947,-30
827654408,827654412,4,2641,1626,-30
830557778,830557779,1,1000,1080,-30
832318128,832318133,5,1795,1233,-30
839555811,839555814,3,2209,1464,-30
840126911,840126890,-21,2289,1466,-30
841972251,841972258,7,1202,967,-30
843102166,843102171,5,2322,1344,-30
843394606,843394612,6,2076,1110,-30
843605565,843605545,-20,3215,1373,-30
844173238,844173242,4,1879,1253,-30
850738496,850738501,5,20318,34652,-30
852886507,852886511,4,2576,1453,-30
854082466,854082462,-4,2117,4915,-30
860754701,860754707,6,2348,1444,-30
861188801,861188796,-5,2570,9161,-30
861390539,861390523,-16,599,575,-30
862836346,862836349,3,1893,2113,-30
863895293,863895298,5,2563,1824,-30
864774126,864774130,4,2317,1077,-30
865555954,865555957,3,1589,1055,-30
865777127,865777112,-15,1594,835,-30
866236716,866236718,2,2046,2139,-30
866763533,866763537,4,1854,1078,-30
872564026,872564031,5,2795,1492,-30
877997217,877997218,1,2069,2032,-30
881417873,881417878,5,2179,977,-30
884143467,884143472,5,2091,1895,-30
889109979,889109985,6,2392,1145,-30
891569914,891569918,4,1987,1582,-30
894978870,894978874,4,2651,1584,-30
895264175,895264179,4,1875,1667,-30
896953473,896953479,6,2385,1991,-30
912754770,912754774,4,1714,1108,-30
924190344,924190350,6,2239,1851,-30
929285942,929285946,4,1799,1142,-30
929750395,929750401,6,2859,1530,-30
930817530,930817545,15,807,3391,-30
931113024,931113031,7,2690,1292,-30
934792947,934792951,4,2331,1049,-30
938208438,938208446,8,2736,1583,-30
938334465,938334469,4,1862,1159,-30
939753276,939753281,5,2017,1371,-30
941173251,941173257,6,1676,1072,-30
943570226,943570230,4,1881,1326,-30
944547598,944547576,-22,1277,770,-30
948798426,948798430,4,2877,1312,-30
949059838,949059843,5,2639,1680,-30
950478300,950478302,2,2555,1946,-30
954185899,954185889,-10,1093,668,-30
957086046,957086051,5,2570,1713,-30
957205452,957205457,5,3087,1418,-30
963197801,963197806,5,2832,1980,-30
964918826,964918831,5,2096,1120,-30
965440390,965440372,-18,2683,1309,-30
968038314,968038319,5,1608,938,-30
969285769,969285774,5,2571,1070,-30
973316595,973316601,6,1665,1162,-30
977898317,977898322,5,1894,1220,-30
979397648,979397654,6,880,1082,-30
980076990,980076995,5,2781,1419,-30
982692899,982692905,6,2162,1214,-30
983196034,983196018,-16,2040,1034,-30
984613426,984613436,10,2934,1080,-30
986048220,986048226,6,2397,1199,-30
987466171,987466175,4,2289,1629,-30
989283510,989283506,-4,952,2371,-30
992440585,992440590,5,2732,1134,-30
992880188,992880192,4,2982,1192,-30
993022113,993022119,6,2300,1535,-30
995574495,995574501,6,1198,1401,-30
997053958,997053962,4,2384,1271,-30
1001420323,1001420327,4,1952,1276,-30
1006706744,1006706749,5,2215,1047,-30
1009563361,1009563346,-15,3650,1186,-30
1011327154,1011327159,5,1809,1847,-30
1019531254,1019531259,5,1099,503,-30
1023562314,1023562309,-5,1849,6482,-30
1025712701,1025712706,5,1950,1240,-30
1030464208,1030464214,6,3226,1162,-30
1042462957,1042462962,5,1866,1064,-30
1046692619,1046692623,4,1727,1268,-30
1050135489,1050135494,5,2381,1026,-30
1051817198,1051817202,4,1813,1045,-30
1053879453,1053879450,-3,858,203,-30
1055192907,1055192910,3,1957,1060,-30
1055288338,1055288354,16,1215,382,-30
1058186490,1058186494,4,2590,1248,-30
1058280065,1058280070,5,1774,1264,-30
1059411984,1059411989,5,2334,1521,-30
1062940818,1062940822,4,2324,1265,-30
1064593091,1064593094,3,38367,34851,-30
1066067804,1066067810,6,3784,1483,-30
1066174459,1066174464,5,2182,1262,-30
1068450053,1068450060,7,2640,1444,-30
1074380454,1074380457,3,2358,1369,-30
1077301081,1077301086,5,1923,1232,-30
1077993729,1077993747,18,3236,1223,-30
1078677782,1078677788,6,2216,1839,-30
1080307323,1080307327,4,1484,1327,-30
1080692934,1080692937,3,2037,1237,-30
1080718650,1080718655,5,2724,1620,-30
1081540731,1081540734,3,2715,1745,-30
1081719762,1081719768,6,2677,1787,-30
1085839250,1085839256,6,2133,1763,-30
1086146683,1086146688,5,1789,1350,-30
1087342621,1087342627,6,2028,1295,-30
1091143089,1091143089,0,2386,2980,-30
1091962589,1091962595,6,1771,866,-30
1093161242,1093161241,-1,2262,4026,-30
1094157806,1094157811,5,1819,1257,-30
1095051642,1095051646,4,2046,1783,-30
1103015854,1103015859,5,2052,753,-30
1105602586,1105602592,6,2136,1553,-30
1106011154,1106011161,7,2905,1366,-30
1106368666,1106368670,4,2311,1252,-30
1108330349,1108330354,5,2534,1261,-30
1110472838,1110472843,5,2774,1232,-30
1116419455,1116419461,6,1624,1201,-30
1122727115,1122727118,3,1993,1248,-30
1124955086,1124955092,6,2201,1258,-30
1125052298,1125052312,14,1335,1287,-30
1125272420,1125272426,6,2551,1573,-30
1125675706,1125675709,3,2785,998,-30
1129142904,1129142909,5,1659,973,-30
1137248554,1137248561,7,2044,957,-30
1148128212,1148128216,4,2264,1145,-30
1148284826,1148284831,5,2605,1800,-30
1148357709,1148357714,5,2265,1150,-30
1149443386,1149443391,5,1970,1549,-30
1153852814,1153852821,7,2811,1103,-30
1158836446,1158836452,6,2917,1003,-30
1159382165,1159382171,6,880,448,-30
1160769287,1160769290,3,2341,771,-30
1164445504,1164445510,6,2379,1269,-30
1169933254,1169933259,5,1538,1313,-30
1171695901,1171695898,-3,1257,3623,-30
1176279537,1176279542,5,2177,1302,-30
1177024553,1177024557,4,3629,2085,-30
1178061837,1178061843,6,2329,1142,-30
1179289458,1179289466,8,419,316,-30
1179814982,1179814981,-1,848,1292,-30
1183515030,1183515034,4,1307,1169,-30
1189599219,1189599223,4,2175,1286,-30
1192090126,1192090131,5,1688,887,-30
1195305597,1195305604,7,2660,1265,-30
1200316735,1200316741,6,2628,1402,-30
1200675610,1200675616,6,2774,1344,-30
1200742839,1200742841,2,613,485,-30
1206572708,1206572714,6,3494,1562,-30
1206776469,1206776474,5,1806,1323,-30
1208622875,1208622880,5,2222,955,-30
1209905093,1209905098,5,2250,1764,-30
1217008610,1217008616,6,2100,1519,-30
1217550728,1217550732,4,2236,1587,-30
1221349545,1221349552,7,2038,1948,-30
1221726565,1221726568,3,1827,1234,-30
1221816989,1221816994,5,2526,968,-30
1228602379,1228602384,5,2251,1333,-30
1231176125,1231176131,6,3280,1761,-30
1231695478,1231695482,4,2072,1250,-30
1231872081,1231872084,3,1348,1267,-30
1232441927,1232441932,5,2647,1433,-30
1233601727,1233601731,4,1203,261,-30
1234191220,1234191226,6,2994,1330,-30
1235628791,1235628789,-2,1118,1757,-30
1241253210,1241253214,4,2630,1347,-30
1244712026,1244712031,5,2732,1985,-30
1245735359,1245735364,5,2907,1486,-30
1253115378,1253115383,5,2519,1434,-30
1257038930,1257038936,6,2514,1488,-30
1258572111,1258572105,-6,2077,1175,-30
1258671260,1258671263,3,2802,1443,-30
1258751497,1258751502,5,2738,1611,-30
1258969195,1258969199,4,1349,1226,-30
1260635814,1260635813,-1,1062,1712,-30
1261354942,1261354949,7,2523,1705,-30
1267766371,1267766374,3,2115,1538,-30
1271560846,1271560853,7,2481,2021,-30
1273217779,1273217785,6,2854,1320,-30
1279158825,1279158831,6,1352,1043,-30
1279846972,1279846974,2,1656,748,-30
1284126131,1284126126,-5,1359,2757,-30
1284954550,1284954554,4,1400,1179,-30
1285646014,1285646017,3,8771,6743,-30
1287057160,1287057162,2,2659,1209,-30
1288132109,1288132114,5,2107,1461,-30
1288553435,1288553441,6,4016,1640,-30
1290575772,1290575777,5,2825,1510,-30
1291961833,1291961837,4,2366,1736,-30
1292593027,1292593011,-16,2739,735,-30
1293938329,1293938335,6,1170,809,-30
1296008826,1296008830,4,2400,1665,-30
1298470826,1298470834,8,2106,1158,-30
1301710489,1301710482,-7,1290,4735,-30
1309567405,1309567411,6,2300,1497,-30
1312481623,1312481630,7,2879,1451,-30
1316741061,1316741066,5,2602,1740,-30
1318517266,1318517270,4,1077,604,-30
1321031598,1321031603,5,2003,1373,-30
1321661445,1321661449,4,2569,1514,-30
1324145062,1324145040,-22,1423,1106,-30
1324961369,1324961376,7,13429,26575,-30
1325609346,1325609340,-6,1516,5482,-30
1329394638,1329394639,1,1885,1717,-30
1333597754,1333597747,-7,1590,7114,-30
1333660686,1333660689,3,1667,962,-30
1339580979,1339580985,6,2076,1167,-30
1342986858,1342986855,-3,1407,2299,-30
1348504689,1348504690,1,1137,1737,-30
1349485681,1349485689,8,1966,1309,-30
1362721926,1362721932,6,3758,1869,-30
1366407191,1366407187,-4,1229,1944,-30
1366503169,1366503171,2,2214,1622,-30
1369241209,1369241212,3,3269,1789,-30
1374811129,1374811136,7,1898,1631,-30
1380731859,1380731862,3,3142,1362,-30
1381235212,1381235215,3,2732,1298,-30
1388836639,1388836643,4,1996,1429,-30
1390800172,1390800177,5,4327,1804,-30
1393641400,1393641406,6,2316,1006,-30
1393966099,1393966095,-4,909,3392,-30
1394985622,1394985627,5,2777,1662,-30
1399209176,1399209180,4,2425,1131,-30
1401297091,1401297094,3,5772,5634,-30
1402047123,1402047129,6,2413,1523,-30
1405163477,1405163483,6,2508,1548,-30
1408851682,1408851686,4,1905,1441,-30
1409206687,1409206668,-19,1535,1201,-30
1410954269,1410954275,6,2418,1834,-30
1415257510,1415257514,4,3207,1068,-30
1417301946,1417301954,8,2144,1172,-30
1418362309,1418362313,4,3090,1963,-30
1420975563,1420975567,4,1581,1280,-30
1428533598,1428533602,4,22922,23768,-30
1428700119,1428700124,5,1842,1750,-30
1433024671,1433024674,3,2297,1634,-30
1433876232,1433876237,5,2771,962,-30
1434882678,1434882682,4,2519,1907,-30
1439946316,1439946312,-4,19647,16823,-30
1440660734,1440660739,5,1820,1611,-30
1441289678,1441289682,4,1713,1133,-30
1441492149,1441492171,22,2284,907,-30
1444192838,1444192845,7,2136,800,-30
1447928694,1447928701,7,3069,1357,-30
1452011253,1452011257,4,2924,1270,-30
1455325981,1455325985,4,2327,1625,-30
1458526138,1458526143,5,3369,1278,-30
1461389886,1461389890,4,1801,1306,-30
1466530075,1466530082,7,2543,1760,-30
1470920790,1470920797,7,1722,1242,-30
1476259089,1476259094,5,2412,1364,-30
1478726458,1478726461,3,2477,1130,-30
1480450355,1480450369,14,1138,641,-30
1480484953,1480484959,6,9342,2223,-30
1484695359,1484695363,4,1826,1283,-30
1488639138,1488639143,5,2183,1565,-30
1490174918,1490174922,4,2779,1324,-30
1490273122,1490273106,-16,3041,1328,-30
1491551587,1491551591,4,1225,852,-30
1495941767,1495941772,5,2453,1244,-30
1496080190,1496080196,6,1701,1334,-30
1497239569,1497239573,4,2035,1523,-30
1502390608,1502390613,5,2026,1625,-30
1505991668,1505991673,5,2797,1640,-30
1506549542,1506549547,5,1801,1221,-30
1512047626,1512047632,6,2931,1805,-30
1514150314,1514150320,6,1962,857,-30
1516349834,1516349838,4,2428,1377,-30
1516616335,1516616352,17,764,322,-30
1518130645,1518130650,5,1671,1538,-30
1518834306,1518834312,6,2219,949,-30
1522122406,1522122411,5,1246,715,-30
1524793618,1524793627,9,2310,1617,-30
1525306428,1525306433,5,2973,1201,-30
1526133523,1526133526,3,1814,1237,-30
1531341817,1531341821,4,2261,1410,-30
1534463618,1534463613,-5,1546,6292,-30
1539811512,1539811517,5,1982,1676,-30
1541425729,1541425734,5,1941,1307,-30
1543398265,1543398270,5,1766,1216,-30
1545795378,1545795382,4,2634,1362,-30
1549201639,1549201637,-2,1163,1974,-30
1549493889,1549493894,5,2348,1178,-30
1549565877,1549565880,3,1457,1087,-30
1549796505,1549796510,5,2424,1582,-30
1549892112,1549892118,6,2084,1141,-30
1550521876,1550521882,6,2326,1352,-30
1554392486,1554392491,5,2517,1091,-30
1567511040,1567511046,6,1937,1043,-30
1570671614,1570671619,5,1452,939,-30
1575573692,1575573698,6,2310,1485,-30
1577039582,1577039586,4,2475,1047,-30
1579087436,1579087441,5,4308,2892,-30
1579677502,1579677508,6,2491,1250,-30
1580319964,1580319967,3,1493,1183,-30
1588008464,1588008458,-6,1275,5007,-30
1590006687,1590006693,6,2977,1093,-30
1590327130,1590327133,3,2418,3024,-30
1594805482,1594805489,7,1748,1072,-30
1595500002,1595500007,5,2276,1107,-30
1596482371,1596482374,3,1975,1238,-30
1598996674,1598996680,6,3463,1307,-30
1601087749,1601087751,2,1934,1414,-30
1601582255,1601582261,6,2434,932,-30
1608589780,1608589784,4,2108,1355,-30
1610052315,1610052322,7,1865,1214,-30
1612075141,1612075145,4,2360,1062,-30
1613536596,1613536590,-6,2415,7123,-30
1614666633,1614666634,1,1956,1846,-30
1615546650,1615546646,-4,2039,6135,-30
1617543473,1617543478,5,1781,1220,-30
1617917129,1617917135,6,3222,1487,-30
1619114312,1619114318,6,2106,1497,-30
1620209898,1620209902,4,2499,1619,-30
1621834558,1621834563,5,1947,1375,-30
1626379217,1626379222,5,1274,1218,-30
1627593999,1627594005,6,2147,1252,-30
1629975309,1629975314,5,2002,1467,-30
1630241364,1630241371,7,3269,1729,-30
1638707163,1638707169,6,2319,1436,-30
1639502470,1639502475,5,3224,1551,-30
1639771149,1639771154,5,2705,1574,-30
1640135315,1640135304,-11,716,172,-30
1640444670,1640444675,5,2666,1622,-30
1641628806,1641628811,5,2373,1563,-30
1651442072,1651442077,5,2365,1564,-30
1660274932,1660274939,7,3735,1314,-30
1661480863,1661480869,6,3174,1212,-30
1662792038,1662792043,5,1881,1349,-30
1663889631,1663889634,3,1426,1027,-30
1664582090,1664582082,-8,1001,4841,-30
1666111451,1666111457,6,2292,1851,-30
1666340918,1666340923,5,933,759,-30
1667193109,1667193091,-18,1485,838,-30
1668417117,1668417123,6,2960,1299,-30
1672124707,1672124713,6,2218,1141,-30
1672161805,1672161809,4,2229,1499,-30
1675503680,1675503686,6,2156,1496,-30
1675851755,1675851761,6,2469,1263,-30
1678941531,1678941538,7,2504,1290,-30
1679558448,1679558452,4,2633,1381,-30
1679715666,1679715674,8,1695,1330,-30
1683319425,1683319429,4,2488,1135,-30
1684031753,1684031754,1,988,1581,-30
1687777213,1687777218,5,1947,1337,-30
1688242458,1688242461,3,2067,984,-30
1691433665,1691433671,6,3330,1609,-30
1692207496,1692207502,6,2051,1153,-30
1693227430,1693227434,4,1839,964,-30
1693674410,1693674416,6,2105,1707,-30
1699210982,1699210987,5,1891,1131,-30
1700388285,1700388283,-2,21156,13364,-30
1701489301,1701489299,-2,1277,1757,-30
1701971706,1701971707,1,2289,3173,-30
1703027336,1703027342,6,2292,1463,-30
1708725464,1708725469,5,1661,913,-30
1709378519,1709378527,8,2373,1034,-30
1709614026,1709614034,8,1221,450,-30
1711464978,1711464984,6,2096,1329,-30
1714365006,1714365011,5,1110,831,-30
1714527868,1714527869,1,860,966,-30
1717279991,1717279995,4,1990,1741,-30
1723278595,1723278601,6,3602,1421,-30
1724548339,1724548344,5,1036,1235,-30
1725340429,1725340435,6,1201,1044,-30
1726811091,1726811106,15,2441,1244,-30
1726906358,1726906363,5,1374,448,-30
1727965174,1727965178,4,2355,1172,-30
1728104241,1728104245,4,2123,1616,-30
1729454754,1729454760,6,2546,1304,-30
1730138662,1730138667,5,1541,1194,-30
1730982354,1730982357,3,2988,1999,-30
1740183903,1740183907,4,1722,1297,-30
1741427631,1741427626,-5,756,2632,-30
1747161571,1747161576,5,1937,1215,-30
1750871800,1750871806,6,3618,1699,-30
1751328891,1751328896,5,2703,1416,-30
1752920943,1752920948,5,1682,1393,-30
1753843571,1753843555,-16,1947,787,-30
1754186465,1754186461,-4,2252,6322,-30
1767324405,1767324398,-7,1678,5548,-30
1775017081,1775017085,4,2312,1181,-30
1775445371,1775445375,4,1327,698,-30
1776068137,1776068139,2,1369,1595,-30
1776904949,1776904954,5,2612,1248,-30
1777946650,1777946656,6,3417,1552,-30
1782514445,1782514449,4,2701,1233,-30
1783021169,1783021175,6,2251,1196,-30
1787575736,1787575738,2,2199,1421,-30
1788756485,1788756489,4,2331,1267,-30
1789123545,1789123547,2,1488,978,-30
1795233816,1795233819,3,1836,877,-30
1797808075,1797808081,6,3288,1649,-30
1799199506,1799199511,5,2160,1134,-30
1803621527,1803621533,6,2988,1368,-30
1804457351,1804457355,4,2258,1770,-30
1805954894,1805954899,5,2459,1671,-30
1807702170,1807702179,9,864,658,-30
1810800242,1810800263,21,134,936,-30
1812112750,1812112755,5,2158,1013,-30
1813913282,1813913283,1,2182,2315,-30
1819424933,1819424939,6,2026,1723,-30
1819876476,1819876476,0,3032,3687,-30
1820630461,1820630466,5,2731,1203,-30
1826449317,1826449322,5,2504,1564,-30
1828990268,1828990274,6,3660,1414,-30
1829510418,1829510425,7,3007,1100,-30
1830425750,1830425763,13,1544,951,-30
1835636662,1835636666,4,2377,1039,-30
1838843545,1838843543,-2,25718,8390,-30
1839542182,1839542187,5,1160,1101,-30
1840103218,1840103221,3,1432,949,-30
1840334706,1840334711,5,2039,1295,-30
1843384745,1843384742,-3,1004,1642,-30
1848205860,1848205865,5,2327,1547,-30
1850847509,1850847515,6,1709,1069,-30
1852654001,1852654005,4,1796,1542,-30
1853123313,1853123319,6,2948,1704,-30
1856328862,1856328867,5,3021,1723,-30
1857998089,1857998089,0,1535,2401,-30
1861439025,1861439031,6,1908,834,-30
1861599725,1861599730,5,4662,2292,-30
1864859279,1864859286,7,1252,962,-30
1865572715,1865572731,16,1839,1224,-30
1865918273,1865918256,-17,1862,952,-30
1867546837,1867546842,5,2413,1329,-30
1875705874,1875705879,5,2189,1487,-30
1876634999,1876635001,2,1735,1291,-30
1884263253,1884263257,4,2450,1328,-30
1886194473,1886194470,-3,1471,2860,-30
1886681007,1886681012,5,3370,1728,-30
1886912486,1886912489,3,2118,1842,-30
1891007186,1891007192,6,3371,1281,-30
1892793877,1892793872,-5,998,2238,-30
1905700110,1905700115,5,2696,1530,-30
1907482098,1907482094,-4,973,2188,-30
1908276088,1908276078,-10,69,1064,-30
1910963269,1910963273,4,1986,1100,-30
1911120665,1911120669,4,2242,1412,-30
1911746486,1911746485,-1,961,2636,-30
1913122942,1913122948,6,3025,1367,-30
1915041205,1915041210,5,2868,1466,-30
1915675102,1915675101,-1,1034,1329,-30
1918110543,1918110547,4,2586,1397,-30
1925982777,1925982783,6,2167,1201,-30
1926466589,1926466595,6,2128,1528,-30
1927385277,1927385291,14,2091,1765,-30
1927622702,1927622706,4,3088,1766,-30
1927750438,1927750456,18,3038,1474,-30
1929122146,1929122132,-14,2245,1602,-30
1930900976,1930900979,3,2408,966,-30
1931812342,1931812346,4,2121,1785,-30
1942524877,1942524883,6,2273,1395,-30
1949050978,1949050984,6,2306,1182,-30
1957672815,1957672818,3,2047,1354,-30
1962800161,1962800166,5,2515,1227,-30
1963675631,1963675638,7,2549,1311,-30
1968621521,1968621538,17,18,1932,-30
1971913004,1971913007,3,1465,1372,-30
1975448302,1975448307,5,2299,1170,-30
1976428263,1976428268,5,2515,1403,-30
1977347724,1977347730,6,3111,1096,-30
1979203915,1979203921,6,2333,1456,-30
1979925908,1979925915,7,2677,1388,-30
1981924302,1981924320,18,1395,4545,-30
1984778965,1984778971,6,1464,1362,-30
1987218887,1987218894,7,2311,1607,-30
1989322844,1989322847,3,2840,955,-30
1992196240,1992196243,3,2330,1144,-30
1993852897,1993852902,5,1447,940,-30
1994062415,1994062419,4,1790,1480,-30
1998787730,1998787734,4,2580,1622,-30
1999340373,1999340372,-1,1402,2097,-30
2000735780,2000735783,3,1981,1166,-30
2001966863,2001966868,5,2501,1346,-30
2005877605,2005877610,5,2843,1924,-30
2006155813,2006155819,6,2311,1580,-30
2006664414,2006664414,0,1420,1617,-30
2006821070,2006821076,6,1927,1532,-30
2008295562,2008295568,6,2489,1495,-30
2008421129,2008421134,5,1629,927,-30
2011726511,2011726517,6,2639,1510,-30
2011909123,2011909129,6,1854,1227,-30
2012254925,2012254929,4,2211,1539,-30
2013683058,2013683065,7,2975,2080,-30
2016772923,2016772927,4,3112,1398,-30
2019143390,2019143394,4,2132,964,-30
2022171390,2022171394,4,1720,1397,-30
2022746554,2022746558,4,1971,1589,-30
2022923866,2022923870,4,2151,1441,-30
2026663102,2026663106,4,1793,1568,-30
2027661270,2027661271,1,2641,1019,-30
2029293199,2029293202,3,1876,1320,-30
2029540365,2029540367,2,2288,1430,-30
2030708663,2030708669,6,2154,1406,-30
2036754829,2036754833,4,1990,1116,-30
2038912526,2038912533,7,2691,1482,-30
2040749922,2040749929,7,1943,1445,-30
2043489149,2043489155,6,2262,1483,-30
2045607881,2045607886,5,2006,1196,-30
2046206639,2046206639,0,867,1430,-30
2046386857,2046386862,5,2794,1558,-30
2047960445,2047960447,2,1215,1186,-30
2053987005,2053987011,6,1379,1188,-30
2057395026,2057395031,5,3185,1738,-30
2058345034,2058345038,4,2377,1436,-30
2059267142,2059267147,5,1532,863,-30
2059357805,2059357811,6,2049,942,-30
2064045869,2064045874,5,3642,1655,-30
2066531398,2066531402,4,2025,1584,-30
2068070934,2068070939,5,2196,1588,-30
2069599989,2069599982,-7,1121,2816,-30
2071485054,2071485059,5,2456,1322,-30
2074000286,2074000293,7,2325,1538,-30
2078403367,2078403371,4,1477,724,-30
2081641609,2081641614,5,2195,1281,-30
2083170706,2083170710,4,1440,707,-30
2083361221,2083361226,5,2038,1238,-30
2087600931,2087600935,4,1819,1772,-30
2088316395,2088316401,6,1587,642,-30
2093384465,2093384469,4,1561,1493,-30
2094029061,2094029081,20,3438,1599,-30
2094601713,2094601717,4,1890,1291,-30
2100837435,2100837442,7,1544,1188,-30
2101028578,2101028583,5,2054,1570,-30
2101861450,2101861451,1,1860,1254,-30
2102748159,2102748176,17,1160,853,-30
2105393941,2105393947,6,2639,1561,-30
2107019798,2107019804,6,2095,1639,-30
2109275736,2109275742,6,2100,1539,-30
2111735143,2111735148,5,1601,1163,-30
2113400031,2113400035,4,2447,1608,-30
2125385389,2125385394,5,5030,2024,-30
2125830400,2125830407,7,1404,745,-30
2128347621,2128347627,6,1797,1238,-30
2133303254,2133303258,4,2174,1101,-30
2138550060,2138550065,5,3092,1777,-30
2139087926,2139087931,5,1950,1411,-30
2146336592,2146336597,5,2890,1410,-30
2151485890,2151485895,5,1836,929,-30
2156991415,2156991418,3,1645,1653,-30
2159491061,2159491079,18,2070,1465,-30
2160268633,2160268638,5,1736,852,-30
2161619714,2161619719,5,2552,1356,-30
2164818430,2164818434,4,2441,1760,-30
2165935941,2165935946,5,2020,1260,-30
2167908828,2167908830,2,1391,1332,-30
2168437651,2168437656,5,2589,1532,-30
2168610357,2168610340,-17,1469,754,-30
2169263362,2169263364,2,1933,1221,-30
2169758684,2169758699,15,1429,1179,-30
2179344447,2179344453,6,2515,1406,-30
2181693077,2181693082,5,2780,957,-30
2182080144,2182080149,5,2629,1564,-30
2185075806,2185075810,4,1801,1188,-30
2186321870,2186321875,5,2119,1361,-30
2187104914,2187104918,4,2933,1166,-30
2187907203,2187907209,6,1615,1048,-30
2189351028,2189351034,6,2444,1249,-30
2190410294,2190410298,4,2029,1031,-30
2194818546,2194818552,6,2208,1329,-30
2197410810,2197410815,5,2529,1096,-30
2200380014,2200380018,4,1674,1149,-30
2200504669,2200504650,-19,2216,1439,-30
2202788020,2202788023,3,1257,1016,-30
2204067213,2204067218,5,2399,1215,-30
2206093480,2206093486,6,2218,1330,-30
2210411025,2210411028,3,1749,993,-30
2210806231,2210806234,3,1791,968,-30
2216081257,2216081261,4,2388,2175,-30
2217160277,2217160282,5,2432,1327,-30
2217974503,2217974507,4,1410,1054,-30
2219566956,2219566954,-2,1042,877,-30
2220823342,2220823325,-17,3040,589,-30
2222557117,2222557120,3,1677,1227,-30
2226206106,2226206111,5,1465,1491,-30
2227104257,2227104262,5,2215,1019,-30
2230311887,2230311891,4,2877,1322,-30
2230511508,2230511493,-15,1011,2188,-30
2231254636,2231254658,22,3069,1678,-30
2231316522,2231316505,-17,1128,163,-30
2231652950,2231652954,4,2272,1477,-30
2235280786,2235280792,6,2576,1123,-30
2242399375,2242399379,4,2271,1147,-30
2247855824,2247855830,6,3255,1244,-30
2251659558,2251659566,8,1753,1308,-30
2255396789,2255396793,4,2220,1648,-30
2256174081,2256174080,-1,1288,2117,-30
2257425048,2257425054,6,2061,882,-30
2257513070,2257513077,7,1355,1116,-30
2257835942,2257835947,5,2338,1131,-30
2257891505,2257891510,5,1972,1462,-30
2260263711,2260263716,5,1295,842,-30
2263486977,2263486984,7,2354,1480,-30
2264916378,2264916386,8,2519,1505,-30
2270098990,2270098994,4,1710,1380,-30
2273541319,2273541322,3,888,1477,-30
2275016327,2275016334,7,1968,1138,-30
2275300076,2275300080,4,1940,1211,-30
2277089665,2277089669,4,2672,1547,-30
2284253793,2284253795,2,1268,1600,-30
2284282714,2284282718,4,2513,1003,-30
2285588591,2285588597,6,1834,1279,-30
2286839889,2286839896,7,2233,1487,-30
2289489019,2289489023,4,2352,1421,-30
2290708975,2290708980,5,2490,1564,-30
2290977675,2290977659,-16,2148,1532,-30
2292463891,2292463896,5,2649,1935,-30
2295454246,2295454251,5,1624,896,-30
2295593516,2295593521,5,2546,1471,-30
2295761248,2295761253,5,1922,1158,-30
2297980513,2297980518,5,2392,1510,-30
2298286547,2298286551,4,2431,1194,-30
2299458839,2299458843,4,2808,1844,-30
2302861409,2302861414,5,5116,3024,-30
2309127317,2309127322,5,1529,1288,-30
2310728087,2310728091,4,2400,1510,-30
2317082095,2317082100,5,421,261,-30
2317717858,2317717862,4,2508,1545,-30
2317978718,2317978725,7,2549,1663,-30
2328968484,2328968489,5,1595,1077,-30
2329224297,2329224299,2,2043,2022,-30
2333625442,2333625446,4,1737,1293,-30
2334548246,2334548253,7,2400,977,-30
2334693281,2334693287,6,2564,1400,-30
2344112864,2344112846,-18,1523,1316,-30
2344754295,2344754302,7,1809,993,-30
2345340929,2345340934,5,2811,1430,-30
2354212117,2354212119,2,1505,904,-30
2365537538,2365537543,5,1005,517,-30
2370278028,2370278033,5,2706,1091,-30
2383078316,2383078323,7,2339,1280,-30
2383952213,2383952217,4,2079,1110,-30
2384035627,2384035634,7,1805,1529,-30
2384733814,2384733822,8,1287,900,-30
2385944930,2385944936,6,2892,1436,-30
2386541911,2386541891,-20,2723,1017,-30
2386847111,2386847118,7,2777,1327,-30
2387280303,2387280306,3,2662,1463,-30
2393829489,2393829489,0,1592,1856,-30
2396591833,2396591827,-6,765,1550,-30
2396881798,2396881803,5,2117,1418,-30
2400490644,2400490645,1,1666,1360,-30
2401646270,2401646274,4,1593,949,-30
2401842694,2401842714,20,714,433,-30
2402406429,2402406434,5,3559,1544,-30
2402590977,2402590982,5,2628,1732,-30
2411372678,2411372682,4,2358,906,-30
2411624191,2411624180,-11,2144,873,-30
2419287206,2419287213,7,1868,1255,-30
2420177860,2420177876,16,2786,1542,-30
2421627578,2421627583,5,2504,1452,-30
2422478981,2422478985,4,1638,1209,-30
2422652404,2422652398,-6,1870,9269,-30
2433603164,2433603166,2,1650,1873,-30
2436046850,2436046853,3,1835,1212,-30
2436714358,2436714359,1,1109,1155,-30
2437269610,2437269615,5,2615,1456,-30
2439475931,2439475932,1,984,95,-30
2449836526,2449836529,3,1139,796,-30
2450542410,2450542392,-18,2449,1609,-30
2451206853,2451206859,6,2207,1267,-30
2452249667,2452249670,3,2837,1464,-30
2454672439,2454672443,4,2809,2048,-30
2454984698,2454984702,4,2177,1307,-30
2458261305,2458261311,6,3449,1571,-30
2458355745,2458355749,4,2669,1391,-30
2458525449,2458525454,5,1930,1455,-30
2460563620,2460563635,15,764,1513,-30
2468375934,2468375938,4,2019,1484,-30
2469680113,2469680117,4,2975,1759,-30
2470443579,2470443587,8,2754,1349,-30
2475168354,2475168359,5,3180,1645,-30
2478542364,2478542369,5,1665,1112,-30
2480567834,2480567838,4,2126,1722,-30
2485730273,2485730280,7,2204,1109,-30
2486570625,2486570631,6,1710,1525,-30
2489343038,2489343042,4,2474,1863,-30
2492099387,2492099393,6,2846,1789,-30
2494366373,2494366378,5,1994,961,-30
2496388740,2496388746,6,2553,696,-30
2505425546,2505425525,-21,2072,1695,-30
2507671719,2507671718,-1,1412,1512,-30
2509334981,2509334986,5,2702,1422,-30
2510392249,2510392254,5,820,837,-30
2513360182,2513360186,4,1814,1180,-30
2515677497,2515677502,5,2004,1233,-30
2516235534,2516235538,4,2594,1530,-30
2516744954,2516744937,-17,1745,1114,-30
2517967946,2517967951,5,3294,1699,-30
2525048247,2525048255,8,1581,800,-30
2525153922,2525153926,4,1749,854,-30
2525690120,2525690125,5,2879,1738,-30
2527040406,2527040406,0,1949,1621,-30
2531633366,2531633371,5,2597,1322,-30
2533961487,2533961490,3,1114,962,-30
2535931974,2535931979,5,2285,1988,-30
2538037417,2538037422,5,2359,1125,-30
2538393128,2538393132,4,2253,1081,-30
2542332534,2542332538,4,2506,2001,-30
2549737366,2549737370,4,2408,1070,-30
2549871849,2549871854,5,2731,1650,-30
2549978427,2549978432,5,2512,1580,-30
2550767535,2550767542,7,1741,1036,-30
2550926715,2550926730,15,552,331,-30
2553645234,2553645239,5,1376,893,-30
2556467625,2556467626,1,1694,1659,-30
2558587662,2558587662,0,1941,1965,-30
2560097946,2560097950,4,1805,1324,-30
2560255814,2560255819,5,2185,1248,-30
2560797349,2560797342,-7,1808,8064,-30
2565914917,2565914923,6,3987,1740,-30
2573765193,2573765196,3,2114,1404,-30
2576417049,2576417053,4,1833,1138,-30
2579480391,2579480386,-5,1022,2688,-30
2580321801,2580321804,3,2175,1026,-30
2583530355,2583530361,6,2966,1095,-30
2596539675,2596539678,3,2646,1678,-30
2597407563,2597407569,6,1757,1404,-30
2600624981,2600624983,2,1147,2224,-30
2602485102,2602485107,5,3637,1122,-30
2603345157,2603345162,5,1910,1140,-30
2604457205,2604457211,6,2827,1593,-30
2605518226,2605518231,5,2882,1146,-30
2608271692,2608271695,3,2220,1408,-30
2608973156,2608973155,-1,1160,1465,-30
2610620054,2610620058,4,2365,1679,-30
2613321182,2613321187,5,3376,2365,-30
2617107509,2617107514,5,2197,1555,-30
2623219875,2623219878,3,1277,1440,-30
2624352891,2624352895,4,2272,1713,-30
2625553683,2625553678,-5,2624,8645,-30
2625600573,2625600577,4,1935,1020,-30
2626322014,2626322020,6,2081,1052,-30
2632490117,2632490120,3,2418,1809,-30
2636339817,2636339821,4,2409,1767,-30
2639007023,2639007029,6,2034,1662,-30
2640066063,2640066067,4,1904,905,-30
2640622853,2640622859,6,2199,1459,-30
2641737257,2641737262,5,3013,1638,-30
2645258195,2645258198,3,3691,2702,-30
2646637002,2646637003,1,1556,1559,-30
2646803834,2646803836,2,2429,1924,-30
2647041877,2647041882,5,2949,1499,-30
2649850074,2649850054,-20,1178,638,-30
2650436155,2650436159,4,1601,1787,-30
2654172237,2654172242,5,2175,1303,-30
2656058527,2656058527,0,28,4497,-30
2660722918,2660722923,5,2312,1338,-30
2663073436,2663073441,5,1665,1326,-30
2665855742,2665855747,5,1692,922,-30
2665985482,2665985466,-16,1967,907,-30
2667966370,2667966375,5,1466,703,-30
2668587901,2668587906,5,1708,915,-30
2668928790,2668928795,5,1711,1184,-30
2670929158,2670929162,4,1937,1560,-30
2671851186,2671851189,3,2246,1230,-30
2673260333,2673260337,4,1984,1645,-30
2674026122,2674026127,5,2042,1463,-30
2680835779,2680835783,4,3448,1480,-30
2682765122,2682765129,7,1980,1477,-30
2683660066,2683660070,4,2172,1508,-30
2683781663,2683781673,10,422,157,-30
2689608666,2689608670,4,1775,1037,-30
2690104683,2690104690,7,2396,1222,-30
2698625527,2698625533,6,3220,1191,-30
2699038265,2699038265,0,3323,3199,-30
2700235738,2700235743,5,2590,1247,-30
2709555734,2709555738,4,1468,653,-30
2710208895,2710208899,4,2589,1587,-30
2712536410,2712536413,3,2769,2056,-30
2714730101,2714730106,5,2578,1372,-30
2715079577,2715079583,6,3843,1556,-30
2715208143,2715208143,0,1116,2285,-30
2720895995,2720895999,4,2101,1180,-30
2721784794,2721784798,4,2596,1629,-30
2722007761,2722007765,4,2956,1703,-30
2722078175,2722078154,-21,1210,1278,-30
2722907975,2722907980,5,1896,737,-30
2723135638,2723135616,-22,935,768,-30
2724261317,2724261323,6,11354,52807,-30
2724669086,2724669090,4,1653,1844,-30
2727073047,2727073051,4,3275,1730,-30
2729044385,2729044391,6,1814,1419,-30
2729554307,2729554314,7,10048,4562,-30
2730543986,2730543993,7,2983,2042,-30
2731964367,2731964372,5,1726,1320,-30
2735636685,2735636691,6,2363,962,-30
2737780946,2737780952,6,2594,1540,-30
2741949486,2741949491,5,2368,1084,-30
2742254363,2742254370,7,3832,1378,-30
2742811738,2742811728,-10,599,226,-30
2752117019,2752117027,8,4120,1710,-30
2752635844,2752635850,6,2086,858,-30
2754669543,2754669550,7,1882,1357,-30
2758827305,2758827318,13,13846,40956,-30
2765804436,2765804439,3,1528,1491,-30
2767403767,2767403761,-6,658,3776,-30
2774498792,2774498779,-13,10602,40828,-30
2775146538,2775146543,5,3416,1348,-30
2777082874,2777082880,6,2087,1561,-30
2777663688,2777663693,5,2652,1504,-30
2780394968,2780394974,6,1821,1400,-30
2780772168,2780772174,6,1949,1174,-30
2781444066,2781444070,4,2374,1297,-30
2785901855,2785901859,4,1873,1195,-30
2790698381,2790698387,6,1768,1419,-30
2791436925,2791436931,6,2928,1403,-30
2794085374,2794085382,8,3147,1776,-30
2797140202,2797140211,9,10874,45247,-30
2797706018,2797706023,5,1212,744,-30
2798271548,2798271552,4,1718,1578,-30
2799174725,2799174727,2,2757,2853,-30
2800488517,2800488515,-2,1330,1941,-30
2809232513,2809232517,4,3059,1674,-30
2815208052,2815208057,5,2348,1051,-30
2815440501,2815440506,5,1846,1058,-30
2816293558,2816293564,6,1991,1265,-30
2816575096,2816575095,-1,1101,1641,-30
2818204601,2818204606,5,3131,1983,-30
2820717097,2820717101,4,2031,1146,-30
2822387436,2822387441,5,2997,1791,-30
2825398442,2825398446,4,2360,1392,-30
2834403859,2834403865,6,6824,2032,-30
2840573769,2840573771,2,1748,2195,-30
2848405167,2848405174,7,1848,1158,-30
2854148650,2854148654,4,2048,1146,-30
2854750234,2854750239,5,2332,1279,-30
2854986384,2854986372,-12,2710,1111,-30
2855109798,2855109803,5,2225,1474,-30
2855305234,2855305240,6,2627,1305,-30
2859236613,2859236617,4,2043,1034,-30
2864018895,2864018890,-5,1328,2541,-30
2865802559,2865802565,6,2897,1225,-30
2866712903,2866712908,5,1659,1245,-30
2867064083,2867064096,13,1378,1152,-30
2867388138,2867388123,-15,1600,1173,-30
2871209474,2871209482,8,2439,1155,-30
2871566174,2871566178,4,2315,1306,-30
2872971470,2872971475,5,2665,1899,-30
2885996991,2885996998,7,1878,779,-30
2888305246,2888305249,3,2447,1722,-30
2893853331,2893853335,4,2404,1650,-30
2897479929,2897479934,5,3374,1129,-30
2898130801,2898130786,-15,729,327,-30
2901480181,2901480186,5,1681,1071,-30
2904919157,2904919162,5,2302,1632,-30
2905042152,2905042156,4,2641,1336,-30
2906600318,2906600322,4,1883,1350,-30
2906870906,2906870911,5,3293,1338,-30
2907350902,2907350908,6,2243,1328,-30
2908051702,2908051682,-20,755,784,-30
2911143148,2911143153,5,1216,1037,-30
2929016098,2929016102,4,1837,967,-30
2929299384,2929299388,4,2339,1290,-30
2932766701,2932766705,4,1884,1159,-30
2932881513,2932881499,-14,2599,1192,-30
2936259846,2936259852,6,2859,1264,-30
2943585098,2943585103,5,1571,1139,-30
2946450915,2946450922,7,2234,1604,-30
2949005001,2949005007,6,2059,1341,-30
2949888382,2949888386,4,1666,1378,-30
2957085088,2957085082,-6,2555,7372,-30
2958122399,2958122403,4,2583,1578,-30
2964461275,2964461279,4,2481,1471,-30
2966611977,2966611977,0,601,1266,-30
2968705045,2968705051,6,2657,1198,-30
2969036288,2969036272,-16,1246,532,-30
2971275422,2971275425,3,2145,1815,-30
2975050393,2975050393,0,1358,2159,-30
2976127597,2976127580,-17,1590,1310,-30
2981701163,2981701167,4,2758,1454,-30
2983399509,2983399515,6,2636,1167,-30
2983708984,2983708990,6,2377,1197,-30
2992225614,2992225620,6,1783,1153,-30
2993789042,2993789046,4,1901,1726,-30
3000426712,3000426717,5,1917,1236,-30
3000931366,3000931370,4,2177,1286,-30
3004482307,3004482311,4,1800,1809,-30
3004604900,3004604902,2,1731,1948,-30
3009477486,3009477490,4,2394,1180,-30
3011801745,3011801751,6,1491,1391,-30
3021695951,3021695955,4,2088,1223,-30
3033910227,3033910231,4,2094,1352,-30
3038488112,3038488119,7,2256,1285,-30
3038735539,3038735528,-11,850,341,-30
3048530357,3048530361,4,2555,1854,-30
3049671342,3049671349,7,4683,2155,-30
3052153522,3052153521,-1,1755,1871,-30
3057301950,3057301954,4,1583,1627,-30
3060723634,3060723639,5,3242,1068,-30
3061291097,3061291113,16,1955,1413,-30
3064119297,3064119301,4,1965,1760,-30
3064242879,3064242883,4,1583,1401,-30
3065282157,3065282162,5,2133,1254,-30
3066041229,3066041212,-17,2794,1469,-30
3074133602,3074133602,0,2975,3266,-30
3078886214,3078886218,4,2890,1325,-30
3083497198,3083497205,7,2294,1186,-30
3085440783,3085440790,7,3245,1222,-30
3087502953,3087502957,4,1948,1012,-30
3088277445,3088277460,15,610,26,-30
3091602145,3091602150,5,1742,934,-30
3093759444,3093759450,6,1852,999,-30
3096231733,3096231737,4,1703,1059,-30
3097069012,3097069018,6,2960,1409,-30
3099710023,3099710026,3,1740,1291,-30
3103618994,3103618999,5,1586,983,-30
3104190802,3104190809,7,2307,1211,-30
3106653965,3106653970,5,2445,1317,-30
3108754478,3108754483,5,2246,977,-30
3109935817,3109935824,7,11514,34774,-30
3110192951,3110192954,3,2336,2073,-30
3113396181,3113396187,6,2434,1181,-30
3116553077,3116553071,-6,1361,4488,-30
3117682457,3117682458,1,1793,1458,-30
3125671818,3125671814,-4,1102,2401,-30
3129805933,3129805938,5,2441,1790,-30
3136128995,3136129001,6,2288,1299,-30
3136316529,3136316533,4,2266,1563,-30
3136588190,3136588194,4,2538,1405,-30
3136785850,3136785850,0,791,2522,-30
3138893538,3138893542,4,2079,1124,-30
3142626011,3142626006,-5,1343,3022,-30
3146059723,3146059728,5,2431,1567,-30
3148436851,3148436854,3,1399,1634,-30
3150101477,3150101481,4,1312,1287,-30
3164528533,3164528538,5,2851,1263,-30
3166090084,3166090087,3,1966,1413,-30
3166784906,3166784909,3,2270,1597,-30
3174335310,3174335314,4,1890,1188,-30
3175234768,3175234773,5,1868,1188,-30
3179399829,3179399825,-4,21705,17536,-30
3179716726,3179716730,4,2731,1629,-30
3180676770,3180676777,7,2343,981,-30
3180893138,3180893139,1,2274,2065,-30
3182288358,3182288362,4,2639,1105,-30
3182365487,3182365483,-4,823,1548,-30
3183228386,3183228401,15,1914,1411,-30
3183747477,3183747481,4,3150,1632,-30
3185247473,3185247478,5,5349,2531,-30
3192631237,3192631244,7,2927,1059,-30
3193522717,3193522724,7,2233,1777,-30
3195878026,3195878030,4,2240,1647,-30
3197204881,3197204864,-17,2254,978,-30
3198552502,3198552504,2,1567,1451,-30
3199425208,3199425213,5,1942,1061,-30
3202965293,3202965299,6,2577,1676,-30
3206264966,3206264973,7,1601,739,-30
3206914455,3206914433,-22,1153,501,-30
3207163951,3207163957,6,1766,1114,-30
3213335089,3213335094,5,2136,1152,-30
3213571590,3213571609,19,1597,1332,-30
3213758857,3213758862,5,2800,1264,-30
3215576122,3215576123,1,1086,1209,-30
3216715221,3216715226,5,1556,1299,-30
3217088582,3217088587,5,2565,1596,-30
3220178813,3220178817,4,3788,1375,-30
3221073453,3221073459,6,3002,1358,-30
3221140846,3221140846,0,1295,1254,-30
3222220062,3222220060,-2,1318,1763,-30
3232598625,3232598633,8,3286,1466,-30
3233006266,3233006270,4,2057,1224,-30
3235544746,3235544750,4,2864,1800,-30
3248235042,3248235047,5,1779,1255,-30
3253416645,3253416650,5,1995,1538,-30
3254905069,3254905074,5,3348,1321,-30
3255728566,3255728570,4,2286,1424,-30
3256049843,3256049847,4,1885,1079,-30
3257277483,3257277487,4,2719,1400,-30
3257928401,3257928406,5,3103,1009,-30
3263010495,3263010499,4,2452,1054,-30
3264509207,3264509210,3,2340,1515,-30
3266299323,3266299327,4,2277,1085,-30
3266817230,3266817234,4,2466,1720,-30
3269254006,3269254027,21,1162,71,-30
3271279778,3271279785,7,1945,1398,-30
3272082204,3272082205,1,16407,3772,-30
3272412374,3272412380,6,2710,1373,-30
3272803321,3272803326,5,2791,1083,-30
3273131330,3273131335,5,1144,873,-30
3276353071,3276353055,-16,2008,1157,-30
3281814319,3281814324,5,2212,1438,-30
3283630826,3283630833,7,1539,760,-30
3285792679,3285792686,7,1561,1266,-30
3288359970,3288359975,5,3003,2024,-30
3292590413,3292590419,6,1948,1261,-30
3293537800,3293537804,4,1923,1012,-30
3295725360,3295725364,4,1762,1010,-30
3301945130,3301945135,5,2879,1454,-30
3302023614,3302023618,4,2014,1952,-30
3304278273,3304278273,0,1146,1651,-30
3307041033,3307041038,5,3367,2126,-30
3307384618,3307384623,5,2194,1208,-30
3307409988,3307409993,5,2822,1862,-30
3316561481,3316561485,4,2643,1554,-30
3319301830,3319301835,5,1733,1337,-30
3320971861,3320971873,12,3024,1721,-30
3321195258,3321195244,-14,2025,986,-30
3324045130,3324045137,7,2594,1354,-30
3324427626,3324427630,4,1829,1008,-30
3326032955,3326032959,4,2069,1646,-30
3333220765,3333220769,4,2445,1290,-30
3335903416,3335903423,7,3044,1412,-30
3338955150,3338955154,4,2538,1169,-30
3340532215,3340532214,-1,914,2918,-30
3344580565,3344580570,5,1792,1056,-30
3345999303,3345999306,3,1855,1456,-30
3347475381,3347475386,5,1492,1593,-30
3349029442,3349029447,5,1259,877,-30
3349845514,3349845521,7,4734,2467,-30
3354460557,3354460562,5,2826,1418,-30
3359231067,3359231074,7,1566,762,-30
3360324067,3360324071,4,3059,1527,-30
3361339863,3361339869,6,2552,1416,-30
3364527060,3364527062,2,2591,1657,-30
3365824885,3365824892,7,2959,2110,-30
3373969703,3373969719,16,17,1575,-30
3375801697,3375801702,5,3277,1541,-30
3377031622,3377031629,7,2280,1385,-30
3379136030,3379136035,5,1882,1000,-30
3382651657,3382651662,5,2365,1130,-30
3382679093,3382679098,5,2078,1339,-30
3385831969,3385831975,6,2216,1145,-30
3393286741,3393286747,6,3490,1199,-30
3394604594,3394604596,2,1832,1184,-30
3395191649,3395191659,10,3042,1345,-30
3395592391,3395592395,4,2785,1222,-30
3410721948,3410721952,4,3355,1848,-30
3412237558,3412237563,5,1863,792,-30
3414267892,3414267902,10,1419,2550,-30
3417925909,3417925914,5,2387,1284,-30
3418789950,3418789936,-14,1066,444,-30
3422236517,3422236522,5,2772,1199,-30
3422654238,3422654242,4,2725,1754,-30
3423682102,3423682107,5,2279,1185,-30
3423747806,3423747811,5,1273,731,-30
3426408254,3426408259,5,2584,1356,-30
3426492957,3426492961,4,3041,1781,-30
3428488165,3428488170,5,3392,1196,-30
3430930358,3430930362,4,1745,829,-30
3431628343,3431628353,10,1088,252,-30
3436247412,3436247415,3,1825,1108,-30
3441654494,3441654499,5,2312,1161,-30
3441997960,3441997963,3,1314,961,-30
3442520822,3442520827,5,1920,1327,-30
3443137889,3443137894,5,2636,1771,-30
3444734478,3444734481,3,1990,1020,-30
3450472401,3450472407,6,1639,1379,-30
3450592594,3450592598,4,2240,1626,-30
3451077053,3451077050,-3,25985,7941,-30
3459456895,3459456898,3,2697,1539,-30
3461615824,3461615825,1,1399,1301,-30
3463699426,3463699431,5,2893,1101,-30
3464088660,3464088666,6,2230,870,-30
3465534701,3465534705,4,2388,1855,-30
3465656924,3465656929,5,1252,781,-30
3470117380,3470117387,7,2266,1027,-30
3476363571,3476363577,6,2854,1738,-30
3478644831,3478644836,5,2304,1196,-30
3483418194,3483418199,5,2426,1241,-30
3485010404,3485010409,5,2558,1876,-30
3490743961,3490743965,4,1719,1470,-30
3493193254,3493193260,6,4402,2280,-30
3495136294,3495136296,2,1529,1569,-30
3497326607,3497326613,6,2263,1609,-30
3503362821,3503362827,6,1746,1266,-30
3504873190,3504873185,-5,1000,906,-30
3506650694,3506650699,5,2420,1142,-30
3506779918,3506779938,20,2321,1211,-30
3510546335,3510546330,-5,1113,4006,-30
3512249781,3512249786,5,1754,1261,-30
3515986803,3515986805,2,922,973,-30
3521288701,3521288706,5,2380,1551,-30
3521903278,3521903281,3,1973,1156,-30
3522289718,3522289723,5,1722,1452,-30
3524755182,3524755185,3,2239,1376,-30
3526791594,3526791599,5,2608,1018,-30
3530753397,3530753400,3,2815,995,-30
3535060390,3535060389,-1,2124,4574,-30
3536846681,3536846682,1,1506,1630,-30
3539723283,3539723286,3,2227,1166,-30
3540908005,3540908010,5,2444,1219,-30
3541023085,3541023085,0,2186,3036,-30
3541820474,3541820478,4,3214,1592,-30
3543705778,3543705783,5,2470,1194,-30
3544027119,3544027125,6,2056,1443,-30
3545015731,3545015738,7,4719,1464,-30
3553394378,3553394385,7,1281,811,-30
3554953095,3554953099,4,2458,1298,-30
3555605606,3555605611,5,2417,1565,-30
3557083011,3557083023,12,877,189,-30
3559340958,3559340962,4,1855,1114,-30
3559564052,3559564055,3,1799,1158,-30
3559872831,3559872835,4,2259,1098,-30
3559898075,3559898057,-18,886,796,-30
3559911634,3559911633,-1,50,47,-30
3567385762,3567385767,5,2565,1291,-30
3568035637,3568035639,2,1848,1915,-30
3572610000,3572610006,6,2029,1203,-30
3574839683,3574839687,4,2311,1353,-30
3575040112,3575040116,4,3442,1637,-30
3585734071,3585734069,-2,2017,4628,-30
3589849326,3589849333,7,2297,1553,-30
3591612204,3591612210,6,1951,849,-30
3593281042,3593281047,5,1375,1002,-30
3593435050,3593435055,5,2739,1501,-30
3596390917,3596390922,5,2998,1373,-30
3596793187,3596793189,2,1643,1008,-30
3598504397,3598504402,5,2219,1136,-30
3600996697,3600996704,7,2541,1432,-30
3605616393,3605616397,4,1471,861,-30
3609426762,3609426769,7,2169,1321,-30
3614634783,3614634787,4,2252,1585,-30
3618559417,3618559421,4,1610,1471,-30
3627018677,3627018682,5,1667,1334,-30
3632806242,3632806249,7,2526,1178,-30
3638335674,3638335678,4,3298,1661,-30
3640316563,3640316570,7,2196,1311,-30
3641274985,3641274990,5,3096,1098,-30
3641673358,3641673363,5,2868,1380,-30
3644349621,3644349626,5,2318,1141,-30
3646505124,3646505129,5,2150,1292,-30
3651826308,3651826313,5,1735,1315,-30
3653405701,3653405706,5,2676,1038,-30
3661313517,3661313524,7,2408,1322,-30
3661686394,3661686398,4,2643,1336,-30
3662983615,3662983621,6,1553,1558,-30
3675024137,3675024139,2,1736,1549,-30
3676282162,3676282171,9,2309,1166,-30
3677179773,3677179779,6,2891,1246,-30
3679815730,3679815737,7,2361,1037,-30
3682422564,3682422570,6,1538,1293,-30
3682888430,3682888436,6,2577,1837,-30
3690882498,3690882503,5,1838,1367,-30
3691145842,3691145849,7,850,158,-30
3703352339,3703352346,7,2704,1545,-30
3704399372,3704399375,3,2156,1118,-30
3704993031,3704993038,7,2268,1367,-30
3708499122,3708499125,3,1543,1013,-30
3709431757,3709431760,3,2482,1894,-30
3712838271,3712838278,7,2899,1692,-30
3713570174,3713570178,4,2841,1297,-30
3717771759,3717771765,6,1929,1204,-30
3721349305,3721349310,5,1960,1215,-30
3721671318,3721671324,6,2048,1316,-30
3728088258,3728088262,4,2984,1608,-30
3728315682,3728315687,5,1977,1493,-30
3734435422,3734435426,4,2242,1002,-30
3735782082,3735782082,0,3068,4575,-30
3738337365,3738337371,6,2643,1457,-30
3738669538,3738669543,5,2002,1097,-30
3738771886,3738771890,4,2779,1556,-30
3746863330,3746863333,3,1952,1196,-30
3747237386,3747237384,-2,1587,2041,-30
3750202406,3750202411,5,2396,1437,-30
3751051846,3751051851,5,1821,1213,-30
3752586301,3752586305,4,3096,992,-30
3753502411,3753502417,6,2639,1712,-30
3756377513,3756377514,1,31454,25360,-30
3760543934,3760543939,5,2624,977,-30
3760776578,3760776583,5,2249,1403,-30
3760905913,3760905919,6,2480,1487,-30
3761391285,3761391290,5,2146,1193,-30
3762425450,3762425456,6,1625,1187,-30
3763906704,3763906708,4,2356,1319,-30
3768818798,3768818803,5,2386,1267,-30
3768886041,3768886026,-15,3181,1542,-30
3768960770,3768960753,-17,2363,1040,-30
3770137811,3770137815,4,1081,830,-30
3776046567,3776046571,4,2596,1536,-30
3778580031,3778580035,4,2465,975,-30
3778866725,3778866729,4,2010,1443,-30
3780645490,3780645496,6,2954,1641,-30
3780791119,3780791124,5,1888,929,-30
3786776725,3786776731,6,8037,2726,-30
3788730805,3788730810,5,1625,1085,-30
3790581629,3790581634,5,2553,1568,-30
3794031482,3794031487,5,3396,1910,-30
3794652886,3794652868,-18,1473,381,-30
3795090822,3795090828,6,2992,1135,-30
3795724613,3795724592,-21,1567,1149,-30
3797363902,3797363906,4,2231,1462,-30
3797482973,3797482975,2,5102,22267,-30
3798410938,3798410943,5,2222,844,-30
3805936776,3805936779,3,2694,1788,-30
3807270979,3807270986,7,3039,1649,-30
3808583346,3808583350,4,1519,1179,-30
3809411755,3809411759,4,2486,1348,-30
3810574853,3810574865,12,1413,1383,-30
3815306225,3815306227,2,1343,1180,-30
3815899161,3815899167,6,2540,1600,-30
3816759925,3816759930,5,3306,1395,-30
3819645754,3819645757,3,1882,1390,-30
3821705709,3821705717,8,2430,1185,-30
3822041800,3822041784,-16,2541,1096,-30
3833704322,3833704328,6,1726,1349,-30
3835301816,3835301822,6,2734,1117,-30
3836299187,3836299191,4,2047,1826,-30
3836591985,3836591991,6,2838,1739,-30
3838322665,3838322666,1,1009,694,-30
3838674548,3838674532,-16,2508,1490,-30
3838902445,3838902426,-19,1004,265,-30
3840662021,3840662023,2,1904,1368,-30
3840834748,3840834754,6,1955,866,-30
3842377954,3842377960,6,2245,1338,-30
3847639309,3847639314,5,3238,1662,-30
3852652870,3852652874,4,2879,1764,-30
3855041338,3855041322,-16,420,291,-30
3858236853,3858236858,5,3647,1375,-30
3860864646,3860864649,3,2803,1256,-30
3865950306,3865950309,3,2505,1284,-30
3866887382,3866887374,-8,1560,5520,-30
3874337271,3874337275,4,2432,1196,-30
3875875614,3875875617,3,2657,1488,-30
3876051145,3876051149,4,2269,1396,-30
3876479777,3876479782,5,1994,1130,-30
3877664089,3877664095,6,2441,1306,-30
3878703534,3878703538,4,1764,1126,-30
3882047970,3882047974,4,1517,967,-30
3885043063,3885043067,4,2461,1017,-30
3886322345,3886322350,5,2352,1853,-30
3886636973,3886636979,6,2036,1176,-30
3886800070,3886800075,5,2017,1142,-30
3890500221,3890500216,-5,1366,2462,-30
3891248273,3891248279,6,2513,1416,-30
3891349622,3891349631,9,2298,1256,-30
3892956811,3892956816,5,2557,1521,-30
3894135630,3894135635,5,2743,1418,-30
3895692778,3895692785,7,2135,1288,-30
3898468051,3898468057,6,2372,1566,-30
3906696513,3906696517,4,1981,1548,-30
3908483187,3908483193,6,1911,1251,-30
3910696204,3910696208,4,2325,1090,-30
3911351934,3911351938,4,2173,1581,-30
3914975623,3914975628,5,2045,1082,-30
3916205446,3916205452,6,2697,1607,-30
3917308398,3917308404,6,1973,1055,-30
3918976405,3918976410,5,2245,1599,-30
3924030882,3924030887,5,2512,1726,-30
3925848953,3925848950,-3,1534,2741,-30
3930066002,3930066004,2,2085,1766,-30
3931193666,3931193673,7,2546,1135,-30
3933759511,3933759516,5,2337,1929,-30
3937414702,3937414706,4,1601,667,-30
3938154823,3938154827,4,1940,832,-30
3943123469,3943123473,4,1761,1111,-30
3943965257,3943965256,-1,1820,2482,-30
3946887358,3946887361,3,1814,762,-30
3959224894,3959224897,3,2276,1657,-30
3959611334,3959611340,6,2396,1694,-30
3964208585,3964208590,5,2645,1750,-30
3969011436,3969011441,5,2430,1422,-30
3973337535,3973337538,3,2348,1387,-30
3973587641,3973587645,4,2436,1800,-30
3973948694,3973948698,4,1192,1118,-30
3981161329,3981161326,-3,1809,3079,-30
3981316605,3981316600,-5,1134,4306,-30
3981838461,3981838465,4,2014,1065,-30
3985734694,3985734699,5,2209,972,-30
3989624304,3989624310,6,2973,1224,-30
3994463628,3994463632,4,2788,1557,-30
3994854782,3994854762,-20,2155,1208,-30
3998234531,3998234537,6,2256,1220,-30
3998460181,3998460160,-21,1475,485,-30
4000192442,4000192437,-5,1205,2689,-30
4003496343,4003496347,4,2529,1634,-30
4004824028,4004824034,6,3003,1220,-30
4010090441,4010090445,4,1527,824,-30
4010117193,4010117200,7,791,248,-30
4010776349,4010776349,0,33659,22341,-30
4034848894,4034848898,4,2625,1541,-30
4035862783,4035862788,5,2100,1031,-30
4038294073,4038294079,6,1804,1323,-30
4039926289,4039926295,6,2237,1286,-30
4045439542,4045439547,5,3086,1297,-30
4047545386,4047545389,3,1593,1030,-30
4050092045,4050092049,4,2034,1158,-30
4050310822,4050310826,4,1015,994,-30
4055080342,4055080346,4,1771,1438,-30
4055224657,4055224664,7,3159,1868,-30
4057134569,4057134575,6,1672,947,-30
4059003934,4059003939,5,2285,931,-30
4059048506,4059048512,6,2196,1196,-30
4059221454,4059221433,-21,2025,990,-30
4061510213,4061510218,5,2777,1441,-30
4064565057,4064565049,-8,33848,14704,-30
4064662390,4064662394,4,1470,1460,-30
4068915837,4068915839,2,1259,908,-30
4070007330,4070007335,5,2491,1508,-30
4071163174,4071163178,4,1969,1027,-30
4074768245,4074768249,4,2975,1835,-30
4081934465,4081934469,4,2559,1018,-30
4083230694,4083230702,8,2753,1129,-30
4083333797,4083333776,-21,2173,1145,-30
4087038466,4087038470,4,2518,1090,-30
4091747658,4091747662,4,1251,1325,-30
4098047730,4098047736,6,2060,1649,-30
4099790318,4099790322,4,1613,1107,-30
4100340194,4100340201,7,3094,1099,-30
4104155406,4104155424,18,3102,943,-30
4105620220,4105620225,5,2777,1565,-30
4106291046,4106291051,5,1620,936,-30
4108696726,4108696726,0,930,1147,-30
4108857114,4108857098,-16,305,795,-30
4110261621,4110261623,2,2591,2082,-30
4113472857,4113472861,4,2171,1646,-30
4118318149,4118318153,4,1752,1114,-30
4123057549,4123057554,5,1890,1250,-30
4125689217,4125689223,6,1820,1338,-30
4125902668,4125902672,4,2709,1328,-30
4132755394,4132755399,5,2030,1057,-30
4133033775,4133033778,3,2145,952,-30
4134210877,4134210881,4,2253,1218,-30
4136532365,4136532360,-5,1885,6603,-30
4137772934,4137772951,17,326,509,-30
4140099188,4140099193,5,2083,1337,-30
4140226612,4140226614,2,1387,1179,-30
4140752514,4140752519,5,2336,978,-30
4148723201,4148723206,5,1784,1026,-30
4152788182,4152788186,4,2311,1538,-30
4154175786,4154175793,7,2720,1501,-30
4155228477,4155228482,5,2390,1613,-30
4156251797,4156251805,8,2410,915,-30
4158643009,4158643011,2,3134,1485,-30
4162280678,4162280685,7,2127,1137,-30
4166150549,4166150553,4,2105,1409,-30
4166398514,4166398499,-15,1224,713,-30
4166712154,4166712159,5,2449,1311,-30
4166878344,4166878354,10,1852,1483,-30
4167930087,4167930090,3,1998,1333,-30
4168604788,4168604783,-5,1219,2735,-30
4172625081,4172625086,5,1468,913,-30
4172685066,4172685071,5,3304,1532,-30
4183608986,4183608991,5,2933,1530,-30
4183984026,4183984026,0,1505,1828,-30
4184531322,4184531327,5,18219,23565,-30
4184665924,4184665923,-1,1092,1785,-30
4185696126,4185696129,3,2162,1902,-30
4186034803,4186034810,7,2844,1665,-30
4187887539,4187887543,4,3139,1856,-30
4188051725,4188051730,5,1652,1109,-30
4194006283,4194006287,4,2531,823,-30
4205433419,4205433426,7,2007,1127,-30
4207945265,4207945270,5,1626,1310,-30
4210197065,4210197069,4,2691,1461,-30
4211268758,4211268763,5,2966,1357,-30
4211813475,4211813490,15,573,118,-30
4212522613,4212522616,3,2201,1550,-30
4214450054,4214450050,-4,847,4042,-30
4215109596,4215109601,5,3759,2424,-30
4215652930,4215652934,4,2986,1712,-30
4217575987,4217575993,6,1060,974,-30
4218601988,4218601994,6,1892,1434,-30
4219651167,4219651174,7,2359,1257,-30
4220121133,4220121112,-21,2231,1332,-30
4220176827,4220176830,3,1995,1586,-30
4221007272,4221007275,3,2523,1325,-30
4221297786,4221297790,4,2690,1357,-30
4223404570,4223404576,6,2803,1504,-30
4224216467,4224216468,1,1302,1577,-30
4228250593,4228250599,6,2457,1223,-30
4231373054,4231373059,5,2187,999,-30
4231920853,4231920849,-4,1741,5082,-30
4233494719,4233494725,6,1368,960,-30
4233771840,4233771846,6,2202,1514,-30
4234124219,4234124222,3,1912,1725,-30
4234407161,4234407167,6,3049,1406,-30
4234864802,4234864806,4,2621,1428,-30
4239506609,4239506615,6,2289,1628,-30
4240464399,4240464403,4,3201,1719,-30
4241344162,4241344166,4,2200,1342,-30
4245805493,4245805498,5,1779,1133,-30
4247304253,4247304260,7,3004,1596,-30
4247860797,4247860801,4,1860,1330,-30
4249702341,4249702347,6,1669,908,-30
4254868138,4254868142,4,3441,1466,-30
4255077597,4255077602,5,2094,1202,-30
4255712254,4255712258,4,3626,1229,-30
4256927649,4256927653,4,2102,1008,-30
4261658870,4261658874,4,987,1081,-30
4270065736,4270065740,4,3443,1792,-30
4270328997,4270329003,6,2008,1388,-30
4271784136,4271784141,5,2410,1240,-30
4273119197,4273119203,6,2217,1425,-30
4273718382,4273718385,3,1698,1380,-30
4276858849,4276858854,5,1991,942,-30
4279530202,4279530194,-8,1562,4548,-30
4284426309,4284426313,4,1906,1589,-30
4286217133,4286217134,1,1427,1063,-30
4290251610,4290251616,6,1891,947,-30
4290805151,4290805131,-20,2444,1363,-30
4290961976,4290961981,5,2045,906,-30
4295566522,4295566525,3,1790,1357,-30
4301679755,4301679762,7,1971,1135,-30
4302620223,4302620227,4,1810,1192,-30
4303199817,4303199822,5,2228,1546,-30
4305450524,4305450508,-16,2391,17909,-30
4308031366,4308031371,5,3534,1674,-30
4312402962,4312402965,3,1669,1124,-30
4315780477,4315780481,4,1298,1025,-30
4316998806,4316998810,4,2830,1834,-30
4320620940,4320620945,5,2146,1595,-30
4328225140,4328225146,6,2795,1012,-30
4332755345,4332755350,5,1318,874,-30
4334068869,4334068873,4,1516,995,-30
4336926434,4336926441,7,1905,1241,-30
4343122007,4343122013,6,2157,1376,-30
4349041865,4349041871,6,3085,1480,-30
4349767917,4349767921,4,1580,1307,-30
4350595670,4350595677,7,2037,1054,-30
4352030828,4352030836,8,3423,1784,-30
4352282512,4352282523,11,1525,1479,-30
4359100742,4359100747,5,1763,1400,-30
4362271605,4362271610,5,2690,1932,-30
4364490799,4364490799,0,2583,3075,-30
4366003361,4366003366,5,2366,1497,-30
4368083020,4368083017,-3,1323,2897,-30
4369122047,4369122042,-5,771,2847,-30
4369830649,4369830655,6,2480,1075,-30
4371523534,4371523538,4,2434,1618,-30
4374585294,4374585298,4,2389,1099,-30
4374957102,4374957081,-21,884,384,-30
4376831813,4376831818,5,2823,1189,-30
4378282066,4378282071,5,2594,1583,-30
4383601989,4383601994,5,4960,2965,-30
4384344189,4384344194,5,2810,1553,-30
4384852942,4384852923,-19,3210,1593,-30
4388714979,4388714984,5,2070,998,-30
4390818821,4390818823,2,1395,1133,-30
4392363054,4392363057,3,1876,1164,-30
4395235118,4395235119,1,2738,3210,-30
4396353072,4396353076,4,1704,1087,-30
4402791649,4402791669,20,1884,875,-30
4403937332,4403937353,21,2967,1461,-30
4410664668,4410664672,4,3026,1651,-30
4410960164,4410960164,0,1349,2074,-30
4413328486,4413328488,2,1814,1576,-30
4415646319,4415646323,4,1401,1098,-30
4416092040,4416092044,4,2342,1217,-30
4416802951,4416802957,6,2314,1496,-30
4421904267,4421904274,7,2962,1307,-30
4423190075,4423190077,2,1619,1226,-30
4426402458,4426402463,5,2297,1479,-30
4429746103,4429746107,4,1975,1677,-30
4435231337,4435231341,4,3002,1686,-30
4435881315,4435881331,16,887,795,-30
4437815217,4437815223,6,1952,1185,-30
4440930304,4440930309,5,1851,1036,-30
4441816575,4441816580,5,3425,2108,-30
4443051976,4443051982,6,2586,1465,-30
4444187242,4444187237,-5,1463,4731,-30
4446813837,4446813841,4,2712,1220,-30
4447806123,4447806129,6,1956,1681,-30
4447891731,4447891736,5,646,419,-30
4449726451,4449726454,3,885,636,-30
4451439486,4451439490,4,2460,1361,-30
4452296822,4452296828,6,2615,1113,-30
4453438854,4453438860,6,1604,1047,-30
4453535886,4453535891,5,2207,1034,-30
4454711946,4454711951,5,1885,1046,-30
4456801011,4456801013,2,1645,1716,-30
4458132026,4458132022,-4,2457,7121,-30
4462871516,4462871499,-17,1763,851,-30
4464559334,4464559338,4,1452,1806,-30
4466476383,4466476388,5,2218,1427,-30
4470248565,4470248569,4,2371,1639,-30
4473003476,4473003482,6,1667,930,-30
4473054450,4473054455,5,1341,848,-30
4474321073,4474321078,5,2656,1652,-30
4475277051,4475277058,7,1867,850,-30
4476340590,4476340594,4,2026,1127,-30
4481775418,4481775435,17,775,293,-30
4482691246,4482691250,4,2630,1575,-30
4483598558,4483598562,4,1798,1502,-30
4485436977,4485436982,5,1554,1202,-30
4485564270,4485564249,-21,961,482,-30
4485904741,4485904722,-19,132,1603,-30
4488085827,4488085831,4,2753,1093,-30
4491103166,4491103170,4,2548,1394,-30
4492433441,4492433446,5,1874,1142,-30
4493441162,4493441165,3,2421,1755,-30
4496174402,4496174407,5,2087,1222,-30
4496457099,4496457104,5,2306,1099,-30
4501962056,4501962061,5,2531,1313,-30
4506504443,4506504447,4,2485,1579,-30
4507179910,4507179915,5,2549,1298,-30
4507490147,4507490152,5,2185,1276,-30
4508329312,4508329318,6,2920,1451,-30
4508789537,4508789542,5,1818,1200,-30
4511075984,4511075988,4,1941,1241,-30
4511677538,4511677543,5,1646,788,-30
4512542925,4512542905,-20,1518,730,-30
4513916378,4513916385,7,2827,1406,-30
4514370422,4514370426,4,1621,1418,-30
4517539509,4517539515,6,2600,1039,-30
4523155395,4523155397,2,2848,1876,-30
4527311991,4527311994,3,1750,1090,-30
4527694665,4527694671,6,1208,985,-30
4530761054,4530761058,4,1821,1432,-30
4533480675,4533480681,6,1877,1107,-30
4534886869,4534886878,9,12179,35071,-30
4535779101,4535779105,4,2591,1084,-30
4536330497,4536330501,4,2154,1396,-30
4537679694,4537679701,7,2287,1542,-30
4540646847,4540646853,6,1353,1335,-30
4544736015,4544736018,3,1156,1086,-30
4548116400,4548116405,5,2042,1201,-30
4552923692,4552923686,-6,987,4876,-30
4557118581,4557118586,5,1699,1112,-30
4559417426,4559417431,5,1827,1368,-30
4564243394,4564243401,7,3624,1075,-30
4567175176,4567175178,2,2346,1426,-30
4568668817,4568668822,5,2444,1134,-30
4568855270,4568855275,5,2146,1359,-30
4569101103,4569101106,3,1721,1551,-30
4570994566,4570994571,5,2870,997,-30
4578839603,4578839604,1,1019,2191,-30
4579743053,4579743059,6,3486,1357,-30
4584768126,4584768131,5,1984,1198,-30
4584826530,4584826535,5,2529,1264,-30
4585059486,4585059492,6,2024,866,-30
4585736314,4585736322,8,2622,1252,-30
4587552749,4587552754,5,2006,1668,-30
4590287823,4590287820,-3,1243,3310,-30
4590769361,4590769365,4,3132,1749,-30
4590867768,4590867773,5,2637,1309,-30
4594488030,4594488034,4,2609,1566,-30
4594881469,4594881473,4,1877,1024,-30
4596384182,4596384187,5,1870,1207,-30
4597402792,4597402798,6,2364,1210,-30
4599108559,4599108565,6,1481,1321,-30
4603340021,4603340026,5,2508,1696,-30
4604046379,4604046386,7,1953,1262,-30
4606675758,4606675760,2,13685,19087,-30
4606880529,4606880535,6,1595,1197,-30
4610485917,4610485921,4,2345,1197,-30
4615128267,4615128272,5,2402,1172,-30
4617563107,4617563113,6,2173,1205,-30
4622277157,4622277162,5,2076,1446,-30
4623324253,4623324258,5,2111,2189,-30
4627533064,4627533068,4,2169,1505,-30
4635253706,4635253712,6,2209,1241,-30
4637158868,4637158873,5,2226,1130,-30
4639764786,4639764792,6,2932,1879,-30
4641271709,4641271713,4,1982,996,-30
4655646727,4655646708,-19,2120,1268,-30
4658878872,4658878878,6,1748,1659,-30
4661304405,4661304406,1,1676,1212,-30
4663209958,4663209962,4,1398,1279,-30
4665948674,4665948674,0,1964,3077,-30
4667371677,4667371677,0,1627,1360,-30
4670305749,4670305754,5,2262,1643,-30
4671046037,4671046042,5,4977,2682,-30
4672012455,4672012458,3,2598,1247,-30
4676380254,4676380261,7,5074,1725,-30
4678305990,4678305993,3,2163,1170,-30
4683610789,4683610794,5,5033,3027,-30
4684926410,4684926414,4,1921,1213,-30
4685653268,4685653250,-18,1517,637,-30
4687770025,4687770026,1,1683,956,-30
4697578786,4697578789,3,1434,1188,-30
4700523770,4700523774,4,2802,1930,-30
4700750795,4700750799,4,2712,1644,-30
4704808879,4704808884,5,3152,1142,-30
4710443169,4710443174,5,2532,1357,-30
4711196699,4711196705,6,2348,1625,-30
4714438280,4714438285,5,2529,1499,-30
4716232073,4716232080,7,65640,25389,-30
4719380235,4719380234,-1,2395,3879,-30
4720108878,4720108873,-5,697,3548,-30
4723163838,4723163839,1,2029,1109,-30
4724478395,4724478398,3,2214,1738,-30
4725022458,4725022462,4,2290,1692,-30
4726501363,4726501367,4,2016,987,-30
4728251990,4728251994,4,2087,1083,-30
4732248095,4732248102,7,1825,999,-30
4740778903,4740778909,6,3644,1534,-30
4744379818,4744379823,5,2423,1083,-30
4745962948,4745962951,3,2353,1497,-30
4746048173,4746048178,5,3002,1570,-30
4746840758,4746840763,5,1880,1649,-30
4749684997,4749685002,5,2826,2227,-30
4756613902,4756613906,4,2254,1083,-30
4763663513,4763663518,5,2232,1884,-30
4771223877,4771223899,22,2625,2717,-30
4772343857,4772343863,6,19273,44590,-30
4775667677,4775667679,2,2923,1606,-30
4778225561,4778225567,6,2121,1092,-30
4783540770,4783540776,6,2529,1296,-30
4784686743,4784686739,-4,875,1783,-30
4786461925,4786461931,6,2623,1123,-30
4789848967,4789848964,-3,959,2883,-30
4791771414,4791771420,6,2310,1264,-30
4793133959,4793133970,11,2503,1238,-30
4796793954,4796793959,5,1833,1396,-30
4799440457,4799440458,1,1827,1109,-30
4799814250,4799814258,8,797,451,-30
4805804951,4805804958,7,3895,1736,-30
4805987278,4805987282,4,1840,1017,-30
4807641482,4807641486,4,1941,1244,-30
4812460793,4812460798,5,1910,1458,-30
4813979552,4813979555,3,2228,891,-30
4814867490,4814867495,5,2671,1354,-30
4820354571,4820354574,3,900,544,-30
4828567285,4828567290,5,1847,1096,-30
4832905747,4832905753,6,2873,1765,-30
4833520446,4833520451,5,2348,1350,-30
4833734553,4833734561,8,2167,1369,-30
4837122682,4837122681,-1,8677,14124,-30
4840351898,4840351902,4,1734,1270,-30
4840513206,4840513209,3,2317,1542,-30
4849388974,4849388979,5,2601,1284,-30
4852962114,4852962119,5,2034,944,-30
4853100571,4853100569,-2,1184,1329,-30
4857059230,4857059234,4,1958,1308,-30
4857695854,4857695837,-17,1967,1033,-30
4859755826,4859755830,4,2152,1195,-30
4866504070,4866504076,6,2331,1452,-30
4868089618,4868089625,7,2129,1088,-30
4868601449,4868601452,3,2193,1640,-30
4870763671,4870763675,4,1692,663,-30
4873879044,4873879049,5,1929,1023,-30
4875436285,4875436293,8,1507,773,-30
4876618959,4876618965,6,1865,1951,-30
4879169277,4879169281,4,2881,1306,-30
4879368374,4879368382,8,4941,1685,-30
4882028423,4882028426,3,1954,1503,-30
4884653346,4884653352,6,2183,974,-30
4884880339,4884880322,-17,4655,2747,-30
4887035283,4887035287,4,2575,1343,-30
4887750078,4887750086,8,3206,1558,-30
4889619720,4889619723,3,1708,1222,-30
4895697342,4895697346,4,2422,1456,-30
4895889311,4895889314,3,2803,1289,-30
4896108950,4896108939,-11,721,311,-30
4896308369,4896308373,4,2879,1245,-30
4899292721,4899292726,5,2014,1349,-30
4899892225,4899892231,6,1688,1156,-30
4900888733,4900888737,4,1930,1343,-30
4901496342,4901496348,6,2175,1846,-30
4901863194,4901863198,4,1601,1296,-30
4912455435,4912455439,4,1935,1355,-30
4914266325,4914266331,6,1911,648,-30
4917927633,4917927638,5,2623,1416,-30
4918793003,4918793007,4,2699,1481,-30
4920834971,4920834977,6,2697,1582,-30
4923876855,4923876848,-7,1050,4073,-30
4929043947,4929043953,6,3518,1712,-30
4929539640,4929539645,5,2317,1616,-30
4929576774,4929576778,4,2190,1470,-30
4930797438,4930797441,3,1962,1180,-30
4933190073,4933190078,5,2272,1473,-30
4937389548,4937389554,6,1946,807,-30
4937791225,4937791231,6,1667,1128,-30
4939739457,4939739461,4,1701,1690,-30
4940021465,4940021471,6,3044,1965,-30
4943268001,4943268004,3,2213,1533,-30
4949560687,4949560682,-5,1038,4343,-30
4949673802,4949673807,5,2516,1679,-30
4950582926,4950582927,1,1639,1693,-30
4954703686,4954703690,4,3330,2052,-30
4955510469,4955510476,7,1230,950,-30
4959584222,4959584222,0,1069,960,-30
4969731563,4969731562,-1,1171,1451,-30
4974936209,4974936214,5,2334,1050,-30
4976481863,4976481867,4,2195,1540,-30
4977231554,4977231559,5,1922,1018,-30
4983692133,4983692138,5,1530,1394,-30
4984272645,4984272625,-20,1775,987,-30
4984467582,4984467589,7,1571,1119,-30
4986805691,4986805698,7,2783,1164,-30
4988138382,4988138367,-15,1036,556,-30
4990182755,4990182759,4,2546,2000,-30
4994204890,4994204895,5,2538,1256,-30
4996886829,4996886834,5,1961,1047,-30
5001217251,5001217255,4,2297,1079,-30
5001748699,5001748683,-16,742,1267,-30
5003410254,5003410258,4,2508,1514,-30
5007705813,5007705813,0,1818,2850,-30
5009273273,5009273277,4,1300,1112,-30
5010615870,5010615866,-4,809,1767,-30
5010875787,5010875791,4,3484,1965,-30
5011601370,5011601371,1,34810,16980,-30
5015348529,5015348534,5,2390,1465,-30
5023288162,5023288167,5,3278,1352,-30
5030712422,5030712427,5,1971,905,-30
5031660955,5031660959,4,2028,1397,-30
5034971910,5034971916,6,1581,1090,-30
5036879578,5036879583,5,2546,1431,-30
5038640083,5038640089,6,2084,1297,-30
5040131905,5040131910,5,2624,1077,-30
5044350148,5044350158,10,71,1993,-30
5045537178,5045537185,7,2301,1229,-30
5052019566,5052019570,4,1739,1082,-30
5056293258,5056293262,4,1279,1246,-30
5057181621,5057181626,5,1729,996,-30
5060705758,5060705763,5,2497,1159,-30
5064023951,5064023956,5,2839,1310,-30
5065540945,5065540949,4,2057,962,-30
5068257555,5068257558,3,1906,1251,-30
5068671094,5068671099,5,2262,1344,-30
5069383255,5069383260,5,2172,1041,-30
5069483651,5069483655,4,2740,1661,-30
5070059695,5070059700,5,2725,1411,-30
5070586116,5070586123,7,1628,1016,-30
5075100118,5075100123,5,2869,1147,-30
5075500278,5075500281,3,1743,1400,-30
5086537746,5086537751,5,1958,1269,-30
5087483565,5087483569,4,1349,1095,-30
5091989047,5091989053,6,1667,1426,-30
5094008065,5094008070,5,2745,1553,-30
5098605030,5098605034,4,1700,1711,-30
5103323506,5103323511,5,971,442,-30
5105255058,5105255064,6,1734,1455,-30
5110553171,5110553175,4,2443,1059,-30
5111939592,5111939595,3,2027,1068,-30
5119111553,5119111557,4,2286,795,-30
5119533718,5119533721,3,2029,1408,-30
5121731557,5121731550,-7,864,7188,-30
5122301809,5122301814,5,1947,1376,-30
5128158137,5128158156,19,1850,1584,-30
5129809229,5129809230,1,2748,2271,-30
5132171850,5132171853,3,2041,930,-30
5133281247,5133281250,3,2229,1678,-30
5142278982,5142278986,4,1096,609,-30
5152156382,5152156385,3,1782,814,-30
5152858206,5152858210,4,1795,1606,-30
5153068617,5153068621,4,1837,951,-30
5154375867,5154375871,4,2347,1589,-30
5158506443,5158506446,3,2567,1364,-30
5161068697,5161068703,6,2204,1552,-30
5161289114,5161289119,5,2575,1123,-30
5167171718,5167171719,1,1616,1249,-30
5168600142,5168600146,4,2147,1253,-30
5173240858,5173240868,10,1764,1090,-30
5178063988,5178063990,2,1311,1331,-30
5178635292,5178635296,4,1766,1747,-30
5186552824,5186552827,3,1965,1330,-30
5187354993,5187354998,5,1270,873,-30
5187825971,5187825975,4,1878,1047,-30
5190696600,5190696602,2,2118,892,-30
5194142762,5194142763,1,1349,1094,-30
5195615186,5195615191,5,1600,1222,-30
5197258252,5197258257,5,2229,1103,-30
5197778690,5197778700,10,867,51,-30
5198433005,5198433010,5,2670,1260,-30
5200326654,5200326659,5,2323,1065,-30
5205553193,5205553198,5,2010,1812,-30
5209969792,5209969798,6,2425,1459,-30
5212841726,5212841731,5,2209,1148,-30
5213815090,5213815096,6,2022,1279,-30
5216102594,5216102601,7,1903,657,-30
5218056222,5218056230,8,2885,1659,-30
5222760394,5222760399,5,2723,1381,-30
5230770353,5230770351,-2,1277,1817,-30
5233544425,5233544431,6,2219,1387,-30
5235110345,5235110350,5,2087,929,-30
5240929410,5240929417,7,2178,1384,-30
5242741920,5242741923,3,1695,1083,-30
5244050324,5244050330,6,3186,1128,-30
5246436636,5246436639,3,2411,1616,-30
5249808418,5249808422,4,2515,752,-30
5251551925,5251551929,4,1827,1296,-30
5254642612,5254642616,4,2216,1973,-30
5255693979,5255693985,6,1820,985,-30
5256114906,5256114910,4,2844,1406,-30
5257076922,5257076926,4,2477,1248,-30
5257211126,5257211130,4,1744,1317,-30
5262856366,5262856371,5,2564,912,-30
5265154266,5265154266,0,2859,4495,-30
5268670460,5268670465,5,2338,1030,-30
5270660766,5270660770,4,2457,1117,-30
5271612857,5271612859,2,2446,1147,-30
5273003277,5273003279,2,1665,1396,-30
5273716029,5273716030,1,1670,1826,-30
5277736796,5277736802,6,2440,1572,-30
5281533656,5281533662,6,2525,1358,-30
5286860881,5286860885,4,1302,1602,-30
5290602188,5290602192,4,11842,28833,-30
5291475565,5291475570,5,2207,1143,-30
5294204887,5294204893,6,1555,1387,-30
5294680810,5294680815,5,2146,1127,-30
5299377175,5299377178,3,1340,635,-30
5301011930,5301011936,6,3150,1324,-30
5310847111,5310847117,6,2516,1544,-30
5310950055,5310950059,4,1601,1669,-30
5314086090,5314086089,-1,1226,1465,-30
5317412857,5317412854,-3,1271,1418,-30
5318489122,5318489127,5,2232,1214,-30
5321027307,5321027293,-14,953,1406,-30
5321640871,5321640877,6,2490,1527,-30
5322517877,5322517882,5,2120,920,-30
5325953310,5325953311,1,1486,908,-30
5330622538,5330622543,5,1864,1321,-30
5331344058,5331344062,4,1856,1543,-30
5332177454,5332177458,4,1677,1257,-30
5336161697,5336161702,5,2877,1682,-30
5338166641,5338166647,6,2180,993,-30
5338234506,5338234490,-16,519,401,-30
5338408963,5338408947,-16,1286,2222,-30
5343339418,5343339425,7,2166,1566,-30
5344655351,5344655355,4,1084,871,-30
5348432922,5348432930,8,4435,1209,-30
5349276273,5349276278,5,2897,1402,-30
5350715810,5350715815,5,2767,1727,-30
5352475129,5352475134,5,2271,1238,-30
5355363087,5355363091,4,2077,1204,-30
5355867066,5355867071,5,1429,1032,-30
5356926970,5356926977,7,2699,1595,-30
5359770954,5359770959,5,2588,1428,-30
5360659818,5360659823,5,2128,1557,-30
5363583714,5363583719,5,4561,2062,-30
5364277673,5364277678,5,1887,1209,-30
5365131729,5365131734,5,2150,1178,-30
5367769894,5367769898,4,3162,1450,-30
5384590791,5384590775,-16,1540,1239,-30
5385444569,5385444573,4,3268,2453,-30
5386974399,5386974402,3,1811,1410,-30
5391661270,5391661273,3,1024,1588,-30
5394416534,5394416541,7,3211,1327,-30
5394806167,5394806176,9,2589,1487,-30
5397210310,5397210317,7,3347,1365,-30
5397583906,5397583921,15,752,184,-30
5399890110,5399890117,7,2354,1301,-30
5401133244,5401133249,5,2138,1343,-30
5403508475,5403508479,4,1309,1181,-30
5407536616,5407536623,7,3563,1370,-30
5409066318,5409066322,4,1517,1357,-30
5409176113,5409176117,4,1524,1165,-30
5413826604,5413826608,4,2221,1251,-30
5414395662,5414395661,-1,1227,1585,-30
5416021178,5416021184,6,1585,917,-30
5417501535,5417501538,3,3634,2426,-30
5417877894,5417877899,5,1843,1198,-30
5418678245,5418678250,5,3232,1067,-30
5425272881,5425272886,5,2081,1138,-30
5432083896,5432083899,3,1452,1629,-30
5432587946,5432587955,9,2603,1138,-30
5433062312,5433062314,2,1607,1306,-30
5439408200,5439408206,6,1263,1204,-30
5442506053,5442506054,1,1898,2525,-30
5444188322,5444188325,3,2797,2002,-30
5451222726,5451222727,1,1771,2309,-30
5451497785,5451497790,5,3432,1912,-30
5454737458,5454737462,4,982,1030,-30
5454910910,5454910916,6,2421,1491,-30
5458478541,5458478544,3,2386,1119,-30
5466450085,5466450089,4,2379,1623,-30
5474318557,5474318562,5,2015,585,-30
5474392041,5474392026,-15,2268,740,-30
5482715543,5482715546,3,1455,1037,-30
5482768754,5482768755,1,1330,255,-30
5484385735,5484385739,4,2605,1228,-30
5488867969,5488867963,-6,581,3355,-30
5489039469,5489039475,6,2419,1031,-30
5492903795,5492903801,6,2260,1527,-30
5493027358,5493027363,5,2303,1418,-30
5495801386,5495801394,8,2056,1290,-30
5498176453,5498176459,6,2824,1518,-30
5500416535,5500416534,-1,1978,1897,-30
5500517187,5500517193,6,3040,1740,-30
5501690840,5501690833,-7,1388,607,-30
5503465599,5503465603,4,2089,1325,-30
5503552022,5503552026,4,2052,1477,-30
5503659538,5503659539,1,1114,1817,-30
5505366970,5505366975,5,1655,1238,-30
5511844623,5511844627,4,1211,586,-30
5515176273,5515176278,5,1971,1095,-30
5520369253,5520369258,5,3374,1768,-30
5527359914,5527359919,5,2753,1117,-30
5534299619,5534299625,6,2425,1179,-30
5537276145,5537276149,4,2267,876,-30
5541789222,5541789217,-5,766,2145,-30
5543991181,5543991186,5,2279,1169,-30
5544149773,5544149752,-21,7840,2529,-30
5547991324,5547991329,5,3059,1576,-30
5548872134,5548872139,5,1411,1216,-30
5550716244,5550716250,6,1443,915,-30
5551420453,5551420436,-17,1719,754,-30
5553665615,5553665621,6,2640,1379,-30
5562197041,5562197046,5,2873,1730,-30
5572204365,5572204371,6,3058,1131,-30
5574127122,5574127129,7,2058,1226,-30
5575976962,5575976966,4,2020,1040,-30
5578119877,5578119882,5,2849,1636,-30
5584508050,5584508054,4,1026,980,-30
5584905935,5584905939,4,2060,1258,-30
5586832743,5586832748,5,2033,1595,-30
5589341045,5589341051,6,1930,1101,-30
5598678802,5598678807,5,2570,1254,-30
5604713458,5604713465,7,2620,1533,-30
5605411454,5605411461,7,12872,2668,-30
5607962008,5607962014,6,1790,1692,-30
5609640214,5609640218,4,2032,1212,-30
5609922881,5609922887,6,2349,1397,-30
5611816206,5611816202,-4,1365,3001,-30
5614789891,5614789895,4,1900,1336,-30
5624911744,5624911751,7,3187,1112,-30
5627307476,5627307482,6,2288,1204,-30
5629031130,5629031134,4,1722,1239,-30
5630228482,5630228488,6,2670,1054,-30
5630760954,5630760960,6,14240,20041,-30
5631490634,5631490638,4,1930,1037,-30
5632752946,5632752953,7,5071,1602,-30
5638960302,5638960297,-5,23681,16459,-30
5640700913,5640700916,3,1766,1225,-30
5642263370,5642263375,5,2012,1449,-30
5642341122,5642341105,-17,740,306,-30
5643105287,5643105290,3,1619,2463,-30
5645134585,5645134589,4,1510,1860,-30
5648377348,5648377353,5,2058,1142,-30
5649862315,5649862320,5,2554,1549,-30
5651363968,5651363974,6,2215,1214,-30
5652158635,5652158640,5,2955,1565,-30
5656519044,5656519050,6,2994,1535,-30
5656705214,5656705218,4,2142,945,-30
5656803906,5656803911,5,1880,995,-30
5661472674,5661472678,4,2766,1727,-30
5665584617,5665584619,2,1771,786,-30
5665828118,5665828096,-22,590,240,-30
5666865333,5666865336,3,1633,1682,-30
5671600921,5671600915,-6,839,2241,-30
5674598210,5674598216,6,2654,1407,-30
5675741657,5675741660,3,1296,1001,-30
5675863463,5675863470,7,1983,1386,-30
5678397534,5678397529,-5,761,2420,-30
5678543907,5678543890,-17,1532,1002,-30
5684643538,5684643542,4,2656,1615,-30
5685893766,5685893771,5,2251,1680,-30
5686685114,5686685120,6,2700,1729,-30
5687972462,5687972466,4,2137,1220,-30
5688269318,5688269321,3,1434,1789,-30
5693002495,5693002501,6,1946,1663,-30
5693392327,5693392331,4,1498,958,-30
5693740425,5693740429,4,2453,1505,-30
5699035547,5699035552,5,2953,1484,-30
5699750331,5699750337,6,2440,1567,-30
5701469238,5701469243,5,3376,1276,-30
5706256729,5706256734,5,2512,1665,-30
5710515016,5710515021,5,1987,1215,-30
5711575471,5711575479,8,13613,25576,-30
5715147553,5715147558,5,2106,1259,-30
5715984113,5715984118,5,2435,1410,-30
5716227778,5716227784,6,810,207,-30
5717144219,5717144216,-3,623,2359,-30
5719878230,5719878234,4,2339,1637,-30
5725470111,5725470118,7,2972,1100,-30
5728639201,5728639204,3,3482,3313,-30
5729094474,5729094478,4,2031,1253,-30
5729499269,5729499273,4,1357,1185,-30
5730226697,5730226693,-4,25165,12006,-30
5732879891,5732879899,8,2541,1003,-30
5733090421,5733090402,-19,652,217,-30
5734554877,5734554884,7,3382,1789,-30
5738551017,5738551022,5,2766,1408,-30
5739556593,5739556597,4,1934,1912,-30
5741736486,5741736490,4,2850,1150,-30
5742633937,5742633922,-15,1517,948,-30
5742996630,5742996635,5,2314,1892,-30
5746597849,5746597854,5,3050,1857,-30
5747028011,5747028017,6,2914,1183,-30
5747416285,5747416286,1,1062,1026,-30
5747885506,5747885511,5,1565,1445,-30
5748421780,5748421785,5,1874,1413,-30
5761921909,5761921914,5,3120,1480,-30
5764467303,5764467307,4,1119,945,-30
5765887931,5765887938,7,2588,994,-30
5768313041,5768313046,5,1733,1242,-30
5768980004,5768980009,5,1578,1115,-30
5772755937,5772755940,3,2428,1477,-30
5777932982,5777932986,4,2938,1868,-30
5781048650,5781048651,1,55553,41429,-30
5782602002,5782602007,5,3375,1533,-30
5783154046,5783154024,-22,543,262,-30
5783745954,5783745949,-5,971,3528,-30
5788451302,5788451284,-18,1619,743,-30
5788839666,5788839672,6,3595,1253,-30
5792960194,5792960199,5,1511,1061,-30
5797327701,5797327706,5,7550,29834,-30
5810238910,5810238914,4,1972,974,-30
5813356493,5813356498,5,2628,1154,-30
5813449523,5813449527,4,1282,703,-30
5813671390,5813671402,12,1875,1308,-30
5814007505,5814007522,17,2955,1799,-30
5814723533,5814723513,-20,2477,1000,-30
5818406348,5818406353,5,2476,1662,-30
5822439633,5822439639,6,1441,815,-30
5843081742,5843081749,7,2127,1555,-30
5845395841,5845395847,6,2571,1216,-30
5846677894,5846677897,3,1413,1529,-30
5847180117,5847180119,2,2506,1440,-30
5847313210,5847313214,4,1530,1133,-30
5858347651,5858347655,4,2504,1679,-30
5859126050,5859126054,4,1231,978,-30
5862507319,5862507300,-19,2421,1274,-30
5864196373,5864196379,6,2637,1497,-30
5866501270,5866501275,5,1550,1084,-30
5867455531,5867455539,8,1326,455,-30
5868035921,5868035923,2,2502,1474,-30
5868457593,5868457598,5,3594,1527,-30
5870040507,5870040514,7,3025,1971,-30
5872676169,5872676174,5,2446,1095,-30
5872910835,5872910837,2,1206,1687,-30
5877530571,5877530569,-2,1141,1652,-30
5879298525,5879298531,6,2786,1531,-30
5881374959,5881374961,2,1877,1513,-30
5882225677,5882225682,5,1505,1356,-30
5885407861,5885407867,6,2902,1638,-30
5885750435,5885750435,0,1684,2173,-30
5891938201,5891938206,5,2457,1213,-30
5895722045,5895722050,5,2500,1148,-30
5897732246,5897732253,7,1647,1596,-30
5898898624,5898898629,5,3082,1702,-30
5900318021,5900318027,6,1453,655,-30
5906085095,5906085102,7,1858,878,-30
5910355222,5910355227,5,2301,1441,-30
5919349236,5919349240,4,2541,1765,-30
5919883157,5919883162,5,2231,1301,-30
5921668832,5921668835,3,1889,1109,-30
5922237000,5922236987,-13,1697,862,-30
5928522737,5928522743,6,1744,1239,-30
5933548227,5933548234,7,2470,943,-30
5935558305,5935558309,4,1801,1171,-30
5942564034,5942564038,4,1684,1557,-30
5942757294,5942757298,4,2330,1508,-30
5943782860,5943782864,4,2905,1631,-30
5945843205,5945843210,5,2252,1019,-30
5946397002,5946397009,7,2089,926,-30
5947599450,5947599432,-18,2063,919,-30
5950778909,5950778913,4,2470,1314,-30
5951833613,5951833617,4,2323,951,-30
5952646213,5952646233,20,1751,1057,-30
5956190601,5956190604,3,1288,1395,-30
5958912273,5958912279,6,2584,1382,-30
5964320246,5964320252,6,3399,1863,-30
5964926728,5964926733,5,1691,1495,-30
5965419462,5965419472,10,3472,1463,-30
5966040136,5966040141,5,2163,1212,-30
5966181455,5966181459,4,2431,1573,-30
5971290741,5971290745,4,1860,982,-30
5980212879,5980212885,6,3140,1666,-30
5980950315,5980950330,15,2857,1394,-30
5981054800,5981054801,1,767,179,-30
5983592598,5983592603,5,1551,1272,-30
5985512068,5985512074,6,2850,1750,-30
5987774506,5987774511,5,2884,1720,-30
5989751776,5989751780,4,1556,1195,-30
5990400728,5990400734,6,2368,1149,-30
5990722462,5990722469,7,2317,1265,-30
5990909707,5990909710,3,1838,1378,-30
5996760421,5996760426,5,1476,1341,-30
5997628158,5997628163,5,2578,1426,-30
5997910381,5997910381,0,3149,4874,-30
5999695352,5999695355,3,23577,20200,-30
6001370550,6001370556,6,2052,1321,-30
6009197580,6009197585,5,1713,1571,-30
6013769164,6013769169,5,1295,881,-30
6019317828,6019317829,1,1314,1077,-30
6020064264,6020064265,1,11171,11712,-30
6020368506,6020368510,4,2298,1103,-30
6023033434,6023033438,4,1946,1035,-30
6026921145,6026921149,4,2178,1283,-30
6028838114,6028838119,5,1415,937,-30
6029853890,6029853898,8,2664,1331,-30
6030274460,6030274465,5,2745,2093,-30
6030865143,6030865150,7,3344,1411,-30
6034996231,6034996236,5,2488,1498,-30
6037976623,6037976618,-5,959,4327,-30
6049719574,6049719579,5,2143,900,-30
6051161381,6051161386,5,2312,1266,-30
6052715974,6052715978,4,1835,1615,-30
6053688080,6053688086,6,3890,2340,-30
6054389237,6054389243,6,2703,1501,-30
6054701884,6054701889,5,2690,1655,-30
6057165933,6057165937,4,2213,1361,-30
6059832842,6059832846,4,2514,1202,-30
6060170914,6060170929,15,654,197,-30
6074507274,6074507280,6,2584,1448,-30
6077087234,6077087238,4,1256,1185,-30
6082335426,6082335407,-19,1906,1228,-30
6082783160,6082783163,3,2742,1228,-30
6082824942,6082824947,5,1828,1599,-30
6085175664,6085175669,5,2302,1066,-30
6086741981,6086741983,2,77,1613,-30
6088402537,6088402542,5,2254,1298,-30
6090090255,6090090257,2,21038,19819,-30
6093412866,6093412871,5,2058,1148,-30
6093582140,6093582146,6,2265,1363,-30
6094499257,6094499261,4,1819,1256,-30
6095327009,6095326995,-14,1643,1175,-30
6095387234,6095387239,5,3017,1298,-30
6098625291,6098625297,6,2023,1139,-30
6098657630,6098657634,4,1768,1076,-30
6098820806,6098820812,6,1718,1310,-30
6106860040,6106860046,6,2717,1541,-30
6107264295,6107264276,-19,2509,1515,-30
6107650657,6107650665,8,1838,1361,-30
6110311490,6110311492,2,1351,1929,-30
6110607879,6110607887,8,3126,1537,-30
6113481946,6113481949,3,1744,1503,-30
6114557903,6114557910,7,2137,757,-30
6114767475,6114767478,3,1510,1494,-30
6125373455,6125373459,4,2172,1181,-30
6125886110,6125886123,13,2082,1625,-30
6132008487,6132008494,7,1706,1007,-30
6135468167,6135468173,6,2700,1507,-30
6136494548,6136494548,0,1253,1603,-30
6138299577,6138299582,5,1999,1109,-30
6139847531,6139847525,-6,1824,6159,-30
6142547946,6142547950,4,2268,1096,-30
6144827046,6144827050,4,2066,1336,-30
6145068636,6145068639,3,2280,1182,-30
6149299230,6149299232,2,1544,1512,-30
6151110839,6151110846,7,2700,1287,-30
6153507485,6153507492,7,1867,1710,-30
6154946474,6154946478,4,2964,1616,-30
6155178665,6155178667,2,1398,1371,-30
6156847782,6156847786,4,2121,1147,-30
6161952211,6161952217,6,2307,1109,-30
6162549122,6162549127,5,2999,1323,-30
6162744298,6162744304,6,2640,885,-30
6164504031,6164504035,4,2339,1677,-30
6169199015,6169199018,3,1668,961,-30
6173908248,6173908253,5,3217,1473,-30
6174154277,6174154282,5,1177,1109,-30
6176690677,6176690682,5,1935,1713,-30
6176737723,6176737727,4,2174,1696,-30
6183466733,6183466738,5,1656,1124,-30
6191265694,6191265698,4,1518,1345,-30
6191382201,6191382209,8,1906,1212,-30
6193841986,6193841991,5,1761,1608,-30
6197837438,6197837442,4,1808,1851,-30
6200496609,6200496616,7,10363,1355,-30
6203910653,6203910658,5,2344,1214,-30
6204183024,6204183017,-7,947,3480,-30
6205623273,6205623277,4,1795,1236,-30
6209110026,6209110031,5,1969,1167,-30
6210162777,6210162781,4,2775,1265,-30
6210197791,6210197792,1,1303,19809,-30
6212678733,6212678738,5,2980,1594,-30
6220405461,6220405454,-7,874,3464,-30
6223563510,6223563514,4,2070,1444,-30
6228767085,6228767091,6,1927,1011,-30
6229220443,6229220427,-16,657,484,-30
6229895862,6229895866,4,2659,1465,-30
6230718137,6230718141,4,3620,1535,-30
6230979617,6230979610,-7,1208,6157,-30
6232185068,6232185073,5,1797,896,-30
6235456123,6235456126,3,3123,1373,-30
6235883419,6235883425,6,2731,973,-30
6237494882,6237494886,4,2214,1226,-30
6237803294,6237803299,5,2190,1195,-30
6241034249,6241034254,5,2166,1107,-30
6244511502,6244511507,5,2302,993,-30
6246042038,6246042044,6,1876,1398,-30
6257507814,6257507798,-16,1265,567,-30
6257692350,6257692355,5,3569,1488,-30
6258455947,6258455951,4,1806,1571,-30
6263476008,6263476012,4,1861,1617,-30
6264778629,6264778635,6,2146,818,-30
6265004890,6265004891,1,11609,11190,-30
6270445625,6270445618,-7,1454,7404,-30
6271404748,6271404749,1,2048,2318,-30
6272362385,6272362390,5,2021,1315,-30
6280500637,6280500641,4,1877,1140,-30
6282341561,6282341570,9,17881,19675,-30
6284426466,6284426466,0,1901,2093,-30
6289666206,6289666211,5,1418,735,-30
6290935961,6290935964,3,1690,1220,-30
6291600062,6291600067,5,2652,1309,-30
6292701100,6292701106,6,2728,1246,-30
6295960517,6295960527,10,13222,43907,-30
6296753273,6296753279,6,2164,954,-30
6298788116,6298788118,2,3522,3412,-30
6299399783,6299399782,-1,1548,2041,-30
6301412771,6301412778,7,1789,862,-30
6302290037,6302290042,5,4650,2653,-30
6303261434,6303261439,5,2804,1037,-30
6306275559,6306275562,3,2667,1745,-30
6311340967,6311340973,6,1998,1565,-30
6312827909,6312827911,2,1501,1428,-30
6314635495,6314635495,0,1087,986,-30
6318237537,6318237517,-20,1423,808,-30
6331683000,6331683004,4,2646,1428,-30
6333665103,6333665107,4,2245,853,-30
6334300963,6334300969,6,2684,1556,-30
6336678593,6336678597,4,2733,1734,-30
6339159519,6339159524,5,2435,1254,-30
6342387861,6342387869,8,2610,1121,-30
6344214925,6344214929,4,1182,1057,-30
6344523687,6344523692,5,1872,1527,-30
6345384313,6345384318,5,1810,1259,-30
6348869565,6348869567,2,1618,2316,-30
6349097610,6349097615,5,2297,1574,-30
6349959186,6349959190,4,1745,882,-30
6351733186,6351733192,6,2467,1226,-30
6353892033,6353892040,7,4431,1348,-30
6355833507,6355833513,6,2974,886,-30
6356566824,6356566829,5,1784,1332,-30
6362371672,6362371676,4,2386,989,-30
6363185463,6363185467,4,2211,1250,-30
6365442918,6365442922,4,1659,1254,-30
6369740280,6369740283,3,2210,1275,-30
6371642610,6371642614,4,2594,1752,-30
6376372852,6376372855,3,1503,1386,-30
6376548113,6376548117,4,1837,1533,-30
6381315430,6381315409,-21,1359,1062,-30
6383196809,6383196807,-2,1573,1284,-30
6384936657,6384936663,6,1931,1056,-30
6385688602,6385688606,4,2355,1381,-30
6389337260,6389337266,6,1741,729,-30
6394147942,6394147950,8,11943,7181,-30
6396645790,6396645796,6,2477,1402,-30
6397928106,6397928110,4,1756,1477,-30
6400208383,6400208387,4,1609,768,-30
6402139246,6402139252,6,1682,1699,-30
6402489830,6402489835,5,2068,1019,-30
6406237690,6406237695,5,1572,1243,-30
6406537498,6406537501,3,2143,1481,-30
6409597533,6409597539,6,1658,1255,-30
6413342662,6413342665,3,1987,1398,-30
6421121537,6421121542,5,1684,1106,-30
6421303234,6421303238,4,2674,1566,-30
6429505130,6429505135,5,2077,1473,-30
6431755805,6431755806,1,1491,909,-30
6441523660,6441523664,4,2558,1185,-30
6442414854,6442414859,5,1635,1592,-30
6443039684,6443039687,3,1533,1209,-30
6445132278,6445132283,5,2304,1145,-30
6447141841,6447141846,5,1859,937,-30
6449264714,6449264719,5,3258,1661,-30
6456961749,6456961770,21,1035,1710,-30
6457511682,6457511687,5,898,808,-30
6460527993,6460527976,-17,2239,1309,-30
6467806446,6467806452,6,2672,1760,-30
6468176278,6468176282,4,1730,1650,-30
6471520067,6471520071,4,2939,1720,-30
6473521462,6473521467,5,1943,1516,-30
6475232106,6475232111,5,2427,1170,-30
6477769134,6477769139,5,2047,1199,-30
6478911485,6478911477,-8,1513,5572,-30
6480464283,6480464287,4,2604,1228,-30
6482424493,6482424494,1,1432,2027,-30
6483358529,6483358534,5,2887,2068,-30
6486137930,6486137935,5,2801,1481,-30
6493348686,6493348686,0,1147,1886,-30
6499440446,6499440453,7,2305,1275,-30
6500888918,6500888923,5,1744,989,-30
6501093633,6501093636,3,1540,1045,-30
6502269616,6502269621,5,2970,1804,-30
6510413099,6510413102,3,1279,1255,-30
6513468345,6513468350,5,2013,1293,-30
6517438248,6517438249,1,2324,1508,-30
6517546828,6517546851,23,2240,1202,-30
6518829998,6518830005,7,2628,1662,-30
6529702445,6529702449,4,2150,1872,-30
6530431111,6530431117,6,1703,1145,-30
6531772249,6531772258,9,1729,1337,-30
6536224565,6536224569,4,2753,1814,-30
6536266918,6536266930,12,1655,1601,-30
6537755110,6537755114,4,2373,1906,-30
6541287179,6541287186,7,3381,1788,-30
6544688983,6544688989,6,1417,1333,-30
6545414821,6545414827,6,1847,1289,-30
6547819110,6547819114,4,2736,1809,-30
6549485297,6549485301,4,2276,1729,-30
6553878722,6553878727,5,2762,1591,-30
6557178387,6557178394,7,1745,1216,-30
6559346322,6559346327,5,3070,1319,-30
6564997107,6564997105,-2,1167,2905,-30
6565310882,6565310887,5,2470,1650,-30
6565988066,6565988070,4,1621,971,-30
6567359272,6567359276,4,2283,1265,-30
6568748117,6568748123,6,2346,1353,-30
6569512129,6569512134,5,1668,1070,-30
6574604045,6574604050,5,1200,766,-30
6574941553,6574941559,6,2562,1266,-30
6577391567,6577391574,7,2468,1043,-30
6582294834,6582294838,4,2899,1595,-30
6583000143,6583000147,4,1975,968,-30
6586830374,6586830372,-2,19096,8346,-30
6587291277,6587291280,3,1434,1101,-30
6591152726,6591152731,5,1772,1186,-30
6592476366,6592476367,1,1990,1517,-30
6592514524,6592514531,7,2256,1079,-30
6593057396,6593057402,6,2363,1164,-30
6594679259,6594679263,4,1240,787,-30
6597494790,6597494795,5,2107,1377,-30
6599719057,6599719061,4,2250,1264,-30
6603410218,6603410223,5,2424,1332,-30
6606455746,6606455732,-14,992,512,-30
6612151707,6612151713,6,2234,972,-30
6615511815,6615511798,-17,2584,1326,-30
6615579086,6615579092,6,3033,1324,-30
6615648165,6615648187,22,2721,1430,-30
6616345193,6616345198,5,2869,1313,-30
6616829196,6616829202,6,1612,1074,-30
6617828433,6617828434,1,2084,3371,-30
6618920536,6618920516,-20,804,299,-30
6621557629,6621557633,4,1418,1203,-30
6622429554,6622429559,5,2219,1430,-30
6625299876,6625299883,7,1549,961,-30
6631383205,6631383211,6,1952,973,-30
6632307997,6632308000,3,2388,1783,-30
6634957873,6634957877,4,2635,2173,-30
6638853946,6638853938,-8,1286,5613,-30
6639550637,6639550641,4,1913,1172,-30
6640692219,6640692223,4,3095,1489,-30
6642642980,6642642987,7,3649,1112,-30
6648341505,6648341510,5,5067,3139,-30
6656551807,6656551813,6,3256,1412,-30
6657933474,6657933479,5,3396,1187,-30
6658355897,6658355901,4,2161,1200,-30
6658591750,6658591755,5,2244,1228,-30
6663356662,6663356670,8,2639,1521,-30
6666051807,6666051811,4,2418,1195,-30
6666961862,6666961844,-18,1912,1057,-30
6669349231,6669349236,5,1889,1142,-30
6676802985,6676802988,3,2876,2189,-30
6678060257,6678060261,4,8338,3879,-30
6680346179,6680346183,4,2398,1462,-30
6681174190,6681174191,1,1478,1562,-30
6683596781,6683596786,5,2515,1510,-30
6683674597,6683674603,6,2639,1922,-30
6684620872,6684620874,2,1521,1891,-30
6684760885,6684760873,-12,1395,1069,-30
6690378622,6690378628,6,4059,1991,-30
6691134308,6691134314,6,2467,1103,-30
6692250605,6692250609,4,2252,1256,-30
6695363776,6695363780,4,2339,1587,-30
6695530149,6695530168,19,1690,977,-30
6695637858,6695637863,5,2406,1649,-30
6696253802,6696253807,5,3041,1977,-30
6697251503,6697251507,4,2630,946,-30
6700498706,6700498707,1,1223,1358,-30
6700891862,6700891866,4,2051,1492,-30
6702724905,6702724910,5,2087,1191,-30
6705541126,6705541130,4,2286,1235,-30
6706656150,6706656156,6,1438,878,-30
6709415588,6709415595,7,2571,1352,-30
6710331338,6710331343,5,2375,1276,-30
6714171680,6714171686,6,2589,1394,-30
6715408113,6715408123,10,2607,1717,-30
6715468812,6715468817,5,1963,1509,-30
6719695524,6719695529,5,1685,1356,-30
6722166701,6722166707,6,2681,1267,-30
6726512330,6726512334,4,2459,1439,-30
6728148258,6728148263,5,2423,1174,-30
6730714130,6730714134,4,2161,1503,-30
6733166442,6733166448,6,2249,1184,-30
6736801166,6736801171,5,2207,1411,-30
6737817502,6737817505,3,2323,1594,-30
6740487438,6740487445,7,3359,1386,-30
6740716180,6740716183,3,2010,1456,-30
6744306867,6744306872,5,2663,1272,-30
6745045629,6745045633,4,2335,1492,-30
6746016024,6746016031,7,2777,1023,-30
6756706578,6756706582,4,2885,1378,-30
6759208082,6759208087,5,2980,1196,-30
6760895656,6760895661,5,1902,1306,-30
6764776291,6764776287,-4,932,2525,-30
6768041576,6768041583,7,2150,1261,-30
6769238154,6769238154,0,2658,4236,-30
6774237554,6774237557,3,3309,1441,-30
6777513399,6777513402,3,2137,865,-30
6778056383,6778056402,19,1086,848,-30
6789897507,6789897511,4,2178,1529,-30
6796621303,6796621310,7,2481,1404,-30
6801223802,6801223806,4,2156,1032,-30
6803584073,6803584078,5,1903,1537,-30
6804412888,6804412884,-4,2129,6377,-30
6804555991,6804555995,4,1658,1153,-30
6805047545,6805047548,3,2301,1510,-30
6805475318,6805475317,-1,1710,1605,-30
6806853198,6806853202,4,2101,1097,-30
6807309768,6807309754,-14,1202,668,-30
6812422431,6812422418,-13,10958,43771,-30
6818428466,6818428470,4,2529,1374,-30
6818759371,6818759355,-16,2552,851,-30
6819456019,6819456023,4,2478,1181,-30
6823038953,6823038959,6,1964,1142,-30
6828888532,6828888550,18,1335,758,-30
6832239703,6832239698,-5,1039,3323,-30
6834022338,6834022344,6,2015,1401,-30
6837494361,6837494365,4,1462,1227,-30
6838199062,6838199064,2,2343,1440,-30
6839969166,6839969170,4,2040,938,-30
6841862306,6841862311,5,1945,886,-30
6844644543,6844644548,5,1822,1193,-30
6846519416,6846519418,2,1593,1469,-30
6847801137,6847801142,5,1317,1349,-30
6847982602,6847982621,19,2277,1237,-30
6851019638,6851019644,6,2039,923,-30
6854519756,6854519762,6,2302,1070,-30
6854888098,6854888105,7,2379,1107,-30
6858682194,6858682198,4,1539,1783,-30
6861223234,6861223233,-1,3695,18449,-30
6862368282,6862368285,3,2210,1098,-30
6863998747,6863998750,3,170,1562,-30
6864721342,6864721346,4,1717,1340,-30
6866121326,6866121331,5,2653,1563,-30
6867545834,6867545837,3,2467,1148,-30
6872679340,6872679343,3,1705,1035,-30
6874244365,6874244372,7,2388,1056,-30
6880574446,6880574435,-11,1212,708,-30
6882227769,6882227774,5,1740,942,-30
6884031002,6884031007,5,2644,1353,-30
6887088456,6887088458,2,1460,1478,-30
6888794971,6888794976,5,2133,1335,-30
6889759816,6889759821,5,2031,1331,-30
6892505130,6892505136,6,4262,1818,-30
6894612102,6894612107,5,1667,1363,-30
6898855970,6898855975,5,2164,1292,-30
6901819309,6901819312,3,2660,1508,-30
6901901818,6901901823,5,4040,2177,-30
6903274017,6903274016,-1,1136,2354,-30
6904695501,6904695506,5,2758,1254,-30
6908390246,6908390252,6,2419,1661,-30
6914202650,6914202655,5,2311,1194,-30
6914734505,6914734509,4,2339,1342,-30
6917328940,6917328945,5,1847,1047,-30
6917541733,6917541754,21,1870,1266,-30
6918043341,6918043345,4,1861,1688,-30
6918478194,6918478203,9,1452,1270,-30
6920790446,6920790450,4,1816,1170,-30
6921831850,6921831853,3,1941,1882,-30
6925509343,6925509345,2,2315,1782,-30
6927708474,6927708481,7,2181,1111,-30
6927945965,6927945971,6,2032,760,-30
6931329854,6931329862,8,2616,1340,-30
6931663348,6931663353,5,2446,1067,-30
6931688626,6931688624,-2,701,51,-30
6931702186,6931702184,-2,27,18,-30
6940945784,6940945790,6,2152,1145,-30
6942975449,6942975454,5,2141,1044,-30
6947244006,6947244010,4,2639,1028,-30
6950492911,6950492916,5,1467,790,-30
6950691797,6950691802,5,1747,1139,-30
6952258489,6952258486,-3,1886,3471,-30
6955591798,6955591802,4,2033,1024,-30
6960057534,6960057539,5,2410,1349,-30
6960763598,6960763602,4,3559,2002,-30
6971738258,6971738262,4,1551,933,-30
6973801049,6973801055,6,3078,1373,-30
6975551348,6975551351,3,3486,1549,-30
6975785117,6975785118,1,2398,1639,-30
6977428657,6977428658,1,1917,1666,-30
6978543632,6978543637,5,2353,1558,-30
6979053231,6979053237,6,2471,1593,-30
6979914088,6979914092,4,2307,1608,-30
6989608329,6989608334,5,2249,1177,-30
6993137148,6993137153,5,1842,1403,-30
6994148641,6994148646,5,2555,1785,-30
6994612343,6994612350,7,2810,1395,-30
6997601798,6997601807,9,1825,1002,-30
7000368299,7000368302,3,1833,1252,-30
7001036084,7001036097,13,2219,1264,-30
7005843451,7005843458,7,2689,1627,-30
7005906181,7005906187,6,2877,1487,-30
7008902234,7008902239,5,1997,1291,-30
7008987807,7008987811,4,2492,1240,-30
7009410073,7009410067,-6,1962,6142,-30
7011285070,7011285069,-1,1501,2307,-30
7011510471,7011510476,5,2688,1377,-30
7015611066,7015611072,6,2542,1724,-30
7016346598,7016346603,5,1713,1119,-30
7017321613,7017321608,-5,2213,4933,-30
7018429881,7018429886,5,2493,1567,-30
7018515942,7018515946,4,1555,1010,-30
7027408722,7027408727,5,2173,968,-30
7033062477,7033062481,4,2314,933,-30
7033676149,7033676150,1,1123,1071,-30
7034188593,7034188599,6,2466,1282,-30
7034451514,7034451518,4,2379,1251,-30
7041362477,7041362479,2,3532,3957,-30
7041650783,7041650777,-6,1119,3979,-30
7042454333,7042454340,7,2679,1184,-30
7044507331,7044507339,8,4685,1656,-30
7046645052,7046645055,3,1172,1422,-30
7046672292,7046672310,18,246,2013,-30
7047127670,7047127676,6,1885,1323,-30
7047312533,7047312539,6,2002,1746,-30
7048645451,7048645459,8,8097,2803,-30
7049735848,7049735852,4,1723,1125,-30
7052670434,7052670432,-2,1073,2265,-30
7060129431,7060129429,-2,8525,16883,-30
7066323336,7066323339,3,1558,791,-30
7068952225,7068952229,4,1100,1066,-30
7071664250,7071664255,5,2690,1132,-30
7075987573,7075987578,5,2734,1799,-30
7078006574,7078006578,4,1808,1227,-30
7078286174,7078286181,7,1460,735,-30
7078838262,7078838267,5,2419,1039,-30
7086248930,7086248935,5,3610,1539,-30
7091565504,7091565506,2,1004,783,-30
7094191104,7094191104,0,1592,2271,-30
7094943038,7094943045,7,2844,1339,-30
7096273549,7096273546,-3,3011,9181,-30
7103328073,7103328078,5,2765,1067,-30
7104684570,7104684575,5,2335,1274,-30
7105419031,7105419029,-2,561,1816,-30
7108045590,7108045596,6,2140,884,-30
7108274920,7108274926,6,2174,1236,-30
7121146401,7121146406,5,1544,1052,-30
7122734131,7122734137,6,2387,1391,-30
7123194502,7123194480,-22,2222,804,-30
7124514866,7124514873,7,3297,1271,-30
7130206593,7130206598,5,3592,1837,-30
7133079613,7133079619,6,3832,2120,-30
7135465346,7135465353,7,2464,1532,-30
7136068562,7136068566,4,2622,1439,-30
7138800069,7138800072,3,1865,1202,-30
7142172550,7142172554,4,1609,941,-30
7143225386,7143225391,5,2459,1300,-30
7145065651,7145065654,3,1886,1567,-30
7145291300,7145291322,22,2125,1030,-30
7149351249,7149351254,5,2246,1410,-30
7149767928,7149767934,6,1757,1187,-30
7150900677,7150900682,5,2846,1401,-30
7151071818,7151071823,5,2259,902,-30
7152027830,7152027834,4,2227,1015,-30
7155326615,7155326620,5,2302,1602,-30
7156804142,7156804147,5,1933,1054,-30
7158707415,7158707422,7,3553,1583,-30
7161531548,7161531554,6,2939,1448,-30
7162337898,7162337903,5,2026,1694,-30
7164635249,7164635255,6,2234,1205,-30
7164981591,7164981597,6,2115,1346,-30
7167643276,7167643280,4,2880,1643,-30
7167807515,7167807518,3,5674,4073,-30
7168247446,7168247452,6,1899,1126,-30
7169639234,7169639244,10,2376,1165,-30
7175885037,7175885042,5,2239,1416,-30
7176474048,7176474052,4,2017,1272,-30
7177081087,7177081092,5,1758,955,-30
7179574947,7179574942,-5,1867,4488,-30
7184227589,7184227594,5,1722,1543,-30
7184346335,7184346321,-14,793,457,-30
7185360610,7185360614,4,1539,838,-30
7187123617,7187123622,5,2705,1111,-30
7187275177,7187275181,4,1963,1130,-30
7191861749,7191861754,5,1599,1348,-30
7194855330,7194855334,4,2236,2029,-30
7199764894,7199764899,5,1977,1550,-30
7200520375,7200520382,7,1628,1351,-30
7205749231,7205749238,7,2987,1582,-30
7207500660,7207500664,4,2243,1178,-30
7216025954,7216025961,7,1942,1039,-30
7217733046,7217733059,13,2134,1486,-30
7219815314,7219815316,2,2582,1604,-30
7231738229,7231738235,6,1732,1012,-30
7233149587,7233149607,20,14933,17990,-30
7238818739,7238818746,7,2691,1544,-30
7240071736,7240071742,6,2153,1045,-30
7242879495,7242879500,5,1346,1062,-30
7243961323,7243961327,4,947,759,-30
7244544649,7244544654,5,3486,2142,-30
7244719815,7244719809,-6,848,2956,-30
7247562502,7247562507,5,1542,953,-30
7253159732,7253159738,6,1266,1058,-30
7258055474,7258055477,3,2434,1394,-30
7258565186,7258565182,-4,1545,4282,-30
7260580716,7260580721,5,1258,805,-30
7262894473,7262894467,-6,812,1025,-30
7264928658,7264928662,4,1998,885,-30
7269557762,7269557764,2,2057,1490,-30
7270634792,7270634798,6,2645,1506,-30
7273996297,7273996301,4,2124,1332,-30
7274436104,7274436109,5,2774,1518,-30
7277603626,7277603625,-1,4007,5447,-30
7278300216,7278300235,19,195,1545,-30
7281810503,7281810509,6,2281,1440,-30
7282013053,7282013058,5,2369,1330,-30
7282637944,7282637951,7,2433,1309,-30
7283395685,7283395691,6,2865,1418,-30
7293176317,7293176321,4,3439,1838,-30
7293724338,7293724343,5,2223,1241,-30
7294951689,7294951694,5,1399,1056,-30
7297312665,7297312670,5,2680,1140,-30
7306923422,7306923427,5,945,1277,-30
7307221205,7307221211,6,2089,1294,-30
7307401243,7307401247,4,2146,1187,-30
7308341247,7308341253,6,2583,1965,-30
7308449942,7308449945,3,1711,1246,-30
7309644162,7309644166,4,2865,1661,-30
7309765038,7309765045,7,3316,1680,-30
7312249307,7312249310,3,1839,1602,-30
7312416157,7312416163,6,2296,1157,-30
7313929764,7313929769,5,2422,1221,-30
7322343098,7322343104,6,2727,1367,-30
7325046956,7325046959,3,1702,1383,-30
7326852149,7326852155,6,1536,767,-30
7335751665,7335751667,2,2028,1208,-30
7339416146,7339416150,4,2204,1302,-30
7340399416,7340399413,-3,2188,5280,-30
7342405527,7342405533,6,2213,1672,-30
7342902568,7342902574,6,2578,1223,-30
7343649542,7343649521,-21,3238,1208,-30
7344785486,7344785492,6,2694,1340,-30
7351035394,7351035399,5,2802,1200,-30
7351194125,7351194106,-19,866,220,-30
7355047889,7355047882,-7,1642,5597,-30
7356684694,7356684699,5,3501,1704,-30
7358713757,7358713764,7,1577,854,-30
7360774985,7360774990,5,3420,1221,-30
7364617326,7364617331,5,842,451,-30
7373003375,7373003379,4,2266,1147,-30
7375425910,7375425915,5,1646,1302,-30
7376607882,7376607886,4,1662,1627,-30
7378367693,7378367698,5,2090,1082,-30
7379387909,7379387915,6,833,270,-30
7385114522,7385114523,1,1411,1320,-30
7385288154,7385288139,-15,1116,250,-30
7392976529,7392976536,7,1888,1031,-30
7394706995,7394706999,4,2658,1369,-30
7395249022,7395249035,13,2580,1297,-30
7395567979,7395567969,-10,612,305,-30
7396105319,7396105325,6,3052,1433,-30
7398326630,7398326635,5,1859,1223,-30
7399738982,7399738986,4,1911,1190,-30
7409819333,7409819339,6,2810,1637,-30
7410247818,7410247818,0,22905,86040,-30
7411934100,7411934105,5,1488,1800,-30
7413104221,7413104215,-6,1189,3459,-30
7419882911,7419882915,4,2607,1692,-30
7421688373,7421688377,4,1751,1135,-30
7421902750,7421902771,21,3188,1678,-30
7425429199,7425429203,4,1714,959,-30
7430922563,7430922569,6,2903,1161,-30
7433077886,7433077890,4,2379,1030,-30
7440285183,7440285190,7,2899,1230,-30
7443102697,7443102701,4,3120,1594,-30
7448660257,7448660261,4,1952,1090,-30
7449687666,7449687663,-3,1141,2120,-30
7450416441,7450416443,2,2866,1685,-30
7451798977,7451798980,3,2955,1795,-30
7453351366,7453351370,4,1903,995,-30
7455630503,7455630509,6,2159,1201,-30
7456054709,7456054689,-20,1420,1643,-30
7458434289,7458434294,5,1922,1634,-30
7462263767,7462263771,4,2489,1131,-30
7463725862,7463725869,7,2282,1004,-30
7464481473,7464481456,-17,1903,634,-30
7465584840,7465584845,5,2140,1303,-30
7465775330,7465775335,5,1715,1253,-30
7466686386,7466686392,6,2460,1297,-30
7466814607,7466814628,21,772,255,-30
7468280375,7468280373,-2,959,1444,-30
7471412554,7471412558,4,2375,1198,-30
7473061605,7473061609,4,1406,1044,-30
7475388469,7475388474,5,1756,1204,-30
7477375487,7477375493,6,2345,1088,-30
7477542330,7477542327,-3,1013,2056,-30
7481517227,7481517232,5,1904,1930,-30
7483565970,7483565974,4,2097,1200,-30
7484880481,7484880486,5,2731,1176,-30
7485256217,7485256203,-14,3073,1882,-30
7487494479,7487494484,5,2038,1418,-30
7487557390,7487557395,5,2479,1021,-30
7487769995,7487770012,17,1447,926,-30
7492418238,7492418242,4,2949,1922,-30
7492540283,7492540276,-7,1156,5674,-30
7493958003,7493958008,5,1594,1380,-30
7495713247,7495713252,5,2156,1143,-30
7495823114,7495823098,-16,2249,952,-30
7498300885,7498300891,6,1943,744,-30
7499910791,7499910795,4,2766,1014,-30
7500818869,7500818874,5,2184,1257,-30
7502576927,7502576933,6,2238,1391,-30
7507861822,7507861826,4,2538,1442,-30
7508321917,7508321934,17,6833,829,-30
7510337029,7510337022,-7,1962,7073,-30
7516253443,7516253447,4,4411,3574,-30
7517218049,7517218053,4,1644,1169,-30
7521715733,7521715737,4,1845,1457,-30
7526931414,7526931413,-1,805,1468,-30
7529025935,7529025939,4,1081,1110,-30
7530990835,7530990828,-7,819,3829,-30
7531405287,7531405288,1,2140,3673,-30
7537798734,7537798740,6,2780,1657,-30
7538335543,7538335547,4,1740,977,-30
7540590678,7540590683,5,2512,1059,-30
7544205016,7544205019,3,2907,1853,-30
7546767927,7546767933,6,3117,1495,-30
7547668604,7547668607,3,1948,1385,-30
7547908474,7547908482,8,1806,1483,-30
7555206130,7555206135,5,1486,1007,-30
7556350994,7556350979,-15,776,633,-30
7557539737,7557539741,4,2005,1312,-30
7562085439,7562085443,4,2513,1120,-30
7562949653,7562949658,5,2476,1405,-30
7572652290,7572652295,5,2304,2104,-30
7575870537,7575870542,5,2279,1297,-30
7580103976,7580103980,4,2085,1352,-30
7582149397,7582149400,3,1944,1100,-30
7584898277,7584898282,5,3038,1363,-30
7588265786,7588265784,-2,1090,1676,-30
7589173090,7589173093,3,1398,1138,-30
7589806718,7589806723,5,2279,1552,-30
7590455401,7590455394,-7,981,3933,-30
7590732359,7590732365,6,3082,1630,-30
7591749201,7591749205,4,1512,1295,-30
7592551602,7592551605,3,1805,999,-30
7596768683,7596768691,8,2483,1103,-30
7600476970,7600476978,8,3879,1258,-30
7601480721,7601480730,9,2149,1378,-30
7601682375,7601682382,7,2734,1508,-30
7602407838,7602407842,4,1338,1214,-30
7605164607,7605164610,3,1561,1600,-30
7606077182,7606077185,3,1701,1213,-30
7606798913,7606798918,5,2273,1184,-30
7611077601,7611077606,5,1575,1463,-30
7613599632,7613599637,5,4833,2653,-30
7615799442,7615799441,-1,998,1617,-30
7616393851,7616393857,6,3849,1592,-30
7617567421,7617567427,6,1830,1229,-30
7617709226,7617709241,15,1063,454,-30
7618043503,7618043488,-15,794,363,-30
7619548878,7619548882,4,2096,1486,-30
7627231126,7627231132,6,2247,1260,-30
7633498389,7633498394,5,1698,944,-30
7638763525,7638763530,5,2570,1259,-30
7643463710,7643463715,5,1860,1158,-30
7644437503,7644437509,6,2355,1345,-30
7650005791,7650005794,3,1619,910,-30
7655119455,7655119458,3,1613,1318,-30
7656166284,7656166285,1,1301,1787,-30
7657761837,7657761841,4,2148,1423,-30
7667146439,7667146444,5,1225,966,-30
7673416223,7673416232,9,13385,44126,-30
7674118396,7674118399,3,2460,1300,-30
7678496210,7678496214,4,1143,1316,-30
7679119614,7679119619,5,2280,1100,-30
7682326903,7682326910,7,1847,1466,-30
7684163754,7684163760,6,3096,1540,-30
7686432432,7686432437,5,2064,1207,-30
7690955217,7690955221,4,2612,1653,-30
7691186186,7691186168,-18,1611,560,-30
7691686394,7691686397,3,1395,1566,-30
7692532131,7692532146,15,1518,944,-30
7693289722,7693289727,5,1596,1011,-30
7693535163,7693535170,7,3072,1616,-30
7694005189,7694005193,4,2469,1902,-30
7694756479,7694756482,3,1329,1371,-30
7696169228,7696169234,6,2122,1178,-30
7698733066,7698733071,5,3041,1484,-30
7699552207,7699552210,3,1605,1879,-30
7700201881,7700201881,0,1916,1930,-30
7701818120,7701818125,5,2974,1735,-30
7702106065,7702106048,-17,983,343,-30
7702330988,7702330975,-13,9830,27694,-30
7702416446,7702416453,7,2376,1192,-30
7706291957,7706291962,5,2253,1359,-30
7706904097,7706904100,3,2082,981,-30
7710623301,7710623306,5,1950,1286,-30
7717243511,7717243515,4,2666,797,-30
7717742911,7717742916,5,2924,1957,-30
7719098321,7719098327,6,3085,1620,-30
7719404263,7719404267,4,2012,1614,-30
7720733837,7720733842,5,2244,1253,-30
7721961984,7721961989,5,2476,1755,-30
7722637565,7722637570,5,1949,1117,-30
7723838322,7723838329,7,2573,1182,-30
7725335748,7725335753,5,1932,1616,-30
7725408554,7725408557,3,2374,1184,-30
7726084925,7726084944,19,1135,484,-30
7727128117,7727128108,-9,733,401,-30
7729663610,7729663593,-17,2060,1015,-30
7730423351,7730423357,6,1913,1088,-30
7731612961,7731612967,6,2561,1560,-30
7733553789,7733553768,-21,770,344,-30
7734680907,7734680911,4,2217,1218,-30
7749254653,7749254658,5,2336,1517,-30
7749443754,7749443759,5,2477,1075,-30
7749471379,7749471386,7,2375,1031,-30
7749804647,7749804626,-21,1547,494,-30
7752640087,7752640091,4,1616,1150,-30
7753621725,7753621731,6,2696,1733,-30
7756156317,7756156321,4,1659,1124,-30
7757017426,7757017423,-3,721,256,-30
7765218859,7765218864,5,2254,1089,-30
7767165379,7767165383,4,1979,1007,-30
7767938813,7767938817,4,1992,1135,-30
7771970941,7771970946,5,1410,1192,-30
7774398202,7774398207,5,2846,1567,-30
7775860806,7775860813,7,2906,1461,-30
7777178198,7777178201,3,2473,1302,-30
7777921701,7777921701,0,11242,14016,-30
7779573725,7779573729,4,2080,1213,-30
7779724485,7779724491,6,3129,1161,-30
7780376058,7780376074,16,863,2076,-30
7780589772,7780589775,3,2367,990,-30
7781965005,7781965011,6,2730,1026,-30
7787747767,7787747771,4,1892,999,-30
7788200595,7788200579,-16,2958,1979,-30
7790682429,7790682433,4,1946,1537,-30
7792362837,7792362842,5,2565,1302,-30
7792838465,7792838470,5,3145,1366,-30
7792873085,7792873099,14,3188,1326,-30
7793113550,7793113555,5,2180,1292,-30
7793641302,7793641306,4,2592,1179,-30
7805689568,7805689569,1,1644,1493,-30
7808221282,7808221287,5,2666,1430,-30
7816801942,7816801950,8,2994,1626,-30
7817644710,7817644715,5,148,233,-30
7817943268,7817943252,-16,2817,941,-30
7831319765,7831319769,4,2119,1215,-30
7832632892,7832632897,5,1226,649,-30
7834274332,7834274337,5,1891,1467,-30
7836563604,7836563609,5,2045,1577,-30
7838267914,7838267918,4,1388,1156,-30
7845848029,7845848034,5,1806,840,-30
7846091167,7846091173,6,2414,1143,-30
7851607618,7851607623,5,3699,1358,-30
7851863406,7851863388,-18,1929,784,-30
7857323348,7857323352,4,1904,1272,-30
7858070194,7858070199,5,3173,1399,-30
7858798582,7858798587,5,3197,1299,-30
7860574755,7860574758,3,1237,1025,-30
7860611689,7860611694,5,1150,1617,-30
7865687864,7865687869,5,2403,1583,-30
7868092178,7868092183,5,2270,1323,-30
7871371637,7871371642,5,3166,1688,-30
7876057897,7876057901,4,2062,1164,-30
7877307441,7877307448,7,2218,1447,-30
7880411509,7880411513,4,2895,1384,-30
7882353663,7882353667,4,1995,1375,-30
7884015086,7884015081,-5,1363,3067,-30
7895455598,7895455605,7,2586,1396,-30
7901840830,7901840834,4,2123,1263,-30
7902624574,7902624579,5,2085,1313,-30
7905145409,7905145411,2,2334,1939,-30
7908539701,7908539701,0,2200,2533,-30
7908673150,7908673156,6,1797,1008,-30
7911769215,7911769222,7,2387,1342,-30
7913694573,7913694577,4,3297,1425,-30
7914628703,7914628707,4,1360,637,-30
7915254083,7915254089,6,2028,1257,-30
7916160985,7916160989,4,1935,1152,-30
7919137604,7919137611,7,2202,1169,-30
7919552941,7919552947,6,2181,1213,-30
7922429511,7922429522,11,2535,1224,-30
7925397850,7925397855,5,1622,1174,-30
7933849198,7933849201,3,2301,1794,-30
7936340751,7936340757,6,2834,1588,-30
7938631953,7938631957,4,2224,1709,-30
7938883125,7938883129,4,2629,1377,-30
7943519219,7943519224,5,1275,919,-30
7944150689,7944150695,6,3233,1503,-30
7944367895,7944367901,6,2575,1387,-30
7947337527,7947337532,5,1487,1148,-30
7947588834,7947588835,1,658,263,-30
7951817766,7951817770,4,2681,1512,-30
7954147737,7954147742,5,2885,1559,-30
7956292214,7956292221,7,3272,1743,-30
7960241238,7960241242,4,1767,959,-30
7964889472,7964889473,1,2402,1988,-30
7966249601,7966249605,4,2824,1708,-30
7968606389,7968606394,5,2502,1699,-30
7968752401,7968752384,-17,3044,1546,-30
7971944225,7971944231,6,2740,1658,-30
7973698137,7973698133,-4,1291,2697,-30
7977905047,7977905045,-2,709,1169,-30
7982643429,7982643433,4,1784,1330,-30
7985509909,7985509914,5,3060,1425,-30
7986282984,7986282989,5,3210,1778,-30
7986554664,7986554667,3,2146,1363,-30
7990620347,7990620350,3,1949,1276,-30
7990712190,7990712195,5,1555,1076,-30
7995487801,7995487807,6,2191,1283,-30
7999189296,7999189300,4,2161,1573,-30
8000824532,8000824538,6,1432,1038,-30
8003822517,8003822520,3,7938,17632,-30
8005722574,8005722579,5,2093,854,-30
8005830809,8005830815,6,2749,1472,-30
8011198727,8011198733,6,3376,1391,-30
8011900698,8011900707,9,1455,1302,-30
8013179222,8013179229,7,3198,1252,-30
8014347722,8014347727,5,2409,1541,-30
8019196029,8019196034,5,2162,1045,-30
8021226891,8021226895,4,1774,1339,-30
8024361812,8024361817,5,2898,1364,-30
8025694081,8025694081,0,683,344,-30
8025839518,8025839523,5,1628,1406,-30
8027298075,8027298080,5,2388,1908,-30
8028939582,8028939586,4,2249,1399,-30
8032625562,8032625566,4,2004,1291,-30
8033293601,8033293623,22,2578,710,-30
8040680204,8040680209,5,2865,1676,-30
8041374541,8041374546,5,1158,1013,-30
8043631698,8043631697,-1,5929,7848,-30
8047565510,8047565516,6,2474,1104,-30
8048134398,8048134386,-12,1111,513,-30
8053643483,8053643489,6,1937,1396,-30
8054037927,8054037930,3,746,1005,-30
8058849451,8058849455,4,2900,1370,-30
8059023510,8059023503,-7,6185,28596,-30
8060109505,8060109507,2,2724,1479,-30
8061110371,8061110377,6,2324,1258,-30
8063211382,8063211384,2,1729,1807,-30
8064182182,8064182187,5,2077,1733,-30
8066115381,8066115386,5,3635,1707,-30
8067005656,8067005659,3,1708,1062,-30
8071859018,8071859026,8,1875,1412,-30
8075039220,8075039223,3,2438,1291,-30
8078448158,8078448162,4,3458,1993,-30
8085025302,8085025322,20,2829,1428,-30
8088291789,8088291795,6,2465,1655,-30
8089217493,8089217493,0,4609,6241,-30
8090582289,8090582295,6,2238,1467,-30
8093001541,8093001545,4,1538,1148,-30
8093285154,8093285159,5,1492,1391,-30
8095085698,8095085702,4,1031,1281,-30
8097525977,8097525983,6,2239,1197,-30
8097730015,8097730001,-14,2189,552,-30
8098486188,8098486193,5,2512,974,-30
8099126505,8099126489,-16,2234,1806,-30
8100212825,8100212830,5,1985,1061,-30
8102244503,8102244509,6,2703,1593,-30
8103076102,8103076106,4,2072,1050,-30
8104093364,8104093348,-16,3341,952,-30
8104236886,8104236891,5,2210,1320,-30
8105543788,8105543795,7,1784,1391,-30
8106143009,8106143015,6,2874,1680,-30
8108531714,8108531720,6,10424,29925,-30
8108995581,8108995585,4,2032,1437,-30
8110808898,8110808903,5,2218,1610,-30
8113595399,8113595405,6,3082,1235,-30
8114108085,8114108090,5,2694,1643,-30
8117862773,8117862771,-2,2005,4961,-30
8118594382,8118594387,5,1423,943,-30
8120588238,8120588241,3,1515,1337,-30
8127003002,8127003007,5,3119,1164,-30
8128447461,8128447466,5,2470,1365,-30
8139134438,8139134444,6,1956,1256,-30
8139162084,8139162065,-19,1995,1018,-30
8142005150,8142005155,5,2241,976,-30
8147977987,8147977987,0,2193,1925,-30
8148658299,8148658302,3,2367,1358,-30
8149355717,8149355716,-1,1170,2203,-30
8149845909,8149845902,-7,2130,6722,-30
8154262602,8154262607,5,2787,1486,-30
8158507189,8158507193,4,1768,965,-30
8159118218,8159118218,0,1238,1195,-30
8160223053,8160223058,5,2556,1719,-30
8166552371,8166552377,6,3129,1447,-30
8170849675,8170849682,7,2928,1400,-30
8170991238,8170991257,19,576,300,-30
8172119758,8172119750,-8,1120,3045,-30
8173542199,8173542205,6,2502,1397,-30
8181077498,8181077507,9,2690,1215,-30
8183162422,8183162418,-4,1884,6742,-30
8183635021,8183635027,6,2380,1186,-30
8185160536,8185160540,4,2096,1725,-30
8185665647,8185665639,-8,1109,3778,-30
8187551558,8187551564,6,2416,1408,-30
8188806992,8188806995,3,2085,1297,-30
8193821537,8193821542,5,2570,1341,-30
8194418478,8194418488,10,1693,1467,-30
8198165866,8198165870,4,2296,1079,-30
8198293911,8198293906,-5,763,308,-30
8198535963,8198535970,7,2815,1316,-30
8202314977,8202314980,3,1578,1587,-30
8203041078,8203041082,4,2826,1580,-30
8203371530,8203371535,5,2911,1690,-30
8204274231,8204274224,-7,969,5531,-30
8204763367,8204763362,-5,1291,3867,-30
8207198233,8207198239,6,3424,1380,-30
8211110619,8211110621,2,867,846,-30
8214773540,8214773543,3,2117,1106,-30
8217121770,8217121774,4,1724,1062,-30
8224310611,8224310605,-6,1267,3562,-30
8226009327,8226009330,3,2530,1691,-30
8228509167,8228509163,-4,942,2081,-30
8233022667,8233022672,5,1866,1263,-30
8235789126,8235789130,4,2100,1118,-30
8235822999,8235823006,7,2100,1117,-30
8241177258,8241177262,4,2323,1252,-30
8246020552,8246020556,4,2453,1401,-30
8251007153,8251007159,6,2678,1128,-30
8258989271,8258989278,7,2383,1467,-30
8262822536,8262822530,-6,1192,4512,-30
8266610830,8266610837,7,2528,1359,-30
8272227174,8272227180,6,1858,1035,-30
8272465728,8272465733,5,1784,1133,-30
8281118101,8281118106,5,3279,1137,-30
8288400234,8288400238,4,3029,1970,-30
8289824669,8289824674,5,1657,934,-30
8291695726,8291695731,5,1747,1072,-30
8297494557,8297494560,3,2111,1239,-30
8298612362,8298612368,6,2266,1699,-30
8303031385,8303031391,6,2798,655,-30
8303130641,8303130624,-17,2587,1101,-30
8308185099,8308185094,-5,20103,14367,-30
8312487856,8312487861,5,2480,1054,-30
8312571245,8312571259,14,1787,1197,-30
8314965969,8314965975,6,2784,1753,-30
8317999259,8317999258,-1,1001,2093,-30
8322658122,8322658129,7,2734,1065,-30
8322940297,8322940301,4,1806,1170,-30
8326255763,8326255766,3,1478,1269,-30
8326481560,8326481565,5,3232,1722,-30
8328061980,8328061986,6,1873,1186,-30
8330471587,8330471592,5,1675,1362,-30
8331365640,8331365645,5,2660,1763,-30
8333812897,8333812898,1,1467,1520,-30
8334482058,8334482044,-14,2758,1667,-30
8336030581,8336030581,0,1686,1456,-30
8336955010,8336955022,12,520,1737,-30
8343584889,8343584895,6,2566,1784,-30
8349880753,8349880757,4,2819,1303,-30
8353649105,8353649113,8,9329,2340,-30
8355633506,8355633511,5,2467,1365,-30
8360624946,8360624952,6,2152,1411,-30
8366097311,8366097317,6,2236,1884,-30
8370852830,8370852832,2,1215,1357,-30
8372460970,8372460974,4,2542,1246,-30
8376357977,8376357984,7,2058,1577,-30
8378184050,8378184054,4,2293,1222,-30
8383974417,8383974422,5,1730,1367,-30
8385487465,8385487468,3,2505,1632,-30
8388457947,8388457950,3,2306,1118,-30
8388599508,8388599521,13,2235,1269,-30
8388668923,8388668905,-18,2640,846,-30
8399300704,8399300702,-2,1083,2695,-30
8401118979,8401118983,4,2434,1281,-30
8401212976,8401212985,9,2011,1411,-30
8401843839,8401843825,-14,880,542,-30
8408133186,8408133191,5,2311,1122,-30
8408470532,8408470537,5,2011,1342,-30
8411286251,8411286256,5,2094,830,-30
8412296230,8412296248,18,871,237,-30
8415601181,8415601188,7,2546,1287,-30
8415754450,8415754457,7,2650,1335,-30
8416271110,8416271117,7,2277,785,-30
8420516209,8420516215,6,2118,1279,-30
8424930886,8424930890,4,1897,1324,-30
8425685890,8425685893,3,959,816,-30
8426233574,8426233577,3,2749,1622,-30
8426806367,8426806371,4,1547,1021,-30
8427140051,8427140058,7,3336,1164,-30
8431326477,8431326482,5,2224,1276,-30
8432533127,8432533132,5,2691,1279,-30
8433846737,8433846744,7,1843,1309,-30
8433942917,8433942921,4,2426,1572,-30
8434097233,8434097216,-17,1337,763,-30
8436038598,8436038601,3,1701,1421,-30
8436380541,8436380546,5,1906,1645,-30
8441170823,8441170829,6,2545,1520,-30
8441472200,8441472203,3,1826,1312,-30
8442571803,8442571807,4,1590,1197,-30
8456614264,8456614270,6,2349,1411,-30
8458085998,8458086003,5,2526,1557,-30
8459754787,8459754784,-3,1025,1953,-30
8462514782,8462514787,5,2137,1621,-30
8463157162,8463157158,-4,1104,2680,-30
8464261038,8464261042,4,1596,964,-30
8466443209,8466443215,6,2337,1342,-30
8467869966,8467869970,4,2081,1267,-30
8469419102,8469419106,4,1014,689,-30
8473786606,8473786610,4,1607,1071,-30
8475258170,8475258163,-7,1474,7734,-30
8476164219,8476164224,5,1962,1274,-30
8477153573,8477153576,3,802,273,-30
8477725533,8477725537,4,2798,1975,-30
8478035434,8478035440,6,2539,1447,-30
8484238583,8484238589,6,2471,1874,-30
8489462594,8489462600,6,2235,1213,-30
8490533470,8490533466,-4,1189,3197,-30
8492937386,8492937392,6,3049,1584,-30
8494802478,8494802482,4,3256,1913,-30
8496146172,8496146177,5,1566,1191,-30
8503307975,8503307969,-6,761,2314,-30
8506576952,8506576959,7,1764,1177,-30
8512099715,8512099714,-1,4338,7569,-30
8517277330,8517277348,18,7729,16222,-30
8526341486,8526341493,7,1889,1166,-30
8532081978,8532081985,7,2935,1350,-30
8540198305,8540198308,3,2199,2006,-30
8541000098,8541000076,-22,2176,928,-30
8541991547,8541991553,6,1306,910,-30
8543250151,8543250158,7,1678,863,-30
8544722005,8544722008,3,1578,1002,-30
8545155106,8545155110,4,2564,1719,-30
8547660671,8547660678,7,2268,1578,-30
8551489808,8551489813,5,2053,1292,-30
8555926629,8555926635,6,684,266,-30
8559241882,8559241885,3,1862,804,-30
8561490362,8561490365,3,2628,1103,-30
8563474092,8563474104,12,229,1244,-30
8563756529,8563756533,4,1765,1208,-30
8564902989,8564902993,4,2250,1640,-30
8569358417,8569358422,5,1990,953,-30
8572082590,8572082586,-4,446,191,-30
8577054858,8577054861,3,2544,1568,-30
8581035274,8581035280,6,2248,1332,-30
8582208577,8582208582,5,1797,1221,-30
8582655078,8582655097,19,2290,1956,-30
8583767553,8583767558,5,1530,1322,-30
8584450386,8584450385,-1,1347,2904,-30
8584860334,8584860339,5,2425,1511,-30
8588069190,8588069189,-1,1325,2158,-30
8588732906,8588732914,8,2276,1275,-30
8589027230,8589027235,5,1280,1517,-30
8591636568,8591636573,5,2276,1597,-30
8592576625,8592576628,3,2814,2412,-30
8596466945,8596466951,6,1672,932,-30
8596570702,8596570706,4,2218,1643,-30
8597582418,8597582423,5,1991,764,-30
8601326915,8601326918,3,945,1586,-30
8602135282,8602135286,4,2465,1360,-30
8604179355,8604179361,6,2889,1448,-30
8607548157,8607548161,4,1822,871,-30
8609936898,8609936902,4,2706,1488,-30
8613107885,8613107877,-8,1569,8431,-30
8614582849,8614582854,5,2640,1294,-30
8615756628,8615756635,7,3986,1256,-30
8616507069,8616507089,20,1985,1373,-30
8619326743,8619326750,7,2347,1107,-30
8623531965,8623531969,4,1890,1278,-30
8626455428,8626455432,4,1586,1536,-30
8627192666,8627192670,4,1336,1292,-30
8628442125,8628442130,5,3132,1602,-30
8636246019,8636246022,3,2327,1570,-30
8636623849,8636623851,2,1551,1471,-30
8640911953,8640911957,4,3102,1686,-30
8642226034,8642226039,5,2796,1304,-30
8642534190,8642534195,5,2827,1315,-30
8647345634,8647345639,5,2428,1476,-30
8647930363,8647930345,-18,2080,947,-30
8656125733,8656125737,4,2863,1596,-30
8660165534,8660165541,7,2416,1366,-30
8662437029,8662437032,3,896,921,-30
8663356090,8663356086,-4,1461,1131,-30
8669809322,8669809326,4,2551,1137,-30
8671550189,8671550196,7,1818,740,-30
8673021490,8673021494,4,2190,1153,-30
8673413277,8673413283,6,3591,1046,-30
8673914810,8673914815,5,2697,1466,-30
8676714222,8676714227,5,2035,1200,-30
8686884634,8686884639,5,2735,1381,-30
8690273309,8690273290,-19,4868,149,-30
8691179877,8691179882,5,2316,1266,-30
8691650698,8691650706,8,2375,1840,-30
8694480161,8694480163,2,1946,1852,-30
8695111116,8695111121,5,3025,1563,-30
8696904193,8696904202,9,1485,722,-30
8697447675,8697447680,5,3110,1750,-30
8697661036,8697661019,-17,799,514,-30
8697775738,8697775743,5,2058,1334,-30
8698890439,8698890444,5,2502,1628,-30
8699386406,8699386414,8,2049,945,-30
8699893139,8699893122,-17,2496,1413,-30
8700164427,8700164431,4,1764,1423,-30
8702847274,8702847277,3,2193,1229,-30
8703228329,8703228333,4,2504,1042,-30
8703400207,8703400195,-12,666,309,-30
8704607984,8704607989,5,1847,1214,-30
8705574912,8705574897,-15,934,371,-30
8710240626,8710240632,6,1339,955,-30
8711045993,8711045997,4,2199,1529,-30
8713588585,8713588590,5,1348,1068,-30
8714205020,8714205025,5,2127,1455,-30
8714541787,8714541793,6,1732,772,-30
8714713718,8714713706,-12,1520,718,-30
8715042794,8715042798,4,2525,1636,-30
8719192142,8719192146,4,2109,929,-30
8723467465,8723467469,4,1950,1333,-30
8728284367,8728284380,13,2211,1278,-30
8729309271,8729309248,-23,2401,1193,-30
8733237976,8733237981,5,1847,1128,-30
8736784274,8736784279,5,2640,2147,-30
8737960274,8737960280,6,2169,1262,-30
8743262142,8743262148,6,2344,1519,-30
8753767138,8753767142,4,2099,1836,-30
8757459893,8757459899,6,1541,960,-30
8760864212,8760864216,4,2004,1165,-30
8764550658,8764550658,0,3012,1538,-30
8765465485,8765465489,4,3272,1640,-30
8767711407,8767711410,3,2565,1955,-30
8767988919,8767988923,4,2539,1026,-30
8768626274,8768626290,16,2300,1557,-30
8770258958,8770258962,4,2409,1725,-30
8772735762,8772735766,4,1907,987,-30
8772949719,8772949720,1,661,199,-30
8783570867,8783570874,7,2414,963,-30
8787387438,8787387442,4,2379,1322,-30
8792440413,8792440417,4,1997,962,-30
8792885440,8792885443,3,1757,1217,-30
8794593322,8794593327,5,2002,1196,-30
8795077185,8795077190,5,3208,1231,-30
8797662447,8797662452,5,2840,1738,-30
8797931831,8797931837,6,1205,225,-30
8800183485,8800183490,5,2631,1283,-30
8803929286,8803929290,4,2083,1305,-30
8804555141,8804555146,5,1907,1203,-30
8808161674,8808161680,6,2106,1322,-30
8811436347,8811436355,8,1589,812,-30
8812278966,8812278972,6,2296,1206,-30
8816515406,8816515411,5,1866,1015,-30
8816612511,8816612491,-20,1208,813,-30
8818739227,8818739233,6,1954,1100,-30
8821634613,8821634619,6,1688,1216,-30
8823037229,8823037234,5,2226,1314,-30
8828138196,8828138194,-2,1180,2056,-30
8829297306,8829297305,-1,1660,3173,-30
8831470882,8831470887,5,1573,1393,-30
8833266328,8833266334,6,2166,947,-30
8834076110,8834076115,5,2007,876,-30
8835363887,8835363885,-2,1196,2701,-30
8835879102,8835879109,7,1984,1504,-30
8837544478,8837544483,5,1591,1119,-30
8838527780,8838527786,6,1439,1105,-30
8838763638,8838763643,5,1597,1397,-30
8840709162,8840709167,5,2435,1361,-30
8841634761,8841634766,5,1844,1382,-30
8846112585,8846112590,5,2582,1318,-30
8849072902,8849072907,5,2601,1397,-30
8850663962,8850663965,3,2051,1358,-30
8852759395,8852759400,5,2220,1661,-30
8854383231,8854383237,6,2127,1268,-30
8856798165,8856798171,6,2825,1793,-30
8859221673,8859221678,5,2333,1451,-30
8860140968,8860140949,-19,1842,901,-30
8860767655,8860767653,-2,34551,37690,-30
8861674973,8861674953,-20,2015,1275,-30
8862896786,8862896791,5,2723,1485,-30
8864720127,8864720130,3,1606,1140,-30
8866212670,8866212677,7,2271,1120,-30
8867544499,8867544503,4,1696,879,-30
8869720593,8869720594,1,1451,1689,-30
8869809770,8869809776,6,3661,1453,-30
8873816726,8873816731,5,2327,810,-30
8874036271,8874036256,-15,1671,804,-30
8885440471,8885440468,-3,1270,3366,-30
8887435238,8887435243,5,2179,1209,-30
8888093310,8888093318,8,1455,1011,-30
8891238301,8891238306,5,2414,1186,-30
8893780628,8893780632,4,2334,1614,-30
8896048100,8896048095,-5,1192,3525,-30
8902957393,8902957399,6,2057,1070,-30
8903244678,8903244682,4,2471,1662,-30
8904785282,8904785288,6,1560,884,-30
8905478898,8905478905,7,2109,1592,-30
8907791010,8907791014,4,1597,605,-30
8910793026,8910793033,7,2329,1271,-30
8911438735,8911438735,0,1706,1457,-30
8912405770,8912405773,3,2170,1525,-30
8913468418,8913468423,5,2232,1450,-30
8913523087,8913523067,-20,1568,652,-30
8921465370,8921465375,5,1952,814,-30
8923279607,8923279611,4,2341,1296,-30
8927916618,8927916623,5,1801,1441,-30
8931783302,8931783306,4,2677,1566,-30
8935641248,8935641252,4,1608,1106,-30
8937434806,8937434811,5,1069,670,-30
8948445297,8948445305,8,3302,1243,-30
8950597570,8950597576,6,3193,1811,-30
8960122163,8960122168,5,2058,1162,-30
8960284871,8960284875,4,1857,1472,-30
8960630190,8960630193,3,2755,1995,-30
8961292291,8961292295,4,2716,1866,-30
8962880308,8962880311,3,1491,1026,-30
8965790267,8965790271,4,2359,1319,-30
8971951734,8971951739,5,2422,1557,-30
8972371939,8972371942,3,1958,1139,-30
8973160268,8973160274,6,2434,1183,-30
8975247836,8975247854,18,1092,2842,-30
8979203018,8979203023,5,2006,1459,-30
8980441398,8980441404,6,2054,1745,-30
8988309159,8988309164,5,2471,1552,-30
8988560427,8988560416,-11,413,106,-30
8991872627,8991872631,4,2114,1033,-30
8992106653,8992106659,6,2611,1241,-30
8993004001,8993004009,8,1796,877,-30
8994845087,8994845095,8,4862,1358,-30
8995639479,8995639479,0,1174,1854,-30
8996437426,8996437430,4,2198,1533,-30
8999498671,8999498666,-5,410,1327,-30
9004101438,9004101438,0,1838,2767,-30
9007673733,9007673739,6,3061,1649,-30
9012855839,9012855844,5,2021,1140,-30
9016593375,9016593380,5,4610,2755,-30
9016701994,9016701998,4,2242,1223,-30
9021405844,9021405847,3,1818,1284,-30
9022704406,9022704411,5,1542,1222,-30
9026849842,9026849847,5,3119,1204,-30
9028255001,9028255007,6,1864,1530,-30
9029200778,9029200783,5,1837,1040,-30
9033650662,9033650668,6,2793,1840,-30
9033922688,9033922688,0,5617,7874,-30
9037036777,9037036782,5,2563,1464,-30
9049120570,9049120576,6,1649,1405,-30
9049980337,9049980343,6,2006,1256,-30
9054522860,9054522866,6,2563,1659,-30
9054555953,9054555963,10,792,117,-30
9055532058,9055532062,4,1794,1221,-30
9056491044,9056491025,-19,1206,604,-30
9058542448,9058542451,3,2508,1847,-30
9063732752,9063732758,6,1981,1031,-30
9064541398,9064541398,0,1922,2985,-30
9065248250,9065248255,5,2275,1333,-30
9065801766,9065801770,4,2300,1194,-30
9071894938,9071894942,4,1506,1046,-30
9073639042,9073639049,7,2557,1318,-30
9075578296,9075578301,5,307,1717,-30
9076624680,9076624682,2,2552,2355,-30
9085114384,9085114375,-9,1606,1652,-30
9090980762,9090980767,5,1693,1123,-30
9091308112,9091308116,4,2493,1722,-30
9097999250,9097999255,5,2179,1286,-30
9098433070,9098433075,5,2357,1163,-30
9099669747,9099669751,4,2723,1730,-30
9100833161,9100833153,-8,1240,10187,-30
9108486001,9108486007,6,2580,1138,-30
9111107301,9111107304,3,2301,1527,-30
9111704066,9111704071,5,2181,1239,-30
9112060808,9112060814,6,2184,1194,-30
9112555025,9112555029,4,2337,1560,-30
9114099250,9114099254,4,1881,1219,-30
9116895355,9116895358,3,1672,1332,-30
9119366236,9119366242,6,6329,3357,-30
9120673450,9120673454,4,2462,1665,-30
9126559613,9126559617,4,1720,1171,-30
9126714456,9126714462,6,15177,19047,-30
9127528807,9127528811,4,2522,1569,-30
9128814779,9128814785,6,3556,1588,-30
9132239996,9132240001,5,2740,1908,-30
9132915518,9132915523,5,3877,1249,-30
9134227841,9134227846,5,3375,1711,-30
9136320921,9136320925,4,2900,1980,-30
9140227227,9140227235,8,2863,1204,-30
9147835698,9147835702,4,2570,1481,-30
9148662361,9148662366,5,4637,1936,-30
9150070966,9150070973,7,3400,1571,-30
9151319221,9151319224,3,2243,1417,-30
9151867194,9151867201,7,2851,1473,-30
9152955163,9152955167,4,2268,1000,-30
9155712115,9155712113,-2,1004,2292,-30
9157355127,9157355145,18,2262,1306,-30
9161783709,9161783715,6,2337,1139,-30
9163078249,9163078238,-11,34860,14692,-30
9164116374,9164116381,7,2976,1577,-30
9171546093,9171546096,3,2008,1612,-30
9174308332,9174308337,5,2336,1201,-30
9178565623,9178565629,6,2197,1997,-30
9181139486,9181139488,2,2679,1283,-30
9181938262,9181938267,5,1178,926,-30
9182584891,9182584897,6,1372,1083,-30
9186181770,9186181775,5,2684,1208,-30
9190235346,9190235353,7,1913,1091,-30
9191005062,9191005067,5,1585,1082,-30
9193414965,9193414971,6,2453,1586,-30
9194644867,9194644857,-10,1253,827,-30
9197541755,9197541758,3,2423,2069,-30
9199994518,9199994522,4,2009,1373,-30
9200515831,9200515834,3,2166,1482,-30
9206617334,9206617342,8,2696,1352,-30
9207347560,9207347565,5,2364,1117,-30
9208286415,9208286420,5,2172,1558,-30
9208586206,9208586200,-6,1283,5845,-30
9209225397,9209225402,5,3043,1378,-30
9211649398,9211649402,4,2402,1319,-30
9211950762,9211950767,5,2688,1567,-30
9213768314,9213768319,5,2126,1864,-30
9216137087,9216137091,4,1981,1320,-30
9216478598,9216478604,6,1789,1363,-30
9218691847,9218691854,7,3513,1399,-30
9219873429,9219873434,5,2444,1515,-30
9230182472,9230182479,7,2976,1310,-30
9237398222,9237398227,5,1942,1061,-30
9239667770,9239667774,4,3296,1788,-30
9241318570,9241318574,4,2578,1776,-30
9245540669,9245540676,7,2543,1399,-30
9245722370,9245722377,7,2457,1266,-30
9247076158,9247076162,4,2606,1594,-30
9249903950,9249903954,4,3625,1608,-30
9251412912,9251412917,5,2521,1455,-30
9254029448,9254029451,3,1767,1331,-30
9259982098,9259982103,5,2411,1195,-30
9264648445,9264648438,-7,1635,7877,-30
9267771442,9267771442,0,864,1488,-30
9267855626,9267855610,-16,2541,1217,-30
9268631953,9268631950,-3,7573,39115,-30
9273871972,9273871978,6,2372,1165,-30
9276535303,9276535309,6,3246,1015,-30
9276587957,9276587938,-19,2571,1508,-30
9280974001,9280974006,5,2342,1617,-30
9284911426,9284911425,-1,1082,1873,-30
9287837351,9287837348,-3,2475,5607,-30
9289325449,9289325454,5,2713,1658,-30
9292357370,9292357367,-3,883,2386,-30
9296505520,9296505527,7,2515,1269,-30
9300296324,9300296329,5,2816,1132,-30
9301737315,9301737318,3,1521,1342,-30
9304762181,9304762186,5,2371,1132,-30
9306909214,9306909218,4,2269,1577,-30
9307115133,9307115135,2,1685,990,-30
9313054430,9313054434,4,1586,1330,-30
9313230967,9313230974,7,2647,1502,-30
9314187276,9314187281,5,3027,1473,-30
9314724838,9314724837,-1,5633,7715,-30
9318067002,9318067007,5,2895,1527,-30
9319558909,9319558914,5,2537,1555,-30
9322279144,9322279150,6,1758,1589,-30
9325939710,9325939713,3,1323,1606,-30
9326261825,9326261829,4,1970,1455,-30
9331325789,9331325794,5,1939,1195,-30
9334102474,9334102479,5,2427,1246,-30
9343090671,9343090675,4,1958,1267,-30
9349839959,9349839962,3,1632,1158,-30
9350751974,9350751979,5,2928,1465,-30
9351622554,9351622558,4,2322,1454,-30
9357129266,9357129269,3,9955,8963,-30
9357461570,9357461562,-8,1614,7360,-30
9357523241,9357523245,4,2216,1127,-30
9364135706,9364135712,6,2462,1695,-30
9365097438,9365097441,3,1634,1158,-30
9367103407,9367103412,5,2296,1941,-30
9367588339,9367588345,6,3446,1547,-30
9374855077,9374855082,5,1575,982,-30
9378431934,9378431941,7,2580,1564,-30
9379101785,9379101788,3,2097,1318,-30
9388208920,9388208924,4,1913,1240,-30
9389031732,9389031714,-18,1017,232,-30
9393660245,9393660250,5,2108,1314,-30
9394011422,9394011429,7,2798,1541,-30
9394669823,9394669818,-5,550,38,-30
9395346229,9395346233,4,1925,1308,-30
9397925151,9397925155,4,1389,742,-30
9402753164,9402753168,4,1890,1445,-30
9408189429,9408189433,4,2169,1472,-30
9410005004,9410005007,3,1903,1298,-30
9410599659,9410599663,4,2794,1732,-30
9412933333,9412933337,4,1836,1515,-30
9416454133,9416454134,1,1535,1284,-30
9418119186,9418119194,8,1929,1139,-30
9420757651,9420757655,4,1801,1098,-30
9423389275,9423389280,5,3109,1863,-30
9425219366,9425219352,-14,1142,162,-30
9428443169,9428443174,5,2522,1817,-30
9435536810,9435536814,4,1748,1101,-30
9437184698,9437184702,4,2411,1790,-30
9437256561,9437256565,4,3012,1572,-30
9440284637,9440284641,4,2749,1528,-30
9446484036,9446484042,6,2707,1275,-30
9447190207,9447190210,3,1633,882,-30
9450055234,9450055238,4,2516,1519,-30
9452355672,9452355675,3,2474,1102,-30
9454420386,9454420391,5,2753,1828,-30
9454578029,9454578034,5,1658,1055,-30
9455436590,9455436595,5,2126,1297,-30
9457774629,9457774635,6,1854,1443,-30
9459184228,9459184247,19,1022,2603,-30
9459232957,9459232964,7,2145,1455,-30
9460630543,9460630522,-21,124,1001,-30
9463268123,9463268127,4,2252,1445,-30
9466009373,9466009378,5,2810,1346,-30
9467155219,9467155217,-2,1539,2500,-30
9469227986,9469227992,6,2153,1172,-30
9470919794,9470919802,8,2877,1101,-30
9473756486,9473756491,5,2331,1054,-30
9474370259,9474370261,2,1853,1447,-30
9478450702,9478450708,6,3809,1715,-30
9480672869,9480672870,1,1719,1241,-30
9482038035,9482038031,-4,2283,5562,-30
9483730201,9483730206,5,2272,768,-30
9495734384,9495734388,4,2932,1908,-30
9501510162,9501510171,9,1935,1015,-30
9503864622,9503864629,7,1834,1427,-30
9506841205,9506841210,5,2760,1498,-30
9508019898,9508019902,4,2474,1773,-30
9510754685,9510754690,5,3425,1671,-30
9511690813,9511690818,5,2051,1375,-30
9513299563,9513299570,7,2142,1165,-30
9513437055,9513437058,3,3766,2981,-30
9515558413,9515558421,8,3228,1341,-30
9516307654,9516307662,8,2076,1022,-30
9517147553,9517147558,5,4316,1600,-30
9518684566,9518684571,5,2241,1204,-30
9521830384,9521830375,-9,1911,885,-30
9522144748,9522144754,6,1996,1269,-30
9523500723,9523500722,-1,643,1116,-30
9525057990,9525057987,-3,1846,4339,-30
9525355875,9525355881,6,2675,1556,-30
9527041800,9527041806,6,1558,1395,-30
9527251731,9527251736,5,1950,958,-30
9527305639,9527305618,-21,1930,1203,-30
9527886928,9527886916,-12,1228,849,-30
9534771102,9534771107,5,1676,1580,-30
9540498206,9540498210,4,3116,1683,-30
9545496335,9545496340,5,2224,1070,-30
9545916250,9545916256,6,1967,1282,-30
9545988750,9545988760,10,1780,1407,-30
9546018643,9546018650,7,2953,1431,-30
9546100121,9546100126,5,2648,1462,-30
9547535834,9547535838,4,2253,1372,-30
9548692690,9548692696,6,2304,1315,-30
9550139178,9550139172,-6,1369,8721,-30
9552641171,9552641177,6,3510,1974,-30
9552696217,9552696222,5,3604,2150,-30
9561983650,9561983655,5,2675,2100,-30
9565785419,9565785423,4,1596,1292,-30
9569916473,9569916479,6,2660,1276,-30
9573660001,9573660005,4,1119,878,-30
9573873145,9573873149,4,3023,956,-30
9576542261,9576542269,8,4172,2155,-30
9577328772,9577328778,6,4405,2487,-30
9580770346,9580770351,5,2304,1228,-30
9582192981,9582192994,13,1638,1065,-30
9583506290,9583506297,7,3208,1220,-30
9586988178,9586988183,5,2762,1573,-30
9588102997,9588102995,-2,1018,1399,-30
9589362914,9589362921,7,2604,1479,-30
9590188851,9590188854,3,41368,35867,-30
9592026021,9592026025,4,2139,1653,-30
9592264263,9592264267,4,1910,1925,-30
9594269257,9594269262,5,1598,1137,-30
9603861137,9603861143,6,2401,1547,-30
9607986882,9607986885,3,1956,1041,-30
9609199339,9609199344,5,2140,1406,-30
9610390283,9610390287,4,2832,1324,-30
9614467721,9614467724,3,2287,1350,-30
9620113438,9620113442,4,2385,1864,-30
9626646724,9626646721,-3,2581,4465,-30
9631297460,9631297466,6,1847,1086,-30
9632971478,9632971482,4,1980,1428,-30
9636876887,9636876892,5,2339,1140,-30
9639059463,9639059466,3,1694,1480,-30
9641006289,9641006294,5,2796,1107,-30
9643059799,9643059806,7,2580,1730,-30
9643301774,9643301780,6,2356,1539,-30
9644556718,9644556717,-1,765,931,-30
9650028573,9650028578,5,2616,1256,-30
9654809537,9654809542,5,5532,3951,-30
9654992990,9654992995,5,2312,1326,-30
9656578779,9656578773,-6,1065,3947,-30
9661069405,9661069411,6,2953,1261,-30
9663299254,9663299258,4,2218,1008,-30
9665687519,9665687523,4,1988,1258,-30
9666033409,9666033413,4,3110,1717,-30
9667671934,9667671946,12,10103,39519,-30
9671092638,9671092643,5,2632,1213,-30
9674046385,9674046391,6,1978,1463,-30
9676430669,9676430675,6,2029,1732,-30
9679343529,9679343534,5,2031,1712,-30
9681727683,9681727684,1,1837,1686,-30
9682918252,9682918258,6,1704,1294,-30
9684615764,9684615769,5,1908,1380,-30
9685310756,9685310737,-19,2206,1276,-30
9686085107,9686085111,4,2345,1405,-30
9687055027,9687055028,1,1818,1548,-30
9687699647,9687699641,-6,906,2209,-30
9691708027,9691708033,6,2582,1675,-30
9691930350,9691930357,7,3772,1753,-30
9693208733,9693208738,5,1920,1355,-30
9694611783,9694611787,4,2634,1414,-30
9697111849,9697111854,5,2193,2135,-30
9698798997,9698799003,6,1555,908,-30
9701347351,9701347344,-7,1902,6953,-30
9701653310,9701653314,4,2746,1433,-30
9711113836,9711113840,4,1961,1137,-30
9711657077,9711657082,5,2757,1033,-30
9712533653,9712533633,-20,2616,1581,-30
9715139465,9715139467,2,1580,1671,-30
9722080821,9722080826,5,1353,1265,-30
9723121782,9723121786,4,2823,1464,-30
9723368278,9723368290,12,1504,1259,-30
9725322642,9725322647,5,2109,1011,-30
9725440295,9725440313,18,1878,1290,-30
9725769894,9725769901,7,1975,1195,-30
9725999534,9725999553,19,1771,799,-30
9727102387,9727102391,4,1775,1564,-30
9734813170,9734813174,4,1985,1399,-30
9735194809,9735194810,1,1927,1381,-30
9737165706,9737165710,4,1608,1190,-30
9738649811,9738649793,-18,4548,1311,-30
9739716798,9739716795,-3,1231,2792,-30
9740613078,9740613081,3,2502,1610,-30
9742897049,9742897051,2,720,887,-30
9744786414,9744786415,1,3137,2943,-30
9745842710,9745842715,5,2583,1434,-30
9747529524,9747529528,4,2780,1894,-30
9752334289,9752334293,4,1869,895,-30
9757372922,9757372927,5,2601,1206,-30
9757891131,9757891133,2,1612,1060,-30
9765289482,9765289487,5,1906,1462,-30
9769064670,9769064674,4,2530,1394,-30
9770132166,9770132170,4,2548,1374,-30
9773704958,9773704961,3,2382,1540,-30
9783281148,9783281153,5,2097,822,-30
9786182529,9786182534,5,2047,1658,-30
9786879392,9786879386,-6,1677,6458,-30
9787225631,9787225633,2,1866,1794,-30
9789609033,9789609040,7,3223,1513,-30
9791226021,9791226025,4,2558,1497,-30
9792697693,9792697699,6,2036,1103,-30
9792974696,9792974681,-15,2726,1034,-30
9793072230,9793072209,-21,1012,536,-30
9800904342,9800904346,4,2500,1679,-30
9803136468,9803136473,5,18137,34767,-30
9807762270,9807762262,-8,859,4649,-30
9808314666,9808314673,7,9919,30155,-30
9810196209,9810196214,5,4943,2930,-30
9810709482,9810709486,4,1921,1656,-30
9817143251,9817143263,12,1048,3431,-30
9818599382,9818599385,3,1532,980,-30
9818794426,9818794411,-15,2241,1289,-30
9819369475,9819369480,5,2847,1788,-30
9823367043,9823367048,5,2171,961,-30
9825144212,9825144216,4,2984,1585,-30
9834455093,9834455099,6,2258,1586,-30
9835551087,9835551091,4,2053,964,-30
9836909501,9836909508,7,2381,1403,-30
9839542593,9839542598,5,2040,1263,-30
9845064550,9845064553,3,1133,1415,-30
9846711466,9846711471,5,1696,1166,-30
9846877271,9846877275,4,1426,915,-30
9850124829,9850124835,6,2402,1370,-30
9851183593,9851183601,8,2272,1408,-30
9853665142,9853665148,6,3075,1765,-30
9854695174,9854695182,8,3682,1937,-30
9854818266,9854818265,-1,1252,2425,-30
9857383017,9857383022,5,2252,1663,-30
9857613078,9857613060,-18,2415,1366,-30
9860898343,9860898349,6,2943,1926,-30
9863955916,9863955920,4,3346,1944,-30
9870270290,9870270290,0,1605,1291,-30
9874107389,9874107394,5,1943,1416,-30
9874887851,9874887854,3,2049,1060,-30
9875220433,9875220437,4,2425,1702,-30
9877718446,9877718451,5,2958,1326,-30
9882245369,9882245373,4,3066,1328,-30
9882481630,9882481634,4,2340,1353,-30
9882974357,9882974354,-3,1309,2083,-30
9887810140,9887810145,5,2561,873,-30
9887912370,9887912364,-6,794,240,-30
9893309110,9893309115,5,1022,1029,-30
9896797473,9896797481,8,2798,1581,-30
9897014999,9897014992,-7,1801,3620,-30
9898500973,9898500978,5,2715,1530,-30
9900126321,9900126330,9,825,274,-30
9901632491,9901632497,6,2214,1153,-30
9902357513,9902357518,5,1999,1268,-30
9904380554,9904380556,2,2279,1725,-30
9907024222,9907024227,5,2110,1587,-30
9908523043,9908523047,4,2290,1444,-30
9924697599,9924697603,4,2341,1578,-30
9925628908,9925628913,5,2464,1885,-30
9932970674,9932970679,5,3130,1525,-30
9933288636,9933288642,6,2829,1628,-30
9933700766,9933700768,2,3170,2223,-30
9937034733,9937034738,5,3139,1829,-30
9937429707,9937429711,4,1938,1604,-30
9937471908,9937471913,5,2541,1172,-30
9938175698,9938175703,5,3067,1475,-30
9938698017,9938698022,5,2887,1375,-30
9941557852,9941557858,6,2359,1250,-30
9945614491,9945614495,4,2396,1128,-30
9949378433,9949378436,3,1939,1545,-30
9951312952,9951312955,3,1968,1380,-30
9952269534,9952269538,4,2287,1366,-30
9952480059,9952480042,-17,2000,1399,-30
9952982682,9952982681,-1,1096,1984,-30
9954559354,9954559358,4,2530,1108,-30
9960808884,9960808877,-7,961,5935,-30
9961996209,9961996213,4,2638,1216,-30
9967506491,9967506497,6,2329,2209,-30
9971154334,9971154339,5,2271,1250,-30
9976383682,9976383687,5,2411,1276,-30
9979778907,9979778920,13,14884,24212,-30
9988152738,9988152743,5,1654,1288,-30
9988662293,9988662294,1,1101,1254,-30
9989841094,9989841100,6,2675,1745,-30
9994771948,9994771954,6,3255,1849,-30
9997479581,9997479584,3,2356,1317,-30
10004130787,10004130791,4,2357,1503,-30
10004628686,10004628690,4,1822,1128,-30
10006386115,10006386108,-7,2098,7302,-30
10006453463,10006453468,5,3467,1380,-30
10008857891,10008857895,4,2903,1853,-30
10017227218,10017227222,4,1299,1100,-30
10018139491,10018139495,4,1956,1788,-30
10020826321,10020826327,6,2557,1115,-30
10021818755,10021818762,7,3171,1501,-30
10023821446,10023821450,4,1540,757,-30
10026452301,10026452305,4,2886,1271,-30
10028340007,10028340012,5,2256,1643,-30
10029955557,10029955562,5,750,766,-30
10031344056,10031344059,3,3117,1849,-30
10032272041,10032272046,5,1976,1365,-30
10033310750,10033310755,5,2727,1212,-30
10033412730,10033412731,1,1119,1524,-30
10034316901,10034316906,5,2260,1152,-30
10035747411,10035747414,3,1552,1203,-30
10036620245,10036620246,1,1584,1841,-30
10040214408,10040214414,6,2626,972,-30
10043311765,10043311770,5,1739,1268,-30
10047016098,10047016099,1,2837,3334,-30
10048718099,10048718106,7,1737,838,-30
10048986014,10048986018,4,1777,1357,-30
10050069509,10050069514,5,1943,1103,-30
10058078235,10058078241,6,3492,2010,-30
10060450066,10060450071,5,11966,7583,-30
10061141568,10061141573,5,2259,2079,-30
10062512521,10062512526,5,2620,1296,-30
10066990006,10066990010,4,2139,975,-30
10070365453,10070365458,5,1338,872,-30
10074041078,10074041082,4,2028,1264,-30
10075260076,10075260097,21,3209,881,-30
10076090948,10076090953,5,1832,722,-30
10080001841,10080001845,4,2074,1254,-30
10082815202,10082815209,7,2846,1684,-30
10084320984,10084320991,7,3746,1433,-30
10084584638,10084584627,-11,2680,1185,-30
10085085475,10085085490,15,724,239,-30
10090365902,10090365907,5,2661,1616,-30
10091068430,10091068434,4,1537,1015,-30
10095635084,10095635091,7,2999,1700,-30
10102778604,10102778602,-2,26366,13715,-30
10106516568,10106516568,0,41480,32376,-30
10107417814,10107417820,6,2546,1152,-30
10109458979,10109458982,3,2483,1410,-30
10116700589,10116700594,5,2090,1431,-30
10117960765,10117960770,5,2017,1121,-30
10121746934,10121746930,-4,56,953,-30
10123744005,10123744009,4,2966,1632,-30
10126228182,10126228186,4,2350,1315,-30
10133002289,10133002295,6,2805,1695,-30
10134202037,10134202042,5,2252,1835,-30
10135834048,10135834053,5,2460,1358,-30
10139196650,10139196654,4,1935,1059,-30
10143721090,10143721094,4,2967,1218,-30
10149858494,10149858499,5,1547,1106,-30
10153369077,10153369082,5,1733,955,-30
10154733966,10154733972,6,1910,1496,-30
10156794499,10156794503,4,2411,1123,-30
10164193638,10164193642,4,2163,1508,-30
10168819274,10168819279,5,2622,1933,-30
10171209224,10171209221,-3,1247,2663,-30
10175490458,10175490463,5,1905,1008,-30
10179868706,10179868711,5,2080,1307,-30
10180191510,10180191516,6,2632,1093,-30
10186447569,10186447574,5,2793,1343,-30
10189013969,10189013974,5,1999,1455,-30
10189276131,10189276138,7,3225,1575,-30
10193431186,10193431180,-6,1611,10573,-30
10194401022,10194401026,4,1671,980,-30
10194742306,10194742309,3,2120,1773,-30
10195635981,10195635992,11,16244,32156,-30
10199498317,10199498322,5,1270,1141,-30
10203484675,10203484680,5,2816,1430,-30
10207338570,10207338575,5,2312,1582,-30
10211770318,10211770328,10,13862,26132,-30
10212808761,10212808764,3,1557,1283,-30
10213041176,10213041181,5,2200,1157,-30
10213129631,10213129638,7,2787,1197,-30
10213480950,10213480954,4,2063,1015,-30
10213940847,10213940850,3,1473,1071,-30
10214462807,10214462812,5,2371,1718,-30
10220046140,10220046145,5,2602,979,-30
10223057847,10223057852,5,2240,949,-30
10223127154,10223127159,5,1600,1047,-30
10223946948,10223946971,23,2610,1522,-30
10226577788,10226577784,-4,608,1427,-30
10228433442,10228433445,3,1564,1183,-30
10231727842,10231727847,5,1887,1247,-30
10233108513,10233108518,5,1767,1225,-30
10233255579,10233255584,5,2394,1574,-30
10236538147,10236538153,6,2098,1444,-30
10238841350,10238841347,-3,1291,2362,-30
10242519635,10242519640,5,3828,1696,-30
10242964321,10242964326,5,1569,1353,-30
10245873248,10245873255,7,2343,789,-30
10247199238,10247199243,5,1869,1018,-30
10247995761,10247995776,15,1926,1568,-30
10248469647,10248469650,3,2097,1159,-30
10248946154,10248946158,4,2344,978,-30
10256701862,10256701869,7,2514,1087,-30
10257062707,10257062714,7,1507,845,-30
10257691358,10257691361,3,1481,1308,-30
10259400537,10259400542,5,1632,965,-30
10261054858,10261054863,5,2281,1712,-30
10262784612,10262784615,3,2676,1563,-30
10265248203,10265248206,3,1489,1792,-30
10267429470,10267429473,3,1851,1219,-30
10268168322,10268168327,5,3249,1659,-30
10269156301,10269156305,4,1376,1196,-30
10269213813,10269213835,22,3110,1764,-30
10269884166,10269884169,3,1675,1601,-30
10273717217,10273717219,2,1103,1349,-30
10276393727,10276393725,-2,967,1956,-30
10276722225,10276722230,5,1396,1230,-30
10285806391,10285806396,5,3164,1910,-30
10285845909,10285845913,4,1119,700,-30
10286273526,10286273530,4,1450,943,-30
10286357326,10286357330,4,1714,1056,-30
10290954918,10290954923,5,3232,1694,-30
10292838622,10292838626,4,2313,1538,-30
10295841111,10295841115,4,2426,1423,-30
10297215436,10297215441,5,2481,1281,-30
10298099908,10298099912,4,1931,1681,-30
10299942758,10299942763,5,2096,1142,-30
10300602611,10300602596,-15,1554,751,-30
10306974332,10306974337,5,2091,1022,-30
10307034259,10307034264,5,1566,882,-30
10307936501,10307936505,4,2939,2119,-30
10311166489,10311166493,4,1417,1058,-30
10313100574,10313100577,3,2838,1797,-30
10316751238,10316751241,3,2090,1109,-30
10317400694,10317400699,5,1769,1049,-30
10318593021,10318593026,5,2266,1283,-30
10322915338,10322915343,5,2007,1209,-30
10323596537,10323596542,5,2895,1391,-30
10323905142,10323905146,4,2089,1206,-30
10328598349,10328598345,-4,1513,3328,-30
10333060679,10333060683,4,2678,1346,-30
10333826663,10333826668,5,2535,1351,-30
10334126774,10334126780,6,1428,831,-30
10335097862,10335097842,-20,1784,727,-30
10348514641,10348514646,5,2197,1131,-30
10349023712,10349023712,0,1974,2550,-30
10350337222,10350337226,4,1250,936,-30
10351202183,10351202160,-23,1072,523,-30
10353468366,10353468371,5,2410,1080,-30
10353633595,10353633609,14,3243,1240,-30
10354457621,10354457626,5,2875,1800,-30
10355814962,10355814968,6,12799,25180,-30
10355867246,10355867251,5,2152,1073,-30
10356799398,10356799403,5,3744,1482,-30
10357513780,10357513786,6,2733,1571,-30
10367590485,10367590492,7,3256,1559,-30
10371955186,10371955191,5,2052,1270,-30
10372780585,10372780590,5,3279,1972,-30
10374812803,10374812807,4,26052,23597,-30
10380400294,10380400298,4,2397,1353,-30
10381855138,10381855142,4,1922,1658,-30
10382206834,10382206839,5,1766,1007,-30
10384760978,10384760982,4,2570,1708,-30
10385292567,10385292552,-15,1293,978,-30
10389374377,10389374361,-16,2232,1272,-30
10393233489,10393233495,6,3293,1401,-30
10393822166,10393822170,4,2033,1200,-30
10396398889,10396398892,3,2128,1656,-30
10397375794,10397375799,5,3170,1715,-30
10399519803,10399519809,6,3245,1412,-30
10408356973,10408356979,6,1460,849,-30
10410252235,10410252238,3,2257,1795,-30
10415501767,10415501774,7,2663,1524,-30
10421758653,10421758658,5,2898,2014,-30
10422446367,10422446370,3,2000,1890,-30
10424258150,10424258158,8,3775,1045,-30
10428093540,10428093546,6,1487,1073,-30
10429052178,10429052182,4,2961,1391,-30
10430098331,10430098335,4,1311,1164,-30
10430444582,10430444585,3,1677,1267,-30
10436864044,10436864050,6,2838,1515,-30
10439588890,10439588895,5,3813,1339,-30
10446579846,10446579854,8,2378,1194,-30
10447464226,10447464230,4,1884,1720,-30
10449975379,10449975383,4,3292,1367,-30
10461121358,10461121363,5,2231,1705,-30
10465449456,10465449461,5,2841,1508,-30
10465952404,10465952410,6,4491,1604,-30
10467790287,10467790291,4,2453,1764,-30
10468660361,10468660346,-15,1192,393,-30
10472400646,10472400646,0,2081,1270,-30
10476832348,10476832351,3,1867,1158,-30
10480659824,10480659827,3,2316,1211,-30
10481605221,10481605227,6,1413,1175,-30
10481815439,10481815443,4,1538,1070,-30
10481857146,10481857128,-18,1950,1425,-30
10482166434,10482166439,5,2200,1571,-30
10482265534,10482265539,5,2138,1504,-30
10490626381,10490626387,6,2462,1786,-30
10490910174,10490910178,4,3526,1245,-30
10497991626,10497991630,4,2770,1619,-30
10501337975,10501337979,4,2227,1131,-30
10510589354,10510589358,4,2773,1697,-30
10512412659,10512412662,3,1896,1355,-30
10512893786,10512893790,4,3415,1453,-30
10513942759,10513942764,5,2479,1452,-30
10518230398,10518230400,2,2545,1418,-30
10524613773,10524613779,6,3102,1415,-30
10527598135,10527598138,3,1466,1492,-30
10534341726,10534341730,4,1449,922,-30
10538361193,10538361198,5,1779,1275,-30
10545511993,10545512000,7,4503,1822,-30
10547486279,10547486273,-6,1050,4944,-30
10555192809,10555192807,-2,45085,20047,-30
10558456686,10558456690,4,3166,1747,-30
10559528206,10559528210,4,2429,1354,-30
10559871870,10559871875,5,2148,1193,-30
10566177471,10566177465,-6,33115,16124,-30
10567559706,10567559712,6,2357,1403,-30
10575647866,10575647872,6,13146,31985,-30
10577951939,10577951944,5,2617,1180,-30
10581617184,10581617190,6,2518,1519,-30
10588624053,10588624058,5,2480,1566,-30
10589768178,10589768183,5,2851,1522,-30
10590727050,10590727058,8,1410,1006,-30
10595419719,10595419720,1,2033,2426,-30
10597995702,10597995706,4,1311,1039,-30
10599478774,10599478779,5,2856,1348,-30
10600361957,10600361937,-20,2129,1062,-30
10601789999,10601789976,-23,3122,1609,-30
10611637379,10611637383,4,1923,1591,-30
10613953773,10613953776,3,2511,1199,-30
10614949605,10614949609,4,1669,1405,-30
10619554584,10619554590,6,1563,1229,-30
10619808466,10619808470,4,2128,1124,-30
10619903565,10619903568,3,1767,1913,-30
10620174642,10620174648,6,2655,1573,-30
10620595810,10620595825,15,884,284,-30
10623179010,10623179015,5,2890,1531,-30
10623670539,10623670544,5,2156,1281,-30
10628288766,10628288770,4,1916,1213,-30
10634175318,10634175325,7,2404,1114,-30
10640073305,10640073311,6,2415,1288,-30
10641698263,10641698271,8,2244,825,-30
10643033106,10643033110,4,2647,1675,-30
10645739910,10645739914,4,2508,1395,-30
10648148149,10648148148,-1,1186,1972,-30
10653180567,10653180572,5,2611,1685,-30
10655378034,10655378039,5,2507,985,-30
10657054835,10657054837,2,3272,3153,-30
10657640987,10657640989,2,1808,979,-30
10658153523,10658153527,4,1029,1393,-30
10664495987,10664495991,4,1162,1072,-30
10665618481,10665618466,-15,1838,721,-30
10667534697,10667534702,5,2336,1533,-30
10671402172,10671402178,6,2545,1262,-30
10672424293,10672424286,-7,2024,8597,-30
10683863794,10683863799,5,2763,1599,-30
10686754478,10686754483,5,3893,2222,-30
10686860753,10686860760,7,2006,1211,-30
10690954948,10690954954,6,3269,1670,-30
10691574685,10691574690,5,2460,1335,-30
10692642460,10692642467,7,2846,1350,-30
10693926391,10693926395,4,2150,1359,-30
10694038793,10694038799,6,2656,1836,-30
10695645052,10695645065,13,10915,44919,-30
10695861990,10695861995,5,2405,1226,-30
10697445718,10697445723,5,1982,1182,-30
10697822710,10697822712,2,3448,4401,-30
10702415237,10702415233,-4,1796,4883,-30
10704495498,10704495502,4,2721,1061,-30
10705158045,10705158049,4,1861,1306,-30
10707166143,10707166123,-20,1051,1000,-30
10707756489,10707756493,4,1386,1585,-30
10711564566,10711564572,6,3169,1450,-30
10716707501,10716707505,4,1631,1269,-30
10721397106,10721397110,4,2096,1262,-30
10722130790,10722130791,1,1243,1357,-30
10729196278,10729196282,4,1857,1534,-30
10735396658,10735396665,7,6761,2506,-30
10740076140,10740076144,4,2235,1276,-30
10741045523,10741045527,4,1950,1484,-30
10743835823,10743835826,3,2625,2137,-30
10746198540,10746198545,5,2358,1424,-30
10759225264,10759225268,4,2073,1426,-30
10760627867,10760627870,3,2030,1207,-30
10762550175,10762550179,4,1977,1045,-30
10762684665,10762684648,-17,1726,1214,-30
10768501379,10768501386,7,2103,1265,-30
10770668933,10770668937,4,2625,1154,-30
10770715319,10770715325,6,1995,1255,-30
10771108750,10771108756,6,2950,1240,-30
10772475064,10772475073,9,2606,1175,-30
10776488517,10776488522,5,1869,2045,-30
10778705750,10778705755,5,2077,1418,-30
10779156063,10779156069,6,1963,1642,-30
10781927569,10781927575,6,2272,1635,-30
10782132790,10782132797,7,3197,1509,-30
10783391285,10783391290,5,1708,1441,-30
10785548032,10785548029,-3,1183,1813,-30
10788477309,10788477311,2,8912,6728,-30
10791108645,10791108649,4,2052,1066,-30
10795459473,10795459479,6,1598,1046,-30
10802325655,10802325658,3,1771,949,-30
10802612117,10802612096,-21,1635,917,-30
10811052429,10811052434,5,1276,1089,-30
10816045841,10816045846,5,1421,1192,-30
10819742591,10819742591,0,1197,1476,-30
10821645780,10821645782,2,1818,1125,-30
10821873173,10821873178,5,2380,1057,-30
10822222628,10822222633,5,1844,1393,-30
10822615985,10822615989,4,2469,1242,-30
10825869847,10825869845,-2,1377,1549,-30
10827768821,10827768828,7,1880,1404,-30
10830404983,10830404971,-12,11541,37688,-30
10830856873,10830856878,5,2418,1943,-30
10832703121,10832703126,5,1972,874,-30
10833783162,10833783162,0,1183,2333,-30
10835967541,10835967545,4,1601,1052,-30
10836171105,10836171109,4,1767,1315,-30
10836478838,10836478844,6,2247,1591,-30
10837623103,10837623109,6,3164,1833,-30
10841287293,10841287293,0,1461,2663,-30
10843829670,10843829675,5,3487,1814,-30
10843963432,10843963438,6,2596,1710,-30
10844315073,10844315059,-14,1618,952,-30
10844718887,10844718890,3,1366,860,-30
10845515870,10845515859,-11,1129,400,-30
10846487050,10846487055,5,2122,1778,-30
10850259109,10850259113,4,3604,1801,-30
10851341300,10851341306,6,2532,1855,-30
10852193368,10852193374,6,2255,967,-30
10852617682,10852617686,4,2243,1259,-30
10853574966,10853574972,6,2389,1852,-30
10860270576,10860270569,-7,1085,6531,-30
10860508691,10860508695,4,1308,1311,-30
10860887743,10860887750,7,2799,1211,-30
10862351332,10862351336,4,2496,1544,-30
10864914944,10864914937,-7,2712,10050,-30
10867202802,10867202807,5,5983,26226,-30
10867598465,10867598470,5,3094,1293,-30
10869008404,10869008408,4,2251,1551,-30
10871299297,10871299303,6,1774,1280,-30
10876944810,10876944814,4,2360,1388,-30
10880718081,10880718087,6,2365,1385,-30
10881665433,10881665430,-3,1238,970,-30
10884581294,10884581297,3,2159,1458,-30
10888484658,10888484662,4,2465,1181,-30
10890018634,10890018638,4,2457,1727,-30
10897962626,10897962632,6,2036,1031,-30
10899078423,10899078403,-20,24280,26285,-30
10899141948,10899141954,6,2266,1140,-30
10901724593,10901724590,-3,2612,5158,-30
10903017303,10903017311,8,2584,1091,-30
10904881685,10904881698,13,11654,45303,-30
10907111657,10907111662,5,2779,2119,-30
10908427938,10908427942,4,2155,1239,-30
10915669949,10915669954,5,2800,1511,-30
10918483378,10918483377,-1,931,1615,-30
10919723366,10919723369,3,3085,905,-30
10923920874,10923920878,4,1433,1189,-30
10930171054,10930171051,-3,901,1472,-30
10934891406,10934891411,5,1548,1349,-30
10937243389,10937243394,5,1891,1020,-30
10942362735,10942362738,3,2000,1335,-30
10943154205,10943154209,4,2002,1557,-30
10944078811,10944078809,-2,2092,3125,-30
10948226290,10948226294,4,2649,1241,-30
10950753858,10950753863,5,1812,1607,-30
10954075422,10954075429,7,3243,1533,-30
10956006262,10956006268,6,2732,2107,-30
10959621382,10959621387,5,2167,1310,-30
10960292142,10960292147,5,1846,1296,-30
10963138102,10963138106,4,2743,1295,-30
10963430493,10963430496,3,2691,1529,-30
10964364398,10964364403,5,2335,1360,-30
10967528050,10967528054,4,1980,1127,-30
10971164175,10971164179,4,2184,1301,-30
10972596262,10972596267,5,3280,1479,-30
10973672784,10973672789,5,1930,982,-30
10975476371,10975476353,-18,2434,1738,-30
10975521701,10975521707,6,2510,1713,-30
10976826151,10976826151,0,1389,1211,-30
10984265247,10984265242,-5,22734,8245,-30
10988674215,10988674218,3,2590,1504,-30
10990261137,10990261142,5,2170,1260,-30
10990500161,10990500166,5,2289,1561,-30
10992735268,10992735272,4,3468,1954,-30
10993534471,10993534450,-21,2454,1284,-30
10993572817,10993572820,3,1665,1083,-30
10995643890,10995643895,5,2312,1166,-30
10997492338,10997492355,17,393,13290,-30
10999086072,10999086078,6,2548,1191,-30
11000528371,11000528377,6,2079,1300,-30
11007928019,11007928022,3,1735,1498,-30
11009440451,11009440455,4,3490,1700,-30
11012494986,11012494993,7,2328,1246,-30
11013584942,11013584947,5,2616,1205,-30
11017038960,11017038963,3,2091,1559,-30
11018124142,11018124147,5,1013,700,-30
11021222422,11021222426,4,1780,1304,-30
11023073160,11023073166,6,1682,786,-30
11028468609,11028468613,4,1987,1117,-30
11029424184,11029424189,5,2342,1323,-30
11041527843,11041527846,3,1125,1342,-30
11043314102,11043314107,5,2042,1105,-30
11046484048,11046484053,5,1984,1729,-30
11046692589,11046692596,7,2501,1448,-30
11048112566,11048112570,4,2125,1108,-30
11053510376,11053510382,6,2520,1722,-30
11056211158,11056211163,5,2922,1528,-30
11060067877,11060067881,4,2359,1396,-30
11065777010,11065777015,5,2076,1148,-30
11067822185,11067822189,4,1609,1461,-30
11067860721,11067860708,-13,1043,351,-30
11072803344,11072803348,4,1680,1102,-30
11084214778,11084214782,4,2704,1213,-30
11086380155,11086380159,4,1967,1116,-30
11087598824,11087598829,5,2568,1004,-30
11087910241,11087910246,5,3470,1775,-30
11089036516,11089036505,-11,32648,15250,-30
11094060511,11094060517,6,2774,1221,-30
11097882785,11097882771,-14,1894,1040,-30
11099641516,11099641519,3,2191,1525,-30
11107367850,11107367856,6,2118,859,-30
11108089233,11108089226,-7,827,84,-30
11108503401,11108503400,-1,861,231,-30
11112227772,11112227778,6,2740,1375,-30
11126737862,11126737867,5,2361,1147,-30
11134319351,11134319364,13,13872,21264,-30
11137609542,11137609545,3,1530,1423,-30
11137777589,11137777571,-18,1114,217,-30
11139751905,11139751914,9,5888,946,-30
11140615275,11140615279,4,1922,1499,-30
11141824353,11141824357,4,2994,1552,-30
11143769915,11143769920,5,2589,1438,-30
11143980292,11143980296,4,1548,1179,-30
11151466500,11151466506,6,1700,1047,-30
11152126979,11152126960,-19,2238,1353,-30
11152860113,11152860117,4,2165,860,-30
11158520247,11158520254,7,1870,1773,-30
11160483449,11160483441,-8,775,3417,-30
11161286198,11161286202,4,66,571,-30
11164889456,11164889462,6,2352,889,-30
11168418301,11168418306,5,2137,1480,-30
11171136550,11171136554,4,1566,1129,-30
11172420964,11172420967,3,1407,1139,-30
11174819119,11174819125,6,2148,1370,-30
11174960416,11174960421,5,2253,1326,-30
11175317774,11175317773,-1,1617,2373,-30
11175791678,11175791683,5,2165,1237,-30
11176887105,11176887111,6,1637,1076,-30
11180077813,11180077813,0,5622,7623,-30
11183092730,11183092735,5,1616,990,-30
11183918618,11183918625,7,3278,1652,-30
11189728855,11189728860,5,2015,1132,-30
11189780373,11189780385,12,2814,724,-30
11190250538,11190250522,-16,2655,1082,-30
11190567221,11190567223,2,2186,1441,-30
11191199175,11191199175,0,1606,2138,-30
11198216653,11198216660,7,12645,28494,-30
11199796661,11199796666,5,2295,1619,-30
11204009710,11204009705,-5,987,3148,-30
11205119833,11205119835,2,1444,1341,-30
11205163813,11205163818,5,2085,921,-30
11205913904,11205913908,4,2112,1071,-30
11209868601,11209868605,4,2530,1593,-30
11210057350,11210057363,13,622,332,-30
11210820278,11210820277,-1,1196,2325,-30
11211914627,11211914633,6,2374,1716,-30
11212036974,11212036962,-12,1395,421,-30
11212185978,11212185982,4,1386,1389,-30
11216732962,11216732967,5,1871,1114,-30
11222586428,11222586422,-6,746,3582,-30
11222966986,11222966991,5,2148,1268,-30
11224464358,11224464374,16,1857,1246,-30
11225175942,11225175945,3,1458,801,-30
11226339822,11226339826,4,1784,1448,-30
11226505614,11226505618,4,2030,1395,-30
11227912876,11227912879,3,1867,1176,-30
11228020698,11228020705,7,725,188,-30
11229807117,11229807122,5,1902,1202,-30
11231660146,11231660153,7,3050,1289,-30
11235413820,11235413825,5,1961,1482,-30
11236465790,11236465794,4,2721,1730,-30
11245889633,11245889637,4,1998,1295,-30
11247253570,11247253575,5,1123,1334,-30
11249045466,11249045473,7,1923,1266,-30
11250523241,11250523247,6,2056,1353,-30
11251360026,11251360033,7,3053,1447,-30
11252022067,11252022070,3,2391,1223,-30
11252930810,11252930815,5,1893,1392,-30
11252963671,11252963675,4,2349,1348,-30
11257380045,11257380052,7,12392,36706,-30
11259240307,11259240313,6,2355,1341,-30
11260103329,11260103334,5,2231,1694,-30
11266774668,11266774670,2,1004,1118,-30
11268453432,11268453435,3,2321,1221,-30
11271717913,11271717917,4,1278,1287,-30
11276739434,11276739439,5,1492,1168,-30
11282232814,11282232821,7,2544,1266,-30
11288686769,11288686773,4,1887,1346,-30
11294490794,11294490799,5,1670,809,-30
11295020473,11295020477,4,1488,1361,-30
11296045606,11296045611,5,2026,1439,-30
11298735132,11298735137,5,2851,1206,-30
11299330231,11299330234,3,1998,1019,-30
11300931749,11300931754,5,1925,1126,-30
11306912022,11306912028,6,3095,1290,-30
11310191362,11310191367,5,1460,806,-30
11311247739,11311247735,-4,795,2768,-30
11313251067,11313251073,6,2891,1701,-30
11315731219,11315731222,3,1434,1372,-30
11320396303,11320396299,-4,1473,6032,-30
11320820793,11320820798,5,1922,998,-30
11325822234,11325822238,4,1695,1293,-30
11326799097,11326799103,6,2002,1142,-30
11328163347,11328163353,6,2154,1131,-30
11331379202,11331379207,5,2329,1159,-30
11341715166,11341715171,5,2914,1499,-30
11348043338,11348043343,5,3354,1396,-30
11350139736,11350139740,4,2183,1586,-30
11351042174,11351042179,5,8236,5297,-30
11351716029,11351716034,5,2533,766,-30
11352117507,11352117511,4,2289,1338,-30
11352380398,11352380392,-6,1038,3585,-30
11354505641,11354505647,6,2039,1054,-30
11355093329,11355093335,6,2624,1427,-30
11355360019,11355360010,-9,1699,909,-30
11358895402,11358895405,3,1418,984,-30
11363673311,11363673315,4,1911,1323,-30
11364189291,11364189296,5,1956,1593,-30
11370772625,11370772628,3,2833,1727,-30
11371344897,11371344882,-15,41,3192,-30
11371768134,11371768140,6,2322,985,-30
11374920929,11374920935,6,2246,1355,-30
11375600571,11375600576,5,2967,2170,-30
11375826842,11375826843,1,1374,1406,-30
11376664322,11376664326,4,2986,1541,-30
11379398376,11379398381,5,1808,1082,-30
11379758428,11379758432,4,2241,1361,-30
11381664458,11381664463,5,2169,1532,-30
11381909027,11381909033,6,2013,1606,-30
11383129119,11383129124,5,2933,1712,-30
11383792567,11383792554,-13,1165,314,-30
11387715505,11387715506,1,1473,1801,-30
11394046662,11394046669,7,2319,977,-30
11395383613,11395383617,4,2996,1535,-30
11399180771,11399180775,4,2278,1163,-30
11399601632,11399601637,5,2953,2100,-30
11399770471,11399770475,4,1975,1350,-30
11400863882,11400863886,4,2585,1271,-30
11407095995,11407096001,6,2117,1073,-30
11410379862,11410379865,3,2587,1323,-30
11410807735,11410807739,4,3308,1868,-30
11413591627,11413591630,3,1898,1472,-30
11416962463,11416962469,6,2008,1397,-30
11420968709,11420968714,5,2080,1510,-30
11423533045,11423533049,4,1957,1321,-30
11424763642,11424763647,5,2156,1469,-30
11426219499,11426219503,4,2266,1445,-30
11428704481,11428704486,5,2276,1030,-30
11429413875,11429413882,7,3063,1238,-30
11430038207,11430038192,-15,794,442,-30
11431860889,11431860890,1,1328,976,-30
11437743601,11437743605,4,2332,1419,-30
11444480142,11444480143,1,1244,1434,-30
11446517722,11446517727,5,2746,1242,-30
11447122117,11447122123,6,3159,1491,-30
11453530977,11453530983,6,2352,1583,-30
11455048986,11455048990,4,2114,883,-30
11455244707,11455244710,3,1572,1586,-30
11456674815,11456674820,5,2742,1175,-30
11456826184,11456826185,1,5511,26206,-30
11458566317,11458566323,6,2855,1379,-30
11459167838,11459167842,4,2384,1202,-30
11459745683,11459745689,6,3124,1876,-30
11463922035,11463922041,6,2347,1480,-30
11466606935,11466606941,6,2081,1554,-30
11467341949,11467341946,-3,27508,7694,-30
11467375739,11467375740,1,1724,2444,-30
11468164776,11468164781,5,3654,2092,-30
11470614454,11470614459,5,2848,1255,-30
11477402485,11477402485,0,3563,4049,-30
11478481900,11478481906,6,2287,1015,-30
11480104394,11480104395,1,2666,3061,-30
11482731791,11482731785,-6,1104,2541,-30
11485790578,11485790585,7,2519,1331,-30
11486576073,11486576079,6,1432,1041,-30
11486987423,11486987430,7,1901,859,-30
11488918846,11488918850,4,2269,1485,-30
11492412122,11492412127,5,1981,1345,-30
11510092114,11510092118,4,6097,2844,-30
11510485009,11510485014,5,1447,1345,-30
11510648975,11510648954,-21,1542,580,-30
11512668202,11512668206,4,2453,1250,-30
11521332665,11521332670,5,1841,1632,-30
11525532406,11525532410,4,2922,1587,-30
11528929902,11528929907,5,2412,1671,-30
11530107213,11530107210,-3,1477,3805,-30
11530821830,11530821834,4,1666,1480,-30
11531385638,11531385642,4,1532,1380,-30
11539323159,11539323163,4,1632,1389,-30
11540209376,11540209381,5,2141,1065,-30
11544613770,11544613774,4,1897,1142,-30
11544736213,11544736192,-21,1498,613,-30
11545638584,11545638588,4,1974,923,-30
11546960546,11546960531,-15,2429,906,-30
11552072160,11552072163,3,2743,1228,-30
11553640142,11553640147,5,2634,974,-30
11553950203,11553950210,7,2880,1368,-30
11554110225,11554110230,5,2045,1830,-30
11557412730,11557412734,4,2152,1282,-30
11559217242,11559217248,6,2397,1555,-30
11569832587,11569832579,-8,725,4654,-30
11576517326,11576517331,5,2647,1353,-30
11577259838,11577259844,6,2908,1881,-30
11579615350,11579615355,5,2633,1352,-30
11580496809,11580496812,3,2182,1348,-30
11581041844,11581041850,6,2582,1384,-30
11583787076,11583787083,7,1788,1212,-30
11585860317,11585860321,4,2065,1564,-30
11591339202,11591339206,4,2333,1238,-30
11596377934,11596377938,4,2177,1619,-30
11597756513,11597756520,7,2652,1080,-30
11601726334,11601726339,5,2258,1651,-30
11604020148,11604020153,5,2167,1253,-30
11606069604,11606069611,7,2193,1277,-30
11607647062,11607647067,5,2386,1640,-30
11609007161,11609007165,4,2564,1357,-30
11610792534,11610792538,4,1809,878,-30
11613094907,11613094914,7,7626,1327,-30
11622216307,11622216311,4,1863,1167,-30
11633621262,11633621257,-5,992,4275,-30
11637304177,11637304181,4,2882,1426,-30
11642188694,11642188682,-12,542,381,-30
11643922110,11643922115,5,1373,1131,-30
11644074904,11644074906,2,1258,1212,-30
11648261864,11648261866,2,1466,1445,-30
11659351040,11659351045,5,2555,1261,-30
11661906865,11661906870,5,2767,1593,-30
11667610550,11667610554,4,1940,1267,-30
11669200769,11669200775,6,3071,1674,-30
11670061511,11670061514,3,1386,936,-30
11677905878,11677905873,-5,567,3002,-30
11680011950,11680011951,1,1151,841,-30
11680568089,11680568093,4,2465,1237,-30
11685321124,11685321129,5,2660,2308,-30
11689929347,11689929353,6,2206,1389,-30
11689966164,11689966148,-16,1712,1131,-30
11693077474,11693077478,4,2095,1554,-30
11698021292,11698021297,5,2015,1104,-30
11704422811,11704422818,7,2373,1418,-30
11714164980,11714164986,6,2777,1206,-30
11714666013,11714666019,6,1345,1080,-30
11715342015,11715342018,3,1783,874,-30
11716580369,11716580374,5,2259,1044,-30
11718462659,11718462656,-3,1121,2987,-30
11718743494,11718743498,4,2017,919,-30
11718909201,11718909217,16,2140,1240,-30
11722470463,11722470466,3,1202,1322,-30
11728448850,11728448856,6,2351,1219,-30
11732527443,11732527447,4,1922,1790,-30
11734697858,11734697863,5,1788,1140,-30
11739224096,11739224100,4,1759,1419,-30
11740337393,11740337399,6,2551,1522,-30
11741713259,11741713262,3,1654,1249,-30
11742984390,11742984396,6,2231,1341,-30
11743172944,11743172949,5,2215,1669,-30
11744465109,11744465114,5,2667,1845,-30
11745037633,11745037639,6,1754,1484,-30
11745150669,11745150650,-19,1599,1155,-30
11746164113,11746164117,4,42331,25468,-30
11746626093,11746626097,4,2623,2070,-30
11749673192,11749673199,7,7566,2607,-30
11750042449,11750042444,-5,638,1843,-30
11752455111,11752455118,7,2714,1382,-30
11755408985,11755408989,4,2902,1633,-30
11758170362,11758170366,4,1882,709,-30
11759116630,11759116610,-20,2024,873,-30
11765846225,11765846229,4,1933,1375,-30
11769143115,11769143120,5,1928,1100,-30
11769233514,11769233530,16,2303,1326,-30
11770029346,11770029351,5,2136,1878,-30
11774919515,11774919521,6,2161,941,-30
11778059043,11778059049,6,1909,1320,-30
11781762383,11781762387,4,3207,1708,-30
11782665100,11782665106,6,1993,1611,-30
11784892520,11784892526,6,3320,1381,-30
11784922655,11784922660,5,2638,1311,-30
11785386415,11785386417,2,958,992,-30
11787785469,11787785475,6,2565,1285,-30
11790780766,11790780769,3,2299,906,-30
11791282697,11791282701,4,2457,1440,-30
11794440191,11794440194,3,1698,1252,-30
11794841726,11794841730,4,1957,892,-30
11798178629,11798178634,5,2420,1055,-30
11801818861,11801818867,6,1833,1289,-30
11811922526,11811922530,4,1764,1104,-30
11812888991,11812888994,3,3233,1538,-30
11813227706,11813227705,-1,1086,1262,-30
11816101645,11816101650,5,2553,927,-30
11816551440,11816551445,5,1773,1160,-30
11818849771,11818849753,-18,1919,695,-30
11820097178,11820097184,6,2673,2205,-30
11823649059,11823649063,4,2007,1420,-30
11824698718,11824698700,-18,1463,844,-30
11829975058,11829975072,14,2343,1681,-30
11831124527,11831124534,7,1377,837,-30
11833423405,11833423411,6,2619,1439,-30
11834339934,11834339943,9,1555,1086,-30
11842207382,11842207387,5,2307,1751,-30
11844904382,11844904383,1,2892,2968,-30
11845748182,11845748187,5,2247,899,-30
11845906289,11845906273,-16,2165,1200,-30
11848120263,11848120264,1,1296,1631,-30
11852411969,11852411970,1,1349,1436,-30
11856106965,11856106970,5,1583,1228,-30
11856766490,11856766495,5,2301,1309,-30
11865103910,11865103909,-1,1099,2280,-30
11873815411,11873815415,4,1803,1510,-30
11875691537,11875691540,3,1952,1226,-30
11877585564,11877585566,2,1531,1753,-30
11884140459,11884140439,-20,1390,869,-30
11891623102,11891623107,5,2785,1901,-30
11894171936,11894171941,5,3346,1475,-30
11897000805,11897000812,7,7158,2346,-30
11897063004,11897063008,4,1868,1250,-30
11897379329,11897379335,6,1866,1093,-30
11898758829,11898758835,6,3550,1342,-30
11901366614,11901366619,5,2171,1307,-30
11902061743,11902061749,6,1345,948,-30
11902981130,11902981112,-18,765,262,-30
11906098685,11906098690,5,2425,1147,-30
11906816366,11906816373,7,3001,773,-30
11907256206,11907256211,5,2571,1526,-30
11908024050,11908024057,7,2336,1414,-30
11908590057,11908590062,5,5113,2938,-30
11909098169,11909098170,1,1466,1020,-30
11912411954,11912411958,4,2036,1434,-30
11920896551,11920896553,2,1169,912,-30
11921925077,11921925082,5,1986,1450,-30
11926060501,11926060506,5,2097,1307,-30
11926452797,11926452794,-3,1107,3326,-30
11928847965,11928847969,4,1886,1150,-30
11928925693,11928925698,5,2139,1780,-30
11929959530,11929959538,8,2513,1378,-30
11933677419,11933677423,4,2336,1350,-30
11933888659,11933888644,-15,923,445,-30
11938280850,11938280838,-12,25480,15717,-30
11938983750,11938983753,3,1813,1090,-30
11943606342,11943606346,4,2362,1158,-30
11944476792,11944476797,5,1685,1366,-30
11945581112,11945581117,5,1686,1695,-30
11948636517,11948636522,5,1414,1097,-30
11953683695,11953683699,4,1571,891,-30
11955822201,11955822205,4,1842,1227,-30
11959825322,11959825329,7,2393,1333,-30
11961007738,11961007743,5,2530,1878,-30
11961948082,11961948091,9,2280,1111,-30
11964852023,11964852030,7,2150,1271,-30
11967261349,11967261353,4,1849,1203,-30
11973077080,11973077085,5,1813,1157,-30
11974431966,11974431970,4,2362,1750,-30
11976314005,11976314011,6,2342,1516,-30
11976473023,11976473022,-1,1744,2664,-30
11978016426,11978016430,4,3334,1933,-30
11981289230,11981289237,7,1883,1379,-30
11982354270,11982354277,7,3897,1236,-30
11989841703,11989841706,3,88,1360,-30
11991729127,11991729133,6,2872,854,-30
12002247869,12002247878,9,13365,24058,-30
12003794249,12003794256,7,12016,37546,-30
12004681480,12004681485,5,2611,1430,-30
12009946581,12009946585,4,1865,1274,-30
12013197406,12013197413,7,6141,3064,-30
12019722988,12019722995,7,2942,1767,-30
12019935641,12019935658,17,2078,1750,-30
12028924101,12028924105,4,2272,1171,-30
12036715222,12036715226,4,2713,1126,-30
12038339253,12038339257,4,2299,1826,-30
12047594224,12047594230,6,2286,1435,-30
12048786406,12048786410,4,2207,1284,-30
12050805182,12050805188,6,3459,1365,-30
12051793226,12051793231,5,2221,1194,-30
12061159767,12061159773,6,2776,1606,-30
12064460325,12064460330,5,2274,1278,-30
12064644444,12064644452,8,2770,1916,-30
12069873663,12069873670,7,2506,1358,-30
12071983496,12071983501,5,1630,870,-30
12074451376,12074451381,5,1892,1225,-30
12075286172,12075286174,2,1720,1683,-30
12077136628,12077136635,7,2260,1209,-30
12083063166,12083063170,4,1979,1604,-30
12085023890,12085023892,2,1991,1403,-30
12086535478,12086535485,7,2254,1270,-30
12087101207,12087101211,4,2036,1144,-30
12089540278,12089540281,3,1470,1154,-30
12095913193,12095913195,2,2010,1541,-30
12097885641,12097885642,1,1239,1487,-30
12100089269,12100089270,1,1544,1058,-30
12102648306,12102648291,-15,1597,517,-30
12103077839,12103077846,7,3750,1346,-30
12110406238,12110406244,6,2681,1927,-30
12114129745,12114129750,5,2130,1265,-30
12115346304,12115346297,-7,1842,10812,-30
12115526185,12115526190,5,1626,1262,-30
12116358535,12116358540,5,2279,1403,-30
12119056102,12119056107,5,3347,1501,-30
12130580962,12130580963,1,1305,1685,-30
12131518017,12131518019,2,2022,1146,-30
12139245126,12139245134,8,2800,1390,-30
12139787715,12139787719,4,1898,1124,-30
12139957823,12139957802,-21,803,416,-30
12150945458,12150945462,4,1468,776,-30
12153398686,12153398690,4,2432,1160,-30
12153717692,12153717674,-18,2448,770,-30
12154483704,12154483709,5,2229,1489,-30
12154659641,12154659634,-7,493,1974,-30
12156999840,12156999843,3,2286,1600,-30
12159400238,12159400242,4,1967,1495,-30
12165430558,12165430563,5,2172,1371,-30
12166257762,12166257763,1,4146,3919,-30
12178059059,12178059066,7,2822,1956,-30
12183173875,12183173877,2,1088,1755,-30
12185126639,12185126643,4,1820,1615,-30
12187135122,12187135129,7,2009,1374,-30
12188836658,12188836662,4,1929,838,-30
12188927498,12188927503,5,2263,1709,-30
12190520769,12190520775,6,1759,1452,-30
12192909563,12192909567,4,1798,1353,-30
12193941587,12193941591,4,2639,1608,-30
12198448967,12198448971,4,2291,1171,-30
12198721090,12198721105,15,2588,1036,-30
12199291321,12199291314,-7,933,3325,-30
12202786638,12202786643,5,1399,705,-30
12204778125,12204778130,5,1859,1349,-30
12205723909,12205723914,5,2353,1299,-30
12206158702,12206158697,-5,1298,3419,-30
12208747198,12208747197,-1,1340,1439,-30
12216538494,12216538497,3,2346,2211,-30
12219021884,12219021887,3,3062,1983,-30
12222266394,12222266399,5,2418,1114,-30
12222732390,12222732394,4,12945,8565,-30
12229598117,12229598120,3,4501,2479,-30
12229794737,12229794741,4,2465,781,-30
12233002631,12233002635,4,1710,1329,-30
12234970598,12234970603,5,2646,1482,-30
12235694763,12235694770,7,2702,1413,-30
12236316869,12236316874,5,1256,1009,-30
12237402557,12237402561,4,3178,1553,-30
12244688493,12244688498,5,2369,1739,-30
12245858053,12245858060,7,2223,1621,-30
12246966761,12246966766,5,2418,1496,-30
12250833975,12250833980,5,2209,1209,-30
12254952186,12254952193,7,3189,1425,-30
12258530086,12258530090,4,2411,1358,-30
12258701277,12258701283,6,1344,1072,-30
12260282662,12260282668,6,2596,1465,-30
12261998752,12261998757,5,1540,871,-30
12263187156,12263187162,6,2039,1352,-30
12263214298,12263214305,7,2371,1567,-30
12265431057,12265431061,4,2748,1798,-30
12265979393,12265979394,1,1241,1394,-30
12268899014,12268899020,6,2239,1045,-30
12269037154,12269037137,-17,1989,911,-30
12270788751,12270788750,-1,955,2614,-30
12271899172,12271899177,5,2683,1367,-30
12272482311,12272482314,3,1557,741,-30
12274508939,12274508951,12,249,3318,-30
12279573230,12279573235,5,2758,1309,-30
12280361163,12280361167,4,1480,897,-30
12282186817,12282186822,5,1899,1127,-30
12283603118,12283603122,4,1680,1554,-30
12284228843,12284228843,0,1899,2081,-30
12285009277,12285009283,6,2331,1481,-30
12285733295,12285733289,-6,927,1995,-30
12286856281,12286856287,6,1828,1069,-30
12287005432,12287005438,6,3316,1853,-30
12287174770,12287174755,-15,924,871,-30
12287595450,12287595454,4,2206,1524,-30
12290418111,12290418117,6,2609,1615,-30
12291933279,12291933285,6,2748,2000,-30
12293016813,12293016817,4,2424,1390,-30
12294158998,12294159002,4,2869,1981,-30
12298505810,12298505815,5,2176,1553,-30
12302994878,12302994881,3,4109,3900,-30
12306130473,12306130477,4,1840,980,-30
12306962488,12306962491,3,4341,2761,-30
12307558574,12307558578,4,2408,899,-30
12308930051,12308930054,3,2737,1229,-30
12311664155,12311664160,5,1903,1488,-30
12311809516,12311809528,12,1425,612,-30
12311982389,12311982394,5,1755,919,-30
12315368294,12315368298,4,1936,1403,-30
12316073771,12316073776,5,1404,1512,-30
12320671479,12320671485,6,2796,1288,-30
12321584372,12321584377,5,1912,1520,-30
12324330605,12324330608,3,2085,1312,-30
12326160790,12326160794,4,2792,1700,-30
12327731756,12327731760,4,2145,1721,-30
12328110381,12328110364,-17,2686,1390,-30
12336871765,12336871767,2,2207,1368,-30
12339267537,12339267541,4,2199,1388,-30
12339623275,12339623290,15,2360,1123,-30
12339673397,12339673378,-19,1540,916,-30
12344791274,12344791277,3,2037,1473,-30
12345568058,12345568062,4,2272,1471,-30
12345634567,12345634573,6,1926,1597,-30
12349695968,12349695972,4,1981,1833,-30
12354435096,12354435103,7,1491,1133,-30
12354914266,12354914270,4,1374,959,-30
12361461609,12361461615,6,2141,1229,-30
12363735330,12363735334,4,1565,938,-30
12367079449,12367079455,6,2641,1645,-30
12368347585,12368347581,-4,529,1417,-30
12370695930,12370695934,4,2548,1305,-30
12372620614,12372620620,6,2993,1703,-30
12373636020,12373636033,13,2125,1223,-30
12378664706,12378664710,4,1476,998,-30
12395895921,12395895926,5,1567,1065,-30
12397220893,12397220899,6,2794,1512,-30
12400592436,12400592439,3,1726,1499,-30
12401143606,12401143609,3,1593,1067,-30
12404140494,12404140487,-7,1177,19631,-30
12409199022,12409199026,4,2364,1423,-30
12415806685,12415806690,5,2168,1523,-30
12418089618,12418089623,5,2088,1469,-30
12418592046,12418592052,6,2801,1428,-30
12420738381,12420738385,4,1042,763,-30
12421113803,12421113808,5,2306,1579,-30
12423682711,12423682715,4,2704,1456,-30
12430840262,12430840266,4,2277,1488,-30
12432661001,12432661004,3,2941,1520,-30
12434100165,12434100170,5,2862,1405,-30
12434424438,12434424445,7,2657,1452,-30
12437083562,12437083566,4,2780,1431,-30
12440796935,12440796938,3,2183,1388,-30
12443699647,12443699653,6,2820,1622,-30
12444198205,12444198210,5,2547,1265,-30
12444233982,12444233992,10,2342,1227,-30
12444785933,12444785937,4,1836,1543,-30
12447752881,12447752882,1,5028,22881,-30
12450674762,12450674767,5,2527,1593,-30
12455048584,12455048591,7,2195,954,-30
12456867958,12456867962,4,2972,1565,-30
12458879075,12458879081,6,1415,1357,-30
12458983572,12458983555,-17,1398,713,-30
12460500876,12460500878,2,1977,1954,-30
12461612626,12461612629,3,2042,1178,-30
12462168420,12462168441,21,809,282,-30
12463915701,12463915706,5,2354,1223,-30
12466349353,12466349359,6,3175,1789,-30
12466960532,12466960537,5,1929,1344,-30
12467252889,12467252895,6,2227,1044,-30
12469378537,12469378542,5,3122,1231,-30
12470229767,12470229746,-21,2089,1331,-30
12470530657,12470530661,4,2096,1216,-30
12471733369,12471733374,5,1755,947,-30
12472470114,12472470098,-16,2358,847,-30
12480832360,12480832365,5,2180,1605,-30
12482391181,12482391185,4,1101,1520,-30
12482986882,12482986888,6,2880,1495,-30
12483416245,12483416249,4,1726,1335,-30
12489960472,12489960477,5,2425,1073,-30
12490245170,12490245173,3,1750,1244,-30
12490510813,12490510815,2,2236,1688,-30
12491751952,12491751968,16,1864,720,-30
12494084185,12494084190,5,2075,1620,-30
12502628474,12502628481,7,2904,1345,-30
12504040801,12504040806,5,2794,1793,-30
12505474826,12505474831,5,2205,1098,-30
12512481213,12512481218,5,2192,1184,-30
12517723674,12517723672,-2,1336,2458,-30
12521708516,12521708523,7,2980,1430,-30
12523425018,12523425022,4,2244,1026,-30
12529123321,12529123325,4,2837,1397,-30
12531268958,12531268964,6,2749,1444,-30
12533143642,12533143647,5,2711,1342,-30
12535508850,12535508855,5,2225,1361,-30
12538286811,12538286817,6,1596,1264,-30
12540161239,12540161243,4,2129,1238,-30
12541718396,12541718401,5,2291,1119,-30
12546510670,12546510675,5,1601,1323,-30
12550145405,12550145410,5,2178,1247,-30
12550510393,12550510379,-14,622,364,-30
12552761584,12552761578,-6,37,3642,-30
12554212585,12554212589,4,1616,1341,-30
12554480784,12554480785,1,1680,2134,-30
12560696314,12560696317,3,3923,3765,-30
12561105222,12561105226,4,1809,1326,-30
12563280530,12563280535,5,1872,1243,-30
12563753397,12563753402,5,2402,1545,-30
12564341406,12564341411,5,2615,1292,-30
12567135242,12567135245,3,2037,1413,-30
12569680989,12569680994,5,1928,1128,-30
12569949714,12569949718,4,2125,1423,-30
12572073203,12572073209,6,2664,1334,-30
12573673711,12573673714,3,2319,2036,-30
12574213955,12574213963,8,4803,1687,-30
12578699484,12578699488,4,2237,1637,-30
12579523175,12579523182,7,2951,863,-30
12582676386,12582676390,4,1663,703,-30
12592236886,12592236894,8,2612,876,-30
12593638428,12593638434,6,1984,1302,-30
12596142025,12596142031,6,1846,1143,-30
12596558564,12596558570,6,2547,1332,-30
12599445658,12599445663,5,2266,1340,-30
12599518015,12599518021,6,52595,26929,-30
12599669519,12599669514,-5,1997,6660,-30
12600959015,12600959017,2,2615,2680,-30
12605690319,12605690324,5,3355,1899,-30
12607711362,12607711367,5,3385,1569,-30
12609662650,12609662651,1,848,1237,-30
12618711120,12618711126,6,2478,1502,-30
12619510737,12619510734,-3,1059,2276,-30
12619551577,12619551581,4,2007,1215,-30
12622668157,12622668162,5,3344,1519,-30
12624512648,12624512646,-2,1006,2468,-30
12624664043,12624664049,6,1563,1167,-30
12626338501,12626338506,5,1572,1184,-30
12629992729,12629992734,5,2237,1513,-30
12630227927,12630227906,-21,2145,1481,-30
12630297548,12630297553,5,2006,1527,-30
12631952971,12631952974,3,1411,1356,-30
12641081413,12641081419,6,2016,1537,-30
12642166449,12642166453,4,1531,1277,-30
12648481741,12648481745,4,3122,1502,-30
12652266028,12652266034,6,1796,898,-30
12654141983,12654141987,4,1269,1217,-30
12655299878,12655299879,1,1137,1548,-30
12656848013,12656848018,5,3421,1494,-30
12659595011,12659595014,3,1263,969,-30
12661632767,12661632770,3,1973,1317,-30
12664501391,12664501396,5,2539,1590,-30
12664612746,12664612751,5,2224,1406,-30
12664737039,12664737045,6,2164,1319,-30
12665735994,12665735999,5,2647,1804,-30
12667406399,12667406403,4,2461,1914,-30
12669099491,12669099496,5,2692,1643,-30
12669471801,12669471811,10,1712,986,-30
12680907425,12680907431,6,3718,1976,-30
12682321549,12682321555,6,2535,1317,-30
12686543439,12686543443,4,2009,975,-30
12687402509,12687402514,5,2274,1615,-30
12697926386,12697926391,5,2997,1269,-30
12698374694,12698374699,5,2853,1922,-30
12698576363,12698576369,6,2573,1740,-30
12703285146,12703285152,6,2959,1597,-30
12703563148,12703563154,6,2732,1646,-30
12717368958,12717368963,5,2670,1254,-30
12719234635,12719234639,4,2038,1640,-30
12720233908,12720233921,13,2086,1060,-30
12721553985,12721553988,3,1115,1306,-30
12723619298,12723619303,5,2404,1265,-30
12730048753,12730048758,5,2072,1118,-30
12735581354,12735581358,4,2436,1146,-30
12736971620,12736971612,-8,1432,3152,-30
12741231139,12741231156,17,2776,1277,-30
12742755478,12742755499,21,1764,1469,-30
12747101656,12747101661,5,2611,1679,-30
12747231445,12747231428,-17,2842,1444,-30
12749436687,12749436683,-4,598,251,-30
12753616729,12753616735,6,2221,1658,-30
12754786139,12754786143,4,1377,1200,-30
12754849585,12754849571,-14,728,371,-30
12756859542,12756859549,7,2167,1420,-30
12757948911,12757948918,7,5680,2880,-30
12758202025,12758202030,5,2410,1741,-30
12759141253,12759141258,5,5081,2600,-30
12759203376,12759203381,5,1798,1115,-30
12761914496,12761914500,4,2582,1506,-30
12764085399,12764085402,3,2200,1472,-30
12764157004,12764157007,3,3499,1570,-30
12767397552,12767397558,6,2117,931,-30
12769925043,12769925046,3,2259,1134,-30
12770540082,12770540080,-2,5069,11725,-30
12774460254,12774460253,-1,877,1895,-30
12775963992,12775963986,-6,1639,4344,-30
12777315837,12777315820,-17,2544,1211,-30
12780421193,12780421199,6,2274,1254,-30
12782507964,12782507969,5,2806,1418,-30
12783724213,12783724218,5,1917,1314,-30
12784948284,12784948287,3,1568,1240,-30
12785407050,12785407053,3,2720,1474,-30
12794848786,12794848791,5,2522,1237,-30
12796422084,12796422089,5,1752,1382,-30
12797766542,12797766546,4,1696,1011,-30
12798940260,12798940265,5,2017,1291,-30
12799348216,12799348222,6,2340,1042,-30
12800304909,12800304932,23,1025,1352,-30
12803959779,12803959780,1,1287,988,-30
12808161716,12808161720,4,1845,1500,-30
12808343863,12808343866,3,1832,1801,-30
12808934546,12808934552,6,2878,1599,-30
12809097898,12809097896,-2,1075,2156,-30
12810306401,12810306406,5,2572,1082,-30
12810521626,12810521611,-15,1266,697,-30
12811376201,12811376206,5,2609,1231,-30
12811574966,12811574947,-19,708,686,-30
12815466288,12815466295,7,2774,1354,-30
12826073786,12826073789,3,2363,1370,-30
12827936339,12827936335,-4,1635,4445,-30
12831693618,12831693623,5,2310,1832,-30
12834011785,12834011790,5,1884,1342,-30
12837616441,12837616447,6,1735,1122,-30
12838742886,12838742890,4,1899,1297,-30
12841830860,12841830865,5,4580,2104,-30
12843231862,12843231869,7,12492,22532,-30
12847618137,12847618135,-2,4511,6757,-30
12847939282,12847939286,4,1925,1361,-30
12849488587,12849488592,5,2449,1382,-30
12851888374,12851888379,5,2005,862,-30
12855238713,12855238709,-4,47163,19605,-30
12856793600,12856793605,5,3648,1350,-30
12857514982,12857514988,6,2202,970,-30
12857845158,12857845163,5,2198,1649,-30
12863332871,12863332873,2,1183,2040,-30
12863479139,12863479145,6,1948,1366,-30
12864861928,12864861931,3,2300,1459,-30
12865813301,12865813293,-8,875,4049,-30
12870273307,12870273314,7,3675,1462,-30
12870391066,12870391072,6,1587,1232,-30
12872799131,12872799110,-21,21149,42441,-30
12873363768,12873363773,5,2490,1748,-30
12874216061,12874216065,4,2010,1137,-30
12874988454,12874988459,5,2090,1342,-30
12879545691,12879545696,5,2038,1361,-30
12882045211,12882045215,4,2097,965,-30
12884323706,12884323712,6,2150,1046,-30
12884598173,12884598153,-20,2258,1782,-30
12884923826,12884923830,4,1868,723,-30
12888542909,12888542900,-9,335,98,-30
12890286157,12890286162,5,2391,1501,-30
12891713149,12891713154,5,2938,1403,-30
12892113038,12892113039,1,2071,1739,-30
12895038713,12895038720,7,2714,1422,-30
12897719948,12897719946,-2,1086,2523,-30
12900557839,12900557846,7,2200,976,-30
12900592558,12900592562,4,2000,1747,-30
12909708681,12909708685,4,2135,930,-30
12910818527,12910818530,3,1463,935,-30
12913705542,12913705546,4,2210,1330,-30
12914173206,12914173213,7,2526,1237,-30
12914858115,12914858120,5,2815,1237,-30
12915122183,12915122188,5,1693,1010,-30
12915585356,12915585362,6,2734,1215,-30
12917468729,12917468734,5,1835,711,-30
12924091649,12924091646,-3,1602,3463,-30
12924443638,12924443642,4,2159,2051,-30
12927683414,12927683419,5,2666,1327,-30
12928288589,12928288594,5,1772,1185,-30
12929195300,12929195302,2,1909,1280,-30
12929561679,12929561660,-19,1482,1046,-30
12929778042,12929778042,0,801,1454,-30
12935087070,12935087074,4,2475,1269,-30
12938323573,12938323578,5,2216,1178,-30
12938670029,12938670034,5,1909,1392,-30
12941828340,12941828344,4,2050,1432,-30
12942204657,12942204643,-14,1235,480,-30
12947132405,12947132410,5,2899,1155,-30
12947722486,12947722492,6,2676,1224,-30
12949132414,12949132418,4,2145,2294,-30
12950228705,12950228708,3,1828,1303,-30
12955615562,12955615566,4,2255,1631,-30
12956234898,12956234902,4,1896,1115,-30
12958005234,12958005238,4,2316,1215,-30
12960464445,12960464442,-3,1261,2418,-30
12967201055,12967201061,6,1722,829,-30
12969342905,12969342909,4,3734,1771,-30
12970079290,12970079287,-3,1082,3137,-30
12972142223,12972142226,3,2245,1517,-30
12974056210,12974056208,-2,1161,1572,-30
12975271417,12975271422,5,2867,1469,-30
12975463274,12975463279,5,2443,1077,-30
12977883774,12977883781,7,1509,1750,-30
12981389143,12981389147,4,1987,1532,-30
12981671467,12981671472,5,2503,2368,-30
12984302726,12984302730,4,2275,814,-30
12987937635,12987937641,6,1411,1015,-30
12990298115,12990298120,5,1626,936,-30
12993328776,12993328781,5,3460,1852,-30
12993393519,12993393505,-14,1229,561,-30
12995086339,12995086343,4,1598,1638,-30
12997655834,12997655835,1,1153,1702,-30
12999250254,12999250256,2,1374,1000,-30
13000048054,13000048063,9,3678,1627,-30
13004170086,13004170086,0,1013,2112,-30
13005403701,13005403706,5,2460,1392,-30
13005923254,13005923235,-19,1836,1019,-30
13009334914,13009334913,-1,961,1972,-30
13009616177,13009616181,4,2451,1860,-30
13014157504,13014157508,4,2684,1719,-30
13020702400,13020702406,6,1430,1307,-30
13023874397,13023874402,5,1664,1054,-30
13027678464,13027678466,2,1592,1520,-30
13032228737,13032228741,4,1166,700,-30
13038869612,13038869618,6,1903,1144,-30
13040004953,13040004936,-17,1866,673,-30
13040854429,13040854435,6,2406,1333,-30
13041575324,13041575328,4,1315,1071,-30
13043894360,13043894366,6,2406,1642,-30
13045935550,13045935555,5,1341,1182,-30
13049576501,13049576506,5,2278,1429,-30
13052298445,13052298450,5,1758,1304,-30
13055996751,13055996757,6,1637,1117,-30
13060604854,13060604858,4,2351,1580,-30
13062603667,13062603674,7,2597,1325,-30
13062633586,13062633604,18,877,255,-30
13066898874,13066898879,5,2039,970,-30
13070009835,13070009840,5,1666,1296,-30
13074324424,13074324428,4,1591,1130,-30
13075242777,13075242783,6,2145,1403,-30
13075695749,13075695754,5,2570,1461,-30
13077741855,13077741861,6,1723,1253,-30
13080183694,13080183699,5,1888,1046,-30
13083709003,13083709002,-1,1122,1384,-30
13087552925,13087552931,6,1440,1086,-30
13089325012,13089325011,-1,87,2788,-30
13090601695,13090601699,4,1796,1281,-30
13091811407,13091811413,6,1903,1507,-30
13091975626,13091975630,4,2324,1420,-30
13093488478,13093488482,4,2423,1661,-30
13098941931,13098941935,4,3091,1891,-30
13108277995,13108278001,6,2725,1330,-30
13111158448,13111158452,4,1947,1235,-30
13111531555,13111531558,3,2375,1425,-30
13112090489,13112090494,5,2113,1283,-30
13112333018,13112333023,5,1888,1434,-30
13112878542,13112878563,21,764,292,-30
13115120313,13115120318,5,1886,1295,-30
13115960258,13115960242,-16,2166,1456,-30
13117065088,13117065094,6,2242,1240,-30
13119811702,13119811708,6,2787,1379,-30
13120553682,13120553668,-14,789,577,-30
13123603794,13123603798,4,1654,1098,-30
13126523402,13126523409,7,3064,1557,-30
13127164630,13127164629,-1,1590,2451,-30
13132213737,13132213743,6,2311,1089,-30
13135106586,13135106594,8,1227,631,-30
13135573362,13135573366,4,2339,1142,-30
13141945308,13141945313,5,3210,1905,-30
13144755046,13144755049,3,2087,930,-30
13145092830,13145092848,18,2329,1157,-30
13145599623,13145599609,-14,2053,683,-30
13147485249,13147485251,2,2035,2773,-30
13151138983,13151138990,7,3293,1445,-30
13152123729,13152123727,-2,1584,2996,-30
13153014272,13153014279,7,3494,1224,-30
13153505310,13153505289,-21,1754,1125,-30
13157104303,13157104307,4,3125,1688,-30
13159360046,13159360049,3,1803,1268,-30
13161099364,13161099368,4,2059,1802,-30
13167110488,13167110484,-4,932,2129,-30
13168587413,13168587418,5,2201,1217,-30
13177006346,13177006351,5,2419,1077,-30
13183296353,13183296360,7,1941,1322,-30
13184881931,13184881937,6,2147,1473,-30
13186171395,13186171400,5,2253,1588,-30
13186605805,13186605810,5,1637,1103,-30
13187469029,13187469033,4,1138,1328,-30
13190733622,13190733629,7,2450,1034,-30
13191883122,13191883105,-17,3747,1868,-30
13193780693,13193780695,2,1975,1638,-30
13195931635,13195931639,4,1261,1421,-30
13197041762,13197041769,7,1810,1336,-30
13200422650,13200422655,5,1742,1318,-30
13203629470,13203629474,4,1873,853,-30
13204092869,13204092876,7,2810,1316,-30
13204378758,13204378763,5,2506,1306,-30
13208703550,13208703555,5,2057,1393,-30
13208734558,13208734538,-20,819,527,-30
13209014807,13209014803,-4,1765,3766,-30
13210126478,13210126484,6,3007,1874,-30
13211538758,13211538763,5,1719,868,-30
13213134576,13213134581,5,1944,1634,-30
13218341611,13218341617,6,2520,662,-30
13218500316,13218500328,12,1796,1478,-30
13223514648,13223514655,7,3054,1730,-30
13224795263,13224795268,5,2491,1738,-30
13232463055,13232463057,2,3283,3465,-30
13232792925,13232792929,4,2560,1635,-30
13234930742,13234930747,5,1930,1239,-30
13235563777,13235563780,3,2398,1545,-30
13239894980,13239894985,5,3588,1862,-30
13240790525,13240790533,8,1763,1447,-30
13241217282,13241217297,15,3284,1527,-30
13241747255,13241747240,-15,795,468,-30
13243086087,13243086091,4,1965,1144,-30
13248963187,13248963193,6,2341,1513,-30
13251230289,13251230294,5,1890,1655,-30
13252349642,13252349648,6,3674,1660,-30
13253365825,13253365830,5,3399,1775,-30
13255944978,13255944984,6,2184,1140,-30
13256168030,13256168019,-11,2054,1006,-30
13256831597,13256831603,6,1264,1309,-30
13258264458,13258264462,4,2195,1554,-30
13258818803,13258818786,-17,1200,398,-30
13262829489,13262829493,4,1978,896,-30
13265729171,13265729177,6,1761,1152,-30
13266179658,13266179663,5,2488,1187,-30
13269804364,13269804368,4,2949,1879,-30
13272634922,13272634927,5,3075,1780,-30
13281546298,13281546300,2,1879,1789,-30
13282993702,13282993705,3,2161,1553,-30
13284270003,13284269998,-5,937,3365,-30
13287111571,13287111577,6,1888,1313,-30
13289150125,13289150130,5,2339,1549,-30
13289407207,13289407193,-14,823,391,-30
13290967734,13290967718,-16,1206,460,-30
13291446721,13291446725,4,2147,1424,-30
13292975222,13292975228,6,1994,965,-30
13293096854,13293096835,-19,1144,336,-30
13298041350,13298041343,-7,1593,7537,-30
13302349474,13302349481,7,3011,1507,-30
13307759688,13307759693,5,2413,1534,-30
13317494058,13317494063,5,3746,1753,-30
13323340322,13323340327,5,2477,1723,-30
13323437990,13323437995,5,1513,1003,-30
13325630289,13325630295,6,2951,1688,-30
13334703221,13334703226,5,2337,1295,-30
13335177879,13335177886,7,1149,907,-30
13342894109,13342894113,4,3018,1373,-30
13346273267,13346273271,4,2391,1614,-30
13347213376,13347213380,4,1727,1800,-30
13348478758,13348478764,6,2919,1015,-30
13352377296,13352377300,4,2720,1411,-30
13352925339,13352925327,-12,9975,39907,-30
13353575085,13353575089,4,539,315,-30
13354616803,13354616809,6,2755,1296,-30
13355589649,13355589653,4,2727,1579,-30
13364650347,13364650351,4,2093,1416,-30
13366287339,13366287341,2,1571,1145,-30
13369806695,13369806697,2,1782,1555,-30
13371580295,13371580302,7,3197,1616,-30
13372399678,13372399684,6,4289,1762,-30
13377802546,13377802550,4,2502,1329,-30
13379289369,13379289374,5,1958,1498,-30
13382223670,13382223668,-2,980,1356,-30
13383047903,13383047907,4,2290,1595,-30
13383482541,13383482521,-20,2435,1589,-30
13383854662,13383854662,0,2288,3552,-30
13385660700,13385660705,5,2685,1511,-30
13388045718,13388045698,-20,645,1653,-30
13392771130,13392771132,2,769,320,-30
13396516854,13396516862,8,2720,1573,-30
13397835773,13397835773,0,17157,21371,-30
13404255974,13404255975,1,891,1233,-30
13405943537,13405943532,-5,3103,10793,-30
13406401165,13406401165,0,2543,2213,-30
13408026113,13408026094,-19,2163,1146,-30
13409387589,13409387594,5,2243,1675,-30
13412816708,13412816712,4,1545,567,-30
13412918532,13412918545,13,3097,1674,-30
13414568602,13414568605,3,2419,1594,-30
13414708474,13414708478,4,1097,1269,-30
13419143106,13419143110,4,2164,1335,-30
13425113209,13425113211,2,1663,1080,-30
13435524601,13435524606,5,2760,1339,-30
13438046122,13438046127,5,2135,1479,-30
13438712903,13438712899,-4,1647,4243,-30
13441277850,13441277855,5,2230,1290,-30
13443949761,13443949766,5,2516,1772,-30
13444673819,13444673823,4,2652,1360,-30
13449019933,13449019939,6,3598,1429,-30
13450648648,13450648654,6,12820,6829,-30
13450698221,13450698225,4,1721,1166,-30
13454763194,13454763197,3,1222,1098,-30
13461237977,13461237983,6,4022,3023,-30
13463464950,13463464957,7,3401,1929,-30
13465988159,13465988163,4,2252,1279,-30
13467730926,13467730931,5,1484,411,-30
13468208418,13468208421,3,1645,1159,-30
13469759631,13469759635,4,2163,1544,-30
13471780721,13471780724,3,894,966,-30
13472557983,13472557964,-19,932,439,-30
13473742298,13473742305,7,1794,1151,-30
13477441166,13477441171,5,1887,1755,-30
13480083057,13480083065,8,2161,1883,-30
13482659154,13482659152,-2,8872,16078,-30
13482826380,13482826383,3,2469,1259,-30
13483409589,13483409586,-3,4088,8169,-30
13484072753,13484072759,6,2482,1447,-30
13485944757,13485944762,5,2899,1675,-30
13487083016,13487083019,3,1494,1302,-30
13488004113,13488004112,-1,607,249,-30
13489176226,13489176229,3,1504,1156,-30
13491015190,13491015194,4,1911,1369,-30
13493448945,13493448950,5,2234,1433,-30
13496703718,13496703724,6,2096,1889,-30
13502772098,13502772098,0,4172,6784,-30
13507144272,13507144278,6,2212,1488,-30
13509237529,13509237534,5,2209,1276,-30
13510752786,13510752789,3,1962,1508,-30
13512883845,13512883849,4,2026,1350,-30
13520508229,13520508234,5,2081,1778,-30
13522100828,13522100832,4,2482,1610,-30
13523226950,13523226955,5,2938,1067,-30
13527159679,13527159684,5,1542,1021,-30
13530343348,13530343352,4,1985,850,-30
13531075868,13531075873,5,2772,1176,-30
13534479734,13534479741,7,4125,1240,-30
13539271463,13539271466,3,2631,1331,-30
13541310310,13541310312,2,1415,1728,-30
13546658466,13546658470,4,2195,1153,-30
13547705894,13547705875,-19,2928,1068,-30
13551202592,13551202597,5,2773,1509,-30
13551391085,13551391064,-21,1574,1039,-30
13552684712,13552684718,6,2440,908,-30
13553976964,13553976948,-16,1911,1056,-30
13564564920,13564564928,8,2493,1259,-30
13565911607,13565911612,5,3352,1500,-30
13567422278,13567422282,4,2370,1310,-30
13567841018,13567841023,5,2186,1475,-30
13569860994,13569860999,5,2620,1544,-30
13572188737,13572188742,5,2262,1100,-30
13573851427,13573851434,7,1806,1216,-30
13581218657,13581218662,5,2189,1290,-30
13581784890,13581784896,6,2506,1046,-30
13583954718,13583954721,3,2488,1517,-30
13586128259,13586128265,6,9074,3996,-30
13586815429,13586815433,4,2122,1397,-30
13589871157,13589871146,-11,43233,17737,-30
13589909980,13589909984,4,1989,1370,-30
13590066672,13590066675,3,2698,1554,-30
13591139623,13591139628,5,3028,1331,-30
13591940678,13591940682,4,2133,1165,-30
13592056030,13592056035,5,1991,1335,-30
13595345292,13595345296,4,1510,1036,-30
13596692653,13596692634,-19,1909,1391,-30
13603289755,13603289758,3,1893,995,-30
13604566089,13604566102,13,13858,49552,-30
13618206695,13618206703,8,3072,1292,-30
13619914150,13619914154,4,2154,1234,-30
13620577144,13620577153,9,1730,1338,-30
13622405470,13622405474,4,2376,1326,-30
13625068614,13625068615,1,1766,1868,-30
13629905803,13629905798,-5,1530,3055,-30
13630995593,13630995599,6,5697,2380,-30
13635230955,13635230960,5,3032,1122,-30
13636404605,13636404612,7,2902,1555,-30
13642083249,13642083254,5,3342,1331,-30
13645335935,13645335939,4,2363,1421,-30
13647156554,13647156559,5,1761,1111,-30
13651476745,13651476752,7,2108,1165,-30
13657291945,13657291948,3,2046,1167,-30
13660338549,13660338553,4,2039,1287,-30
13664653898,13664653902,4,1650,1052,-30
13668102153,13668102154,1,1795,1939,-30
13668317739,13668317742,3,2377,1286,-30
13671298170,13671298174,4,2065,1315,-30
13678367889,13678367894,5,1919,1241,-30
13679761332,13679761338,6,2053,1505,-30
13681323438,13681323442,4,2255,1497,-30
13688424147,13688424141,-6,25007,10300,-30
13689477415,13689477419,4,1905,1130,-30
13690444795,13690444798,3,1310,1696,-30
13692478453,13692478458,5,2745,1470,-30
13692929244,13692929249,5,2274,1331,-30
13693580909,13693580914,5,2105,1329,-30
13700406629,13700406631,2,1877,1773,-30
13702316397,13702316402,5,2706,1221,-30
13707754477,13707754483,6,2347,1473,-30
13711113755,13711113759,4,2545,1628,-30
13711571173,13711571178,5,2975,1551,-30
13714441187,13714441191,4,1798,962,-30
13717462876,13717462883,7,2270,1216,-30
13720617204,13720617210,6,2015,1250,-30
13723901125,13723901130,5,2037,1271,-30
13729277921,13729277927,6,2475,1038,-30
13730699936,13730699943,7,20143,21718,-30
13731917724,13731917730,6,3608,1569,-30
13732394751,13732394757,6,2627,1262,-30
13732474398,13732474402,4,1585,1264,-30
13734478791,13734478795,4,2134,1129,-30
13736262824,13736262844,20,74,1432,-30
13736786469,13736786448,-21,2105,1064,-30
13737326044,13737326047,3,2046,1032,-30
13745380406,13745380410,4,2322,1176,-30
13747123525,13747123532,7,2531,1231,-30
13749376406,13749376410,4,2702,1677,-30
13749583633,13749583638,5,1583,922,-30
13750604715,13750604721,6,2278,1463,-30
13760897192,13760897197,5,2708,1425,-30
13768625220,13768625227,7,1596,940,-30
13769106797,13769106802,5,2116,1489,-30
13775612370,13775612377,7,2298,1484,-30
13779612234,13779612237,3,1705,1016,-30
13779980805,13779980805,0,2561,3494,-30
13781779947,13781779951,4,1912,1176,-30
13784272201,13784272202,1,1512,1517,-30
13784476619,13784476625,6,2321,1877,-30
13786688771,13786688777,6,1995,1203,-30
13788330291,13788330296,5,2074,1232,-30
13789384450,13789384454,4,2512,1247,-30
13793068655,13793068658,3,1985,1372,-30
13793115442,13793115447,5,3155,2117,-30
13794326263,13794326258,-5,1304,4589,-30
13800018158,13800018167,9,1750,924,-30
13800190467,13800190472,5,1305,1597,-30
13803387825,13803387831,6,1538,943,-30
13807736406,13807736414,8,1158,1237,-30
13810523835,13810523841,6,2352,1243,-30
13814769434,13814769439,5,2592,1302,-30
13814948228,13814948212,-16,2410,1071,-30
13816430107,13816430090,-17,715,549,-30
13820658545,13820658554,9,2623,1581,-30
13823733437,13823733443,6,2161,910,-30
13825934391,13825934397,6,2667,1307,-30
13826284153,13826284134,-19,1930,1257,-30
13829926721,13829926726,5,2680,1250,-30
13832393422,13832393427,5,2709,1187,-30
13835274814,13835274820,6,1769,1030,-30
13837929169,13837929173,4,2639,1542,-30
13838266042,13838266049,7,3504,1548,-30
13841526913,13841526919,6,2587,2048,-30
13845388211,13845388197,-14,1667,1192,-30
13846131862,13846131869,7,2180,1102,-30
13851780998,13851781003,5,2142,1187,-30
13851961920,13851961939,19,2796,1312,-30
13852044289,13852044295,6,1917,706,-30
13853615145,13853615150,5,1761,1300,-30
13859412806,13859412812,6,2232,1168,-30
13861183287,13861183291,4,1698,990,-30
13862888862,13862888866,4,1782,894,-30
13869957766,13869957771,5,2293,1378,-30
13871470774,13871470780,6,2614,1378,-30
13877181356,13877181361,5,2486,1057,-30
13877221338,13877221323,-15,1878,1496,-30
13877826962,13877826970,8,1689,825,-30
13880107981,13880107983,2,1468,1259,-30
13880409326,13880409329,3,719,1565,-30
13896292050,13896292054,4,1654,1562,-30
13896336446,13896336428,-18,1463,762,-30
13899359549,13899359554,5,2322,1745,-30
13900117155,13900117161,6,1664,1021,-30
13900691821,13900691840,19,1422,975,-30
13901462961,13901462966,5,1762,1064,-30
13916768155,13916768149,-6,1252,4183,-30
13923816054,13923816054,0,1025,1536,-30
13929395975,13929395981,6,2625,1783,-30
13930744007,13930744012,5,2204,1328,-30
13936125760,13936125763,3,2596,1495,-30
13936852913,13936852917,4,1862,1479,-30
13939161666,13939161671,5,1963,1477,-30
13939663919,13939663922,3,2612,1757,-30
13940051107,13940051113,6,2580,1326,-30
13940081665,13940081675,10,3838,1618,-30
13945236149,13945236154,5,2604,1376,-30
13945277664,13945277651,-13,2157,1387,-30
13947667610,13947667611,1,2133,1633,-30
13948528183,13948528182,-1,2024,4413,-30
13949278134,13949278140,6,2091,1339,-30
13949348505,13949348510,5,1957,1310,-30
13953152866,13953152873,7,1634,1203,-30
13955114667,13955114671,4,1164,899,-30
13958650120,13958650122,2,1759,1264,-30
13963174545,13963174549,4,2045,1190,-30
13968466110,13968466113,3,1233,1193,-30
13972957698,13972957703,5,1452,1523,-30
13973964090,13973964094,4,2987,1591,-30
13996066790,13996066794,4,1689,1467,-30
13997722314,13997722321,7,2060,1448,-30
13998313309,13998313305,-4,808,2180,-30
13998674026,13998674029,3,1839,1239,-30
13999645886,13999645904,18,1505,1144,-30
14000221147,14000221163,16,705,435,-30
14004622229,14004622234,5,1957,1561,-30
14005079099,14005079102,3,3586,1575,-30
14005559991,14005559994,3,3170,2884,-30
14005610722,14005610727,5,2510,974,-30
14009115012,14009115018,6,2190,1253,-30
14012856246,14012856251,5,2520,1558,-30
14013726942,14013726947,5,876,298,-30
14017905227,14017905231,4,1657,984,-30
14020220458,14020220465,7,2434,827,-30
14024962665,14024962670,5,2488,1254,-30
14027783802,14027783807,5,2310,1188,-30
14030121511,14030121518,7,2550,900,-30
14031287069,14031287074,5,3549,1985,-30
14034884760,14034884766,6,5317,2154,-30
14035063850,14035063856,6,2319,1268,-30
14037899353,14037899359,6,1885,915,-30
14038076445,14038076449,4,592,219,-30
14041168967,14041168972,5,1185,590,-30
14044466016,14044466019,3,1870,1138,-30
14044549918,14044549896,-22,2624,1008,-30
14045385105,14045385109,4,1750,1351,-30
14046690195,14046690188,-7,705,362,-30
14048743987,14048743993,6,1172,922,-30
14049341547,14049341548,1,1450,1423,-30
14055994662,14055994668,6,1855,981,-30
14056055959,14056055940,-19,1448,436,-30
14057322436,14057322438,2,1963,1541,-30
14058184176,14058184181,5,2424,1637,-30
14066230388,14066230395,7,3856,1668,-30
14067680229,14067680234,5,1657,1254,-30
14068040556,14068040563,7,2396,1323,-30
14071755981,14071755986,5,2017,1418,-30
14072966946,14072966950,4,2264,1573,-30
14075375411,14075375406,-5,785,2927,-30
14076540767,14076540771,4,1183,1030,-30
14085969840,14085969843,3,1851,1522,-30
14086030086,14086030107,21,766,256,-30
14090420350,14090420353,3,2218,1258,-30
14092165930,14092165934,4,2733,866,-30
14092804616,14092804621,5,2429,1170,-30
14096930690,14096930695,5,1217,1397,-30
14099045149,14099045155,6,3059,1708,-30
14099455002,14099455006,4,2581,1703,-30
14104370898,14104370905,7,2138,1747,-30
14111324894,14111324898,4,1590,935,-30
14112339338,14112339341,3,2037,1169,-30
14113254725,14113254730,5,1511,972,-30
14113329175,14113329152,-23,2512,1571,-30
14113632539,14113632543,4,2003,1451,-30
14114437586,14114437591,5,2498,1124,-30
14115388247,14115388250,3,877,1474,-30
14118606481,14118606485,4,2965,1151,-30
14121708234,14121708237,3,3154,1420,-30
14123527143,14123527146,3,2668,1386,-30
14123863599,14123863604,5,2834,2141,-30
14126162877,14126162881,4,1800,1118,-30
14127350923,14127350906,-17,1145,464,-30
14128266539,14128266545,6,2055,1213,-30
14128775294,14128775274,-20,766,560,-30
14130671069,14130671074,5,2243,1373,-30
14136083922,14136083926,4,1679,967,-30
14136883971,14136883975,4,1893,1308,-30
14137337308,14137337313,5,1832,1460,-30
14137709721,14137709710,-11,1059,1958,-30
14138118187,14138118191,4,2049,1534,-30
14141290063,14141290067,4,1471,935,-30
14143063913,14143063910,-3,1644,2906,-30
14143774471,14143774476,5,2128,1712,-30
14145943323,14145943328,5,2773,991,-30
14146247272,14146247291,19,2571,1589,-30
14148220613,14148220593,-20,1163,858,-30
14152647989,14152647993,4,1487,1412,-30
14153592730,14153592735,5,1489,759,-30
14155387817,14155387822,5,2660,1224,-30
14155420234,14155420231,-3,1407,2221,-30
14156905368,14156905370,2,1673,1726,-30
14163441396,14163441401,5,2231,1230,-30
14168284307,14168284302,-5,1225,2496,-30
14169561925,14169561931,6,1724,1810,-30
14171723184,14171723190,6,3857,1456,-30
14172881041,14172881046,5,2503,1596,-30
14180644335,14180644339,4,1648,878,-30
14188361231,14188361235,4,1279,1380,-30
14188605353,14188605358,5,2036,1449,-30
14189210153,14189210158,5,2708,1117,-30
14190624515,14190624521,6,2011,969,-30
14195095634,14195095641,7,6683,2345,-30
14198567677,14198567683,6,1651,937,-30
14199872418,14199872407,-11,1627,1368,-30
14205288550,14205288556,6,2401,1450,-30
14206638460,14206638465,5,2598,1644,-30
14207776955,14207776959,4,1432,1017,-30
14208376970,14208376976,6,3132,1465,-30
14209541971,14209541977,6,2317,1323,-30
14209839793,14209839798,5,2179,1253,-30
14210803990,14210803985,-5,981,4630,-30
14214161082,14214161089,7,2940,1210,-30
14216909485,14216909490,5,2703,983,-30
14221298082,14221298086,4,1962,1314,-30
14222023083,14222023087,4,2391,1336,-30
14225350481,14225350486,5,2559,843,-30
14225525531,14225525515,-16,2465,2018,-30
14229600216,14229600222,6,6817,2173,-30
14230873374,14230873378,4,1652,1932,-30
14231074225,14231074234,9,1129,678,-30
14231627324,14231627327,3,2459,1000,-30
14232819701,14232819707,6,1355,1048,-30
14235916025,14235916030,5,3140,1766,-30
14237073715,14237073722,7,1667,1167,-30
14239132553,14239132556,3,2521,1502,-30
14239602325,14239602329,4,2670,1520,-30
14240683886,14240683890,4,3061,1864,-30
14241681423,14241681427,4,2546,1322,-30
14242724959,14242724958,-1,1582,2531,-30
14244786245,14244786250,5,2775,1776,-30
14246059754,14246059758,4,1698,1354,-30
14246277193,14246277198,5,2331,1571,-30
14247200055,14247200059,4,1847,838,-30
14248403430,14248403435,5,2978,1408,-30
14248472403,14248472388,-15,1955,1248,-30
14250381018,14250381023,5,2652,1829,-30
14251588210,14251588216,6,2748,1188,-30
14255403501,14255403506,5,2270,1341,-30
14255745953,14255745957,4,2372,1521,-30
14256257704,14256257706,2,855,191,-30
14263643203,14263643209,6,2890,1346,-30
14263861891,14263861873,-18,1405,689,-30
14268107581,14268107586,5,2247,1156,-30
14274656593,14274656598,5,2450,988,-30
14275375371,14275375369,-2,1074,151,-30
14276741505,14276741510,5,2224,1258,-30
14277000867,14277000874,7,2893,1817,-30
14279131457,14279131462,5,2149,1223,-30
14279948987,14279948989,2,1620,1935,-30
14280998122,14280998127,5,925,850,-30
14281252447,14281252426,-21,1278,731,-30
14282201192,14282201196,4,1943,1558,-30
14282711104,14282711121,17,873,220,-30
14285932539,14285932545,6,2696,1178,-30
14290462997,14290463002,5,2264,1440,-30
14291275710,14291275717,7,1984,977,-30
14292022072,14292022076,4,2431,1768,-30
14292663542,14292663521,-21,1693,866,-30
14294421052,14294421055,3,1758,1449,-30
14297663625,14297663630,5,3134,1322,-30
14298772399,14298772405,6,2730,1269,-30
14304515743,14304515748,5,2798,1727,-30
14306464227,14306464232,5,2871,1631,-30
14306829352,14306829357,5,2400,1445,-30
14311580018,14311580022,4,2145,1262,-30
14312366445,14312366449,4,2213,1512,-30
14318588518,14318588524,6,2088,1408,-30
14323105911,14323105912,1,698,362,-30
14329132806,14329132811,5,1573,1009,-30
14330000578,14330000582,4,2110,849,-30
14330085485,14330085466,-19,1681,748,-30
14330874539,14330874545,6,2055,1174,-30
14336903241,14336903242,1,1417,1906,-30
14337319829,14337319834,5,1167,1044,-30
14339276018,14339276021,3,2927,3439,-30
14342757738,14342757745,7,2455,1169,-30
14344258073,14344258079,6,3379,1325,-30
14345159313,14345159318,5,2240,786,-30
14348050426,14348050430,4,2456,1207,-30
14348652358,14348652366,8,2589,1242,-30
14353616769,14353616774,5,2316,1361,-30
14355541574,14355541580,6,2195,1561,-30
14355714301,14355714304,3,2039,1629,-30
14357150163,14357150169,6,2401,1104,-30
14357670096,14357670082,-14,818,818,-30
14358511826,14358511831,5,1715,1287,-30
14360652290,14360652295,5,2085,1198,-30
14364503501,14364503506,5,2477,1175,-30
14365066633,14365066638,5,1962,1373,-30
14365197471,14365197457,-14,809,218,-30
14376862549,14376862553,4,2172,1323,-30
14377950923,14377950927,4,2108,1355,-30
14379547438,14379547440,2,1740,2181,-30
14384315358,14384315362,4,2917,1122,-30
14385512501,14385512505,4,3572,1799,-30
14385783154,14385783159,5,1456,1472,-30
14393917989,14393917993,4,3044,1431,-30
14396146830,14396146835,5,1224,441,-30
14396191992,14396191997,5,2268,1415,-30
14398919433,14398919447,14,17590,37523,-30
14399139061,14399139067,6,2334,1626,-30
14399724683,14399724688,5,2521,1777,-30
14403616450,14403616458,8,2704,1322,-30
14407584058,14407584066,8,3009,1376,-30
14408409337,14408409355,18,625,236,-30
14408965187,14408965195,8,2578,1460,-30
14412772654,14412772658,4,1495,1144,-30
14412864118,14412864122,4,2692,1233,-30
14412931087,14412931081,-6,21221,13326,-30
14415437301,14415437301,0,1483,1765,-30
14416181571,14416181575,4,2497,1304,-30
14419709066,14419709070,4,2050,1027,-30
14422697265,14422697270,5,1685,1326,-30
14431363512,14431363516,4,1892,1542,-30
14431825030,14431825032,2,22972,52453,-30
14432483879,14432483888,9,1827,1195,-30
14436530586,14436530594,8,2696,1252,-30
14437155356,14437155358,2,2152,1858,-30
14437582462,14437582468,6,2921,1435,-30
14440089617,14440089625,8,1931,1623,-30
14440201542,14440201545,3,2203,2835,-30
14441763937,14441763943,6,2180,1341,-30
14442282977,14442282978,1,1117,910,-30
14443220555,14443220561,6,3327,1327,-30
14443314872,14443314860,-12,4974,869,-30
14443363548,14443363554,6,2235,1054,-30
14451838709,14451838712,3,2719,1885,-30
14453601506,14453601510,4,1679,1247,-30
14454504142,14454504147,5,2379,1119,-30
14455588447,14455588452,5,2428,1271,-30
14455723769,14455723771,2,1554,1211,-30
14455940938,14455940945,7,2438,1667,-30
14455994164,14455994169,5,3195,1784,-30
14456554780,14456554785,5,2190,1511,-30
14457182051,14457182057,6,1780,870,-30
14458078215,14458078220,5,2452,1446,-30
14462477643,14462477649,6,2251,1445,-30
14463820722,14463820723,1,1750,1404,-30
14463947917,14463947922,5,1872,1157,-30
14469904291,14469904286,-5,1032,3291,-30
14470840082,14470840086,4,2429,1439,-30
14474101127,14474101132,5,2006,1459,-30
14476730445,14476730449,4,1947,1492,-30
14488542208,14488542201,-7,2256,9938,-30
14493929839,14493929844,5,2318,1646,-30
14495366827,14495366834,7,2076,940,-30
14501287043,14501287038,-5,1973,7572,-30
14504382706,14504382711,5,2047,1501,-30
14504795287,14504795291,4,738,140,-30
14511141441,14511141446,5,1891,1089,-30
14511992814,14511992819,5,2476,1004,-30
14516056949,14516056954,5,2137,1506,-30
14517038318,14517038326,8,4558,1622,-30
14517252741,14517252762,21,2404,1123,-30
14521642546,14521642546,0,1080,1179,-30
14522366919,14522366925,6,2333,1777,-30
14524795226,14524795231,5,2112,1442,-30
14526351639,14526351641,2,1947,1496,-30
14529026654,14529026660,6,2017,1253,-30
14532301850,14532301854,4,2795,1401,-30
14533408527,14533408533,6,1929,1328,-30
14535895897,14535895895,-2,1152,741,-30
14541313685,14541313690,5,1640,1136,-30
14542724003,14542724009,6,11653,27447,-30
14543009388,14543009393,5,3064,1844,-30
14546960734,14546960739,5,2148,1716,-30
14547856780,14547856785,5,2347,1408,-30
14548799174,14548799179,5,2662,1301,-30
14557271546,14557271541,-5,883,2243,-30
14557444887,14557444892,5,2156,1195,-30
14558611581,14558611582,1,1444,1318,-30
14560304003,14560304007,4,2094,1058,-30
14564177782,14564177785,3,1736,1100,-30
14566257454,14566257459,5,2066,1789,-30
14566913661,14566913642,-19,2534,1521,-30
14569418235,14569418239,4,1672,1127,-30
14570387988,14570387993,5,3777,1523,-30
14571861602,14571861609,7,3333,1953,-30
14573326489,14573326495,6,5060,1641,-30
14574293297,14574293302,5,1957,1240,-30
14577947549,14577947555,6,2148,1322,-30
14578102617,14578102621,4,1937,1988,-30
14586914977,14586914981,4,1576,1929,-30
14587864375,14587864381,6,2669,1547,-30
14588930193,14588930196,3,3220,1882,-30
14591713807,14591713813,6,2761,1580,-30
14591975737,14591975739,2,2558,1716,-30
14593825599,14593825603,4,2780,1519,-30
14594384149,14594384151,2,2250,1748,-30
14596056846,14596056845,-1,1774,1957,-30
14599319784,14599319789,5,2018,1555,-30
14599379978,14599379983,5,2726,1072,-30
14601606933,14601606938,5,1825,1309,-30
14603097554,14603097558,4,2145,1112,-30
14607027561,14607027566,5,1476,977,-30
14607800829,14607800834,5,1817,1096,-30
14612951719,14612951714,-5,21235,14723,-30
14619552794,14619552799,5,1892,1344,-30
14622097311,14622097317,6,2098,1259,-30
14622124045,14622124048,3,2255,1512,-30
14622479761,14622479754,-7,851,283,-30
14630395566,14630395571,5,2161,1346,-30
14635933571,14635933580,9,12765,28402,-30
14643434224,14643434229,5,1637,1015,-30
14646548898,14646548903,5,2535,1428,-30
14647934822,14647934829,7,3410,2003,-30
14649455688,14649455693,5,3063,1818,-30
14650168362,14650168367,5,1928,1022,-30
14653113962,14653113967,5,2867,1782,-30
14655970081,14655970085,4,1810,1545,-30
14657212881,14657212886,5,2169,1280,-30
14658162057,14658162062,5,2564,1162,-30
14658863679,14658863685,6,2051,1167,-30
14659689625,14659689630,5,2353,1200,-30
14663649764,14663649769,5,1874,1898,-30
14664861382,14664861360,-22,915,508,-30
14670828873,14670828877,4,2537,1403,-30
14676764194,14676764205,11,3170,1363,-30
14677755632,14677755638,6,2019,1477,-30
14682178762,14682178766,4,2187,1540,-30
14684127007,14684127009,2,1651,1512,-30
14684398947,14684398951,4,2770,1731,-30
14684616648,14684616653,5,2237,1448,-30
14685144049,14685144054,5,2318,1280,-30
14685182441,14685182435,-6,1088,4226,-30
14687246246,14687246250,4,2709,1577,-30
14687808830,14687808834,4,2168,1627,-30
14689038473,14689038476,3,2295,1555,-30
14694153408,14694153407,-1,1114,1272,-30
14696467711,14696467716,5,1911,1558,-30
14697058971,14697058974,3,2268,1320,-30
14698971762,14698971766,4,2327,1422,-30
14701072195,14701072199,4,1757,986,-30
14709482797,14709482803,6,2111,1282,-30
14712331958,14712331954,-4,23159,9550,-30
14715187257,14715187262,5,3083,2229,-30
14716034726,14716034730,4,2283,1647,-30
14716885863,14716885866,3,1878,1442,-30
14723140850,14723140854,4,1743,920,-30
14724997239,14724997246,7,1692,787,-30
14726170464,14726170468,4,2343,1279,-30
14727505437,14727505438,1,1949,1478,-30
14728014113,14728014118,5,2148,1285,-30
14731371795,14731371783,-12,8543,36231,-30
14736735634,14736735628,-6,813,1938,-30
14737058130,14737058132,2,2053,1557,-30
14737939215,14737939222,7,3181,1464,-30
14738274014,14738274019,5,2352,1457,-30
14738972331,14738972335,4,1627,1378,-30
14743289909,14743289913,4,1924,1515,-30
14744182145,14744182151,6,1867,1247,-30
14746360663,14746360669,6,1631,996,-30
14746400273,14746400288,15,697,153,-30
14747246161,14747246167,6,2278,1430,-30
14747523466,14747523471,5,1773,1258,-30
14751044455,14751044461,6,3193,1604,-30
14752894789,14752894794,5,1322,1246,-30
14754041469,14754041469,0,961,1027,-30
14756164614,14756164618,4,1744,1081,-30
14756968565,14756968546,-19,1091,612,-30
14758641596,14758641603,7,1274,996,-30
14761486426,14761486430,4,2695,1429,-30
14761992450,14761992454,4,2445,1482,-30
14766663636,14766663639,3,2452,1857,-30
14767218817,14767218821,4,2346,1592,-30
14768084833,14768084833,0,1462,1924,-30
14768837425,14768837430,5,2790,2102,-30
14770028854,14770028858,4,2224,1377,-30
14770676209,14770676214,5,2508,1448,-30
14770775278,14770775283,5,1796,1129,-30
14776201142,14776201154,12,914,169,-30
14776496246,14776496256,10,1787,1118,-30
14779844125,14779844125,0,1417,1784,-30
14780617133,14780617140,7,1727,1349,-30
14783186179,14783186185,6,2106,1668,-30
14793589836,14793589842,6,1834,1358,-30
14794716743,14794716747,4,2305,1508,-30
14800009366,14800009360,-6,1347,5415,-30
14800884927,14800884931,4,1583,1382,-30
14802112815,14802112820,5,2258,1382,-30
14807560341,14807560345,4,1899,1164,-30
14807744846,14807744833,-13,1415,561,-30
14812106426,14812106429,3,1911,1518,-30
14816455266,14816455271,5,2255,1662,-30
14816655216,14816655214,-2,1491,3514,-30
14817010287,14817010292,5,2680,2122,-30
14817195146,14817195152,6,1947,1457,-30
14820455623,14820455627,4,2806,1514,-30
14821206747,14821206751,4,2663,1276,-30
14822889046,14822889050,4,2352,1682,-30
14831569323,14831569327,4,2099,1081,-30
14832442662,14832442667,5,2496,1592,-30
14832487717,14832487719,2,1624,1569,-30
14838993827,14838993833,6,2881,1294,-30
14841235790,14841235795,5,2117,1427,-30
14844452218,14844452222,4,1725,1208,-30
14845587153,14845587157,4,1667,771,-30
14845992333,14845992344,11,2527,1560,-30
14846690502,14846690506,4,2758,1480,-30
14847586090,14847586094,4,1652,1274,-30
14847931686,14847931690,4,2140,1314,-30
14851087656,14851087665,9,505,2655,-30
14861225089,14861225095,6,2104,1503,-30
14862027566,14862027573,7,1486,781,-30
14862498032,14862498037,5,2496,1298,-30
14865057457,14865057462,5,2849,2123,-30
14867437967,14867437973,6,1438,1078,-30
14869326091,14869326096,5,2878,1706,-30
14869358683,14869358690,7,2393,991,-30
14870695468,14870695473,5,2207,1690,-30
14873384539,14873384549,10,3676,1161,-30
14876588854,14876588861,7,2513,1176,-30
14880632658,14880632661,3,1775,1599,-30
14883967290,14883967294,4,2607,1572,-30
14884194254,14884194258,4,1888,1132,-30
14884338461,14884338466,5,2241,1514,-30
14884868682,14884868696,14,717,187,-30
14885202456,14885202461,5,2650,1884,-30
14886699545,14886699548,3,2575,1067,-30
14888514301,14888514306,5,2032,1201,-30
14892644087,14892644094,7,2633,1757,-30
14893791511,14893791515,4,2132,1190,-30
14894570914,14894570915,1,33245,36083,-30
14897482578,14897482581,3,684,764,-30
14898319358,14898319337,-21,1257,1292,-30
14902819129,14902819134,5,1783,1535,-30
14909321174,14909321179,5,2313,1088,-30
14913330717,14913330722,5,1756,957,-30
14913407843,14913407848,5,2052,1509,-30
14913698459,14913698464,5,2263,755,-30
14914564220,14914564224,4,1997,1290,-30
14915928490,14915928494,4,1474,1219,-30
14916015032,14916015038,6,2658,1929,-30
14916577850,14916577856,6,2826,1638,-30
14924225823,14924225826,3,2451,1936,-30
14925423258,14925423263,5,2225,911,-30
14925846059,14925846063,4,2112,1287,-30
14926629400,14926629401,1,1906,1295,-30
14926912129,14926912144,15,1586,980,-30
14930448642,14930448649,7,2187,1138,-30
14941441422,14941441426,4,2647,1513,-30
14941629242,14941629247,5,1818,1150,-30
14944830100,14944830107,7,1535,1155,-30
14948405538,14948405542,4,2056,1022,-30
14952658837,14952658842,5,1192,588,-30
14954621554,14954621558,4,2034,976,-30
14956524817,14956524821,4,2817,1833,-30
14960070983,14960070981,-2,1107,1952,-30
14962279297,14962279302,5,1261,1705,-30
14963145341,14963145347,6,1978,932,-30
14965300367,14965300373,6,1495,1034,-30
14973269478,14973269478,0,6249,6656,-30
14978493901,14978493906,5,2754,1498,-30
14978622143,14978622150,7,1526,1242,-30
14981964205,14981964210,5,2528,1538,-30
14985811584,14985811588,4,2211,1143,-30
14985896142,14985896147,5,1382,1204,-30
14993307563,14993307567,4,1832,1273,-30
14996793981,14996793987,6,1623,1063,-30
14998670639,14998670643,4,2117,1488,-30
14999415478,14999415483,5,2198,1148,-30
15000425088,15000425093,5,1960,1033,-30
15001100738,15001100744,6,2787,1127,-30
15002264846,15002264851,5,2457,1167,-30
15002465169,15002465172,3,1563,1371,-30
15005158925,15005158906,-19,1919,769,-30
15011252471,15011252479,8,2151,1221,-30
15011802742,15011802747,5,2270,1455,-30
15012118193,15012118178,-15,1838,1436,-30
15015521435,15015521435,0,1369,1749,-30
15015841486,15015841491,5,2676,1320,-30
15016800767,15016800775,8,2854,1437,-30
15017324323,15017324330,7,2236,1514,-30
15020828567,15020828573,6,3221,1222,-30
15022064081,15022064087,6,2079,1213,-30
15022292978,15022292979,1,1687,1299,-30
15022705268,15022705273,5,2219,1185,-30
15024796343,15024796349,6,2249,1436,-30
15028543402,15028543406,4,2508,1563,-30
15029857437,15029857441,4,2791,1634,-30
15032892378,15032892382,4,2047,1288,-30
15034528286,15034528294,8,40566,15931,-30
15035591158,15035591165,7,1629,1230,-30
15043918227,15043918232,5,1771,1407,-30
15046746273,15046746278,5,1639,1231,-30
15057340458,15057340463,5,1426,984,-30
15062706802,15062706806,4,1869,990,-30
15064977150,15064977154,4,1258,939,-30
15066654242,15066654249,7,2683,1332,-30
15072381162,15072381167,5,1276,812,-30
15074606523,15074606524,1,1746,1873,-30
15079560554,15079560561,7,2072,959,-30
15079853018,15079853001,-17,2453,1261,-30
15081099441,15081099441,0,2376,3284,-30
15084717841,15084717847,6,2315,1184,-30
15089139303,15089139309,6,2258,1349,-30
15090398931,15090398935,4,2507,2017,-30
15091708990,15091708998,8,1955,1211,-30
15093101655,15093101659,4,1786,981,-30
15097379747,15097379751,4,2475,1347,-30
15104395136,15104395141,5,2321,1587,-30
15110085758,15110085763,5,1495,1525,-30
15110179919,15110179915,-4,859,1344,-30
15112963169,15112963164,-5,24305,13129,-30
15114409822,15114409826,4,1749,1194,-30
15114594865,15114594871,6,2148,1147,-30
15116056576,15116056581,5,1636,764,-30
15118079354,15118079359,5,2295,904,-30
15122606463,15122606459,-4,1225,2535,-30
15124406890,15124406896,6,2678,1459,-30
15126081071,15126081066,-5,725,2339,-30
15127543461,15127543462,1,1598,1800,-30
15129276548,15129276553,5,1751,1162,-30
15140655371,15140655373,2,1757,1565,-30
15141291067,15141291067,0,1510,1373,-30
15142406246,15142406251,5,2478,919,-30
15148045150,15148045153,3,2248,2048,-30
15151793447,15151793450,3,1901,1512,-30
15153769386,15153769392,6,1998,1162,-30
15153998650,15153998664,14,509,326,-30
15155501163,15155501165,2,2415,1769,-30
15158523567,15158523570,3,1091,826,-30
15158714929,15158714934,5,2978,1468,-30
15162457886,15162457890,4,1973,1089,-30
15163003398,15163003402,4,2048,1476,-30
15165467917,15165467921,4,2942,1393,-30
15169254954,15169254954,0,2330,2252,-30
15170369280,15170369285,5,2706,1648,-30
15172873870,15172873875,5,2198,1360,-30
15174331705,15174331712,7,4120,1201,-30
15175865362,15175865368,6,2118,1266,-30
15178603554,15178603560,6,2703,1478,-30
15184517632,15184517636,4,2220,1405,-30
15186078257,15186078262,5,3140,1574,-30
15191019173,15191019179,6,2274,1584,-30
15191108392,15191108395,3,2298,1261,-30
15192180842,15192180846,4,1257,1021,-30
15193115870,15193115876,6,2123,1199,-30
15193463929,15193463946,17,2843,1291,-30
15202172781,15202172788,7,2294,1510,-30
15202510586,15202510591,5,1347,982,-30
15204248358,15204248359,1,1385,2021,-30
15207516281,15207516287,6,2330,1070,-30
15208464106,15208464110,4,1901,1363,-30
15208803441,15208803442,1,1393,1263,-30
15209659332,15209659336,4,2246,1716,-30
15212713501,15212713505,4,1392,825,-30
15216619033,15216619036,3,3209,1629,-30
15217586246,15217586253,7,1824,1179,-30
15217911845,15217911850,5,2767,1131,-30
15218882948,15218882953,5,1887,1619,-30
15222149089,15222149095,6,1658,1072,-30
15224998215,15224998221,6,2688,1104,-30
15225351240,15225351246,6,1599,708,-30
15233680961,15233680966,5,2640,1392,-30
15234576826,15234576811,-15,1367,693,-30
15236144772,15236144777,5,2628,2085,-30
15236311486,15236311490,4,3079,1708,-30
15238338807,15238338813,6,2516,1713,-30
15241922260,15241922265,5,1867,1320,-30
15245491338,15245491343,5,2587,1383,-30
15249946210,15249946215,5,1761,1140,-30
15250173365,15250173365,0,1505,2027,-30
15250828258,15250828263,5,1403,976,-30
15250994374,15250994373,-1,952,2360,-30
15260224018,15260224025,7,1440,1055,-30
15262997962,15262997967,5,2046,1106,-30
15264366894,15264366899,5,1027,1285,-30
15266213194,15266213199,5,3554,1265,-30
15267694325,15267694329,4,2330,1209,-30
15273235995,15273236001,6,1479,925,-30
15274197954,15274197960,6,3236,1795,-30
15276807391,15276807398,7,2718,1764,-30
15277466186,15277466190,4,1803,1306,-30
15278375538,15278375524,-14,1820,670,-30
15278951312,15278951318,6,1804,1037,-30
15284117027,15284117034,7,2706,1250,-30
15289244902,15289244907,5,2637,1699,-30
15292992825,15292992830,5,2374,1426,-30
15293620097,15293620105,8,1874,880,-30
15297180780,15297180776,-4,1449,2366,-30
15299789459,15299789467,8,1667,1184,-30
15300656713,15300656719,6,3099,1218,-30
15304001572,15304001576,4,2116,927,-30
15305100959,15305100965,6,1582,1076,-30
15305131379,15305131386,7,2775,1016,-30
15308307189,15308307193,4,1474,1180,-30
15310204392,15310204396,4,2807,1716,-30
15310459551,15310459539,-12,1600,605,-30
15314467053,15314467058,5,3197,1655,-30
15315782634,15315782641,7,2187,1457,-30
15316708718,15316708722,4,2293,1634,-30
15325757297,15325757302,5,2023,1427,-30
15326395710,15326395714,4,2908,1603,-30
15331187148,15331187154,6,1845,1324,-30
15333936573,15333936577,4,2095,1689,-30
15334515146,15334515151,5,1415,579,-30
15335018899,15335018883,-16,2326,1536,-30
15337875993,15337875998,5,1126,870,-30
15341285192,15341285195,3,2213,1723,-30
15348226695,15348226702,7,2034,1178,-30
15348278034,15348278039,5,2187,1204,-30
15354148422,15354148427,5,2319,1322,-30
15356996674,15356996678,4,1982,1472,-30
15358316114,15358316118,4,1769,1406,-30
15363607926,15363607926,0,1486,1559,-30
15366393210,15366393209,-1,1422,1328,-30
15367406688,15367406682,-6,918,413,-30
15375237867,15375237865,-2,1420,2108,-30
15378494121,15378494126,5,3429,1340,-30
15380439161,15380439168,7,3611,1413,-30
15381509273,15381509257,-16,2834,1221,-30
15382359784,15382359793,9,3409,1577,-30
15383702847,15383702851,4,2152,1223,-30
15390418305,15390418309,4,2445,1645,-30
15391034489,15391034494,5,2234,1645,-30
15393062226,15393062229,3,1421,1026,-30
15394181618,15394181625,7,2633,1132,-30
15394812891,15394812895,4,1146,1072,-30
15396072626,15396072633,7,3072,1539,-30
15398392884,15398392888,4,2592,1547,-30
15401790727,15401790731,4,1629,980,-30
15403198698,15403198703,5,1377,770,-30
15407253215,15407253219,4,2442,1654,-30
15409025833,15409025834,1,1382,1518,-30
15409230110,15409230115,5,2228,1233,-30
15414780434,15414780436,2,2159,2692,-30
15415896270,15415896274,4,1880,977,-30
15417786365,15417786370,5,1867,1870,-30
15420578343,15420578349,6,2060,1252,-30
15421109622,15421109625,3,4853,3372,-30
15423945395,15423945399,4,2496,1297,-30
15424005068,15424005081,13,807,153,-30
15426866877,15426866882,5,1828,1446,-30
15427636658,15427636662,4,3017,1412,-30
15427706727,15427706733,6,1790,1516,-30
15430355681,15430355687,6,2458,1675,-30
15431119805,15431119810,5,2679,1670,-30
15431415222,15431415224,2,566,196,-30
15434692983,15434692987,4,2112,1289,-30
15434783410,15434783414,4,1543,1136,-30
15434812584,15434812589,5,2873,1286,-30
15436468706,15436468712,6,2232,1232,-30
15436681061,15436681041,-20,1578,1094,-30
15441453801,15441453808,7,7664,41037,-30
15441620614,15441620621,7,2132,941,-30
15444010787,15444010792,5,1520,857,-30
15459222146,15459222151,5,2356,1089,-30
15467811581,15467811585,4,2649,1431,-30
15468955606,15468955596,-10,1180,253,-30
15480778225,15480778227,2,2599,988,-30
15481912471,15481912474,3,2528,1520,-30
15484156354,15484156360,6,1733,1089,-30
15488800177,15488800183,6,2893,1618,-30
15492164470,15492164473,3,1666,1197,-30
15496311837,15496311843,6,62106,27119,-30
15498400422,15498400426,4,2089,1035,-30
15502421864,15502421870,6,7246,2439,-30
15503659222,15503659227,5,2935,1625,-30
15504203533,15504203531,-2,1257,1937,-30
15504802650,15504802654,4,2573,1480,-30
15505304607,15505304611,4,2530,1434,-30
15515447174,15515447179,5,1521,773,-30
15517081402,15517081397,-5,1052,2214,-30
15517642031,15517642034,3,2148,1424,-30
15520907852,15520907857,5,2195,1433,-30
15523225566,15523225571,5,2536,1341,-30
15529754380,15529754385,5,2147,1392,-30
15533208781,15533208786,5,2764,1399,-30
15534909833,15534909838,5,2118,1270,-30
15538010193,15538010198,5,2319,1419,-30
15540245246,15540245250,4,2091,1094,-30
15540796145,15540796145,0,1223,1695,-30
15541373775,15541373781,6,3130,1450,-30
15542138242,15542138246,4,1686,1219,-30
15546045910,15546045911,1,12494,11433,-30
15546761913,15546761922,9,3505,1314,-30
15552039050,15552039054,4,3428,1371,-30
15552210177,15552210182,5,1762,861,-30
15552845969,15552845976,7,1673,1116,-30
15554954484,15554954490,6,3180,1712,-30
15555608189,15555608196,7,3114,1579,-30
15555707690,15555707697,7,1707,1707,-30
15556371703,15556371683,-20,2420,1243,-30
15558115963,15558115967,4,2118,948,-30
15558244132,15558244147,15,2461,1110,-30
15565566395,15565566401,6,2280,1420,-30
15565720223,15565720227,4,2251,1052,-30
15571680869,15571680876,7,3589,1959,-30
15571707111,15571707114,3,1785,1326,-30
15576521710,15576521716,6,11169,4349,-30
15576655397,15576655403,6,2230,1310,-30
15581412066,15581412065,-1,1453,1687,-30
15589933567,15589933571,4,2464,1792,-30
15590335578,15590335596,18,5376,12992,-30
15593496968,15593496974,6,3700,1824,-30
15593947529,15593947536,7,2444,1672,-30
15598483514,15598483520,6,2739,1272,-30
15599642806,15599642811,5,3131,1606,-30
15600031004,15600031010,6,1937,1153,-30
15606492121,15606492118,-3,923,1411,-30
15608283455,15608283460,5,2804,2254,-30
15613744547,15613744545,-2,1081,1635,-30
15615143217,15615143220,3,2045,1666,-30
15616587197,15616587202,5,2562,1270,-30
15625625610,15625625615,5,1940,1198,-30
15633295796,15633295793,-3,18071,11977,-30
15641611174,15641611179,5,2571,1278,-30
15642003379,15642003383,4,1610,1233,-30
15647622460,15647622463,3,1697,1594,-30
15657041591,15657041595,4,2520,1249,-30
15657727990,15657727971,-19,2104,1318,-30
15657892867,15657892872,5,2831,1398,-30
15659499299,15659499303,4,1415,856,-30
15662056132,15662056136,4,1930,1661,-30
15665004234,15665004238,4,2727,1564,-30
15675509028,15675509030,2,7297,7126,-30
15677358927,15677358930,3,2581,1668,-30
15677514478,15677514483,5,2444,1052,-30
15684752890,15684752894,4,2137,1091,-30
15685361755,15685361760,5,3470,1246,-30
15686821249,15686821252,3,2185,1509,-30
15689099219,15689099225,6,1795,844,-30
15697304281,15697304286,5,2227,1414,-30
15702156558,15702156563,5,2460,1550,-30
15702404613,15702404613,0,3286,4335,-30
15709214282,15709214287,5,2059,1542,-30
15709975038,15709975043,5,2333,1193,-30
15711383389,15711383395,6,1749,999,-30
15711798858,15711798861,3,3191,1445,-30
15712139894,15712139900,6,2181,1171,-30
15713493639,15713493644,5,2313,1027,-30
15717421945,15717421946,1,1568,1343,-30
15719340318,15719340321,3,20348,18330,-30
15731052686,15731052690,4,2228,1044,-30
15733440463,15733440471,8,2850,1558,-30
15735879699,15735879703,4,2102,718,-30
15737559701,15737559706,5,2205,1652,-30
15738737570,15738737570,0,1406,1468,-30
15741782802,15741782807,5,2231,1012,-30
15743713795,15743713798,3,2358,1723,-30
15744320183,15744320189,6,3705,2049,-30
15748062093,15748062098,5,2137,993,-30
15748497698,15748497701,3,1866,1007,-30
15750588290,15750588294,4,2188,1143,-30
15750698130,15750698139,9,2208,1075,-30
15750856053,15750856034,-19,1889,1033,-30
15758341440,15758341445,5,2567,1292,-30
15764657554,15764657554,0,839,1367,-30
15765510945,15765510950,5,1518,1153,-30
15769488922,15769488927,5,2377,1223,-30
15773527761,15773527767,6,2200,1073,-30
15773740745,15773740760,15,601,312,-30
15774059970,15774059976,6,2835,1241,-30
15776808283,15776808287,4,1700,1102,-30
15779103911,15779103915,4,2368,1425,-30
15779716463,15779716470,7,3890,2170,-30
15779789766,15779789770,4,2213,1325,-30
15781867949,15781867954,5,1733,1375,-30
15782728230,15782728234,4,2065,1253,-30
15783477074,15783477070,-4,1406,3019,-30
15785447262,15785447269,7,1409,1167,-30
15792296896,15792296900,4,3195,1278,-30
15793431958,15793431960,2,2131,881,-30
15795572554,15795572558,4,1209,947,-30
15798108495,15798108500,5,2571,1697,-30
15801187551,15801187555,4,1543,1154,-30
15813640378,15813640385,7,2345,1255,-30
15821819476,15821819480,4,1812,1656,-30
15823906222,15823906223,1,1465,1764,-30
15825487919,15825487914,-5,57601,33078,-30
15828698271,15828698278,7,2225,1072,-30
15832000298,15832000302,4,1404,877,-30
15833512974,15833512980,6,5840,2724,-30
15840544805,15840544810,5,2573,1146,-30
15841405831,15841405835,4,1591,926,-30
15842163832,15842163837,5,2736,1802,-30
15843496846,15843496851,5,1440,990,-30
15850578576,15850578576,0,1507,1582,-30
15853226663,15853226669,6,2599,1976,-30
15854460758,15854460763,5,2182,1412,-30
15854945867,15854945873,6,2869,1517,-30
15855691886,15855691867,-19,2677,1397,-30
15859003474,15859003474,0,1103,1591,-30
15867008365,15867008371,6,2397,1176,-30
15880031185,15880031190,5,2536,1993,-30
15883750565,15883750569,4,1774,1209,-30
15885173500,15885173506,6,3261,1343,-30
15886561395,15886561402,7,1578,984,-30
15900990465,15900990470,5,2810,1405,-30
15902769141,15902769138,-3,828,1508,-30
15908033982,15908033986,4,2403,1380,-30
15908527259,15908527265,6,2561,1452,-30
15911214878,15911214881,3,1493,1205,-30
15917121593,15917121579,-14,1461,1138,-30
15918672550,15918672554,4,2402,1171,-30
15920033408,15920033410,2,1704,1590,-30
15920511986,15920511991,5,2216,1351,-30
15924776685,15924776690,5,2284,1484,-30
15924966238,15924966245,7,3129,1347,-30
15929130810,15929130813,3,2105,1902,-30
15934052204,15934052207,3,2820,1911,-30
15940478994,15940479000,6,2273,1255,-30
15950119350,15950119357,7,2961,1396,-30
15950369116,15950369122,6,3263,1332,-30
15951665554,15951665562,8,3496,1142,-30
15955049432,15955049416,-16,46151,14474,-30
15956865442,15956865446,4,2292,1183,-30
15961228006,15961228010,4,2450,1798,-30
15962041850,15962041855,5,2317,1087,-30
15963367589,15963367595,6,1360,1365,-30
15965452354,15965452358,4,2771,1488,-30
15973564573,15973564579,6,2848,1900,-30
15975974126,15975974130,4,1843,1044,-30
15976081923,15976081928,5,2908,1625,-30
15976908621,15976908627,6,2144,946,-30
15979770443,15979770448,5,2839,1389,-30
15982611190,15982611195,5,2820,1514,-30
15986826153,15986826157,4,1534,1105,-30
15987348530,15987348523,-7,1349,4867,-30
15993601284,15993601290,6,1433,1274,-30
15999831858,15999831865,7,3216,1139,-30
16000032738,16000032722,-16,1920,1314,-30
16002624588,16002624593,5,1806,1608,-30
16006354722,16006354727,5,2420,893,-30
16006954762,16006954767,5,2804,1099,-30
16007503037,16007503037,0,4099,1819,-30
16007761169,16007761175,6,2040,1354,-30
16010089263,16010089266,3,2885,1734,-30
16011168082,16011168087,5,1913,1365,-30
16011777718,16011777726,8,2124,1467,-30
16015585244,16015585248,4,3307,1456,-30
16016865993,16016865998,5,1885,1122,-30
16021104991,16021104996,5,1604,1139,-30
16027213058,16027213065,7,2066,1154,-30
16029545129,16029545127,-2,5434,8048,-30
16030423138,16030423142,4,2011,1324,-30
16030858678,16030858682,4,2374,2007,-30
16036773064,16036773046,-18,1871,1532,-30
16037207932,16037207938,6,3017,1584,-30
16038253355,16038253355,0,1447,1312,-30
16040561784,16040561789,5,1728,1406,-30
16041780956,16041780961,5,2409,1289,-30
16042411670,16042411675,5,1387,968,-30
16045192841,16045192846,5,1881,936,-30
16048111098,16048111090,-8,1370,925,-30
16051800058,16051800061,3,2748,1389,-30
16052424933,16052424938,5,1098,740,-30
16056638641,16056638647,6,2879,1377,-30
16057821889,16057821895,6,2294,1594,-30
16062716366,16062716371,5,2077,1033,-30
16064131573,16064131578,5,3303,1099,-30
16075912969,16075912974,5,2097,1166,-30
16077921086,16077921086,0,1508,1223,-30
16080881223,16080881229,6,2353,1227,-30
16081802357,16081802362,5,2558,1721,-30
16081892762,16081892769,7,2601,1492,-30
16091616322,16091616327,5,2466,1010,-30
16092268576,16092268571,-5,1352,4374,-30
16093628675,16093628674,-1,953,2584,-30
16094160867,16094160871,4,1870,1101,-30
16094211348,16094211350,2,1135,1562,-30
16104884114,16104884127,13,1751,1040,-30
16107194882,16107194886,4,2042,1420,-30
16109933121,16109933127,6,1628,822,-30
16119013990,16119013995,5,2329,1036,-30
16122526211,16122526214,3,1943,795,-30
16124671963,16124671967,4,2403,1610,-30
16124893604,16124893611,7,2194,1843,-30
16125616308,16125616314,6,12081,23886,-30
16126877538,16126877542,4,1458,1018,-30
16126945921,16126945926,5,2566,1333,-30
16128284609,16128284596,-13,1950,1103,-30
16129947700,16129947705,5,2150,1146,-30
16130055199,16130055205,6,2567,1860,-30
16134495556,16134495562,6,2338,1647,-30
16136574627,16136574631,4,2336,998,-30
16137452877,16137452859,-18,4042,878,-30
16141878010,16141878015,5,926,1027,-30
16143887485,16143887493,8,15360,31755,-30
16143930554,16143930558,4,2042,1334,-30
16146947272,16146947277,5,3661,1294,-30
16147777105,16147777110,5,3010,1155,-30
16150112090,16150112094,4,869,392,-30
16152865695,16152865675,-20,1259,847,-30
16153785579,16153785561,-18,1113,724,-30
16155085819,16155085825,6,2324,1435,-30
16160541096,16160541101,5,2321,1220,-30
16170904746,16170904751,5,2345,1497,-30
16175558956,16175558962,6,2116,1203,-30
16180536967,16180536971,4,1570,1427,-30
16181751393,16181751398,5,2750,1590,-30
16184785527,16184785532,5,2265,1243,-30
16186300613,16186300618,5,1649,1095,-30
16187030602,16187030606,4,2064,1246,-30
16193899518,16193899523,5,1940,1348,-30
16196811438,16196811444,6,1805,1212,-30
16198895366,16198895370,4,1876,1036,-30
16199497082,16199497076,-6,1477,368,-30
16200043849,16200043851,2,2152,1259,-30
16200513814,16200513819,5,2976,1777,-30
16204926651,16204926658,7,3433,1435,-30
16208744136,16208744142,6,3348,1814,-30
16209958421,16209958426,5,1925,1071,-30
16213108802,16213108805,3,2262,1235,-30
16215281587,16215281590,3,1543,1023,-30
16215496762,16215496745,-17,5008,1885,-30
16217202355,16217202358,3,2253,1540,-30
16217834929,16217834934,5,1931,915,-30
16218146365,16218146371,6,2091,1057,-30
16220369314,16220369319,5,2217,1422,-30
16223846574,16223846582,8,2767,1202,-30
16225813626,16225813630,4,1917,1051,-30
16227016688,16227016694,6,2274,1227,-30
16227447515,16227447518,3,1932,932,-30
16227769011,16227769010,-1,1317,2098,-30
16229518592,16229518597,5,2126,1260,-30
16232158885,16232158887,2,1344,935,-30
16233168105,16233168111,6,2525,1251,-30
16233603651,16233603632,-19,2639,1424,-30
16234544903,16234544909,6,2260,1457,-30
16234917457,16234917462,5,2000,1041,-30
16235532648,16235532651,3,1589,1475,-30
16238108418,16238108425,7,3298,1709,-30
16238650917,16238650900,-17,2112,1190,-30
16240378653,16240378659,6,1488,935,-30
16242303575,16242303578,3,2140,1617,-30
16246636070,16246636075,5,3586,1645,-30
16249048471,16249048474,3,1483,1116,-30
16251527255,16251527261,6,2340,1570,-30
16257264575,16257264580,5,1721,1531,-30
16260051757,16260051761,4,2377,1694,-30
16260322254,16260322257,3,1506,1285,-30
16263590426,16263590422,-4,20812,14221,-30
16267304993,16267304998,5,2130,1845,-30
16267791106,16267791114,8,11907,21648,-30
16268917583,16268917579,-4,1423,2989,-30
16271819212,16271819217,5,2841,1341,-30
16276200404,16276200403,-1,20136,12456,-30
16279526717,16279526723,6,1636,995,-30
16282837251,16282837255,4,2843,1533,-30
16297509935,16297509939,4,2023,1264,-30
16302296254,16302296258,4,1788,1288,-30
16306285050,16306285056,6,2853,2011,-30
16307000537,16307000523,-14,2451,980,-30
16310330967,16310330970,3,1886,1569,-30
16310860011,16310860017,6,2716,1423,-30
16314190040,16314190030,-10,28852,16053,-30
16318019738,16318019742,4,2776,1671,-30
16326835350,16326835355,5,1855,889,-30
16329436289,16329436294,5,2149,1471,-30
16330473034,16330473041,7,2338,1509,-30
16337056691,16337056697,6,2284,1549,-30
16339678265,16339678271,6,2082,1190,-30
16340794765,16340794770,5,2887,1971,-30
16343643685,16343643690,5,1623,1366,-30
16347189955,16347189961,6,2479,1488,-30
16348292869,16348292873,4,3194,1403,-30
16351347111,16351347113,2,1996,1239,-30
16352107443,16352107457,14,438,54,-30
16356384998,16356385003,5,2258,1111,-30
16356439933,16356439938,5,1967,908,-30
16357943555,16357943560,5,3217,1521,-30
16362322995,16362323002,7,2713,1292,-30
16363948115,16363948119,4,1411,1131,-30
16366712251,16366712256,5,1989,1534,-30
16366915354,16366915359,5,8518,19190,-30
16369508357,16369508363,6,3377,1127,-30
16370103666,16370103670,4,2602,1684,-30
16371253018,16371253025,7,3445,1852,-30
16374331754,16374331759,5,1220,894,-30
16374830456,16374830451,-5,1034,277,-30
16379749810,16379749808,-2,18401,18626,-30
16384211050,16384211054,4,2080,1320,-30
16384465342,16384465347,5,2675,2006,-30
16390455017,16390454996,-21,811,124,-30
16392580491,16392580498,7,1539,1105,-30
16393799001,16393799006,5,3202,1944,-30
16396008806,16396008813,7,5248,2734,-30
16407723240,16407723244,4,2293,1450,-30
16409080665,16409080671,6,1967,1391,-30
16410291525,16410291520,-5,872,2822,-30
16410664414,16410664421,7,1577,1078,-30
16412555470,16412555474,4,1786,1590,-30
16414632981,16414632986,5,2443,1195,-30
16416790942,16416790952,10,2622,1516,-30
16419222006,16419222011,5,3066,1528,-30
16420787967,16420787968,1,1684,1898,-30
16422738239,16422738245,6,2847,1540,-30
16424545802,16424545806,4,1651,1134,-30
16427896473,16427896478,5,2771,1545,-30
16430832809,16430832814,5,1917,1308,-30
16435602677,16435602673,-4,1370,1724,-30
16445641061,16445641065,4,1717,1966,-30
16446011158,16446011161,3,2468,1227,-30
16450550606,16450550611,5,6437,3429,-30
16450693530,16450693535,5,3503,1808,-30
16450721335,16450721340,5,2232,1349,-30
16455801884,16455801880,-4,1876,1347,-30
16456993202,16456993208,6,2310,1195,-30
16458240913,16458240917,4,1762,1106,-30
16459353163,16459353168,5,2871,1647,-30
16459394165,16459394187,22,1884,1193,-30
16462635213,16462635219,6,1605,1083,-30
16462760148,16462760154,6,1512,1145,-30
16465987886,16465987890,4,1729,1385,-30
16466756716,16466756718,2,1181,1401,-30
16467297659,16467297665,6,2302,1356,-30
16468370207,16468370214,7,2383,1377,-30
16475077657,16475077664,7,1947,1394,-30
16479660902,16479660905,3,2326,1101,-30
16484678474,16484678479,5,1940,902,-30
16486680203,16486680208,5,2827,1830,-30
16489434003,16489434008,5,1775,951,-30
16496942442,16496942449,7,1772,1036,-30
16497862954,16497862958,4,2909,1562,-30
16501433061,16501433062,1,1286,1927,-30
16505437502,16505437493,-9,47603,3585,-30
16508750249,16508750250,1,1494,1115,-30
16510129870,16510129874,4,5701,4210,-30
16511862368,16511862374,6,1576,1236,-30
16515992697,16515992702,5,2047,911,-30
16517613834,16517613839,5,1952,1435,-30
16519989405,16519989409,4,1491,1074,-30
16520756594,16520756600,6,2488,1019,-30
16526400390,16526400385,-5,2405,6573,-30
16531249602,16531249604,2,1805,1979,-30
16531483818,16531483821,3,2172,1375,-30
16531591341,16531591346,5,2524,1100,-30
16532348978,16532348983,5,1208,956,-30
16533495338,16533495343,5,2699,853,-30
16534069712,16534069719,7,2504,1176,-30
16539699922,16539699926,4,1907,1573,-30
16541381414,16541381418,4,2112,1423,-30
16543586515,16543586522,7,1568,744,-30
16546460321,16546460322,1,1187,1047,-30
16549268550,16549268557,7,3092,1422,-30
16550086595,16550086598,3,1618,1309,-30
16556585837,16556585844,7,4600,1545,-30
16557869290,16557869293,3,2726,1325,-30
16560893556,16560893559,3,1929,1550,-30
16561742141,16561742147,6,1713,1110,-30
16562444839,16562444840,1,478,195,-30
16563740661,16563740666,5,2258,1720,-30
16566401802,16566401807,5,1287,1177,-30
16568094366,16568094370,4,2114,1391,-30
16569443549,16569443555,6,2011,1076,-30
16573591327,16573591332,5,2551,1465,-30
16578575478,16578575483,5,1464,860,-30
16579334711,16579334715,4,1812,1136,-30
16581564561,16581564566,5,2331,1129,-30
16584878705,16584878710,5,2705,1267,-30
16586451165,16586451166,1,33001,50313,-30
16586648553,16586648559,6,1550,978,-30
16587860223,16587860222,-1,1423,1717,-30
16589413348,16589413354,6,2693,1788,-30
16599221936,16599221937,1,969,1737,-30
16604690733,16604690738,5,3708,1279,-30
16605077846,16605077850,4,1931,1328,-30
16606947119,16606947124,5,2448,1123,-30
16607714178,16607714183,5,3128,1165,-30
16611731766,16611731769,3,1334,1366,-30
16612007954,16612007961,7,2078,1169,-30
16612490372,16612490386,14,1747,1228,-30
16616262330,16616262334,4,2623,1576,-30
16618584634,16618584638,4,2184,1488,-30
16620088798,16620088802,4,2338,1044,-30
16620233158,16620233165,7,3955,1226,-30
16622379331,16622379334,3,1555,1164,-30
16624477070,16624477075,5,1811,1162,-30
16625408638,16625408645,7,2413,1269,-30
16625495363,16625495367,4,1561,1124,-30
16626624430,16626624437,7,2212,1161,-30
16627540033,16627540039,6,2879,1062,-30
16628017838,16628017841,3,2811,1696,-30
16629220856,16629220861,5,2388,1318,-30
16636456014,16636456017,3,2595,2137,-30
16641296626,16641296631,5,2635,1314,-30
16642891602,16642891609,7,2197,1812,-30
16648486382,16648486386,4,2753,1561,-30
16655418590,16655418594,4,2002,1155,-30
16656917730,16656917734,4,2697,1413,-30
16661208370,16661208374,4,1848,1307,-30
16661691493,16661691499,6,1728,1039,-30
16677729973,16677729977,4,1765,1230,-30
16678222706,16678222710,4,2126,1191,-30
16680171271,16680171277,6,1772,1324,-30
16680616867,16680616873,6,2524,1261,-30
16683865466,16683865469,3,2360,1010,-30
16684738580,16684738586,6,2938,1303,-30
16687421879,16687421884,5,2619,1452,-30
16688036812,16688036817,5,1381,1143,-30
16690994569,16690994574,5,1803,1097,-30
16692000620,16692000613,-7,911,5865,-30
16692237149,16692237154,5,2117,1297,-30
16695963571,16695963578,7,2969,1732,-30
16697253738,16697253743,5,2316,1298,-30
16698438415,16698438417,2,1670,1841,-30
16699180075,16699180079,4,2492,1217,-30
16701362483,16701362487,4,1917,864,-30
16701860508,16701860506,-2,1209,1807,-30
16703000153,16703000158,5,2192,1250,-30
16703247534,16703247539,5,2355,1310,-30
16707022794,16707022795,1,3703,3352,-30
16707612653,16707612658,5,3095,1530,-30
16708999730,16708999730,0,1756,1350,-30
16709242821,16709242825,4,1975,1108,-30
16709937537,16709937543,6,1349,684,-30
16709990007,16709990024,17,658,217,-30
16712270238,16712270218,-20,2303,1302,-30
16717877635,16717877640,5,2742,1254,-30
16718431317,16718431297,-20,2745,1218,-30
16718538739,16718538742,3,2021,1112,-30
16720261650,16720261653,3,1530,1461,-30
16722279270,16722279274,4,1822,1227,-30
16726773421,16726773425,4,1689,1083,-30
16727566661,16727566646,-15,2177,1220,-30
16729878402,16729878410,8,1652,1284,-30
16730898790,16730898785,-5,915,4883,-30
16733861386,16733861391,5,2201,1009,-30
16734682005,16734682010,5,2584,1620,-30
16734996149,16734996155,6,2032,1333,-30
16737116857,16737116859,2,1366,1022,-30
16741971073,16741971079,6,2053,1364,-30
16742214390,16742214394,4,1557,894,-30
16744731162,16744731166,4,2289,1304,-30
16745241414,16745241409,-5,1264,3527,-30
16747538797,16747538802,5,2254,1456,-30
16748884176,16748884181,5,2624,1342,-30
16749710905,16749710909,4,2348,1149,-30
16750418886,16750418892,6,1511,1453,-30
16751739645,16751739632,-13,2320,508,-30
16751827347,16751827353,6,3281,1758,-30
16755639778,16755639781,3,1727,1154,-30
16757723431,16757723437,6,2199,1293,-30
16759109836,16759109841,5,1941,1496,-30
16759563848,16759563853,5,2205,1951,-30
16759649713,16759649718,5,2728,959,-30
16764457698,16764457705,7,2459,1238,-30
16769145043,16769145038,-5,850,1619,-30
16772208410,16772208415,5,1827,1271,-30
16777015279,16777015284,5,2442,1173,-30
16781817826,16781817830,4,1670,1630,-30
16782711742,16782711747,5,2803,1774,-30
16783307026,16783307031,5,2377,1241,-30
16784858902,16784858906,4,2078,1195,-30
16790197092,16790197095,3,1935,1329,-30
16791644006,16791644004,-2,2805,3988,-30
16791967442,16791967446,4,2195,1082,-30
16793136095,16793136102,7,5982,2054,-30
16794518002,16794518007,5,1537,1226,-30
16799894347,16799894351,4,2252,1075,-30
16800938359,16800938363,4,2646,1299,-30
16806962825,16806962824,-1,2212,2862,-30
16809108886,16809108891,5,2068,1134,-30
16809181325,16809181330,5,1985,1584,-30
16809773949,16809773949,0,1705,1622,-30
16812594458,16812594462,4,2770,1497,-30
16812893972,16812893975,3,2615,1059,-30
16813308071,16813308075,4,2625,1911,-30
16814185077,16814185080,3,1223,1076,-30
16819098386,16819098392,6,1673,1135,-30
16823889684,16823889687,3,1991,1472,-30
16833716865,16833716869,4,1472,994,-30
16835698519,16835698525,6,2824,1646,-30
16835773547,16835773554,7,2941,1812,-30
16837426809,16837426804,-5,803,2456,-30
16839295282,16839295286,4,35170,25199,-30
16841482546,16841482550,4,2309,1541,-30
16842528614,16842528619,5,2266,1005,-30
16842718381,16842718386,5,2179,1296,-30
16843022763,16843022767,4,2009,871,-30
16848912382,16848912387,5,1572,1134,-30
16857674226,16857674231,5,2842,1429,-30
16862017090,16862017096,6,2053,1365,-30
16871996722,16871996726,4,2944,2144,-30
16872251850,16872251850,0,2973,5045,-30
16874054454,16874054459,5,2802,1291,-30
16883488928,16883488930,2,2115,1755,-30
16884655791,16884655797,6,2145,1418,-30
16884703583,16884703586,3,2536,1513,-30
16886018917,16886018921,4,2784,1003,-30
16886764919,16886764914,-5,966,385,-30
16888212786,16888212792,6,2188,1262,-30
16888580078,16888580084,6,3007,1273,-30
16890527974,16890527978,4,1391,717,-30
16893714427,16893714431,4,2518,1856,-30
16895251222,16895251226,4,2594,1252,-30
16898016914,16898016918,4,2105,1660,-30
16900507518,16900507523,5,1800,1167,-30
16901144654,16901144658,4,2238,1648,-30
16909569933,16909569938,5,2025,1591,-30
16910212110,16910212115,5,1896,1538,-30
16910432257,16910432265,8,1456,1753,-30
16913148469,16913148475,6,2070,1022,-30
16914210906,16914210910,4,1785,1125,-30
16915522351,16915522357,6,2355,1391,-30
16918179885,16918179892,7,2321,1338,-30
16921237589,16921237594,5,1177,1386,-30
16925512067,16925512071,4,1967,1303,-30
16927295011,16927295016,5,2715,1974,-30
16927669468,16927669482,14,24918,45747,-30
16932414839,16932414845,6,1590,1371,-30
16933206146,16933206155,9,25904,1791,-30
16934636915,16934636921,6,2090,1816,-30
16940682465,16940682469,4,2250,1356,-30
16955372444,16955372450,6,9097,29435,-30
16962884819,16962884822,3,2658,1178,-30
16965343638,16965343641,3,1496,1288,-30
16968305314,16968305319,5,2497,1736,-30
16969131366,16969131370,4,2107,1442,-30
16970418183,16970418187,4,970,673,-30
16972200635,16972200641,6,1380,1395,-30
16973652190,16973652197,7,2273,1497,-30
16973748168,16973748170,2,716,298,-30
16976180789,16976180795,6,1916,1145,-30
16976957246,16976957251,5,1837,1493,-30
16980096949,16980096953,4,2665,1645,-30
16981199332,16981199337,5,1739,1255,-30
16981389546,16981389551,5,1916,926,-30
16982269919,16982269922,3,1394,967,-30
16983219795,16983219801,6,3121,1401,-30
16985449213,16985449219,6,2135,1056,-30
16994454403,16994454407,4,2710,1519,-30
16994618828,16994618831,3,1597,1193,-30
16995099621,16995099623,2,1556,1545,-30
16996212121,16996212127,6,2492,1247,-30
16998729390,16998729397,7,2448,1208,-30
17002499132,17002499138,6,2792,1092,-30
17006279014,17006279022,8,1722,1234,-30
17007413350,17007413354,4,2449,1324,-30
17008435281,17008435286,5,2598,1235,-30
17012812692,17012812695,3,1492,1017,-30
17013917301,17013917306,5,2119,917,-30
17017434146,17017434150,4,1437,1280,-30
17019885351,17019885345,-6,1581,7808,-30
17020451689,17020451693,4,2782,1485,-30
17021028609,17021028607,-2,1251,1792,-30
17022688537,17022688542,5,2468,1192,-30
17023380670,17023380675,5,2101,1245,-30
17023927861,17023927865,4,1934,1322,-30
17028075510,17028075514,4,2313,1060,-30
17028229958,17028229963,5,2031,1118,-30
17032893818,17032893826,8,2956,1859,-30
17036083074,17036083079,5,3029,1504,-30
17041223731,17041223732,1,1586,1758,-30
17041939940,17041939960,20,391,150,-30
17042496817,17042496822,5,1840,1322,-30
17042561266,17042561273,7,56946,18896,-30
17044493921,17044493927,6,1218,705,-30
17044683205,17044683209,4,2165,1393,-30
17046971969,17046971974,5,2523,1295,-30
17049264042,17049264038,-4,2253,4699,-30
17061825902,17061825905,3,2414,1271,-30
17063670381,17063670384,3,1973,1304,-30
17064364526,17064364532,6,3004,1790,-30
17066310841,17066310846,5,3246,1588,-30
17066786646,17066786652,6,1758,1696,-30
17069807964,17069807955,-9,1286,1803,-30
17071488091,17071488096,5,2603,2164,-30
17073229820,17073229804,-16,531,184,-30
17073844536,17073844530,-6,1232,273,-30
17077623905,17077623910,5,1777,1206,-30
17078815763,17078815767,4,735,1091,-30
17080371313,17080371313,0,1532,1440,-30
17081758930,17081758933,3,2726,1631,-30
17083845569,17083845574,5,2705,1291,-30
17085611276,17085611281,5,2038,1652,-30
17096024637,17096024643,6,2252,1167,-30
17097122387,17097122376,-11,998,316,-30
17098191243,17098191249,6,3121,1646,-30
17098522616,17098522622,6,2867,1138,-30
17099863863,17099863870,7,3944,1720,-30
17102345673,17102345680,7,1963,1326,-30
17102427225,17102427210,-15,2001,1314,-30
17103727201,17103727206,5,2101,1215,-30
17105655440,17105655444,4,1565,1270,-30
17107175161,17107175165,4,1902,1140,-30
17114900989,17114900996,7,2676,1691,-30
17116038901,17116038906,5,2036,1608,-30
17118012291,17118012298,7,2066,1628,-30
17118432797,17118432796,-1,1363,2767,-30
17121437633,17121437640,7,2153,1193,-30
17125065690,17125065699,9,2968,865,-30
17127843655,17127843658,3,2323,1961,-30
17128451998,17128452003,5,1828,1193,-30
17129445775,17129445778,3,2890,1696,-30
17131641002,17131641007,5,2478,1294,-30
17135052233,17135052239,6,2593,1734,-30
17135617862,17135617867,5,975,909,-30
17139028798,17139028803,5,1316,945,-30
17141762442,17141762442,0,1108,1408,-30
17145095346,17145095353,7,15975,15408,-30
17152825297,17152825303,6,2321,1091,-30
17155181366,17155181368,2,1548,1975,-30
17157586419,17157586423,4,2636,1843,-30
17161370252,17161370257,5,1987,1458,-30
17162438614,17162438619,5,1524,826,-30
17164463668,17164463672,4,2515,1508,-30
17167398745,17167398750,5,1732,1011,-30
17176336338,17176336343,5,2104,1232,-30
17184835853,17184835857,4,1792,1333,-30
17186322771,17186322775,4,2350,1630,-30
17187360803,17187360808,5,2400,1078,-30
17193616050,17193616055,5,2437,1298,-30
17193754183,17193754190,7,1960,1522,-30
17199606678,17199606678,0,1010,1968,-30
17203185263,17203185267,4,1782,1175,-30
17204823798,17204823802,4,2799,1713,-30
17215145284,17215145282,-2,206,755,-30
17217684613,17217684618,5,2320,1424,-30
17221642982,17221642982,0,1256,2113,-30
17223281862,17223281864,2,2222,1061,-30
17226785386,17226785393,7,2270,1230,-30
17228466880,17228466885,5,3827,1822,-30
17230412897,17230412902,5,2726,1258,-30
17231619653,17231619657,4,1832,1737,-30
17232552312,17232552315,3,1725,1403,-30
17233855642,17233855643,1,1208,1897,-30
17239929806,17239929813,7,2344,1304,-30
17242037769,17242037772,3,1453,119,-30
17242075076,17242075088,12,2323,1221,-30
17242596825,17242596820,-5,1226,3420,-30
17243639601,17243639606,5,1218,457,-30
17247636028,17247636033,5,24936,35766,-30
17247997240,17247997234,-6,2512,6546,-30
17249110280,17249110285,5,2283,1358,-30
17249750049,17249750052,3,2144,1712,-30
17250521778,17250521784,6,2595,1736,-30
17252448042,17252448046,4,1642,942,-30
17254273791,17254273794,3,2610,1463,-30
17260027620,17260027625,5,1355,1322,-30
17265280338,17265280341,3,2081,1123,-30
17266375874,17266375878,4,2833,1584,-30
17268050146,17268050151,5,2834,1220,-30
17277806088,17277806095,7,2057,1030,-30
17278138895,17278138901,6,3333,1811,-30
17278741307,17278741310,3,1084,542,-30
17281118462,17281118465,3,2283,1435,-30
17282145289,17282145293,4,11986,7442,-30
17282604710,17282604715,5,1881,1329,-30
17289904033,17289904039,6,2327,1423,-30
17291078081,17291078087,6,1647,943,-30
17293307786,17293307791,5,3536,2039,-30
17303984050,17303984057,7,3591,1808,-30
17304093213,17304093234,21,2842,1647,-30
17305174068,17305174074,6,2656,920,-30
17309831003,17309831007,4,1629,1257,-30
17310718458,17310718464,6,1899,919,-30
17313492655,17313492661,6,899,831,-30
17314104519,17314104525,6,3099,1140,-30
17318368501,17318368506,5,2256,1568,-30
17322280322,17322280328,6,1909,1521,-30
17327669762,17327669770,8,2395,721,-30
17328153554,17328153559,5,1662,934,-30
17329486870,17329486875,5,1090,927,-30
17335533434,17335533440,6,2084,1760,-30
17337480421,17337480427,6,2238,1196,-30
17340556238,17340556238,0,2775,4225,-30
17341538777,17341538779,2,1566,1366,-30
17344179485,17344179490,5,1423,1038,-30
17345261561,17345261559,-2,823,1584,-30
17347462814,17347462810,-4,5858,13565,-30
17347777830,17347777835,5,1745,945,-30
17348895456,17348895461,5,2924,1815,-30
17349223631,17349223637,6,3229,2234,-30
17353071811,17353071815,4,1626,969,-30
17353308922,17353308926,4,2353,1222,-30
17354144555,17354144561,6,2826,1569,-30
17360656608,17360656611,3,2431,1610,-30
17364674335,17364674337,2,1813,989,-30
17372452874,17372452879,5,2181,1283,-30
17374830626,17374830604,-22,1861,841,-30
17375542851,17375542856,5,2636,1381,-30
17379679930,17379679934,4,1456,899,-30
17386201946,17386201950,4,1881,1186,-30
17386373607,17386373618,11,2046,930,-30
17387431051,17387431054,3,3074,1532,-30
17388254945,17388254950,5,2312,1625,-30
17388700323,17388700327,4,1948,1317,-30
17391609817,17391609822,5,2266,896,-30
17392199015,17392198992,-23,1633,1086,-30
17395704214,17395704223,9,2100,1185,-30
17397081399,17397081403,4,1878,838,-30
17399713738,17399713743,5,1740,944,-30
17401087901,17401087905,4,2840,2117,-30
17402171100,17402171105,5,2126,1666,-30
17403874991,17403874995,4,1989,1471,-30
17410394878,17410394883,5,2545,1212,-30
17412061290,17412061272,-18,1958,902,-30
17416807349,17416807355,6,3842,1406,-30
17421062577,17421062581,4,2718,1939,-30
17421212804,17421212809,5,1784,1702,-30
17425752575,17425752578,3,1794,1111,-30
17426819182,17426819186,4,2001,1184,-30
17428260927,17428260927,0,1072,1440,-30
17428587230,17428587234,4,1143,858,-30
17428662500,17428662520,20,2266,874,-30
17430185453,17430185459,6,3669,1550,-30
17430542326,17430542331,5,3403,1655,-30
17432241602,17432241607,5,2196,1420,-30
17432409661,17432409641,-20,2204,1092,-30
17432784540,17432784546,6,3528,893,-30
17433298930,17433298934,4,1186,952,-30
17434978344,17434978350,6,1742,1348,-30
17437542634,17437542640,6,2015,1221,-30
17444731401,17444731402,1,1394,1727,-30
17447316234,17447316239,5,1609,1383,-30
17449404805,17449404810,5,2891,1409,-30
17450909226,17450909230,4,1752,1481,-30
17456650486,17456650491,5,3135,1266,-30
17458019364,17458019369,5,2074,1024,-30
17458951431,17458951434,3,1558,1503,-30
17463216062,17463216068,6,2777,1626,-30
17464850177,17464850185,8,4242,1127,-30
17464951979,17464951968,-11,648,261,-30
17465089706,17465089692,-14,1818,1032,-30
17465972183,17465972190,7,2152,1086,-30
17468556059,17468556062,3,1731,1080,-30
17472570008,17472570015,7,2480,1291,-30
17475264668,17475264674,6,2922,1225,-30
17475924754,17475924759,5,2208,1429,-30
17476838690,17476838696,6,2332,1306,-30
17485071694,17485071693,-1,936,1148,-30
17486509859,17486509864,5,3360,1742,-30
17493059149,17493059155,6,3100,1855,-30
17506148899,17506148904,5,2390,1135,-30
17506244855,17506244833,-22,1484,824,-30
17508677622,17508677626,4,1870,1490,-30
17514818175,17514818162,-13,886,411,-30
17515553439,17515553445,6,3584,1742,-30
17515642198,17515642203,5,2441,1467,-30
17516728450,17516728457,7,2102,1471,-30
17517598502,17517598508,6,1775,1191,-30
17519922548,17519922555,7,1672,1488,-30
17522519477,17522519481,4,3672,1327,-30
17523513217,17523513222,5,2113,1524,-30
17527043038,17527043042,4,1856,1220,-30
17529114845,17529114846,1,1714,1871,-30
17540266754,17540266757,3,18133,13489,-30
17540595934,17540595914,-20,1658,1106,-30
17541554073,17541554087,14,260,1397,-30
17542298514,17542298518,4,1679,1094,-30
17544855342,17544855343,1,1796,1296,-30
17546517974,17546517978,4,1722,1049,-30
17549232248,17549232253,5,3299,1643,-30
17553765486,17553765491,5,1729,953,-30
17555967816,17555967822,6,2688,1449,-30
17557825497,17557825503,6,5399,3135,-30
17558153478,17558153481,3,3724,2889,-30
17563152131,17563152134,3,1425,1090,-30
17565637158,17565637163,5,2065,1126,-30
17567294582,17567294588,6,2985,1342,-30
17580157613,17580157619,6,1837,964,-30
17584476753,17584476757,4,1490,1492,-30
17585189102,17585189107,5,3120,2085,-30
17586858334,17586858331,-3,1343,2743,-30
17591062550,17591062557,7,2866,1053,-30
17591128110,17591128099,-11,702,293,-30
17593466002,17593466006,4,1554,1184,-30
17595636463,17595636466,3,2343,993,-30
17596603882,17596603886,4,2833,1023,-30
17597721681,17597721685,4,2539,2010,-30
17603540417,17603540421,4,2224,1699,-30
17604556554,17604556553,-1,2394,3889,-30
17614112047,17614112040,-7,296,1176,-30
17625704125,17625704130,5,2211,1534,-30
17626902586,17626902590,4,2673,1395,-30
17628801416,17628801422,6,2087,1316,-30
17631844381,17631844385,4,2917,1748,-30
17634022069,17634022075,6,2388,1273,-30
17636071310,17636071314,4,1787,1409,-30
17636195557,17636195563,6,2774,1410,-30
17637489583,17637489588,5,2147,1379,-30
17645113673,17645113679,6,2261,1464,-30
17646486960,17646486966,6,1871,1247,-30
17648227576,17648227588,12,12902,52483,-30
17650080743,17650080749,6,3718,1990,-30
17652010986,17652010990,4,1544,2025,-30
17652272358,17652272364,6,2803,1424,-30
17654236732,17654236739,7,1420,980,-30
17654777118,17654777100,-18,1390,769,-30
17656142644,17656142649,5,1904,1377,-30
17657102737,17657102743,6,2354,1031,-30
17659387241,17659387243,2,31961,26658,-30
17659439337,17659439343,6,2411,1433,-30
17659771161,17659771166,5,1841,1062,-30
17661194309,17661194314,5,1874,1211,-30
17661754687,17661754691,4,801,393,-30
17663244345,17663244352,7,1853,1541,-30
17664818606,17664818610,4,3582,1308,-30
17666177759,17666177757,-2,670,1210,-30
17667149380,17667149385,5,2135,1738,-30
17667395567,17667395573,6,1333,866,-30
17675599087,17675599080,-7,1425,4030,-30
17682590242,17682590246,4,2782,1878,-30
17684656010,17684656014,4,1865,1163,-30
17685226502,17685226509,7,2351,1368,-30
17686003610,17686003614,4,1865,1350,-30
17686161611,17686161614,3,1790,963,-30
17689211517,17689211522,5,2671,1362,-30
17692669696,17692669701,5,4251,1713,-30
17694295297,17694295302,5,1823,1785,-30
17696536494,17696536497,3,2775,1204,-30
17700027712,17700027718,6,1388,828,-30
17716764667,17716764674,7,2489,734,-30
17718470125,17718470129,4,4538,2761,-30
17721719214,17721719214,0,1283,1946,-30
17726733782,17726733791,9,2848,1476,-30
17730982453,17730982457,4,2678,1898,-30
17731189121,17731189126,5,1461,842,-30
17733989098,17733989101,3,2710,1504,-30
17740114433,17740114438,5,1307,874,-30
17740808976,17740808982,6,2646,1332,-30
17747813786,17747813790,4,3186,1059,-30
17753234354,17753234359,5,2662,1366,-30
17756002961,17756002967,6,1264,899,-30
17757257231,17757257235,4,2933,1050,-30
17758739250,17758739253,3,2253,1357,-30
17759688986,17759688992,6,2294,1474,-30
17761220816,17761220820,4,3103,1129,-30
17763464073,17763464077,4,1723,1479,-30
17766399749,17766399749,0,1319,1898,-30
17767401331,17767401335,4,1982,1706,-30
17770658590,17770658595,5,1826,1060,-30
17775114193,17775114200,7,2809,1328,-30
17776597754,17776597761,7,2938,1185,-30
17783268810,17783268814,4,2469,1426,-30
17784055089,17784055094,5,1503,944,-30
17784576777,17784576777,0,2304,4170,-30
17785809758,17785809762,4,3721,1611,-30
17788917222,17788917226,4,958,806,-30
17789578189,17789578193,4,1524,989,-30
17790940156,17790940159,3,2414,1503,-30
17791704501,17791704505,4,2218,1655,-30
17796464630,17796464635,5,2213,1474,-30
17804458986,17804458993,7,1953,1766,-30
17804691682,17804691686,4,2161,1108,-30
17806386142,17806386147,5,2677,1449,-30
17810429602,17810429607,5,1736,1433,-30
17812801497,17812801503,6,2803,1152,-30
17815690365,17815690371,6,1860,1269,-30
17816485243,17816485242,-1,1603,2792,-30
17819895654,17819895661,7,1423,1073,-30
17823118302,17823118306,4,1623,1087,-30
17826480542,17826480545,3,2028,1325,-30
17829174306,17829174315,9,1805,1324,-30
17829552864,17829552869,5,2428,1658,-30
17829831019,17829831002,-17,691,91,-30
17840081785,17840081789,4,2381,1830,-30
17840353728,17840353733,5,2545,1650,-30
17840558490,17840558475,-15,1118,1179,-30
17841459901,17841459898,-3,1981,4827,-30
17842362706,17842362710,4,2562,1199,-30
17844734569,17844734575,6,2315,1561,-30
17846350627,17846350633,6,1629,684,-30
17847273649,17847273646,-3,675,1050,-30
17850832992,17850832997,5,2584,1521,-30
17852338226,17852338219,-7,2078,9654,-30
17856309179,17856309184,5,2115,1798,-30
17858162218,17858162223,5,1887,967,-30
17860569966,17860569965,-1,818,1392,-30
17862439006,17862439011,5,3687,1988,-30
17867890842,17867890846,4,2275,1433,-30
17870888885,17870888889,4,2550,1517,-30
17874302418,17874302411,-7,1076,4904,-30
17878946732,17878946739,7,2109,1419,-30
17879828869,17879828874,5,1610,1084,-30
17880027974,17880027979,5,2471,1319,-30
17883613890,17883613894,4,2527,1174,-30
17887861199,17887861184,-15,1580,12856,-30
17887966809,17887966815,6,1773,758,-30
17892807805,17892807806,1,749,1303,-30
17893535267,17893535274,7,1692,1391,-30
17893956337,17893956342,5,2495,1307,-30
17894293023,17894293026,3,585,374,-30
17895993018,17895993024,6,1390,883,-30
17898183063,17898183069,6,1859,1150,-30
17899221356,17899221379,23,1533,2064,-30
17900895702,17900895706,4,2970,1566,-30
17902797514,17902797521,7,2584,1365,-30
17904030439,17904030443,4,1884,1346,-30
17904294296,17904294303,7,2681,1302,-30
17904515018,17904515026,8,3487,1356,-30
17907931191,17907931195,4,2954,1660,-30
17910447807,17910447811,4,1422,854,-30
17916333545,17916333552,7,2302,927,-30
17917289916,17917289923,7,2268,1204,-30
17918770804,17918770793,-11,1193,499,-30
17921495467,17921495474,7,2274,1389,-30
17921619398,17921619405,7,1731,1202,-30
17924217613,17924217616,3,2683,1334,-30
17924572477,17924572482,5,2628,1761,-30
17925032475,17925032489,14,1939,1017,-30
17929464589,17929464588,-1,2272,3509,-30
17930740351,17930740358,7,2053,1129,-30
17936171969,17936171975,6,3452,1183,-30
17936270362,17936270346,-16,791,590,-30
17936394610,17936394594,-16,1481,1105,-30
17941963937,17941963942,5,3025,1688,-30
17950277894,17950277898,4,2410,1709,-30
17952090510,17952090513,3,1446,1248,-30
17953895020,17953895025,5,2778,1065,-30
17955980182,17955980187,5,2458,1103,-30
17956565694,17956565699,5,1721,1077,-30
17959542125,17959542130,5,2548,1768,-30
17961741027,17961741031,4,2437,1392,-30
17965235201,17965235206,5,2207,816,-30
17965893208,17965893215,7,774,792,-30
17969211776,17969211781,5,1646,1597,-30
17970215146,17970215151,5,1772,1323,-30
17975645686,17975645691,5,2390,1141,-30
17977106990,17977106994,4,1358,1171,-30
17979085667,17979085671,4,1740,1124,-30
17982592498,17982592504,6,2179,1367,-30
17982846765,17982846767,2,2378,1297,-30
17983734634,17983734638,4,2055,1601,-30
17985336786,17985336790,4,1389,918,-30
17992608479,17992608482,3,1902,1078,-30
17994216752,17994216757,5,2804,1452,-30
17994776514,17994776522,8,2188,1369,-30
17996912093,17996912097,4,1916,1310,-30
17999551309,17999551314,5,2228,1559,-30
18001470258,18001470262,4,2203,1733,-30
18003648170,18003648174,4,2352,1520,-30
18005431658,18005431662,4,2391,1315,-30
18007564726,18007564731,5,3229,1263,-30
18011932350,18011932350,0,2108,1797,-30
18018011939,18018011958,19,972,100,-30
18022834810,18022834815,5,2121,1117,-30
18025047022,18025047027,5,2241,1109,-30
18029525474,18029525482,8,2008,1292,-30
18031235015,18031235018,3,1428,886,-30
18034818637,18034818642,5,2639,1621,-30
18035347642,18035347625,-17,1879,804,-30
18035975786,18035975791,5,1799,978,-30
18036992021,18036992026,5,2684,1418,-30
18037048448,18037048445,-3,1309,2055,-30
18037963322,18037963324,2,12838,14635,-30
18046734790,18046734793,3,1638,952,-30
18049197326,18049197334,8,1457,689,-30
18050182857,18050182866,9,2394,1648,-30
18051070174,18051070178,4,2401,1034,-30
18059573998,18059574003,5,2559,1414,-30
18068282933,18068282938,5,1762,1385,-30
18072534475,18072534480,5,2408,1395,-30
18075424910,18075424915,5,2602,997,-30
18077678083,18077678089,6,2328,1149,-30
18078228183,18078228188,5,2367,1496,-30
18078419830,18078419837,7,1218,979,-30
18079000220,18079000202,-18,1581,857,-30
18079586755,18079586758,3,1729,1546,-30
18086993018,18086993022,4,1735,928,-30
18091104389,18091104395,6,1759,989,-30
18092837171,18092837178,7,3859,1821,-30
18095432912,18095432915,3,1784,1530,-30
18097875366,18097875371,5,1587,1382,-30
18102938566,18102938571,5,2141,1243,-30
18104501398,18104501402,4,1998,956,-30
18107984998,18107985002,4,3356,1907,-30
18109183073,18109183075,2,6548,6438,-30
18110876583,18110876588,5,1142,760,-30
18112380413,18112380417,4,2431,1408,-30
18117950849,18117950851,2,1528,1719,-30
18118138990,18118138994,4,2105,1499,-30
18118169550,18118169558,8,2303,1176,-30
18118205738,18118205738,0,1109,1126,-30
18119823149,18119823155,6,3574,1626,-30
18123533697,18123533719,22,39428,10326,-30
18126538578,18126538582,4,3149,2591,-30
18131619056,18131619060,4,1473,1172,-30
18135242770,18135242769,-1,1564,1042,-30
18135941839,18135941834,-5,944,1795,-30
18138149097,18138149103,6,2198,1140,-30
18138515780,18138515787,7,3540,1306,-30
18140026517,18140026522,5,2408,1515,-30
18144931185,18144931190,5,2485,1346,-30
18146977120,18146977127,7,5572,2182,-30
18149821925,18149821931,6,2523,1335,-30
18151053336,18151053341,5,2049,1063,-30
18153068872,18153068877,5,2369,1099,-30
18154914037,18154914040,3,2499,1717,-30
18155728643,18155728650,7,2118,1600,-30
18157578610,18157578609,-1,5702,9175,-30
18163296834,18163296838,4,2355,1015,-30
18163550282,18163550296,14,775,208,-30
18170272975,18170272980,5,2889,1359,-30
18170972081,18170972087,6,2110,1130,-30
18178522421,18178522426,5,2998,1546,-30
18182056943,18182056949,6,2424,1684,-30
18182159182,18182159187,5,2192,1257,-30
18182428778,18182428783,5,2951,1451,-30
18187101241,18187101231,-10,1567,28620,-30
18190846355,18190846359,4,1625,1141,-30
18193735776,18193735781,5,2422,795,-30
18197692641,18197692645,4,1342,933,-30
18198903401,18198903407,6,2133,961,-30
18199116062,18199116067,5,2022,1047,-30
18202094418,18202094423,5,1695,1076,-30
18205841914,18205841917,3,935,982,-30
18206813580,18206813586,6,2784,1553,-30
18208394722,18208394726,4,2858,2267,-30
18209396826,18209396830,4,1645,1681,-30
18214047586,18214047589,3,1931,996,-30
18219232459,18219232463,4,2590,2548,-30
18226448506,18226448511,5,1896,1452,-30
18228017712,18228017717,5,2253,1420,-30
18230492929,18230492933,4,2981,2057,-30
18230880717,18230880723,6,2663,1058,-30
18235488414,18235488420,6,3604,1707,-30
18235803595,18235803602,7,71288,23994,-30
18237302707,18237302713,6,1816,1534,-30
18240307740,18240307746,6,2339,1261,-30
18242208874,18242208879,5,2446,2023,-30
18242271629,18242271632,3,2257,1178,-30
18242798071,18242798078,7,1800,1070,-30
18246230259,18246230264,5,2816,1666,-30
18247650002,18247649986,-16,2905,1871,-30
18250347149,18250347155,6,2502,1574,-30
18251003077,18251003077,0,1789,1314,-30
18252911320,18252911327,7,2707,1080,-30
18253602594,18253602598,4,2380,1436,-30
18253690926,18253690931,5,2163,1109,-30
18258047730,18258047736,6,2163,1292,-30
18258426117,18258426121,4,1873,880,-30
18260114406,18260114411,5,2138,1553,-30
18261765721,18261765725,4,2364,1699,-30
18262325997,18262326001,4,2178,974,-30
18265248377,18265248379,2,1776,1304,-30
18265469569,18265469570,1,1320,1316,-30
18270792998,18270793003,5,3300,1752,-30
18274067885,18274067883,-2,1334,2665,-30
18277833264,18277833270,6,2873,1286,-30
18281006409,18281006413,4,2336,1358,-30
18284822263,18284822267,4,1990,1198,-30
18285335281,18285335282,1,1762,2033,-30
18285817062,18285817068,6,1943,1121,-30
18291511013,18291511018,5,2192,1431,-30
18291703441,18291703424,-17,2442,1313,-30
18293499581,18293499586,5,2025,1518,-30
18297678685,18297678691,6,2523,1094,-30
18297952369,18297952374,5,2381,1299,-30
18298036110,18298036114,4,1992,1525,-30
18300558591,18300558595,4,2262,1368,-30
18307133132,18307133137,5,2373,1518,-30
18320388916,18320388922,6,2707,1491,-30
18322657098,18322657103,5,2344,1113,-30
18324184113,18324184117,4,3744,1832,-30
18325178402,18325178406,4,1289,1317,-30
18329393564,18329393541,-23,34,1417,-30
18333558158,18333558163,5,1686,1241,-30
18333644426,18333644442,16,1094,1137,-30
18334854818,18334854821,3,1497,759,-30
18335816041,18335816046,5,2160,1255,-30
18336883840,18336883846,6,2516,1485,-30
18340684234,18340684238,4,1200,779,-30
18341287427,18341287430,3,1872,1173,-30
18341877997,18341878001,4,2988,1625,-30
18344158722,18344158726,4,1819,961,-30
18350174893,18350174894,1,23567,19172,-30
18350835899,18350835899,0,1146,1010,-30
18351178214,18351178215,1,952,1406,-30
18352925156,18352925156,0,40444,21959,-30
18357589727,18357589730,3,1260,1113,-30
18366030645,18366030647,2,2300,1826,-30
18367948778,18367948776,-2,1113,1311,-30
18375853329,18375853334,5,1314,825,-30
18376136571,18376136554,-17,2911,1487,-30
18379435370,18379435374,4,1888,708,-30
18381435106,18381435111,5,2561,1753,-30
18381871034,18381871041,7,3266,1583,-30
18383440389,18383440393,4,2791,1460,-30
18391079407,18391079412,5,2103,1429,-30
18391715803,18391715811,8,2115,1280,-30
18392179984,18392179991,7,2373,1112,-30
18393709185,18393709188,3,2486,1343,-30
18398713199,18398713203,4,1900,1322,-30
18404187066,18404187071,5,2509,1477,-30
18405276312,18405276317,5,3472,1739,-30
18410096262,18410096266,4,2390,1489,-30
18413872338,18413872344,6,2147,1137,-30
18419657672,18419657675,3,2170,1240,-30
18420110993,18420110998,5,1998,1833,-30
18421877819,18421877822,3,2116,1614,-30
18426258153,18426258157,4,2055,1012,-30
18428858759,18428858766,7,3022,1274,-30
18435610349,18435610354,5,1987,1356,-30
18436029962,18436029966,4,2463,1359,-30
18436307276,18436307282,6,1737,1378,-30
18436862523,18436862531,8,1927,1114,-30
18438854267,18438854271,4,2863,1847,-30
18439667126,18439667132,6,1103,920,-30
18439958957,18439958948,-9,922,167,-30
18444400213,18444400218,5,1862,1238,-30
18448870861,18448870867,6,2662,1495,-30
18449488867,18449488866,-1,708,2471,-30
18449730205,18449730209,4,1680,1569,-30
18451802918,18451802915,-3,1627,2325,-30
18461558437,18461558442,5,1868,1599,-30
18464711793,18464711798,5,2406,1506,-30
18468527251,18468527250,-1,5375,7271,-30
18473417338,18473417346,8,2836,1444,-30
18474588336,18474588323,-13,2099,1172,-30
18478595934,18478595942,8,2553,688,-30
18478840489,18478840472,-17,1824,1085,-30
18479513615,18479513622,7,3712,1492,-30
18484883717,18484883718,1,1711,1677,-30
18487086673,18487086677,4,2269,1308,-30
18488219473,18488219474,1,1188,1517,-30
18498144129,18498144134,5,935,1012,-30
18499394976,18499394981,5,1973,1115,-30
18502224922,18502224926,4,2701,1414,-30
18503447382,18503447364,-18,1996,865,-30
18506235713,18506235708,-5,1942,4771,-30
18510353049,18510353055,6,2082,1532,-30
18513128883,18513128887,4,2283,1120,-30
18516326275,18516326282,7,1383,1399,-30
18517944982,18517944986,4,2289,1285,-30
18520774034,18520774041,7,4472,1707,-30
18529104980,18529104986,6,2650,1380,-30
18530402981,18530402985,4,1592,1018,-30
18531280726,18531280730,4,2501,1339,-30
18531578274,18531578259,-15,1451,967,-30
18533412940,18533412942,2,1290,1253,-30
18534856157,18534856163,6,1086,460,-30
18539029375,18539029375,0,1706,2414,-30
18540117419,18540117423,4,2278,1145,-30
18540767830,18540767834,4,894,887,-30
18544300713,18544300715,2,10519,49669,-30
18546831889,18546831895,6,1939,1269,-30
18551898127,18551898133,6,1631,1243,-30
18553091995,18553091976,-19,1997,1122,-30
18553605837,18553605857,20,1982,1204,-30
18555879561,18555879566,5,2150,1476,-30
18558709850,18558709855,5,2946,1707,-30
18562510970,18562510974,4,2444,1122,-30
18563506961,18563506967,6,2166,1887,-30
18565704846,18565704851,5,1781,993,-30
18569264589,18569264586,-3,38706,18997,-30
18572667097,18572667100,3,7995,6797,-30
18574071464,18574071471,7,1961,1345,-30
18574285142,18574285147,5,2209,1157,-30
18575707673,18575707676,3,1556,1363,-30
18576853457,18576853461,4,2981,1547,-30
18577525971,18577525976,5,1996,1531,-30
18578677434,18578677438,4,2418,1367,-30
18583085701,18583085704,3,2009,1832,-30
18583994961,18583994967,6,2945,1454,-30
18584096759,18584096763,4,1381,1026,-30
18586468674,18586468681,7,1804,1458,-30
18593890242,18593890246,4,2151,1244,-30
18601311111,18601311118,7,1133,1005,-30
18604892643,18604892649,6,2347,1066,-30
18606471820,18606471826,6,1424,771,-30
18622912081,18622912086,5,2875,1470,-30
18626705114,18626705118,4,1907,1291,-30
18629111511,18629111518,7,1848,1131,-30
18630043118,18630043123,5,3245,1395,-30
18631416277,18631416282,5,2123,1299,-30
18635515886,18635515890,4,2429,890,-30
18636468707,18636468710,3,2191,1279,-30
18639712088,18639712089,1,1101,1012,-30
18642490899,18642490903,4,2478,1335,-30
18648946710,18648946716,6,3163,1348,-30
18650063701,18650063701,0,3728,4077,-30
18650333889,18650333894,5,2357,1066,-30
18652040870,18652040875,5,2146,1139,-30
18653167219,18653167227,8,1500,1338,-30
18655920741,18655920746,5,2448,1347,-30
18660618732,18660618736,4,2882,1516,-30
18660716278,18660716299,21,1838,991,-30
18660901566,18660901570,4,1966,1213,-30
18662334158,18662334165,7,3348,1767,-30
18662824113,18662824120,7,1672,1526,-30
18663521122,18663521127,5,1010,1080,-30
18664750469,18664750474,5,1823,1543,-30
18664959817,18664959826,9,2992,1514,-30
18665349338,18665349343,5,1819,1180,-30
18667162483,18667162475,-8,1154,5936,-30
18668319583,18668319586,3,1582,1283,-30
18668376104,18668376110,6,2509,1479,-30
18669689093,18669689098,5,2815,1728,-30
18670306485,18670306489,4,3107,2523,-30
18671834762,18671834767,5,1805,1237,-30
18672194485,18672194490,5,2857,1272,-30
18673017099,18673017105,6,1609,1689,-30
18673210998,18673211002,4,1994,1471,-30
18673760980,18673760986,6,1457,828,-30
18674025078,18674025060,-18,1689,1170,-30
18675276841,18675276846,5,1583,1108,-30
18676191391,18676191395,4,2328,1593,-30
18677163157,18677163162,5,1389,1134,-30
18679420190,18679420194,4,3815,1392,-30
18680901988,18680901993,5,2545,1465,-30
18683160871,18683160873,2,1791,1395,-30
18684440000,18684440001,1,5776,18025,-30
18690902637,18690902641,4,2075,1653,-30
18692281930,18692281934,4,2019,1187,-30
18692519090,18692519074,-16,1936,1371,-30
18695108623,18695108627,4,1869,991,-30
18696002990,18696002993,3,3298,1510,-30
18697073813,18697073821,8,13417,25299,-30
18697169572,18697169577,5,2355,1329,-30
18698675820,18698675835,15,16407,46777,-30
18706354522,18706354526,4,1868,1651,-30
18709443696,18709443694,-2,1373,2911,-30
18711297298,18711297300,2,2268,1464,-30
18712514497,18712514503,6,2571,1315,-30
18713807035,18713807043,8,2700,1365,-30
18720059341,18720059345,4,2212,1504,-30
18721578370,18721578377,7,1912,875,-30
18724171474,18724171478,4,1361,1284,-30
18724776892,18724776897,5,2454,1364,-30
18728784044,18728784051,7,2875,2070,-30
18729807806,18729807811,5,1577,1056,-30
18735128449,18735128454,5,2282,1691,-30
18741758598,18741758604,6,2865,1455,-30
18746992761,18746992765,4,2353,1225,-30
18748620223,18748620226,3,2614,1631,-30
18749265189,18749265198,9,2871,1279,-30
18750747014,18750747018,4,2760,1843,-30
18752311776,18752311782,6,2895,1359,-30
18752354613,18752354619,6,2046,1339,-30
18753795045,18753795049,4,1927,1738,-30
18755201657,18755201662,5,2904,1885,-30
18755826525,18755826529,4,2280,851,-30
18757543514,18757543519,5,2987,1510,-30
18759753067,18759753073,6,4197,2568,-30
18759851278,18759851282,4,1712,1642,-30
18763481492,18763481498,6,2293,1048,-30
18770381297,18770381298,1,2063,1843,-30
18771898905,18771898910,5,1573,1357,-30
18774693911,18774693914,3,2206,1560,-30
18775207517,18775207523,6,2304,1404,-30
18775388719,18775388698,-21,2489,1544,-30
18776496605,18776496607,2,1695,1115,-30
18777457184,18777457188,4,2695,1123,-30
18781553846,18781553851,5,1549,984,-30
18782385142,18782385146,4,2551,1130,-30
18783073304,18783073307,3,1825,1399,-30
18783213649,18783213654,5,2611,1055,-30
18784047138,18784047143,5,2034,980,-30
18785007572,18785007577,5,2123,1065,-30
18786052696,18786052698,2,1675,1382,-30
18787658288,18787658286,-2,1984,1874,-30
18788114321,18788114326,5,3083,1665,-30
18789192022,18789192027,5,2845,1401,-30
18790660488,18790660494,6,1503,1262,-30
18790701789,18790701794,5,2521,1004,-30
18794417230,18794417236,6,1481,987,-30
18797258831,18797258835,4,2290,1219,-30
18798721577,18798721582,5,1670,1012,-30
18801475971,18801475978,7,1601,646,-30
18806201110,18806201116,6,2383,1478,-30
18807219439,18807219456,17,3208,1560,-30
18808856818,18808856817,-1,1881,2585,-30
18808913365,18808913371,6,1520,840,-30
18809854817,18809854837,20,231,1689,-30
18810621746,18810621753,7,2264,1170,-30
18813563833,18813563837,4,1410,883,-30
18814734597,18814734601,4,2306,1519,-30
18816630621,18816630628,7,1789,1107,-30
18821524930,18821524935,5,1670,1383,-30
18821645736,18821645723,-13,1293,842,-30
18829569574,18829569579,5,1407,1082,-30
18834488222,18834488220,-2,1227,2056,-30
18838696210,18838696193,-17,2012,1201,-30
18839730201,18839730207,6,2468,1763,-30
18839968614,18839968621,7,2563,1161,-30
18840118874,18840118882,8,1613,820,-30
18840253030,18840253017,-13,2648,1117,-30
18842443378,18842443385,7,2579,1826,-30
18842535489,18842535469,-20,2027,1208,-30
18844622020,18844622026,6,2413,1641,-30
18848567339,18848567344,5,1727,1704,-30
18848981718,18848981722,4,2471,1878,-30
18852526747,18852526751,4,2136,1791,-30
18852711942,18852711946,4,1768,1356,-30
18852834858,18852834863,5,2165,1619,-30
18855845189,18855845193,4,2401,1953,-30
18863468924,18863468930,6,2358,1313,-30
18866332010,18866332015,5,2960,1160,-30
18869553836,18869553841,5,2022,1393,-30
18869788343,18869788343,0,1201,2565,-30
18869976435,18869976429,-6,968,2166,-30
18871011593,18871011598,5,1841,1203,-30
18873279422,18873279426,4,1477,1009,-30
18879542390,18879542398,8,2095,1316,-30
18880485955,18880485959,4,2001,946,-30
18885692230,18885692236,6,1886,1211,-30
18887181184,18887181190,6,2902,1414,-30
18888146681,18888146686,5,1610,897,-30
18888207915,18888207920,5,2080,1201,-30
18888338712,18888338698,-14,2097,1174,-30
18889876070,18889876074,4,2067,1595,-30
18893458282,18893458291,9,3037,1541,-30
18895267830,18895267832,2,1449,1792,-30
18896170791,18896170796,5,2544,1581,-30
18898730883,18898730886,3,1989,1170,-30
18908203390,18908203395,5,1608,1282,-30
18908498985,18908498991,6,3368,1680,-30
18911120523,18911120529,6,2285,1319,-30
18913761837,18913761841,4,1699,878,-30
18915190143,18915190147,4,2309,1432,-30
18918836349,18918836353,4,1815,751,-30
18920028744,18920028747,3,1985,1380,-30
18922718569,18922718573,4,2268,941,-30
18928416668,18928416673,5,2777,1847,-30
18930461708,18930461713,5,3303,1414,-30
18930786135,18930786122,-13,872,518,-30
18931653975,18931653980,5,1785,1247,-30
18933101319,18933101324,5,3144,1712,-30
18935256640,18935256645,5,1867,1421,-30
18937515089,18937515094,5,1687,1059,-30
18939576414,18939576409,-5,1251,4019,-30
18940771459,18940771466,7,2204,1239,-30
18941471061,18941471065,4,1351,853,-30
18941855901,18941855906,5,2932,1446,-30
18944496574,18944496579,5,1275,1064,-30
18949571358,18949571365,7,2549,1618,-30
18956165151,18956165157,6,3788,1302,-30
18956811833,18956811839,6,2256,999,-30
18962231683,18962231687,4,2446,2085,-30
18963037161,18963037155,-6,1340,5467,-30
18968644681,18968644681,0,2075,1582,-30
18969803058,18969803062,4,2353,1415,-30
18970599558,18970599562,4,2574,1587,-30
18972192807,18972192810,3,2267,1511,-30
18972423285,18972423291,6,2949,1109,-30
18973478173,18973478177,4,1285,971,-30
18975583050,18975583053,3,2644,1055,-30
18975845285,18975845287,2,1660,1142,-30
18980090638,18980090645,7,1991,1153,-30
18983445237,18983445243,6,1578,799,-30
18988677415,18988677398,-17,2747,1169,-30
18990633989,18990633994,5,2758,1560,-30
18992925637,18992925640,3,1815,1328,-30
18993342637,18993342643,6,2359,1623,-30
18994677010,18994677015,5,2202,1777,-30
18996455505,18996455510,5,2483,1552,-30
18996772889,18996772905,16,2414,1108,-30
19001647555,19001647558,3,1219,958,-30
19002517614,19002517617,3,1739,1539,-30
19003055641,19003055644,3,1939,1087,-30
19003846060,19003846064,4,1942,1150,-30
19004280917,19004280923,6,2542,1228,-30
19004743062,19004743040,-22,1631,1464,-30
19006926801,19006926806,5,2203,1097,-30
19010458113,19010458114,1,1325,1630,-30
19011172322,19011172327,5,2344,1579,-30
19013757186,19013757180,-6,1605,5550,-30
19014532123,19014532107,-16,1713,1115,-30
19020708710,19020708715,5,1984,1082,-30
19021877838,19021877843,5,2539,1747,-30
19024207405,19024207410,5,2053,873,-30
19027361280,19027361285,5,2248,1310,-30
19029309193,19029309199,6,2191,1287,-30
19029367675,19029367680,5,1995,846,-30
19029738689,19029738693,4,3073,1930,-30
19032875762,19032875767,5,2250,1368,-30
19033885194,19033885199,5,1781,866,-30
19042978842,19042978846,4,2543,1136,-30
19046288721,19046288727,6,2531,1585,-30
19046466072,19046466078,6,2613,1250,-30
19048666845,19048666849,4,3081,1201,-30
19050469764,19050469747,-17,1370,920,-30
19051772378,19051772382,4,1810,1065,-30
19052739809,19052739814,5,1964,1212,-30
19054268618,19054268625,7,1682,1120,-30
19054494218,19054494221,3,1295,1189,-30
19054753246,19054753250,4,2469,1101,-30
19055537062,19055537068,6,1629,1076,-30
19056296094,19056296098,4,2531,1503,-30
19056889513,19056889518,5,4704,2702,-30
19062652188,19062652192,4,2656,1840,-30
19063030861,19063030857,-4,1980,3346,-30
19065410933,19065410935,2,1943,948,-30
19071876558,19071876561,3,1998,1196,-30
19073494713,19073494716,3,1802,1196,-30
19076487502,19076487507,5,1970,1336,-30
19078936983,19078936986,3,1738,1159,-30
19081343908,19081343913,5,2418,1313,-30
19084507154,19084507161,7,10804,4668,-30
19084740014,19084740019,5,1725,1050,-30
19088607901,19088607907,6,1742,874,-30
19089333634,19089333640,6,2681,1399,-30
19091886017,19091886021,4,2517,1903,-30
19092651489,19092651493,4,2808,1784,-30
19092997306,19092997310,4,1502,982,-30
19096282214,19096282207,-7,1488,4188,-30
19097952638,19097952637,-1,1037,110,-30
19098253226,19098253234,8,2528,1450,-30
19100796961,19100796965,4,2733,1803,-30
19100827193,19100827177,-16,2465,1434,-30
19103860341,19103860346,5,2125,1384,-30
19105833153,19105833155,2,1250,1002,-30
19105969159,19105969166,7,3757,1251,-30
19106127432,19106127434,2,1604,1040,-30
19107334006,19107334010,4,2076,1022,-30
19108012173,19108012179,6,2409,1324,-30
19111467338,19111467338,0,126,1033,-30
19113184682,19113184687,5,2399,1215,-30
19117221003,19117221008,5,2459,1452,-30
19118353594,19118353596,2,1910,1230,-30
19123455102,19123455107,5,2764,1590,-30
19125155117,19125155122,5,1795,1244,-30
19125217241,19125217257,16,2377,1259,-30
19126948012,19126948017,5,27578,18882,-30
19129646121,19129646127,6,2044,1230,-30
19131753225,19131753230,5,2782,1560,-30
19132826039,19132826045,6,2400,1214,-30
19133484398,19133484403,5,2084,1254,-30
19138674416,19138674422,6,2879,1679,-30
19138956379,19138956383,4,1726,1645,-30
19140539542,19140539542,0,1886,2036,-30
19140765490,19140765499,9,13787,25739,-30
19141740798,19141740801,3,2286,1514,-30
19144868877,19144868879,2,2790,1950,-30
19146404472,19146404478,6,1922,1061,-30
19154693210,19154693213,3,1990,1390,-30
19155640769,19155640755,-14,2272,655,-30
19156350801,19156350805,4,2422,1343,-30
19156507427,19156507434,7,3075,1618,-30
19158902030,19158902036,6,1407,1359,-30
19160705074,19160705075,1,1430,1531,-30
19161630902,19161630902,0,1313,1947,-30
19169348964,19169348970,6,2421,1345,-30
19169568009,19169568019,10,2324,1163,-30
19171715582,19171715585,3,2574,1498,-30
19172806327,19172806331,4,1518,625,-30
19173477650,19173477655,5,1906,1112,-30
19175765095,19175765098,3,2562,1343,-30
19177010899,19177010899,0,796,787,-30
19179552655,19179552661,6,2548,1544,-30
19186691997,19186692002,5,4952,3314,-30
19194435813,19194435818,5,3756,1358,-30
19202894529,19202894534,5,1795,1411,-30
19207651539,19207651546,7,2659,1622,-30
19214377857,19214377862,5,2380,1292,-30
19218364402,19218364409,7,2237,1740,-30
19218537043,19218537048,5,1803,1374,-30
19219532397,19219532402,5,2825,1424,-30
19220631455,19220631460,5,1935,1229,-30
19223404945,19223404950,5,3302,1556,-30
19224556379,19224556385,6,2899,1357,-30
19227727928,19227727927,-1,3079,959,-30
19229262591,19229262596,5,3514,1554,-30
19232113189,19232113194,5,1535,1545,-30
19233634834,19233634839,5,2111,1596,-30
19236389155,19236389160,5,2084,1459,-30
19241963018,19241963018,0,2228,4379,-30
19245278858,19245278860,2,2677,1565,-30
19247025626,19247025630,4,2450,1250,-30
19248665067,19248665071,4,2140,1375,-30
19249663411,19249663411,0,920,1155,-30
19251526945,19251526950,5,2193,1200,-30
19251994528,19251994534,6,2559,1057,-30
19256072505,19256072510,5,1650,1170,-30
19256930033,19256930035,2,1803,1391,-30
19257562885,19257562890,5,2710,1258,-30
19262793740,19262793743,3,1999,1383,-30
19264530815,19264530819,4,3180,1211,-30
19267879255,19267879260,5,2438,1221,-30
19274232554,19274232559,5,2126,1487,-30
19281155069,19281155074,5,2432,1293,-30
19282581001,19282580984,-17,1600,903,-30
19283580065,19283580070,5,2372,1329,-30
19287757278,19287757283,5,1632,1513,-30
19288477368,19288477375,7,2929,1164,-30
19290283701,19290283706,5,2173,1000,-30
19296786151,19296786145,-6,1127,369,-30
19301093053,19301093059,6,2306,1358,-30
19304224302,19304224307,5,2550,1334,-30
19308324098,19308324101,3,2431,1014,-30
19308527950,19308527930,-20,2898,1149,-30
19309446057,19309446063,6,2779,1014,-30
19310086953,19310086958,5,2109,1435,-30
19311758952,19311758949,-3,899,1996,-30
19318061517,19318061521,4,2455,1684,-30
19319294394,19319294398,4,2483,1057,-30
19322064986,19322064991,5,2959,1496,-30
19322668119,19322668125,6,2181,1502,-30
19324476339,19324476344,5,1065,1266,-30
19325780113,19325780115,2,1828,1951,-30
19330794406,19330794410,4,1805,1595,-30
19331578681,19331578685,4,1818,1273,-30
19332068653,19332068658,5,2196,1379,-30
19334351135,19334351139,4,2326,1688,-30
19336132476,19336132480,4,2908,1405,-30
19336267775,19336267780,5,10942,16407,-30
19340377482,19340377489,7,2433,1066,-30
19342695013,19342695018,5,2233,1254,-30
19347851575,19347851578,3,1721,1061,-30
19347978338,19347978324,-14,1553,1049,-30
19352488924,19352488929,5,2968,1870,-30
19353138142,19353138146,4,1474,1562,-30
19359384673,19359384677,4,2278,1221,-30
19361196566,19361196571,5,1801,1317,-30
19365173122,19365173125,3,1945,1434,-30
19366911174,19366911179,5,2723,1364,-30
19371351811,19371351810,-1,810,1769,-30
19376218697,19376218701,4,2325,1162,-30
19379567038,19379567042,4,2251,1174,-30
19380492728,19380492733,5,2131,951,-30
19392247233,19392247237,4,2015,1577,-30
19394108077,19394108082,5,2540,945,-30
19401516897,19401516903,6,2910,1884,-30
19403337045,19403337048,3,3562,3832,-30
19408550346,19408550343,-3,1055,2715,-30
19409826044,19409826050,6,2110,1355,-30
19411915478,19411915482,4,2240,1454,-30
19415011544,19415011548,4,2849,1773,-30
19417263283,19417263288,5,2567,1311,-30
19419026605,19419026611,6,2450,1328,-30
19419252662,19419252654,-8,1265,2618,-30
19424006710,19424006715,5,2535,1057,-30
19424194409,19424194415,6,3246,1323,-30
19424465397,19424465403,6,1995,1135,-30
19424661668,19424661651,-17,1612,1248,-30
19430204151,19430204156,5,2165,867,-30
19431475189,19431475199,10,9424,38645,-30
19432275105,19432275109,4,2415,1551,-30
19433730191,19433730194,3,1390,1199,-30
19435375344,19435375350,6,2844,1147,-30
19437430346,19437430350,4,2180,1265,-30
19442187352,19442187355,3,1108,1111,-30
19444920530,19444920535,5,1838,1350,-30
19446856796,19446856795,-1,49672,67037,-30
19448494002,19448494008,6,2671,1132,-30
19451002146,19451002149,3,2027,2095,-30
19452453660,19452453643,-17,1092,481,-30
19454813235,19454813241,6,1891,1299,-30
19456769193,19456769198,5,3403,1717,-30
19457687603,19457687608,5,3083,1816,-30
19458251519,19458251526,7,1612,875,-30
19461820105,19461820122,17,16941,22514,-30
19466394786,19466394789,3,2307,1155,-30
19467260753,19467260760,7,1571,1151,-30
19470242135,19470242140,5,2727,1650,-30
19470798705,19470798710,5,3679,1482,-30
19476410230,19476410234,4,1987,1332,-30
19477264950,19477264955,5,2485,1470,-30
19478404040,19478404046,6,2605,1559,-30
19486640850,19486640855,5,2263,1606,-30
19486876670,19486876650,-20,1981,995,-30
19487123205,19487123211,6,2642,1397,-30
19487204468,19487204449,-19,1404,711,-30
19487274634,19487274638,4,2430,1326,-30
19490846618,19490846625,7,6236,2630,-30
19508379240,19508379245,5,2125,1606,-30
19508918631,19508918637,6,2561,1796,-30
19510044201,19510044206,5,1671,1395,-30
19510218868,19510218874,6,2549,831,-30
19512975146,19512975150,4,2163,1497,-30
19515318170,19515318175,5,2134,1165,-30
19525349370,19525349375,5,1524,1065,-30
19526606238,19526606245,7,2133,1061,-30
19527657434,19527657439,5,1715,1045,-30
19532208855,19532208861,6,2273,1345,-30
19533282941,19533282945,4,1938,1118,-30
19533951117,19533951131,14,2015,1177,-30
19534160391,19534160396,5,1952,1108,-30
19537187446,19537187450,4,2771,1550,-30
19542455738,19542455745,7,2752,1237,-30
19543139170,19543139166,-4,847,3946,-30
19548334497,19548334504,7,3684,1713,-30
19550893431,19550893435,4,3605,1589,-30
19551467150,19551467154,4,2503,1919,-30
19552955846,19552955853,7,2392,1255,-30
19554333078,19554333084,6,2710,1172,-30
19555151803,19555151809,6,3451,1902,-30
19566047065,19566047069,4,1857,1803,-30
19566730599,19566730595,-4,1263,1854,-30
19569203123,19569203123,0,1449,1683,-30
19570439929,19570439932,3,1895,1763,-30
19571534382,19571534387,5,2243,1411,-30
19573258289,19573258293,4,1764,950,-30
19574857644,19574857625,-19,2847,1318,-30
19577155030,19577155037,7,2395,1387,-30
19584499340,19584499345,5,1671,1088,-30
19588126266,19588126271,5,1821,1464,-30
19588211170,19588211155,-15,2974,979,-30
19588472905,19588472907,2,2396,2877,-30
19590199044,19590199057,13,544,2011,-30
19590490090,19590490094,4,1932,2001,-30
19590571346,19590571351,5,2155,896,-30
19592462344,19592462350,6,2077,1292,-30
19595647665,19595647670,5,3704,1735,-30
19596330374,19596330378,4,1324,1118,-30
19596503573,19596503578,5,1542,1087,-30
19596905609,19596905614,5,2247,1319,-30
19602919800,19602919804,4,3547,1147,-30
19605631605,19605631610,5,3358,1449,-30
19608805500,19608805507,7,2629,1079,-30
19610617788,19610617793,5,1728,1034,-30
19611619738,19611619720,-18,794,992,-30
19615979337,19615979343,6,3645,1344,-30
19617135279,19617135282,3,936,623,-30
19618224684,19618224667,-17,806,414,-30
19620439662,19620439668,6,2269,1119,-30
19629426887,19629426885,-2,833,2545,-30
19638597375,19638597381,6,2126,1207,-30
19642187818,19642187824,6,3215,1518,-30
19647060387,19647060394,7,1857,1096,-30
19650453462,19650453466,4,2939,1379,-30
19651170517,19651170522,5,2531,1872,-30
19656902022,19656902026,4,1582,1099,-30
19656966168,19656966177,9,3376,1499,-30
19657024730,19657024713,-17,2396,770,-30
19657343897,19657343897,0,1669,1718,-30
19660826625,19660826630,5,1458,896,-30
19664933182,19664933186,4,2788,1563,-30
19667846961,19667846966,5,3150,1515,-30
19673218328,19673218334,6,2733,1208,-30
19673949518,19673949517,-1,1369,1561,-30
19675885696,19675885701,5,3380,1814,-30
19676387073,19676387078,5,3208,1401,-30
19676427959,19676427964,5,2031,1193,-30
19676576373,19676576381,8,20018,45465,-30
19679806498,19679806502,4,3976,3014,-30
19682304766,19682304774,8,1903,926,-30
19683421382,19683421383,1,2640,1445,-30
19684694622,19684694626,4,2092,1774,-30
19689049318,19689049322,4,1847,1314,-30
19690684178,19690684182,4,2176,1236,-30
19692286834,19692286841,7,2368,1489,-30
19693673803,19693673806,3,1902,1259,-30
19696324289,19696324290,1,893,1767,-30
19700206896,19700206902,6,2504,1071,-30
19703049706,19703049713,7,3204,1629,-30
19710542585,19710542590,5,2254,1353,-30
19712738681,19712738683,2,3880,2192,-30
19718734688,19718734693,5,1957,1211,-30
19719537302,19719537305,3,1606,1195,-30
19719661490,19719661506,16,1376,1095,-30
19723205360,19723205360,0,1728,1679,-30
19723757902,19723757903,1,1909,1652,-30
19726022593,19726022595,2,39032,39412,-30
19726781506,19726781496,-10,879,325,-30
19727478444,19727478467,23,2047,1841,-30
19728147726,19728147706,-20,2302,1178,-30
19739692668,19739692685,17,1125,1772,-30
19741178713,19741178718,5,3016,1528,-30
19741706966,19741706970,4,2151,1287,-30
19744582838,19744582843,5,2305,1309,-30
19746793271,19746793254,-17,1340,790,-30
19751170570,19751170575,5,1792,1192,-30
19752735457,19752735462,5,1496,1368,-30
19753575863,19753575841,-22,1514,756,-30
19757613240,19757613245,5,1635,1224,-30
19758331825,19758331827,2,2122,1601,-30
19760542179,19760542182,3,1988,1543,-30
19760688439,19760688443,4,3571,2009,-30
19760868084,19760868079,-5,2102,7290,-30
19765686415,19765686420,5,2443,1877,-30
19766404379,19766404384,5,2357,1708,-30
19766931550,19766931554,4,1914,1647,-30
19767476240,19767476246,6,2879,1699,-30
19774591782,19774591787,5,2265,1312,-30
19776269310,19776269315,5,2250,1543,-30
19777884086,19777884090,4,2667,1528,-30
19781659198,19781659199,1,1782,1825,-30
19784029943,19784029947,4,1014,1152,-30
19789658697,19789658702,5,1731,1421,-30
19793168103,19793168108,5,1575,1224,-30
19793703022,19793703026,4,2140,1811,-30
19794292714,19794292718,4,2240,1195,-30
19794567076,19794567059,-17,3503,1750,-30
19798309183,19798309186,3,2299,1350,-30
19802003576,19802003580,4,3068,2565,-30
19802238423,19802238426,3,1381,1422,-30
19803697653,19803697658,5,1952,1027,-30
19808634037,19808634042,5,2281,1019,-30
19812792621,19812792625,4,2173,1555,-30
19815385935,19815385939,4,3254,1469,-30
19817145521,19817145528,7,2954,1585,-30
19817274162,19817274167,5,1473,892,-30
19818585563,19818585566,3,1201,878,-30
19819703712,19819703714,2,1455,1200,-30
19827100690,19827100686,-4,1991,7199,-30
19828217322,19828217329,7,2980,1849,-30
19829956362,19829956367,5,2415,1349,-30
19834591825,19834591826,1,1570,1676,-30
19839969097,19839969101,4,1977,1634,-30
19841068418,19841068424,6,3601,1542,-30
19843128378,19843128384,6,2423,1264,-30
19847433422,19847433426,4,1695,1313,-30
19847492688,19847492694,6,1853,1519,-30
19848288801,19848288807,6,1700,1039,-30
19854543701,19854543706,5,2065,1779,-30
19855795413,19855795431,18,2075,1169,-30
19855974361,19855974347,-14,2187,1018,-30
19856179827,19856179831,4,1462,1264,-30
19858573991,19858573995,4,1750,1076,-30
19862134397,19862134401,4,1763,1356,-30
19864744178,19864744180,2,1835,1236,-30
19868318878,19868318883,5,1255,997,-30
19868798586,19868798569,-17,2952,1092,-30
19870548111,19870548114,3,2534,1863,-30
19871076372,19871076378,6,3985,1885,-30
19871601508,19871601511,3,1304,1866,-30
19875119797,19875119802,5,2132,1342,-30
19878614091,19878614096,5,2392,1634,-30
19883365089,19883365096,7,2504,1282,-30
19885014238,19885014243,5,1643,1173,-30
19886625327,19886625331,4,2474,1642,-30
19886688398,19886688380,-18,3339,873,-30
19893972405,19893972410,5,2006,1800,-30
19896067828,19896067825,-3,97,5843,-30
19899304209,19899304211,2,2100,1454,-30
19900287777,19900287781,4,2128,1452,-30
19900353150,19900353145,-5,1087,5542,-30
19910777466,19910777469,3,1747,1443,-30
19914566565,19914566570,5,2457,1597,-30
19914629196,19914629202,6,1980,1362,-30
19918270370,19918270375,5,2013,1019,-30
19919717298,19919717304,6,2268,1140,-30
19920068366,19920068371,5,2153,1624,-30
19920875725,19920875730,5,2027,1300,-30
19921871294,19921871292,-2,1212,1469,-30
19923773821,19923773826,5,2450,1209,-30
19924439183,19924439190,7,2732,1451,-30
19925064362,19925064366,4,2899,1298,-30
19925840553,19925840556,3,2750,1161,-30
19927369328,19927369331,3,1582,1032,-30
19935285154,19935285159,5,1800,1237,-30
19941019168,19941019173,5,1843,1343,-30
19951506233,19951506231,-2,37532,21227,-30
19953411138,19953411144,6,2494,1738,-30
19957121885,19957121891,6,4519,1513,-30
19960169864,19960169867,3,2228,1626,-30
19967414854,19967414854,0,1233,2079,-30
19974938180,19974938184,4,1418,1185,-30
19980660116,19980660122,6,2671,1271,-30
19982534610,19982534615,5,1436,1140,-30
19983009300,19983009305,5,2303,1016,-30
19986952046,19986952049,3,1917,900,-30
19989186654,19989186662,8,2483,1087,-30
19990419642,19990419635,-7,1948,9484,-30
19992232404,19992232411,7,6285,2617,-30
19992433867,19992433873,6,2976,1243,-30
19998492821,19998492824,3,3221,1939,-30
19999779741,19999779749,8,13893,21978,-30
20001103786,20001103790,4,2418,1929,-30
20001514598,20001514597,-1,1629,2562,-30
20002973218,20002973223,5,1985,1445,-30
20004858394,20004858400,6,2589,1580,-30
20007426474,20007426479,5,2182,1190,-30
20007580692,20007580675,-17,3144,1159,-30
20008780306,20008780311,5,2543,1499,-30
20011502710,20011502714,4,1470,1637,-30
20011964928,20011964935,7,3883,1433,-30
20012046795,20012046794,-1,1393,2212,-30
20014821994,20014822001,7,3200,941,-30
20015726724,20015726730,6,1908,1203,-30
20015985363,20015985378,15,1767,765,-30
20016328358,20016328362,4,2029,1532,-30
20017312263,20017312268,5,2486,1151,-30
20019174075,20019174078,3,2131,1196,-30
20021333821,20021333827,6,2412,1173,-30
20024516905,20024516909,4,2667,1604,-30
20026466475,20026466478,3,1693,1067,-30
20028057081,20028057086,5,1804,1155,-30
20029488553,20029488563,10,452,352,-30
20030159671,20030159674,3,2042,1235,-30
20030624813,20030624815,2,2244,2280,-30
20032037584,20032037588,4,2211,1449,-30
20036759323,20036759328,5,2939,2074,-30
20036952854,20036952860,6,2134,864,-30
20037038485,20037038491,6,2167,1265,-30
20038813930,20038813933,3,1869,1484,-30
20040660634,20040660641,7,1504,1240,-30
20041119442,20041119448,6,1495,1368,-30
20042301253,20042301258,5,3131,1192,-30
20047159394,20047159399,5,2158,1626,-30
20047700749,20047700754,5,1964,1644,-30
20048796712,20048796713,1,1798,1756,-30
20053422502,20053422507,5,2183,1497,-30
20056721151,20056721145,-6,1256,6928,-30
20061047122,20061047127,5,2472,1386,-30
20062641150,20062641154,4,2243,1197,-30
20062884706,20062884711,5,1954,1367,-30
20063839885,20063839888,3,2565,1780,-30
20064058565,20064058569,4,2278,1411,-30
20069759515,20069759517,2,35977,31066,-30
20070736999,20070737002,3,1960,1137,-30
20074090923,20074090904,-19,2760,950,-30
20074355866,20074355871,5,1438,1377,-30
20075118878,20075118883,5,2710,1326,-30
20075344615,20075344618,3,1635,1378,-30
20082943822,20082943829,7,2485,1389,-30
20084373368,20084373373,5,3313,1430,-30
20084461661,20084461665,4,1796,1310,-30
20085609001,20085609006,5,1571,1530,-30
20087374725,20087374731,6,2987,1109,-30
20089567983,20089567986,3,2354,1118,-30
20089680106,20089680091,-15,1934,835,-30
20091772316,20091772319,3,1349,1697,-30
20102279258,20102279263,5,2301,1201,-30
20111337686,20111337691,5,2826,1960,-30
20112456027,20112456025,-2,1472,2436,-30
20115963869,20115963875,6,2489,1615,-30
20119492040,20119492045,5,2600,1399,-30
20125422369,20125422373,4,2386,1194,-30
20127535522,20127535529,7,3544,1144,-30
20132154924,20132154927,3,2225,1123,-30
20134707957,20134707958,1,1672,1696,-30
20136244961,20136244966,5,2152,1376,-30
20136797190,20136797195,5,2371,1318,-30
20137414578,20137414580,2,1375,1306,-30
20139222564,20139222586,22,18679,51740,-30
20144925817,20144925822,5,2206,1193,-30
20148289885,20148289890,5,4490,2360,-30
20149461585,20149461586,1,2490,2133,-30
20149566313,20149566317,4,2744,1423,-30
20156613983,20156613989,6,2238,1768,-30
20157500491,20157500474,-17,2256,931,-30
20160939329,20160939329,0,835,1580,-30
20173608686,20173608689,3,2087,1257,-30
20180304268,20180304251,-17,2868,1365,-30
20183343650,20183343655,5,2083,1228,-30
20183523020,20183523022,2,2157,1827,-30
20186163051,20186163049,-2,1327,2575,-30
20190438274,20190438281,7,1328,1131,-30
20192329271,20192329277,6,1755,965,-30
20194407465,20194407469,4,2450,1199,-30
20197733377,20197733382,5,1612,1200,-30
20212160484,20212160488,4,2078,2031,-30
20216377340,20216377334,-6,4272,9849,-30
20220045354,20220045358,4,1974,1194,-30
20221004858,20221004863,5,1793,1169,-30
20221735971,20221735975,4,1850,1061,-30
20227840396,20227840403,7,4248,1800,-30
20229770194,20229770200,6,2030,1083,-30
20229922511,20229922518,7,2709,1231,-30
20233483150,20233483154,4,1825,1896,-30
20236435265,20236435270,5,3317,1447,-30
20236821258,20236821264,6,2408,1212,-30
20238474394,20238474400,6,2374,1310,-30
20241428434,20241428440,6,1102,876,-30
20242573017,20242573024,7,3643,1769,-30
20251168251,20251168257,6,2050,1452,-30
20251301311,20251301290,-21,1381,1204,-30
20251951517,20251951522,5,1768,1104,-30
20257753094,20257753098,4,2349,1552,-30
20258679651,20258679654,3,1821,1286,-30
20259993371,20259993375,4,2793,1424,-30
20262355414,20262355418,4,2114,1554,-30
20263335850,20263335855,5,2255,1235,-30
20263775110,20263775115,5,949,820,-30
20264190769,20264190765,-4,23386,71175,-30
20272793931,20272793935,4,1569,1249,-30
20276610185,20276610177,-8,173,1532,-30
20281427938,20281427943,5,3217,1818,-30
20286144087,20286144091,4,2306,1160,-30
20292281170,20292281174,4,1637,1192,-30
20301653726,20301653731,5,2569,1500,-30
20305812191,20305812198,7,2412,1490,-30
20306484401,20306484406,5,2365,1155,-30
20310028902,20310028900,-2,2405,978,-30
20310263595,20310263594,-1,1526,1534,-30
20313001351,20313001355,4,1679,21110,-30
20315194995,20315195000,5,2246,1451,-30
20318898649,20318898654,5,3339,1801,-30
20323519698,20323519696,-2,951,2472,-30
20323681003,20323681007,4,2244,1114,-30
20329136121,20329136125,4,3908,1830,-30
20331749070,20331749063,-7,853,4384,-30
20333856139,20333856138,-1,1123,2955,-30
20333951223,20333951229,6,2108,1530,-30
20334340710,20334340716,6,1348,1077,-30
20342781351,20342781355,4,1846,952,-30
20346973590,20346973595,5,2571,1157,-30
20347023937,20347023942,5,2488,1675,-30
20347210770,20347210774,4,1643,1018,-30
20351412360,20351412364,4,2598,1008,-30
20351994782,20351994783,1,1761,1574,-30
20352883007,20352883013,6,1853,941,-30
20356754496,20356754502,6,2582,1094,-30
20358094606,20358094611,5,2459,1674,-30
20359622285,20359622290,5,1733,1331,-30
20365203306,20365203313,7,2196,1025,-30
20366094082,20366094082,0,1834,2065,-30
20371833958,20371833962,4,2200,1240,-30
20375288771,20375288777,6,1941,1217,-30
20375610302,20375610307,5,2333,1692,-30
20376900364,20376900369,5,1716,1227,-30
20385635525,20385635531,6,2516,1292,-30
20391252720,20391252725,5,1876,1213,-30
20393762066,20393762070,4,2021,1135,-30
20395246009,20395246003,-6,1886,1754,-30
20395307568,20395307559,-9,177,964,-30
20396117991,20396117997,6,3230,1802,-30
20398139441,20398139446,5,2388,1780,-30
20400422006,20400422010,4,2087,1341,-30
20401406185,20401406190,5,1408,1401,-30
20407056850,20407056854,4,1933,1421,-30
20415569689,20415569694,5,2546,1444,-30
20418622318,20418622323,5,2075,999,-30
20421163662,20421163658,-4,1153,3110,-30
20429760133,20429760129,-4,21214,66838,-30
20429878837,20429878842,5,2545,1622,-30
20431394353,20431394358,5,3045,1467,-30
20433702341,20433702345,4,2427,1380,-30
20435902802,20435902805,3,1914,1191,-30
20439322913,20439322919,6,2053,1469,-30
20443350514,20443350517,3,1994,1156,-30
20446785889,20446785894,5,3184,1770,-30
20452885309,20452885315,6,2492,1304,-30
20453472482,20453472486,4,2041,1583,-30
20455641325,20455641318,-7,1212,4111,-30
20457881716,20457881722,6,1207,843,-30
20465166777,20465166781,4,2256,971,-30
20465716030,20465716035,5,2673,1673,-30
20466653492,20466653498,6,2515,1290,-30
20469596170,20469596177,7,3808,2020,-30
20470676081,20470676064,-17,2472,1373,-30
20471535546,20471535551,5,2890,1736,-30
20472462198,20472462202,4,9400,23644,-30
20483218927,20483218932,5,2334,1310,-30
20484734390,20484734390,0,2610,3768,-30
20488989503,20488989506,3,1674,886,-30
20490827897,20490827901,4,1471,1361,-30
20490934381,20490934386,5,2310,923,-30
20492985274,20492985279,5,2287,1382,-30
20493102009,20493102014,5,2071,1173,-30
20493898429,20493898434,5,2203,1341,-30
20502649934,20502649941,7,2478,1036,-30
20503431903,20503431909,6,2393,1112,-30
20503692389,20503692393,4,1526,1328,-30
20505481454,20505481459,5,1786,1291,-30
20507539640,20507539645,5,1568,1564,-30
20508016049,20508016054,5,1442,1015,-30
20514887229,20514887235,6,2916,1370,-30
20516186351,20516186353,2,2244,1204,-30
20518162147,20518162151,4,1591,1160,-30
20518724954,20518724959,5,1237,956,-30
20522423538,20522423538,0,3113,4379,-30
20524619241,20524619246,5,2441,1530,-30
20526643446,20526643451,5,2402,1376,-30
20526826204,20526826206,2,1808,1149,-30
20529791024,20529791027,3,2608,2004,-30
20534579393,20534579399,6,2474,1152,-30
20536607974,20536607967,-7,1193,7520,-30
20539984569,20539984574,5,4363,1612,-30
20540334766,20540334770,4,2252,1287,-30
20541679142,20541679146,4,2024,1232,-30
20541823280,20541823286,6,2462,1192,-30
20542082362,20542082367,5,2225,1263,-30
20544250050,20544250053,3,1462,931,-30
20544797284,20544797288,4,2963,1626,-30
20545220306,20545220310,4,2292,1686,-30
20547688507,20547688511,4,2365,1423,-30
20553510737,20553510741,4,3672,1877,-30
20555316889,20555316894,5,2066,1116,-30
20556003862,20556003865,3,1547,1182,-30
20560030331,20560030334,3,2043,1937,-30
20560698080,20560698084,4,2314,1298,-30
20562527381,20562527387,6,2189,1512,-30
20563171010,20563170993,-17,1325,667,-30
20566958386,20566958390,4,2394,1406,-30
20571318570,20571318576,6,3045,1241,-30
20574801449,20574801455,6,2752,1326,-30
20577077601,20577077610,9,2974,937,-30
20579351416,20579351421,5,2299,1338,-30
20582015359,20582015363,4,1759,1216,-30
20582339017,20582339002,-15,1063,796,-30
20583451611,20583451619,8,1228,846,-30
20585527143,20585527137,-6,1039,3951,-30
20585872713,20585872719,6,2345,1213,-30
20586197313,20586197318,5,2054,1360,-30
20586465386,20586465368,-18,2423,962,-30
20588230159,20588230154,-5,890,1101,-30
20588874342,20588874347,5,1788,1312,-30
20594873432,20594873430,-2,28303,9868,-30
20597068945,20597068951,6,2753,1537,-30
20599362274,20599362278,4,3170,1667,-30
20600450581,20600450586,5,2123,1519,-30
20600902166,20600902148,-18,1788,851,-30
20602282875,20602282879,4,1942,998,-30
20603455542,20603455546,4,2841,1571,-30
20609084183,20609084187,4,2775,1476,-30
20613290986,20613290971,-15,2398,834,-30
20614675273,20614675280,7,6445,2616,-30
20615541378,20615541383,5,2293,1205,-30
20616188276,20616188278,2,2149,1147,-30
20616244610,20616244616,6,3589,1627,-30
20616458021,20616458001,-20,2148,835,-30
20620240822,20620240827,5,2457,1322,-30
20620504037,20620504043,6,1986,1095,-30
20620629996,20620630016,20,2919,1915,-30
20620698698,20620698704,6,2693,1835,-30
20621952890,20621952894,4,1541,1097,-30
20624657877,20624657881,4,2649,1584,-30
20626509075,20626509081,6,2363,1461,-30
20628384785,20628384789,4,2346,1439,-30
20629491678,20629491683,5,1869,1133,-30
20630429666,20630429670,4,2005,1265,-30
20632584822,20632584827,5,2817,1854,-30
20633918597,20633918601,4,2386,1693,-30
20635964825,20635964831,6,1618,1218,-30
20638070225,20638070230,5,1976,1443,-30
20638795646,20638795651,5,1254,1147,-30
20649077262,20649077266,4,2367,1693,-30
20654137479,20654137485,6,1193,1215,-30
20655654937,20655654941,4,2774,1238,-30
20658990872,20658990875,3,2401,1356,-30
20659472060,20659472065,5,5903,2891,-30
20659722861,20659722866,5,1770,1335,-30
20660039123,20660039127,4,2162,1342,-30
20660404409,20660404426,17,1238,1200,-30
20661390202,20661390206,4,2407,1975,-30
20666560554,20666560560,6,2227,1186,-30
20668556469,20668556475,6,2438,1269,-30
20668608684,20668608675,-9,1115,390,-30
20669461777,20669461781,4,2294,1609,-30
20671026770,20671026775,5,2551,1181,-30
20671210550,20671210536,-14,851,249,-30
20673344914,20673344914,0,1381,1127,-30
20674028026,20674028032,6,2728,1682,-30
20677741606,20677741612,6,2843,1696,-30
20679874846,20679874845,-1,2949,3230,-30
20681327717,20681327718,1,13303,17776,-30
20682282948,20682282953,5,2190,1742,-30
20693356564,20693356569,5,2628,1523,-30
20695894095,20695894102,7,1729,941,-30
20703374010,20703374006,-4,1103,3113,-30
20704421551,20704421555,4,1760,1519,-30
20705076517,20705076520,3,1850,1420,-30
20713984649,20713984646,-3,2159,5995,-30
20717519168,20717519174,6,2424,1509,-30
20719250554,20719250558,4,2256,1183,-30
20723804580,20723804583,3,1558,1181,-30
20724333470,20724333473,3,2487,1046,-30
20729799734,20729799738,4,825,459,-30
20730160332,20730160339,7,2714,1157,-30
20732715698,20732715703,5,1789,1580,-30
20732755519,20732755526,7,2070,1372,-30
20740731725,20740731730,5,3355,1583,-30
20742055410,20742055415,5,2016,1067,-30
20744232373,20744232370,-3,728,1493,-30
20748315214,20748315217,3,1664,1950,-30
20760041579,20760041584,5,2468,1522,-30
20761841047,20761841051,4,2153,1725,-30
20763956530,20763956534,4,2839,1161,-30
20764638106,20764638111,5,19501,29433,-30
20775223522,20775223526,4,3017,1541,-30
20781487447,20781487452,5,2587,1410,-30
20781815671,20781815648,-23,1566,481,-30
20785346178,20785346182,4,1968,1041,-30
20790009207,20790009213,6,2236,1090,-30
20792194079,20792194084,5,3437,1436,-30
20792291358,20792291363,5,1935,1605,-30
20793761606,20793761611,5,2192,1158,-30
20794676681,20794676687,6,2367,1451,-30
20795884546,20795884549,3,1519,870,-30
20799164085,20799164089,4,2560,1979,-30
20805533969,20805533972,3,1894,2006,-30
20805610456,20805610461,5,3566,2107,-30
20808151991,20808151995,4,2295,1579,-30
20808675670,20808675674,4,1989,1206,-30
20810632057,20810632059,2,1707,1557,-30
20811860942,20811860944,2,2155,1919,-30
20815892801,20815892803,2,1896,1472,-30
20817785163,20817785166,3,2142,1279,-30
20830527817,20830527823,6,2285,1596,-30
20832492558,20832492561,3,1310,1156,-30
20833705013,20833705019,6,2709,1494,-30
20833783398,20833783403,5,2023,1148,-30
20835087390,20835087395,5,2852,1856,-30
20835994542,20835994546,4,1386,1093,-30
20837128339,20837128342,3,1667,1539,-30
20839002247,20839002251,4,2038,928,-30
20841041301,20841041307,6,2538,1094,-30
20844331384,20844331392,8,2392,1543,-30
20847382886,20847382891,5,2975,1049,-30
20848242107,20848242110,3,2333,1296,-30
20850020078,20850020084,6,1822,1250,-30
20854383802,20854383805,3,2243,1101,-30
20857255463,20857255467,4,2068,1218,-30
20858656403,20858656408,5,2311,1763,-30
20861177663,20861177670,7,2168,1497,-30
20861747352,20861747355,3,1672,1610,-30
20863888467,20863888470,3,2147,1385,-30
20868684582,20868684586,4,1932,785,-30
20869014220,20869014226,6,1883,1228,-30
20869223070,20869223050,-20,1681,864,-30
20875666082,20875666082,0,2331,1780,-30
20877980614,20877980619,5,2320,1250,-30
20878771267,20878771272,5,2290,1317,-30
20879823665,20879823670,5,2542,1415,-30
20880134732,20880134738,6,2168,1190,-30
20880391189,20880391192,3,2634,1435,-30
20881047254,20881047234,-20,966,406,-30
20886953883,20886953881,-2,1190,1895,-30
20888230574,20888230579,5,2518,1210,-30
20890344917,20890344923,6,2193,1102,-30
20891991309,20891991311,2,1476,827,-30
20896967337,20896967343,6,2731,1551,-30
20901428257,20901428260,3,7978,28185,-30
20902387230,20902387234,4,2692,1280,-30
20904008521,20904008526,5,3218,1771,-30
20907067645,20907067645,0,1029,1493,-30
20908893749,20908893758,9,8350,40176,-30
20912610069,20912610073,4,3317,1350,-30
20918770165,20918770171,6,2008,1407,-30
20918918503,20918918503,0,2182,1513,-30
20919487335,20919487342,7,6898,2482,-30
20919617316,20919617319,3,1197,1107,-30
20920727598,20920727602,4,1601,1101,-30
20923476454,20923476458,4,2201,1189,-30
20925000146,20925000147,1,1012,12,-30
20926704490,20926704495,5,2375,953,-30
20926956228,20926956231,3,2109,1487,-30
20927170006,20927170013,7,2521,1592,-30
20930720506,20930720509,3,1975,1606,-30
20931101720,20931101726,6,3390,1726,-30
20933955095,20933955101,6,1986,1438,-30
20935034246,20935034250,4,1191,1066,-30
20942642777,20942642782,5,2695,1101,-30
20943468910,20943468914,4,2458,1128,-30
20950029762,20950029766,4,3246,1935,-30
20957419135,20957419125,-10,31673,15537,-30
20960237144,20960237126,-18,1938,1353,-30
20964783510,20964783517,7,1296,704,-30
20966060492,20966060499,7,2138,1432,-30
20969853595,20969853601,6,2113,1237,-30
20971728051,20971728057,6,1827,1514,-30
20971817994,20971817994,0,799,1849,-30
20974508125,20974508130,5,2409,1097,-30
20981840493,20981840507,14,2038,1355,-30
20984949104,20984949109,5,1764,1474,-30
20985847987,20985847990,3,1848,1437,-30
20987068344,20987068351,7,2153,1244,-30
20989130353,20989130364,11,1960,1081,-30
20989948974,20989948978,4,1110,1209,-30
20994648671,20994648677,6,3018,1310,-30
20999536892,20999536896,4,1926,1788,-30
21001551253,21001551259,6,2501,1278,-30
21001761454,21001761461,7,1994,1184,-30
21002340574,21002340554,-20,784,421,-30
21002514754,21002514757,3,1317,1029,-30
21003064586,21003064594,8,3374,937,-30
21006962756,21006962761,5,1881,1517,-30
21015284314,21015284321,7,1848,749,-30
21016189405,21016189387,-18,2309,1062,-30
21019781514,21019781518,4,2097,1145,-30
21020826087,21020826082,-5,36375,15924,-30
21025979515,21025979514,-1,1004,1662,-30
21026571721,21026571723,2,6082,17787,-30
21029233506,21029233511,5,2042,1351,-30
21029795428,21029795410,-18,2292,1101,-30
21030883338,21030883342,4,2235,1052,-30
21034712361,21034712367,6,2146,1260,-30
21035271925,21035271935,10,11685,25770,-30
21035867198,21035867203,5,2651,1500,-30
21037131830,21037131835,5,1994,1588,-30
21045462042,21045462049,7,1536,949,-30
21048386717,21048386723,6,6059,2300,-30
21049092497,21049092515,18,715,1859,-30
21051569056,21051569062,6,3208,991,-30
21056128817,21056128822,5,1975,1047,-30
21060129848,21060129854,6,2772,1787,-30
21061983474,21061983479,5,1928,801,-30
21063396549,21063396550,1,2168,1560,-30
21064226441,21064226446,5,2957,1388,-30
21064406022,21064406032,10,884,492,-30
21065491770,21065491776,6,2300,1175,-30
21066595585,21066595589,4,2228,1301,-30
21074561949,21074561953,4,2435,1293,-30
21076314922,21076314929,7,2230,1859,-30
21079449409,21079449414,5,2076,942,-30
21083902085,21083902089,4,1250,1301,-30
21085981498,21085981503,5,2457,1101,-30
21087140308,21087140288,-20,3208,1369,-30
21089409222,21089409226,4,2471,1165,-30
21090300757,21090300763,6,2316,1375,-30
21094567873,21094567877,4,3222,1467,-30
21097323106,21097323111,5,2403,1457,-30
21098312713,21098312718,5,2929,1694,-30
21099753710,21099753715,5,2437,1473,-30
21104835831,21104835838,7,2248,1234,-30
21106619427,21106619426,-1,1175,1760,-30
21109123106,21109123112,6,2488,988,-30
21114016676,21114016682,6,2602,1241,-30
21114451816,21114451827,11,1252,1259,-30
21115060317,21115060322,5,2759,1522,-30
21119329319,21119329325,6,3287,1759,-30
21119872730,21119872729,-1,2304,3002,-30
21123374234,21123374238,4,2749,1468,-30
21125912394,21125912401,7,7157,2397,-30
21127166395,21127166378,-17,2345,1241,-30
21128543307,21128543313,6,1884,1328,-30
21129829378,21129829375,-3,1409,4852,-30
21132528114,21132528119,5,1737,930,-30
21135919894,21135919899,5,2172,629,-30
21139045533,21139045537,4,1479,946,-30
21141379117,21141379121,4,1752,1256,-30
21143210749,21143210753,4,2216,1772,-30
21144424765,21144424769,4,1741,1408,-30
21146349450,21146349456,6,2153,1566,-30
21150490533,21150490538,5,1500,1075,-30
21151864406,21151864408,2,1934,1696,-30
21153341981,21153341987,6,1531,1089,-30
21155161926,21155161931,5,2137,1043,-30
21155779838,21155779846,8,3634,1701,-30
21155877841,21155877833,-8,2774,164,-30
21156024877,21156024890,13,1384,837,-30
21159413981,21159413987,6,1990,1231,-30
21160141353,21160141359,6,3152,1294,-30
21162074563,21162074569,6,1666,995,-30
21162591855,21162591853,-2,1530,2359,-30
21165762642,21165762646,4,1739,1112,-30
21169871235,21169871241,6,2089,1222,-30
21172153671,21172153668,-3,1508,2272,-30
21173601901,21173601906,5,1701,1257,-30
21175601484,21175601490,6,2328,1424,-30
21176583956,21176583961,5,2742,1219,-30
21178543034,21178543038,4,2604,1636,-30
21181858060,21181858065,5,2914,1340,-30
21182300080,21182300084,4,2373,1080,-30
21182464953,21182464948,-5,1674,5922,-30
21182946633,21182946628,-5,2544,1719,-30
21184791090,21184791093,3,2458,1534,-30
21187010127,21187010114,-13,10248,43953,-30
21189939429,21189939434,5,2234,1127,-30
21192022373,21192022378,5,2732,1051,-30
21193303142,21193303147,5,1891,1125,-30
21194163458,21194163463,5,1824,1051,-30
21198421422,21198421427,5,3175,1760,-30
21201426749,21201426754,5,2637,1479,-30
21203291574,21203291578,4,1778,1266,-30
21203317290,21203317293,3,1956,1276,-30
21205453110,21205453115,5,2916,1843,-30
21205799505,21205799510,5,1996,1558,-30
21206676692,21206676698,6,2148,851,-30
21208161638,21208161644,6,2257,1137,-30
21208387873,21208387880,7,2702,1395,-30
21213182524,21213182526,2,1574,1221,-30
21213618138,21213618143,5,3269,1536,-30
21217630701,21217630696,-5,1902,8207,-30
21218048372,21218048377,5,6802,3623,-30
21218630510,21218630514,4,1482,1282,-30
21219844901,21219844880,-21,639,258,-30
21224316090,21224316094,4,994,955,-30
21225754441,21225754445,4,3057,1563,-30
21227405459,21227405461,2,2122,1649,-30
21228513204,21228513206,2,1637,855,-30
21229477217,21229477225,8,5926,2711,-30
21229954085,21229954090,5,1980,844,-30
21231530782,21231530771,-11,636,222,-30
21236803160,21236803165,5,3223,1617,-30
21241498030,21241498035,5,2298,1194,-30
21242721194,21242721199,5,1588,999,-30
21247458144,21247458151,7,3216,970,-30
21251566272,21251566275,3,2279,1597,-30
21260954430,21260954434,4,2114,1626,-30
21261247070,21261247076,6,2556,1393,-30
21263008699,21263008704,5,2309,1602,-30
21264285409,21264285414,5,2065,1374,-30
21265492062,21265492067,5,3051,1479,-30
21272475326,21272475330,4,3465,1518,-30
21272838690,21272838696,6,2987,1462,-30
21273708662,21273708668,6,2516,1712,-30
21273945790,21273945810,20,2539,1399,-30
21274101754,21274101764,10,19898,56776,-30
21282742544,21282742549,5,2287,1160,-30
21283348999,21283349006,7,2403,1678,-30
21283707347,21283707353,6,3027,1416,-30
21284272586,21284272590,4,2114,976,-30
21292007229,21292007234,5,2424,1346,-30
21292904763,21292904767,4,2911,2016,-30
21296266214,21296266218,4,2255,1400,-30
21298262277,21298262280,3,1178,1246,-30
21299181593,21299181599,6,3096,1258,-30
21300704095,21300704094,-1,1010,2199,-30
21301407701,21301407705,4,2597,1559,-30
21307653177,21307653182,5,2378,1737,-30
21308582040,21308582050,10,1984,1390,-30
21309012580,21309012585,5,2404,1335,-30
21310351382,21310351387,5,2402,1535,-30
21317048998,21317049001,3,1567,936,-30
21317813160,21317813167,7,1304,798,-30
21320619765,21320619771,6,2163,1339,-30
21321034310,21321034314,4,2514,1185,-30
21321415242,21321415247,5,1921,919,-30
21322711414,21322711421,7,2088,1026,-30
21324608003,21324608008,5,2832,1675,-30
21329596326,21329596331,5,2771,1252,-30
21331633645,21331633651,6,2639,939,-30
21333137835,21333137841,6,3726,1527,-30
21337976593,21337976593,0,1328,1861,-30
21340936085,21340936089,4,1856,1640,-30
21343505241,21343505245,4,2669,1872,-30
21343982476,21343982482,6,1814,1116,-30
21346272678,21346272684,6,2753,1080,-30
21346440290,21346440272,-18,2486,756,-30
21349205537,21349205530,-7,37,2106,-30
21349699646,21349699650,4,2178,1115,-30
21349809990,21349809979,-11,630,131,-30
21351822034,21351822039,5,2508,1456,-30
21352891478,21352891483,5,2110,1265,-30
21353065962,21353065967,5,2223,1623,-30
21353310742,21353310746,4,1880,1357,-30
21356909374,21356909378,4,2007,1300,-30
21363487081,21363487086,5,2250,1463,-30
21364204034,21364204039,5,2271,1296,-30
21366974531,21366974533,2,1750,1516,-30
21371418405,21371418410,5,1430,862,-30
21381252925,21381252930,5,1768,1423,-30
21382248627,21382248630,3,1358,1323,-30
21397547266,21397547271,5,1946,1368,-30
21397699171,21397699161,-10,643,159,-30
21398012747,21398012728,-19,3469,1720,-30
21398964141,21398964146,5,2166,1502,-30
21400394504,21400394510,6,2861,1584,-30
21402807237,21402807242,5,1566,1471,-30
21404585231,21404585237,6,2712,1310,-30
21408569274,21408569278,4,2929,1872,-30
21410249642,21410249647,5,2539,1408,-30
21413121327,21413121330,3,1686,1465,-30
21413336710,21413336715,5,2072,1161,-30
21418483024,21418483027,3,1394,1257,-30
21418657782,21418657787,5,1749,1127,-30
21419099413,21419099419,6,2417,1424,-30
21421412685,21421412686,1,5024,18319,-30
21424445114,21424445118,4,2820,1688,-30
21427238654,21427238657,3,3401,1613,-30
21431739170,21431739173,3,2256,1597,-30
21435920162,21435920163,1,1368,1938,-30
21436719698,21436719702,4,2737,1509,-30
21437696472,21437696476,4,2369,1354,-30
21442504789,21442504793,4,5273,3315,-30
21445096321,21445096326,5,2122,1373,-30
21446600869,21446600874,5,2235,1591,-30
21453701066,21453701069,3,3202,1709,-30
21454627582,21454627586,4,1592,1222,-30
21455998981,21455998982,1,1500,1170,-30
21460728332,21460728336,4,1989,1154,-30
21462432373,21462432379,6,2560,1425,-30
21466434125,21466434130,5,2086,1181,-30
21470759679,21470759682,3,1270,1396,-30
21473734785,21473734789,4,2422,1401,-30
21476243814,21476243817,3,1487,1331,-30
21483569897,21483569901,4,1798,986,-30
21487509364,21487509368,4,2098,984,-30
21494846831,21494846846,15,2728,968,-30
21498740022,21498740028,6,2401,1156,-30
21499726171,21499726176,5,2475,1687,-30
21502478806,21502478812,6,2545,1254,-30
21502763454,21502763457,3,1548,1313,-30
21505227913,21505227917,4,2520,1544,-30
21505606571,21505606577,6,2565,1314,-30
21507362254,21507362259,5,2998,1491,-30
21507533682,21507533688,6,1635,1117,-30
21508281323,21508281327,4,1617,1676,-30
21511160589,21511160594,5,2043,1353,-30
21514531005,21514531009,4,1775,1648,-30
21518900534,21518900540,6,2447,1246,-30
21518968721,21518968725,4,1813,1247,-30
21522775814,21522775822,8,679,150,-30
21523152397,21523152378,-19,1754,1179,-30
21523962773,21523962777,4,2806,1419,-30
21525631985,21525631989,4,2149,2013,-30
21527426297,21527426302,5,1307,1062,-30
21528490869,21528490875,6,2218,1205,-30
21530943448,21530943449,1,1546,1161,-30
21533397419,21533397423,4,1821,1189,-30
21533506262,21533506263,1,982,1424,-30
21537792679,21537792682,3,2746,1466,-30
21540701886,21540701891,5,2836,1095,-30
21541873908,21541873911,3,1738,1279,-30
21541991494,21541991499,5,700,406,-30
21542718166,21542718171,5,2910,2289,-30
21551301610,21551301614,4,2671,1620,-30
21551447286,21551447291,5,1805,1102,-30
21558018277,21558018256,-21,363,7426,-30
21564254926,21564254928,2,1720,2083,-30
21566234255,21566234260,5,2428,1422,-30
21570445577,21570445564,-13,5302,16172,-30
21570933661,21570933666,5,2299,1350,-30
21572282747,21572282753,6,2344,1495,-30
21575939856,21575939862,6,2330,1397,-30
21576445185,21576445186,1,2167,1167,-30
21580512258,21580512261,3,1781,1206,-30
21581497177,21581497182,5,1704,1712,-30
21583510582,21583510560,-22,2102,1509,-30
21590988682,21590988687,5,2551,1204,-30
21591035952,21591035938,-14,1261,309,-30
21591829346,21591829351,5,3124,1607,-30
21594500759,21594500765,6,8605,17901,-30
21596311498,21596311503,5,1777,1375,-30
21599139330,21599139335,5,2041,1248,-30
21599468701,21599468682,-19,2783,1352,-30
21599669301,21599669312,11,2408,1418,-30
21603899831,21603899834,3,2149,1812,-30
21612164121,21612164126,5,2220,1266,-30
21614645930,21614645928,-2,1354,2253,-30
21619012512,21619012517,5,2180,1309,-30
21624930031,21624930025,-6,929,2464,-30
21629683543,21629683547,4,37713,52380,-30
21632830312,21632830318,6,2154,1417,-30
21633666768,21633666789,21,2699,1233,-30
21633732892,21633732907,15,4518,754,-30
21633758245,21633758225,-20,1666,932,-30
21638157828,21638157833,5,2444,1698,-30
21639972613,21639972619,6,1830,944,-30
21640506665,21640506670,5,2179,1177,-30
21640882206,21640882210,4,2677,1355,-30
21645708841,21645708846,5,2952,2005,-30
21646449507,21646449511,4,2816,1459,-30
21648661106,21648661110,4,2149,1248,-30
21649237777,21649237781,4,1581,1519,-30
21649882169,21649882175,6,2165,1518,-30
21651140446,21651140452,6,4543,1495,-30
21652295437,21652295442,5,1999,1022,-30
21653154597,21653154601,4,2431,1532,-30
21655288354,21655288359,5,2571,1158,-30
21658256554,21658256558,4,2800,1259,-30
21659640617,21659640623,6,1416,967,-30
21661009353,21661009358,5,2879,1028,-30
21661387392,21661387378,-14,1131,788,-30
21662702410,21662702415,5,1822,1419,-30
21670243873,21670243878,5,1774,1030,-30
21676569436,21676569434,-2,1059,2705,-30
21677950065,21677950067,2,4359,3398,-30
21680436146,21680436153,7,1883,815,-30
21680966540,21680966546,6,3463,1350,-30
21688047001,21688046999,-2,1048,458,-30
21691011776,21691011782,6,2675,1386,-30
21693790850,21693790855,5,2036,1530,-30
21694825400,21694825406,6,2087,1158,-30
21695796895,21695796902,7,2195,1266,-30
21699959487,21699959492,5,2955,1831,-30
21701935125,21701935130,5,2393,1104,-30
21703263726,21703263732,6,1909,1093,-30
21703614494,21703614501,7,2486,1360,-30
21709014042,21709014045,3,1385,1530,-30
21718991875,21718991878,3,1148,1617,-30
21719067138,21719067145,7,2468,1394,-30
21721404401,21721404404,3,2921,1704,-30
21726747497,21726747497,0,32652,46896,-30
21728097062,21728097066,4,2011,1165,-30
21729523387,21729523392,5,2381,1299,-30
21734680953,21734680957,4,3589,1955,-30
21734785166,21734785171,5,2193,1722,-30
21738530198,21738530202,4,2860,1603,-30
21746095146,21746095148,2,1540,1823,-30
21749056947,21749056952,5,2483,1744,-30
21753023309,21753023314,5,2865,1564,-30
21753859789,21753859793,4,1943,1459,-30
21755013830,21755013835,5,2737,1487,-30
21756455565,21756455559,-6,1378,10208,-30
21758879013,21758879019,6,2246,1102,-30
21764016286,21764016291,5,2988,1036,-30
21764891838,21764891842,4,1992,1439,-30
21765731735,21765731742,7,2137,1212,-30
21770226938,21770226942,4,2484,1364,-30
21772003397,21772003403,6,2164,1149,-30
21775498829,21775498834,5,2439,1506,-30
21780204239,21780204246,7,3456,1645,-30
21783331069,21783331074,5,2102,1422,-30
21783436391,21783436395,4,2623,1581,-30
21783485668,21783485674,6,1827,946,-30
21786432878,21786432882,4,2757,1723,-30
21791470242,21791470247,5,1871,1204,-30
21791845113,21791845116,3,1494,1023,-30
21794719585,21794719590,5,2339,1119,-30
21804892749,21804892769,20,1745,1151,-30
21809381877,21809381881,4,2025,1577,-30
21809724771,21809724770,-1,1293,1151,-30
21813446795,21813446801,6,2353,1606,-30
21819535167,21819535174,7,2163,1140,-30
21819782106,21819782113,7,1966,875,-30
21822326593,21822326598,5,2187,1383,-30
21830129330,21830129335,5,2855,1626,-30
21830186647,21830186652,5,3025,1585,-30
21838861178,21838861182,4,1898,908,-30
21839163378,21839163361,-17,1577,905,-30
21840025205,21840025210,5,3086,1293,-30
21847929666,21847929671,5,1498,1119,-30
21848071341,21848071346,5,1587,1031,-30
21850636542,21850636547,5,2613,1213,-30
21850974601,21850974606,5,1997,1183,-30
21852003694,21852003700,6,2158,1291,-30
21854348142,21854348147,5,1873,993,-30
21855954618,21855954613,-5,601,2068,-30
21856762322,21856762326,4,1867,1104,-30
21856802203,21856802204,1,2006,2345,-30
21857059766,21857059769,3,1967,1259,-30
21858109413,21858109420,7,4192,1643,-30
21861044502,21861044506,4,1518,1398,-30
21861836381,21861836386,5,2626,1865,-30
21863136886,21863136892,6,12432,18905,-30
21867102525,21867102530,5,1706,1389,-30
21867948129,21867948135,6,2710,1374,-30
21872383003,21872383008,5,2548,1803,-30
21872933982,21872933988,6,2147,1301,-30
21874238730,21874238734,4,1190,1051,-30
21874396489,21874396493,4,1991,1365,-30
21874564433,21874564418,-15,2480,784,-30
21880295006,21880295011,5,2200,1385,-30
21881659582,21881659589,7,2525,1043,-30
21887349498,21887349502,4,2578,1336,-30
21893933972,21893933978,6,2244,1597,-30
21899195807,21899195806,-1,1963,2705,-30
21900219234,21900219229,-5,1891,5364,-30
21907232682,21907232686,4,2365,1432,-30
21909823957,21909823963,6,1831,1553,-30
21912297267,21912297273,6,3386,1763,-30
21914669372,21914669376,4,2349,1328,-30
21915719109,21915719114,5,3482,1767,-30
21916959382,21916959382,0,1230,1980,-30
21917422181,21917422184,3,1562,889,-30
21920027690,21920027696,6,2331,1666,-30
21921649912,21921649914,2,1693,794,-30
21924591633,21924591637,4,2390,1240,-30
21924645954,21924645961,7,1952,1381,-30
21927673346,21927673346,0,2563,3422,-30
21934777170,21934777179,9,6973,2850,-30
21937353669,21937353675,6,2435,1154,-30
21943998233,21943998237,4,1964,1339,-30
21946358407,21946358411,4,2831,1407,-30
21947827358,21947827362,4,1227,1276,-30
21949746295,21949746303,8,2488,915,-30
21953041582,21953041586,4,2379,1532,-30
21953162896,21953162901,5,1938,1374,-30
21953838999,21953838998,-1,2456,3785,-30
21964435092,21964435096,4,1921,1303,-30
21967850290,21967850295,5,1642,1350,-30
21970605123,21970605128,5,2361,1362,-30
21971113495,21971113476,-19,1489,1242,-30
21973907955,21973907959,4,2329,1536,-30
21983325450,21983325455,5,1578,1126,-30
21985128213,21985128217,4,2408,1314,-30
21987156597,21987156599,2,1705,765,-30
21987891872,21987891878,6,1682,1070,-30
22000569641,22000569646,5,2476,1269,-30
22001911996,22001911994,-2,7,579,-30
22002843131,22002843146,15,2589,1104,-30
22003046350,22003046354,4,2183,1435,-30
22011010971,22011010977,6,1992,1402,-30
22012138726,22012138731,5,2687,1165,-30
22012408555,22012408558,3,1200,726,-30
22013549897,22013549901,4,2039,1115,-30
22013904114,22013904118,4,2907,2212,-30
22016715551,22016715549,-2,1141,2552,-30
22018021712,22018021717,5,3444,1795,-30
22019214200,22019214207,7,2888,1134,-30
22019604209,22019604214,5,4283,2415,-30
22020072638,22020072643,5,2742,1449,-30
22020672880,22020672885,5,2929,1325,-30
22023803389,22023803384,-5,1275,2395,-30
22025107665,22025107670,5,1628,1583,-30
22025320230,22025320234,4,3639,1867,-30
22026682830,22026682835,5,2307,1561,-30
22027701712,22027701717,5,2049,919,-30
22028294518,22028294525,7,2643,1248,-30
22030361058,22030361036,-22,1265,914,-30
22030634742,22030634745,3,2068,1151,-30
22031860563,22031860569,6,2096,969,-30
22033692853,22033692858,5,2280,938,-30
22035336222,22035336227,5,1317,704,-30
22036213380,22036213385,5,2634,1595,-30
22039689162,22039689169,7,2033,1293,-30
22040675816,22040675821,5,2215,1170,-30
22043420635,22043420641,6,2630,1009,-30
22047509811,22047509825,14,1410,1144,-30
22051850943,22051850950,7,2176,971,-30
22052026489,22052026507,18,1161,331,-30
22054131402,22054131407,5,2035,1550,-30
22055667406,22055667413,7,4791,1539,-30
22060394432,22060394437,5,2377,1749,-30
22061702709,22061702714,5,2670,1697,-30
22062032709,22062032689,-20,1820,728,-30
22062655273,22062655278,5,1088,788,-30
22066484217,22066484222,5,1624,1255,-30
22068574836,22068574838,2,1819,1077,-30
22069895762,22069895767,5,1895,1402,-30
22071460909,22071460913,4,1666,1221,-30
22072525525,22072525530,5,1828,1051,-30
22072916575,22072916578,3,1111,1458,-30
22076361399,22076361403,4,2396,1075,-30
22078386878,22078386882,4,2464,1000,-30
22078982781,22078982786,5,2275,1308,-30
22080644753,22080644757,4,1608,1340,-30
22080686166,22080686170,4,1649,1057,-30
22083802151,22083802155,4,1075,1004,-30
22085443101,22085443105,4,2999,1999,-30
22087238786,22087238791,5,1687,981,-30
22088252238,22088252242,4,1608,1228,-30
22091356390,22091356396,6,2536,1659,-30
22092968334,22092968352,18,2010,1302,-30
22100594843,22100594848,5,2782,1374,-30
22103114829,22103114835,6,2861,905,-30
22107535748,22107535736,-12,1913,676,-30
22107700163,22107700169,6,2504,1505,-30
22113994284,22113994289,5,2119,1185,-30
22117235696,22117235690,-6,1865,2759,-30
22120967217,22120967220,3,1430,1023,-30
22122198090,22122198095,5,2563,1024,-30
22126830957,22126830963,6,1458,950,-30
22129658242,22129658246,4,1671,1309,-30
22130311254,22130311259,5,1817,821,-30
22132393580,22132393583,3,2703,1623,-30
22138883071,22138883057,-14,982,5075,-30
22141360489,22141360494,5,1502,933,-30
22148628223,22148628224,1,3346,2766,-30
22152394087,22152394091,4,2187,1073,-30
22163444209,22163444213,4,1784,1086,-30
22175165647,22175165653,6,2602,1373,-30
22177131891,22177131896,5,2248,857,-30
22178006262,22178006266,4,1564,915,-30
22178699111,22178699121,10,1165,746,-30
22180515529,22180515534,5,2559,1790,-30
22184312629,22184312608,-21,1604,962,-30
22190651027,22190651033,6,1605,1022,-30
22194718747,22194718753,6,3170,1029,-30
22195220492,22195220473,-19,1006,710,-30
22195678698,22195678706,8,1610,1312,-30
22199147621,22199147617,-4,1038,1708,-30
22202321367,22202321370,3,2474,1541,-30
22202381941,22202381946,5,1865,1078,-30
22206931788,22206931793,5,2196,1021,-30
22211932066,22211932070,4,2529,1219,-30
22215971656,22215971663,7,3876,1198,-30
22216909974,22216909978,4,1908,1238,-30
22218244451,22218244457,6,2308,1477,-30
22220476662,22220476666,4,1049,1067,-30
22223522409,22223522412,3,1582,1442,-30
22230026471,22230026463,-8,1389,4924,-30
22230989183,22230989183,0,868,1768,-30
22234567288,22234567292,4,2622,1793,-30
22239002328,22239002330,2,2090,1551,-30
22239464595,22239464601,6,2688,1511,-30
22239732023,22239732035,12,2556,1226,-30
22243319983,22243319989,6,2590,1510,-30
22245946448,22245946447,-1,1739,2706,-30
22250289390,22250289395,5,2714,1769,-30
22250789601,22250789606,5,3670,2356,-30
22251748237,22251748241,4,1234,905,-30
22253136571,22253136576,5,2297,1018,-30
22254686428,22254686435,7,1800,1374,-30
22261820610,22261820615,5,2412,1352,-30
22262730033,22262730039,6,2511,1033,-30
22264268719,22264268727,8,2342,1218,-30
22265709313,22265709320,7,3137,1568,-30
22268703367,22268703374,7,1937,1426,-30
22270697874,22270697883,9,14498,30158,-30
22272052577,22272052579,2,1962,1326,-30
22275011694,22275011702,8,3093,1455,-30
22277454748,22277454754,6,1950,1662,-30
22281009727,22281009733,6,2067,1404,-30
22281846432,22281846438,6,2429,1214,-30
22283313533,22283313535,2,1455,1430,-30
22284265964,22284265968,4,1725,1369,-30
22285421793,22285421797,4,2425,1433,-30
22286482330,22286482335,5,2178,1351,-30
22287100301,22287100306,5,2483,1500,-30
22287570885,22287570891,6,1969,1626,-30
22289219370,22289219373,3,1903,1436,-30
22290558392,22290558397,5,2853,1419,-30
22291623869,22291623873,4,2148,1494,-30
22291933413,22291933418,5,2296,847,-30
22293171678,22293171682,4,1999,1302,-30
22294627631,22294627635,4,2449,1613,-30
22298014534,22298014540,6,2125,1363,-30
22299009876,22299009883,7,2187,872,-30
22302558859,22302558861,2,1565,1198,-30
22304976433,22304976437,4,2156,926,-30
22305381985,22305381988,3,21788,30815,-30
22307112886,22307112894,8,3789,764,-30
22307835154,22307835170,16,1903,1161,-30
22313643622,22313643627,5,2617,1184,-30
22314335233,22314335239,6,2348,1283,-30
22314649811,22314649809,-2,36440,19934,-30
22315016195,22315016201,6,2542,1727,-30
22316632814,22316632818,4,1832,1228,-30
22317717643,22317717647,4,1089,855,-30
22321213658,22321213663,5,2191,1041,-30
22322061443,22322061422,-21,1258,1272,-30
22325190340,22325190345,5,1999,1159,-30
22327770965,22327770970,5,2074,953,-30
22328121939,22328121922,-17,1754,1477,-30
22329061302,22329061309,7,2070,994,-30
22330416427,22330416431,4,2417,2113,-30
22332272434,22332272441,7,1812,1708,-30
22333272410,22333272415,5,1996,1369,-30
22333989837,22333989842,5,2697,1880,-30
22340956893,22340956878,-15,1948,1083,-30
22345135189,22345135193,4,2372,1310,-30
22350621869,22350621876,7,2591,1367,-30
22352223475,22352223481,6,2995,1635,-30
22352948718,22352948722,4,2199,1225,-30
22353583731,22353583735,4,1857,1205,-30
22354966611,22354966617,6,2399,1308,-30
22356178040,22356178042,2,900,785,-30
22357813498,22357813504,6,2074,958,-30
22359027674,22359027677,3,1366,1100,-30
22361022238,22361022243,5,2316,1478,-30
22363273643,22363273646,3,2201,848,-30
22364389249,22364389245,-4,1199,2182,-30
22364878323,22364878327,4,1157,752,-30
22365717050,22365717056,6,2199,1238,-30
22366131743,22366131747,4,1525,934,-30
22366365914,22366365919,5,2229,1076,-30
22367631586,22367631577,-9,3,1334,-30
22369460473,22369460478,5,1615,1565,-30
22370477802,22370477806,4,1308,924,-30
22374134802,22374134806,4,1515,1679,-30
22378618799,22378618805,6,2211,1074,-30
22382001485,22382001490,5,2669,1404,-30
22382965242,22382965247,5,1772,961,-30
22383187059,22383187063,4,1556,1142,-30
22385622130,22385622139,9,2782,1516,-30
22386376942,22386376962,20,440,225,-30
22389337460,22389337465,5,2873,1376,-30
22390596549,22390596553,4,2149,1317,-30
22390714251,22390714257,6,1594,1354,-30
22393769657,22393769663,6,2032,1301,-30
22398113477,22398113482,5,2949,1569,-30
22401235669,22401235671,2,1409,735,-30
22407561094,22407561099,5,1873,1032,-30
22408601166,22408601166,0,1213,1493,-30
22410774919,22410774926,7,2285,1586,-30
22413723053,22413723058,5,1369,1276,-30
22419311053,22419311058,5,1994,1507,-30
22420949258,22420949258,0,875,1874,-30
22425066714,22425066718,4,8366,6702,-30
22425586137,22425586143,6,1910,939,-30
22432356041,22432356046,5,3014,1498,-30
22434691190,22434691195,5,1769,1041,-30
22435379505,22435379510,5,2149,943,-30
22437884388,22437884389,1,1520,1837,-30
22439285681,22439285687,6,2344,1111,-30
22439728530,22439728535,5,2539,952,-30
22440998418,22440998422,4,2629,1378,-30
22441355869,22441355852,-17,2525,1125,-30
22442552161,22442552166,5,2226,1249,-30
22444498787,22444498790,3,1874,1036,-30
22447651045,22447651050,5,2379,701,-30
22459585024,22459585023,-1,3022,4196,-30
22463317067,22463317071,4,2103,1490,-30
22464728131,22464728133,2,1655,1890,-30
22465434274,22465434278,4,1173,625,-30
22466764554,22466764559,5,1686,1031,-30
22467497599,22467497606,7,2468,1113,-30
22467954042,22467954050,8,3921,1913,-30
22472855349,22472855353,4,2924,1927,-30
22473191678,22473191686,8,1200,1076,-30
22477729506,22477729511,5,2752,1554,-30
22488428825,22488428831,6,1886,1231,-30
22493803310,22493803308,-2,1676,3994,-30
22494642002,22494642007,5,2447,1478,-30
22502499249,22502499255,6,2546,999,-30
22503194747,22503194744,-3,1903,2668,-30
22504999201,22504999206,5,2144,1142,-30
22514922743,22514922739,-4,1377,2894,-30
22515756721,22515756727,6,7441,3431,-30
22516684067,22516684072,5,2970,1906,-30
22517516413,22517516419,6,2782,1390,-30
22526984764,22526984769,5,1968,1034,-30
22529062894,22529062898,4,2582,1461,-30
22529381063,22529381069,6,2845,1138,-30
22533458643,22533458646,3,1253,1231,-30
22537702894,22537702904,10,9538,42966,-30
22540954122,22540954128,6,2588,1049,-30
22544125894,22544125900,6,8274,2676,-30
22550805546,22550805550,4,2366,1093,-30
22552313285,22552313293,8,3735,1558,-30
22556404338,22556404344,6,2105,851,-30
22559903324,22559903329,5,3526,1568,-30
22565142317,22565142320,3,1841,1032,-30
22565298954,22565298969,15,595,411,-30
22566322242,22566322246,4,1524,1058,-30
22566928009,22566928010,1,1353,1442,-30
22569130781,22569130785,4,2635,1825,-30
22575173542,22575173547,5,1770,1087,-30
22575491068,22575491073,5,2694,1301,-30
22575787867,22575787873,6,1824,874,-30
22576759263,22576759270,7,2013,1541,-30
22577161365,22577161371,6,5372,1741,-30
22582223711,22582223715,4,2183,1233,-30
22582769431,22582769435,4,2342,1306,-30
22584194594,22584194597,3,2024,1649,-30
22587172597,22587172600,3,2129,1360,-30
22588807022,22588807027,5,1858,1214,-30
22589043595,22589043600,5,4707,2869,-30
22590609911,22590609916,5,2694,1672,-30
22594547443,22594547450,7,2221,1171,-30
22594869710,22594869714,4,1957,770,-30
22595998684,22595998689,5,1528,883,-30
22598893350,22598893353,3,1824,1318,-30
22603043895,22603043901,6,2109,903,-30
22604473113,22604473118,5,2455,1522,-30
22604599078,22604599080,2,1137,1330,-30
22617733471,22617733476,5,2165,1345,-30
22620089524,22620089528,4,2588,1395,-30
22622763286,22622763291,5,2523,1788,-30
22625262501,22625262506,5,1855,1871,-30
22628619922,22628619926,4,3819,3079,-30
22629988186,22629988191,5,1304,767,-30
22633283920,22633283924,4,1978,1495,-30
22633807285,22633807289,4,2804,1799,-30
22635287870,22635287849,-21,1625,338,-30
22635389843,22635389847,4,3205,1957,-30
22639113918,22639113923,5,2052,1238,-30
22643914653,22643914657,4,1416,1614,-30
22647925457,22647925461,4,1318,897,-30
22648396114,22648396121,7,2009,1288,-30
22651272386,22651272390,4,2602,1380,-30
22652739910,22652739916,6,3257,1469,-30
22653593874,22653593879,5,2466,1495,-30
22653625664,22653625674,10,1278,1196,-30
22657431925,22657431931,6,1998,1540,-30
22660817554,22660817558,4,2258,1169,-30
22661931186,22661931191,5,2394,1248,-30
22663067916,22663067919,3,1679,1368,-30
22666088326,22666088331,5,1845,865,-30
22667249673,22667249673,0,1491,1344,-30
22668056791,22668056769,-22,578,217,-30
22669808222,22669808227,5,5262,2665,-30
22672895422,22672895425,3,2177,1757,-30
22673859518,22673859522,4,2885,1783,-30
22682568986,22682568991,5,2930,1301,-30
22684634961,22684634954,-7,1014,4186,-30
22685359477,22685359482,5,2077,1291,-30
22686705341,22686705346,5,1598,1152,-30
22689299646,22689299650,4,1480,1377,-30
22689335773,22689335778,5,2384,1578,-30
22691496577,22691496582,5,2216,1180,-30
22694593999,22694594006,7,2623,1338,-30
22695310025,22695310031,6,1987,1401,-30
22696251481,22696251486,5,2346,1099,-30
22696770121,22696770125,4,2340,1560,-30
22698942858,22698942863,5,2056,1531,-30
22700113361,22700113367,6,2135,1282,-30
22701298291,22701298295,4,2686,1722,-30
22702571613,22702571610,-3,1275,3003,-30
22705451677,22705451682,5,1830,1779,-30
22705596463,22705596469,6,981,548,-30
22708078491,22708078503,12,1065,173,-30
22719136698,22719136697,-1,2306,2946,-30
22721590930,22721590935,5,2584,1384,-30
22723152717,22723152722,5,2261,1167,-30
22728232345,22728232353,8,2856,999,-30
22731543978,22731543983,5,2852,1162,-30
22740023306,22740023311,5,2775,1296,-30
22742804042,22742804045,3,1741,1227,-30
22748842014,22748842014,0,1518,1600,-30
22750229205,22750229211,6,1395,1223,-30
22754640354,22754640358,4,1831,1047,-30
22755259482,22755259486,4,2482,1278,-30
22757302407,22757302410,3,2329,1334,-30
22759891433,22759891437,4,1776,1145,-30
22760130962,22760130978,16,397,11,-30
22761246642,22761246646,4,1944,1432,-30
22763052835,22763052841,6,2329,1778,-30
22763707644,22763707647,3,1702,1113,-30
22764758256,22764758259,3,1751,978,-30
22766221510,22766221514,4,1164,646,-30
22768538917,22768538921,4,2494,1364,-30
22770963306,22770963310,4,1917,1633,-30
22771308887,22771308890,3,1442,1520,-30
22774637734,22774637728,-6,2084,8814,-30
22774920073,22774920079,6,2317,827,-30
22780891905,22780891911,6,2517,1288,-30
22786838861,22786838864,3,1966,2061,-30
22791394904,22791394894,-10,1569,767,-30
22793704229,22793704234,5,1921,1218,-30
22793894790,22793894771,-19,3040,1516,-30
22795839346,22795839342,-4,1438,3158,-30
22796748613,22796748618,5,2044,886,-30
22799197603,22799197608,5,2681,1195,-30
22802780182,22802780187,5,2297,1498,-30
22803610898,22803610902,4,2315,1344,-30
22806023169,22806023172,3,2156,1540,-30
22811095197,22811095200,3,1714,1426,-30
22817764721,22817764724,3,2082,1327,-30
22819676500,22819676519,19,475,1586,-30
22821327154,22821327157,3,1941,1126,-30
22823293154,22823293157,3,1359,1636,-30
22823466316,22823466318,2,2004,1764,-30
22823721482,22823721486,4,1694,1166,-30
22826190971,22826190975,4,1466,871,-30
22835066639,22835066642,3,1903,1132,-30
22837553415,22837553421,6,1079,1062,-30
22841275847,22841275851,4,1823,1627,-30
22841672386,22841672393,7,3509,1883,-30
22846385751,22846385758,7,907,459,-30
22853017078,22853017083,5,1783,983,-30
22861427909,22861427914,5,1952,1525,-30
22862051795,22862051803,8,2789,1212,-30
22862994587,22862994587,0,1385,1215,-30
22863615558,22863615562,4,1466,1133,-30
22863903371,22863903377,6,1845,1106,-30
22867210414,22867210418,4,2365,1349,-30
22873224990,22873224994,4,1846,1070,-30
22874899341,22874899341,0,4057,4331,-30
22879036591,22879036598,7,2099,1368,-30
22880878686,22880878690,4,1746,1146,-30
22886703110,22886703115,5,3029,1489,-30
22887488623,22887488626,3,2062,1144,-30
22887753859,22887753851,-8,575,195,-30
22888625031,22888625035,4,2903,1706,-30
22889996254,22889996259,5,4780,1604,-30
22890449979,22890449984,5,2732,1381,-30
22891617447,22891617449,2,7225,20689,-30
22893240015,22893240022,7,3915,1451,-30
22896260782,22896260786,4,2607,1490,-30
22904148869,22904148875,6,2419,1203,-30
22910030788,22910030794,6,2048,1041,-30
22911994652,22911994658,6,1956,1577,-30
22915470026,22915470031,5,1514,866,-30
22916561457,22916561473,16,1576,1005,-30
22917138919,22917138936,17,895,179,-30
22923738581,22923738587,6,2668,1226,-30
22925416588,22925416586,-2,1313,1580,-30
22926354828,22926354831,3,2067,1474,-30
22928317725,22928317730,5,2754,981,-30
22931108725,22931108744,19,2135,1188,-30
22932525544,22932525550,6,2461,1617,-30
22933269859,22933269863,4,2650,1380,-30
22933691272,22933691278,6,2536,1271,-30
22937158165,22937158170,5,2754,1673,-30
22937541329,22937541334,5,2010,1374,-30
22938557241,22938557245,4,2998,1393,-30
22940983662,22940983662,0,28814,1625,-30
22943498278,22943498277,-1,1274,2079,-30
22953885878,22953885887,9,2843,873,-30
22956746767,22956746767,0,2463,2430,-30
22959187441,22959187445,4,1520,1242,-30
22965490513,22965490518,5,2252,1360,-30
22965541710,22965541715,5,1860,1559,-30
22969502702,22969502705,3,2167,1112,-30
22971606073,22971606078,5,2258,1435,-30
22975271722,22975271728,6,1737,1360,-30
22975971666,22975971671,5,1689,1004,-30
22976786599,22976786602,3,2296,1933,-30
22977381606,22977381614,8,2069,1131,-30
22980753543,22980753550,7,3229,1692,-30
22984533482,22984533486,4,1689,1109,-30
22985182634,22985182638,4,2644,1762,-30
22985351693,22985351698,5,2887,1735,-30
22986398830,22986398837,7,1734,1146,-30
22990095270,22990095275,5,2037,1170,-30
22990750378,22990750385,7,2274,962,-30
22991116072,22991116076,4,2272,1342,-30
22993793176,22993793179,3,2355,1280,-30
23000198402,23000198405,3,2488,1308,-30
23000939117,23000939122,5,1544,1053,-30
23001727364,23001727353,-11,651,240,-30
23006523957,23006523962,5,2309,1467,-30
23008716773,23008716777,4,2371,1178,-30
23011225758,23011225762,4,2089,963,-30
23016203750,23016203755,5,1227,1156,-30
23017952099,23017952103,4,3429,1430,-30
23018006283,23018006289,6,3038,1304,-30
23019791735,23019791744,9,5094,1111,-30
23021281245,23021281250,5,2657,1597,-30
23021397415,23021397434,19,548,193,-30
23025923324,23025923328,4,2667,1674,-30
23036402037,23036402045,8,3646,1230,-30
23037667173,23037667179,6,2833,1322,-30
23039118697,23039118685,-12,933,4423,-30
23039226285,23039226290,5,2358,1077,-30
23040363081,23040363085,4,2275,1434,-30
23040868405,23040868410,5,1336,1208,-30
23045300211,23045300215,4,1993,1596,-30
23046193518,23046193515,-3,900,1275,-30
23049384491,23049384497,6,2046,1671,-30
23051684422,23051684426,4,1874,1570,-30
23054667277,23054667283,6,1913,491,-30
23055527500,23055527512,12,2741,1927,-30
23056078817,23056078822,5,3518,1341,-30
23062685502,23062685507,5,2014,1772,-30
23067790158,23067790162,4,1183,821,-30
23072467805,23072467809,4,2116,1428,-30
23075193849,23075193844,-5,1176,3208,-30
23075933046,23075933051,5,1596,1025,-30
23079730702,23079730706,4,1954,1735,-30
23079838513,23079838515,2,1251,1116,-30
23082053168,23082053166,-2,1776,2268,-30
23084021601,23084021606,5,2252,1331,-30
23084164653,23084164649,-4,1217,2077,-30
23088142446,23088142450,4,2108,1384,-30
23088418406,23088418411,5,2348,1211,-30
23088765066,23088765070,4,1269,986,-30
23089963689,23089963695,6,3375,1341,-30
23090647737,23090647738,1,1919,1371,-30
23091166731,23091166736,5,2619,1247,-30
23092626329,23092626335,6,1351,1067,-30
23095001690,23095001695,5,2598,1030,-30
23095140454,23095140434,-20,2301,1301,-30
23097577924,23097577922,-2,2508,3767,-30
23100530503,23100530508,5,2542,1292,-30
23101872936,23101872936,0,1362,874,-30
23101915793,23101915778,-15,1279,624,-30
23105504784,23105504789,5,2821,1056,-30
23109062706,23109062712,6,2173,1432,-30
23109248731,23109248739,8,2654,1086,-30
23111716555,23111716560,5,2365,1223,-30
23115921951,23115921956,5,2145,1506,-30
23116795183,23116795182,-1,1342,1474,-30
23117353879,23117353885,6,1660,942,-30
23120333695,23120333694,-1,814,1220,-30
23121299305,23121299310,5,3274,1227,-30
23124441958,23124441961,3,2094,1159,-30
23125003482,23125003487,5,2949,1448,-30
23126963665,23126963671,6,2251,1574,-30
23128310501,23128310506,5,4438,2332,-30
23128832422,23128832428,6,1946,1805,-30
23134732241,23134732237,-4,1116,3859,-30
23134803183,23134803188,5,2545,1407,-30
23136934579,23136934582,3,1992,1292,-30
23140596711,23140596718,7,3495,1202,-30
23141306406,23141306414,8,2615,1275,-30
23144404362,23144404369,7,1884,903,-30
23150998328,23150998333,5,2792,1148,-30
23151049022,23151049026,4,1716,1008,-30
23152091579,23152091582,3,2216,1700,-30
23154514705,23154514703,-2,1114,2033,-30
23155602734,23155602734,0,4618,6108,-30
23157344721,23157344727,6,2234,1607,-30
23157499406,23157499410,4,1713,1089,-30
23161960733,23161960736,3,1502,1498,-30
23165702022,23165702027,5,1959,1385,-30
23166873677,23166873682,5,2010,1532,-30
23167733694,23167733701,7,2362,1428,-30
23169267398,23169267403,5,1890,1735,-30
23175299511,23175299511,0,1156,1301,-30
23176907988,23176907981,-7,1521,3543,-30
23177060563,23177060567,4,1966,1237,-30
23178345354,23178345360,6,2357,1138,-30
23180384570,23180384575,5,1575,1040,-30
23180621095,23180621094,-1,1673,3096,-30
23184112239,23184112245,6,1446,606,-30
23185158118,23185158123,5,1452,1164,-30
23188558133,23188558135,2,2914,2462,-30
23190538648,23190538653,5,2791,1429,-30
23192392439,23192392442,3,1834,1386,-30
23193705960,23193705962,2,2186,1624,-30
23193844337,23193844322,-15,2514,1553,-30
23193999490,23193999499,9,2724,1367,-30
23195224529,23195224535,6,2144,1339,-30
23195251321,23195251325,4,1975,1260,-30
23196450474,23196450479,5,1561,1331,-30
23196575373,23196575377,4,2223,1395,-30
23196690942,23196690949,7,2440,942,-30
23197760026,23197760031,5,1260,614,-30
23202518232,23202518237,5,2584,1301,-30
23203101165,23203101169,4,2494,2047,-30
23204532468,23204532473,5,2020,1434,-30
23206855293,23206855298,5,2896,1788,-30
23216547465,23216547471,6,1373,873,-30
23219570372,23219570377,5,1975,1003,-30
23219923531,23219923530,-1,1359,2181,-30
23220740162,23220740183,21,2313,1356,-30
23221628663,23221628667,4,2398,1197,-30
23224796608,23224796614,6,1896,1151,-30
23232127544,23232127550,6,1084,500,-30
23234386594,23234386597,3,2510,1223,-30
23234526180,23234526202,22,1594,1330,-30
23234855009,23234855014,5,1502,1174,-30
23237904761,23237904761,0,4345,14921,-30
23247115077,23247115081,4,2319,1740,-30
23249575185,23249575190,5,2018,1317,-30
23249947013,23249947014,1,2058,1845,-30
23252103466,23252103471,5,2319,967,-30
23254518541,23254518545,4,2065,1297,-30
23256711550,23256711557,7,2380,1308,-30
23258633574,23258633579,5,1404,1176,-30
23259379529,23259379535,6,2267,1589,-30
23260897810,23260897814,4,2129,1097,-30
23261200875,23261200860,-15,2642,859,-30
23263260229,23263260234,5,1857,752,-30
23263899789,23263899794,5,3154,1575,-30
23267786658,23267786664,6,2328,904,-30
23267908865,23267908869,4,2841,1378,-30
23270779325,23270779330,5,2745,1417,-30
23270877075,23270877079,4,2202,1539,-30
23271517604,23271517606,2,1584,1833,-30
23273676622,23273676627,5,1992,1179,-30
23274050535,23274050541,6,3144,1826,-30
23274991223,23274991227,4,2846,1896,-30
23276369288,23276369292,4,2536,1211,-30
23279706802,23279706806,4,1527,1148,-30
23279893380,23279893386,6,2323,1480,-30
23280273914,23280273907,-7,574,297,-30
23280936841,23280936845,4,2441,1522,-30
23281182434,23281182437,3,1957,1580,-30
23293050274,23293050279,5,2217,1317,-30
23293867514,23293867520,6,1589,932,-30
23300714329,23300714335,6,1582,1133,-30
23302712990,23302712996,6,2631,1601,-30
23303112810,23303112814,4,2016,1470,-30
23303862746,23303862753,7,3058,1762,-30
23305499865,23305499871,6,2817,1929,-30
23306782665,23306782670,5,2112,1213,-30
23308003767,23308003773,6,2677,1168,-30
23322151421,23322151435,14,230,516,-30
23327389017,23327389023,6,1790,1108,-30
23329228658,23329228665,7,1374,857,-30
23329268071,23329268052,-19,1191,522,-30
23332535699,23332535706,7,3888,1180,-30
23339913454,23339913458,4,2859,1514,-30
23342429966,23342429971,5,2021,880,-30
23345394582,23345394586,4,3027,1647,-30
23347194424,23347194430,6,1640,1293,-30
23353199855,23353199857,2,1535,1807,-30
23359079359,23359079363,4,1344,1323,-30
23373234775,23373234756,-19,1811,1106,-30
23378679934,23378679935,1,2338,1866,-30
23380793213,23380793219,6,2640,1157,-30
23380937014,23380937017,3,1062,1909,-30
23381736046,23381736052,6,2570,1505,-30
23390378424,23390378422,-2,2994,4813,-30
23390823629,23390823635,6,2963,1225,-30
23393855198,23393855203,5,2556,1464,-30
23394123405,23394123413,8,3182,1508,-30
23395263572,23395263577,5,2407,2167,-30
23399269006,23399269011,5,2423,1164,-30
23401619565,23401619566,1,1847,1058,-30
23404366061,23404366066,5,2303,1251,-30
23405058167,23405058173,6,2072,1906,-30
23407030537,23407030537,0,937,1043,-30
23408011162,23408011156,-6,1531,2135,-30
23411644125,23411644121,-4,3215,7223,-30
23412350997,23412351001,4,2835,1719,-30
23414502917,23414502922,5,2119,1198,-30
23414603889,23414603893,4,1838,1279,-30
23418226727,23418226732,5,3376,1892,-30
23420482853,23420482858,5,1840,1452,-30
23424578976,23424578984,8,3756,1584,-30
23426187757,23426187761,4,2357,1381,-30
23428885584,23428885589,5,1989,1086,-30
23432180218,23432180226,8,5605,2169,-30
23436319503,23436319510,7,2520,1403,-30
23448508853,23448508855,2,1797,1593,-30
23449104254,23449104258,4,1488,945,-30
23449446859,23449446863,4,2371,1230,-30
23450885534,23450885539,5,2157,1168,-30
23454728327,23454728331,4,2146,1670,-30
23455156988,23455156990,2,1847,1137,-30
23459470988,23459470994,6,2182,1536,-30
23460585963,23460585966,3,1485,1245,-30
23463632848,23463632852,4,1678,1700,-30
23468421825,23468421830,5,2302,1633,-30
23471494762,23471494767,5,3036,1528,-30
23472228297,23472228302,5,2635,1702,-30
23472317026,23472317030,4,2096,1249,-30
23473396544,23473396547,3,1509,1153,-30
23473614342,23473614342,0,1662,1758,-30
23473809380,23473809383,3,2238,1165,-30
23473864473,23473864475,2,1385,1967,-30
23484791578,23484791582,4,1884,1239,-30
23485586781,23485586787,6,1408,1239,-30
23491143387,23491143392,5,1536,1267,-30
23494810690,23494810695,5,2454,1025,-30
23499434895,23499434899,4,1992,788,-30
23499864462,23499864466,4,2842,1737,-30
23502696677,23502696681,4,3357,1765,-30
23504070709,23504070714,5,2844,1314,-30
23504898144,23504898149,5,2146,1318,-30
23505705600,23505705601,1,1655,1470,-30
23506733158,23506733163,5,2796,1508,-30
23508043654,23508043659,5,1816,1454,-30
23518102910,23518102913,3,1471,889,-30
23519072773,23519072765,-8,1620,9643,-30
23519179414,23519179421,7,2172,868,-30
23523300953,23523300957,4,2845,1451,-30
23523341382,23523341386,4,2478,1534,-30
23523553274,23523553280,6,1924,844,-30
23526754594,23526754600,6,1422,978,-30
23527648230,23527648235,5,2319,1218,-30
23528071442,23528071446,4,2816,1446,-30
23530961206,23530961210,4,2178,1188,-30
23532469827,23532469824,-3,1332,3619,-30
23532702501,23532702506,5,3226,1265,-30
23536147875,23536147879,4,1386,1276,-30
23536717145,23536717151,6,1893,1091,-30
23539128601,23539128606,5,2120,1405,-30
23541817945,23541817947,2,1985,1541,-30
23542497379,23542497385,6,3349,1555,-30
23548023777,23548023782,5,1674,879,-30
23548369872,23548369878,6,3002,1705,-30
23550340318,23550340322,4,2284,1685,-30
23551944182,23551944186,4,2585,1397,-30
23555055636,23555055640,4,1674,1747,-30
23560485500,23560485503,3,1150,609,-30
23564761899,23564761903,4,1975,865,-30
23567677907,23567677911,4,2225,1632,-30
23571270958,23571270963,5,2700,1706,-30
23574270773,23574270771,-2,838,987,-30
23577399146,23577399151,5,3196,1531,-30
23578199371,23578199375,4,2197,1259,-30
23578912073,23578912078,5,1661,1148,-30
23581536040,23581536046,6,3368,1938,-30
23581774174,23581774193,19,2502,1444,-30
23585156176,23585156181,5,2078,1511,-30
23585922093,23585922098,5,2184,1139,-30
23586542602,23586542617,15,2298,1369,-30
23587019057,23587019044,-13,1991,791,-30
23588310875,23588310881,6,2171,1177,-30
23589225286,23589225286,0,1452,2409,-30
23598325598,23598325603,5,2305,1344,-30
23599053740,23599053742,2,2063,965,-30
23599632777,23599632782,5,2406,1464,-30
23601885930,23601885934,4,2369,1426,-30
23603435806,23603435811,5,2063,1374,-30
23604848111,23604848093,-18,1325,1221,-30
23610118962,23610118965,3,2126,1460,-30
23613379509,23613379515,6,1546,1224,-30
23615251916,23615251922,6,2092,1205,-30
23618320933,23618320938,5,1677,1336,-30
23619041990,23619041995,5,2500,1722,-30
23623965026,23623965031,5,2255,1123,-30
23624439893,23624439915,22,2462,1521,-30
23628120823,23628120829,6,2519,1553,-30
23629930294,23629930299,5,2814,1128,-30
23633357361,23633357369,8,3424,1640,-30
23635561746,23635561750,4,2040,1339,-30
23638060426,23638060432,6,3177,1692,-30
23638400964,23638400969,5,2327,1870,-30
23641813183,23641813186,3,2434,1255,-30
23643187070,23643187075,5,2434,1334,-30
23643725977,23643725996,19,1453,721,-30
23647291482,23647291487,5,1991,1282,-30
23647564319,23647564337,18,2525,1932,-30
23648347493,23648347500,7,1714,1006,-30
23652716190,23652716204,14,2315,1315,-30
23659593905,23659593898,-7,1654,5674,-30
23661618134,23661618138,4,1936,1142,-30
23671570593,23671570598,5,1276,1229,-30
23673341157,23673341161,4,2056,1420,-30
23675137974,23675137982,8,2023,1102,-30
23678364582,23678364586,4,2212,1364,-30
23682257499,23682257505,6,2289,1567,-30
23682476909,23682476891,-18,1467,736,-30
23683527416,23683527422,6,2466,1881,-30
23684342302,23684342307,5,1932,930,-30
23688192825,23688192830,5,2599,1174,-30
23693973113,23693973106,-7,1248,5983,-30
23697274246,23697274252,6,1960,1705,-30
23697370034,23697370039,5,2397,1193,-30
23697720103,23697720122,19,3821,1369,-30
23702782762,23702782765,3,4365,3150,-30
23703020866,23703020871,5,2334,1361,-30
23707574666,23707574671,5,2121,1080,-30
23714770716,23714770721,5,2093,1378,-30
23716818947,23716818951,4,1801,1340,-30
23719606785,23719606790,5,2553,1137,-30
23720249063,23720249049,-14,2273,662,-30
23729872886,23729872891,5,2545,1319,-30
23731548453,23731548457,4,1992,1146,-30
23733538774,23733538755,-19,2269,1544,-30
23734036463,23734036469,6,2385,1134,-30
23736041202,23736041207,5,2208,1016,-30
23737937654,23737937658,4,1345,869,-30
23742785135,23742785142,7,2000,1459,-30
23744652265,23744652272,7,2455,1459,-30
23756901374,23756901374,0,9639,15370,-30
23757236395,23757236399,4,1339,1011,-30
23767006361,23767006362,1,1494,1829,-30
23768517180,23768517182,2,1859,1483,-30
23768908126,23768908134,8,2680,1187,-30
23769556091,23769556097,6,1774,1744,-30
23777831295,23777831299,4,2284,1157,-30
23779061508,23779061513,5,2541,641,-30
23781725149,23781725154,5,1935,1161,-30
23785468387,23785468392,5,1916,1133,-30
23789336785,23789336791,6,2319,1767,-30
23793729390,23793729395,5,2007,1355,-30
23794120670,23794120677,7,1750,1565,-30
23794232310,23794232314,4,2331,1272,-30
23794826789,23794826768,-21,2652,1614,-30
23799389710,23799389715,5,1162,722,-30
23799740490,23799740472,-18,1757,1135,-30
23800600101,23800600106,5,1856,1332,-30
23802423013,23802423012,-1,1960,4112,-30
23806748665,23806748671,6,1705,1187,-30
23811770232,23811770237,5,1858,1139,-30
23812083571,23812083576,5,2444,1066,-30
23813066429,23813066433,4,2030,834,-30
23813559154,23813559158,4,2077,1419,-30
23814287798,23814287803,5,2154,1395,-30
23814580166,23814580147,-19,1816,933,-30
23822865525,23822865530,5,2133,2003,-30
23824027956,23824027961,5,2300,1196,-30
23826263230,23826263235,5,1585,1102,-30
23828063177,23828063182,5,1922,1617,-30
23828500614,23828500617,3,2715,1653,-30
23829790164,23829790170,6,2959,1486,-30
23830044998,23830044979,-19,1134,611,-30
23830314031,23830314035,4,2063,1333,-30
23831299549,23831299553,4,2330,1376,-30
23835556607,23835556614,7,2298,1728,-30
23836927207,23836927212,5,2266,1581,-30
23838195522,23838195527,5,1682,1381,-30
23841504107,23841504111,4,2146,1296,-30
23842426305,23842426310,5,2155,1020,-30
23847525412,23847525415,3,2032,1314,-30
23850229932,23850229937,5,2490,1135,-30
23850373845,23850373867,22,1632,751,-30
23851854092,23851854099,7,3007,1615,-30
23852182663,23852182667,4,3448,1294,-30
23857220714,23857220719,5,2192,1031,-30
23859050146,23859050151,5,2505,1559,-30
23869646455,23869646463,8,1823,1204,-30
23870733887,23870733893,6,2318,1162,-30
23872743038,23872743043,5,2510,1087,-30
23876640031,23876640035,4,1988,1093,-30
23877929370,23877929375,5,3440,1564,-30
23879646202,23879646207,5,2453,1129,-30
23880721361,23880721366,5,2928,1260,-30
23881277114,23881277119,5,1967,892,-30
23881874756,23881874736,-20,1578,1105,-30
23885747818,23885747822,4,1809,1002,-30
23887821474,23887821478,4,2059,1444,-30
23889933748,23889933751,3,1482,1412,-30
23890148093,23890148099,6,2305,1286,-30
23894516177,23894516184,7,2836,1230,-30
23894829226,23894829228,2,1517,2027,-30
23897512118,23897512125,7,2722,1551,-30
23898628975,23898628979,4,2658,1297,-30
23899728436,23899728442,6,2139,756,-30
23900141893,23900141895,2,2570,1609,-30
23900428465,23900428469,4,2317,1557,-30
23901048834,23901048839,5,1650,1002,-30
23906380173,23906380179,6,1602,910,-30
23907444646,23907444651,5,2488,1191,-30
23916676211,23916676205,-6,31085,6413,-30
23918413422,23918413429,7,1824,1288,-30
23918801085,23918801091,6,1946,1079,-30
23920318482,23920318471,-11,776,784,-30
23920736385,23920736371,-14,1175,1030,-30
23921775255,23921775259,4,2218,1160,-30
23922429335,23922429332,-3,879,149,-30
23923191098,23923191101,3,1743,1088,-30
23925732836,23925732841,5,1623,1197,-30
23926834380,23926834387,7,2127,1345,-30
23931088871,23931088878,7,2078,1283,-30
23931217893,23931217875,-18,1567,1118,-30
23931986291,23931986293,2,1898,1533,-30
23936141765,23936141770,5,3293,1743,-30
23936954099,23936954103,4,2414,1504,-30
23937410276,23937410281,5,1946,1360,-30
23938757913,23938757918,5,2912,1452,-30
23940870013,23940870017,4,2564,1923,-30
23942203469,23942203474,5,1576,778,-30
23942645694,23942645676,-18,2553,1466,-30
23947694591,23947694594,3,1598,1351,-30
23962106370,23962106375,5,2872,1656,-30
23962426605,23962426611,6,2171,1501,-30
23963719780,23963719783,3,1775,1315,-30
23964172212,23964172217,5,2337,1473,-30
23965796479,23965796482,3,2192,1551,-30
23974054935,23974054942,7,3837,1631,-30
23974833255,23974833261,6,2471,1043,-30
23980547812,23980547817,5,2052,1284,-30
23982844646,23982844654,8,2814,1557,-30
23987633763,23987633769,6,3474,1604,-30
23988073573,23988073577,4,1880,1389,-30
23988664335,23988664339,4,2768,1342,-30
23989268059,23989268063,4,1390,1019,-30
23991656393,23991656394,1,1795,1816,-30
23992052592,23992052597,5,2148,1536,-30
23993331010,23993331004,-6,1713,6287,-30
23993762498,23993762502,4,1930,1142,-30
23996651085,23996651090,5,2273,1776,-30
23999082570,23999082575,5,1990,1182,-30
24001498998,24001499004,6,3177,2162,-30
24002870574,24002870581,7,2261,1245,-30
24006013973,24006013978,5,2065,980,-30
24006761570,24006761576,6,2790,1978,-30
24007105809,24007105813,4,1417,1225,-30
24007200586,24007200606,20,475,2848,-30
24008771419,24008771426,7,2176,1147,-30
24010587818,24010587823,5,3005,1788,-30
24014544350,24014544356,6,2704,1438,-30
24015465703,24015465689,-14,627,316,-30
24016120242,24016120250,8,1360,729,-30
24018562532,24018562512,-20,1391,1284,-30
24020154773,24020154778,5,1980,1386,-30
24022548570,24022548577,7,3034,1394,-30
24026048805,24026048812,7,2004,1043,-30
24026161698,24026161684,-14,1668,961,-30
24026308618,24026308596,-22,1706,1235,-30
24030474331,24030474335,4,2810,1467,-30
24031512521,24031512526,5,1886,1547,-30
24035774441,24035774446,5,1978,1632,-30
24036577928,24036577934,6,1946,912,-30
24036677523,24036677506,-17,686,342,-30
24038732496,24038732497,1,1682,2393,-30
24038981850,24038981832,-18,852,384,-30
24041317853,24041317859,6,2606,1051,-30
24042663326,24042663327,1,1272,1312,-30
24044030595,24044030598,3,2755,1586,-30
24045713257,24045713259,2,2201,1145,-30
24046681072,24046681078,6,2191,1718,-30
24050583414,24050583418,4,2784,1599,-30
24054645376,24054645382,6,3540,1677,-30
24055529790,24055529799,9,3642,956,-30
24057641830,24057641835,5,3167,2213,-30
24057928408,24057928414,6,2535,1580,-30
24065792311,24065792315,4,2571,1539,-30
24068923245,24068923249,4,2528,1304,-30
24070349981,24070349983,2,1726,1362,-30
24071129857,24071129862,5,2166,1276,-30
24072207054,24072207059,5,2076,1353,-30
24074707408,24074707410,2,1682,1329,-30
24076085573,24076085574,1,1226,1085,-30
24077343230,24077343235,5,2466,1217,-30
24077755889,24077755894,5,2042,1186,-30
24083375291,24083375298,7,1890,1165,-30
24085562614,24085562618,4,1329,977,-30
24086197751,24086197756,5,2158,1076,-30
24086679545,24086679555,10,2229,1092,-30
24086729303,24086729310,7,995,549,-30
24091053711,24091053711,0,1042,1423,-30
24093264055,24093264058,3,1772,1064,-30
24094387751,24094387753,2,3385,2860,-30
24096245121,24096245125,4,1971,1187,-30
24097603737,24097603718,-19,1252,689,-30
24098683897,24098683893,-4,1453,4093,-30
24100416884,24100416889,5,2202,1292,-30
24103298883,24103298887,4,1819,1012,-30
24103455597,24103455603,6,1842,1147,-30
24108096139,24108096147,8,1766,1056,-30
24110582045,24110582049,4,2095,1855,-30
24111067305,24111067325,20,1040,254,-30
24111815829,24111815811,-18,1879,753,-30
24115352712,24115352719,7,2849,1304,-30
24117926548,24117926554,6,5684,2544,-30
24118602563,24118602570,7,2529,1295,-30
24120013734,24120013738,4,2021,1449,-30
24120386981,24120386986,5,1909,1177,-30
24122176009,24122176016,7,2040,1386,-30
24124654898,24124654902,4,2475,1340,-30
24128131902,24128131908,6,2291,1545,-30
24128283316,24128283320,4,1705,1566,-30
24128659901,24128659907,6,2204,1217,-30
24130580673,24130580675,2,2515,1878,-30
24132354603,24132354603,0,1190,1576,-30
24133558113,24133558117,4,2375,1412,-30
24133833964,24133833948,-16,934,303,-30
24136721166,24136721172,6,2575,1258,-30
24138367657,24138367661,4,2351,1699,-30
24139809943,24139809949,6,2150,1576,-30
24144390070,24144390075,5,2795,1107,-30
24144645324,24144645315,-9,1069,188,-30
24147205472,24147205474,2,1931,1295,-30
24152310199,24152310204,5,1983,1414,-30
24152426254,24152426233,-21,2031,1544,-30
24153842385,24153842390,5,3101,1265,-30
24154171694,24154171698,4,1805,921,-30
24154712917,24154712920,3,3546,2682,-30
24154961343,24154961346,3,1977,1363,-30
24162102621,24162102620,-1,3105,5813,-30
24162699295,24162699300,5,2596,1879,-30
24167200306,24167200312,6,2433,1222,-30
24168745039,24168745041,2,2117,1902,-30
24169907119,24169907125,6,2016,1213,-30
24171457309,24171457313,4,1696,1393,-30
24172265966,24172265970,4,1080,747,-30
24173672638,24173672643,5,3078,1170,-30
24174559482,24174559488,6,2466,1216,-30
24178605708,24178605713,5,1992,1288,-30
24179352427,24179352433,6,1847,866,-30
24181484814,24181484821,7,2553,1077,-30
24181672202,24181672188,-14,964,263,-30
24181925622,24181925622,0,1212,1753,-30
24184270461,24184270465,4,1778,1351,-30
24192975310,24192975323,13,3163,1154,-30
24193013305,24193013308,3,2336,1538,-30
24194972158,24194972164,6,3253,2323,-30
24195820858,24195820862,4,2985,1487,-30
24197314793,24197314798,5,1762,1331,-30
24200243303,24200243307,4,1929,977,-30
24201084966,24201084967,1,1667,1677,-30
24201721117,24201721110,-7,956,3030,-30
24207572382,24207572388,6,2482,1315,-30
24208727742,24208727746,4,1659,944,-30
24210447701,24210447703,2,1733,1548,-30
24214845169,24214845174,5,2827,1785,-30
24219911153,24219911159,6,1820,1449,-30
24223291322,24223291330,8,12936,26438,-30
24223334442,24223334447,5,2709,1414,-30
24223672075,24223672081,6,2537,1667,-30
24224474241,24224474247,6,2610,1444,-30
24225912042,24225912045,3,929,933,-30
24229395055,24229395060,5,1827,1698,-30
24233185654,24233185662,8,2905,1152,-30
24238291840,24238291846,6,1617,1433,-30
24239009622,24239009608,-14,2570,928,-30
24240278185,24240278190,5,2630,1907,-30
24240428320,24240428306,-14,2059,1192,-30
24241908825,24241908830,5,2063,1052,-30
24242532891,24242532895,4,1638,1032,-30
24242858849,24242858854,5,2558,1391,-30
24249622132,24249622138,6,2182,1455,-30
24254463893,24254463889,-4,830,2445,-30
24256959015,24256959019,4,5547,3091,-30
24258451099,24258451105,6,2406,1710,-30
24258697758,24258697762,4,2473,1178,-30
24258856190,24258856195,5,1843,1262,-30
24260464595,24260464602,7,1796,1048,-30
24261094777,24261094795,18,2044,1425,-30
24261279394,24261279377,-17,1350,504,-30
24264858938,24264858943,5,2655,1263,-30
24266675327,24266675332,5,750,415,-30
24269028358,24269028376,18,685,245,-30
24269236300,24269236305,5,2453,1418,-30
24273851998,24273852003,5,2850,1256,-30
24275953219,24275953222,3,2030,1579,-30
24277404994,24277404993,-1,1973,1759,-30
24286582273,24286582281,8,4050,1701,-30
24290995701,24290995707,6,2703,1299,-30
24291940906,24291940909,3,2441,1703,-30
24294603926,24294603931,5,2008,1033,-30
24297834468,24297834474,6,2077,1164,-30
24298931983,24298931985,2,1398,1301,-30
24302257823,24302257827,4,1460,1384,-30
24302754731,24302754734,3,1429,1209,-30
24305830473,24305830477,4,2091,2156,-30
24308465348,24308465353,5,2000,1711,-30
24309371586,24309371569,-17,2481,993,-30
24309669478,24309669483,5,2135,1993,-30
24311641165,24311641170,5,2036,1320,-30
24312640052,24312640057,5,2455,1145,-30
24314025718,24314025721,3,1612,1010,-30
24314398895,24314398901,6,1903,1156,-30
24314849273,24314849260,-13,3024,967,-30
24316671203,24316671205,2,2228,1860,-30
24316720562,24316720569,7,2440,1308,-30
24317073797,24317073802,5,2286,834,-30
24319855546,24319855542,-4,2491,3815,-30
24324602955,24324602960,5,2418,1359,-30
24324636090,24324636095,5,2347,1333,-30
24325967949,24325967954,5,1144,1060,-30
24327090074,24327090081,7,3892,1548,-30
24327346409,24327346414,5,2292,1549,-30
24333271869,24333271875,6,2045,1555,-30
24334112381,24334112386,5,1955,1027,-30
24336562977,24336562971,-6,1162,4645,-30
24337112307,24337112313,6,3247,1724,-30
24338734890,24338734895,5,1695,983,-30
24342487229,24342487235,6,2439,1335,-30
24348581673,24348581679,6,1623,713,-30
24348738562,24348738567,5,1309,1100,-30
24349035298,24349035303,5,2846,1611,-30
24349494873,24349494879,6,2883,914,-30
24350390222,24350390227,5,1810,895,-30
24350561123,24350561130,7,1333,1172,-30
24351268442,24351268459,17,1431,412,-30
24354239213,24354239217,4,1544,1177,-30
24356611917,24356611923,6,1886,1318,-30
24361307820,24361307823,3,1893,1686,-30
24366692443,24366692450,7,2005,1521,-30
24374640234,24374640238,4,2052,1478,-30
24375311238,24375311240,2,2544,1445,-30
24375847094,24375847099,5,2527,1570,-30
24376771077,24376771082,5,2462,1331,-30
24377338628,24377338612,-16,1449,698,-30
24390077410,24390077415,5,1398,746,-30
24391464572,24391464578,6,2364,1507,-30
24393073777,24393073782,5,2149,1434,-30
24393103535,24393103540,5,1741,849,-30
24393379394,24393379380,-14,1496,694,-30
24397217104,24397217110,6,1850,1529,-30
24399254536,24399254539,3,1848,1284,-30
24400081803,24400081802,-1,1653,2594,-30
24400545866,24400545870,4,1522,1131,-30
24400989373,24400989362,-11,669,340,-30
24403747231,24403747235,4,1532,1238,-30
24404402061,24404402067,6,1832,1658,-30
24406495819,24406495823,4,1784,1083,-30
24411939006,24411939011,5,2119,1149,-30
24412962017,24412962019,2,2449,1062,-30
24416564741,24416564746,5,2690,1414,-30
24419593522,24419593525,3,1825,1492,-30
24421427227,24421427234,7,4036,1613,-30
24421823963,24421823971,8,2988,1430,-30
24424416680,24424416683,3,1757,1620,-30
24427077396,24427077401,5,2611,1695,-30
24429417254,24429417260,6,2929,1247,-30
24430725682,24430725686,4,2189,1768,-30
24431307950,24431307955,5,1726,1196,-30
24436387814,24436387817,3,1428,1717,-30
24440566305,24440566306,1,1265,1837,-30
24441047309,24441047314,5,3071,1462,-30
24441161400,24441161388,-12,2379,1086,-30
24442923806,24442923811,5,2142,977,-30
24448837971,24448837974,3,2229,1574,-30
24455220662,24455220666,4,2107,1181,-30
24456620814,24456620818,4,958,738,-30
24456960270,24456960277,7,2878,1860,-30
24460578861,24460578866,5,2267,1801,-30
24462010469,24462010474,5,4233,1749,-30
24462707280,24462707278,-2,1353,3193,-30
24463143475,24463143479,4,1317,912,-30
24463779829,24463779810,-19,1547,694,-30
24464068767,24464068774,7,1949,1507,-30
24466750891,24466750895,4,1841,1439,-30
24473158579,24473158585,6,2868,1284,-30
24477106785,24477106790,5,2090,1326,-30
24478883193,24478883195,2,1481,1940,-30
24480571217,24480571221,4,1902,1223,-30
24482708337,24482708342,5,1511,701,-30
24484235859,24484235864,5,2399,1204,-30
24484267636,24484267616,-20,2315,1184,-30
24491915787,24491915792,5,2191,1717,-30
24492103669,24492103688,19,590,222,-30
24493065101,24493065108,7,2448,1580,-30
24493245498,24493245502,4,2595,1470,-30
24496143062,24496143068,6,2735,1457,-30
24496361722,24496361730,8,854,1216,-30
24498025927,24498025933,6,2988,1114,-30
24501177690,24501177697,7,2582,1363,-30
24507217922,24507217930,8,3431,2007,-30
24507645675,24507645680,5,2315,1370,-30
24507972266,24507972252,-14,860,235,-30
24509650798,24509650806,8,11600,31413,-30
24509870384,24509870392,8,1404,1235,-30
24510551490,24510551495,5,2202,888,-30
24511767755,24511767759,4,2388,1025,-30
24512297848,24512297854,6,2020,1253,-30
24514448283,24514448286,3,1838,1290,-30
24514485262,24514485264,2,2255,2419,-30
24520095910,24520095911,1,542,308,-30
24520722386,24520722391,5,1540,1072,-30
24521853994,24521853997,3,1915,1365,-30
24523231157,24523231164,7,3121,1021,-30
24524409418,24524409422,4,1435,1460,-30
24524840929,24524840935,6,2941,1522,-30
24527137873,24527137875,2,2484,1091,-30
24528306227,24528306231,4,2406,1703,-30
24528700866,24528700871,5,2194,1258,-30
24539547128,24539547134,6,2828,1694,-30
24541001799,24541001805,6,1908,1479,-30
24547206816,24547206822,6,2327,1016,-30
24548006653,24548006658,5,1952,1099,-30
24548430021,24548430025,4,1640,1301,-30
24548791602,24548791588,-14,1950,873,-30
24548919338,24548919343,5,1788,902,-30
24554892149,24554892154,5,2658,1063,-30
24563528326,24563528332,6,2715,1435,-30
24565999869,24565999875,6,2275,950,-30
24567649034,24567649038,4,1838,1252,-30
24570242574,24570242582,8,3240,890,-30
24571401198,24571401203,5,4880,2486,-30
24578170277,24578170281,4,2695,1461,-30
24580026435,24580026442,7,2509,1432,-30
24582747317,24582747318,1,517,884,-30
24584465627,24584465631,4,1816,1626,-30
24584819530,24584819531,1,1661,1380,-30
24587633089,24587633095,6,2433,888,-30
24587813662,24587813641,-21,2194,1004,-30
24589610388,24589610394,6,2718,1624,-30
24589704077,24589704082,5,2185,1174,-30
24594251022,24594251028,6,2123,1450,-30
24599891449,24599891454,5,3443,1760,-30
24600244695,24600244698,3,1358,1070,-30
24600860588,24600860593,5,2096,1377,-30
24600996587,24600996601,14,3719,1375,-30
24603008079,24603008084,5,2105,1240,-30
24604340138,24604340142,4,2211,1208,-30
24611944589,24611944608,19,326,1461,-30
24612063549,24612063529,-20,2229,1015,-30
24613822314,24613822319,5,2257,746,-30
24615246218,24615246221,3,1726,806,-30
24622651492,24622651495,3,1954,1253,-30
24625741343,24625741349,6,2733,1547,-30
24628829559,24628829566,7,2730,1202,-30
24635066582,24635066586,4,1963,1298,-30
24635328347,24635328350,3,1086,1250,-30
24636456575,24636456578,3,1772,1297,-30
24636682749,24636682731,-18,2132,1664,-30
24637812133,24637812137,4,2495,1902,-30
24644744154,24644744159,5,2326,1310,-30
24645003889,24645003890,1,2864,2059,-30
24649504189,24649504193,4,2068,1471,-30
24653793291,24653793297,6,2932,1468,-30
24653844934,24653844939,5,2535,1442,-30
24657204907,24657204911,4,1983,903,-30
24657335989,24657335993,4,1639,1108,-30
24660239372,24660239374,2,2282,2170,-30
24661646749,24661646755,6,2268,1050,-30
24667714638,24667714642,4,1643,831,-30
24668657826,24668657830,4,3056,2032,-30
24671082850,24671082854,4,2619,1279,-30
24671816766,24671816773,7,3214,1784,-30
24672532500,24672532500,0,4808,17927,-30
24673033430,24673033435,5,2462,1145,-30
24674479523,24674479526,3,2087,1230,-30
24677256418,24677256423,5,2303,1699,-30
24677777818,24677777796,-22,956,2253,-30
24678283267,24678283271,4,3417,1878,-30
24679689709,24679689715,6,1615,1234,-30
24680920233,24680920238,5,2455,965,-30
24681776725,24681776728,3,1733,1560,-30
24682524454,24682524460,6,2546,1358,-30
24683140894,24683140896,2,1227,651,-30
24684806931,24684806916,-15,1467,741,-30
24685844637,24685844639,2,2065,1891,-30
24693956168,24693956173,5,2221,1787,-30
24694501618,24694501623,5,2392,950,-30
24694976678,24694976681,3,1428,984,-30
24701657829,24701657835,6,2300,1354,-30
24705045494,24705045499,5,3068,1578,-30
24714759566,24714759571,5,2189,1553,-30
24719104855,24719104861,6,4390,3018,-30
24721837282,24721837286,4,3065,1852,-30
24722187308,24722187304,-4,1964,4320,-30
24722409970,24722409964,-6,1794,5390,-30
24725859298,24725859294,-4,1235,4463,-30
24725919648,24725919653,5,2038,1148,-30
24726170434,24726170438,4,1556,884,-30
24728314498,24728314498,0,1546,2782,-30
24731598237,24731598242,5,2119,1389,-30
24732924886,24732924891,5,2364,1177,-30
24733181966,24733181970,4,3006,1135,-30
24734028501,24734028506,5,1431,765,-30
24736284633,24736284636,3,1935,1232,-30
24738113397,24738113411,14,609,321,-30
24741713074,24741713082,8,1749,1316,-30
24751616453,24751616459,6,2307,1432,-30
24759097211,24759097217,6,3573,1892,-30
24759719246,24759719251,5,2375,969,-30
24765315529,24765315528,-1,1439,1526,-30
24767381036,24767381042,6,3932,2287,-30
24767980242,24767980247,5,971,684,-30
24768631094,24768631102,8,2497,1153,-30
24769182178,24769182160,-18,2494,1338,-30
24771692387,24771692393,6,1865,1321,-30
24774028129,24774028132,3,1861,1243,-30
24776892978,24776892982,4,1815,1417,-30
24778306429,24778306431,2,2238,1679,-30
24780799946,24780799942,-4,2316,4989,-30
24781397670,24781397675,5,2745,1162,-30
24781945774,24781945778,4,1885,1079,-30
24782001269,24782001274,5,1777,856,-30
24783574192,24783574197,5,2776,1528,-30
24785502109,24785502115,6,2439,1096,-30
24785923644,24785923646,2,1378,1814,-30
24787970523,24787970526,3,2016,1289,-30
24794817642,24794817646,4,1443,1023,-30
24801147206,24801147210,4,2913,1251,-30
24802799262,24802799266,4,2013,1311,-30
24804926649,24804926655,6,2360,1256,-30
24806568733,24806568735,2,1627,1087,-30
24807225362,24807225367,5,2371,1490,-30
24808379517,24808379521,4,2590,1442,-30
24809649873,24809649877,4,1583,1062,-30
24813449098,24813449102,4,2358,1383,-30
24815133421,24815133427,6,8501,28536,-30
24817853966,24817853986,20,1493,1311,-30
24818165101,24818165106,5,2160,1518,-30
24819579270,24819579275,5,2361,1674,-30
24826439956,24826439961,5,2494,1336,-30
24828456527,24828456531,4,1679,1030,-30
24830966560,24830966563,3,2405,1499,-30
24831898296,24831898312,16,2088,848,-30
24834537989,24834537998,9,4125,1141,-30
24839210150,24839210158,8,4239,1644,-30
24841252527,24841252534,7,9700,21402,-30
24842519838,24842519844,6,1951,1072,-30
24848210364,24848210370,6,2364,1481,-30
24849516007,24849516010,3,2825,1438,-30
24850516739,24850516745,6,3543,1553,-30
24856331417,24856331421,4,3156,2023,-30
24861524616,24861524622,6,2656,1587,-30
24861561564,24861561570,6,2125,1696,-30
24863686251,24863686258,7,2522,1693,-30
24868271858,24868271863,5,2299,1685,-30
24869205993,24869205996,3,2289,1060,-30
24869670667,24869670673,6,2264,1551,-30
24869894249,24869894235,-14,1218,554,-30
24870215745,24870215749,4,2098,1157,-30
24874014847,24874014851,4,1891,1169,-30
24878371489,24878371485,-4,22729,14325,-30
24885255261,24885255271,10,11389,28257,-30
24887723082,24887723086,4,1533,1135,-30
24893408625,24893408630,5,1399,1351,-30
24898419267,24898419270,3,2334,1198,-30
24899367499,24899367502,3,2291,1278,-30
24904592329,24904592335,6,2778,1309,-30
24908566073,24908566078,5,2884,1381,-30
24909382812,24909382817,5,2625,1502,-30
24910404111,24910404111,0,2993,1933,-30
24911181405,24911181399,-6,662,3622,-30
24914140503,24914140510,7,3013,1271,-30
24914975706,24914975712,6,3066,1555,-30
24920223997,24920223998,1,1999,1507,-30
24921085884,24921085889,5,2233,1282,-30
24921131294,24921131276,-18,1362,1233,-30
24924045694,24924045699,5,2381,1674,-30
24926210066,24926210070,4,2451,1704,-30
24928771043,24928771050,7,1291,1158,-30
24929194185,24929194191,6,38750,19550,-30
24929749233,24929749238,5,1530,1676,-30
24930311290,24930311295,5,2519,1055,-30
24932262977,24932262958,-19,1759,1199,-30
24936740956,24936740958,2,1710,1094,-30
24936941573,24936941579,6,1807,1354,-30
24943108547,24943108552,5,2574,1743,-30
24944292041,24944292045,4,2117,1633,-30
24946760011,24946760015,4,1626,1304,-30
24948751550,24948751551,1,226,6178,-30
24951920858,24951920862,4,2183,1290,-30
24952496608,24952496610,2,1944,879,-30
24956265377,24956265380,3,1836,932,-30
24957647487,24957647490,3,2029,1096,-30
24959114484,24959114491,7,1394,995,-30
24960813558,24960813558,0,1503,870,-30
24962577978,24962577984,6,1907,1072,-30
24967634020,24967634023,3,2413,1252,-30
24967695251,24967695255,4,2572,1661,-30
24970651836,24970651841,5,1900,1363,-30
24972354520,24972354513,-7,1273,5388,-30
24978093161,24978093165,4,1514,1268,-30
24979451571,24979451577,6,2508,1471,-30
24984884883,24984884889,6,2654,1661,-30
24985154192,24985154197,5,2186,1294,-30
24985337974,24985337979,5,1511,1033,-30
24989875515,24989875517,2,1865,1009,-30
24990238682,24990238690,8,2573,991,-30
24995769054,24995769059,5,1761,1250,-30
24999095653,24999095658,5,2546,1412,-30
24999198934,24999198939,5,2398,1441,-30
25006965223,25006965226,3,2286,1255,-30
25008468378,25008468385,7,4550,1264,-30
25009224341,25009224346,5,2305,1118,-30
25014130986,25014130994,8,2512,1198,-30
25019332490,25019332495,5,2553,1414,-30
25021877114,25021877119,5,2241,1559,-30
25022830965,25022830970,5,1970,1489,-30
25028745498,25028745502,4,2498,1354,-30
25031461483,25031461490,7,2309,1494,-30
25033092105,25033092110,5,2513,1335,-30
25035163996,25035163996,0,32125,51430,-30
25038391978,25038391982,4,2482,1223,-30
25039784201,25039784205,4,2931,1982,-30
25041888522,25041888526,4,1461,1178,-30
25044352201,25044352206,5,2485,1555,-30
25044734684,25044734690,6,2626,1474,-30
25047100783,25047100789,6,2681,1622,-30
25048814777,25048814782,5,2395,1188,-30
25053945510,25053945495,-15,2961,1099,-30
25055137662,25055137667,5,1880,965,-30
25059704405,25059704407,2,1637,1504,-30
25061279613,25061279617,4,1430,1254,-30
25062263387,25062263383,-4,3084,43946,-30
25062977702,25062977706,4,2273,1144,-30
25065889569,25065889564,-5,2850,165,-30
25066202666,25066202670,4,3130,1710,-30
25067047954,25067047958,4,2770,1462,-30
25068458161,25068458166,5,1947,1497,-30
25068898592,25068898598,6,2786,1258,-30
25072510111,25072510117,6,1766,1125,-30
25072573033,25072573038,5,2948,1630,-30
25073092717,25073092722,5,1806,721,-30
25073282703,25073282682,-21,2589,1464,-30
25074162476,25074162483,7,965,850,-30
25076423374,25076423379,5,2522,1147,-30
25078274570,25078274575,5,2623,1685,-30
25080420320,25080420326,6,2827,1506,-30
25082221416,25082221417,1,1357,1250,-30
25086902272,25086902277,5,2489,1550,-30
25088228232,25088228239,7,2075,1497,-30
25088648886,25088648890,4,2065,1282,-30
25088974862,25088974865,3,1426,1431,-30
25091626691,25091626695,4,1394,970,-30
25094197013,25094197015,2,2698,1991,-30
25094836389,25094836394,5,1915,1506,-30
25096470590,25096470594,4,2080,1066,-30
25097917276,25097917281,5,2220,942,-30
25101817137,25101817141,4,2657,2341,-30
25102844806,25102844811,5,2306,1139,-30
25107724271,25107724274,3,2567,1524,-30
25108330940,25108330950,10,375,4482,-30
25108695435,25108695443,8,2746,1247,-30
25115337654,25115337657,3,1538,1122,-30
25117894549,25117894554,5,1310,1067,-30
25118621873,25118621879,6,3422,1508,-30
25120161777,25120161781,4,1463,785,-30
25120727947,25120727946,-1,16836,7688,-30
25125262747,25125262750,3,1540,1505,-30
25127161057,25127161062,5,4864,2638,-30
25128182688,25128182694,6,2701,1587,-30
25133987308,25133987312,4,2497,1711,-30
25134725109,25134725113,4,2175,930,-30
25135385159,25135385136,-23,2446,1269,-30
25136506917,25136506910,-7,1278,4204,-30
25136873684,25136873690,6,2340,1654,-30
25137221436,25137221442,6,3057,1445,-30
25137311230,25137311235,5,2348,1426,-30
25137679846,25137679850,4,2898,1483,-30
25142438181,25142438185,4,1639,1460,-30
25142649295,25142649301,6,2760,1430,-30
25144496826,25144496834,8,3396,1005,-30
25145281738,25145281743,5,1832,1277,-30
25146132841,25146132847,6,1711,1280,-30
25152161889,25152161897,8,2095,1059,-30
25152303057,25152303061,4,2681,1156,-30
25153050577,25153050583,6,33951,15350,-30
25157777036,25157777040,4,2274,1655,-30
25167092279,25167092282,3,2066,1446,-30
25169340570,25169340574,4,2019,1050,-30
25172476195,25172476202,7,2859,1370,-30
25173515574,25173515581,7,2167,1228,-30
25173809653,25173809659,6,2204,1205,-30
25174252282,25174252288,6,1898,1114,-30
25174312190,25174312194,4,2201,1490,-30
25177596758,25177596762,4,2405,1319,-30
25178058505,25178058509,4,3377,1436,-30
25178799805,25178799813,8,2825,1534,-30
25179549538,25179549542,4,2393,1944,-30
25181363532,25181363535,3,2861,899,-30
25187887919,25187887924,5,2285,1246,-30
25192502654,25192502657,3,1282,1292,-30
25195595194,25195595199,5,2080,1229,-30
25197446654,25197446658,4,2897,1221,-30
25202829442,25202829446,4,2442,1230,-30
25203454113,25203454120,7,3341,1284,-30
25207874421,25207874427,6,1452,994,-30
25210419661,25210419666,5,3399,1550,-30
25210486301,25210486313,12,2708,1196,-30
25211885794,25211885803,9,893,250,-30
25213441969,25213441971,2,2068,1086,-30
25213888022,25213888028,6,3050,1802,-30
25216689207,25216689211,4,1061,920,-30
25218124831,25218124837,6,3113,2274,-30
25219890170,25219890175,5,1536,1622,-30
25227106052,25227106055,3,2202,1235,-30
25229533470,25229533475,5,2935,1561,-30
25229650825,25229650831,6,2464,1088,-30
25235887243,25235887247,4,2359,1284,-30
25237447991,25237447995,4,3562,1488,-30
25244993042,25244993047,5,1882,958,-30
25247723002,25247723006,4,2043,1070,-30
25248106373,25248106375,2,1040,892,-30
25254016422,25254016427,5,932,443,-30
25255209369,25255209373,4,1602,1354,-30
25256499731,25256499737,6,2708,1421,-30
25258953494,25258953499,5,2257,1036,-30
25259472539,25259472544,5,2067,1428,-30
25261101462,25261101468,6,2306,1241,-30
25266361071,25266361075,4,1721,1681,-30
25266406782,25266406785,3,2555,1315,-30
25267408675,25267408680,5,3338,1596,-30
25267815226,25267815233,7,2033,1100,-30
25271809357,25271809361,4,1378,868,-30
25276066914,25276066920,6,2718,1807,-30
25279159406,25279159413,7,1903,1082,-30
25289044568,25289044573,5,2480,1240,-30
25291219192,25291219211,19,1031,2333,-30
25296825493,25296825497,4,2277,1071,-30
25297582962,25297582967,5,2551,1544,-30
25301512041,25301512047,6,1791,913,-30
25302590724,25302590730,6,2446,1413,-30
25302960367,25302960373,6,2381,1255,-30
25305025952,25305025956,4,1598,894,-30
25308983285,25308983290,5,2679,1176,-30
25309317310,25309317316,6,1856,1300,-30
25309773981,25309773962,-19,743,314,-30
25313146088,25313146091,3,2996,1652,-30
25313857899,25313857903,4,2201,1449,-30
25317602857,25317602863,6,2134,1214,-30
25319375782,25319375789,7,2042,1421,-30
25319773186,25319773190,4,2410,1461,-30
25322043741,25322043747,6,2214,943,-30
25323907226,25323907230,4,1816,1033,-30
25324876568,25324876574,6,3235,1958,-30
25325041255,25325041233,-22,841,84,-30
25329847490,25329847494,4,2147,1339,-30
25331917511,25331917514,3,2323,1521,-30
25332402282,25332402286,4,2712,1331,-30
25333156550,25333156553,3,3911,2257,-30
25335987687,25335987690,3,1339,981,-30
25339603142,25339603147,5,3058,1697,-30
25342880660,25342880666,6,2316,1366,-30
25343503466,25343503470,4,1611,1385,-30
25347030517,25347030522,5,2333,1295,-30
25348274457,25348274463,6,2795,1470,-30
25348620329,25348620334,5,2519,1378,-30
25348745520,25348745526,6,2725,1618,-30
25354390122,25354390126,4,2911,1484,-30
25363481067,25363481073,6,1834,858,-30
25365012990,25365012995,5,2240,1038,-30
25365705479,25365705465,-14,1172,712,-30
25367839644,25367839650,6,1878,1029,-30
25372748728,25372748733,5,2023,1419,-30
25375263651,25375263629,-22,1675,950,-30
25376079939,25376079946,7,1284,1168,-30
25376272625,25376272642,17,2412,1242,-30
25377445850,25377445851,1,1943,1059,-30
25382024307,25382024312,5,2546,1365,-30
25382515566,25382515570,4,1801,1156,-30
25383278683,25383278689,6,2609,1317,-30
25389506602,25389506607,5,1376,1189,-30
25395813557,25395813557,0,1457,1933,-30
25396935273,25396935274,1,1204,944,-30
25401973517,25401973523,6,2331,1588,-30
25404478764,25404478766,2,2083,1044,-30
25408779809,25408779814,5,2531,914,-30
25411666746,25411666750,4,1735,839,-30
25412734334,25412734339,5,1654,1236,-30
25413182072,25413182077,5,2197,1468,-30
25414207709,25414207711,2,2216,1471,-30
25414472057,25414472062,5,2078,987,-30
25416652478,25416652483,5,7150,3275,-30
25417987387,25417987393,6,2005,1591,-30
25418571553,25418571558,5,2068,906,-30
25420968438,25420968443,5,2934,1839,-30
25423276542,25423276546,4,1894,1218,-30
25425028595,25425028600,5,2354,949,-30
25425696674,25425696679,5,2940,1303,-30
25430942634,25430942619,-15,2067,1000,-30
25433380411,25433380421,10,2030,1601,-30
25433405878,25433405882,4,2587,2005,-30
25434172700,25434172694,-6,1714,6552,-30
25438598638,25438598642,4,2018,1327,-30
25443134021,25443134025,4,2889,1356,-30
25446614808,25446614813,5,2315,1189,-30
25448689770,25448689774,4,2587,1561,-30
25452501246,25452501250,4,2544,1619,-30
25455462237,25455462243,6,1740,1320,-30
25456016301,25456016306,5,1957,1313,-30
25456051331,25456051323,-8,886,215,-30
25458842360,25458842365,5,2083,951,-30
25458975713,25458975731,18,1210,572,-30
25459857814,25459857818,4,2662,1912,-30
25460986254,25460986258,4,2909,1577,-30
25462312826,25462312823,-3,1167,2747,-30
25470369521,25470369531,10,12248,31579,-30
25470437038,25470437042,4,2075,1074,-30
25471339884,25471339890,6,2152,730,-30
25473452649,25473452653,4,1739,1307,-30
25475723742,25475723745,3,1882,1043,-30
25476346473,25476346477,4,3223,1521,-30
25479103360,25479103366,6,3066,1734,-30
25484410823,25484410829,6,2300,1706,-30
25484687980,25484687985,5,2067,1415,-30
25486010922,25486010927,5,2821,1569,-30
25486661319,25486661304,-15,1396,558,-30
25487030546,25487030549,3,2067,1421,-30
25489268522,25489268526,4,1341,1554,-30
25490930113,25490930118,5,2150,1242,-30
25491227454,25491227459,5,2112,1384,-30
25491456905,25491456921,16,2086,1215,-30
25492382284,25492382289,5,2767,1347,-30
25493147549,25493147529,-20,2900,1243,-30
25494463234,25494463239,5,1658,1035,-30
25494702278,25494702299,21,1952,1255,-30
25496870828,25496870833,5,2947,2015,-30
25497115409,25497115414,5,2257,1192,-30
25497761441,25497761447,6,3026,1758,-30
25498365693,25498365700,7,3197,1588,-30
25503460398,25503460392,-6,16910,18499,-30
25505939006,25505939011,5,1242,978,-30
25509190611,25509190615,4,2789,1195,-30
25509228313,25509228317,4,1848,1376,-30
25514763330,25514763336,6,2930,2149,-30
25516043199,25516043203,4,900,798,-30
25519289946,25519289951,5,2285,1110,-30
25521402753,25521402758,5,2553,1466,-30
25529562030,25529562032,2,1227,1442,-30
25534180914,25534180918,4,3009,1430,-30
25537398193,25537398198,5,2060,1112,-30
25537635104,25537635107,3,1916,1411,-30
25538153890,25538153897,7,2047,1428,-30
25539542353,25539542358,5,2720,1111,-30
25540492419,25540492425,6,1654,1459,-30
25542829385,25542829388,3,1801,1568,-30
25543671501,25543671480,-21,1842,753,-30
25549674194,25549674199,5,2867,1812,-30
25549916778,25549916783,5,2419,1450,-30
25550091504,25550091523,19,2635,1112,-30
25550150586,25550150590,4,1475,920,-30
25550449037,25550449042,5,2027,1204,-30
25551281157,25551281161,4,2451,1420,-30
25552250708,25552250715,7,3150,952,-30
25552383550,25552383554,4,1777,1102,-30
25558571093,25558571094,1,962,1274,-30
25565738756,25565738755,-1,1156,1258,-30
25566372874,25566372858,-16,3065,1418,-30
25571039350,25571039354,4,1903,1125,-30
25571389936,25571389941,5,2734,1632,-30
25571997466,25571997472,6,3760,1893,-30
25572677161,25572677162,1,2229,1224,-30
25576003367,25576003373,6,2109,1235,-30
25576203364,25576203367,3,2027,1208,-30
25577131171,25577131178,7,2947,1595,-30
25577203004,25577203011,7,1380,1481,-30
25580013705,25580013710,5,2295,1705,-30
25581530239,25581530246,7,2002,1624,-30
25581977720,25581977726,6,2480,1122,-30
25583385141,25583385146,5,2265,1165,-30
25587231229,25587231232,3,2150,1519,-30
25587777587,25587777595,8,1782,1006,-30
25589664322,25589664327,5,2074,1363,-30
25590221149,25590221153,4,2906,1681,-30
25591799270,25591799274,4,2325,873,-30
25593688095,25593688099,4,1201,1226,-30
25595278349,25595278355,6,2627,997,-30
25602752308,25602752312,4,2965,1761,-30
25604753256,25604753250,-6,1508,4628,-30
25608068740,25608068745,5,2570,1670,-30
25622357078,25622357082,4,1649,722,-30
25625135722,25625135740,18,368,1727,-30
25626639450,25626639457,7,7845,3559,-30
25629814438,25629814444,6,2460,1671,-30
25630667314,25630667319,5,2612,1518,-30
25631898363,25631898369,6,1531,492,-30
25633732081,25633732087,6,2216,1036,-30
25634398517,25634398523,6,2602,1326,-30
25637764708,25637764714,6,31845,24443,-30
25648150963,25648150969,6,3095,1319,-30
25651631378,25651631382,4,1821,1074,-30
25651770763,25651770747,-16,1591,694,-30
25654121612,25654121616,4,2256,1346,-30
25654515790,25654515769,-21,1419,396,-30
25655634737,25655634742,5,1806,1167,-30
25657744607,25657744613,6,2274,1386,-30
25663769897,25663769891,-6,1629,4322,-30
25670466357,25670466364,7,2770,1442,-30
25675743753,25675743733,-20,3043,1284,-30
25677792117,25677792123,6,2194,1135,-30
25678657631,25678657616,-15,887,300,-30
25686062119,25686062124,5,1496,1232,-30
25686199877,25686199882,5,2719,1506,-30
25689738129,25689738133,4,2142,1310,-30
25693650263,25693650269,6,2814,1440,-30
25694116010,25694116011,1,1189,1536,-30
25694166903,25694166906,3,1626,1128,-30
25695530206,25695530210,4,1781,890,-30
25697192861,25697192866,5,1518,1486,-30
25700386314,25700386318,4,1904,1220,-30
25700820010,25700820014,4,2004,933,-30
25704846980,25704846985,5,1551,1609,-30
25707752393,25707752397,4,3013,1468,-30
25712971286,25712971290,4,1865,1266,-30
25713307356,25713307361,5,1463,782,-30
25718352487,25718352493,6,2740,1352,-30
25721372894,25721372898,4,2387,1139,-30
25725672570,25725672575,5,2772,1132,-30
25728127273,25728127277,4,2208,1160,-30
25729454245,25729454250,5,1668,1208,-30
25735096458,25735096453,-5,1086,2725,-30
25737588635,25737588640,5,2314,1562,-30
25738031429,25738031433,4,2615,1211,-30
25747061350,25747061350,0,1630,1647,-30
25749437786,25749437790,4,2743,1370,-30
25752548369,25752548373,4,1801,1013,-30
25752941772,25752941777,5,1994,1109,-30
25753197805,25753197788,-17,1730,1194,-30
25754638270,25754638274,4,1467,1065,-30
25757787206,25757787211,5,2273,1853,-30
25760235145,25760235149,4,3276,1776,-30
25762485895,25762485901,6,1766,1046,-30
25763293294,25763293298,4,1583,1413,-30
25763862075,25763862081,6,2317,1243,-30
25764390718,25764390725,7,3892,1512,-30
25768825281,25768825294,13,1679,1229,-30
25768967254,25768967259,5,2451,1333,-30
25769435518,25769435523,5,1316,1251,-30
25771667914,25771667920,6,2789,1232,-30
25775199122,25775199123,1,960,1281,-30
25775426969,25775426973,4,2320,1443,-30
25776887273,25776887278,5,2021,1287,-30
25779374903,25779374907,4,1853,711,-30
25781070929,25781070949,20,2564,1168,-30
25785354185,25785354190,5,2717,1630,-30
25788513675,25788513679,4,2368,1799,-30
25792385198,25792385203,5,2585,1326,-30
25795316005,25795316008,3,2241,1323,-30
25795579111,25795579120,9,713,203,-30
25798207178,25798207182,4,2328,1127,-30
25803831123,25803831129,6,1481,1065,-30
25804950598,25804950594,-4,1222,2259,-30
25806533097,25806533103,6,861,864,-30
25808886283,25808886290,7,1863,1021,-30
25811430254,25811430258,4,1841,1119,-30
25812164413,25812164393,-20,1793,380,-30
25819024613,25819024617,4,2174,987,-30
25826250766,25826250771,5,2678,1291,-30
25826750285,25826750281,-4,1732,360,-30
25826916620,25826916627,7,3264,1693,-30
25827464913,25827464917,4,2327,1470,-30
25832704282,25832704287,5,2051,1328,-30
25838437886,25838437890,4,2245,1502,-30
25842028073,25842028073,0,3273,3925,-30
25842720717,25842720718,1,8228,7645,-30
25844244337,25844244341,4,1936,1389,-30
25844893354,25844893358,4,2225,1217,-30
25845641934,25845641939,5,1487,1024,-30
25853551738,25853551742,4,1886,1253,-30
25857350639,25857350641,2,2161,1648,-30
25857996305,25857996312,7,3512,1333,-30
25860985841,25860985846,5,2830,1678,-30
25862589762,25862589754,-8,1265,5783,-30
25864976719,25864976723,4,2665,1489,-30
25865970685,25865970692,7,1935,892,-30
25866967404,25866967411,7,2349,1087,-30
25867077466,25867077452,-14,1379,711,-30
25871967334,25871967331,-3,729,1502,-30
25872447615,25872447618,3,2300,1231,-30
25877407180,25877407185,5,1780,1290,-30
25879929642,25879929646,4,2308,1611,-30
25882072371,25882072376,5,2119,1681,-30
25885273372,25885273378,6,3070,1973,-30
25886723562,25886723569,7,6525,1435,-30
25894196874,25894196878,4,2447,1943,-30
25899639561,25899639566,5,1623,1316,-30
25900254158,25900254162,4,3380,1699,-30
25904439286,25904439289,3,2665,1143,-30
25904928597,25904928579,-18,1861,844,-30
25906339501,25906339506,5,1232,859,-30
25906752114,25906752119,5,2435,942,-30
25908986386,25908986390,4,2746,1239,-30
25912335753,25912335757,4,2615,1695,-30
25918159538,25918159543,5,1882,1060,-30
25920333790,25920333795,5,2331,1059,-30
25923471306,25923471310,4,2111,1464,-30
25925811802,25925811807,5,2471,1295,-30
25929597810,25929597824,14,14065,35893,-30
25934044578,25934044586,8,2596,1043,-30
25936322817,25936322820,3,2303,1129,-30
25937587054,25937587068,14,1152,234,-30
25938298731,25938298737,6,1423,1096,-30
25940976398,25940976402,4,2431,1605,-30
25941121410,25941121414,4,2227,1386,-30
25941178042,25941178047,5,1765,889,-30
25942228486,25942228490,4,1910,1246,-30
25944140627,25944140632,5,1327,978,-30
25946343075,25946343079,4,2584,2081,-30
25946463496,25946463502,6,2332,1271,-30
25948363123,25948363126,3,1899,1329,-30
25951572771,25951572775,4,2218,1156,-30
25955608893,25955608900,7,1825,860,-30
25957553063,25957553067,4,2145,1240,-30
25959120822,25959120827,5,1477,1107,-30
25959740444,25959740449,5,2199,1371,-30
25961371795,25961371776,-19,2134,1069,-30
25962107782,25962107801,19,826,322,-30
25963241433,25963241436,3,2910,1476,-30
25963737882,25963737887,5,2064,1159,-30
25966492194,25966492199,5,1339,689,-30
25966714137,25966714120,-17,2161,951,-30
25969609934,25969609939,5,2648,1527,-30
25970308699,25970308705,6,2511,1766,-30
25972771939,25972771943,4,2312,995,-30
25973675977,25973675978,1,852,1042,-30
25974359681,25974359665,-16,6449,2405,-30
25976759270,25976759274,4,2335,1181,-30
25977962178,25977962162,-16,892,322,-30
25983392845,25983392849,4,2139,1728,-30
25987076376,25987076383,7,688,801,-30
25989326525,25989326529,4,2679,1740,-30
25993060607,25993060612,5,2714,1884,-30
25998482566,25998482570,4,2574,1034,-30
26000197437,26000197442,5,2216,1309,-30
26000918199,26000918204,5,2614,1544,-30
26002351496,26002351501,5,2159,1213,-30
26004096858,26004096862,4,1278,907,-30
26005414055,26005414060,5,2071,913,-30
26013461574,26013461580,6,2339,1537,-30
26013602013,26013602018,5,1356,726,-30
26016576381,26016576386,5,2289,1554,-30
26017521830,26017521835,5,2149,1308,-30
26017634945,26017634951,6,2274,1390,-30
26021543354,26021543376,22,2145,1677,-30
26022985212,26022985219,7,3270,1047,-30
26027769481,26027769482,1,2681,2967,-30
26029057472,26029057477,5,1969,1220,-30
26030568591,26030568591,0,2325,3700,-30
26033998510,26033998513,3,2082,1442,-30
26036865305,26036865311,6,2612,1133,-30
26038543127,26038543132,5,2636,1564,-30
26038723014,26038723018,4,1297,1100,-30
26043532848,26043532846,-2,2712,4933,-30
26048057584,26048057588,4,2051,1641,-30
26049680632,26049680633,1,1905,1983,-30
26050242498,26050242502,4,1715,833,-30
26053937126,26053937133,7,2877,1162,-30
26054173573,26054173576,3,1547,1074,-30
26057447051,26057447034,-17,65,757,-30
26061300890,26061300894,4,1617,901,-30
26062423537,26062423541,4,1764,1087,-30
26062759210,26062759215,5,1657,993,-30
26063042238,26063042243,5,1509,1079,-30
26063684091,26063684097,6,2306,1021,-30
26063890865,26063890869,4,2292,1537,-30
26066154526,26066154529,3,3058,1908,-30
26067097155,26067097162,7,2475,1944,-30
26067371292,26067371300,8,4519,1958,-30
26068257220,26068257223,3,1105,1110,-30
26068932442,26068932447,5,1776,1312,-30
26069904305,26069904311,6,2685,1481,-30
26072377321,26072377324,3,2056,1005,-30
26074926422,26074926419,-3,1699,4001,-30
26076890441,26076890445,4,1597,1316,-30
26078577282,26078577287,5,3378,1469,-30
26082003753,26082003758,5,2303,1083,-30
26088114096,26088114102,6,2100,1445,-30
26088159090,26088159096,6,1797,1117,-30
26091554228,26091554233,5,1970,1156,-30
26093035932,26093035936,4,2706,1649,-30
26094840235,26094840238,3,1573,1500,-30
26095684870,26095684874,4,3528,1646,-30
26096446695,26096446701,6,2347,1618,-30
26097608666,26097608671,5,1792,1101,-30
26097865095,26097865106,11,3160,1058,-30
26098583017,26098583007,-10,111,1167,-30
26100083714,26100083720,6,3267,1691,-30
26101610161,26101610167,6,3738,1539,-30
26104834327,26104834330,3,3017,2059,-30
26106189615,26106189619,4,1599,966,-30
26108336482,26108336480,-2,2155,5474,-30
26110128310,26110128315,5,2062,1168,-30
26112403065,26112403070,5,1964,1082,-30
26112608590,26112608577,-13,863,377,-30
26114053674,26114053678,4,2517,1168,-30
26118362509,26118362514,5,2835,1257,-30
26120357350,26120357355,5,2976,1392,-30
26120953809,26120953826,17,921,221,-30
26123609247,26123609252,5,1946,1105,-30
26126406913,26126406917,4,2721,1325,-30
26126784350,26126784361,11,939,388,-30
26127640461,26127640466,5,2693,1671,-30
26127868213,26127868216,3,1761,1113,-30
26128029962,26128029968,6,3058,1714,-30
26131455383,26131455386,3,2078,1256,-30
26132356162,26132356176,14,850,419,-30
26133985488,26133985510,22,1899,3744,-30
26137000319,26137000323,4,2141,1487,-30
26137217653,26137217658,5,2057,1287,-30
26138220435,26138220441,6,11545,26962,-30
26141402716,26141402721,5,1799,1447,-30
26146005153,26146005157,4,2925,1497,-30
26150601926,26150601932,6,3753,1739,-30
26153368759,26153368765,6,1756,879,-30
26154442513,26154442513,0,1777,2278,-30
26156300619,26156300624,5,2210,1479,-30
26156925543,26156925547,4,2703,1368,-30
26157457337,26157457342,5,2384,1003,-30
26163540447,26163540446,-1,3,2375,-30
26163642032,26163642049,17,367,1199,-30
26170724230,26170724235,5,2260,1586,-30
26174174037,26174174042,5,2426,1790,-30
26174265389,26174265394,5,1873,1539,-30
26175830821,26175830825,4,1670,1556,-30
26181565769,26181565774,5,2083,1686,-30
26184471539,26184471546,7,2710,1571,-30
26185562655,26185562661,6,2305,1289,-30
26191458305,26191458310,5,2885,1497,-30
26192805918,26192805922,4,2574,1435,-30
26193329499,26193329498,-1,1548,3125,-30
26193448371,26193448376,5,2672,1592,-30
26194708081,26194708088,7,2142,1792,-30
26197347867,26197347872,5,1747,1438,-30
26200876637,26200876643,6,3318,1585,-30
26206367575,26206367579,4,2272,1060,-30
26207154186,26207154192,6,3081,1407,-30
26210216087,26210216093,6,1932,1070,-30
26212166439,26212166445,6,3088,1157,-30
26213593741,26213593746,5,2459,1267,-30
26218040863,26218040866,3,2431,1634,-30
26219716841,26219716833,-8,78,1315,-30
26220517653,26220517657,4,2279,1149,-30
26221051634,26221051638,4,1656,1138,-30
26221805382,26221805386,4,1179,1116,-30
26222378011,26222378007,-4,1154,2859,-30
26222705912,26222705910,-2,1012,2219,-30
26223197177,26223197181,4,2228,1225,-30
26223565544,26223565549,5,1861,959,-30
26229359870,26229359864,-6,1131,3238,-30
26233567062,26233567061,-1,1653,1675,-30
26233742644,26233742649,5,1420,828,-30
26234394349,26234394354,5,2180,1170,-30
26234716626,26234716630,4,2003,853,-30
26234823165,26234823170,5,2044,1186,-30
26236429801,26236429805,4,3535,1494,-30
26237063844,26237063848,4,2194,1213,-30
26240121122,26240121126,4,1984,1440,-30
26242822306,26242822311,5,2977,1330,-30
26248477461,26248477466,5,1882,834,-30
26248567209,26248567202,-7,684,271,-30
26250361038,26250361044,6,2035,1162,-30
26250801633,26250801641,8,2151,1128,-30
26251374547,26251374544,-3,24155,28280,-30
26251755690,26251755695,5,2452,1390,-30
26255255045,26255255050,5,2162,1284,-30
26255692178,26255692162,-16,2837,1760,-30
26256965318,26256965323,5,1551,1705,-30
26257019798,26257019802,4,2393,1722,-30
26257086889,26257086894,5,2087,885,-30
26261649382,26261649386,4,1514,927,-30
26262839757,26262839761,4,1672,1389,-30
26270364289,26270364293,4,2037,1332,-30
26274540686,26274540690,4,2083,1155,-30
26274936682,26274936683,1,1447,938,-30
26275256674,26275256679,5,2729,1437,-30
26276468621,26276468625,4,2289,1388,-30
26278363069,26278363075,6,2212,1292,-30
26280485997,26280486003,6,2597,1522,-30
26280831910,26280831915,5,2573,1173,-30
26280867765,26280867746,-19,4152,2815,-30
26286417003,26286416999,-4,1478,3668,-30
26286606375,26286606380,5,3707,1784,-30
26288380409,26288380411,2,1784,1787,-30
26291284689,26291284692,3,2064,1144,-30
26292656242,26292656244,2,2460,2912,-30
26294692388,26294692391,3,2629,1441,-30
26296835599,26296835603,4,1853,1396,-30
26302569568,26302569574,6,2125,1100,-30
26303271551,26303271555,4,1165,994,-30
26303308820,26303308827,7,1877,1048,-30
26304482780,26304482783,3,2323,1135,-30
26311036102,26311036108,6,1571,858,-30
26311436562,26311436566,4,2791,1819,-30
26313322565,26313322569,4,1954,1094,-30
26314303024,26314303030,6,1965,1095,-30
26316513126,26316513133,7,1529,1027,-30
26317036986,26317036994,8,2090,966,-30
26317281974,26317281963,-11,932,309,-30
26323783930,26323783935,5,2163,1545,-30
26323884401,26323884402,1,1860,2207,-30
26326470567,26326470570,3,1850,1278,-30
26327052674,26327052689,15,2175,1391,-30
26327405583,26327405562,-21,2540,1296,-30
26329693074,26329693077,3,3218,1579,-30
26329963458,26329963464,6,2235,1323,-30
26331662355,26331662359,4,1671,788,-30
26332338238,26332338217,-21,1240,778,-30
26334897113,26334897117,4,1841,1228,-30
26336805486,26336805491,5,2772,1094,-30
26337658566,26337658570,4,1750,1129,-30
26346147211,26346147216,5,2804,1493,-30
26351682966,26351682962,-4,908,3635,-30
26351802868,26351802872,4,1365,609,-30
26356857819,26356857814,-5,771,2766,-30
26359165164,26359165165,1,1272,1833,-30
26362124379,26362124382,3,1746,1011,-30
26363341282,26363341286,4,1839,1019,-30
26366459461,26366459466,5,2100,1261,-30
26366540703,26366540698,-5,209,932,-30
26371463456,26371463458,2,1627,1182,-30
26372277664,26372277669,5,2570,1703,-30
26375385978,26375385981,3,2486,1979,-30
26377432497,26377432503,6,1602,1240,-30
26377840639,26377840619,-20,2797,1567,-30
26379904129,26379904134,5,2450,1294,-30
26380376213,26380376219,6,2468,1397,-30
26383095150,26383095154,4,2447,1444,-30
26383266141,26383266146,5,2163,1218,-30
26385287598,26385287593,-5,1093,4070,-30
26385423804,26385423809,5,2599,1460,-30
26390180627,26390180631,4,3096,1607,-30
26393006555,26393006556,1,1536,1784,-30
26393941988,26393941989,1,1355,1799,-30
26396795859,26396795865,6,2775,1514,-30
26402235365,26402235371,6,1541,1174,-30
26407467670,26407467674,4,2653,1103,-30
26410789530,26410789535,5,2626,1614,-30
26414530470,26414530474,4,2320,1547,-30
26414693910,26414693912,2,1563,1325,-30
26418622302,26418622307,5,2269,1498,-30
26419367969,26419367975,6,1757,1451,-30
26420095497,26420095501,4,2503,1479,-30
26420152304,26420152311,7,2163,723,-30
26420582469,26420582473,4,2520,1092,-30
26421182877,26421182882,5,1545,1010,-30
26421314415,26421314427,12,1945,1356,-30
26421468858,26421468862,4,2878,1123,-30
26421852803,26421852785,-18,1128,153,-30
26423559622,26423559629,7,1918,957,-30
26425446585,26425446591,6,1750,908,-30
26429323354,26429323362,8,2990,1792,-30
26430045340,26430045339,-1,828,2472,-30
26436254428,26436254434,6,1624,1289,-30
26443091689,26443091695,6,1837,1649,-30
26443488722,26443488711,-11,1052,480,-30
26445382362,26445382367,5,2011,1164,-30
26449869738,26449869743,5,1445,657,-30
26452240044,26452240050,6,2999,1907,-30
26453854177,26453854183,6,2005,895,-30
26455589898,26455589903,5,1622,1145,-30
26458446942,26458446946,4,1914,1284,-30
26466841459,26466841465,6,2085,1292,-30
26467071454,26467071457,3,755,343,-30
26469391745,26469391748,3,1614,1540,-30
26471176653,26471176659,6,3038,1251,-30
26473793919,26473793926,7,2379,1083,-30
26475833801,26475833806,5,2665,1435,-30
26477276276,26477276282,6,2221,1373,-30
26482092630,26482092630,0,877,2041,-30
26482365997,26482366003,6,1721,676,-30
26486812358,26486812361,3,1266,851,-30
26487484382,26487484388,6,2974,1451,-30
26490603038,26490603042,4,1963,1460,-30
26491527853,26491527834,-19,2543,1240,-30
26498381181,26498381187,6,3630,1923,-30
26500613245,26500613248,3,1460,1019,-30
26501333678,26501333683,5,3445,1661,-30
26502531909,26502531915,6,2343,1158,-30
26508062489,26508062495,6,2659,1644,-30
26508792942,26508792946,4,1881,908,-30
26518344057,26518344062,5,1922,1202,-30
26518874971,26518874977,6,1618,1415,-30
26521338554,26521338558,4,415,348,-30
26533806011,26533806014,3,1185,1513,-30
26535058468,26535058473,5,2972,1243,-30
26535640370,26535640353,-17,1412,1014,-30
26539715102,26539715108,6,2461,1223,-30
26542181886,26542181890,4,1539,871,-30
26542391063,26542391066,3,2352,1284,-30
26544670243,26544670247,4,1343,1144,-30
26545132914,26545132912,-2,1425,2417,-30
26546843681,26546843686,5,10114,4472,-30
26550036561,26550036566,5,2116,1179,-30
26553665934,26553665939,5,2355,1357,-30
26554211049,26554211057,8,2326,1039,-30
26554274462,26554274442,-20,626,206,-30
26557401190,26557401196,6,1820,1573,-30
26558051899,26558051905,6,2291,1402,-30
26559401354,26559401360,6,3047,2011,-30
26559638614,26559638618,4,2698,1431,-30
26561546839,26561546843,4,1811,868,-30
26561615042,26561615047,5,2666,1540,-30
26561698055,26561698062,7,2607,1767,-30
26570775657,26570775662,5,2873,1788,-30
26571319462,26571319468,6,2486,1659,-30
26573487542,26573487547,5,1733,1006,-30
26574861638,26574861642,4,2553,1912,-30
26577108272,26577108277,5,1915,1066,-30
26579493378,26579493382,4,2160,1180,-30
26579738606,26579738585,-21,1972,632,-30
26586884553,26586884559,6,2376,1027,-30
26589961182,26589961187,5,2126,1044,-30
26592729846,26592729850,4,2915,1412,-30
26595413242,26595413262,20,259,1138,-30
26598282354,26598282359,5,1630,798,-30
26600911322,26600911326,4,2165,1390,-30
26602754782,26602754790,8,4444,1538,-30
26604269574,26604269578,4,1221,837,-30
26613561402,26613561407,5,1854,1018,-30
26615472110,26615472115,5,2348,1235,-30
26617457025,26617457029,4,1502,920,-30
26621866369,26621866377,8,1754,1046,-30
26622538759,26622538740,-19,1166,786,-30
26623013279,26623013260,-19,2011,1104,-30
26623945461,26623945456,-5,1880,6216,-30
26624944622,26624944625,3,1614,1340,-30
26629879161,26629879160,-1,1610,2313,-30
26630078137,26630078141,4,1620,1287,-30
26631349850,26631349855,5,2891,1253,-30
26633374727,26633374735,8,2407,1464,-30
26635257237,26635257241,4,2245,1206,-30
26636866506,26636866512,6,2586,1038,-30
26638375224,26638375228,4,1608,1460,-30
26644421414,26644421407,-7,31745,10875,-30
26644571287,26644571291,4,1233,1052,-30
26646550024,26646550026,2,2176,1094,-30
26647063856,26647063861,5,2560,1150,-30
26651135405,26651135410,5,2609,1149,-30
26651480883,26651480888,5,1910,1356,-30
26651842503,26651842505,2,1880,1587,-30
26652205021,26652205024,3,1757,1291,-30
26652678555,26652678559,4,1900,1603,-30
26652746194,26652746199,5,2370,1551,-30
26654877485,26654877493,8,4321,1656,-30
26655665682,26655665687,5,2114,1157,-30
26656562529,26656562533,4,1791,1465,-30
26657496313,26657496317,4,2240,1438,-30
26661483646,26661483653,7,2997,1775,-30
26664537694,26664537699,5,2197,1292,-30
26664646132,26664646139,7,3064,1281,-30
26667179238,26667179244,6,2386,1326,-30
26673043839,26673043843,4,2844,1698,-30
26673311623,26673311628,5,2072,1184,-30
26673684877,26673684882,5,1729,1016,-30
26680337053,26680337057,4,1576,883,-30
26683355890,26683355896,6,1725,1078,-30
26691603019,26691603025,6,1317,796,-30
26692342726,26692342734,8,1982,1143,-30
26693811990,26693811995,5,2125,1033,-30
26702770634,26702770640,6,2808,1545,-30
26707307109,26707307113,4,1688,979,-30
26709366527,26709366532,5,2535,1763,-30
26711276708,26711276710,2,1340,1685,-30
26716413371,26716413379,8,6097,2342,-30
26718932217,26718932222,5,2982,2338,-30
26721907363,26721907367,4,1674,1253,-30
26726014327,26726014330,3,3724,2817,-30
26727512323,26727512327,4,2361,1266,-30
26734296255,26734296247,-8,924,5545,-30
26737232050,26737232054,4,2329,998,-30
26738435638,26738435639,1,1456,1900,-30
26739984964,26739984969,5,2027,1256,-30
26741678562,26741678569,7,1937,1117,-30
26741757614,26741757618,4,2227,1397,-30
26744060326,26744060330,4,3664,1759,-30
26744365413,26744365393,-20,2646,1561,-30
26745555601,26745555605,4,1572,1024,-30
26745899105,26745899109,4,2447,1513,-30
26748988349,26748988356,7,1758,1068,-30
26752725310,26752725315,5,3162,1648,-30
26755896134,26755896137,3,1918,1180,-30
26758928869,26758928874,5,1803,1157,-30
26760816354,26760816357,3,2266,1165,-30
26763787728,26763787734,6,2126,1218,-30
26765112265,26765112272,7,1247,986,-30
26765963926,26765963931,5,2940,1883,-30
26766367573,26766367580,7,2222,1447,-30
26772429368,26772429370,2,1947,1476,-30
26774236095,26774236099,4,1283,822,-30
26775131006,26775131011,5,1649,1732,-30
26778298462,26778298460,-2,800,2055,-30
26781301638,26781301642,4,1343,1298,-30
26787533157,26787533161,4,1409,1147,-30
26787580914,26787580896,-18,2325,1081,-30
26789956728,26789956733,5,2294,1255,-30
26790979054,26790979058,4,2458,1440,-30
26796300297,26796300302,5,2680,1094,-30
26801368699,26801368705,6,2622,1827,-30
26801813346,26801813350,4,2312,1459,-30
26803041472,26803041474,2,2646,1379,-30
26803898697,26803898699,2,2986,2807,-30
26807256012,26807256015,3,1047,995,-30
26807862766,26807862773,7,1153,595,-30
26810213672,26810213678,6,3927,1456,-30
26810790157,26810790163,6,1966,1029,-30
26810891487,26810891465,-22,3330,2211,-30
26812005205,26812005211,6,2144,1074,-30
26812324925,26812324932,7,2506,1591,-30
26813048309,26813048315,6,941,309,-30
26814231090,26814231095,5,1929,1234,-30
26816161210,26816161216,6,2591,1409,-30
26818445073,26818445078,5,1411,1035,-30
26820616001,26820616003,2,2151,1254,-30
26820810304,26820810303,-1,1456,1231,-30
26822734006,26822734010,4,3196,2623,-30
26824438798,26824438805,7,4286,1770,-30
26830273674,26830273682,8,2680,1013,-30
26830831513,26830831517,4,3758,3590,-30
26831310838,26831310843,5,2288,1635,-30
26833032313,26833032319,6,2602,1287,-30
26833928482,26833928487,5,1960,1542,-30
26838746701,26838746700,-1,1736,3168,-30
26839413241,26839413246,5,1843,1396,-30
26839800255,26839800253,-2,1144,1651,-30
26844233712,26844233717,5,1345,927,-30
26845643991,26845643976,-15,634,111,-30
26846870850,26846870865,15,1955,1121,-30
26851493051,26851493054,3,2019,1489,-30
26855678367,26855678373,6,2017,842,-30
26859808446,26859808451,5,5920,3064,-30
26861738205,26861738211,6,1979,1263,-30
26863534593,26863534599,6,2185,1523,-30
26868797751,26868797756,5,2218,1268,-30
26869761431,26869761437,6,2173,1548,-30
26875975886,26875975890,4,2945,1215,-30
26876968000,26876967998,-2,1415,3691,-30
26879833368,26879833373,5,2348,1206,-30
26881630345,26881630350,5,1890,1718,-30
26885776614,26885776618,4,2413,1119,-30
26886470598,26886470601,3,2549,1422,-30
26887446645,26887446658,13,2805,1601,-30
26890895030,26890895035,5,1448,1187,-30
26891902026,26891902031,5,2592,1234,-30
26892407338,26892407344,6,2271,924,-30
26895913151,26895913158,7,1917,1071,-30
26897116167,26897116172,5,2257,1200,-30
26898331183,26898331187,4,1637,1787,-30
26900476836,26900476841,5,2146,1880,-30
26900811950,26900811953,3,2283,1038,-30
26903073738,26903073744,6,2309,1327,-30
26905001718,26905001724,6,2603,1272,-30
26907876906,26907876913,7,1608,980,-30
26909843369,26909843374,5,2601,1570,-30
26914539600,26914539604,4,2159,1696,-30
26918059370,26918059376,6,2439,1758,-30
26921151668,26921151674,6,1959,1705,-30
26922076393,26922076388,-5,17044,15264,-30
26926084230,26926084235,5,2106,1349,-30
26926568155,26926568161,6,1911,1241,-30
26940859629,26940859633,4,2227,1154,-30
26943637980,26943637983,3,1981,1698,-30
26945171913,26945171918,5,1938,1012,-30
26951645312,26951645318,6,3603,1593,-30
26952366292,26952366296,4,2504,933,-30
26954809567,26954809563,-4,1053,2268,-30
26961834858,26961834864,6,2515,1376,-30
26962276390,26962276395,5,2114,1198,-30
26962496608,26962496595,-13,2256,1265,-30
26965782374,26965782381,7,2087,1201,-30
26966428603,26966428607,4,2607,1442,-30
26967130482,26967130489,7,1643,1060,-30
26967368514,26967368498,-16,2204,1500,-30
26969275373,26969275377,4,2235,1184,-30
26973469242,26973469246,4,2240,1444,-30
26978384466,26978384471,5,2518,1497,-30
26978952427,26978952430,3,1380,1305,-30
26979955652,26979955658,6,2095,969,-30
26981590047,26981590050,3,25815,21535,-30
26982744078,26982744082,4,1823,1066,-30
26983300090,26983300095,5,1856,1304,-30
26987624010,26987624014,4,2252,1188,-30
26988259354,26988259359,5,2607,1353,-30
26991211798,26991211803,5,2629,1325,-30
26997022729,26997022730,1,3650,3745,-30
26999065233,26999065238,5,1987,769,-30
26999611111,26999611115,4,1410,982,-30
27000604330,27000604335,5,3324,1842,-30
27001934710,27001934716,6,2497,1719,-30
27006844166,27006844171,5,2740,1404,-30
27008344191,27008344178,-13,687,561,-30
27009295325,27009295330,5,2577,1122,-30
27018994070,27018994077,7,1860,1164,-30
27021341049,27021341054,5,1793,1473,-30
27023530458,27023530461,3,1971,1217,-30
27027184958,27027184963,5,2612,1518,-30
27029156317,27029156321,4,1601,1134,-30
27031987654,27031987657,3,2510,1339,-30
27033755197,27033755203,6,2272,988,-30
27038820678,27038820682,4,3516,1708,-30
27044767826,27044767831,5,2067,1347,-30
27047691067,27047691072,5,2103,1451,-30
27048832706,27048832710,4,2193,1314,-30
27050275873,27050275879,6,2253,1170,-30
27051376996,27051377001,5,2132,1332,-30
27052100709,27052100714,5,1924,1600,-30
27053135590,27053135594,4,2189,1017,-30
27053538286,27053538302,16,15895,20497,-30
27054188289,27054188291,2,1204,899,-30
27055076166,27055076169,3,1975,1285,-30
27062260081,27062260086,5,2560,966,-30
27062985564,27062985562,-2,1706,2985,-30
27068373423,27068373425,2,805,1484,-30
27069451632,27069451638,6,2900,1348,-30
27072065246,27072065244,-2,2406,5119,-30
27072886426,27072886430,4,1995,1676,-30
27072923041,27072923026,-15,1001,93,-30
27073752300,27073752307,7,3842,1262,-30
27075817721,27075817725,4,2046,1356,-30
27078854336,27078854339,3,1858,1465,-30
27084230989,27084230994,5,1795,994,-30
27086468350,27086468357,7,3415,1383,-30
27088741401,27088741406,5,3511,1415,-30
27094004662,27094004665,3,2054,1340,-30
27096532938,27096532944,6,2439,1618,-30
27102979775,27102979784,9,47,2155,-30
27104472546,27104472546,0,1542,1582,-30
27105351630,27105351635,5,2487,1184,-30
27113079914,27113079906,-8,950,6077,-30
27118804119,27118804125,6,1919,1565,-30
27120020287,27120020294,7,2984,1115,-30
27120826542,27120826547,5,3176,1508,-30
27122776443,27122776449,6,3086,1303,-30
27124967033,27124967037,4,2241,1412,-30
27128306821,27128306826,5,1453,821,-30
27128750990,27128750994,4,2536,1413,-30
27136665773,27136665778,5,2529,1145,-30
27142923171,27142923178,7,2126,1091,-30
27146058759,27146058770,11,14196,25860,-30
27152286402,27152286405,3,1554,1232,-30
27155247599,27155247597,-2,890,1316,-30
27157667545,27157667546,1,1418,1275,-30
27171945307,27171945311,4,1477,786,-30
27172276158,27172276164,6,2937,1488,-30
27173331755,27173331762,7,4014,1182,-30
27175076202,27175076207,5,2411,1691,-30
27178375192,27178375198,6,5421,1930,-30
27179813110,27179813115,5,2036,1113,-30
27187281683,27187281687,4,1959,1385,-30
27191168997,27191169002,5,2377,1475,-30
27191722966,27191722946,-20,1289,751,-30
27192064465,27192064469,4,2007,1046,-30
27193322146,27193322151,5,2235,1167,-30
27196187476,27196187483,7,6568,2350,-30
27197994694,27197994702,8,2504,1010,-30
27204506026,27204506031,5,2404,1638,-30
27205606604,27205606610,6,1875,1183,-30
27207628776,27207628783,7,1434,1261,-30
27209248946,27209248951,5,519,11251,-30
27210223194,27210223198,4,3077,1536,-30
27213831224,27213831228,4,2574,1484,-30
27214241466,27214241474,8,2404,1031,-30
27214372794,27214372776,-18,519,321,-30
27221874039,27221874043,4,2435,1295,-30
27224891427,27224891430,3,2224,1238,-30
27226989086,27226989091,5,2592,1397,-30
27227088095,27227088099,4,2731,1204,-30
27228064590,27228064595,5,2126,1085,-30
27230465669,27230465667,-2,1353,2694,-30
27230848706,27230848710,4,2282,1154,-30
27236043678,27236043683,5,1386,672,-30
27240475158,27240475163,5,1714,708,-30
27242458447,27242458451,4,2281,1603,-30
27246844337,27246844343,6,1412,1058,-30
27249837033,27249837038,5,2573,1199,-30
27251767278,27251767282,4,6754,3466,-30
27253404257,27253404256,-1,1671,1975,-30
27258118292,27258118295,3,1664,1910,-30
27260090625,27260090627,2,1697,1922,-30
27260824235,27260824239,4,2034,1318,-30
27262603322,27262603326,4,1825,1088,-30
27264530714,27264530719,5,1638,849,-30
27268081221,27268081227,6,2162,1062,-30
27268133910,27268133913,3,1564,890,-30
27268915550,27268915554,4,2099,1119,-30
27273767946,27273767952,6,2446,1683,-30
27274722857,27274722863,6,2186,1391,-30
27275002214,27275002217,3,2415,2240,-30
27275104297,27275104302,5,2311,1217,-30
27276317479,27276317486,7,2765,1373,-30
27280318675,27280318678,3,941,1165,-30
27280697619,27280697624,5,1541,940,-30
27282511822,27282511829,7,2005,1293,-30
27285254006,27285254010,4,1803,1202,-30
27288828649,27288828651,2,1681,1145,-30
27296453562,27296453566,4,1148,975,-30
27297215746,27297215751,5,3056,1487,-30
27299531768,27299531773,5,2039,894,-30
27299766195,27299766177,-18,1846,1459,-30
27305329096,27305329099,3,1945,1271,-30
27309507498,27309507499,1,918,801,-30
27316928186,27316928190,4,2165,1598,-30
27323974014,27323974014,0,9164,11761,-30
27325827849,27325827843,-6,1862,7004,-30
27327648041,27327648043,2,1399,1636,-30
27327970433,27327970439,6,1899,1015,-30
27329187398,27329187402,4,2552,1354,-30
27332062425,27332062430,5,2092,1103,-30
27334560637,27334560642,5,1673,865,-30
27335578089,27335578095,6,1162,903,-30
27337172249,27337172254,5,2673,1387,-30
27337978604,27337978606,2,1263,1277,-30
27339906991,27339906998,7,2722,1389,-30
27341023231,27341023235,4,1751,1378,-30
27343282298,27343282304,6,2203,1786,-30
27345138173,27345138178,5,2019,1215,-30
27347816533,27347816537,4,2404,1094,-30
27350453278,27350453283,5,2793,1806,-30
27351337711,27351337716,5,3159,1517,-30
27352592205,27352592210,5,3539,1758,-30
27352699034,27352699033,-1,973,143,-30
27353621527,27353621530,3,4243,22406,-30
27356641685,27356641690,5,2263,1073,-30
27357898801,27357898806,5,2154,1361,-30
27358882830,27358882835,5,1610,1158,-30
27359810383,27359810387,4,1941,1178,-30
27360955111,27360955114,3,2466,1700,-30
27361541460,27361541466,6,3472,1138,-30
27361690561,27361690567,6,2498,1484,-30
27363887136,27363887140,4,1843,1414,-30
27366392694,27366392701,7,2086,1527,-30
27370090238,27370090242,4,2880,1514,-30
27372752492,27372752494,2,2024,1388,-30
27374730633,27374730635,2,2115,1868,-30
27375845482,27375845488,6,3243,1138,-30
27376736376,27376736394,18,2411,1233,-30
27379072539,27379072538,-1,1848,2024,-30
27384259377,27384259382,5,3125,1556,-30
27386436501,27386436506,5,2300,1448,-30
27387961631,27387961644,13,26153,16122,-30
27388745225,27388745229,4,2791,1586,-30
27394897021,27394897025,4,2075,1240,-30
27403487090,27403487095,5,3091,1446,-30
27404644249,27404644254,5,2102,952,-30
27407888643,27407888647,4,1511,982,-30
27409989448,27409989453,5,3285,1312,-30
27410356598,27410356601,3,1811,1168,-30
27410854785,27410854770,-15,1046,326,-30
27411146906,27411146912,6,2318,1879,-30
27413357002,27413357009,7,2188,1423,-30
27415257098,27415257103,5,5163,2492,-30
27415595965,27415595971,6,1946,972,-30
27415805098,27415805083,-15,857,536,-30
27417965729,27417965731,2,1751,1447,-30
27420148125,27420148130,5,594,266,-30
27424440775,27424440768,-7,1232,4361,-30
27435270277,27435270282,5,1441,708,-30
27436334318,27436334322,4,3027,1180,-30
27436884957,27436884957,0,2326,3783,-30
27438163808,27438163811,3,2656,1507,-30
27442702962,27442702966,4,3075,1467,-30
27443641534,27443641539,5,3044,1664,-30
27446705330,27446705336,6,2146,1926,-30
27447782748,27447782728,-20,159,1,-30
27450015005,27450015013,8,2609,1273,-30
27452886456,27452886462,6,2331,1444,-30
27452982254,27452982258,4,2200,1146,-30
27454098359,27454098363,4,2982,1488,-30
27458105727,27458105731,4,2017,1451,-30
27464801505,27464801511,6,1439,1161,-30
27477093976,27477093959,-17,928,1466,-30
27479543430,27479543433,3,1828,1230,-30
27483155213,27483155219,6,1923,1098,-30
27485542907,27485542910,3,2719,1501,-30
27486982314,27486982319,5,2569,2099,-30
27487788195,27487788201,6,2613,940,-30
27489583994,27489583987,-7,1268,5572,-30
27490052877,27490052881,4,2063,845,-30
27492430777,27492430783,6,2158,1414,-30
27501915582,27501915586,4,1557,1258,-30
27512169060,27512169065,5,2008,2527,-30
27515892390,27515892398,8,2658,1058,-30
27516392293,27516392299,6,1793,1080,-30
27517241857,27517241862,5,1639,1514,-30
27517648686,27517648690,4,2196,1948,-30
27519683409,27519683407,-2,1409,3039,-30
27521774718,27521774723,5,2074,1578,-30
27522761906,27522761913,7,2974,1355,-30
27524320082,27524320086,4,1487,1026,-30
27530298370,27530298370,0,2000,1339,-30
27530482382,27530482386,4,1647,1010,-30
27534961950,27534961956,6,1706,1135,-30
27537785531,27537785541,10,2132,1237,-30
27539413561,27539413567,6,2107,1105,-30
27539535708,27539535713,5,2684,1276,-30
27543718709,27543718715,6,2770,1216,-30
27548523198,27548523203,5,3167,2081,-30
27548708124,27548708128,4,1855,1026,-30
27550243554,27550243559,5,2609,1469,-30
27551280214,27551280219,5,1854,1241,-30
27554974609,27554974605,-4,32998,7114,-30
27556920510,27556920513,3,2172,1234,-30
27557436333,27557436339,6,1555,1990,-30
27560169470,27560169477,7,3869,1686,-30
27561791917,27561791922,5,2163,1300,-30
27563128617,27563128619,2,1684,1777,-30
27563790725,27563790730,5,2598,1294,-30
27563879221,27563879227,6,2005,1175,-30
27564399370,27564399371,1,1468,1132,-30
27567969683,27567969687,4,888,717,-30
27572266042,27572266045,3,2540,939,-30
27572617513,27572617523,10,2608,1415,-30
27573495637,27573495659,22,2953,1624,-30
27574030058,27574030061,3,1593,764,-30
27575375457,27575375463,6,2078,1316,-30
27578289134,27578289137,3,2679,1928,-30
27578520596,27578520602,6,2170,1305,-30
27582708619,27582708614,-5,1367,4313,-30
27584234782,27584234787,5,2407,1650,-30
27584626046,27584626050,4,3476,1297,-30
27585338695,27585338700,5,1946,1209,-30
27593223351,27593223354,3,2776,2169,-30
27595586238,27595586243,5,1811,840,-30
27596105287,27596105291,4,2067,1284,-30
27596244630,27596244611,-19,1677,997,-30
27597488887,27597488893,6,2365,1090,-30
27598015205,27598015188,-17,1553,1071,-30
27598482129,27598482132,3,1536,1345,-30
27601749406,27601749409,3,2592,1577,-30
27604303507,27604303513,6,1873,1275,-30
27604885742,27604885747,5,2604,1591,-30
27608276755,27608276757,2,1999,1054,-30
27611004913,27611004917,4,1593,1710,-30
27613452133,27613452138,5,2749,1696,-30
27615377566,27615377569,3,2138,1224,-30
27616979680,27616979685,5,1772,1379,-30
27619530533,27619530542,9,1670,865,-30
27620680658,27620680667,9,1904,1178,-30
27621028551,27621028547,-4,1064,260,-30
27623939498,27623939503,5,2176,1676,-30
27624102868,27624102873,5,1697,1434,-30
27627742032,27627742038,6,3269,1440,-30
27631172805,27631172810,5,1815,1122,-30
27631762509,27631762492,-17,2529,1409,-30
27636751493,27636751496,3,2463,1346,-30
27639951021,27639951020,-1,1491,1670,-30
27643264422,27643264427,5,1990,1382,-30
27645655983,27645655986,3,2633,1178,-30
27645751278,27645751282,4,2238,1218,-30
27645925449,27645925454,5,1188,1040,-30
27649097518,27649097513,-5,1124,3250,-30
27651278735,27651278740,5,1503,1376,-30
27652718145,27652718150,5,2354,914,-30
27652876917,27652876918,1,1579,1492,-30
27652977550,27652977555,5,2199,1914,-30
27655643050,27655643055,5,1531,1170,-30
27659140237,27659140244,7,2577,1560,-30
27664522805,27664522811,6,1655,991,-30
27667813187,27667813195,8,1834,905,-30
27670520896,27670520901,5,2277,1082,-30
27673105123,27673105127,4,1947,694,-30
27678016282,27678016289,7,3389,1589,-30
27678453020,27678453025,5,3116,1757,-30
27680721554,27680721559,5,1904,1947,-30
27682039022,27682039027,5,2121,1078,-30
27683466031,27683466035,4,2392,1594,-30
27684884201,27684884207,6,1864,1389,-30
27685628977,27685628993,16,2391,1316,-30
27686592660,27686592667,7,1808,1391,-30
27691940738,27691940744,6,10604,30565,-30
27692265153,27692265158,5,2441,1790,-30
27695309095,27695309101,6,2106,1425,-30
27697298953,27697298958,5,2310,1482,-30
27697392773,27697392778,5,1513,1280,-30
27698359538,27698359542,4,2616,1920,-30
27698782942,27698782922,-20,1225,940,-30
27704947789,27704947789,0,1474,2602,-30
27705233410,27705233427,17,492,1169,-30
27705635621,27705635627,6,6166,2893,-30
27709459807,27709459814,7,2775,1460,-30
27723448706,27723448713,7,2802,1961,-30
27725368683,27725368687,4,2472,1522,-30
27727472993,27727472998,5,1768,1182,-30
27730353948,27730353955,7,2188,1596,-30
27731336570,27731336552,-18,981,784,-30
27732152322,27732152331,9,3064,1127,-30
27732676339,27732676322,-17,1305,974,-30
27734755950,27734755954,4,1997,1308,-30
27737485958,27737485962,4,2464,1147,-30
27740301124,27740301126,2,1078,1253,-30
27748163611,27748163616,5,2403,1534,-30
27749288187,27749288194,7,2381,1338,-30
27749466053,27749466057,4,671,122,-30
27750415153,27750415157,4,1782,1804,-30
27754733949,27754733957,8,1559,1485,-30
27756629186,27756629190,4,2080,1296,-30
27757474151,27757474156,5,2014,1329,-30
27757646098,27757646103,5,3101,1214,-30
27764021399,27764021405,6,2967,2052,-30
27774158280,27774158285,5,2057,953,-30
27774683821,27774683827,6,1659,1113,-30
27777158347,27777158353,6,2982,1421,-30
27786161857,27786161861,4,2534,1425,-30
27788181619,27788181624,5,2370,1340,-30
27788522901,27788522905,4,3165,1467,-30
27791214641,27791214641,0,1333,1858,-30
27791790797,27791790809,12,1189,891,-30
27793054221,27793054224,3,2139,1914,-30
27794573770,27794573775,5,1894,869,-30
27795863008,27795863012,4,1510,1253,-30
27797571135,27797571131,-4,2028,5817,-30
27798957567,27798957571,4,1806,1334,-30
27799195530,27799195534,4,1644,1333,-30
27801529511,27801529514,3,1589,1071,-30
27806442045,27806442051,6,1704,1077,-30
27815130090,27815130097,7,4744,2056,-30
27816216005,27816216011,6,102,5373,-30
27827258954,27827258958,4,1094,865,-30
27830376570,27830376575,5,1383,966,-30
27834515001,27834515005,4,2138,1058,-30
27837599764,27837599770,6,2802,1518,-30
27837649932,27837649938,6,7431,2196,-30
27838139502,27838139508,6,2569,861,-30
27840105898,27840105904,6,1706,875,-30
27843828858,27843828863,5,1756,1220,-30
27848320875,27848320878,3,2129,1317,-30
27856080652,27856080658,6,2705,1935,-30
27856795856,27856795834,-22,92,2362,-30
27860817374,27860817382,8,2137,1340,-30
27862213733,27862213739,6,2168,1477,-30
27866112083,27866112081,-2,1121,1934,-30
27868264129,27868264134,5,2077,1558,-30
27875102939,27875102944,5,2020,1471,-30
27876772317,27876772321,4,2662,1373,-30
27877722039,27877722043,4,3166,1773,-30
27878883847,27878883850,3,2013,1360,-30
27879892714,27879892719,5,2185,1109,-30
27880329269,27880329275,6,2308,1290,-30
27886235594,27886235598,4,2256,1299,-30
27887010696,27887010703,7,2053,952,-30
27889417262,27889417267,5,1732,780,-30
27890022648,27890022653,5,2565,1823,-30
27890772647,27890772653,6,2412,1496,-30
27891327334,27891327342,8,2454,1807,-30
27891467888,27891467891,3,1608,905,-30
27900760025,27900760030,5,1622,1091,-30
27902224445,27902224450,5,1446,968,-30
27903991019,27903991022,3,2018,1303,-30
27907421364,27907421368,4,2223,762,-30
27913008265,27913008270,5,1831,1028,-30
27913567871,27913567874,3,3006,1685,-30
27918129990,27918129998,8,2485,1545,-30
27920514631,27920514636,5,3694,2215,-30
27920680694,27920680697,3,2266,1491,-30
27923194323,27923194326,3,2086,1241,-30
27924791880,27924791885,5,1930,1106,-30
27930375070,27930375074,4,2135,1265,-30
27931696801,27931696807,6,1927,1285,-30
27931764121,27931764126,5,2181,1034,-30
27934663298,27934663302,4,2795,1314,-30
27937801904,27937801908,4,2083,1514,-30
27939095300,27939095303,3,1982,1544,-30
27941863395,27941863399,4,1097,667,-30
27943657377,27943657382,5,2072,1319,-30
27945507510,27945507516,6,2269,1161,-30
27952049773,27952049779,6,2918,2131,-30
27952572554,27952572559,5,2806,1457,-30
27955687535,27955687539,4,2196,1010,-30
27957172695,27957172701,6,2730,1325,-30
27957920434,27957920420,-14,1491,698,-30
27959583803,27959583804,1,1260,1223,-30
27960317363,27960317363,0,1350,1294,-30
27961667882,27961667886,4,1888,1426,-30
27962510550,27962510546,-4,1159,2405,-30
27963731270,27963731283,13,749,276,-30
27966733790,27966733785,-5,1453,5147,-30
27967294709,27967294714,5,2922,1246,-30
27968772550,27968772554,4,3082,1590,-30
27968805857,27968805844,-13,1308,756,-30
27970315735,27970315741,6,3086,1420,-30
27972903214,27972903219,5,2843,1449,-30
27973874082,27973874086,4,1551,1212,-30
27975123884,27975123890,6,1804,1125,-30
27977033625,27977033629,4,1650,1569,-30
27977197318,27977197322,4,2790,1484,-30
27979780108,27979780111,3,2320,1183,-30
27981634857,27981634864,7,1969,1130,-30
27982117078,27982117099,21,2713,1291,-30
27984043856,27984043858,2,2781,2266,-30
27984421163,27984421170,7,2545,1165,-30
27984839906,27984839911,5,2177,1494,-30
27987317643,27987317649,6,1097,711,-30
27988026829,27988026833,4,2152,1099,-30
27988563921,27988563926,5,2130,1177,-30
27988967858,27988967864,6,1567,1077,-30
27990366657,27990366665,8,6591,2164,-30
27992063914,27992063919,5,1492,1041,-30
27995305733,27995305738,5,1611,1744,-30
27997421361,27997421366,5,1377,1048,-30
27998595778,27998595784,6,3293,1214,-30
28000046797,28000046801,4,1778,868,-30
28000595004,28000594986,-18,1697,1383,-30
28001093606,28001093608,2,1317,1761,-30
28001425326,28001425331,5,1869,942,-30
28001569208,28001569213,5,2087,1453,-30
28001974609,28001974595,-14,549,182,-30
28008284230,28008284234,4,3600,1972,-30
28011190905,28011190911,6,1318,978,-30
28012848063,28012848069,6,3005,2253,-30
28012963601,28012963606,5,3140,1147,-30
28025209997,28025210003,6,1894,1201,-30
28031804282,28031804287,5,1459,781,-30
28033147110,28033147117,7,2576,1433,-30
28040916987,28040916992,5,1985,1417,-30
28041087074,28041087080,6,925,269,-30
28045194816,28045194822,6,1805,1063,-30
28048180018,28048180022,4,2906,1198,-30
28050207106,28050207110,4,2960,1602,-30
28051081890,28051081897,7,2929,1213,-30
28053037838,28053037843,5,2951,2074,-30
28053776896,28053776900,4,2795,1898,-30
28054201850,28054201865,15,441,184,-30
28054685737,28054685742,5,2624,1176,-30
28065570918,28065570922,4,2658,1744,-30
28070711499,28070711502,3,2603,1503,-30
28074770097,28074770093,-4,1349,3507,-30
28074875161,28074875167,6,2365,1106,-30
28082327591,28082327597,6,2347,1396,-30
28092754594,28092754600,6,1767,1147,-30
28093090259,28093090243,-16,1230,804,-30
28093989481,28093989486,5,1906,1028,-30
28094251354,28094251358,4,2049,1014,-30
28095756321,28095756326,5,5652,2225,-30
28098965711,28098965717,6,3086,1972,-30
28100304389,28100304386,-3,1336,1777,-30
28100439585,28100439591,6,2958,1621,-30
28114341636,28114341641,5,1625,1338,-30
28115082694,28115082689,-5,801,2428,-30
28115844243,28115844224,-19,1855,1738,-30
28118818802,28118818801,-1,1001,1742,-30
28119259213,28119259218,5,2161,1090,-30
28120362060,28120362064,4,2057,1728,-30
28125146473,28125146478,5,2081,1223,-30
28129981689,28129981685,-4,1262,3247,-30
28130733833,28130733838,5,1505,912,-30
28131548360,28131548365,5,1774,1250,-30
28132399206,28132399211,5,1668,1399,-30
28132541967,28132541972,5,2358,1698,-30
28135109663,28135109666,3,1978,1355,-30
28135552992,28135552998,6,2396,1025,-30
28137144693,28137144694,1,1751,1293,-30
28139568948,28139568952,4,2311,1446,-30
28140689155,28140689155,0,1065,1715,-30
28145704857,28145704863,6,2070,1156,-30
28147617366,28147617346,-20,3547,1770,-30
28149874680,28149874684,4,1885,1563,-30
28153563338,28153563345,7,2263,832,-30
28155066142,28155066146,4,2769,1428,-30
28155790250,28155790254,4,2345,1299,-30
28167051161,28167051167,6,2472,1223,-30
28167460718,28167460727,9,4301,1047,-30
28167714825,28167714811,-14,2672,1766,-30
28167840708,28167840713,5,2518,1339,-30
28168507750,28168507750,0,3083,3445,-30
28168744736,28168744740,4,1766,1007,-30
28171247187,28171247194,7,2510,1151,-30
28172636226,28172636230,4,3013,2079,-30
28174792573,28174792577,4,2381,1680,-30
28174868902,28174868906,4,2190,1516,-30
28180282506,28180282511,5,2389,1176,-30
28182711161,28182711165,4,2096,1234,-30
28190817239,28190817244,5,2378,1501,-30
28191350819,28191350822,3,1421,858,-30
28192256526,28192256521,-5,1830,4487,-30
28197171138,28197171143,5,2121,1320,-30
28197441197,28197441203,6,1835,1093,-30
28198050846,28198050827,-19,1034,271,-30
28200481970,28200481975,5,1526,1187,-30
28201107574,28201107579,5,2514,1573,-30
28204730501,28204730507,6,2117,1416,-30
28205046306,28205046311,5,1980,1279,-30
28205628324,28205628331,7,3769,1532,-30
28209709596,28209709600,4,3300,1409,-30
28218374785,28218374790,5,2982,1786,-30
28221309763,28221309768,5,1058,805,-30
28222814199,28222814202,3,1653,1488,-30
28232583326,28232583331,5,1650,986,-30
28236056258,28236056263,5,2441,1144,-30
28237915967,28237915971,4,1561,1333,-30
28238071689,28238071694,5,1795,1143,-30
28239208054,28239208063,9,2901,1245,-30
28244052121,28244052124,3,3011,1848,-30
28245756303,28245756306,3,1081,1160,-30
28245855047,28245855067,20,2665,1468,-30
28245962241,28245962224,-17,2304,1250,-30
28247613493,28247613499,6,2970,1511,-30
28249894043,28249894047,4,2428,1498,-30
28255265049,28255265054,5,2470,1495,-30
28256880307,28256880313,6,2379,1311,-30
28257407840,28257407837,-3,3848,17607,-30
28262684791,28262684794,3,1994,1605,-30
28263940209,28263940211,2,1120,856,-30
28264012902,28264012906,4,2551,1295,-30
28268381108,28268381110,2,2082,1885,-30
28270723390,28270723396,6,2478,1128,-30
28272613448,28272613453,5,2238,1440,-30
28274342465,28274342469,4,2328,1003,-30
28275456237,28275456239,2,1388,1333,-30
28283441474,28283441477,3,8725,19287,-30
28283547494,28283547497,3,2027,1571,-30
28284005004,28284005006,2,1732,1338,-30
28287151378,28287151382,4,2677,1679,-30
28287883300,28287883304,4,1512,1174,-30
28296823825,28296823831,6,2109,1460,-30
28297304964,28297304968,4,2593,1541,-30
28299513970,28299513975,5,2360,1042,-30
28299575356,28299575361,5,1938,1011,-30
28300285568,28300285573,5,2859,1835,-30
28306860466,28306860469,3,3128,912,-30
28309363737,28309363742,5,1591,1019,-30
28309400259,28309400241,-18,651,346,-30
28314750129,28314750132,3,2016,1285,-30
28316909466,28316909471,5,1667,1368,-30
28318047963,28318047966,3,3486,1635,-30
28320281787,28320281793,6,3611,1758,-30
28323756169,28323756175,6,1846,1239,-30
28325698227,28325698233,6,1994,1483,-30
28334004205,28334004211,6,2446,1631,-30
28337291961,28337291967,6,2031,1147,-30
28338027011,28338027016,5,2086,1355,-30
28340636802,28340636806,4,2273,1622,-30
28344234751,28344234756,5,3643,1845,-30
28345133582,28345133588,6,2101,1506,-30
28345465902,28345465913,11,1889,1142,-30
28345754871,28345754852,-19,2574,1138,-30
28346715250,28346715253,3,2163,1103,-30
28347690354,28347690359,5,1840,1095,-30
28349093033,28349093038,5,1965,1223,-30
28350731358,28350731361,3,2985,1635,-30
28354162543,28354162548,5,2999,1404,-30
28361302630,28361302635,5,3029,1484,-30
28363145945,28363145951,6,2475,1097,-30
28363803370,28363803374,4,1935,1419,-30
28368062371,28368062376,5,2403,1166,-30
28369958555,28369958559,4,2145,1205,-30
28370405773,28370405777,4,2739,1166,-30
28373097117,28373097121,4,2684,2028,-30
28374056386,28374056390,4,1581,1379,-30
28374289493,28374289498,5,2010,1457,-30
28382445353,28382445350,-3,1770,3805,-30
28382763585,28382763590,5,2382,1057,-30
28383710266,28383710271,5,1606,1126,-30
28384138075,28384138082,7,2753,1022,-30
28386556162,28386556170,8,6855,2562,-30
28388947163,28388947169,6,3055,1376,-30
28390438233,28390438229,-4,126061,50448,-30
28392501487,28392501491,4,2089,1150,-30
28398876352,28398876359,7,2923,1022,-30
28399437266,28399437273,7,2303,1024,-30
28401009593,28401009599,6,2102,1496,-30
28403139692,28403139696,4,2041,789,-30
28403703237,28403703242,5,2012,1520,-30
28405251290,28405251294,4,2225,1825,-30
28409027526,28409027530,4,1483,1476,-30
28410842394,28410842395,1,30478,91573,-30
28412767823,28412767825,2,1696,1392,-30
28414080311,28414080315,4,1929,1601,-30
28422420526,28422420531,5,2060,1416,-30
28422568179,28422568187,8,1926,1079,-30
28423120567,28423120572,5,2251,1255,-30
28424081302,28424081305,3,2289,1065,-30
28425526322,28425526327,5,2255,1260,-30
28426060987,28426060993,6,1636,1337,-30
28426678534,28426678538,4,2415,1541,-30
28427430698,28427430701,3,2853,1625,-30
28429808450,28429808450,0,2105,3279,-30
28432224814,28432224814,0,2281,2760,-30
28434035872,28434035879,7,2613,1014,-30
28435675103,28435675105,2,3786,3855,-30
28436872190,28436872195,5,3417,1749,-30
28438093227,28438093233,6,1857,1215,-30
28440791789,28440791795,6,2086,1070,-30
28441237037,28441237018,-19,2041,1244,-30
28441570878,28441570899,21,2425,1227,-30
28450027129,28450027134,5,1676,691,-30
28452388586,28452388590,4,1623,1151,-30
28455362259,28455362265,6,1782,1113,-30
28458136162,28458136169,7,1716,1390,-30
28460137499,28460137503,4,2728,1376,-30
28463274063,28463274069,6,2354,1694,-30
28464022750,28464022755,5,2164,1286,-30
28466278906,28466278911,5,2322,1949,-30
28468659113,28468659117,4,2259,1184,-30
28470603409,28470603416,7,2298,1273,-30
28470948818,28470948823,5,2227,1070,-30
28472418038,28472418033,-5,773,2792,-30
28473035613,28473035617,4,1787,1344,-30
28473063896,28473063912,16,2073,1370,-30
28475778954,28475778953,-1,2747,4153,-30
28479542114,28479542114,0,12854,18485,-30
28482880280,28482880287,7,2088,1135,-30
28485785545,28485785550,5,2474,1669,-30
28486334902,28486334906,4,1657,951,-30
28487860441,28487860445,4,2282,1106,-30
28489756883,28489756889,6,2086,1763,-30
28489860337,28489860342,5,2009,1196,-30
28496754949,28496754955,6,2187,1417,-30
28497382118,28497382124,6,2541,1613,-30
28501167214,28501167221,7,2343,1640,-30
28501303246,28501303228,-18,1593,842,-30
28501453015,28501453021,6,2224,1460,-30
28502397833,28502397838,5,2875,1709,-30
28502964061,28502964065,4,2334,1385,-30
28509261191,28509261195,4,3018,1499,-30
28509927874,28509927878,4,2220,1414,-30
28511140974,28511140978,4,1961,959,-30
28512722208,28512722214,6,4632,1574,-30
28519505890,28519505895,5,2329,1526,-30
28519925847,28519925851,4,2338,1107,-30
28521316726,28521316728,2,2809,2785,-30
28522526547,28522526545,-2,1039,2153,-30
28523029798,28523029802,4,1659,1032,-30
28525406414,28525406419,5,2771,1255,-30
28527192467,28527192465,-2,1362,2895,-30
28528373389,28528373389,0,2010,3278,-30
28528581122,28528581126,4,1540,1319,-30
28531571401,28531571405,4,1708,1199,-30
28532583427,28532583433,6,3056,1605,-30
28533547577,28533547583,6,1680,1021,-30
28533584089,28533584094,5,2627,1211,-30
28539432583,28539432589,6,3499,1146,-30
28542717409,28542717414,5,1964,1237,-30
28543945437,28543945418,-19,875,217,-30
28546346522,28546346527,5,2353,1320,-30
28547424674,28547424679,5,3009,1084,-30
28555260626,28555260630,4,2619,1454,-30
28555775738,28555775742,4,1797,1294,-30
28560197375,28560197382,7,1908,1322,-30
28565428202,28565428208,6,2992,1411,-30
28566737915,28566737919,4,2514,1541,-30
28567148646,28567148653,7,3110,1365,-30
28569063602,28569063605,3,1369,1378,-30
28569153195,28569153175,-20,1655,1016,-30
28570079457,28570079462,5,3029,1794,-30
28570193846,28570193851,5,2765,1414,-30
28570725362,28570725366,4,2872,1725,-30
28571524333,28571524339,6,1576,968,-30
28571869844,28571869842,-2,1712,2590,-30
28574454628,28574454635,7,3412,1422,-30
28580819770,28580819775,5,2765,1224,-30
28583517401,28583517383,-18,2928,1417,-30
28585764690,28585764695,5,2742,1832,-30
28587414042,28587414050,8,2541,1166,-30
28588338774,28588338776,2,6834,6498,-30
28593974660,28593974666,6,2631,1665,-30
28595121062,28595121067,5,1529,971,-30
28598883468,28598883486,18,705,1982,-30
28599548201,28599548204,3,2529,1818,-30
28602023807,28602023812,5,2531,1438,-30
28607991385,28607991391,6,3717,1375,-30
28610044416,28610044420,4,1694,1194,-30
28612229166,28612229173,7,1675,1044,-30
28612638250,28612638254,4,1971,1226,-30
28614378961,28614378967,6,2706,1381,-30
28616484078,28616484082,4,1826,1135,-30
28619930122,28619930127,5,2326,1187,-30
28620558491,28620558497,6,2687,1402,-30
28621234815,28621234794,-21,2209,1358,-30
28622298642,28622298649,7,3528,1427,-30
28629583153,28629583157,4,2270,1506,-30
28631095009,28631095014,5,4596,3091,-30
28631656406,28631656413,7,3268,1474,-30
28637632900,28637632902,2,1753,1669,-30
28637672993,28637672997,4,1437,1484,-30
28639702654,28639702659,5,1058,807,-30
28640258889,28640258895,6,3398,840,-30
28641386001,28641386007,6,1324,938,-30
28642439858,28642439863,5,1999,1029,-30
28644676628,28644676631,3,1656,872,-30
28646224895,28646224899,4,2493,1057,-30
28648562506,28648562509,3,1733,1219,-30
28649387362,28649387369,7,2042,1511,-30
28650820085,28650820091,6,3339,1600,-30
28651224629,28651224634,5,2405,1746,-30
28652738325,28652738330,5,2851,1657,-30
28653312913,28653312917,4,2304,1853,-30
28659338097,28659338101,4,4071,1683,-30
28661169222,28661169229,7,2827,1502,-30
28662381964,28662381968,4,2030,1813,-30
28662442721,28662442714,-7,994,4184,-30
28664057025,28664057030,5,3183,2178,-30
28664608610,28664608614,4,1210,1121,-30
28664636482,28664636486,4,1967,1789,-30
28666175120,28666175126,6,2214,957,-30
28666214690,28666214697,7,811,311,-30
28668595973,28668595979,6,1692,1303,-30
28672378478,28672378484,6,2199,1220,-30
28674994487,28674994493,6,2538,996,-30
28676449588,28676449593,5,1983,1204,-30
28685013622,28685013626,4,2021,1418,-30
28689632199,28689632204,5,2003,1811,-30
28689886193,28689886198,5,2776,1470,-30
28691228889,28691228894,5,3367,1619,-30
28695473897,28695473902,5,1593,926,-30
28696399657,28696399662,5,2680,1553,-30
28697126134,28697126141,7,1850,996,-30
28698627299,28698627303,4,1446,923,-30
28699241786,28699241794,8,1487,1081,-30
28700248508,28700248509,1,23,2752,-30
28704256758,28704256754,-4,1285,4446,-30
28704388359,28704388363,4,2005,1328,-30
28706970109,28706970112,3,2470,1745,-30
28707401411,28707401414,3,1739,1753,-30
28708582515,28708582518,3,1861,1238,-30
28711410826,28711410831,5,2211,984,-30
28712756884,28712756887,3,2379,1258,-30
28714166023,28714166023,0,1137,1083,-30
28714693890,28714693890,0,1136,2828,-30
28716802375,28716802381,6,1758,1163,-30
28720284997,28720285003,6,2625,865,-30
28726055791,28726055798,7,2192,1045,-30
28726162966,28726162953,-13,1162,290,-30
28727369734,28727369741,7,1656,1214,-30
28730583859,28730583866,7,2898,1674,-30
28737879204,28737879207,3,3637,3411,-30
28738269759,28738269762,3,1634,1286,-30
28739503371,28739503376,5,2307,1315,-30
28739544433,28739544442,9,2145,1112,-30
28745960498,28745960500,2,1453,1297,-30
28747738895,28747738900,5,1235,846,-30
28748863075,28748863080,5,1189,1283,-30
28749545933,28749545934,1,1897,1288,-30
28760771986,28760771993,7,2672,1587,-30
28763299138,28763299142,4,2045,1377,-30
28767329175,28767329163,-12,31249,15787,-30
28771123975,28771123979,4,2025,1558,-30
28773765307,28773765313,6,2928,1580,-30
28779538775,28779538780,5,2114,1358,-30
28779734815,28779734835,20,957,298,-30
28780309958,28780309962,4,1646,933,-30
28781183353,28781183359,6,2690,972,-30
28785799375,28785799379,4,2582,1336,-30
28787811738,28787811743,5,2735,1394,-30
28787990500,28787990503,3,2526,1584,-30
28788105294,28788105299,5,2434,1244,-30
28792612534,28792612539,5,1542,1158,-30
28796547125,28796547128,3,2160,1910,-30
28798194810,28798194814,4,1834,1429,-30
28800514178,28800514186,8,2463,1416,-30
28806415511,28806415518,7,2527,1218,-30
28807272625,28807272630,5,2210,1457,-30
28811719397,28811719402,5,19834,27386,-30
28818068645,28818068651,6,3330,1794,-30
28818188838,28818188843,5,2835,1253,-30
28820067828,28820067833,5,3605,1878,-30
28820550110,28820550115,5,1930,1628,-30
28827440552,28827440556,4,1025,1975,-30
28829995983,28829995988,5,1772,1518,-30
28831970207,28831970211,4,3400,1397,-30
28834293630,28834293630,0,819,1136,-30
28836715994,28836715998,4,1721,1388,-30
28838227957,28838227961,4,2298,1893,-30
28838506698,28838506701,3,1150,975,-30
28839130473,28839130478,5,2529,1585,-30
28840366938,28840366943,5,1653,1098,-30
28840440255,28840440259,4,2597,1831,-30
28843002373,28843002377,4,2611,1839,-30
28843823623,28843823627,4,1923,1191,-30
28845252301,28845252307,6,2653,1623,-30
28845704597,28845704603,6,2715,1306,-30
28852332886,28852332893,7,1162,1127,-30
28853983914,28853983920,6,2245,1231,-30
28859732778,28859732785,7,1596,781,-30
28861341025,28861341030,5,2238,1458,-30
28862280880,28862280886,6,2755,1774,-30
28862362321,28862362326,5,2425,1330,-30
28868373690,28868373697,7,2469,1103,-30
28870265097,28870265103,6,2310,1104,-30
28871190101,28871190080,-21,2238,1487,-30
28871937351,28871937336,-15,1235,447,-30
28875670002,28875670006,4,2246,1581,-30
28881384369,28881384373,4,2040,1495,-30
28882617578,28882617582,4,1521,972,-30
28883342690,28883342698,8,2621,1575,-30
28887403400,28887403402,2,1756,1665,-30
28889145495,28889145495,0,696,1745,-30
28889957238,28889957243,5,1912,1242,-30
28890117697,28890117683,-14,2314,1051,-30
28890287599,28890287603,4,2067,2136,-30
28890756428,28890756434,6,2609,1788,-30
28891030470,28891030469,-1,1596,1576,-30
28892492380,28892492382,2,8499,9126,-30
28895655196,28895655203,7,2076,1144,-30
28896730552,28896730558,6,2005,1175,-30
28900592049,28900592053,4,2040,1084,-30
28901444204,28901444208,4,2188,1132,-30
28902691874,28902691878,4,2698,1461,-30
28906587459,28906587460,1,1266,1838,-30
28908151310,28908151315,5,1470,779,-30
28910785312,28910785317,5,3606,1694,-30
28913432702,28913432708,6,2013,1359,-30
28915231579,28915231578,-1,1088,1089,-30
28920171978,28920171983,5,1878,1536,-30
28920590581,28920590586,5,3395,1866,-30
28923119661,28923119664,3,2025,1410,-30
28926216653,28926216657,4,2625,1439,-30
28939247176,28939247181,5,2155,1126,-30
28943553230,28943553235,5,3289,1414,-30
28955085955,28955085960,5,1585,1187,-30
28956494615,28956494593,-22,2157,1030,-30
28962181622,28962181637,15,17,1326,-30
28966173237,28966173239,2,2129,1806,-30
28966602111,28966602115,4,1390,994,-30
28966691630,28966691610,-20,3906,1327,-30
28971606706,28971606697,-9,40451,17657,-30
28972859069,28972859075,6,1938,1267,-30
28975456687,28975456693,6,2710,2021,-30
28976593454,28976593458,4,3391,2105,-30
28997932272,28997932277,5,1649,872,-30
28999625732,28999625737,5,1621,1343,-30
29001063339,29001063343,4,1619,1743,-30
29002232420,29002232422,2,2507,2030,-30
29005632043,29005632040,-3,941,3338,-30
29006634765,29006634770,5,1343,893,-30
29009719416,29009719422,6,2826,1423,-30
29011004257,29011004261,4,3120,1508,-30
29022776631,29022776636,5,2601,1205,-30
29028096257,29028096263,6,2508,1165,-30
29029894938,29029894943,5,2714,1425,-30
29032188855,29032188861,6,2657,1665,-30
29032660677,29032660683,6,2274,1379,-30
29034005558,29034005565,7,1787,1237,-30
29034038682,29034038682,0,875,992,-30
29036671074,29036671078,4,2170,1181,-30
29037877034,29037877041,7,1631,860,-30
29039264457,29039264475,18,556,440,-30
29040509222,29040509226,4,2112,1252,-30
29041705141,29041705124,-17,894,216,-30
29042511477,29042511481,4,3073,1495,-30
29043194080,29043194083,3,2174,1770,-30
29043268695,29043268697,2,1598,1128,-30
29044350200,29044350195,-5,1190,3105,-30
29044540096,29044540102,6,2465,1391,-30
29044628346,29044628351,5,2279,1148,-30
29045422199,29045422205,6,1480,1158,-30
29050588898,29050588901,3,2207,1682,-30
29050763709,29050763714,5,1468,1590,-30
29053611230,29053611237,7,1638,1312,-30
29067647593,29067647595,2,1336,1171,-30
29069347296,29069347282,-14,398,1033,-30
29069610848,29069610849,1,1965,1274,-30
29073065228,29073065233,5,1104,538,-30
29080173021,29080173022,1,2203,2092,-30
29080719454,29080719457,3,2668,1045,-30
29081250869,29081250874,5,2856,1267,-30
29088208010,29088208014,4,1698,1495,-30
29088277502,29088277508,6,1333,768,-30
29089063455,29089063432,-23,476,392,-30
29091936815,29091936819,4,1483,1249,-30
29093587877,29093587884,7,2735,1958,-30
29093627292,29093627315,23,1784,1114,-30
29094026666,29094026650,-16,1904,1161,-30
29098601663,29098601669,6,2209,1097,-30
29105179199,29105179206,7,1979,1016,-30
29106004172,29106004177,5,2020,1418,-30
29112413309,29112413311,2,1404,1310,-30
29114191905,29114191910,5,2140,1282,-30
29115372750,29115372754,4,2268,1294,-30
29115532287,29115532294,7,2743,1260,-30
29115703540,29115703548,8,3172,1708,-30
29117741630,29117741634,4,2012,1153,-30
29119394777,29119394782,5,1425,1395,-30
29121124174,29121124181,7,2932,1567,-30
29123828602,29123828610,8,2065,1387,-30
29124129661,29124129641,-20,2577,1305,-30
29130056680,29130056667,-13,1107,388,-30
29134407354,29134407355,1,1323,1343,-30
29139877911,29139877906,-5,1312,2567,-30
29143088437,29143088430,-7,1234,4735,-30
29143710514,29143710517,3,1199,1111,-30
29144050605,29144050608,3,1667,1808,-30
29144756612,29144756617,5,2509,1090,-30
29148341710,29148341717,7,2621,1565,-30
29150977858,29150977863,5,3062,1475,-30
29151488529,29151488533,4,1772,1280,-30
29152686874,29152686877,3,1179,930,-30
29153173283,29153173287,4,1285,1044,-30
29157878690,29157878693,3,2058,759,-30
29159537361,29159537363,2,1146,876,-30
29162028798,29162028802,4,1323,1033,-30
29164695164,29164695169,5,2533,1419,-30
29166264612,29166264617,5,3182,1741,-30
29172013609,29172013613,4,2006,1044,-30
29172766136,29172766139,3,1713,967,-30
29176336032,29176336038,6,2627,1285,-30
29182064186,29182064188,2,1867,1486,-30
29186817366,29186817370,4,2073,2320,-30
29190063650,29190063643,-7,2160,10287,-30
29191745054,29191745059,5,1517,1084,-30
29192953601,29192953606,5,2658,1254,-30
29193080878,29193080882,4,2060,1597,-30
29194593873,29194593878,5,1742,1276,-30
29197210077,29197210081,4,1659,1051,-30
29197858449,29197858454,5,2415,947,-30
29198707736,29198707741,5,2291,1389,-30
29203935202,29203935206,4,2429,1159,-30
29207127918,29207127922,4,1501,1365,-30
29212536573,29212536580,7,5683,2645,-30
29214252532,29214252547,15,1017,3999,-30
29215242409,29215242413,4,1204,507,-30
29217075209,29217075203,-6,1404,3467,-30
29218576046,29218576050,4,1380,1107,-30
29218763563,29218763569,6,2354,1406,-30
29219058590,29219058594,4,2756,1528,-30
29221145662,29221145666,4,2504,1341,-30
29222790400,29222790403,3,1224,1079,-30
29227709834,29227709839,5,1986,1757,-30
29231283933,29231283937,4,3073,1250,-30
29231551388,29231551391,3,2428,1739,-30
29232047975,29232047979,4,2839,1344,-30
29232286109,29232286114,5,1836,995,-30
29232884099,29232884104,5,3204,1939,-30
29233664181,29233664186,5,2029,1311,-30
29234311789,29234311787,-2,1455,934,-30
29234769190,29234769203,13,1153,906,-30
29240458970,29240458971,1,1302,1061,-30
29241086753,29241086757,4,3500,2757,-30
29241722974,29241722979,5,2159,1591,-30
29247170886,29247170888,2,6993,28438,-30
29247287855,29247287860,5,1731,1548,-30
29249412374,29249412378,4,1612,1489,-30
29255519270,29255519264,-6,1435,3666,-30
29260728218,29260728223,5,2761,1326,-30
29261131255,29261131259,4,2269,1994,-30
29261852277,29261852282,5,2850,1279,-30
29267136543,29267136538,-5,476,1762,-30
29267558702,29267558706,4,2153,1807,-30
29268677537,29268677541,4,2402,1394,-30
29268741759,29268741739,-20,882,119,-30
29270261461,29270261465,4,1761,1265,-30
29272024742,29272024737,-5,1286,6142,-30
29274170330,29274170346,16,380,1806,-30
29276682805,29276682810,5,2437,1042,-30
29278139062,29278139067,5,2130,1709,-30
29280923957,29280923961,4,2208,1604,-30
29281630582,29281630589,7,1971,1073,-30
29284733406,29284733411,5,2541,1881,-30
29290070774,29290070778,4,2045,1405,-30
29290817045,29290817049,4,1806,1032,-30
29301501146,29301501144,-2,1182,2786,-30
29304942137,29304942142,5,2325,1171,-30
29306317906,29306317912,6,2007,1566,-30
29308661510,29308661514,4,1886,1559,-30
29308987207,29308987217,10,866,182,-30
29310765598,29310765603,5,3624,1628,-30
29313488885,29313488889,4,2031,1532,-30
29314977374,29314977377,3,1798,1889,-30
29317772085,29317772087,2,1508,1237,-30
29321702481,29321702487,6,2688,1647,-30
29322860713,29322860718,5,2346,1397,-30
29326380157,29326380163,6,2754,1394,-30
29329096818,29329096822,4,2533,1699,-30
29331605985,29331605990,5,2154,1228,-30
29333801387,29333801390,3,2700,1442,-30
29337678482,29337678477,-5,29238,15457,-30
29338795957,29338795962,5,2714,1442,-30
29343810256,29343810262,6,1761,1309,-30
29344156062,29344156063,1,1128,916,-30
29345178450,29345178455,5,2465,1292,-30
29346550943,29346550946,3,2613,1550,-30
29346957539,29346957546,7,2732,1314,-30
29349348244,29349348248,4,2258,1519,-30
29349546974,29349546977,3,2432,1932,-30
29357248282,29357248286,4,3108,1373,-30
29357289317,29357289322,5,1911,1154,-30
29357725958,29357725963,5,1856,1423,-30
29358579430,29358579434,4,1956,1464,-30
29361730932,29361730934,2,1088,1223,-30
29363481097,29363481098,1,1114,665,-30
29367862845,29367862846,1,1471,1146,-30
29368161206,29368161210,4,2047,1302,-30
29369541761,29369541763,2,1645,1792,-30
29370102299,29370102298,-1,947,2106,-30
29370232472,29370232478,6,2209,1606,-30
29371200212,29371200225,13,1719,1237,-30
29372788662,29372788666,4,1407,1246,-30
29378964447,29378964449,2,1693,1112,-30
29387477902,29387477907,5,2019,1276,-30
29387738179,29387738182,3,1623,1148,-30
29387838509,29387838521,12,2675,1106,-30
29389498418,29389498424,6,3118,1714,-30
29392441205,29392441210,5,3610,1714,-30
29394734194,29394734199,5,2666,896,-30
29398103252,29398103258,6,3015,1555,-30
29399995390,29399995394,4,1483,913,-30
29401033492,29401033497,5,1717,1175,-30
29402000202,29402000219,17,1898,960,-30
29407962199,29407962207,8,4835,1585,-30
29408787790,29408787794,4,1740,1148,-30
29410706450,29410706458,8,12128,22122,-30
29412298229,29412298233,4,1916,1433,-30
29415978688,29415978694,6,1608,1091,-30
29421542931,29421542934,3,1283,1673,-30
29423422445,29423422450,5,3659,1643,-30
29424937682,29424937686,4,2540,1509,-30
29426000405,29426000411,6,1570,947,-30
29427047370,29427047377,7,2745,1598,-30
29427336837,29427336838,1,2085,1511,-30
29430227886,29430227878,-8,721,3323,-30
29435210197,29435210201,4,2752,1226,-30
29437308226,29437308228,2,2381,2167,-30
29438375074,29438375079,5,1356,1102,-30
29439909087,29439909093,6,4628,1284,-30
29441752598,29441752603,5,2277,1149,-30
29443592903,29443592885,-18,1861,1120,-30
29443774045,29443774049,4,1543,1254,-30
29444517367,29444517374,7,4543,1844,-30
29450170913,29450170919,6,2773,1228,-30
29451254149,29451254154,5,2577,1205,-30
29453146201,29453146205,4,2358,1881,-30
29462125372,29462125376,4,2580,1359,-30
29465169866,29465169870,4,1767,1375,-30
29466605752,29466605758,6,2283,1478,-30
29466937777,29466937793,16,2498,1566,-30
29467545030,29467545033,3,1299,960,-30
29470310497,29470310501,4,2674,1328,-30
29476394779,29476394782,3,1677,1116,-30
29478409890,29478409894,4,2024,1422,-30
29484821473,29484821479,6,3339,1210,-30
29485062446,29485062457,11,2971,1891,-30
29485859548,29485859553,5,2054,1366,-30
29486856454,29486856460,6,792,753,-30
29487908654,29487908660,6,3343,1939,-30
29492772358,29492772363,5,2915,1353,-30
29493601067,29493601070,3,2193,1071,-30
29493741154,29493741158,4,1825,669,-30
29496974191,29496974197,6,3429,1739,-30
29500013117,29500013112,-5,1208,3678,-30
29502758903,29502758906,3,2307,1389,-30
29506002719,29506002722,3,2158,1468,-30
29506216229,29506216251,22,2440,1013,-30
29507281830,29507281827,-3,1025,2164,-30
29508065085,29508065086,1,2045,1374,-30
29516589266,29516589271,5,1317,707,-30
29517665601,29517665604,3,2781,1821,-30
29518618657,29518618660,3,1994,1748,-30
29518895859,29518895866,7,2092,1211,-30
29518922762,29518922769,7,1800,881,-30
29522284906,29522284912,6,2422,1440,-30
29522713326,29522713327,1,1039,1030,-30
29525403184,29525403191,7,2374,1232,-30
29525527634,29525527629,-5,1858,7446,-30
29526719470,29526719474,4,2795,1758,-30
29530604883,29530604889,6,3068,1307,-30
29532749649,29532749653,4,2310,1181,-30
29532871606,29532871611,5,2140,949,-30
29535311785,29535311789,4,1699,1043,-30
29541009245,29541009249,4,1859,1342,-30
29543878239,29543878223,-16,2665,1251,-30
29546511313,29546511317,4,2032,1377,-30
29551553327,29551553332,5,1946,1227,-30
29552051488,29552051492,4,2260,994,-30
29558297030,29558297035,5,2615,1107,-30
29559494841,29559494847,6,1946,1509,-30
29562445090,29562445095,5,2170,1109,-30
29564090870,29564090875,5,2053,1201,-30
29568044385,29568044390,5,13439,40853,-30
29570916231,29570916234,3,1979,1073,-30
29571928372,29571928374,2,2978,2216,-30
29573076690,29573076695,5,2084,1289,-30
29574174536,29574174530,-6,21866,15391,-30
29577639200,29577639204,4,2121,1393,-30
29583280249,29583280254,5,2438,1171,-30
29583963629,29583963634,5,2138,999,-30
29587618702,29587618706,4,1242,974,-30
29587866911,29587866890,-21,959,375,-30
29589337395,29589337399,4,2757,1926,-30
29591583942,29591583946,4,2614,1598,-30
29597800081,29597800080,-1,1163,1447,-30
29598120618,29598120603,-15,1066,726,-30
29606952145,29606952149,4,2562,1614,-30
29607855705,29607855704,-1,1519,2201,-30
29610450723,29610450727,4,1733,1142,-30
29610512779,29610512785,6,2574,1368,-30
29613145242,29613145247,5,2112,924,-30
29619443222,29619443230,8,3544,1514,-30
29623709434,29623709439,5,2966,1191,-30
29624211385,29624211395,10,521,191,-30
29628655482,29628655487,5,2690,1246,-30
29628950385,29628950388,3,4830,2358,-30
29629565563,29629565569,6,1999,1173,-30
29629973098,29629973115,17,2022,937,-30
29631491458,29631491464,6,2459,1366,-30
29632107763,29632107761,-2,1303,2295,-30
29635039587,29635039570,-17,889,696,-30
29635420013,29635419999,-14,2308,1122,-30
29636141791,29636141794,3,2578,1335,-30
29637114257,29637114260,3,2610,1460,-30
29641042955,29641042959,4,1951,1062,-30
29642688713,29642688717,4,2515,1406,-30
29644251811,29644251806,-5,806,2104,-30
29649637456,29649637461,5,1916,1107,-30
29654985025,29654985031,6,3326,1366,-30
29660501482,29660501489,7,2441,1502,-30
29662899133,29662899137,4,4039,2243,-30
29667134548,29667134553,5,2153,1109,-30
29671267675,29671267679,4,1231,1698,-30
29673988477,29673988482,5,1565,1054,-30
29674777614,29674777619,5,1328,1044,-30
29674865645,29674865644,-1,2075,2785,-30
29680143249,29680143257,8,3357,1693,-30
29680604341,29680604347,6,2285,1379,-30
29681396815,29681396821,6,1996,1156,-30
29684211136,29684211141,5,2576,1842,-30
29685563122,29685563127,5,1461,1282,-30
29686048315,29686048320,5,1761,1274,-30
29686820598,29686820618,20,2670,1209,-30
29687464947,29687464951,4,2434,1568,-30
29689419291,29689419295,4,1698,1385,-30
29694183759,29694183765,6,3402,1234,-30
29697081909,29697081914,5,2231,1128,-30
29698468593,29698468597,4,1687,1027,-30
29700184395,29700184399,4,2458,1220,-30
29700683309,29700683314,5,2498,1238,-30
29701591117,29701591100,-17,2258,1181,-30
29709850899,29709850905,6,2269,1405,-30
29709877541,29709877546,5,2408,1111,-30
29711020449,29711020454,5,2095,1114,-30
29713171101,29713171107,6,2984,1843,-30
29713292670,29713292676,6,1802,747,-30
29713929943,29713929941,-2,930,2756,-30
29715386421,29715386426,5,2832,1759,-30
29716482358,29716482363,5,1885,987,-30
29719422958,29719422962,4,2369,1433,-30
29719628428,29719628434,6,3150,949,-30
29724645838,29724645843,5,3058,1967,-30
29727863294,29727863301,7,1246,967,-30
29729709050,29729709055,5,3027,1542,-30
29735240260,29735240260,0,1622,2436,-30
29737650909,29737650902,-7,23,1469,-30
29739406718,29739406725,7,3089,1424,-30
29741045793,29741045791,-2,1331,1542,-30
29747043647,29747043650,3,3432,2937,-30
29751385982,29751385985,3,2268,1165,-30
29755801972,29755801976,4,2347,1282,-30
29757893185,29757893189,4,2525,1229,-30
29762184965,29762184971,6,2445,1439,-30
29767375574,29767375579,5,1788,1082,-30
29768673304,29768673299,-5,970,2493,-30
29769612305,29769612310,5,3352,1566,-30
29774819774,29774819779,5,2353,1668,-30
29775914927,29775914931,4,2097,1396,-30
29776070522,29776070526,4,2051,1543,-30
29777173290,29777173294,4,1746,1093,-30
29781161708,29781161714,6,2070,869,-30
29783354453,29783354460,7,3124,1333,-30
29783767990,29783768003,13,1514,999,-30
29784220151,29784220136,-15,904,789,-30
29787618352,29787618358,6,2769,1188,-30
29788337063,29788337067,4,2504,1769,-30
29788379876,29788379878,2,2085,976,-30
29788964640,29788964646,6,1749,765,-30
29790628191,29790628196,5,3069,1224,-30
29797008501,29797008507,6,2103,1026,-30
29797702618,29797702624,6,2072,988,-30
29803274618,29803274625,7,2759,1418,-30
29803957811,29803957817,6,2226,1372,-30
29806567724,29806567730,6,4311,2430,-30
29806751957,29806751961,4,1581,1428,-30
29810957570,29810957575,5,2234,1189,-30
29817735934,29817735939,5,2273,1233,-30
29820926281,29820926282,1,1725,989,-30
29823171469,29823171474,5,2289,1205,-30
29823896190,29823896194,4,2042,1144,-30
29825165611,29825165616,5,1536,1280,-30
29829929151,29829929159,8,1910,1663,-30
29832244908,29832244913,5,2492,1259,-30
29833087005,29833087012,7,2603,1720,-30
29835141171,29835141178,7,2076,976,-30
29835541240,29835541246,6,2699,1387,-30
29838970603,29838970616,13,1170,819,-30
29844094860,29844094863,3,2377,2247,-30
29846079474,29846079479,5,1199,1022,-30
29847955989,29847955994,5,2570,1142,-30
29850745727,29850745731,4,2280,1163,-30
29851769853,29851769858,5,1684,1036,-30
29854337085,29854337091,6,2100,1217,-30
29854397347,29854397337,-10,430,391,-30
29855090694,29855090700,6,2508,1398,-30
29855692982,29855692988,6,1522,1441,-30
29857805632,29857805629,-3,1143,968,-30
29860583258,29860583262,4,1907,1284,-30
29862347904,29862347909,5,2285,1034,-30
29862906409,29862906414,5,2693,1025,-30
29866525083,29866525089,6,2734,1196,-30
29867395942,29867395947,5,2400,1398,-30
29869483251,29869483259,8,3307,1110,-30
29874424965,29874424970,5,2464,1541,-30
29874823130,29874823135,5,2958,1478,-30
29875889259,29875889264,5,2317,1854,-30
29878719191,29878719198,7,2614,1050,-30
29879698734,29879698738,4,2514,903,-30
29880280878,29880280858,-20,1733,1027,-30
29880745773,29880745781,8,1808,915,-30
29881811025,29881811029,4,2496,1365,-30
29883251245,29883251250,5,3208,1838,-30
29883377875,29883377868,-7,1216,4360,-30
29883674665,29883674671,6,2830,1412,-30
29883762207,29883762210,3,1089,1117,-30
29884802501,29884802502,1,1234,1722,-30
29885218578,29885218583,5,2148,1172,-30
29892736014,29892736019,5,1902,1123,-30
29892865207,29892865211,4,1694,1439,-30
29896957677,29896957675,-2,999,2014,-30
29897727762,29897727767,5,2249,962,-30
29897878206,29897878213,7,3008,1505,-30
29900311782,29900311787,5,2320,1610,-30
29900799756,29900799762,6,2833,890,-30
29902997129,29902997133,4,2580,1706,-30
29904380050,29904380054,4,2823,1052,-30
29910030380,29910030386,6,1687,1113,-30
29910767946,29910767950,4,1824,1588,-30
29912766442,29912766452,10,14364,31532,-30
29917061226,29917061227,1,2402,1412,-30
29917147203,29917147207,4,1729,1376,-30
29918211318,29918211321,3,2158,1670,-30
29921503177,29921503183,6,2503,1492,-30
29922405737,29922405743,6,1982,1395,-30
29924656525,29924656530,5,3189,2045,-30
29924885966,29924885952,-14,50295,8684,-30
29932602042,29932602046,4,2687,1041,-30
29933381817,29933381827,10,2590,1380,-30
29937561129,29937561134,5,1779,1168,-30
29937654839,29937654848,9,540,282,-30
29940570225,29940570229,4,2755,1123,-30
29941882741,29941882747,6,2385,1826,-30
29946036269,29946036274,5,2305,1302,-30
29946890378,29946890362,-16,936,1109,-30
29951307667,29951307672,5,2456,1644,-30
29951937078,29951937084,6,2968,1025,-30
29959332287,29959332307,20,1005,2566,-30
29960108469,29960108471,2,1617,2388,-30
29962868798,29962868802,4,1917,1453,-30
29964961970,29964961974,4,2258,1447,-30
29965051137,29965051142,5,1695,1257,-30
29966290165,29966290167,2,1010,748,-30
29966893950,29966893955,5,1914,1203,-30
29967296601,29967296605,4,2542,1394,-30
29971687970,29971687968,-2,1002,2153,-30
29972569509,29972569514,5,2460,1087,-30
29973684248,29973684251,3,1377,1374,-30
29974895375,29974895379,4,1753,1371,-30
29978368717,29978368721,4,1406,1256,-30
29979498430,29979498435,5,1551,1163,-30
29983289766,29983289771,5,2240,1195,-30
29987139438,29987139442,4,2045,1160,-30
29987902362,29987902367,5,3492,1483,-30
29988424658,29988424663,5,2207,1483,-30
29988776301,29988776305,4,1808,1177,-30
29991042039,29991042045,6,2797,1795,-30
29996255759,29996255763,4,1679,1223,-30
29999244675,29999244679,4,1204,1167,-30
30001050861,30001050866,5,2505,1529,-30
30003539617,30003539622,5,2245,1286,-30
30004820470,30004820475,5,3120,1843,-30
30005165002,30005165006,4,2334,1329,-30
30005278818,30005278825,7,1677,1152,-30
30007642802,30007642807,5,1916,1364,-30
30009728645,30009728649,4,2586,1373,-30
30009763776,30009763782,6,2033,1162,-30
30019908154,30019908159,5,2449,1187,-30
30021481561,30021481565,4,2078,1672,-30
30025145469,30025145473,4,1907,870,-30
30030799573,30030799577,4,2351,1657,-30
30036256861,30036256866,5,1679,1341,-30
30039849103,30039849108,5,1851,1244,-30
30045084361,30045084366,5,3678,1755,-30
30045205533,30045205525,-8,29194,18191,-30
30047332372,30047332377,5,1712,1355,-30
30054400969,30054400973,4,2675,1224,-30
30056362910,30056362910,0,859,989,-30
30057182021,30057182026,5,2971,1616,-30
30060511522,30060511527,5,2527,1383,-30
30060610786,30060610792,6,2759,1538,-30
30065532495,30065532495,0,1213,1123,-30
30075595968,30075595974,6,2926,1560,-30
30078568761,30078568757,-4,1680,2293,-30
30079705589,30079705594,5,2897,1262,-30
30079968574,30079968579,5,1912,1159,-30
30084109642,30084109623,-19,1117,431,-30
30086966125,30086966130,5,1869,1339,-30
30089565017,30089565023,6,1615,460,-30
30089902785,30089902789,4,3124,1829,-30
30091810416,30091810420,4,2028,1090,-30
30092398966,30092398971,5,2298,1117,-30
30093556519,30093556526,7,1205,981,-30
30093771990,30093771970,-20,1678,1074,-30
30093884429,30093884433,4,1565,1282,-30
30093955374,30093955356,-18,1186,374,-30
30101036713,30101036718,5,2011,845,-30
30101763421,30101763426,5,3039,1682,-30
30102426881,30102426887,6,1977,1465,-30
30104860966,30104860970,4,2087,1391,-30
30106616039,30106616040,1,1374,1481,-30
30109332538,30109332542,4,1177,816,-30
30115217816,30115217821,5,2686,1322,-30
30117266482,30117266484,2,1956,1920,-30
30120161950,30120161954,4,1956,1272,-30
30120333550,30120333554,4,2007,1374,-30
30120600564,30120600569,5,1566,1037,-30
30121013662,30121013666,4,2097,1037,-30
30122094201,30122094205,4,2208,1636,-30
30126471636,30126471642,6,1760,1293,-30
30128791878,30128791882,4,3079,1367,-30
30131176366,30131176371,5,1513,1024,-30
30132521589,30132521594,5,2789,1764,-30
30133025480,30133025486,6,3333,1477,-30
30133292888,30133292890,2,1628,1457,-30
30144561506,30144561513,7,1727,1217,-30
30147852707,30147852714,7,2464,1680,-30
30148804294,30148804301,7,1976,1052,-30
30151483238,30151483243,5,2517,1172,-30
30151775727,30151775730,3,1108,1073,-30
30159353313,30159353319,6,2304,1201,-30
30159938482,30159938487,5,6301,3232,-30
30165790242,30165790249,7,2487,1026,-30
30175365486,30175365491,5,1852,1275,-30
30176404322,30176404329,7,1838,1333,-30
30178302137,30178302142,5,1620,1253,-30
30179467077,30179467082,5,2219,1277,-30
30181346200,30181346204,4,2580,1336,-30
30181983609,30181983611,2,1725,976,-30
30182727165,30182727167,2,2318,1741,-30
30192760898,30192760903,5,1937,1323,-30
30194706416,30194706421,5,2074,1524,-30
30195923787,30195923793,6,1996,1170,-30
30196224510,30196224490,-20,1648,533,-30
30196769252,30196769255,3,2799,2036,-30
30200016782,30200016787,5,2363,983,-30
30205423751,30205423757,6,2365,1535,-30
30205881549,30205881555,6,2487,1189,-30
30207003370,30207003374,4,2610,1337,-30
30209345465,30209345469,4,2375,1606,-30
30210111509,30210111514,5,1728,969,-30
30212205161,30212205158,-3,748,1763,-30
30213520562,30213520567,5,2599,1257,-30
30213772419,30213772411,-8,32938,14024,-30
30217369767,30217369774,7,2676,1843,-30
30217979631,30217979638,7,2022,1438,-30
30218637567,30218637547,-20,2566,1346,-30
30218964571,30218964575,4,2185,1376,-30
30219210776,30219210781,5,2701,1705,-30
30219636146,30219636153,7,3300,1666,-30
30220428282,30220428287,5,1078,1136,-30
30221532270,30221532283,13,476,1816,-30
30227875643,30227875649,6,2234,1483,-30
30229846576,30229846581,5,2109,1773,-30
30230539046,30230539050,4,2379,1644,-30
30236081220,30236081218,-2,1108,1972,-30
30243298638,30243298642,4,1671,1109,-30
30248314724,30248314727,3,2164,1352,-30
30252662785,30252662790,5,2455,1340,-30
30254577338,30254577342,4,2816,1743,-30
30259856918,30259856921,3,1801,1551,-30
30265187397,30265187404,7,1646,1060,-30
30266676310,30266676315,5,2748,1402,-30
30266738406,30266738411,5,1937,1050,-30
30267324493,30267324501,8,2610,1225,-30
30268443226,30268443233,7,12297,5189,-30
30268712686,30268712692,6,2198,1376,-30
30269726218,30269726223,5,2768,1421,-30
30270208660,30270208666,6,2047,963,-30
30271366734,30271366741,7,2234,1193,-30
30272169029,30272169035,6,2822,1501,-30
30273563767,30273563745,-22,1320,1913,-30
30275115807,30275115813,6,2905,1148,-30
30276675336,30276675340,4,3196,2723,-30
30276890287,30276890290,3,1809,1502,-30
30284513673,30284513678,5,2481,1016,-30
30285962618,30285962622,4,1810,1721,-30
30287385062,30287385066,4,2910,1183,-30
30290597210,30290597213,3,1359,1560,-30
30294363200,30294363205,5,2744,1555,-30
30294696123,30294696117,-6,1137,3256,-30
30300660137,30300660139,2,1737,1116,-30
30301969282,30301969267,-15,2734,1110,-30
30302807582,30302807589,7,2069,1258,-30
30303076851,30303076855,4,1189,1077,-30
30304162666,30304162680,14,15596,53317,-30
30304320620,30304320613,-7,1226,4818,-30
30304696086,30304696089,3,2679,1578,-30
30304757426,30304757431,5,2292,1466,-30
30307418218,30307418223,5,1680,1694,-30
30310871673,30310871679,6,785,114,-30
30312901074,30312901078,4,2844,1640,-30
30313871253,30313871258,5,3041,1318,-30
30319499867,30319499863,-4,1015,3562,-30
30326135223,30326135229,6,2212,987,-30
30327022118,30327022096,-22,2019,1215,-30
30328386078,30328386082,4,2798,1806,-30
30341500733,30341500738,5,1574,1383,-30
30342584894,30342584890,-4,2314,5379,-30
30345391250,30345391255,5,2618,1167,-30
30346251994,30346251999,5,2106,1461,-30
30346892467,30346892474,7,1665,995,-30
30351638422,30351638427,5,1802,819,-30
30351929107,30351929111,4,2356,1544,-30
30356588967,30356588973,6,1470,1064,-30
30357313955,30357313957,2,1189,1540,-30
30359546925,30359546929,4,1732,1390,-30
30362311902,30362311909,7,2602,1238,-30
30363036223,30363036201,-22,1278,1973,-30
30363068642,30363068622,-20,1622,756,-30
30364955737,30364955743,6,2125,1379,-30
30366082674,30366082679,5,2101,1336,-30
30370022133,30370022138,5,2679,1332,-30
30371670223,30371670226,3,1420,1154,-30
30371994363,30371994362,-1,1369,1944,-30
30378511770,30378511775,5,2505,1237,-30
30379983302,30379983283,-19,568,193,-30
30381172853,30381172859,6,2642,1684,-30
30382739993,30382740001,8,2523,1573,-30
30385005730,30385005737,7,2328,939,-30
30388453079,30388453083,4,1442,1238,-30
30388657109,30388657114,5,2185,1055,-30
30399238150,30399238153,3,1781,1314,-30
30406933878,30406933882,4,2922,1257,-30
30408112086,30408112091,5,1922,1016,-30
30409706039,30409706045,6,2478,1256,-30
30410477710,30410477714,4,2950,1155,-30
30417516637,30417516642,5,2184,1270,-30
30418556582,30418556589,7,2486,1372,-30
30423438436,30423438442,6,2300,1563,-30
30425705360,30425705365,5,2018,1150,-30
30426319853,30426319857,4,2046,1450,-30
30430214593,30430214597,4,1897,1590,-30
30435861718,30435861717,-1,6265,9071,-30
30436907247,30436907225,-22,1061,599,-30
30439940966,30439940963,-3,972,2410,-30
30445955581,30445955585,4,2721,1181,-30
30447527403,30447527408,5,1522,1043,-30
30450251152,30450251155,3,1673,982,-30
30454476188,30454476193,5,1510,1303,-30
30459431350,30459431355,5,1693,541,-30
30462140616,30462140617,1,1764,1928,-30
30463796425,30463796430,5,1866,1056,-30
30468557721,30468557725,4,2284,1131,-30
30470135042,30470135045,3,1698,1311,-30
30475283326,30475283333,7,2031,1238,-30
30475441781,30475441803,22,1532,1380,-30
30475910755,30475910757,2,1900,1531,-30
30479289057,30479289061,4,2559,1477,-30
30480014944,30480014947,3,2633,1764,-30
30484163854,30484163860,6,1601,1366,-30
30484265600,30484265605,5,1915,1284,-30
30487492925,30487492908,-17,2150,922,-30
30487939003,30487939009,6,3268,1588,-30
30489526048,30489526051,3,2246,1162,-30
30498930387,30498930391,4,1916,1140,-30
30499489593,30499489599,6,2338,1088,-30
30499582178,30499582163,-15,1395,493,-30
30504093208,30504093210,2,1955,1740,-30
30505053809,30505053814,5,2850,1593,-30
30511810907,30511810911,4,1667,1546,-30
30515172875,30515172881,6,2826,1326,-30
30521903382,30521903387,5,2285,1111,-30
30529097203,30529097207,4,2757,1761,-30
30541741310,30541741314,4,1844,1266,-30
30545803825,30545803830,5,2764,1544,-30
30553053066,30553053067,1,1454,1132,-30
30554987939,30554987942,3,2399,1497,-30
30556056014,30556056018,4,2266,1204,-30
30557021657,30557021662,5,2031,1422,-30
30557521372,30557521378,6,2587,986,-30
30558360753,30558360758,5,1850,1076,-30
30561714367,30561714373,6,2928,1555,-30
30562195566,30562195546,-20,1163,760,-30
30564379043,30564379051,8,2409,1060,-30
30564508010,30564508016,6,2985,1341,-30
30566108618,30566108623,5,2181,1231,-30
30568269835,30568269841,6,3260,1921,-30
30578604391,30578604394,3,2062,1100,-30
30579558850,30579558854,4,1257,913,-30
30581948182,30581948189,7,1849,1539,-30
30583896016,30583896023,7,2747,792,-30
30585265039,30585265044,5,1990,1465,-30
30587055623,30587055627,4,2407,1066,-30
30588887693,30588887695,2,1700,1274,-30
30590014017,30590014022,5,3212,1668,-30
30594731227,30594731233,6,3144,1529,-30
30597322488,30597322494,6,3434,1622,-30
30600142608,30600142602,-6,1557,961,-30
30606670774,30606670780,6,2544,1416,-30
30608113473,30608113478,5,1821,1042,-30
30610290014,30610290018,4,2861,1525,-30
30610516445,30610516450,5,2353,1059,-30
30611649005,30611649011,6,2207,1284,-30
30612519697,30612519702,5,2831,1611,-30
30613512723,30613512722,-1,1943,4200,-30
30614090496,30614090502,6,2877,1398,-30
30614169238,30614169243,5,3132,1175,-30
30614502191,30614502197,6,1262,713,-30
30615649454,30615649462,8,2326,1178,-30
30615730922,30615730937,15,714,386,-30
30617030890,30617030894,4,1660,1077,-30
30618368449,30618368454,5,2488,1358,-30
30618948806,30618948796,-10,917,283,-30
30619135530,30619135535,5,2032,1224,-30
30622876722,30622876727,5,1963,1394,-30
30626971365,30626971370,5,2944,1464,-30
30629171926,30629171930,4,1411,1671,-30
30630222656,30630222660,4,1620,1278,-30
30639432339,30639432343,4,2349,1582,-30
30641678395,30641678402,7,2413,1657,-30
30652528518,30652528524,6,2933,2152,-30
30655163640,30655163645,5,2715,1571,-30
30655653662,30655653666,4,2226,1601,-30
30655939034,30655939050,16,2044,1039,-30
30658966558,30658966563,5,2466,1283,-30
30660023694,30660023700,6,2381,1335,-30
30667603697,30667603702,5,2137,1693,-30
30670535506,30670535510,4,2093,1376,-30
30672693126,30672693131,5,1736,1082,-30
30672841950,30672841950,0,7830,18379,-30
30676913214,30676913219,5,935,666,-30
30682793254,30682793257,3,2298,1654,-30
30682996222,30682996228,6,2255,1121,-30
30684968984,30684968982,-2,1762,3062,-30
30685495377,30685495374,-3,715,1802,-30
30687295678,30687295683,5,2977,1402,-30
30687415506,30687415510,4,2019,870,-30
30687936639,30687936643,4,2643,1320,-30
30690653877,30690653883,6,2582,1451,-30
30691366991,30691366989,-2,45739,3960,-30
30691846825,30691846830,5,2625,1277,-30
30695085133,30695085138,5,2642,1286,-30
30695395278,30695395282,4,1807,1196,-30
30695501783,30695501786,3,1317,692,-30
30695692157,30695692176,19,1693,1308,-30
30695721202,30695721196,-6,899,175,-30
30701146225,30701146229,4,1994,1028,-30
30709695600,30709695603,3,2063,1518,-30
30711462429,30711462435,6,2154,1051,-30
30712199674,30712199678,4,1871,875,-30
30718462418,30718462422,4,2603,749,-30
30719023965,30719023948,-17,1385,1248,-30
30720090905,30720090909,4,3109,1118,-30
30721287359,30721287363,4,1787,1132,-30
30722471754,30722471758,4,1465,1163,-30
30725064383,30725064387,4,2863,1369,-30
30725476345,30725476349,4,1935,1170,-30
30732593997,30732593999,2,1560,1715,-30
30732917961,30732917966,5,2279,1099,-30
30732955781,30732955761,-20,2715,1283,-30
30735945208,30735945212,4,3167,1118,-30
30738116323,30738116326,3,2824,1493,-30
30740622032,30740622034,2,1896,1667,-30
30743072018,30743072022,4,2297,1474,-30
30746476899,30746476911,12,19,1271,-30
30746614310,30746614314,4,1808,861,-30
30747502742,30747502721,-21,1310,1334,-30
30748496025,30748496028,3,1355,1256,-30
30749791593,30749791576,-17,1590,982,-30
30752579074,30752579079,5,1731,1210,-30
30753110874,30753110879,5,2519,1248,-30
30753905972,30753905976,4,2058,1741,-30
30755365362,30755365344,-18,586,432,-30
30759561994,30759562000,6,2510,1432,-30
30760143348,30760143354,6,1951,1428,-30
30760884054,30760884059,5,2227,1315,-30
30761794496,30761794501,5,2987,2211,-30
30762173310,30762173314,4,2014,1334,-30
30763049772,30763049778,6,2318,1326,-30
30763278596,30763278600,4,2163,1134,-30
30764280310,30764280288,-22,2497,995,-30
30764810267,30764810252,-15,1108,693,-30
30766279239,30766279242,3,2193,1546,-30
30767445686,30767445690,4,2252,1535,-30
30769539055,30769539059,4,2060,1187,-30
30770566359,30770566366,7,1981,1031,-30
30771952439,30771952443,4,2370,1697,-30
30777598154,30777598162,8,2675,1330,-30
30780610927,30780610934,7,2262,1240,-30
30785640653,30785640659,6,2506,1114,-30
30785935646,30785935650,4,2999,1868,-30
30790999827,30790999817,-10,43191,17775,-30
30796091678,30796091690,12,2276,1402,-30
30796765385,30796765394,9,2076,1362,-30
30799344409,30799344402,-7,1267,5001,-30
30800806442,30800806449,7,2917,1527,-30
30803025093,30803025098,5,2398,1138,-30
30805363773,30805363779,6,1919,944,-30
30805899052,30805899057,5,2666,1700,-30
30810334621,30810334626,5,2317,1334,-30
30811706802,30811706807,5,1639,1139,-30
30817399302,30817399302,0,1407,1000,-30
30820684462,30820684466,4,2032,1144,-30
30823171907,30823171911,4,2042,1331,-30
30826243734,30826243739,5,2254,1651,-30
30828350900,30828350906,6,2147,1237,-30
30834069474,30834069477,3,1571,1581,-30
30835831890,30835831897,7,2092,1152,-30
30839051857,30839051858,1,1838,1864,-30
30846982445,30846982451,6,4486,1788,-30
30848215090,30848215095,5,2150,1078,-30
30848449467,30848449473,6,1853,1407,-30
30852135764,30852135767,3,2028,1306,-30
30852916882,30852916888,6,2937,1686,-30
30854909808,30854909813,5,2097,1492,-30
30859439072,30859439078,6,2814,1274,-30
30866982717,30866982717,0,1993,1959,-30
30869132642,30869132646,4,2433,1366,-30
30870279490,30870279497,7,2191,910,-30
30872117662,30872117666,4,2111,1189,-30
30875334763,30875334767,4,1825,1283,-30
30875394405,30875394410,5,2031,1212,-30
30876835275,30876835279,4,1256,886,-30
30877983605,30877983608,3,1764,1087,-30
30888008203,30888008202,-1,1333,1013,-30
30891842630,30891842622,-8,2129,10349,-30
30896500193,30896500197,4,2478,1297,-30
30898612470,30898612475,5,1659,965,-30
30899926168,30899926173,5,3011,1583,-30
30901044443,30901044447,4,1585,1024,-30
30901206119,30901206131,12,1702,2281,-30
30901542566,30901542585,19,1462,354,-30
30904084275,30904084278,3,1454,758,-30
30904113131,30904113134,3,1115,1427,-30
30904788916,30904788920,4,1514,942,-30
30909468002,30909468006,4,1983,1328,-30
30911235138,30911235143,5,3062,1695,-30
30911578678,30911578683,5,2712,1130,-30
30913843470,30913843475,5,1715,975,-30
30921998175,30921998179,4,1922,1600,-30
30922795190,30922795194,4,1943,1192,-30
30922861565,30922861566,1,2110,1322,-30
30927439686,30927439690,4,2433,1797,-30
30930676664,30930676671,7,2222,1316,-30
30931897260,30931897277,17,350,1731,-30
30933012559,30933012565,6,1363,1035,-30
30937834324,30937834329,5,2362,1408,-30
30939297174,30939297178,4,1911,1240,-30
30939841309,30939841315,6,2844,1494,-30
30942030558,30942030562,4,2075,1497,-30
30942842417,30942842422,5,2920,1997,-30
30942935605,30942935610,5,2497,1776,-30
30944803209,30944803215,6,2466,1667,-30
30944940903,30944940907,4,1729,1160,-30
30949765758,30949765766,8,3421,1438,-30
30951033270,30951033276,6,2891,1199,-30
30952772991,30952772996,5,2327,1434,-30
30954486328,30954486333,5,2149,1346,-30
30963463040,30963463045,5,2474,1487,-30
30963873829,30963873835,6,2239,1286,-30
30964582023,30964582030,7,1614,1487,-30
30966553137,30966553139,2,2931,2729,-30
30968750801,30968750803,2,1901,1339,-30
30968905630,30968905635,5,2595,1341,-30
30970718112,30970718115,3,2844,1692,-30
30972986103,30972986107,4,1276,1193,-30
30974399073,30974399078,5,1413,868,-30
30975137105,30975137109,4,2456,1217,-30
30976451604,30976451608,4,2274,1993,-30
30979569550,30979569557,7,2733,1720,-30
30981091168,30981091172,4,1862,1493,-30
30983737470,30983737476,6,2502,1431,-30
30986116560,30986116566,6,1356,1175,-30
30987284002,30987284009,7,2505,1116,-30
30990186834,30990186839,5,2422,1501,-30
30993420469,30993420474,5,1689,1056,-30
30993516362,30993516368,6,2597,1659,-30
30994356864,30994356868,4,2083,1235,-30
30994797831,30994797830,-1,1395,2324,-30
30997613345,30997613351,6,2649,1382,-30
31002211930,31002211934,4,2789,1125,-30
31006350925,31006350930,5,2470,1879,-30
31007524742,31007524746,4,2291,1291,-30
31008496517,31008496522,5,2286,1452,-30
31011013490,31011013494,4,1893,1254,-30
31013506577,31013506582,5,2459,1531,-30
31013754054,31013754044,-10,1569,736,-30
31018130791,31018130796,5,2278,1165,-30
31018491522,31018491539,17,3321,2046,-30
31018749217,31018749223,6,2646,1108,-30
31019872622,31019872627,5,2010,1353,-30
31020307855,31020307862,7,3044,915,-30
31021017253,31021017259,6,2506,1380,-30
31023220347,31023220350,3,1591,1137,-30
31025398134,31025398141,7,2191,1172,-30
31026877000,31026877006,6,2068,1238,-30
31028720269,31028720274,5,2452,1567,-30
31032640800,31032640806,6,2872,1316,-30
31034030045,31034030042,-3,2149,4461,-30
31035138262,31035138263,1,1596,1046,-30
31038490565,31038490572,7,1748,1085,-30
31042889254,31042889257,3,2972,1444,-30
31043315146,31043315151,5,1779,1412,-30
31043915850,31043915855,5,2687,1121,-30
31046452933,31046452938,5,2568,1255,-30
31052206296,31052206303,7,2015,1303,-30
31056611795,31056611801,6,2464,1612,-30
31058613944,31058613949,5,2350,1290,-30
31059099367,31059099345,-22,2299,773,-30
31063806389,31063806390,1,1928,1623,-30
31065339907,31065339912,5,1827,1284,-30
31071011114,31071011119,5,2908,1558,-30
31071421630,31071421636,6,3037,1612,-30
31072396497,31072396502,5,2687,1208,-30
31073085126,31073085128,2,847,575,-30
31074468678,31074468682,4,2094,1302,-30
31080075309,31080075309,0,35047,23750,-30
31081092365,31081092368,3,2479,1790,-30
31082199906,31082199911,5,3051,2002,-30
31088156630,31088156635,5,1630,938,-30
31089898564,31089898570,6,1469,1405,-30
31091608210,31091608215,5,1321,952,-30
31093060672,31093060677,5,2049,1431,-30
31093383480,31093383471,-9,16695,28418,-30
31093840376,31093840381,5,3036,2042,-30
31094958755,31094958762,7,2235,1068,-30
31095533012,31095533016,4,2385,1574,-30
31099996596,31099996602,6,1552,951,-30
31104878775,31104878781,6,1602,1422,-30
31106979238,31106979243,5,1981,1046,-30
31111147550,31111147555,5,1361,1078,-30
31112954293,31112954299,6,2906,1413,-30
31116081286,31116081290,4,6281,27761,-30
31117381879,31117381885,6,2027,1231,-30
31118125396,31118125380,-16,2310,1066,-30
31118184678,31118184682,4,2100,772,-30
31122849278,31122849282,4,2824,1399,-30
31127002374,31127002376,2,2486,1491,-30
31130704271,31130704275,4,1659,1010,-30
31133433242,31133433247,5,1669,993,-30
31133980027,31133980031,4,1132,730,-30
31135586779,31135586780,1,2207,2090,-30
31137716011,31137716006,-5,1580,5046,-30
31138325155,31138325161,6,3029,1988,-30
31138506217,31138506217,0,2520,1972,-30
31139686379,31139686387,8,2401,1053,-30
31143038482,31143038487,5,2261,1415,-30
31143600805,31143600810,5,3908,2129,-30
31145615614,31145615621,7,2209,1837,-30
31146741120,31146741126,6,1268,660,-30
31147438597,31147438602,5,2240,1144,-30
31148957707,31148957710,3,1338,1795,-30
31149684602,31149684607,5,1868,1178,-30
31151958416,31151958421,5,2086,1123,-30
31155391712,31155391715,3,1873,705,-30
31157596390,31157596395,5,3248,1631,-30
31160337872,31160337878,6,2370,1153,-30
31161307306,31161307305,-1,859,355,-30
31162463069,31162463073,4,1748,1503,-30
31164741255,31164741250,-5,1001,3582,-30
31166332762,31166332767,5,1680,812,-30
31168444571,31168444569,-2,2237,3601,-30
31171138052,31171138056,4,1676,913,-30
31171998000,31171998004,4,10130,7725,-30
31172993483,31172993486,3,1460,1520,-30
31174059249,31174059260,11,9231,37446,-30
31176620733,31176620736,3,2175,1667,-30
31178906440,31178906445,5,2832,1376,-30
31179729176,31179729180,4,1817,1160,-30
31181633318,31181633322,4,1574,897,-30
31184581482,31184581481,-1,1215,1584,-30
31186016021,31186016026,5,1824,1157,-30
31186910237,31186910242,5,2537,1637,-30
31197654893,31197654898,5,1707,956,-30
31201226463,31201226468,5,1987,1231,-30
31202206682,31202206687,5,2349,1335,-30
31204624869,31204624864,-5,992,3977,-30
31214299945,31214299950,5,1868,949,-30
31215297429,31215297433,4,2882,1523,-30
31217371913,31217371918,5,2567,1060,-30
31221548250,31221548254,4,2189,2064,-30
31224611002,31224611005,3,1955,1791,-30
31224976738,31224976742,4,2421,1589,-30
31225663911,31225663916,5,1614,1262,-30
31228256074,31228256082,8,1744,1143,-30
31228852767,31228852773,6,2003,1511,-30
31229154413,31229154419,6,1657,861,-30
31237296518,31237296522,4,1771,1229,-30
31238115426,31238115430,4,2042,1149,-30
31238564035,31238564039,4,1950,1269,-30
31238707402,31238707385,-17,2438,1485,-30
31242417963,31242417966,3,3269,1661,-30
31243636780,31243636785,5,1958,1522,-30
31246157434,31246157439,5,2480,1060,-30
31246676339,31246676343,4,1960,1516,-30
31257195295,31257195302,7,79368,38899,-30
31261151842,31261151847,5,2686,1374,-30
31262333106,31262333106,0,1238,1713,-30
31263929490,31263929494,4,1937,1630,-30
31283908724,31283908730,6,2834,1561,-30
31284263723,31284263728,5,2350,1568,-30
31285868236,31285868242,6,2709,1559,-30
31285980460,31285980458,-2,26270,44721,-30
31286551231,31286551238,7,5640,1480,-30
31287846238,31287846237,-1,2482,4291,-30
31290521773,31290521778,5,1710,1523,-30
31297930946,31297930949,3,2327,1398,-30
31300425961,31300425954,-7,1263,5076,-30
31301163177,31301163183,6,1543,703,-30
31301408160,31301408169,9,1338,1187,-30
31303858941,31303858947,6,2600,1312,-30
31304540055,31304540041,-14,1740,663,-30
31314998530,31314998536,6,2113,1051,-30
31318846649,31318846655,6,1707,926,-30
31322971899,31322971904,5,2053,1026,-30
31324934445,31324934440,-5,34,1999,-30
31329795108,31329795114,6,2681,1342,-30
31333402870,31333402874,4,1738,1197,-30
31335519304,31335519307,3,2531,1706,-30
31339275410,31339275415,5,2615,2037,-30
31339913571,31339913575,4,1952,1355,-30
31340712605,31340712610,5,2342,1454,-30
31341967128,31341967135,7,1354,1425,-30
31345264429,31345264433,4,1671,1087,-30
31347362056,31347362061,5,2172,1650,-30
31348347347,31348347351,4,106,8005,-30
31350103782,31350103790,8,12195,31274,-30
31355489742,31355489746,4,2149,1508,-30
31356291460,31356291465,5,2400,1297,-30
31357648755,31357648761,6,1634,868,-30
31359370014,31359370019,5,2517,1100,-30
31360747227,31360747230,3,1556,1055,-30
31366527118,31366527124,6,2037,978,-30
31369559556,31369559560,4,3223,2030,-30
31369997803,31369997807,4,1556,879,-30
31372560759,31372560765,6,2829,1019,-30
31374863982,31374863987,5,2697,1453,-30
31377626129,31377626135,6,3128,1428,-30
31378356262,31378356282,20,1657,1046,-30
31378566254,31378566232,-22,2194,1195,-30
31382213410,31382213416,6,42245,16605,-30
31385519011,31385519015,4,2560,1558,-30
31386075253,31386075258,5,2217,1122,-30
31387511427,31387511431,4,3546,1428,-30
31389776255,31389776259,4,2762,1799,-30
31390482478,31390482483,5,2273,1254,-30
31391760615,31391760620,5,2161,1125,-30
31392680231,31392680234,3,3642,2923,-30
31393318167,31393318173,6,2837,957,-30
31398371836,31398371841,5,2010,1459,-30
31398636766,31398636779,13,1266,922,-30
31401548146,31401548151,5,778,960,-30
31406809302,31406809319,17,208,1781,-30
31406835402,31406835406,4,1029,539,-30
31412537515,31412537519,4,2195,1389,-30
31414729606,31414729610,4,1532,995,-30
31418190433,31418190434,1,2914,2910,-30
31420033002,31420033008,6,2633,1055,-30
31421142666,31421142652,-14,4071,2275,-30
31421419823,31421419827,4,1821,1301,-30
31423025708,31423025714,6,2148,1320,-30
31426634254,31426634239,-15,1058,844,-30
31428084930,31428084937,7,2217,1738,-30
31428450815,31428450817,2,1169,143,-30
31428859945,31428859951,6,2117,1011,-30
31430272117,31430272123,6,2448,1762,-30
31437999166,31437999171,5,1492,1037,-30
31439169050,31439169055,5,2548,1684,-30
31440375543,31440375549,6,1675,1480,-30
31441288824,31441288826,2,2799,1873,-30
31441896971,31441896976,5,1466,940,-30
31441947707,31441947690,-17,2210,1383,-30
31442938679,31442938677,-2,813,1653,-30
31443593380,31443593383,3,1480,1489,-30
31444100266,31444100271,5,2258,1093,-30
31447979578,31447979582,4,1481,1367,-30
31448576302,31448576308,6,2510,1507,-30
31450091010,31450091014,4,2105,1008,-30
31451908378,31451908382,4,3043,1340,-30
31452052375,31452052379,4,3128,1410,-30
31452689706,31452689713,7,2031,1154,-30
31455840473,31455840477,4,2536,1063,-30
31455965039,31455965056,17,2557,1465,-30
31456965760,31456965765,5,2448,1537,-30
31457119209,31457119215,6,2700,1490,-30
31457225348,31457225354,6,1518,887,-30
31458553142,31458553146,4,1588,1123,-30
31458908095,31458908101,6,2475,1434,-30
31459690410,31459690415,5,1846,1060,-30
31472702602,31472702606,4,2041,1783,-30
31475836227,31475836233,6,2139,795,-30
31480071273,31480071277,4,2131,1717,-30
31482568132,31482568134,2,1999,760,-30
31488862367,31488862373,6,2167,1448,-30
31490131354,31490131358,4,3687,1783,-30
31492887048,31492887051,3,1050,1201,-30
31493059353,31493059358,5,2471,1694,-30
31494738258,31494738262,4,2335,994,-30
31495719365,31495719371,6,1830,1030,-30
31495826738,31495826722,-16,1840,766,-30
31501811734,31501811738,4,1834,1725,-30
31504475489,31504475494,5,2158,1348,-30
31507765663,31507765670,7,2309,1123,-30
31514389238,31514389244,6,2649,1480,-30
31520763985,31520763989,4,1859,1425,-30
31522327875,31522327879,4,1537,585,-30
31525618550,31525618546,-4,705,1813,-30
31525874173,31525874178,5,1426,1550,-30
31529502973,31529502978,5,1862,1392,-30
31529994875,31529994883,8,3173,1779,-30
31530647911,31530647915,4,2402,1509,-30
31538437809,31538437815,6,2410,1049,-30
31539070794,31539070799,5,1627,1163,-30
31539200917,31539200914,-3,1844,2601,-30
31539817781,31539817786,5,3932,2013,-30
31540356432,31540356434,2,1324,1345,-30
31540896692,31540896707,15,13455,43128,-30
31558170310,31558170316,6,2148,1508,-30
31559790112,31559790116,4,2864,1629,-30
31560275994,31560275993,-1,1018,163,-30
31563173775,31563173777,2,1595,1395,-30
31563733538,31563733545,7,3045,1124,-30
31567488372,31567488375,3,2442,1431,-30
31570670818,31570670821,3,1208,1032,-30
31573909059,31573909060,1,1531,1112,-30
31579260223,31579260217,-6,956,1817,-30
31579651977,31579651983,6,2639,1956,-30
31580179333,31580179341,8,2890,1249,-30
31580459472,31580459477,5,1792,904,-30
31580677782,31580677802,20,750,172,-30
31586795822,31586795826,4,2536,1577,-30
31591857764,31591857769,5,2120,1084,-30
31599587949,31599587955,6,1620,762,-30
31600114390,31600114372,-18,1453,1196,-30
31600268490,31600268494,4,2977,1385,-30
31600314635,31600314642,7,2044,1114,-30
31605663874,31605663878,4,3123,1830,-30
31608658045,31608658025,-20,1754,935,-30
31610047966,31610047968,2,1350,1465,-30
31612482557,31612482562,5,2175,1371,-30
31615135527,31615135528,1,6326,8416,-30
31619892735,31619892733,-2,1682,1868,-30
31620811282,31620811286,4,2141,1288,-30
31622082749,31622082753,4,2618,1389,-30
31626405398,31626405403,5,2667,1442,-30
31626598700,31626598723,23,1732,1183,-30
31628968716,31628968721,5,2223,1018,-30
31630877082,31630877087,5,2143,1362,-30
31632257757,31632257762,5,1702,1055,-30
31637772557,31637772563,6,2395,1524,-30
31642903113,31642903117,4,1747,1293,-30
31645026933,31645026939,6,3094,1439,-30
31649502567,31649502572,5,2700,1311,-30
31650851648,31650851653,5,3081,1727,-30
31652397470,31652397469,-1,1863,1567,-30
31653845126,31653845130,4,1828,1760,-30
31658082810,31658082816,6,2620,1801,-30
31658275924,31658275930,6,1894,1384,-30
31661453457,31661453460,3,1602,1128,-30
31667240695,31667240701,6,2693,1215,-30
31669952603,31669952608,5,2123,1339,-30
31674536855,31674536858,3,1954,1031,-30
31676511739,31676511744,5,2457,1411,-30
31676631857,31676631863,6,2978,1250,-30
31679301803,31679301809,6,2317,1050,-30
31681048207,31681048211,4,2448,1426,-30
31681802113,31681802119,6,2463,1429,-30
31684700989,31684700992,3,2314,1007,-30
31688422438,31688422442,4,2736,1279,-30
31690509044,31690509050,6,2268,1624,-30
31696142358,31696142362,4,2217,2124,-30
31696715489,31696715494,5,2650,1504,-30
31702436280,31702436285,5,1410,890,-30
31702749114,31702749118,4,1435,1170,-30
31704063390,31704063395,5,1876,1212,-30
31705149962,31705149967,5,2457,1319,-30
31711759726,31711759730,4,2599,1157,-30
31712034619,31712034623,4,2808,1803,-30
31716079099,31716079106,7,2957,1275,-30
31721167258,31721167262,4,2474,1729,-30
31725864777,31725864782,5,2364,1407,-30
31726330033,31726330037,4,2878,1763,-30
31728615589,31728615595,6,1637,1173,-30
31730705217,31730705221,4,1989,1309,-30
31731972907,31731972914,7,2865,1158,-30
31732777099,31732777106,7,1689,1435,-30
31734484810,31734484815,5,1840,1343,-30
31739610914,31739610919,5,1963,1222,-30
31740512116,31740512117,1,1055,1340,-30
31741223821,31741223809,-12,292,1154,-30
31745506959,31745506963,4,1705,891,-30
31747047524,31747047530,6,3074,1959,-30
31749206997,31749207002,5,1462,795,-30
31750811474,31750811479,5,2491,881,-30
31751501737,31751501741,4,2492,1406,-30
31752758277,31752758258,-19,2664,1694,-30
31753590798,31753590800,2,2429,2814,-30
31753832064,31753832070,6,2579,1922,-30
31756299888,31756299893,5,1922,1281,-30
31757466025,31757466027,2,383,178,-30
31758650043,31758650050,7,1331,999,-30
31759766917,31759766922,5,2610,1597,-30
31761449633,31761449638,5,1463,1030,-30
31761938010,31761938014,4,2525,1486,-30
31764800434,31764800438,4,2160,1263,-30
31765200597,31765200603,6,2676,1292,-30
31769568022,31769568016,-6,1538,11445,-30
31773016823,31773016829,6,1859,1380,-30
31776412390,31776412393,3,2231,1716,-30
31782929146,31782929150,4,2856,1782,-30
31783165066,31783165072,6,1356,779,-30
31783485508,31783485515,7,2108,819,-30
31789062699,31789062703,4,2773,1220,-30
31789569305,31789569298,-7,1229,6600,-30
31791777860,31791777862,2,2393,1257,-30
31795291314,31795291314,0,1699,1764,-30
31799626331,31799626327,-4,1182,1561,-30
31808613579,31808613583,4,1494,1069,-30
31809472850,31809472855,5,2524,1490,-30
31809720870,31809720889,19,2947,958,-30
31813784530,31813784535,5,1270,1125,-30
31814721517,31814721520,3,1915,1167,-30
31815773527,31815773533,6,1807,1308,-30
31817657997,31817658003,6,2090,1464,-30
31818257490,31818257496,6,1457,897,-30
31819064083,31819064087,4,2570,1641,-30
31819415728,31819415740,12,148,1768,-30
31820012557,31820012562,5,1819,1271,-30
31822065876,31822065879,3,1607,1412,-30
31829330909,31829330915,6,2579,1148,-30
31831237997,31831238002,5,3314,1589,-30
31837807237,31837807241,4,2361,1997,-30
31839128083,31839128087,4,2270,1040,-30
31839698950,31839698954,4,1951,1284,-30
31840619786,31840619790,4,1441,1089,-30
31840891248,31840891253,5,2630,1211,-30
31845290816,31845290820,4,3458,1726,-30
31846221526,31846221534,8,3780,1698,-30
31851762624,31851762627,3,2355,1240,-30
31853743667,31853743673,6,2478,1541,-30
31854710856,31854710861,5,2520,1839,-30
31855149880,31855149885,5,1821,1118,-30
31855606586,31855606591,5,3314,1601,-30
31858468045,31858468050,5,1234,587,-30
31867921507,31867921514,7,1911,764,-30
31869552158,31869552162,4,2284,1573,-30
31870891315,31870891320,5,1618,1129,-30
31873043139,31873043146,7,3065,1689,-30
31873431686,31873431692,6,2317,1392,-30
31873524946,31873524932,-14,1091,439,-30
31873686919,31873686923,4,1846,1374,-30
31879617629,31879617634,5,2545,1907,-30
31879839370,31879839375,5,2413,1456,-30
31881763506,31881763511,5,2714,1349,-30
31883930084,31883930087,3,3731,2800,-30
31884948630,31884948635,5,2463,1104,-30
31887251030,31887251035,5,2130,1187,-30
31889686986,31889686990,4,1996,1272,-30
31891605838,31891605842,4,2060,1286,-30
31893367906,31893367909,3,2302,1021,-30
31894074797,31894074802,5,2890,1446,-30
31896369258,31896369258,0,1985,2743,-30
31898466929,31898466935,6,2354,1753,-30
31906830356,31906830363,7,2321,1345,-30
31907427853,31907427856,3,3142,1580,-30
31910504918,31910504924,6,1729,1290,-30
31915406754,31915406748,-6,2846,6444,-30
31916064789,31916064797,8,3796,1593,-30
31916193622,31916193627,5,2524,1379,-30
31918122400,31918122404,4,2145,1644,-30
31918553089,31918553092,3,2310,1322,-30
31919774601,31919774607,6,2239,1408,-30
31920626016,31920626019,3,1885,1400,-30
31923027029,31923027033,4,1590,1278,-30
31927660455,31927660459,4,2111,1031,-30
31931998301,31931998307,6,2261,1590,-30
31932042962,31932042965,3,2065,1515,-30
31933794029,31933794034,5,1755,1009,-30
31937214718,31937214722,4,2240,1457,-30
31944202258,31944202262,4,2914,1714,-30
31946581848,31946581853,5,2785,1796,-30
31946612015,31946612019,4,1623,1491,-30
31950145381,31950145383,2,1127,1204,-30
31953383484,31953383490,6,1367,977,-30
31954469450,31954469454,4,1498,850,-30
31956826691,31956826697,6,2577,1555,-30
31958983447,31958983452,5,2709,1136,-30
31962790090,31962790094,4,2988,1706,-30
31964967600,31964967606,6,3217,1491,-30
31965349854,31965349859,5,1850,816,-30
31967114935,31967114939,4,2001,1595,-30
31973831554,31973831559,5,1873,1191,-30
31979096921,31979096926,5,1914,1276,-30
31984530074,31984530082,8,49053,14188,-30
31985179668,31985179685,17,134,2851,-30
31988901346,31988901350,4,1399,1235,-30
31992485949,31992485954,5,2865,1390,-30
31992873233,31992873237,4,2238,1063,-30
31992922152,31992922155,3,1412,1259,-30
31994375641,31994375647,6,2695,1383,-30
31995949931,31995949934,3,2023,879,-30
32002498379,32002498374,-5,22760,9819,-30
32004818289,32004818299,10,2481,964,-30
32005026102,32005026107,5,2260,1048,-30
32005852233,32005852237,4,2580,1960,-30
32007738301,32007738308,7,3835,1944,-30
32008207327,32008207333,6,609,958,-30
32011956012,32011956017,5,3064,1867,-30
32013439875,32013439878,3,1682,1580,-30
32016583172,32016583174,2,1952,1304,-30
32017294158,32017294162,4,3271,2096,-30
32021003714,32021003719,5,2515,1311,-30
32021513386,32021513403,17,3207,918,-30
32022683726,32022683716,-10,648,232,-30
32026544791,32026544794,3,2052,935,-30
32029078558,32029078562,4,2827,1258,-30
32029943365,32029943371,6,2853,1136,-30
32032794052,32032794058,6,1992,1335,-30
32035131682,32035131689,7,3971,1592,-30
32046177066,32046177070,4,1837,1204,-30
32049250122,32049250127,5,1685,817,-30
32049555995,32049555999,4,2599,1849,-30
32052584484,32052584501,17,1741,830,-30
32053345290,32053345294,4,2969,1397,-30
32054045634,32054045639,5,2031,1299,-30
32056436411,32056436417,6,2447,1861,-30
32057863422,32057863428,6,2172,1630,-30
32058003228,32058003228,0,2551,2779,-30
32061520610,32061520607,-3,2014,5219,-30
32062903487,32062903493,6,3158,1841,-30
32066889072,32066889080,8,1974,1060,-30
32068653929,32068653934,5,2541,1557,-30
32075151210,32075151214,4,1953,1047,-30
32077178786,32077178792,6,2233,1178,-30
32078897178,32078897183,5,2226,948,-30
32081305914,32081305918,4,1934,1056,-30
32081425802,32081425805,3,2164,1211,-30
32087960707,32087960710,3,4121,2759,-30
32094787990,32094787997,7,1986,975,-30
32098200994,32098201000,6,1937,1243,-30
32099149509,32099149515,6,3078,1431,-30
32099210634,32099210642,8,1464,1370,-30
32103109196,32103109201,5,1255,1082,-30
32103511510,32103511490,-20,1580,1004,-30
32103877103,32103877107,4,1836,1214,-30
32110125700,32110125705,5,2119,1409,-30
32110243355,32110243359,4,2298,1050,-30
32113862579,32113862582,3,2315,1322,-30
32115978722,32115978727,5,2718,1545,-30
32116127864,32116127869,5,1067,850,-30
32119484470,32119484476,6,1656,1348,-30
32120655894,32120655896,2,13249,13195,-30
32121618518,32121618524,6,3134,1515,-30
32132091117,32132091122,5,2491,1325,-30
32133925330,32133925335,5,3264,2017,-30
32134584434,32134584437,3,1876,1701,-30
32135793393,32135793397,4,2419,1462,-30
32139976250,32139976253,3,2838,2664,-30
32142423874,32142423882,8,2399,1243,-30
32144383591,32144383595,4,2414,1327,-30
32144925555,32144925559,4,2325,1217,-30
32148075146,32148075151,5,1995,1224,-30
32148952194,32148952178,-16,1938,1334,-30
32149956929,32149956934,5,2416,2227,-30
32150430381,32150430378,-3,1376,3871,-30
32154047905,32154047912,7,10077,35431,-30
32154858161,32154858163,2,1440,1649,-30
32160590053,32160590058,5,3657,1998,-30
32164078371,32164078375,4,1936,1137,-30
32164904298,32164904304,6,2965,1376,-30
32173411829,32173411835,6,1370,900,-30
32173843717,32173843722,5,2173,1376,-30
32176041482,32176041484,2,1422,1502,-30
32176372760,32176372763,3,1545,764,-30
32179069391,32179069397,6,1941,1170,-30
32179405315,32179405321,6,1987,1157,-30
32181570178,32181570184,6,1891,1177,-30
32181841881,32181841887,6,2399,1133,-30
32187509546,32187509550,4,1621,1229,-30
32187554998,32187554980,-18,1535,833,-30
32189766858,32189766866,8,3353,1237,-30
32191652758,32191652763,5,2078,1775,-30
32197301409,32197301414,5,2525,897,-30
32197618065,32197618070,5,2332,1000,-30
32199646112,32199646115,3,2434,1212,-30
32200040189,32200040195,6,2053,1076,-30
32201939581,32201939586,5,2024,1370,-30
32202541069,32202541073,4,2010,1271,-30
32202983318,32202983324,6,2459,1165,-30
32203116649,32203116640,-9,813,321,-30
32207750115,32207750117,2,1768,675,-30
32209863730,32209863734,4,1888,1559,-30
32211076171,32211076169,-2,7615,13198,-30
32212008238,32212008242,4,2414,1549,-30
32215858446,32215858451,5,2373,1191,-30
32216182398,32216182376,-22,2728,1899,-30
32222561420,32222561425,5,2684,1810,-30
32227558860,32227558867,7,2932,1500,-30
32232190302,32232190310,8,2939,1459,-30
32232992728,32232992717,-11,208,3171,-30
32234571362,32234571368,6,1646,1017,-30
32235304058,32235304065,7,2803,1392,-30
32241410090,32241410094,4,1709,644,-30
32241949990,32241949970,-20,1939,1013,-30
32251179982,32251179989,7,1719,1328,-30
32253240869,32253240873,4,2572,1512,-30
32259434613,32259434617,4,1983,1384,-30
32259978889,32259978895,6,2191,1102,-30
32260683180,32260683186,6,2440,1256,-30
32264696481,32264696487,6,3118,1388,-30
32270421261,32270421265,4,2396,1418,-30
32272840596,32272840599,3,29196,23030,-30
32277190713,32277190703,-10,1895,1115,-30
32278269802,32278269807,5,2133,1471,-30
32280266082,32280266088,6,2450,1032,-30
32280901750,32280901729,-21,2358,1828,-30
32283667149,32283667154,5,1955,1278,-30
32284407031,32284407035,4,2321,1473,-30
32287832533,32287832534,1,2716,1436,-30
32289415830,32289415835,5,2097,1475,-30
32293163195,32293163201,6,1527,1417,-30
32294684438,32294684443,5,1726,1163,-30
32299720960,32299720957,-3,1210,2254,-30
32300021330,32300021331,1,1814,1779,-30
32300738174,32300738169,-5,1678,4578,-30
32304377614,32304377618,4,2083,1559,-30
32305626891,32305626895,4,5012,16895,-30
32305889270,32305889275,5,2068,1333,-30
32306752923,32306752927,4,1825,1552,-30
32309554487,32309554489,2,1583,1933,-30
32309701503,32309701506,3,1993,1372,-30
32313256925,32313256930,5,2603,1810,-30
32317852901,32317852902,1,1422,2218,-30
32320809216,32320809214,-2,10464,40625,-30
32321092369,32321092375,6,2756,1928,-30
32324779514,32324779520,6,3148,1782,-30
32327671971,32327671975,4,2410,930,-30
32340405050,32340405054,4,1935,923,-30
32345755171,32345755175,4,1478,1445,-30
32348678403,32348678409,6,1172,633,-30
32349842538,32349842542,4,2193,1331,-30
32350034741,32350034745,4,2454,1616,-30
32352521600,32352521605,5,2621,1582,-30
32353628937,32353628933,-4,1480,4599,-30
32353950871,32353950878,7,2931,1661,-30
32354832735,32354832739,4,1629,1177,-30
32357469855,32357469863,8,1747,1001,-30
32357733773,32357733779,6,2090,1227,-30
32358634753,32358634760,7,1971,1140,-30
32360933442,32360933447,5,1595,974,-30
32371015318,32371015323,5,2610,1265,-30
32372302162,32372302167,5,2089,1593,-30
32372726966,32372726972,6,2391,869,-30
32372956454,32372956434,-20,1042,1062,-30
32376468429,32376468433,4,1454,992,-30
32376818405,32376818407,2,2242,1547,-30
32377077971,32377077975,4,2843,1248,-30
32377214835,32377214841,6,553,176,-30
32377563595,32377563601,6,2329,1579,-30
32378518058,32378518062,4,1576,1151,-30
32380661450,32380661454,4,1694,809,-30
32386915224,32386915228,4,2735,1521,-30
32388030914,32388030918,4,2561,1281,-30
32388803339,32388803343,4,2357,981,-30
32390878558,32390878565,7,2370,1944,-30
32391462192,32391462196,4,1520,1003,-30
32395385761,32395385763,2,1518,749,-30
32397025868,32397025872,4,1078,768,-30
32397879521,32397879531,10,1878,1052,-30
32401000786,32401000778,-8,1030,4066,-30
32403666402,32403666409,7,1735,894,-30
32404290299,32404290288,-11,1418,319,-30
32405835433,32405835438,5,1574,1905,-30
32407523613,32407523617,4,1290,1334,-30
32408354758,32408354765,7,2767,1525,-30
32411808904,32411808903,-1,1217,1090,-30
32418629326,32418629330,4,2862,1229,-30
32420777677,32420777682,5,2383,1471,-30
32420959714,32420959721,7,2222,1132,-30
32422231901,32422231907,6,2190,1639,-30
32422785610,32422785615,5,3455,1605,-30
32425859708,32425859714,6,7794,2527,-30
32426487126,32426487131,5,1901,1238,-30
32428020443,32428020440,-3,1083,2591,-30
32431261415,32431261420,5,1561,1002,-30
32443005440,32443005446,6,2309,951,-30
32443841929,32443841916,-13,1486,1240,-30
32444314831,32444314838,7,1828,977,-30
32446825449,32446825451,2,2614,1729,-30
32447750897,32447750901,4,2267,1315,-30
32452985332,32452985339,7,2309,1466,-30
32455638873,32455638878,5,2581,1385,-30
32456817580,32456817584,4,2554,1053,-30
32457988554,32457988559,5,2602,1406,-30
32459510595,32459510599,4,2493,1282,-30
32460199896,32460199897,1,1650,1667,-30
32462542049,32462542053,4,1720,1673,-30
32462697597,32462697596,-1,1294,2120,-30
32471631821,32471631826,5,2989,1611,-30
32473528597,32473528603,6,1893,1294,-30
32478654999,32478655001,2,38756,47697,-30
32479435137,32479435142,5,1844,1132,-30
32480590542,32480590539,-3,1024,2144,-30
32481224208,32481224189,-19,1805,766,-30
32483399249,32483399254,5,3395,1917,-30
32485190423,32485190426,3,1875,972,-30
32487418938,32487418942,4,2683,1534,-30
32490026100,32490026100,0,2639,3021,-30
32491602938,32491602945,7,2038,1154,-30
32492484477,32492484481,4,1953,1606,-30
32492535814,32492535820,6,2733,1532,-30
32493839893,32493839899,6,2267,1660,-30
32494315577,32494315582,5,3057,1664,-30
32494951114,32494951117,3,1678,1073,-30
32495389163,32495389168,5,1889,1229,-30
32495742282,32495742284,2,1656,1670,-30
32499577470,32499577473,3,1534,1262,-30
32499890370,32499890376,6,3106,1607,-30
32500623317,32500623314,-3,1214,3273,-30
32501182562,32501182567,5,1912,1750,-30
32501397031,32501397035,4,2325,1479,-30
32501868230,32501868233,3,1670,1318,-30
32502787512,32502787516,4,2994,1841,-30
32506843049,32506843052,3,2110,1270,-30
32512045817,32512045823,6,2232,977,-30
32512942426,32512942433,7,1740,1389,-30
32517876214,32517876218,4,1629,984,-30
32518357569,32518357565,-4,1026,2712,-30
32518901815,32518901822,7,3067,1115,-30
32519606887,32519606894,7,2402,1603,-30
32521611069,32521611068,-1,1173,1174,-30
32522363294,32522363301,7,1722,1247,-30
32523416501,32523416507,6,1478,1484,-30
32523531602,32523531584,-18,1853,1229,-30
32523559195,32523559178,-17,934,312,-30
32524383986,32524383989,3,8416,31057,-30
32525391791,32525391791,0,2588,3769,-30
32526976361,32526976365,4,2556,1639,-30
32529690806,32529690809,3,2471,1424,-30
32530760138,32530760157,19,2082,1098,-30
32531828621,32531828627,6,3514,1553,-30
32532064918,32532064922,4,2116,1701,-30
32533026159,32533026166,7,3041,1201,-30
32534385614,32534385619,5,2417,1199,-30
32535506854,32535506858,4,1680,916,-30
32538716150,32538716153,3,2450,1026,-30
32538806759,32538806764,5,2095,1324,-30
32540109206,32540109210,4,1768,1017,-30
32541177466,32541177471,5,2474,1316,-30
32541431952,32541431936,-16,1851,1118,-30
32541874629,32541874634,5,1660,1465,-30
32542030004,32542029986,-18,2796,990,-30
32542226401,32542226407,6,2091,1355,-30
32542887475,32542887481,6,1650,1369,-30
32543227916,32543227919,3,2303,1320,-30
32543553417,32543553415,-2,881,1625,-30
32545794218,32545794223,5,1826,1120,-30
32551546609,32551546614,5,2127,1340,-30
32552261731,32552261735,4,2262,1344,-30
32552479966,32552479974,8,1773,1550,-30
32552575118,32552575130,12,2242,1337,-30
32565501471,32565501476,5,1693,805,-30
32569387570,32569387574,4,1997,1336,-30
32577012558,32577012566,8,2335,1442,-30
32592159449,32592159455,6,1255,1252,-30
32593111355,32593111360,5,1791,1181,-30
32594130195,32594130201,6,2480,1491,-30
32594746256,32594746262,6,3276,1753,-30
32595544414,32595544419,5,4786,1799,-30
32603447738,32603447743,5,2131,1334,-30
32606461068,32606461073,5,1827,1088,-30
32607035317,32607035322,5,2491,1598,-30
32607321501,32607321506,5,2103,1369,-30
32607566482,32607566485,3,2213,1319,-30
32608278314,32608278318,4,2466,1671,-30
32608600383,32608600390,7,1991,970,-30
32609541478,32609541497,19,3054,1723,-30
32609801948,32609801954,6,2055,960,-30
32613175021,32613175024,3,6676,35878,-30
32613584775,32613584780,5,1982,1519,-30
32614238888,32614238893,5,2478,1210,-30
32617420362,32617420369,7,1721,852,-30
32619731608,32619731613,5,3665,1622,-30
32620931510,32620931515,5,1797,1017,-30
32628190714,32628190708,-6,759,3216,-30
32640751215,32640751221,6,1948,1131,-30
32640818878,32640818882,4,2216,1327,-30
32644146341,32644146337,-4,1307,4053,-30
32646907934,32646907938,4,3046,2194,-30
32648575643,32648575647,4,2479,1434,-30
32653995685,32653995691,6,5551,2161,-30
32655070349,32655070354,5,1696,1320,-30
32657047999,32657048004,5,2160,1399,-30
32657823414,32657823418,4,1568,1185,-30
32661551691,32661551696,5,1943,958,-30
32666145206,32666145208,2,1806,1496,-30
32668634353,32668634359,6,1538,840,-30
32669607698,32669607706,8,2329,1361,-30
32670198482,32670198461,-21,1569,1343,-30
32671781657,32671781661,4,2642,1476,-30
32673346127,32673346133,6,1960,938,-30
32681318547,32681318551,4,2476,1336,-30
32682073806,32682073811,5,1865,1120,-30
32683377014,32683377018,4,2042,1490,-30
32686910214,32686910219,5,1983,1079,-30
32689944426,32689944430,4,2132,1714,-30
32692568310,32692568313,3,2534,1196,-30
32696507643,32696507648,5,2130,1082,-30
32698160973,32698160978,5,2490,1541,-30
32698873073,32698873066,-7,122,2151,-30
32698981873,32698981880,7,2382,1163,-30
32703007630,32703007629,-1,8960,13663,-30
32705181018,32705181025,7,2653,1520,-30
32707356377,32707356370,-7,1319,10867,-30
32709750373,32709750379,6,1677,863,-30
32714452317,32714452323,6,2662,1337,-30
32714710454,32714710458,4,4167,2885,-30
32715075717,32715075720,3,2655,1615,-30
32715843770,32715843775,5,2889,828,-30
32718861107,32718861111,4,2120,1074,-30
32719825570,32719825575,5,2269,1549,-30
32721922558,32721922565,7,3472,1549,-30
32726897906,32726897911,5,3198,1333,-30
32727002973,32727002954,-19,823,237,-30
32727125701,32727125706,5,1896,1082,-30
32728129281,32728129286,5,1584,1363,-30
32729757525,32729757529,4,1913,1360,-30
32730841029,32730841035,6,2351,1222,-30
32734026343,32734026346,3,2323,1912,-30
32734928385,32734928391,6,2356,1639,-30
32735855304,32735855307,3,1474,1398,-30
32736758068,32736758071,3,1510,1171,-30
32737765396,32737765401,5,1820,1542,-30
32738358803,32738358809,6,3205,1844,-30
32739849974,32739849979,5,2633,1742,-30
32742796259,32742796257,-2,1482,2586,-30
32746353813,32746353819,6,2060,1280,-30
32746829119,32746829125,6,1688,813,-30
32747021498,32747021483,-15,1924,1324,-30
32747679755,32747679755,0,1653,1261,-30
32749336990,32749336993,3,1895,1269,-30
32751060639,32751060644,5,2020,1347,-30
32756762936,32756762940,4,2415,1335,-30
32759262212,32759262218,6,1264,948,-30
32767907500,32767907505,5,2228,1158,-30
32768809029,32768809034,5,2664,1487,-30
32769195592,32769195594,2,1999,946,-30
32773116014,32773116016,2,1986,1036,-30
32773831087,32773831085,-2,802,1316,-30
32774014680,32774014686,6,2893,1053,-30
32777428290,32777428295,5,2647,1486,-30
32778151697,32778151679,-18,1192,473,-30
32779915774,32779915779,5,2133,1073,-30
32780330029,32780330034,5,2173,1577,-30
32782162386,32782162391,5,2711,898,-30
32784617588,32784617590,2,2591,1361,-30
32785852120,32785852123,3,1902,1056,-30
32786907015,32786907021,6,2650,1591,-30
32787648152,32787648157,5,2426,1076,-30
32788131366,32788131344,-22,1144,853,-30
32788469725,32788469729,4,1684,1111,-30
32790190598,32790190603,5,1889,1413,-30
32790866657,32790866660,3,4168,2728,-30
32793664457,32793664458,1,1300,1245,-30
32794788924,32794788929,5,2826,1664,-30
32794953957,32794953960,3,2100,1853,-30
32795091861,32795091840,-21,1009,671,-30
32798160989,32798160990,1,1535,2022,-30
32810837094,32810837100,6,2908,1683,-30
32814369533,32814369539,6,2206,1008,-30
32816904705,32816904709,4,2071,1239,-30
32817580094,32817580099,5,3478,1944,-30
32820623902,32820623905,3,1867,911,-30
32820703694,32820703704,10,2719,1000,-30
32820793042,32820793059,17,1859,980,-30
32823021346,32823021350,4,2210,1334,-30
32825752215,32825752220,5,2472,1396,-30
32827198953,32827198952,-1,1604,1836,-30
32829915202,32829915209,7,2540,1241,-30
32831259238,32831259234,-4,1582,3857,-30
32831330226,32831330230,4,2402,1691,-30
32831619821,32831619826,5,2167,1452,-30
32833379409,32833379413,4,1963,1157,-30
32836863885,32836863889,4,1894,1133,-30
32838303679,32838303683,4,2187,1037,-30
32846166239,32846166243,4,3590,1954,-30
32848229919,32848229925,6,1718,659,-30
32853573146,32853573152,6,2434,1353,-30
32853604573,32853604577,4,1809,1069,-30
32863797458,32863797472,14,2750,1115,-30
32865491650,32865491657,7,2186,1429,-30
32866206515,32866206518,3,1981,1423,-30
32870602369,32870602373,4,1785,1062,-30
32870964965,32870964985,20,2338,1496,-30
32871302499,32871302504,5,1480,947,-30
32875679992,32875679998,6,2620,1560,-30
32879660705,32879660706,1,1617,1595,-30
32885210917,32885210923,6,1937,995,-30
32885717240,32885717247,7,356,4498,-30
32889020357,32889020363,6,2451,1481,-30
32889471976,32889471978,2,2449,1343,-30
32892910320,32892910325,5,2247,1160,-30
32898003659,32898003662,3,1660,1270,-30
32898612056,32898612062,6,3089,1724,-30
32901653866,32901653871,5,2387,1222,-30
32911637402,32911637407,5,1836,1314,-30
32912256118,32912256122,4,1769,1226,-30
32915414844,32915414834,-10,2289,1682,-30
32915945285,32915945292,7,2497,1783,-30
32922616965,32922616971,6,2836,1221,-30
32923565354,32923565359,5,1919,826,-30
32924633501,32924633521,20,2683,1531,-30
32926357511,32926357509,-2,19667,7629,-30
32934197672,32934197677,5,2264,1077,-30
32934312945,32934312949,4,2182,1458,-30
32934681259,32934681263,4,2042,1034,-30
32935028369,32935028374,5,2726,1222,-30
32936327791,32936327798,7,4539,1443,-30
32936764754,32936764760,6,2295,1452,-30
32937988552,32937988556,4,2123,1397,-30
32939314011,32939314017,6,3437,1786,-30
32940547459,32940547462,3,2591,1498,-30
32940935746,32940935748,2,1535,1541,-30
32944578512,32944578517,5,1638,1172,-30
32948549318,32948549325,7,2806,1488,-30
32949296869,32949296874,5,2021,1362,-30
32949864730,32949864733,3,2519,1166,-30
32950180555,32950180548,-7,876,365,-30
32951152852,32951152839,-13,1112,917,-30
32955626685,32955626690,5,2130,1114,-30
32959012803,32959012807,4,2201,1210,-30
32969315237,32969315243,6,3518,958,-30
32970599461,32970599466,5,2062,1231,-30
32971025763,32971025765,2,1548,1621,-30
32971084626,32971084633,7,3972,1980,-30
32974340584,32974340584,0,1773,2046,-30
32974997737,32974997742,5,2101,1042,-30
32978264721,32978264727,6,10376,4597,-30
32979495071,32979495076,5,3386,1887,-30
32982767486,32982767490,4,1503,942,-30
32986358521,32986358526,5,2968,1208,-30
32986929235,32986929218,-17,1832,1046,-30
32989150288,32989150294,6,2066,1118,-30
32995977326,32995977330,4,1916,1353,-30
32999844322,32999844324,2,1559,1409,-30
33001192090,33001192093,3,2224,1291,-30
33005356205,33005356212,7,3678,1786,-30
33005507742,33005507720,-22,2105,1163,-30
33005681842,33005681846,4,2417,1226,-30
33009107701,33009107706,5,2403,1287,-30
33010497810,33010497814,4,2102,845,-30
33014244193,33014244198,5,2219,1239,-30
33018563992,33018563993,1,1891,1694,-30
33026965444,33026965446,2,2286,1518,-30
33031354533,33031354538,5,2015,1496,-30
33032100768,33032100772,4,1768,1176,-30
33035375015,33035375022,7,2973,1053,-30
33036119638,33036119645,7,2293,1071,-30
33036324960,33036324965,5,2552,1527,-30
33041909678,33041909686,8,1044,885,-30
33044474657,33044474664,7,4080,1233,-30
33046312773,33046312779,6,2026,828,-30
33050294491,33050294497,6,1719,1580,-30
33050642776,33050642780,4,4438,2919,-30
33051322434,33051322429,-5,1769,9075,-30
33053487036,33053487041,5,2271,927,-30
33054869188,33054869187,-1,1208,1236,-30
33056413590,33056413595,5,1677,773,-30
33057083522,33057083505,-17,2523,644,-30
33058085975,33058085979,4,2097,1588,-30
33062763734,33062763741,7,1664,922,-30
33064488389,33064488394,5,2957,1648,-30
33064675810,33064675813,3,1381,762,-30
33067338537,33067338542,5,1222,1180,-30
33070454197,33070454201,4,2081,1432,-30
33072235225,33072235221,-4,1254,1595,-30
33073178097,33073178100,3,1549,1323,-30
33073298575,33073298579,4,2150,1236,-30
33080188128,33080188133,5,2255,1851,-30
33081279758,33081279760,2,1957,1539,-30
33085095762,33085095766,4,2493,1506,-30
33086163066,33086163070,4,2281,1506,-30
33091648330,33091648338,8,2805,1638,-30
33092504985,33092504990,5,1795,1512,-30
33094376908,33094376913,5,2000,969,-30
33098352984,33098352989,5,2294,1611,-30
33099823690,33099823694,4,1623,908,-30
33105836782,33105836787,5,2263,1572,-30
33108446454,33108446459,5,2270,1152,-30
33111801814,33111801819,5,1850,1381,-30
33121767889,33121767894,5,1611,1276,-30
33123296037,33123296043,6,2027,1416,-30
33123429842,33123429847,5,3048,1467,-30
33126329627,33126329634,7,1001,902,-30
33127634083,33127634086,3,1915,1389,-30
33128578548,33128578551,3,1165,729,-30
33130605198,33130605203,5,2354,1417,-30
33135635650,33135635655,5,3278,1334,-30
33136464170,33136464173,3,1960,1545,-30
33136561365,33136561348,-17,1359,823,-30
33140939267,33140939262,-5,1907,6035,-30
33142567622,33142567626,4,2129,1574,-30
33144299271,33144299269,-2,32778,21022,-30
33145468411,33145468415,4,3168,1575,-30
33145537014,33145537018,4,2109,934,-30
33147758062,33147758067,5,2756,1561,-30
33148063667,33148063671,4,2051,1506,-30
33148153623,33148153642,19,1847,1005,-30
33148583693,33148583697,4,1723,1494,-30
33148815389,33148815382,-7,1777,10833,-30
33149787271,33149787275,4,2279,1415,-30
33151934121,33151934127,6,2724,1226,-30
33152853530,33152853534,4,2000,1067,-30
33155975662,33155975666,4,1405,1731,-30
33156811349,33156811354,5,1164,715,-30
33160803728,33160803740,12,13182,46025,-30
33161132886,33161132891,5,2912,1071,-30
33161526162,33161526165,3,1827,1024,-30
33162827207,33162827211,4,2275,1297,-30
33165856706,33165856710,4,2431,1654,-30
33166782530,33166782535,5,997,618,-30
33173108106,33173108111,5,2002,1222,-30
33173876488,33173876493,5,2867,1617,-30
33174274781,33174274786,5,2370,1196,-30
33174708697,33174708702,5,2112,1399,-30
33175140988,33175140992,4,4692,3282,-30
33175305211,33175305218,7,2785,1197,-30
33177732150,33177732158,8,2879,1204,-30
33178735878,33178735884,6,2438,824,-30
33179500518,33179500522,4,3632,1758,-30
33180140586,33180140590,4,1308,1205,-30
33183571023,33183571002,-21,2782,896,-30
33187134693,33187134697,4,2383,1017,-30
33187394994,33187394979,-15,2189,1232,-30
33188259399,33188259405,6,2066,1676,-30
33189026766,33189026769,3,1614,1222,-30
33190099294,33190099294,0,1534,1747,-30
33194989766,33194989771,5,2423,1428,-30
33197451576,33197451578,2,2637,2360,-30
33201025195,33201025198,3,2537,1853,-30
33201911923,33201911929,6,2795,1438,-30
33208543241,33208543246,5,2114,1500,-30
33209055787,33209055791,4,1214,918,-30
33209254769,33209254769,0,844,367,-30
33210055521,33210055524,3,1906,1274,-30
33211863997,33211864001,4,1460,985,-30
33217275535,33217275539,4,2047,1350,-30
33217734121,33217734128,7,2575,1624,-30
33220429237,33220429243,6,2210,1606,-30
33220982942,33220982947,5,1892,1351,-30
33221150364,33221150347,-17,1506,837,-30
33222252407,33222252410,3,1930,1154,-30
33224618430,33224618435,5,3004,1492,-30
33225300566,33225300568,2,1727,1694,-30
33226385164,33226385167,3,3240,1551,-30
33227584607,33227584613,6,2983,1637,-30
33229953794,33229953799,5,1847,895,-30
33230793687,33230793691,4,2679,1631,-30
33232789369,33232789375,6,2824,1805,-30
33233726374,33233726379,5,1871,1588,-30
33239893618,33239893626,8,1192,901,-30
33241633721,33241633726,5,1376,684,-30
33244814707,33244814714,7,2286,1367,-30
33245627187,33245627194,7,2832,1575,-30
33252452920,33252452923,3,2597,1321,-30
33258918735,33258918742,7,2883,1820,-30
33258944018,33258944026,8,2610,839,-30
33263469418,33263469426,8,1809,934,-30
33270711860,33270711863,3,1930,1090,-30
33273676490,33273676495,5,2390,1323,-30
33273960201,33273960202,1,1040,1087,-30
33274337453,33274337434,-19,2920,2107,-30
33278667886,33278667892,6,1937,1046,-30
33281273901,33281273897,-4,1452,4814,-30
33282517209,33282517214,5,2775,1466,-30
33285114664,33285114670,6,1261,885,-30
33286660726,33286660730,4,1685,1110,-30
33289226543,33289226549,6,2594,1168,-30
33290339324,33290339328,4,2486,1653,-30
33292626535,33292626542,7,2874,1412,-30
33303916199,33303916201,2,2758,1425,-30
33304005463,33304005459,-4,493,102,-30
33306223587,33306223591,4,1857,1463,-30
33311161704,33311161710,6,3076,1412,-30
33311832732,33311832738,6,2176,1159,-30
33311965486,33311965490,4,2935,1463,-30
33316040281,33316040287,6,2290,1122,-30
33319882234,33319882240,6,2710,1760,-30
33323318458,33323318463,5,2662,1403,-30
33327032275,33327032281,6,2339,1741,-30
33330768406,33330768411,5,2633,1474,-30
33334696036,33334696040,4,1905,1231,-30
33335384594,33335384598,4,2352,2119,-30
33335988885,33335988891,6,1758,1018,-30
33336940570,33336940575,5,1658,682,-30
33337304790,33337304795,5,1558,1006,-30
33337521350,33337521357,7,4116,1181,-30
33345978590,33345978594,4,2297,1031,-30
33346445482,33346445465,-17,1223,705,-30
33347052803,33347052806,3,1618,1985,-30
33350927782,33350927788,6,2539,1613,-30
33355293868,33355293874,6,2266,1532,-30
33361902496,33361902501,5,3219,2040,-30
33362418777,33362418783,6,2658,1276,-30
33362949377,33362949379,2,2260,1893,-30
33367702426,33367702429,3,2030,1743,-30
33376654450,33376654444,-6,88,3293,-30
33378419969,33378419973,4,2258,1351,-30
33380910083,33380910087,4,2523,1619,-30
33385772498,33385772503,5,1145,765,-30
33386556334,33386556339,5,2990,1275,-30
33394619665,33394619661,-4,1606,2876,-30
33398988265,33398988270,5,2696,1564,-30
33402330266,33402330272,6,1733,917,-30
33408924017,33408924017,0,1602,1755,-30
33409157372,33409157377,5,1918,1046,-30
33411572162,33411572169,7,2257,1318,-30
33411902522,33411902527,5,1719,1116,-30
33411985953,33411985959,6,2930,1703,-30
33414516974,33414516979,5,1907,1037,-30
33415228264,33415228269,5,2547,1701,-30
33419719080,33419719086,6,1847,1283,-30
33420727666,33420727670,4,2194,1798,-30
33420798924,33420798927,3,1481,885,-30
33420990033,33420990038,5,3274,1916,-30
33422371385,33422371378,-7,1827,7528,-30
33422847598,33422847602,4,2336,1011,-30
33424086031,33424086034,3,1626,1378,-30
33424709923,33424709929,6,2073,1154,-30
33425020341,33425020320,-21,1689,746,-30
33430622794,33430622798,4,1311,973,-30
33432047491,33432047481,-10,1007,337,-30
33434968141,33434968147,6,1850,1178,-30
33438251480,33438251498,18,50,1803,-30
33439070529,33439070533,4,2374,1336,-30
33440441806,33440441811,5,2328,1280,-30
33442742804,33442742809,5,3053,1602,-30
33442786549,33442786562,13,1853,1613,-30
33443041975,33443041978,3,2221,1047,-30
33443386775,33443386780,5,979,1398,-30
33450736750,33450736755,5,1370,1179,-30
33453267481,33453267486,5,3174,1331,-30
33455567069,33455567074,5,2333,1304,-30
33457061034,33457061041,7,2040,1111,-30
33457326377,33457326361,-16,1798,1275,-30
33459052769,33459052774,5,2150,1506,-30
33461593406,33461593407,1,1521,1701,-30
33462792177,33462792179,2,850,1048,-30
33464091869,33464091850,-19,2080,839,-30
33465403497,33465403501,4,2510,1094,-30
33465720332,33465720334,2,1433,1037,-30
33474077253,33474077258,5,3468,1088,-30
33475586729,33475586734,5,2136,1396,-30
33481084983,33481084989,6,2834,1111,-30
33483317917,33483317921,4,2698,1471,-30
33484647825,33484647832,7,2295,1273,-30
33485347658,33485347663,5,2999,1807,-30
33487282568,33487282575,7,1652,1152,-30
33492170404,33492170407,3,2050,1229,-30
33492722025,33492722029,4,1715,1233,-30
33493411354,33493411359,5,1295,837,-30
33493483024,33493483042,18,2335,1489,-30
33495377100,33495377103,3,2249,1227,-30
33495456193,33495456200,7,12956,24085,-30
33501486243,33501486247,4,1776,1444,-30
33501761324,33501761329,5,1440,921,-30
33502732226,33502732229,3,1968,1139,-30
33503705770,33503705773,3,2424,1492,-30
33511616502,33511616507,5,1740,886,-30
33515226782,33515226787,5,1947,1262,-30
33518825256,33518825262,6,2755,1764,-30
33519385023,33519385031,8,2675,1577,-30
33520613852,33520613856,4,2592,1312,-30
33520827945,33520827951,6,1800,902,-30
33521131940,33521131946,6,2554,1277,-30
33523269286,33523269293,7,2079,1058,-30
33527100768,33527100774,6,1429,1163,-30
33529195870,33529195875,5,1864,1079,-30
33529365766,33529365771,5,2264,1353,-30
33529468105,33529468111,6,2281,1199,-30
33535419381,33535419386,5,2666,1633,-30
33536238841,33536238846,5,1472,962,-30
33538252310,33538252315,5,2643,1260,-30
33539356946,33539356951,5,2058,884,-30
33541369433,33541369436,3,2555,1648,-30
33543142738,33543142743,5,2573,1077,-30
33545448414,33545448398,-16,1722,913,-30
33545988558,33545988563,5,2376,1052,-30
33556057469,33556057475,6,2577,1261,-30
33556357375,33556357356,-19,2309,1206,-30
33556990781,33556990783,2,52941,36803,-30
33557141430,33557141436,6,2804,1454,-30
33561746854,33561746860,6,1477,1161,-30
33564603327,33564603321,-6,1281,5217,-30
33565635413,33565635418,5,2772,1413,-30
33566725833,33566725837,4,1399,1233,-30
33567429098,33567429106,8,1306,311,-30
33567652494,33567652499,5,2483,1251,-30
33568333982,33568333986,4,2374,1209,-30
33568746714,33568746718,4,1922,811,-30
33569882417,33569882424,7,2377,1622,-30
33571124136,33571124142,6,1933,1158,-30
33571228312,33571228322,10,1446,1202,-30
33572735079,33572735082,3,2054,1502,-30
33574700894,33574700899,5,2036,1460,-30
33575306317,33575306321,4,1638,935,-30
33575450587,33575450590,3,2509,2214,-30
33581189890,33581189894,4,1615,1014,-30
33581689469,33581689462,-7,2732,12722,-30
33586454528,33586454531,3,2001,1535,-30
33587259082,33587259086,4,2675,1317,-30
33589179090,33589179097,7,2053,1278,-30
33592644382,33592644387,5,2319,1309,-30
33594306041,33594306046,5,3160,1622,-30
33595580014,33595580021,7,1801,1009,-30
33597838921,33597838927,6,2202,1140,-30
33598412010,33598412017,7,2107,1303,-30
33599068695,33599068701,6,2439,1154,-30
33604554237,33604554240,3,2679,1958,-30
33605114820,33605114827,7,3120,1099,-30
33605157259,33605157266,7,3474,1482,-30
33612290680,33612290685,5,2147,1282,-30
33613696692,33613696685,-7,38984,14166,-30
33618368493,33618368498,5,1228,797,-30
33618549971,33618549975,4,1465,949,-30
33623875242,33623875245,3,2520,1813,-30
33626298259,33626298262,3,1903,1348,-30
33629620932,33629620937,5,2755,1496,-30
33632160214,33632160219,5,2932,1405,-30
33634790399,33634790400,1,613,139,-30
33635956805,33635956810,5,2102,901,-30
33636150617,33636150620,3,1232,877,-30
33636977879,33636977893,14,2054,1187,-30
33643132654,33643132658,4,2378,1158,-30
33645564026,33645564030,4,1883,1151,-30
33647269103,33647269107,4,1839,1259,-30
33652874026,33652874032,6,2097,1224,-30
33653289263,33653289269,6,2666,974,-30
33654201699,33654201706,7,3439,1073,-30
33656484708,33656484714,6,2368,1162,-30
33657063190,33657063195,5,1925,1534,-30
33657944117,33657944122,5,1671,1387,-30
33658259670,33658259673,3,2617,1555,-30
33658376118,33658376100,-18,1484,1006,-30
33660239361,33660239367,6,1538,1373,-30
33666121682,33666121687,5,2080,859,-30
33667764022,33667764027,5,1988,1253,-30
33669365318,33669365323,5,2180,1140,-30
33674376561,33674376566,5,2733,1410,-30
33674457857,33674457850,-7,1808,4665,-30
33675136813,33675136814,1,3540,3284,-30
33679635157,33679635162,5,1927,1020,-30
33679866536,33679866547,11,1300,153,-30
33682092205,33682092211,6,2266,1609,-30
33684625873,33684625877,4,1878,1353,-30
33684934248,33684934251,3,1781,1581,-30
33690123149,33690123153,4,775,801,-30
33695059409,33695059414,5,2571,1298,-30
33695226788,33695226800,12,2622,1570,-30
33695691211,33695691218,7,4236,1489,-30
33697388054,33697388059,5,3219,1887,-30
33698388887,33698388890,3,2250,745,-30
33700834009,33700834013,4,2688,1684,-30
33705534549,33705534553,4,3083,1255,-30
33705958228,33705958234,6,2526,1619,-30
33707544407,33707544411,4,1381,1244,-30
33711880009,33711880013,4,1806,1233,-30
33713625916,33713625921,5,2353,1422,-30
33715278751,33715278755,4,1289,874,-30
33715365514,33715365518,4,2183,1388,-30
33716016274,33716016278,4,2297,1474,-30
33719376847,33719376850,3,2230,1693,-30
33722829120,33722829123,3,1782,1314,-30
33728305115,33728305121,6,3057,1794,-30
33730143043,33730143048,5,2453,1238,-30
33731927018,33731927022,4,1925,1282,-30
33732621599,33732621602,3,1712,1097,-30
33733035345,33733035350,5,1653,1224,-30
33740898129,33740898135,6,2892,1693,-30
33745718023,33745718029,6,1661,1339,-30
33746177546,33746177553,7,968,57,-30
33747062914,33747062918,4,1569,885,-30
33748598302,33748598308,6,2261,1649,-30
33750047271,33750047273,2,1410,1356,-30
33760740353,33760740358,5,1999,1533,-30
33762310202,33762310205,3,2324,1069,-30
33765483766,33765483771,5,2091,1149,-30
33766569232,33766569238,6,1710,1329,-30
33766940774,33766940778,4,2168,1112,-30
33771677038,33771677042,4,1264,747,-30
33775556149,33775556150,1,1251,1613,-30
33775701238,33775701241,3,2651,1407,-30
33779275129,33779275134,5,2991,1428,-30
33780452160,33780452167,7,2686,1654,-30
33786644134,33786644140,6,2433,1705,-30
33789033992,33789033998,6,2511,1665,-30
33789173574,33789173576,2,1055,719,-30
33791877053,33791877058,5,2194,1289,-30
33793923822,33793923807,-15,2444,1529,-30
33805920383,33805920389,6,2279,1618,-30
33810821969,33810821974,5,2083,1415,-30
33812618073,33812618078,5,2184,1387,-30
33818298491,33818298495,4,2701,1319,-30
33819927249,33819927255,6,2059,1039,-30
33819959453,33819959434,-19,2031,1227,-30
33820387785,33820387790,5,1962,1282,-30
33821576154,33821576161,7,1545,1121,-30
33821746183,33821746200,17,2063,856,-30
33823143408,33823143411,3,2001,1025,-30
33823329808,33823329812,4,2183,1184,-30
33823491434,33823491440,6,10107,20694,-30
33824968573,33824968581,8,1575,749,-30
33826209415,33826209421,6,3172,1207,-30
33826768297,33826768304,7,1182,773,-30
33827369882,33827369865,-17,855,304,-30
33828960205,33828960210,5,2154,1577,-30
33834559202,33834559208,6,2376,1308,-30
33834827140,33834827146,6,2109,1395,-30
33835128360,33835128367,7,2628,1518,-30
33837581162,33837581161,-1,1458,2067,-30
33839047894,33839047898,4,1271,1124,-30
33844934829,33844934822,-7,1345,5158,-30
33845527977,33845527979,2,1516,1175,-30
33846031493,33846031475,-18,2240,1560,-30
33847864301,33847864306,5,2411,1209,-30
33848177878,33848177886,8,3443,1309,-30
33850292429,33850292433,4,1887,1443,-30
33850429970,33850429976,6,1781,972,-30
33855326914,33855326918,4,1751,907,-30
33861808083,33861808088,5,1737,710,-30
33861834906,33861834913,7,2697,1410,-30
33862177887,33862177890,3,1404,1112,-30
33864232724,33864232736,12,67309,81063,-30
33864803853,33864803859,6,3292,2034,-30
33865043434,33865043439,5,2242,1529,-30
33865465216,33865465222,6,2218,1039,-30
33866631931,33866631935,4,2072,1269,-30
33866705385,33866705367,-18,42135,26854,-30
33867527836,33867527843,7,2382,1115,-30
33869546511,33869546515,4,1963,1057,-30
33869707237,33869707242,5,1808,998,-30
33871945512,33871945517,5,2751,1403,-30
33872277460,33872277465,5,2496,1087,-30
33872693530,33872693535,5,1586,980,-30
33872734602,33872734594,-8,729,404,-30
33876585564,33876585568,4,1854,1509,-30
33882596160,33882596156,-4,18098,16540,-30
33885450639,33885450645,6,1863,1527,-30
33886151979,33886151992,13,1727,1009,-30
33891269402,33891269407,5,2618,1933,-30
33891453533,33891453538,5,1650,1115,-30
33892707870,33892707851,-19,1434,1218,-30
33898155661,33898155666,5,2528,1113,-30
33904457070,33904457075,5,2533,1638,-30
33905059142,33905059147,5,1669,855,-30
33906174578,33906174581,3,2684,1542,-30
33913323158,33913323164,6,2405,1432,-30
33913469694,33913469701,7,2420,1410,-30
33916899694,33916899707,13,696,4326,-30
33917479125,33917479129,4,2587,1777,-30
33917978314,33917978318,4,1884,1397,-30
33918309369,33918309374,5,1749,1096,-30
33923253786,33923253792,6,2195,1629,-30
33923908245,33923908249,4,2913,1785,-30
33924800698,33924800706,8,2447,947,-30
33926039966,33926039944,-22,1991,1285,-30
33926151162,33926151167,5,1318,1204,-30
33929446515,33929446520,5,2502,1073,-30
33930087750,33930087732,-18,2490,1313,-30
33935716933,33935716937,4,1864,1107,-30
33939681139,33939681142,3,1702,954,-30
33939775554,33939775560,6,2066,1165,-30
33939859954,33939859971,17,1045,150,-30
33940867358,33940867362,4,2417,1476,-30
33943231710,33943231713,3,1692,1918,-30
33943358030,33943358033,3,1294,1060,-30
33945340266,33945340270,4,1977,835,-30
33947528757,33947528762,5,1237,827,-30
33948281277,33948281282,5,2153,1671,-30
33951542550,33951542555,5,3401,1578,-30
33954436394,33954436398,4,3137,1239,-30
33955437681,33955437685,4,2008,1278,-30
33961185028,33961185033,5,2015,1296,-30
33961639033,33961639038,5,3211,1675,-30
33964121438,33964121443,5,2094,1190,-30
33964206350,33964206354,4,1457,1237,-30
33965899078,33965899083,5,1633,1177,-30
33971962453,33971962459,6,2593,1305,-30
33977589654,33977589658,4,2946,1523,-30
33978279077,33978279059,-18,2006,1185,-30
33980201922,33980201927,5,2802,1668,-30
33981896741,33981896747,6,698,712,-30
33986304262,33986304266,4,1944,1018,-30
33987223637,33987223641,4,2910,1659,-30
33988722069,33988722074,5,2110,920,-30
33989646318,33989646339,21,1059,1087,-30
33990441758,33990441763,5,2084,1353,-30
33991487554,33991487557,3,1344,1238,-30
33995724479,33995724485,6,2364,1077,-30
33997031654,33997031659,5,2305,1302,-30
33998873702,33998873709,7,2302,1293,-30
34000293491,34000293495,4,1496,1105,-30
34000702870,34000702876,6,2769,1317,-30
34010149936,34010149920,-16,150,1614,-30
34010387231,34010387227,-4,440,83,-30
34013915719,34013915724,5,1898,1194,-30
34022098231,34022098236,5,3340,1673,-30
34034665632,34034665637,5,2783,1554,-30
34035923744,34035923744,0,2475,2978,-30
34037920183,34037920186,3,2178,1156,-30
34037968849,34037968836,-13,1228,367,-30
34045737971,34045737977,6,2524,1572,-30
34048075768,34048075772,4,2264,1340,-30
34062026626,34062026630,4,2562,1377,-30
34064563418,34064563422,4,1719,1455,-30
34065760422,34065760417,-5,1340,3805,-30
34066511223,34066511230,7,1119,720,-30
34070336648,34070336651,3,1688,1255,-30
34073129013,34073129015,2,2055,1379,-30
34074614980,34074614983,3,2554,1334,-30
34075646557,34075646563,6,1174,498,-30
34076369061,34076369066,5,2515,1448,-30
34081874805,34081874809,4,1558,1083,-30
34082639054,34082639060,6,2347,1485,-30
34082797963,34082797968,5,2410,1663,-30
34083914579,34083914584,5,2784,1257,-30
34087742766,34087742746,-20,1233,711,-30
34087968818,34087968822,4,2249,1212,-30
34090662752,34090662758,6,1706,1248,-30
34092124813,34092124814,1,2155,2124,-30
34097471005,34097471011,6,2378,1696,-30
34099710361,34099710364,3,1998,1371,-30
34099787186,34099787190,4,2025,1075,-30
34108011806,34108011813,7,3727,2220,-30
34114434962,34114434968,6,1942,1520,-30
34114625865,34114625869,4,1565,957,-30
34116415241,34116415247,6,1826,1214,-30
34117010186,34117010179,-7,851,336,-30
34118545027,34118545031,4,1538,973,-30
34121249525,34121249529,4,2335,1692,-30
34124579283,34124579288,5,1912,1395,-30
34124767370,34124767375,5,3373,1143,-30
34125474962,34125474966,4,2480,1212,-30
34129660108,34129660111,3,2054,1223,-30
34130180174,34130180176,2,2981,1343,-30
34131612278,34131612282,4,2279,1879,-30
34133732669,34133732675,6,1852,1068,-30
34138269922,34138269926,4,1512,750,-30
34140225490,34140225494,4,2293,1087,-30
34141146633,34141146638,5,2108,1042,-30
34146030981,34146030985,4,1749,1498,-30
34151391389,34151391394,5,1784,1419,-30
34152581003,34152581007,4,2318,1475,-30
34152620470,34152620475,5,1231,602,-30
34154317431,34154317438,7,1312,947,-30
34155229993,34155229998,5,2871,1491,-30
34159181658,34159181659,1,1434,980,-30
34160505330,34160505334,4,2956,1428,-30
34164367905,34164367909,4,2068,979,-30
34165120487,34165120492,5,1608,1238,-30
34167318845,34167318849,4,4594,3193,-30
34167367059,34167367065,6,1986,1135,-30
34168147445,34168147426,-19,2670,1388,-30
34169028943,34169028947,4,2261,1100,-30
34170545881,34170545867,-14,2374,1082,-30
34170885122,34170885127,5,2084,1201,-30
34171928031,34171928037,6,2619,1301,-30
34171984541,34171984542,1,1494,1575,-30
34172421206,34172421209,3,2136,873,-30
34178993984,34178993989,5,1835,977,-30
34181679090,34181679095,5,2341,1043,-30
34190917388,34190917393,5,2731,1722,-30
34197449493,34197449498,5,2522,1039,-30
34198546118,34198546117,-1,2067,3475,-30
34199399443,34199399446,3,2556,1408,-30
34200743077,34200743093,16,16072,18137,-30
34200999837,34200999841,4,1900,1337,-30
34202177018,34202177014,-4,1118,3794,-30
34203608736,34203608739,3,2196,1853,-30
34205622739,34205622744,5,1651,1376,-30
34206454215,34206454221,6,3848,1765,-30
34207139626,34207139630,4,2592,1174,-30
34212008002,34212008008,6,3396,1501,-30
34214184378,34214184382,4,2147,1217,-30
34216051311,34216051315,4,2843,1558,-30
34221658809,34221658814,5,2618,1308,-30
34221716897,34221716913,16,1419,1175,-30
34221825082,34221825062,-20,1877,1426,-30
34222426601,34222426606,5,2395,1506,-30
34223960159,34223960163,4,35116,20447,-30
34227832045,34227832051,6,1481,963,-30
34231497441,34231497446,5,2234,1286,-30
34231919820,34231919826,6,3326,2044,-30
34232061145,34232061151,6,2609,1153,-30
34232138407,34232138413,6,2336,970,-30
34232373727,34232373733,6,9342,3158,-30
34238002395,34238002399,4,2228,1295,-30
34239464117,34239464117,0,2013,2271,-30
34242366714,34242366719,5,1978,1170,-30
34246249025,34246249031,6,7778,30266,-30
34248196263,34248196266,3,2246,1411,-30
34252193645,34252193650,5,2858,1361,-30
34253879673,34253879678,5,1747,947,-30
34254588746,34254588751,5,1766,999,-30
34255143945,34255143951,6,1868,959,-30
34256946834,34256946837,3,1957,1494,-30
34258811722,34258811704,-18,2340,1307,-30
34263607830,34263607835,5,1769,1593,-30
34264402039,34264402016,-23,1799,1017,-30
34266743147,34266743156,9,2296,1213,-30
34271946166,34271946172,6,2012,1219,-30
34273091561,34273091566,5,2504,971,-30
34277969245,34277969249,4,2099,1236,-30
34278639345,34278639350,5,2372,1392,-30
34282760831,34282760836,5,2067,984,-30
34285544534,34285544538,4,2357,1133,-30
34287291478,34287291479,1,1707,2461,-30
34291130258,34291130263,5,1487,1169,-30
34301513990,34301513970,-20,1132,1231,-30
34303644857,34303644861,4,2282,1293,-30
34308069518,34308069522,4,1859,982,-30
34310577410,34310577417,7,68248,28169,-30
34311309826,34311309829,3,1836,1825,-30
34311815944,34311815947,3,1760,1506,-30
34315214770,34315214771,1,18181,13999,-30
34318073157,34318073161,4,3891,2967,-30
34319496550,34319496554,4,2076,1009,-30
34320277705,34320277703,-2,1232,1635,-30
34321976885,34321976890,5,2218,1007,-30
34323019552,34323019536,-16,84,3338,-30
34324333845,34324333850,5,2899,1513,-30
34327384838,34327384843,5,2470,1440,-30
34330834440,34330834444,4,2465,1616,-30
34332957536,34332957544,8,14771,23698,-30
34335309236,34335309241,5,3531,1602,-30
34345854140,34345854146,6,1953,1003,-30
34346556642,34346556646,4,2878,1853,-30
34350220973,34350220975,2,2789,1392,-30
34353117318,34353117323,5,2361,1068,-30
34357735805,34357735811,6,1990,1343,-30
34358254688,34358254691,3,2172,1458,-30
34358298674,34358298679,5,2431,1625,-30
34359255737,34359255742,5,1868,1380,-30
34359859197,34359859203,6,3676,1913,-30
34365085677,34365085682,5,2292,1629,-30
34366577339,34366577343,4,1736,1280,-30
34370896110,34370896115,5,2009,1438,-30
34375381941,34375381947,6,2275,1074,-30
34375963483,34375963488,5,2759,1517,-30
34379563170,34379563172,2,2172,1581,-30
34382063330,34382063335,5,2298,781,-30
34382936449,34382936455,6,2083,962,-30
34384856926,34384856930,4,2069,1393,-30
34386648623,34386648629,6,2045,1492,-30
34387011779,34387011782,3,1634,804,-30
34389349758,34389349762,4,2862,1311,-30
34395638333,34395638337,4,2504,1173,-30
34401328761,34401328766,5,1992,1018,-30
34402212706,34402212712,6,2708,1613,-30
34405978730,34405978735,5,2635,1455,-30
34408347001,34408347007,6,1693,1277,-30
34409614653,34409614659,6,1932,1031,-30
34413610868,34413610875,7,1767,1410,-30
34414368226,34414368243,17,1703,1276,-30
34415113218,34415113224,6,3252,1555,-30
34420007366,34420007370,4,1742,1035,-30
34421535556,34421535563,7,2363,1162,-30
34423136881,34423136886,5,3569,1859,-30
34428827005,34428827009,4,1997,732,-30
34429163377,34429163370,-7,660,475,-30
34430528825,34430528829,4,2763,1479,-30
34444292879,34444292882,3,2570,1542,-30
34444853022,34444853027,5,1593,948,-30
34444972623,34444972627,4,1417,1087,-30
34445969684,34445969689,5,2096,1279,-30
34446155812,34446155815,3,2828,1975,-30
34446490162,34446490165,3,1636,1151,-30
34446607539,34446607545,6,1670,1063,-30
34447467275,34447467279,4,1534,767,-30
34448824712,34448824718,6,2091,1228,-30
34451594290,34451594297,7,2058,1128,-30
34453635378,34453635383,5,2711,1611,-30
34455635694,34455635699,5,2603,1593,-30
34456782968,34456782974,6,2359,1412,-30
34460015125,34460015131,6,1920,680,-30
34462010153,34462010158,5,1899,1373,-30
34465119585,34465119581,-4,1089,2645,-30
34466482286,34466482291,5,1926,1012,-30
34470995653,34470995657,4,2983,1733,-30
34472397042,34472397046,4,1302,704,-30
34477866776,34477866781,5,2220,1116,-30
34479784961,34479784973,12,11278,46030,-30
34481683753,34481683749,-4,1103,2385,-30
34486528575,34486528581,6,1684,1219,-30
34487291166,34487291171,5,1651,1330,-30
34487427450,34487427456,6,2650,1309,-30
34493470885,34493470891,6,3767,1596,-30
34497202169,34497202174,5,2141,1316,-30
34498415459,34498415464,5,2131,1575,-30
34500191990,34500191994,4,2214,960,-30
34502460770,34502460769,-1,1351,1358,-30
34503020166,34503020163,-3,2017,4639,-30
34503807091,34503807093,2,1701,2264,-30
34507893218,34507893222,4,2577,1531,-30
34514334529,34514334535,6,1718,749,-30
34516805537,34516805539,2,1579,1406,-30
34518292813,34518292818,5,1782,1680,-30
34522075001,34522075004,3,2677,1297,-30
34524036361,34524036365,4,1863,1484,-30
34527300159,34527300162,3,3109,1919,-30
34529691394,34529691399,5,2129,1508,-30
34530574258,34530574264,6,2607,1181,-30
34530781162,34530781167,5,2177,988,-30
34535067645,34535067649,4,2172,1810,-30
34538460940,34538460945,5,1714,1162,-30
34539092977,34539092984,7,13996,32199,-30
34539956112,34539956118,6,2919,1697,-30
34542716961,34542716967,6,2012,869,-30
34542799337,34542799354,17,1873,1369,-30
34543475721,34543475727,6,1759,1129,-30
34547963335,34547963339,4,986,1142,-30
34550591554,34550591558,4,1632,1169,-30
34552777643,34552777648,5,1793,1575,-30
34552945274,34552945279,5,2232,1802,-30
34555635577,34555635583,6,2209,1519,-30
34558190050,34558190057,7,1653,850,-30
34558664858,34558664865,7,3408,1501,-30
34560635325,34560635331,6,2234,1063,-30
34561427301,34561427306,5,2070,1514,-30
34562314210,34562314214,4,1626,1115,-30
34566970577,34566970573,-4,1290,5076,-30
34567397058,34567397062,4,1930,1261,-30
34570047670,34570047676,6,913,1266,-30
34572626012,34572626017,5,1606,1553,-30
34575353558,34575353552,-6,1516,6312,-30
34578568957,34578568963,6,1560,837,-30
34579363645,34579363649,4,1951,1202,-30
34579886822,34579886826,4,2446,1631,-30
34581326284,34581326290,6,2286,1187,-30
34585076815,34585076818,3,2717,1415,-30
34591725154,34591725159,5,1812,633,-30
34592747578,34592747585,7,2173,1432,-30
34593669514,34593669522,8,3381,1907,-30
34594404206,34594404210,4,1695,1158,-30
34596169683,34596169688,5,1528,901,-30
34604027479,34604027483,4,2594,1250,-30
34613991950,34613991954,4,2704,1721,-30
34614720136,34614720141,5,3542,1794,-30
34618038305,34618038309,4,2567,1441,-30
34618632701,34618632715,14,593,86,-30
34624553641,34624553645,4,3630,1822,-30
34625693003,34625693005,2,1934,1089,-30
34625998273,34625998277,4,3262,1270,-30
34629594077,34629594083,6,1999,1020,-30
34631182310,34631182318,8,3454,1095,-30
34632075947,34632075951,4,2673,1525,-30
34633019118,34633019123,5,1439,1228,-30
34634196882,34634196887,5,2299,1325,-30
34634593445,34634593449,4,2882,1287,-30
34637463701,34637463705,4,2145,1813,-30
34640088947,34640088952,5,1882,1255,-30
34642587002,34642587007,5,2390,1437,-30
34642849353,34642849355,2,1696,1283,-30
34646976938,34646976947,9,1253,290,-30
34651683230,34651683235,5,2374,1724,-30
34652628531,34652628535,4,1885,1682,-30
34652828338,34652828344,6,1544,1011,-30
34653048010,34653048015,5,2314,1309,-30
34655000981,34655000987,6,1914,751,-30
34655606850,34655606855,5,1958,1306,-30
34662355581,34662355585,4,2219,1505,-30
34667151561,34667151566,5,1164,744,-30
34669456797,34669456802,5,2328,1414,-30
34671233594,34671233600,6,2642,1400,-30
34671490402,34671490405,3,2748,1224,-30
34671895701,34671895689,-12,1124,473,-30
34675105853,34675105857,4,1800,1096,-30
34676034886,34676034890,4,2539,1859,-30
34677475043,34677475046,3,2095,1284,-30
34677966694,34677966701,7,2170,1129,-30
34678047949,34678047953,4,2713,1146,-30
34678334073,34678334056,-17,2479,1327,-30
34683834098,34683834102,4,1495,1569,-30
34687499993,34687499999,6,2544,1436,-30
34690070221,34690070222,1,1724,1681,-30
34694113626,34694113630,4,2734,1523,-30
34698710524,34698710524,0,1513,2287,-30
34700302462,34700302467,5,2279,1010,-30
34707450417,34707450418,1,1636,1300,-30
34708214186,34708214190,4,1895,1379,-30
34708987459,34708987464,5,2412,1896,-30
34709178791,34709178797,6,2730,1176,-30
34709734703,34709734707,4,637,349,-30
34710562837,34710562841,4,2376,1368,-30
34711043681,34711043686,5,2568,1638,-30
34711741838,34711741844,6,2237,1044,-30
34712884926,34712884932,6,2470,1201,-30
34719287290,34719287295,5,2177,1420,-30
34719467672,34719467678,6,2917,1131,-30
34721578223,34721578227,4,1900,1197,-30
34725419097,34725419102,5,2221,1532,-30
34726832786,34726832789,3,1962,1643,-30
34727786062,34727786064,2,847,1487,-30
34728888599,34728888602,3,1867,1289,-30
34730696417,34730696422,5,1590,1396,-30
34733482819,34733482824,5,1729,1548,-30
34740411175,34740411179,4,2367,1324,-30
34743137333,34743137338,5,2243,1324,-30
34744162084,34744162086,2,1619,1926,-30
34746983230,34746983234,4,3389,1863,-30
34749194700,34749194703,3,2240,1470,-30
34749271094,34749271099,5,2437,1160,-30
34757086317,34757086323,6,2804,1201,-30
34758465723,34758465727,4,2707,1085,-30
34762534141,34762534145,4,2520,1459,-30
34765978922,34765978927,5,2436,1213,-30
34768590074,34768590078,4,1334,1150,-30
34768745090,34768745094,4,1652,1214,-30
34775108353,34775108358,5,1783,1505,-30
34779084990,34779084994,4,2834,2076,-30
34781759884,34781759894,10,19049,21093,-30
34783469752,34783469756,4,2454,1614,-30
34784790013,34784790016,3,1796,860,-30
34785669941,34785669946,5,2295,1248,-30
34786123513,34786123509,-4,1043,2668,-30
34791220510,34791220506,-4,700,3095,-30
34791414858,34791414860,2,1997,2236,-30
34795396821,34795396826,5,2939,1259,-30
34796110600,34796110605,5,2877,1630,-30
34797100805,34797100805,0,1294,1643,-30
34803644285,34803644289,4,1421,1024,-30
34804073805,34804073818,13,1808,1096,-30
34819746003,34819746003,0,1032,1623,-30
34825409795,34825409801,6,1601,1189,-30
34825706426,34825706432,6,5488,2417,-30
34826375428,34826375434,6,2361,2047,-30
34830143258,34830143263,5,2425,1402,-30
34832050985,34832050990,5,1517,1102,-30
34840012523,34840012526,3,1891,1373,-30
34840132174,34840132182,8,1954,1384,-30
34841010640,34841010646,6,2251,1428,-30
34844075333,34844075339,6,3008,1400,-30
34844317075,34844317079,4,2015,1329,-30
34845893202,34845893206,4,2600,2033,-30
34850955266,34850955273,7,2491,1245,-30
34855566797,34855566803,6,2074,1351,-30
34861901270,34861901275,5,1733,1390,-30
34864980801,34864980805,4,2455,1484,-30
34865267422,34865267428,6,1911,869,-30
34866490885,34866490890,5,2102,987,-30
34868143530,34868143535,5,1966,1116,-30
34878725293,34878725299,6,2254,1224,-30
34881587323,34881587327,4,2370,1297,-30
34882893337,34882893342,5,1608,823,-30
34883208156,34883208158,2,1148,1634,-30
34883914144,34883914146,2,1831,1043,-30
34890086394,34890086399,5,2488,1457,-30
34893436152,34893436157,5,1854,1243,-30
34893911221,34893911225,4,3435,2099,-30
34894642263,34894642267,4,2060,1184,-30
34896467401,34896467407,6,2829,1555,-30
34899050599,34899050603,4,1079,611,-30
34901060458,34901060464,6,2243,1406,-30
34903731385,34903731389,4,3226,1834,-30
34905759782,34905759787,5,2284,1958,-30
34906386284,34906386293,9,13360,19886,-30
34910343794,34910343798,4,1929,1196,-30
34910487389,34910487394,5,1835,1197,-30
34916089970,34916089977,7,2290,1544,-30
34916162738,34916162722,-16,711,358,-30
34918338490,34918338494,4,2271,1508,-30
34929380882,34929380886,4,2330,1297,-30
34930131271,34930131274,3,1938,1095,-30
34938401130,34938401135,5,1233,1138,-30
34940624390,34940624393,3,2673,1718,-30
34942092751,34942092753,2,1042,858,-30
34944624038,34944624041,3,1126,812,-30
34946313292,34946313291,-1,2704,3035,-30
34947366286,34947366290,4,1779,1315,-30
34947584950,34947584956,6,1401,787,-30
34949823743,34949823737,-6,1240,3501,-30
34950957087,34950957093,6,2567,1677,-30
34955248658,34955248662,4,2105,1625,-30
34956327884,34956327889,5,2541,1647,-30
34960294125,34960294129,4,2621,1314,-30
34963107610,34963107616,6,2109,1758,-30
34965585370,34965585374,4,2099,881,-30
34966136911,34966136915,4,330,200,-30
34967375450,34967375456,6,2267,1175,-30
34968440014,34968440020,6,2380,1401,-30
34968850028,34968850031,3,2436,1959,-30
34970662463,34970662458,-5,974,2884,-30
34975507141,34975507145,4,13027,9625,-30
34978553890,34978553896,6,1595,1182,-30
34986155717,34986155724,7,2710,1367,-30
34986892546,34986892550,4,2280,1817,-30
34989250404,34989250410,6,1516,953,-30
34996972333,34996972339,6,2427,1841,-30
34998828680,34998828682,2,1005,1104,-30
34998894949,34998894954,5,2020,1461,-30
35001979689,35001979696,7,2034,1222,-30
35002070205,35002070209,4,2249,1301,-30
35002841697,35002841701,4,2057,1159,-30
35003160509,35003160488,-21,3049,1768,-30
35006248859,35006248865,6,2203,1250,-30
35006506190,35006506197,7,2122,1401,-30
35013670093,35013670098,5,1999,1091,-30
35014149153,35014149161,8,3060,1659,-30
35018930971,35018930976,5,2393,1338,-30
35020148146,35020148151,5,1753,1170,-30
35020788438,35020788439,1,1405,1149,-30
35021647217,35021647224,7,2588,1771,-30
35021954387,35021954387,0,1680,2883,-30
35024033625,35024033631,6,2743,1120,-30
35024098709,35024098692,-17,1763,862,-30
35028049873,35028049877,4,1844,1248,-30
35028407940,35028407945,5,2488,1129,-30
35029244631,35029244637,6,2161,1238,-30
35033802417,35033802423,6,2596,1503,-30
35036076009,35036076013,4,2780,1830,-30
35038034209,35038034214,5,3412,1775,-30
35041099873,35041099880,7,3421,1676,-30
35041127574,35041127553,-21,3540,1250,-30
35048351320,35048351307,-13,1367,1947,-30
35049924233,35049924238,5,2064,1210,-30
35053322318,35053322326,8,4500,1430,-30
35060086686,35060086690,4,2028,1432,-30
35065589270,35065589270,0,773,1410,-30
35070159737,35070159734,-3,1225,2788,-30
35071028288,35071028287,-1,1261,1185,-30
35073679240,35073679244,4,1856,1237,-30
35074231375,35074231381,6,2491,1238,-30
35075751125,35075751130,5,1752,1079,-30
35080704562,35080704569,7,1704,818,-30
35081071655,35081071658,3,1461,1050,-30
35082905183,35082905186,3,2243,1110,-30
35086193582,35086193586,4,2699,1112,-30
35088252471,35088252476,5,2509,1509,-30
35092386693,35092386698,5,1552,1120,-30
35095588143,35095588150,7,2485,1139,-30
35100862781,35100862786,5,1975,1620,-30
35101816964,35101816969,5,2105,1512,-30
35106829136,35106829142,6,1575,1010,-30
35110644447,35110644452,5,2394,1242,-30
35113438375,35113438379,4,1731,1197,-30
35114280871,35114280878,7,1781,1024,-30
35114416463,35114416466,3,1695,1051,-30
35118091610,35118091614,4,2024,1249,-30
35118194478,35118194480,2,2261,1192,-30
35119974156,35119974161,5,2948,1233,-30
35125014472,35125014477,5,1829,1417,-30
35125273627,35125273632,5,4767,2674,-30
35127468846,35127468851,5,3321,1251,-30
35130099333,35130099337,4,2342,1344,-30
35130329234,35130329241,7,1751,1244,-30
35131529361,35131529366,5,2765,1097,-30
35131738803,35131738808,5,2393,1912,-30
35131994106,35131994111,5,2312,1075,-30
35134574814,35134574819,5,3091,1508,-30
35135683759,35135683766,7,3209,1086,-30
35136853178,35136853161,-17,2572,1032,-30
35137200932,35137200937,5,2376,1707,-30
35139816842,35139816848,6,2546,1580,-30
35147035266,35147035272,6,2044,1574,-30
35147301138,35147301124,-14,1822,581,-30
35148817074,35148817072,-2,1161,3381,-30
35162066507,35162066511,4,1746,1250,-30
35163537898,35163537902,4,2243,1223,-30
35165819118,35165819122,4,2340,1187,-30
35166352381,35166352386,5,2038,1160,-30
35171360444,35171360447,3,2916,1507,-30
35174254334,35174254340,6,2451,1053,-30
35178024739,35178024743,4,2063,1039,-30
35179277642,35179277647,5,2327,965,-30
35185213812,35185213814,2,1580,1378,-30
35186112526,35186112531,5,2667,1446,-30
35186379631,35186379637,6,1041,655,-30
35187152846,35187152849,3,2782,1583,-30
35189212690,35189212694,4,2211,1597,-30
35193893861,35193893866,5,2137,1126,-30
35195024919,35195024923,4,2095,1560,-30
35196454725,35196454727,2,1596,1217,-30
35197059307,35197059306,-1,984,1326,-30
35200946711,35200946696,-15,1744,587,-30
35201343689,35201343673,-16,1407,1004,-30
35204047726,35204047731,5,1904,1500,-30
35207286534,35207286539,5,3117,1916,-30
35211207477,35211207483,6,2500,900,-30
35219889519,35219889525,6,1898,954,-30
35222677517,35222677521,4,2276,1416,-30
35226228993,35226228998,5,3254,1655,-30
35227254361,35227254365,4,2174,1465,-30
35234115486,35234115491,5,2700,1259,-30
35240940886,35240940891,5,1700,1036,-30
35241861381,35241861363,-18,1366,631,-30
35247113284,35247113290,6,1769,773,-30
35248797284,35248797290,6,2470,1536,-30
35249208928,35249208932,4,1497,1139,-30
35250121500,35250121481,-19,910,266,-30
35250299732,35250299747,15,1584,1266,-30
35251143775,35251143754,-21,2619,1432,-30
35251349026,35251349033,7,2776,1766,-30
35251674710,35251674692,-18,819,380,-30
35256821742,35256821748,6,2385,1373,-30
35260295057,35260295060,3,14744,11598,-30
35261561034,35261561041,7,1582,1053,-30
35262849185,35262849191,6,2802,1500,-30
35269036322,35269036327,5,2590,1349,-30
35269108243,35269108249,6,2080,1157,-30
35270259901,35270259906,5,1682,1287,-30
35271521235,35271521233,-2,1331,1936,-30
35276323206,35276323212,6,2114,1241,-30
35279614711,35279614716,5,1930,1733,-30
35280960376,35280960382,6,7368,2240,-30
35289413153,35289413158,5,2551,1133,-30
35290904982,35290904970,-12,1083,459,-30
35291676917,35291676922,5,2000,1473,-30
35293183395,35293183403,8,2496,1185,-30
35295055618,35295055622,4,2059,1210,-30
35296621416,35296621419,3,1806,1259,-30
35305450140,35305450146,6,6011,1953,-30
35307008426,35307008430,4,2847,1468,-30
35307455181,35307455186,5,1186,1031,-30
35316123701,35316123709,8,1942,1115,-30
35316859000,35316859003,3,2180,1344,-30
35322099129,35322099135,6,2338,1426,-30
35325566626,35325566629,3,2111,1271,-30
35326425167,35326425170,3,747,1337,-30
35332748641,35332748662,21,2260,1190,-30
35334277827,35334277825,-2,1101,1806,-30
35335515616,35335515619,3,1886,1603,-30
35337379602,35337379606,4,2055,1038,-30
35337871930,35337871912,-18,2042,1449,-30
35339086785,35339086785,0,1505,1869,-30
35344501325,35344501334,9,3949,1281,-30
35344558982,35344558989,7,3188,1643,-30
35344673210,35344673215,5,2350,1641,-30
35346764426,35346764430,4,1953,1503,-30
35346830755,35346830739,-16,868,375,-30
35346993049,35346993056,7,2066,1163,-30
35347185903,35347185908,5,2001,1251,-30
35354493108,35354493115,7,1977,1142,-30
35360677881,35360677886,5,1915,1224,-30
35364159204,35364159208,4,2031,965,-30
35365968797,35365968802,5,1714,1192,-30
35370969355,35370969360,5,2813,1660,-30
35372361401,35372361385,-16,1922,1330,-30
35376955517,35376955522,5,2039,944,-30
35377065341,35377065321,-20,490,435,-30
35377933457,35377933463,6,1932,1099,-30
35379013354,35379013358,4,1389,1101,-30
35380548665,35380548670,5,2662,975,-30
35380612402,35380612385,-17,2710,1375,-30
35380681555,35380681560,5,1390,962,-30
35381537730,35381537735,5,1889,1389,-30
35384421655,35384421661,6,2436,1298,-30
35391281576,35391281580,4,1692,1463,-30
35394163374,35394163381,7,1848,1058,-30
35404937078,35404937082,4,1732,905,-30
35406384943,35406384948,5,2407,1298,-30
35407355678,35407355683,5,1139,1370,-30
35407996953,35407996958,5,2475,1493,-30
35413040072,35413040059,-13,87,2995,-30
35413755230,35413755230,0,1512,1433,-30
35414876280,35414876269,-11,1099,1460,-30
35416814427,35416814429,2,1741,1214,-30
35417778437,35417778442,5,2445,1130,-30
35419576701,35419576705,4,2636,1599,-30
35423507917,35423507922,5,4094,1828,-30
35426145797,35426145802,5,1986,1334,-30
35429836474,35429836481,7,2732,1430,-30
35430232565,35430232569,4,2147,1028,-30
35431950420,35431950425,5,3722,1352,-30
35433766201,35433766206,5,3346,1740,-30
35435571943,35435571946,3,1701,1274,-30
35435907273,35435907277,4,2163,1306,-30
35436172693,35436172697,4,2515,1429,-30
35436412842,35436412849,7,1737,1235,-30
35438644924,35438644926,2,2353,1862,-30
35439333265,35439333272,7,2476,1226,-30
35441762542,35441762548,6,2878,1518,-30
35444188126,35444188131,5,2628,1254,-30
35447073418,35447073415,-3,1267,4001,-30
35447766938,35447766934,-4,588,1943,-30
35450651158,35450651162,4,1713,1556,-30
35451222889,35451222894,5,2705,1587,-30
35453458334,35453458339,5,1482,1183,-30
35453738069,35453738074,5,2291,1374,-30
35458172566,35458172570,4,2187,1449,-30
35468048960,35468048962,2,2813,2008,-30
35471874228,35471874234,6,4021,1768,-30
35472481926,35472481931,5,2580,1821,-30
35480352782,35480352790,8,2636,1635,-30
35480420665,35480420662,-3,1999,4263,-30
35482148284,35482148286,2,1606,1181,-30
35482898163,35482898168,5,2079,1407,-30
35485484449,35485484452,3,1636,860,-30
35485652116,35485652118,2,2086,1830,-30
35490426538,35490426543,5,1949,999,-30
35492918329,35492918329,0,10890,12666,-30
35497132678,35497132683,5,1543,561,-30
35499735527,35499735530,3,1785,1180,-30
35499833586,35499833570,-16,1759,726,-30
35499873442,35499873451,9,1876,1029,-30
35503424435,35503424439,4,1486,923,-30
35507360953,35507360954,1,2417,2727,-30
35511927589,35511927595,6,2156,1228,-30
35511961121,35511961121,0,796,291,-30
35512547024,35512547029,5,2447,1346,-30
35513310145,35513310151,6,3072,1446,-30
35517091710,35517091717,7,2415,1182,-30
35517822874,35517822877,3,2431,1470,-30
35519624486,35519624492,6,2763,1482,-30
35520492697,35520492701,4,1189,973,-30
35522736262,35522736267,5,2100,999,-30
35524269758,35524269762,4,1107,796,-30
35526087290,35526087296,6,2680,1192,-30
35527023119,35527023122,3,2165,971,-30
35527402070,35527402075,5,2052,965,-30
35529899302,35529899306,4,2283,1272,-30
35532941805,35532941806,1,1514,1603,-30
35535528007,35535528013,6,2497,1869,-30
35537234186,35537234192,6,3014,1204,-30
35539898734,35539898736,2,1973,1581,-30
35542232264,35542232269,5,2676,1554,-30
35543479622,35543479627,5,1670,1253,-30
35544849641,35544849644,3,2065,1047,-30
35545645575,35545645579,4,2043,1291,-30
35552480593,35552480596,3,1905,1160,-30
35563804779,35563804783,4,1744,1233,-30
35566280543,35566280547,4,1399,1236,-30
35577391642,35577391643,1,1976,1262,-30
35577603867,35577603875,8,1143,1031,-30
35577905781,35577905784,3,3024,1916,-30
35578530300,35578530306,6,2755,1404,-30
35579958507,35579958521,14,1718,1117,-30
35581006914,35581006919,5,1496,1241,-30
35582150273,35582150266,-7,918,4715,-30
35583100919,35583100926,7,2893,1526,-30
35584958131,35584958135,4,1977,1144,-30
35587425988,35587425993,5,2284,1721,-30
35588159726,35588159731,5,2544,1228,-30
35588331698,35588331702,4,1228,974,-30
35590508961,35590508957,-4,1120,1667,-30
35592340005,35592340007,2,1661,1468,-30
35594165765,35594165770,5,2472,1634,-30
35594547073,35594547078,5,1989,1437,-30
35596175755,35596175767,12,874,1714,-30
35599569846,35599569841,-5,1180,3956,-30
35604468894,35604468890,-4,1880,4672,-30
35605135618,35605135621,3,2587,1616,-30
35606109849,35606109854,5,2275,1121,-30
35606956122,35606956128,6,2858,2013,-30
35607365126,35607365129,3,2065,1606,-30
35608989867,35608989873,6,1707,1050,-30
35609737640,35609737645,5,2271,1650,-30
35609895175,35609895155,-20,2727,1305,-30
35610025277,35610025282,5,2890,865,-30
35612544744,35612544751,7,1674,939,-30
35614174702,35614174706,4,1924,878,-30
35615387278,35615387282,4,1389,730,-30
35616107766,35616107766,0,1052,1501,-30
35616152241,35616152247,6,7341,2458,-30
35624737818,35624737816,-2,717,1091,-30
35649910970,35649910974,4,2439,928,-30
35653456559,35653456565,6,2611,1303,-30
35653530434,35653530438,4,1479,1145,-30
35654400333,35654400337,4,1817,1417,-30
35655433160,35655433165,5,2239,1548,-30
35656861842,35656861837,-5,840,2347,-30
35663939338,35663939346,8,1286,654,-30
35677175811,35677175815,4,2630,1459,-30
35677571200,35677571203,3,1173,1345,-30
35679001766,35679001770,4,1944,1112,-30
35683070365,35683070369,4,2462,1558,-30
35687199725,35687199730,5,1921,745,-30
35690025958,35690025964,6,2257,949,-30
35691948486,35691948492,6,13744,7790,-30
35695030818,35695030823,5,1540,1052,-30
35695074269,35695074282,13,1167,842,-30
35695310217,35695310224,7,2112,1179,-30
35700785911,35700785914,3,2656,1218,-30
35703138192,35703138197,5,1806,1353,-30
35705742550,35705742555,5,2917,1657,-30
35707526126,35707526132,6,2502,1330,-30
35711373657,35711373662,5,2194,1056,-30
35712554283,35712554287,4,2497,1032,-30
35714224831,35714224836,5,1943,1423,-30
35717494207,35717494211,4,1810,1176,-30
35719071821,35719071827,6,2521,1467,-30
35719571469,35719571470,1,1448,1393,-30
35722857773,35722857777,4,1072,1449,-30
35723108073,35723108078,5,1747,1115,-30
35723165946,35723165947,1,803,895,-30
35727316791,35727316794,3,2279,1409,-30
35728653925,35728653929,4,1401,1012,-30
35734583899,35734583904,5,1419,588,-30
35741248693,35741248697,4,2144,1414,-30
35744237273,35744237278,5,1973,861,-30
35744684674,35744684682,8,2877,1374,-30
35749052267,35749052273,6,2315,1256,-30
35759128903,35759128907,4,2699,1062,-30
35766007022,35766007026,4,2014,1197,-30
35772329694,35772329698,4,2516,1694,-30
35778606358,35778606362,4,2505,1805,-30
35778915918,35778915923,5,3098,1062,-30
35779457865,35779457870,5,2107,941,-30
35781445847,35781445851,4,1746,1145,-30
35781694046,35781694052,6,1885,1144,-30
35782117651,35782117654,3,1793,1327,-30
35786331803,35786331781,-22,1462,963,-30
35787143374,35787143379,5,1778,1431,-30
35789100189,35789100195,6,2268,1056,-30
35790120562,35790120567,5,2433,1871,-30
35791997218,35791997222,4,2321,1257,-30
35792792926,35792792929,3,2254,1527,-30
35794001514,35794001500,-14,929,604,-30
35797156953,35797156959,6,2984,1241,-30
35797741191,35797741194,3,2245,1388,-30
35801704194,35801704202,8,1512,806,-30
35803415473,35803415474,1,1482,1489,-30
35808250252,35808250258,6,2772,1412,-30
35809359979,35809359982,3,1775,1633,-30
35811131591,35811131597,6,3381,1667,-30
35812641459,35812641462,3,1617,1025,-30
35814823804,35814823809,5,2718,1107,-30
35815686575,35815686577,2,790,1128,-30
35817107910,35817107916,6,1633,1716,-30
35819954378,35819954383,5,1948,1003,-30
35821763985,35821763989,4,1359,1254,-30
35822899403,35822899405,2,2374,1332,-30
35827002805,35827002807,2,1547,1777,-30
35829558413,35829558422,9,1825,1247,-30
35835690245,35835690241,-4,1416,3343,-30
35837344893,35837344898,5,2290,1174,-30
35840615421,35840615426,5,2975,1479,-30
35843755285,35843755287,2,1985,1457,-30
35844420078,35844420082,4,1625,820,-30
35847388168,35847388175,7,1862,807,-30
35848325470,35848325474,4,1845,1408,-30
35852397484,35852397486,2,2028,1123,-30
35854296920,35854296927,7,10643,1252,-30
35855884154,35855884158,4,1365,974,-30
35856973193,35856973198,5,1834,872,-30
35857185910,35857185917,7,2232,1086,-30
35857226645,35857226649,4,2289,1396,-30
35859628207,35859628210,3,1789,1167,-30
35859730154,35859730136,-18,1525,542,-30
35860422233,35860422238,5,1757,1442,-30
35864318533,35864318537,4,3167,1890,-30
35867172237,35867172242,5,2286,1381,-30
35868196764,35868196770,6,2741,1392,-30
35874932315,35874932321,6,1947,1071,-30
35875672758,35875672763,5,1261,1513,-30
35879902330,35879902335,5,3534,1799,-30
35882828615,35882828622,7,2199,1688,-30
35887459294,35887459298,4,1769,1430,-30
35891653007,35891653025,18,1184,4672,-30
35892436702,35892436706,4,970,1071,-30
35895777153,35895777159,6,3292,1213,-30
35898444801,35898444806,5,1714,868,-30
35900511413,35900511418,5,1978,1363,-30
35902846212,35902846218,6,5599,2401,-30
35909021999,35909022004,5,3027,1746,-30
35909664935,35909664929,-6,1397,5536,-30
35914342331,35914342332,1,1884,1959,-30
35915009371,35915009373,2,1851,1518,-30
35915240282,35915240285,3,1346,597,-30
35915423734,35915423714,-20,1416,668,-30
35916432411,35916432415,4,1384,1252,-30
35919340138,35919340143,5,2582,1885,-30
35919650777,35919650782,5,3620,1184,-30
35921908717,35921908722,5,2512,1110,-30
35927363393,35927363398,5,2856,1615,-30
35927475321,35927475326,5,1873,1164,-30
35929649020,35929649025,5,1618,1093,-30
35930053524,35930053530,6,1941,1132,-30
35932225289,35932225293,4,2747,1583,-30
35941564862,35941564868,6,1720,1197,-30
35943587974,35943587978,4,1742,840,-30
35946300689,35946300695,6,821,907,-30
35947709769,35947709774,5,2774,1470,-30
35949830722,35949830727,5,1732,1593,-30
35954214798,35954214801,3,1970,888,-30
35955247842,35955247842,0,1053,1010,-30
35955834650,35955834655,5,2319,1099,-30
35958304344,35958304342,-2,2381,3722,-30
35962224994,35962224999,5,2968,1967,-30
35964480034,35964480038,4,2284,1510,-30
35965175026,35965175032,6,2032,1145,-30
35966200289,35966200289,0,1344,1554,-30
35967018979,35967018985,6,1773,1517,-30
35969504792,35969504795,3,1200,696,-30
35971103862,35971103869,7,2561,1005,-30
35980050328,35980050333,5,2420,1830,-30
35985297170,35985297163,-7,847,5813,-30
35986465778,35986465782,4,2016,1256,-30
35990190134,35990190134,0,1560,1318,-30
35990591728,35990591733,5,2489,1276,-30
35992492020,35992492023,3,1260,1036,-30
35997854058,35997854065,7,2497,974,-30
35998779309,35998779314,5,2247,1556,-30
36001882337,36001882342,5,1837,1454,-30
36002762262,36002762267,5,2929,2202,-30
36005592629,36005592626,-3,2472,5152,-30
36006037013,36006037017,4,2388,1361,-30
36006745871,36006745876,5,2121,1437,-30
36006839590,36006839596,6,2476,1213,-30
36010063258,36010063262,4,1826,937,-30
36011879815,36011879814,-1,1416,935,-30
36012971005,36012971011,6,1389,679,-30
36016905026,36016905032,6,2492,1295,-30
36019969355,36019969361,6,2240,1674,-30
36020033989,36020033993,4,1448,1377,-30
36022368169,36022368173,4,2441,1841,-30
36023565438,36023565445,7,2001,1473,-30
36026991182,36026991186,4,2262,1136,-30
36027577346,36027577349,3,3092,1479,-30
36029600611,36029600617,6,2516,1273,-30
36030684362,36030684365,3,2217,1356,-30
36030837907,36030837891,-16,1316,416,-30
36034073963,36034073967,4,2273,1414,-30
36035851746,36035851742,-4,878,3459,-30
36041374119,36041374124,5,1812,2001,-30
36042956640,36042956643,3,2127,1289,-30
36046789969,36046789974,5,2034,1338,-30
36050318357,36050318362,5,2504,1165,-30
36053359575,36053359574,-1,1414,2150,-30
36053897823,36053897826,3,3049,1957,-30
36054913041,36054913054,13,12662,51128,-30
36056889880,36056889873,-7,1574,6427,-30
36058484738,36058484745,7,3057,1355,-30
36060545869,36060545874,5,1784,1061,-30
36063213224,36063213230,6,2616,1507,-30
36066771127,36066771131,4,1243,958,-30
36072481893,36072481885,-8,1992,1148,-30
36073214238,36073214243,5,3242,1671,-30
36074480758,36074480764,6,2636,1331,-30
36074794789,36074794794,5,2305,1193,-30
36075128914,36075128898,-16,1037,580,-30
36076918415,36076918399,-16,1060,489,-30
36079369369,36079369375,6,1879,1473,-30
36081951701,36081951712,11,2264,1238,-30
36083549316,36083549322,6,2621,1195,-30
36087316818,36087316822,4,2447,1340,-30
36089022079,36089022081,2,1281,671,-30
36094258094,36094258099,5,2733,992,-30
36095841230,36095841234,4,2964,1817,-30
36096878943,36096878946,3,2217,900,-30
36098640859,36098640861,2,2042,1307,-30
36099368276,36099368282,6,5681,2624,-30
36103168548,36103168555,7,4862,2118,-30
36104389942,36104389947,5,2634,1243,-30
36108272940,36108272943,3,2058,1433,-30
36112909769,36112909775,6,2397,1229,-30
36115796281,36115796286,5,2730,1484,-30
36117187140,36117187145,5,1692,1331,-30
36119303333,36119303337,4,1838,991,-30
36119801247,36119801241,-6,25522,17735,-30
36127068963,36127068958,-5,924,1776,-30
36128094408,36128094413,5,2221,1331,-30
36133305778,36133305782,4,2275,1967,-30
36138547169,36138547174,5,2920,2019,-30
36140192402,36140192406,4,2397,1079,-30
36142326679,36142326678,-1,659,1072,-30
36147276974,36147276979,5,1982,1376,-30
36147367297,36147367301,4,1551,1399,-30
36152590776,36152590781,5,1759,976,-30
36155358468,36155358474,6,2462,1559,-30
36155818730,36155818735,5,1495,927,-30
36158055114,36158055117,3,2367,1398,-30
36159369361,36159369354,-7,1529,6451,-30
36160834065,36160834070,5,1649,969,-30
36162722184,36162722202,18,307,617,-30
36167910426,36167910430,4,1739,1264,-30
36168197249,36168197254,5,2240,1163,-30
36170095605,36170095611,6,2413,1166,-30
36170585090,36170585093,3,1714,1159,-30
36174027295,36174027302,7,2757,1449,-30
36176346618,36176346624,6,2988,2163,-30
36180508613,36180508617,4,2923,1683,-30
36182052917,36182052923,6,2174,1041,-30
36184311190,36184311194,4,2857,1326,-30
36187383851,36187383856,5,1604,1208,-30
36187906085,36187906091,6,2581,1809,-30
36196256650,36196256655,5,2068,1276,-30
36196504413,36196504418,5,1140,892,-30
36200900336,36200900339,3,2389,2278,-30
36203066207,36203066212,5,2183,1525,-30
36206200572,36206200558,-14,1444,556,-30
36206856769,36206856774,5,2025,1142,-30
36212041541,36212041545,4,2349,959,-30
36218312982,36218312987,5,2494,1513,-30
36222748572,36222748578,6,2516,1190,-30
36225548406,36225548409,3,2744,1689,-30
36226282203,36226282207,4,2948,1656,-30
36227017773,36227017777,4,2553,1320,-30
36230392446,36230392449,3,2244,1222,-30
36232723674,36232723678,4,3401,2267,-30
36232927509,36232927514,5,2340,1528,-30
36233472155,36233472159,4,2202,897,-30
36233624098,36233624103,5,2010,1378,-30
36234867077,36234867081,4,1964,1606,-30
36238490854,36238490859,5,2864,1032,-30
36240655594,36240655598,4,2400,1389,-30
36241354394,36241354399,5,2540,1106,-30
36241461143,36241461123,-20,1995,1150,-30
36249526618,36249526622,4,1869,1128,-30
36250224616,36250224621,5,2763,1395,-30
36250957046,36250957052,6,2486,1266,-30
36251043090,36251043096,6,1384,1046,-30
36252331356,36252331363,7,1813,1202,-30
36253995754,36253995759,5,2202,1386,-30
36256231700,36256231694,-6,2042,6226,-30
36256911261,36256911263,2,1756,1371,-30
36257073341,36257073345,4,2292,1811,-30
36259773451,36259773457,6,1739,1189,-30
36262096260,36262096263,3,1788,1159,-30
36265523694,36265523699,5,1813,1276,-30
36265923854,36265923859,5,2827,1462,-30
36270233649,36270233654,5,1743,1099,-30
36271684516,36271684522,6,2644,1691,-30
36275142861,36275142866,5,1852,988,-30
36276614597,36276614603,6,3271,2120,-30
36283400861,36283400865,4,1861,1062,-30
36285527678,36285527682,4,2809,1398,-30
36294751357,36294751362,5,1585,1237,-30
36298285829,36298285834,5,1355,1271,-30
36301605611,36301605613,2,1831,844,-30
36302214569,36302214575,6,2812,1000,-30
36309622328,36309622334,6,1912,1287,-30
36311681626,36311681631,5,1802,1646,-30
36312272790,36312272795,5,1370,918,-30
36314251861,36314251866,5,2315,1212,-30
36314796866,36314796873,7,2773,1522,-30
36315354986,36315354989,3,1565,1056,-30
36319808855,36319808860,5,2615,1538,-30
36322793699,36322793699,0,2624,3559,-30
36323474262,36323474265,3,2613,1489,-30
36323853967,36323853973,6,2363,1386,-30
36325016522,36325016526,4,2192,1047,-30
36325070022,36325070026,4,2252,1537,-30
36330403694,36330403698,4,2702,1401,-30
36332831562,36332831565,3,1986,1209,-30
36339566461,36339566462,1,1266,1552,-30
36344936858,36344936865,7,2761,1537,-30
36345070954,36345070958,4,2118,1085,-30
36350334753,36350334759,6,2343,1301,-30
36351657726,36351657731,5,2812,1250,-30
36353657000,36353657005,5,2320,1315,-30
36354017499,36354017505,6,2062,1730,-30
36354470098,36354470101,3,2238,1305,-30
36356425429,36356425435,6,2087,1515,-30
36359519955,36359519961,6,1827,1057,-30
36362529711,36362529729,18,710,2417,-30
36364079894,36364079899,5,2398,1605,-30
36364239462,36364239467,5,2145,1249,-30
36367283639,36367283643,4,23902,24736,-30
36367377746,36367377751,5,2448,1113,-30
36370148890,36370148896,6,2714,1577,-30
36370273976,36370273979,3,1818,840,-30
36382715570,36382715576,6,2045,1116,-30
36385181605,36385181609,4,2088,1418,-30
36386693198,36386693204,6,2463,1293,-30
36389248741,36389248747,6,2959,1519,-30
36393374485,36393374487,2,2470,1604,-30
36399897206,36399897213,7,2797,1244,-30
36407971850,36407971856,6,2821,1423,-30
36408412891,36408412895,4,2767,1715,-30
36413574334,36413574342,8,2048,1065,-30
36414361889,36414361893,4,2253,1311,-30
36424595017,36424595023,6,2083,1328,-30
36425293793,36425293798,5,3188,1483,-30
36432961454,36432961458,4,1681,1550,-30
36438295354,36438295358,4,1849,1129,-30
36442072910,36442072913,3,1745,1520,-30
36442098791,36442098797,6,2606,1291,-30
36442700054,36442700049,-5,2453,6338,-30
36443896249,36443896254,5,2683,1455,-30
36444556284,36444556290,6,2599,1183,-30
36446247823,36446247829,6,3167,1278,-30
36446864668,36446864674,6,2617,1449,-30
36449627218,36449627223,5,2069,1221,-30
36451821350,36451821353,3,1763,1338,-30
36452604938,36452604941,3,1837,1179,-30
36454064323,36454064327,4,1656,1064,-30
36455804638,36455804641,3,1701,1102,-30
36457874950,36457874954,4,1942,831,-30
36457945201,36457945206,5,2181,1126,-30
36460726805,36460726810,5,2806,1248,-30
36462127152,36462127156,4,2190,1435,-30
36462386914,36462386911,-3,1974,3448,-30
36464485550,36464485553,3,2276,1650,-30
36465078822,36465078826,4,1964,1005,-30
36470175581,36470175586,5,1821,1679,-30
36470849423,36470849429,6,2555,871,-30
36471131178,36471131160,-18,1769,939,-30
36476307766,36476307771,5,3061,1391,-30
36478793569,36478793574,5,1900,1495,-30
36481309497,36481309503,6,2289,998,-30
36482111636,36482111632,-4,961,1731,-30
36485391316,36485391320,4,3028,1616,-30
36489013538,36489013545,7,2567,1288,-30
36496257085,36496257089,4,2361,1340,-30
36500021741,36500021746,5,2305,1468,-30
36501558489,36501558494,5,2366,1641,-30
36505275634,36505275638,4,1971,1078,-30
36509222005,36509221999,-6,3242,12284,-30
36511159361,36511159366,5,2161,1348,-30
36511195866,36511195870,4,2761,1295,-30
36513295446,36513295451,5,1839,803,-30
36513349614,36513349620,6,2604,1365,-30
36513934250,36513934236,-14,934,758,-30
36514207741,36514207747,6,3049,1163,-30
36514804839,36514804843,4,1220,825,-30
36529305855,36529305860,5,1887,1516,-30
36530149681,36530149672,-9,543,230,-30
36531142807,36531142811,4,1890,1121,-30
36532729887,36532729891,4,2731,1838,-30
36533381429,36533381433,4,1890,1132,-30
36536713681,36536713687,6,1923,1109,-30
36539738014,36539738019,5,3202,1640,-30
36540005706,36540005707,1,2998,2448,-30
36541301318,36541301322,4,2531,1259,-30
36542563449,36542563453,4,2240,936,-30
36545296350,36545296355,5,2089,1324,-30
36546248659,36546248664,5,1667,837,-30
36550555781,36550555786,5,2237,1424,-30
36550971167,36550971174,7,2430,1451,-30
36551715821,36551715825,4,2921,1606,-30
36552823108,36552823114,6,2374,1478,-30
36555943286,36555943283,-3,818,1313,-30
36557757786,36557757790,4,1991,1496,-30
36557858982,36557858988,6,2915,1730,-30
36559428541,36559428546,5,2276,1017,-30
36560016343,36560016347,4,2236,1186,-30
36560917189,36560917195,6,1952,1125,-30
36563008414,36563008419,5,2084,1229,-30
36563246717,36563246722,5,2180,1236,-30
36567848974,36567848979,5,1732,1404,-30
36569741617,36569741623,6,2253,922,-30
36572153047,36572153054,7,2835,1055,-30
36574113771,36574113777,6,1905,1179,-30
36575977341,36575977346,5,2379,1147,-30
36579172896,36579172901,5,3225,1692,-30
36584101960,36584101966,6,1921,1550,-30
36585460086,36585460090,4,1989,1177,-30
36586554598,36586554606,8,1263,455,-30
36591212118,36591212124,6,1835,895,-30
36603588761,36603588765,4,2471,1190,-30
36603662082,36603662087,5,1907,1721,-30
36604018397,36604018401,4,2680,1240,-30
36604805354,36604805359,5,2889,1507,-30
36614235062,36614235067,5,2467,1451,-30
36614435493,36614435497,4,2228,1758,-30
36615236361,36615236364,3,2293,1539,-30
36615839181,36615839186,5,2774,1858,-30
36619905699,36619905706,7,5179,1001,-30
36622130213,36622130218,5,2471,855,-30
36623657353,36623657358,5,3132,1360,-30
36624544298,36624544305,7,1648,827,-30
36625759908,36625759912,4,2196,1165,-30
36627835014,36627835018,4,2308,1502,-30
36630411750,36630411753,3,107,4593,-30
36630827997,36630828002,5,2914,1951,-30
36633857798,36633857805,7,2180,1379,-30
36638298964,36638298971,7,2119,1306,-30
36638857824,36638857809,-15,600,267,-30
36639673325,36639673330,5,4898,1738,-30
36644750905,36644750909,4,2205,1549,-30
36645043891,36645043875,-16,2518,1637,-30
36645111920,36645111922,2,2203,1511,-30
36647269118,36647269131,13,998,5398,-30
36650765882,36650765886,4,2427,1506,-30
36651484553,36651484559,6,2026,1145,-30
36652162606,36652162611,5,2358,1241,-30
36655426357,36655426361,4,2455,1590,-30
36655502725,36655502730,5,2495,1282,-30
36657900694,36657900698,4,2784,2326,-30
36658935522,36658935527,5,1660,1183,-30
36660275642,36660275646,4,2214,1333,-30
36661159631,36661159635,4,1734,1621,-30
36662089955,36662089957,2,2299,1949,-30
36668504910,36668504914,4,2996,1328,-30
36669465779,36669465784,5,2026,1345,-30
36671144224,36671144228,4,2038,1452,-30
36672431853,36672431861,8,1464,1079,-30
36674735803,36674735807,4,1527,1558,-30
36675074720,36675074726,6,2253,1455,-30
36676071090,36676071096,6,2395,1150,-30
36676353410,36676353416,6,1728,1080,-30
36678573284,36678573288,4,1999,1416,-30
36678763653,36678763633,-20,965,579,-30
36681290749,36681290753,4,1866,1195,-30
36682108757,36682108759,2,5987,16616,-30
36682759465,36682759469,4,2289,1129,-30
36686790618,36686790622,4,2268,1425,-30
36689845610,36689845614,4,2472,1568,-30
36696850688,36696850692,4,1829,1069,-30
36697100944,36697100950,6,1864,1141,-30
36698547358,36698547362,4,2017,1763,-30
36699421349,36699421355,6,1525,950,-30
36700795955,36700795959,4,2011,1411,-30
36704875010,36704875014,4,3181,1550,-30
36704945498,36704945504,6,2715,1897,-30
36705544320,36705544326,6,1864,968,-30
36710645602,36710645608,6,2440,1287,-30
36710753008,36710753013,5,1709,1186,-30
36710962222,36710962227,5,2233,1321,-30
36711566824,36711566829,5,1931,1415,-30
36713953869,36713953874,5,1993,1518,-30
36716659747,36716659753,6,2474,1403,-30
36719705629,36719705635,6,2302,1211,-30
36724780522,36724780526,4,1943,1092,-30
36726238793,36726238799,6,1878,1078,-30
36726693182,36726693187,5,2707,1914,-30
36731310288,36731310284,-4,738,1917,-30
36731542201,36731542206,5,2261,1045,-30
36733246066,36733246062,-4,719,1632,-30
36733615101,36733615105,4,2436,1506,-30
36734045358,36734045359,1,1630,1361,-30
36734852823,36734852830,7,2266,1618,-30
36735302141,36735302146,5,2384,1814,-30
36741413464,36741413469,5,2091,1060,-30
36742430966,36742430971,5,2407,1406,-30
36742749630,36742749619,-11,831,656,-30
36743727773,36743727777,4,2003,1199,-30
36744735591,36744735599,8,3234,1390,-30
36747616009,36747615999,-10,13051,28960,-30
36752241233,36752241246,13,12263,48258,-30
36757331529,36757331534,5,1316,1085,-30
36759332821,36759332826,5,2815,1648,-30
36759940251,36759940257,6,2484,1875,-30
36760747735,36760747740,5,2148,1152,-30
36760895064,36760895075,11,2184,1320,-30
36763628256,36763628262,6,2241,1549,-30
36764383321,36764383325,4,1885,1056,-30
36772406770,36772406776,6,1966,888,-30
36773003533,36773003538,5,2159,1587,-30
36774347520,36774347526,6,2134,1105,-30
36776184535,36776184542,7,1603,1028,-30
36778937331,36778937337,6,1899,911,-30
36781446080,36781446087,7,2463,1905,-30
36785395398,36785395404,6,2756,1883,-30
36799467426,36799467430,4,2155,1410,-30
36800879918,36800879923,5,2776,1256,-30
36802600247,36802600250,3,1857,1176,-30
36802802411,36802802419,8,1944,1475,-30
36803633445,36803633446,1,1719,1761,-30
36804745574,36804745577,3,1163,796,-30
36806442906,36806442912,6,2356,1517,-30
36806888781,36806888762,-19,1758,1083,-30
36808268296,36808268301,5,1837,1434,-30
36814078517,36814078522,5,2167,1229,-30
36815043073,36815043060,-13,1418,944,-30
36815428168,36815428170,2,1972,1500,-30
36815781088,36815781088,0,1196,1603,-30
36818241007,36818240987,-20,1870,1042,-30
36823257026,36823257022,-4,1250,4584,-30
36830660977,36830660982,5,3014,1420,-30
36834308683,36834308689,6,2053,1338,-30
36838379098,36838379102,4,1952,1181,-30
36849971257,36849971263,6,1717,689,-30
36851910306,36851910310,4,1898,1289,-30
36854258597,36854258603,6,1782,1113,-30
36854780026,36854780031,5,2778,1351,-30
36855536931,36855536929,-2,1374,3698,-30
36855879235,36855879240,5,1145,1286,-30
36858398793,36858398792,-1,983,1426,-30
36859682820,36859682825,5,2593,1484,-30
36862138027,36862138027,0,704,1466,-30
36864633323,36864633328,5,1591,1251,-30
36866408399,36866408406,7,1669,1323,-30
36867186417,36867186424,7,2190,1952,-30
36869529745,36869529750,5,2051,1093,-30
36876715794,36876715798,4,2461,1357,-30
36879108157,36879108161,4,2665,1373,-30
36880505413,36880505419,6,1981,1346,-30
36880893629,36880893633,4,2307,1196,-30
36882600361,36882600362,1,1619,1384,-30
36883144367,36883144371,4,2170,1149,-30
36890692013,36890692019,6,2022,1054,-30
36896253210,36896253215,5,2503,1287,-30
36897444365,36897444364,-1,800,2901,-30
36899204052,36899204059,7,2641,1374,-30
36899522410,36899522416,6,943,264,-30
36901528267,36901528269,2,2454,1587,-30
36903487238,36903487242,4,1608,1072,-30
36905142285,36905142291,6,2810,1577,-30
36905654314,36905654319,5,2953,1463,-30
36908079598,36908079602,4,4918,3283,-30
36909225186,36909225191,5,2299,897,-30
36909672509,36909672515,6,2121,992,-30
36909767654,36909767661,7,8525,3875,-30
36913604230,36913604234,4,2393,1460,-30
36916710373,36916710381,8,1933,1382,-30
36917363332,36917363335,3,1624,603,-30
36917991243,36917991246,3,2824,3187,-30
36921398618,36921398623,5,2796,1624,-30
36921531007,36921531012,5,2589,1474,-30
36922284882,36922284886,4,1834,1093,-30
36923802701,36923802696,-5,1166,3960,-30
36925503632,36925503638,6,1639,1098,-30
36929160708,36929160713,5,2232,1489,-30
36934548789,36934548796,7,1529,1047,-30
36935009398,36935009380,-18,930,340,-30
36936203110,36936203114,4,2615,1338,-30
36936953686,36936953690,4,1936,931,-30
36938340308,36938340313,5,2321,1014,-30
36939159410,36939159414,4,1699,1184,-30
36948560428,36948560432,4,2218,1692,-30
36948930574,36948930578,4,2511,892,-30
36948978286,36948978268,-18,1887,1190,-30
36951105281,36951105287,6,2822,1346,-30
36953733157,36953733164,7,1963,1731,-30
36956517777,36956517781,4,2132,1569,-30
36959496946,36959496950,4,3061,2453,-30
36960638099,36960638105,6,2152,1165,-30
36969049870,36969049873,3,2011,1377,-30
36969560601,36969560601,0,1581,3439,-30
36971242291,36971242297,6,57627,30270,-30
36971343862,36971343866,4,3145,1340,-30
36977098133,36977098139,6,2297,1125,-30
36979235937,36979235942,5,2727,1050,-30
36980045494,36980045498,4,2467,1164,-30
36985359522,36985359526,4,2100,1184,-30
36985777221,36985777225,4,2176,1144,-30
36987894224,36987894227,3,3047,2183,-30
36989419457,36989419463,6,2892,1406,-30
36990045614,36990045620,6,2312,1236,-30
36991122107,36991122110,3,1606,1440,-30
36995345154,36995345158,4,3016,1671,-30
36995576496,36995576503,7,2079,1030,-30
37000538283,37000538293,10,1855,1280,-30
37008220563,37008220567,4,2258,972,-30
37009445959,37009445963,4,1321,1145,-30
37010617725,37010617730,5,2411,1128,-30
37010658479,37010658460,-19,2960,1714,-30
37011770813,37011770818,5,3205,1528,-30
37013728458,37013728461,3,2097,1307,-30
37013865534,37013865542,8,2165,1580,-30
37016962918,37016962922,4,1910,1272,-30
37018646584,37018646590,6,2112,1153,-30
37019458253,37019458258,5,2203,975,-30
37021746893,37021746898,5,1056,619,-30
37025297178,37025297182,4,2131,1299,-30
37027514213,37027514235,22,2930,1020,-30
37028295025,37028295032,7,2918,1434,-30
37032937061,37032937065,4,2271,1166,-30
37032990865,37032990870,5,2033,1404,-30
37034859855,37034859859,4,1779,929,-30
37034992216,37034992223,7,3077,1269,-30
37035257131,37035257137,6,1917,950,-30
37038358113,37038358119,6,2145,1145,-30
37038670680,37038670685,5,2005,1244,-30
37044819615,37044819618,3,2189,965,-30
37048186909,37048186915,6,2564,1361,-30
37051169577,37051169583,6,2462,1662,-30
37052788117,37052788111,-6,1584,8050,-30
37056402556,37056402552,-4,893,2372,-30
37056590496,37056590500,4,1639,874,-30
37057042789,37057042779,-10,959,476,-30
37057549954,37057549960,6,2757,2235,-30
37059765837,37059765842,5,4055,2195,-30
37061782796,37061782798,2,1902,1270,-30
37063550650,37063550649,-1,2620,2912,-30
37071099964,37071099968,4,2340,1436,-30
37071404380,37071404360,-20,2293,1564,-30
37073321558,37073321562,4,2165,1165,-30
37074355326,37074355329,3,1495,1011,-30
37075304396,37075304404,8,2052,1590,-30
37076223136,37076223119,-17,2210,881,-30
37078971298,37078971306,8,1364,1121,-30
37080428895,37080428900,5,3038,1581,-30
37081793090,37081793095,5,2769,1057,-30
37083672124,37083672129,5,3058,1285,-30
37087634861,37087634866,5,2001,1596,-30
37091291145,37091291150,5,2170,1194,-30
37091363429,37091363409,-20,820,595,-30
37091499110,37091499115,5,2101,1153,-30
37096882753,37096882758,5,3262,1102,-30
37100279556,37100279561,5,2261,1300,-30
37100418180,37100418182,2,1420,943,-30
37100615661,37100615656,-5,54575,31362,-30
37101772982,37101772989,7,2650,1012,-30
37105376408,37105376410,2,1523,1428,-30
37108783961,37108783966,5,1908,1087,-30
37110552155,37110552162,7,2263,1268,-30
37112824454,37112824455,1,1261,1786,-30
37117215033,37117215038,5,2466,1376,-30
37120448754,37120448761,7,1355,917,-30
37122295002,37122295007,5,2550,1944,-30
37123921830,37123921835,5,2170,1002,-30
37124439534,37124439537,3,2353,1392,-30
37125316081,37125316086,5,2484,946,-30
37129465460,37129465465,5,2739,1311,-30
37129941406,37129941407,1,1738,1794,-30
37135813742,37135813747,5,1791,1091,-30
37139318930,37139318933,3,2074,1576,-30
37139895953,37139895958,5,2101,1594,-30
37140427866,37140427871,5,1957,983,-30
37141032085,37141032064,-21,2239,1279,-30
37145491744,37145491749,5,2067,1301,-30
37146224414,37146224419,5,2137,742,-30
37146460607,37146460614,7,2134,1617,-30
37148051297,37148051300,3,1374,751,-30
37153166050,37153166053,3,1020,1083,-30
37154290186,37154290191,5,2598,1131,-30
37155669820,37155669820,0,1207,1519,-30
37158264570,37158264574,4,1305,765,-30
37163464385,37163464391,6,2477,1270,-30
37167029073,37167029077,4,2089,1446,-30
37167924192,37167924203,11,1236,751,-30
37168673397,37168673403,6,3325,1500,-30
37168907468,37168907472,4,2631,1481,-30
37170694511,37170694518,7,726,612,-30
37171477494,37171477501,7,1747,935,-30
37171556091,37171556097,6,497,271,-30
37171876955,37171876959,4,5072,3244,-30
37173313266,37173313270,4,2251,1283,-30
37173349158,37173349162,4,1126,1125,-30
37176004983,37176004989,6,2611,1345,-30
37177728550,37177728555,5,2497,1180,-30
37178692751,37178692755,4,2196,1447,-30
37182369541,37182369542,1,32507,26686,-30
37182761101,37182761105,4,1483,935,-30
37183969153,37183969158,5,2878,1405,-30
37184015753,37184015757,4,2558,1224,-30
37184472027,37184472029,2,1584,1034,-30
37196354138,37196354132,-6,25829,19623,-30
37198997841,37198997846,5,2678,1040,-30
37201458346,37201458347,1,3133,3775,-30
37203464826,37203464831,5,2303,1480,-30
37205856220,37205856226,6,3137,1427,-30
37206391114,37206391121,7,1285,992,-30
37209381886,37209381896,10,3006,1383,-30
37211696601,37211696606,5,1955,1232,-30
37215375343,37215375341,-2,1030,2414,-30
37222017365,37222017359,-6,1680,1776,-30
37223219218,37223219225,7,1735,1288,-30
37224065418,37224065422,4,1799,1178,-30
37224879186,37224879194,8,2100,1119,-30
37225032906,37225032912,6,1624,1029,-30
37229933165,37229933170,5,2076,1076,-30
37231105902,37231105907,5,2692,1500,-30
37231681523,37231681528,5,2361,1609,-30
37232065075,37232065069,-6,715,1896,-30
37232511642,37232511662,20,296,2422,-30
37232705042,37232705047,5,1454,1008,-30
37232974491,37232974484,-7,2490,8540,-30
37235677978,37235677980,2,1462,1653,-30
37238994305,37238994307,2,2333,1265,-30
37239654834,37239654839,5,2467,1640,-30
37242339853,37242339857,4,2186,1568,-30
37248641118,37248641122,4,3077,1815,-30
37251105896,37251105900,4,1801,1602,-30
37251284859,37251284867,8,2413,1471,-30
37251748967,37251748955,-12,604,402,-30
37260788503,37260788509,6,2477,1469,-30
37261274486,37261274480,-6,2022,6212,-30
37263925614,37263925619,5,3169,2932,-30
37264031030,37264031038,8,2409,1221,-30
37264749599,37264749603,4,2255,1585,-30
37265433641,37265433636,-5,1161,2479,-30
37266401687,37266401693,6,3953,2398,-30
37272169466,37272169470,4,2588,1601,-30
37272673946,37272673953,7,1743,1467,-30
37273565456,37273565461,5,1769,1329,-30
37278647151,37278647157,6,1725,1201,-30
37281121837,37281121842,5,1363,869,-30
37283717637,37283717641,4,1681,1166,-30
37287380337,37287380340,3,1565,1410,-30
37287406101,37287406106,5,1995,1008,-30
37289086054,37289086060,6,3051,1421,-30
37290664006,37290664008,2,1867,1887,-30
37292141283,37292141287,4,2966,1349,-30
37292914792,37292914798,6,2479,1710,-30
37293635906,37293635910,4,1922,1408,-30
37293951112,37293951118,6,1951,1100,-30
37294116218,37294116210,-8,865,348,-30
37295977880,37295977885,5,2860,1440,-30
37296005513,37296005522,9,2646,648,-30
37296495112,37296495118,6,1761,1027,-30
37297421417,37297421422,5,2379,1074,-30
37304140823,37304140826,3,1174,1191,-30
37305592904,37305592910,6,3035,1353,-30
37305816845,37305816849,4,1762,1314,-30
37309565259,37309565255,-4,1734,5642,-30
37313260926,37313260931,5,1668,1237,-30
37313563214,37313563221,7,3018,1618,-30
37313946319,37313946329,10,1143,700,-30
37318052289,37318052291,2,1514,926,-30
37318423734,37318423741,7,1689,1195,-30
37318461578,37318461584,6,2854,1262,-30
37319585658,37319585663,5,1873,925,-30
37320171962,37320171969,7,2864,1267,-30
37324485106,37324485111,5,2608,1254,-30
37325538732,37325538733,1,1539,2036,-30
37326231922,37326231926,4,3507,1613,-30
37328410119,37328410123,4,2246,1205,-30
37328539378,37328539361,-17,2003,1061,-30
37329085491,37329085497,6,2354,1482,-30
37329418710,37329418691,-19,2392,1385,-30
37331153236,37331153241,5,2742,1898,-30
37340941029,37340941033,4,2450,1099,-30
37343032790,37343032794,4,2920,1702,-30
37343607906,37343607910,4,2300,914,-30
37345768531,37345768536,5,3954,2895,-30
37347733461,37347733466,5,2850,1113,-30
37348278906,37348278912,6,2612,1450,-30
37349900494,37349900489,-5,1985,5041,-30
37350293334,37350293339,5,2680,1425,-30
37351328106,37351328112,6,2934,1414,-30
37352767295,37352767299,4,3324,1324,-30
37355306866,37355306870,4,2431,1094,-30
37355355388,37355355370,-18,1720,1162,-30
37359356849,37359356854,5,1979,1444,-30
37359619317,37359619321,4,2251,1250,-30
37360213443,37360213449,6,1939,1077,-30
37360273710,37360273713,3,1368,1416,-30
37361099733,37361099738,5,1759,1080,-30
37365235887,37365235895,8,2051,1013,-30
37367184213,37367184218,5,1719,1151,-30
37368648171,37368648176,5,1443,1612,-30
37369508103,37369508121,18,1381,712,-30
37371326692,37371326676,-16,1725,1024,-30
37371840836,37371840840,4,3308,1906,-30
37374491046,37374491051,5,2054,1303,-30
37375194361,37375194362,1,3040,2928,-30
37375387313,37375387317,4,1820,1508,-30
37375892719,37375892723,4,1449,678,-30
37376596142,37376596149,7,4109,1198,-30
37377271858,37377271867,9,2055,1350,-30
37380069027,37380069032,5,3898,1697,-30
37380755896,37380755900,4,34207,23991,-30
37382670306,37382670311,5,2670,1698,-30
37384112362,37384112367,5,2531,1262,-30
37393363338,37393363343,5,2549,1487,-30
37397096626,37397096631,5,2309,1156,-30
37404818270,37404818274,4,1681,1112,-30
37406626690,37406626690,0,1735,2449,-30
37406714231,37406714235,4,2088,1181,-30
37409428151,37409428156,5,3463,1743,-30
37412885350,37412885355,5,2698,1632,-30
37413697384,37413697389,5,2252,1417,-30
37416774801,37416774806,5,2102,1367,-30
37417682131,37417682135,4,2445,959,-30
37420410083,37420410089,6,1738,1222,-30
37420669163,37420669169,6,1877,1420,-30
37421729445,37421729451,6,2671,1247,-30
37426959253,37426959257,4,1823,1176,-30
37430292807,37430292813,6,2925,1650,-30
37433846646,37433846653,7,3211,1512,-30
37436874642,37436874646,4,3250,1540,-30
37437438943,37437438950,7,2754,1386,-30
37439362646,37439362652,6,2253,1691,-30
37442472790,37442472795,5,2072,1082,-30
37443610522,37443610527,5,1941,1290,-30
37444520361,37444520368,7,2292,1277,-30
37448200790,37448200786,-4,1147,2047,-30
37458617579,37458617585,6,2499,1568,-30
37459989498,37459989505,7,2851,1477,-30
37460528094,37460528101,7,2631,1270,-30
37461384453,37461384458,5,2978,1246,-30
37461555469,37461555470,1,891,1719,-30
37464814179,37464814185,6,3592,1796,-30
37466207390,37466207395,5,2796,1361,-30
37471677586,37471677591,5,1351,949,-30
37473511858,37473511864,6,1667,906,-30
37475254214,37475254219,5,1959,1163,-30
37476932993,37476932997,4,3109,1623,-30
37477892478,37477892483,5,2949,1737,-30
37480114942,37480114948,6,1948,1201,-30
37481137055,37481137058,3,1465,1403,-30
37490749393,37490749398,5,1345,1353,-30
37491475709,37491475715,6,1416,678,-30
37495881898,37495881901,3,3298,2397,-30
37495961455,37495961449,-6,893,5470,-30
37496901266,37496901270,4,1591,1860,-30
37498633310,37498633316,6,3035,973,-30
37499814859,37499814866,7,2605,1477,-30
37499879050,37499879054,4,2792,1165,-30
37500088902,37500088906,4,1721,1240,-30
37505898745,37505898750,5,1456,1023,-30
37507467654,37507467661,7,3244,1220,-30
37521962549,37521962555,6,3099,1691,-30
37524108262,37524108267,5,1911,1814,-30
37524725599,37524725606,7,3728,1582,-30
37524771732,37524771755,23,2553,1667,-30
37527896330,37527896311,-19,1680,31652,-30
37537089611,37537089615,4,2185,1215,-30
37537690090,37537690094,4,1601,1219,-30
37541677571,37541677574,3,6428,5334,-30
37546360919,37546360923,4,3183,1303,-30
37550683357,37550683362,5,1373,1033,-30
37551715885,37551715891,6,1902,1499,-30
37553553481,37553553487,6,1959,1495,-30
37555773794,37555773798,4,2522,1505,-30
37561606242,37561606245,3,1711,1164,-30
37563333445,37563333449,4,2158,934,-30
37565022704,37565022699,-5,1312,1217,-30
37565889247,37565889254,7,2900,1405,-30
37566196042,37566196046,4,2110,1446,-30
37570911212,37570911215,3,2871,1533,-30
37572283070,37572283075,5,1504,748,-30
37582343364,37582343369,5,4135,2518,-30
37585194645,37585194649,4,2282,1314,-30
37586494246,37586494251,5,2170,1386,-30
37591512251,37591512254,3,1594,1123,-30
37592020314,37592020319,5,2578,1472,-30
37592047874,37592047891,17,1880,1570,-30
37595423210,37595423214,4,2300,1538,-30
37595855073,37595855076,3,2275,1457,-30
37596762765,37596762770,5,1978,1471,-30
37596868589,37596868589,0,1041,1569,-30
37597225941,37597225945,4,1861,1170,-30
37597763097,37597763103,6,3361,1217,-30
37602448851,37602448856,5,3034,1451,-30
37603148046,37603148050,4,2493,1438,-30
37603777408,37603777415,7,3281,947,-30
37604011105,37604011109,4,1393,609,-30
37608514681,37608514687,6,1591,1485,-30
37608688715,37608688720,5,3182,676,-30
37610363248,37610363250,2,1725,1342,-30
37611894033,37611894037,4,1456,979,-30
37613205713,37613205718,5,1499,1143,-30
37613496683,37613496665,-18,2325,1432,-30
37613560785,37613560787,2,2573,1681,-30
37613630033,37613630035,2,2818,1348,-30
37615913456,37615913462,6,4092,2825,-30
37620929138,37620929142,4,2527,1596,-30
37622545510,37622545517,7,2281,1453,-30
37624198447,37624198449,2,4454,3299,-30
37625228259,37625228269,10,2532,1433,-30
37626454250,37626454255,5,1543,1344,-30
37626889645,37626889646,1,1575,1112,-30
37627543898,37627543905,7,2845,1272,-30
37631749004,37631749008,4,2280,1524,-30
37633731430,37633731435,5,2282,1108,-30
37639172963,37639172969,6,1996,1041,-30
37640069297,37640069302,5,2814,1308,-30
37643116898,37643116904,6,1724,1148,-30
37648338101,37648338107,6,3284,1501,-30
37652293507,37652293510,3,2370,1540,-30
37652774269,37652774251,-18,1099,834,-30
37653298318,37653298324,6,3614,1348,-30
37659947643,37659947647,4,2151,1335,-30
37662133140,37662133145,5,2334,1532,-30
37662947376,37662947382,6,2311,1474,-30
37667746115,37667746119,4,1229,589,-30
37668331019,37668331019,0,1763,1750,-30
37668524515,37668524518,3,2412,1414,-30
37676085833,37676085838,5,2211,1676,-30
37679909958,37679909962,4,1030,964,-30
37683528585,37683528589,4,2109,1813,-30
37685084332,37685084337,5,1676,1050,-30
37685935487,37685935490,3,2353,2048,-30
37686280420,37686280427,7,2204,1110,-30
37689053414,37689053421,7,2582,1670,-30
37690877707,37690877711,4,1315,772,-30
37691605840,37691605842,2,2878,1276,-30
37694042443,37694042446,3,2044,1235,-30
37695024794,37695024798,4,1911,1535,-30
37696135013,37696135019,6,1892,893,-30
37697707082,37697707088,6,2689,1768,-30
37699107406,37699107413,7,3089,1504,-30
37700353325,37700353330,5,2225,1352,-30
37703858802,37703858808,6,3052,1569,-30
37704119461,37704119445,-16,1256,1705,-30
37704654241,37704654249,8,19123,19651,-30
37705958401,37705958405,4,2458,1362,-30
37707084936,37707084941,5,2462,1191,-30
37707415598,37707415585,-13,1280,492,-30
37708217501,37708217507,6,6803,2510,-30
37713024989,37713024994,5,2794,1466,-30
37715749245,37715749249,4,3078,1432,-30
37716455203,37716455196,-7,1105,3621,-30
37716593231,37716593233,2,2063,2105,-30
37718080250,37718080253,3,2403,1484,-30
37721652804,37721652802,-2,3250,4105,-30
37724788946,37724788951,5,2465,1537,-30
37729750302,37729750307,5,1882,1135,-30
37731026965,37731026966,1,666,1249,-30
37732630041,37732630046,5,1564,1119,-30
37733129891,37733129897,6,2611,1248,-30
37733241325,37733241327,2,1321,1792,-30
37734305338,37734305345,7,7385,2473,-30
37737826487,37737826494,7,1665,1154,-30
37738471264,37738471269,5,2648,1255,-30
37741142533,37741142529,-4,1375,4807,-30
37742277180,37742277183,3,1855,1419,-30
37742490052,37742490058,6,2774,1517,-30
37746502835,37746502842,7,1241,618,-30
37747057946,37747057951,5,2580,1515,-30
37748943774,37748943778,4,2489,1252,-30
37749055918,37749055922,4,1409,918,-30
37754755750,37754755754,4,3271,1438,-30
37756171731,37756171738,7,2453,1669,-30
37757524501,37757524506,5,2386,1155,-30
37758457022,37758457022,0,1135,1578,-30
37759467595,37759467600,5,2262,1279,-30
37760424049,37760424051,2,1288,1037,-30
37760878655,37760878635,-20,1565,764,-30
37761671934,37761671938,4,2866,1049,-30
37766291067,37766291071,4,2658,1423,-30
37769479299,37769479302,3,1258,1435,-30
37777062562,37777062565,3,1631,1284,-30
37777227747,37777227754,7,2328,1418,-30
37777323690,37777323691,1,2111,2033,-30
37778847081,37778847086,5,1943,1135,-30
37780162471,37780162469,-2,172,1455,-30
37782492786,37782492781,-5,1326,4185,-30
37784289953,37784289951,-2,2230,3454,-30
37784396371,37784396375,4,2145,1537,-30
37784632998,37784632984,-14,690,54,-30
37784761678,37784761658,-20,1151,578,-30
37785791321,37785791326,5,2264,1290,-30
37787547720,37787547725,5,2358,1550,-30
37787973105,37787973120,15,1956,973,-30
37791546146,37791546142,-4,1303,1180,-30
37791876789,37791876768,-21,2216,1235,-30
37805612670,37805612675,5,1849,1248,-30
37806377918,37806377922,4,2602,1219,-30
37809183257,37809183262,5,2001,1193,-30
37810489094,37810489090,-4,962,1576,-30
37812047073,37812047078,5,3037,1260,-30
37813574044,37813574038,-6,1717,1304,-30
37813932077,37813932081,4,1711,1390,-30
37814258223,37814258226,3,882,975,-30
37816019262,37816019267,5,1471,1585,-30
37819594179,37819594184,5,1687,1577,-30
37822216159,37822216163,4,2011,1273,-30
37823975631,37823975634,3,1915,1265,-30
37824174897,37824174903,6,2439,1491,-30
37825229015,37825229022,7,2730,1311,-30
37827507178,37827507185,7,2494,1268,-30
37829610425,37829610430,5,1874,1247,-30
37831176937,37831176941,4,2751,1507,-30
37832572881,37832572895,14,724,2989,-30
37834293419,37834293424,5,1254,1380,-30
37841503486,37841503495,9,2259,1295,-30
37841594654,37841594658,4,2127,1333,-30
37843389286,37843389291,5,1787,1257,-30
37845190870,37845190876,6,2608,1293,-30
37848936266,37848936271,5,2918,1384,-30
37851563254,37851563234,-20,2307,1067,-30
37857419077,37857419057,-20,1219,899,-30
37858719349,37858719355,6,681,469,-30
37860320395,37860320401,6,2446,1774,-30
37862111283,37862111286,3,2423,1347,-30
37862676664,37862676667,3,1988,1039,-30
37863848433,37863848438,5,2740,1367,-30
37865037869,37865037873,4,1268,1151,-30
37865078845,37865078846,1,1112,2130,-30
37866278151,37866278155,4,1442,1558,-30
37866385137,37866385141,4,2873,1721,-30
37866975054,37866975061,7,2413,1235,-30
37869306681,37869306686,5,2041,1506,-30
37869479821,37869479825,4,2548,1183,-30
37872067262,37872067266,4,2450,1602,-30
37874352825,37874352830,5,2218,1265,-30
37874395536,37874395540,4,1888,1293,-30
37875125139,37875125144,5,2115,1175,-30
37875363787,37875363793,6,2393,1146,-30
37875391673,37875391660,-13,1437,769,-30
37878175919,37878175920,1,7732,8347,-30
37879663162,37879663177,15,552,321,-30
37880631870,37880631875,5,2649,1319,-30
37881730054,37881730059,5,2628,1493,-30
37882300854,37882300847,-7,2253,11020,-30
37884537793,37884537795,2,1402,1491,-30
37886085093,37886085100,7,2765,1712,-30
37889522102,37889522104,2,1211,1205,-30
37890007361,37890007369,8,2639,1447,-30
37891035013,37891035020,7,2773,1253,-30
37894671122,37894671127,5,1306,982,-30
37894750275,37894750280,5,2968,1507,-30
37895791877,37895791882,5,1595,877,-30
37896187337,37896187341,4,2046,1325,-30
37899705076,37899705082,6,1512,1005,-30
37900668700,37900668705,5,2477,1339,-30
37901609755,37901609756,1,1396,1691,-30
37904646760,37904646765,5,2272,1259,-30
37905174658,37905174661,3,2439,1086,-30
37910537939,37910537948,9,12485,35832,-30
37915137763,37915137767,4,2445,1711,-30
37915681334,37915681323,-11,1355,797,-30
37915764905,37915764903,-2,1874,2429,-30
37918148734,37918148740,6,1034,837,-30
37922563844,37922563848,4,1500,1202,-30
37923030819,37923030818,-1,1298,2034,-30
37923120443,37923120447,4,1696,1540,-30
37923935312,37923935315,3,1715,1245,-30
37931584521,37931584525,4,2297,1431,-30
37931943314,37931943299,-15,909,237,-30
37936161575,37936161571,-4,1296,4595,-30
37941026278,37941026281,3,1624,1196,-30
37942902723,37942902726,3,1020,1816,-30
37943742369,37943742374,5,2029,944,-30
37946069326,37946069331,5,2391,1408,-30
37947102830,37947102834,4,1863,1563,-30
37948118123,37948118125,2,1097,1295,-30
37951012337,37951012341,4,1785,1556,-30
37952067166,37952067172,6,1685,862,-30
37953353270,37953353274,4,2607,1709,-30
37953779459,37953779463,4,1272,777,-30
37955068613,37955068619,6,2243,1663,-30
37961558570,37961558574,4,2873,1345,-30
37961768122,37961768126,4,2139,1476,-30
37961929106,37961929090,-16,1165,45,-30
37962644935,37962644938,3,1562,437,-30
37962955969,37962955954,-15,3092,1692,-30
37964345074,37964345081,7,3224,1159,-30
37965933585,37965933590,5,2442,1488,-30
37967771386,37967771388,2,1504,1280,-30
37976078390,37976078395,5,2204,1292,-30
37976901194,37976901199,5,2592,1277,-30
37978056937,37978056942,5,1507,1556,-30
37978587181,37978587187,6,2985,1175,-30
37978683706,37978683689,-17,2833,1307,-30
37980531724,37980531729,5,2321,1056,-30
37985315068,37985315073,5,2483,1656,-30
37985422151,37985422137,-14,1377,679,-30
37988390026,37988390031,5,2446,1762,-30
37988927671,37988927677,6,2175,1314,-30
37991306791,37991306794,3,2213,1199,-30
37992709054,37992709058,4,2270,1390,-30
37993441409,37993441414,5,2177,1366,-30
37995644599,37995644603,4,2405,1283,-30
37998903110,37998903116,6,3003,1404,-30
38001403543,38001403547,4,2093,1434,-30
38010561524,38010561529,5,2385,1488,-30
38016392957,38016392962,5,3012,1517,-30
38019358857,38019358861,4,2636,1417,-30
38022990643,38022990646,3,2069,1302,-30
38025960955,38025960959,4,3923,3613,-30
38028694160,38028694162,2,1534,1692,-30
38030152739,38030152738,-1,1284,2205,-30
38030686457,38030686462,5,3068,1666,-30
38031765829,38031765835,6,2060,1166,-30
38032383510,38032383522,12,682,290,-30
38034722248,38034722252,4,2464,1663,-30
38039391170,38039391174,4,2081,1504,-30
38040556072,38040556078,6,2358,1095,-30
38045277017,38045277021,4,1470,1614,-30
38046341180,38046341185,5,1979,1179,-30
38051512498,38051512504,6,14507,19309,-30
38054114963,38054114967,4,1319,1110,-30
38056129574,38056129579,5,2656,1641,-30
38058373456,38058373463,7,2378,1395,-30
38058719738,38058719754,16,1942,910,-30
38059306710,38059306715,5,1546,1188,-30
38060738613,38060738617,4,2570,1093,-30
38061124647,38061124650,3,2125,1357,-30
38067726242,38067726247,5,1393,906,-30
38068724926,38068724932,6,1155,1135,-30
38072846970,38072846975,5,1488,1101,-30
38074410032,38074410055,23,589,1304,-30
38076642743,38076642727,-16,277,1528,-30
38079554019,38079554024,5,2081,1078,-30
38079684461,38079684465,4,2433,1425,-30
38080170846,38080170825,-21,2949,1597,-30
38080924942,38080924949,7,2137,567,-30
38081553829,38081553825,-4,168,2388,-30
38083131885,38083131890,5,2805,1720,-30
38083487853,38083487859,6,2354,1433,-30
38085236962,38085236967,5,1659,972,-30
38085314156,38085314162,6,2735,1699,-30
38085588501,38085588507,6,1096,786,-30
38089156939,38089156944,5,2907,2137,-30
38090376201,38090376207,6,2702,1812,-30
38091039844,38091039824,-20,2329,1235,-30
38092121659,38092121666,7,3531,1790,-30
38097220159,38097220163,4,1777,1134,-30
38097455971,38097455961,-10,942,357,-30
38098521239,38098521245,6,2506,1735,-30
38099043831,38099043835,4,1310,1007,-30
38100271315,38100271316,1,2240,2823,-30
38103855993,38103855990,-3,2824,4633,-30
38105419443,38105419450,7,2230,977,-30
38106944697,38106944703,6,2431,1676,-30
38107693297,38107693302,5,1955,1358,-30
38112753630,38112753625,-5,1114,6451,-30
38113569539,38113569545,6,2024,1322,-30
38114723655,38114723659,4,1143,647,-30
38119311503,38119311501,-2,1718,2481,-30
38119674475,38119674480,5,2133,1163,-30
38124471763,38124471757,-6,1320,4033,-30
38126324714,38126324718,4,2522,1453,-30
38127752950,38127752953,3,1640,1685,-30
38133634043,38133634047,4,2015,1380,-30
38135385030,38135385035,5,3265,1564,-30
38137000493,38137000499,6,2829,1741,-30
38140301449,38140301451,2,2511,2097,-30
38146281502,38146281507,5,2834,1037,-30
38147353282,38147353289,7,2690,1213,-30
38150553280,38150553286,6,2900,1743,-30
38154945050,38154945054,4,2519,1390,-30
38155666251,38155666257,6,2521,1846,-30
38155982550,38155982555,5,1913,1285,-30
38161546108,38161546111,3,2021,1229,-30
38167257649,38167257653,4,2401,1295,-30
38167369698,38167369705,7,1776,1491,-30
38170684848,38170684853,5,1817,1067,-30
38174408622,38174408626,4,2566,1394,-30
38175837115,38175837122,7,3140,951,-30
38178830461,38178830466,5,3558,2017,-30
38180329822,38180329831,9,1202,839,-30
38180446410,38180446396,-14,1580,1004,-30
38183778042,38183778049,7,4445,2134,-30
38183967254,38183967257,3,1863,1145,-30
38186022335,38186022334,-1,1429,2075,-30
38186992229,38186992221,-8,1056,12615,-30
38188555026,38188555030,4,2939,1547,-30
38190755338,38190755343,5,1518,1017,-30
38193960242,38193960246,4,3046,1624,-30
38195037771,38195037774,3,1770,1092,-30
38201583033,38201583037,4,1949,1225,-30
38201929476,38201929480,4,2078,1455,-30
38203022234,38203022238,4,2976,1423,-30
38205050033,38205050041,8,2463,1155,-30
38207601093,38207601099,6,2591,1339,-30
38208829490,38208829495,5,3047,1318,-30
38214132278,38214132286,8,2165,893,-30
38220775378,38220775383,5,1591,794,-30
38223266752,38223266758,6,2335,1070,-30
38226059178,38226059182,4,2313,1386,-30
38227521294,38227521298,4,2279,2384,-30
38227953630,38227953635,5,2022,974,-30
38231362898,38231362902,4,2409,1254,-30
38235628417,38235628422,5,2369,1034,-30
38237366495,38237366501,6,2344,1374,-30
38240294025,38240294031,6,2834,995,-30
38241240667,38241240674,7,3464,1345,-30
38241704971,38241704977,6,3381,1158,-30
38244102662,38244102667,5,1929,1052,-30
38246173411,38246173418,7,1214,667,-30
38247202957,38247202961,4,2204,1377,-30
38250919741,38250919746,5,2094,1651,-30
38253264247,38253264252,5,1559,1165,-30
38255761949,38255761954,5,2755,1362,-30
38264666435,38264666438,3,1428,1020,-30
38265664407,38265664410,3,2164,1331,-30
38267181514,38267181519,5,2289,1018,-30
38267268918,38267268899,-19,3151,1153,-30
38270870389,38270870394,5,1748,1207,-30
38274192430,38274192435,5,1882,1195,-30
38275313995,38275313976,-19,1876,856,-30
38277384196,38277384201,5,2280,1414,-30
38283921746,38283921750,4,2424,1107,-30
38285593972,38285593968,-4,1068,3193,-30
38286737480,38286737486,6,2484,1623,-30
38286856438,38286856445,7,2253,1215,-30
38287217845,38287217858,13,1927,830,-30
38287505309,38287505314,5,2494,1707,-30
38290427874,38290427878,4,2882,1316,-30
38291173087,38291173098,11,1548,1326,-30
38292909714,38292909720,6,2627,1278,-30
38294290721,38294290726,5,2826,866,-30
38298731541,38298731545,4,2415,1639,-30
38302420267,38302420271,4,2426,1196,-30
38306292532,38306292537,5,2145,1461,-30
38308269630,38308269634,4,1789,1090,-30
38310421017,38310421021,4,2102,1511,-30
38310591346,38310591354,8,932,911,-30
38313798766,38313798774,8,3699,1670,-30
38318720781,38318720786,5,2251,810,-30
38321852118,38321852123,5,2627,1389,-30
38325940862,38325940868,6,2986,1587,-30
38328195794,38328195798,4,2339,809,-30
38332964085,38332964090,5,1889,1194,-30
38333591635,38333591641,6,1814,1326,-30
38335802558,38335802562,4,1723,1148,-30
38336114535,38336114540,5,1799,1206,-30
38337022232,38337022238,6,2046,922,-30
38337348961,38337348946,-15,2350,1572,-30
38338652255,38338652260,5,2578,1462,-30
38344398802,38344398806,4,1774,1274,-30
38347298023,38347298027,4,1573,855,-30
38351606373,38351606371,-2,969,2904,-30
38355779513,38355779518,5,3352,1426,-30
38360853974,38360853978,4,2223,1490,-30
38360922270,38360922272,2,1683,1245,-30
38367230252,38367230259,7,2011,1392,-30
38372146713,38372146714,1,2684,2339,-30
38373106649,38373106654,5,2138,944,-30
38375196831,38375196836,5,2083,1602,-30
38380303646,38380303640,-6,1029,4016,-30
38381969308,38381969312,4,2151,1213,-30
38384408095,38384408099,4,2144,857,-30
38384674759,38384674778,19,2363,2224,-30
38390050477,38390050482,5,2024,1043,-30
38397659775,38397659777,2,1169,1122,-30
38400230922,38400230917,-5,1333,3740,-30
38402902598,38402902602,4,2336,1210,-30
38403134568,38403134572,4,2230,1663,-30
38408521539,38408521545,6,976,762,-30
38409144141,38409144138,-3,1808,3666,-30
38409502168,38409502173,5,2467,1153,-30
38409915976,38409915982,6,2622,1225,-30
38412848531,38412848536,5,1767,1257,-30
38414522647,38414522657,10,929,430,-30
38415701795,38415701800,5,2366,1571,-30
38416047057,38416047041,-16,2481,1390,-30
38416298754,38416298762,8,3478,1691,-30
38421916106,38421916111,5,2278,1205,-30
38422493138,38422493143,5,1283,838,-30
38424686146,38424686148,2,1497,1670,-30
38428818528,38428818534,6,2234,1546,-30
38429097829,38429097818,-11,867,502,-30
38433628429,38433628431,2,2440,1815,-30
38434690771,38434690778,7,1669,1265,-30
38435624791,38435624795,4,1525,971,-30
38441567030,38441567034,4,2258,1717,-30
38442284786,38442284790,4,2272,1370,-30
38443571729,38443571734,5,2497,1113,-30
38448551666,38448551669,3,2036,1656,-30
38450741368,38450741376,8,239,1689,-30
38452845365,38452845370,5,2222,1548,-30
38460273873,38460273878,5,2747,1262,-30
38460895170,38460895175,5,1946,1025,-30
38464498475,38464498469,-6,893,2903,-30
38464602053,38464602058,5,1860,1129,-30
38466602259,38466602263,4,2255,1300,-30
38468229082,38468229087,5,3080,2015,-30
38468806086,38468806089,3,1861,1441,-30
38468948748,38468948753,5,1402,1184,-30
38476011394,38476011399,5,1367,1029,-30
38478714015,38478714019,4,3115,1377,-30
38481148754,38481148758,4,2689,1586,-30
38484018061,38484018066,5,1502,1146,-30
38484940373,38484940378,5,2021,1372,-30
38485093913,38485093917,4,2718,1264,-30
38485754621,38485754626,5,2096,1494,-30
38486514144,38486514149,5,2837,1663,-30
38487742311,38487742314,3,2815,1283,-30
38488829691,38488829697,6,10893,24276,-30
38493490038,38493490041,3,1579,1026,-30
38494439537,38494439555,18,1986,1091,-30
38494573710,38494573692,-18,1709,1060,-30
38495730089,38495730095,6,1913,1482,-30
38497267174,38497267178,4,2302,1525,-30
38500354965,38500354970,5,2662,1393,-30
38505453348,38505453355,7,3427,1303,-30
38508535023,38508535029,6,2266,1430,-30
38508789899,38508789881,-18,2836,1153,-30
38509091122,38509091127,5,2976,1942,-30
38509129805,38509129809,4,3010,1337,-30
38515163258,38515163263,5,2201,1392,-30
38515634655,38515634656,1,1801,1530,-30
38516415020,38516415025,5,1777,1327,-30
38521056657,38521056662,5,2572,1546,-30
38524270153,38524270158,5,1714,1303,-30
38524679475,38524679478,3,2467,1883,-30
38529554175,38529554181,6,2354,1079,-30
38531110743,38531110747,4,2372,1603,-30
38532214697,38532214701,4,1859,1086,-30
38532271507,38532271511,4,1641,1147,-30
38535039446,38535039450,4,1993,1344,-30
38536181917,38536181921,4,2133,1112,-30
38539063227,38539063232,5,2115,1369,-30
38540389125,38540389115,-10,581,146,-30
38541364186,38541364190,4,2488,1478,-30
38541731803,38541731794,-9,682,175,-30
38557408185,38557408191,6,2279,1276,-30
38562347310,38562347315,5,3056,1147,-30
38563461533,38563461535,2,2270,1258,-30
38567362741,38567362746,5,1619,1369,-30
38568939866,38568939871,5,2271,1814,-30
38573653092,38573653098,6,1862,1134,-30
38577429008,38577429011,3,1881,1223,-30
38578477430,38578477434,4,2453,1356,-30
38582324864,38582324869,5,2611,1089,-30
38585245579,38585245585,6,2634,1188,-30
38587021006,38587021010,4,2550,1529,-30
38588204086,38588204090,4,1373,985,-30
38588728188,38588728194,6,2064,991,-30
38590107512,38590107518,6,2256,1201,-30
38590686462,38590686466,4,2181,1776,-30
38593042374,38593042379,5,2441,1585,-30
38593569917,38593569922,5,2457,1964,-30
38602103150,38602103153,3,1311,1187,-30
38602343794,38602343802,8,2296,1043,-30
38602854535,38602854545,10,1745,1005,-30
38604448905,38604448910,5,2964,1702,-30
38611318490,38611318495,5,2295,1127,-30
38618368461,38618368466,5,2285,1247,-30
38621303714,38621303723,9,1882,1244,-30
38624241570,38624241575,5,1396,944,-30
38629435914,38629435919,5,2230,1384,-30
38632098003,38632098008,5,1777,914,-30
38635021056,38635021061,5,5117,3099,-30
38636997789,38636997793,4,2210,1283,-30
38640372142,38640372148,6,1753,1081,-30
38641839577,38641839582,5,1740,1035,-30
38652341318,38652341321,3,1984,1505,-30
38653577109,38653577115,6,2095,1007,-30
38653736301,38653736306,5,38046,114886,-30
38654947065,38654947070,5,1951,1040,-30
38656685066,38656685071,5,1973,1324,-30
38657491682,38657491686,4,2285,1385,-30
38659854421,38659854425,4,1702,1574,-30
38660586722,38660586727,5,1524,973,-30
38666701409,38666701414,5,2462,951,-30
38669633598,38669633603,5,2522,1350,-30
38670004038,38670004036,-2,1444,1969,-30
38679829026,38679829032,6,3224,1340,-30
38680834722,38680834708,-14,2512,921,-30
38685528857,38685528858,1,11414,12165,-30
38691417730,38691417735,5,2181,913,-30
38691489409,38691489419,10,182,2953,-30
38697986229,38697986233,4,2477,1298,-30
38709095483,38709095488,5,1886,898,-30
38710876624,38710876629,5,2276,1047,-30
38711683833,38711683817,-16,2518,931,-30
38713398939,38713398942,3,1101,866,-30
38714858658,38714858662,4,1596,1169,-30
38715564282,38715564287,5,2093,1341,-30
38716902102,38716902109,7,3209,997,-30
38720312657,38720312662,5,2743,1405,-30
38728247110,38728247114,4,2371,1416,-30
38728769763,38728769767,4,1376,1360,-30
38729432879,38729432885,6,2273,1255,-30
38729865783,38729865789,6,2237,1342,-30
38734831876,38734831881,5,2461,1422,-30
38735053608,38735053613,5,1914,1654,-30
38738577230,38738577234,4,2153,1189,-30
38740211776,38740211782,6,2299,1242,-30
38741207338,38741207345,7,2990,1011,-30
38742703517,38742703513,-4,577,1568,-30
38746906999,38746907002,3,2050,1495,-30
38750193250,38750193254,4,1713,1122,-30
38752967378,38752967384,6,4042,1783,-30
38759981126,38759981130,4,1623,1206,-30
38762923949,38762923954,5,2853,1339,-30
38763040821,38763040822,1,1678,1343,-30
38763653727,38763653730,3,2135,1544,-30
38769933653,38769933659,6,1848,927,-30
38771839275,38771839280,5,2691,1735,-30
38772365818,38772365821,3,2386,1660,-30
38772641757,38772641760,3,2672,1814,-30
38775545644,38775545649,5,1593,1260,-30
38776072542,38776072520,-22,1348,837,-30
38776552506,38776552505,-1,1539,2722,-30
38781145634,38781145633,-1,19280,8418,-30
38782746990,38782746995,5,2335,1026,-30
38783229838,38783229842,4,2094,1195,-30
38786437245,38786437242,-3,2177,4178,-30
38786509342,38786509347,5,2222,1158,-30
38786911581,38786911563,-18,1307,831,-30
38787006685,38787006689,4,1987,1472,-30
38788461710,38788461715,5,1423,659,-30
38792359450,38792359452,2,1661,1297,-30
38793853454,38793853460,6,2433,1708,-30
38797700486,38797700491,5,2056,1742,-30
38802774610,38802774615,5,2302,1014,-30
38805781833,38805781831,-2,2882,4428,-30
38806214597,38806214601,4,2242,1697,-30
38809332144,38809332149,5,3242,1674,-30
38812384625,38812384630,5,2122,1391,-30
38813327353,38813327358,5,2592,1357,-30
38817267218,38817267222,4,1787,1400,-30
38820755992,38820755980,-12,25451,18507,-30
38821243134,38821243135,1,806,1638,-30
38823405530,38823405534,4,2079,1163,-30
38824619813,38824619819,6,1475,1084,-30
38824817449,38824817431,-18,1272,1111,-30
38825319556,38825319579,23,17766,46205,-30
38825463259,38825463264,5,2127,1219,-30
38825664525,38825664506,-19,980,956,-30
38827366113,38827366113,0,1453,945,-30
38827427667,38827427674,7,875,308,-30
38831228990,38831228994,4,3245,1365,-30
38832875033,38832875037,4,2828,1727,-30
38834319937,38834319946,9,3243,1121,-30
38834902498,38834902484,-14,24,1329,-30
38837498929,38837498934,5,953,851,-30
38840734073,38840734080,7,2676,878,-30
38843995334,38843995339,5,2418,1684,-30
38851000339,38851000346,7,1365,1403,-30
38854923223,38854923226,3,1477,1062,-30
38856005086,38856005091,5,2088,1847,-30
38856750112,38856750101,-11,18,730,-30
38864967605,38864967607,2,1533,1408,-30
38865842375,38865842375,0,1256,1792,-30
38866856545,38866856547,2,2544,1642,-30
38872047774,38872047780,6,2496,1810,-30
38876305774,38876305780,6,1629,1137,-30
38877873713,38877873718,5,2772,1481,-30
38880771325,38880771327,2,2838,1260,-30
38884587679,38884587684,5,2701,1131,-30
38889773620,38889773625,5,2135,1318,-30
38894842338,38894842342,4,2248,1357,-30
38895008182,38895008188,6,1773,1306,-30
38895291415,38895291418,3,2268,1394,-30
38898404571,38898404577,6,2375,1682,-30
38901435108,38901435114,6,2622,850,-30
38904270253,38904270258,5,3124,1537,-30
38908461022,38908461027,5,2365,1560,-30
38908882393,38908882397,4,1659,1353,-30
38911699522,38911699526,4,960,726,-30
38912359106,38912359109,3,2365,1318,-30
38913039516,38913039521,5,2488,1073,-30
38913818198,38913818204,6,2409,1062,-30
38922893386,38922893390,4,1993,1313,-30
38923022307,38923022312,5,1467,829,-30
38923119009,38923119014,5,2619,1569,-30
38926601721,38926601700,-21,218,2754,-30
38926903441,38926903449,8,1761,1291,-30
38928940223,38928940226,3,1782,1420,-30
38929396054,38929396059,5,1997,1273,-30
38930355834,38930355821,-13,238,710,-30
38931461968,38931461972,4,1704,802,-30
38934149858,38934149849,-9,576,200,-30
38936666101,38936666105,4,1646,1160,-30
38942193806,38942193810,4,2805,1631,-30
38949337205,38949337204,-1,1399,1356,-30
38952083346,38952083343,-3,1496,3035,-30
38952436336,38952436341,5,3328,1434,-30
38954586629,38954586634,5,1862,1284,-30
38955561832,38955561838,6,2140,887,-30
38958394262,38958394267,5,3032,1370,-30
38959771398,38959771404,6,2414,1229,-30
38963533827,38963533833,6,5190,2098,-30
38964353213,38964353219,6,1793,979,-30
38965095073,38965095082,9,2238,1394,-30
38965287879,38965287884,5,2313,1248,-30
38970515929,38970515934,5,2940,1401,-30
38972054087,38972054093,6,1462,1411,-30
38976655598,38976655603,5,3288,1361,-30
38977378399,38977378403,4,1894,1736,-30
38977731346,38977731351,5,1769,1334,-30
38979072038,38979072042,4,1527,874,-30
38983408522,38983408527,5,1902,1126,-30
38984038270,38984038271,1,1021,1117,-30
38987102828,38987102833,5,2641,1776,-30
38992318336,38992318341,5,1775,1035,-30
38992972314,38992972311,-3,1490,2586,-30
38993400144,38993400149,5,2301,1245,-30
38995555042,38995555047,5,1035,1277,-30
38997954697,38997954702,5,2463,1031,-30
38998316930,38998316933,3,1626,1373,-30
39003431530,39003431536,6,3122,1840,-30
39003997014,39003997020,6,2207,1540,-30
39005093230,39005093217,-13,3288,1518,-30
39010046773,39010046778,5,2035,1068,-30
39017263295,39017263313,18,914,3164,-30
39017732546,39017732551,5,1245,812,-30
39018279153,39018279159,6,2256,1309,-30
39028872360,39028872365,5,1761,1205,-30
39036995674,39036995679,5,1884,1201,-30
39039771201,39039771206,5,1924,1298,-30
39039974285,39039974290,5,1507,940,-30
39040454126,39040454147,21,1843,1190,-30
39044942106,39044942111,5,2106,677,-30
39051640876,39051640863,-13,22747,25932,-30
39053293412,39053293417,5,2337,1166,-30
39054115270,39054115274,4,3001,1592,-30
39057314725,39057314732,7,2237,1259,-30
39058760335,39058760341,6,3771,2067,-30
39059957417,39059957422,5,2153,1073,-30
39063155177,39063155173,-4,1661,3381,-30
39069218011,39069218015,4,2180,815,-30
39073989178,39073989193,15,1400,1117,-30
39074364830,39074364834,4,2542,1497,-30
39075492726,39075492727,1,1054,1512,-30
39076878754,39076878761,7,2933,1674,-30
39078482102,39078482106,4,2773,1534,-30
39082443918,39082443915,-3,2014,4953,-30
39082703714,39082703719,5,2290,842,-30
39082990905,39082990909,4,1397,1342,-30
39090096821,39090096826,5,3245,1959,-30
39092990473,39092990478,5,2925,1227,-30
39094329678,39094329683,5,1536,1155,-30
39098018793,39098018798,5,1747,1037,-30
39098077777,39098077775,-2,1355,1923,-30
39098802501,39098802506,5,1845,1693,-30
39099144033,39099144039,6,2030,1380,-30
39099938190,39099938198,8,2565,1437,-30
39100754135,39100754139,4,2208,1275,-30
39101779430,39101779434,4,2384,1070,-30
39105103447,39105103450,3,2192,1256,-30
39106272625,39106272631,6,2743,1412,-30
39110033374,39110033379,5,1411,774,-30
39112413025,39112413029,4,1240,975,-30
39114971781,39114971787,6,2812,868,-30
39117249975,39117249994,19,985,1532,-30
39118754360,39118754354,-6,1154,3168,-30
39120407945,39120407951,6,2472,1789,-30
39122055086,39122055092,6,2194,1523,-30
39129213052,39129213057,5,2753,1885,-30
39132831341,39132831345,4,1914,1373,-30
39134974338,39134974341,3,2605,2253,-30
39135451218,39135451222,4,2203,1093,-30
39138704585,39138704584,-1,1158,1313,-30
39145624973,39145624977,4,1833,1191,-30
39147730125,39147730129,4,1714,1100,-30
39148145314,39148145318,4,3019,1531,-30
39149329975,39149329973,-2,1408,1801,-30
39150831794,39150831794,0,1939,2686,-30
39151994509,39151994514,5,2261,1342,-30
39153395538,39153395542,4,3246,1571,-30
39153770675,39153770681,6,2263,1903,-30
39157671320,39157671322,2,9329,7447,-30
39159753381,39159753385,4,2142,1260,-30
39159935949,39159935954,5,3655,2291,-30
39160156388,39160156393,5,1073,856,-30
39163813721,39163813726,5,1645,1154,-30
39164827045,39164827052,7,17115,28704,-30
39165856847,39165856847,0,968,1412,-30
39166302017,39166302023,6,1985,1518,-30
39166683717,39166683721,4,2318,1601,-30
39168486933,39168486938,5,2045,1398,-30
39169879764,39169879767,3,2286,1469,-30
39170245543,39170245550,7,3053,1750,-30
39178371410,39178371414,4,2899,1384,-30
39178796934,39178796939,5,2952,1649,-30
39183679007,39183679013,6,2746,1595,-30
39191820738,39191820746,8,1551,1067,-30
39197090111,39197090118,7,2145,1063,-30
39200623478,39200623479,1,1365,1378,-30
39201026182,39201026187,5,2464,1675,-30
39206102217,39206102222,5,2499,1369,-30
39206659379,39206659383,4,2370,1224,-30
39217560766,39217560771,5,1054,1027,-30
39218117695,39218117697,2,2533,1891,-30
39222238299,39222238304,5,1835,852,-30
39222602695,39222602702,7,2570,970,-30
39226373541,39226373550,9,11059,34082,-30
39231100953,39231100958,5,2338,1337,-30
39235706564,39235706569,5,2006,1026,-30
39236127985,39236127991,6,2167,1232,-30
39238854834,39238854841,7,808,336,-30
39240985809,39240985814,5,2324,1128,-30
39242600581,39242600585,4,2221,1682,-30
39244266533,39244266538,5,2172,1122,-30
39244549077,39244549082,5,2228,1543,-30
39250857703,39250857707,4,2225,1257,-30
39251817257,39251817262,5,1476,1046,-30
39256216128,39256216127,-1,1547,1582,-30
39257174502,39257174508,6,2479,1116,-30
39266083637,39266083630,-7,1749,8114,-30
39266150633,39266150637,4,2174,1366,-30
39270599258,39270599263,5,4100,1748,-30
39271275784,39271275789,5,1920,961,-30
39272667029,39272667031,2,1881,1315,-30
39272749198,39272749178,-20,1221,873,-30
39274855619,39274855626,7,2459,1091,-30
39278959945,39278959951,6,1000,870,-30
39281169458,39281169463,5,2671,1661,-30
39281417657,39281417643,-14,833,384,-30
39284368042,39284368049,7,3363,1360,-30
39287560723,39287560728,5,2320,1442,-30
39294341089,39294341094,5,1879,1634,-30
39296532226,39296532230,4,3449,1953,-30
39297740902,39297740907,5,2239,1417,-30
39297772284,39297772286,2,2159,1385,-30
39302325517,39302325521,4,2640,1327,-30
39302668734,39302668738,4,2579,1396,-30
39304850495,39304850499,4,1774,1212,-30
39305538438,39305538442,4,1782,943,-30
39306286582,39306286586,4,2775,1119,-30
39306948462,39306948467,5,2253,1500,-30
39308410167,39308410170,3,1665,1935,-30
39311233026,39311233031,5,1094,854,-30
39312514457,39312514463,6,3249,1495,-30
39314830629,39314830635,6,2325,1086,-30
39315585283,39315585287,4,2060,1433,-30
39320036080,39320036085,5,2796,1327,-30
39327058114,39327058119,5,2354,1364,-30
39329143658,39329143662,4,1845,1564,-30
39329905290,39329905296,6,2832,1596,-30
39330449818,39330449819,1,1428,1309,-30
39332755151,39332755156,5,2475,1274,-30
39334717829,39334717831,2,2032,1347,-30
39338750558,39338750563,5,2650,921,-30
39345446605,39345446610,5,2382,1303,-30
39347002470,39347002473,3,1375,1266,-30
39350222957,39350222963,6,2175,1324,-30
39350843206,39350843210,4,2090,1081,-30
39350963905,39350963910,5,2499,1465,-30
39352061086,39352061091,5,2000,1440,-30
39352440358,39352440362,4,2461,1310,-30
39352487611,39352487613,2,2506,1838,-30
39354076211,39354076214,3,1194,723,-30
39356960784,39356960786,2,2050,1192,-30
39360769621,39360769627,6,1894,1477,-30
39363987949,39363987952,3,1724,980,-30
39364644233,39364644237,4,1178,1266,-30
39378053020,39378053024,4,2389,1914,-30
39379537626,39379537631,5,2583,1587,-30
39387074542,39387074546,4,1311,943,-30
39388441710,39388441715,5,2929,2049,-30
39391050023,39391050016,-7,433,1574,-30
39392739822,39392739827,5,1758,1375,-30
39397433703,39397433707,4,2214,746,-30
39399436828,39399436833,5,1520,907,-30
39399882890,39399882874,-16,1756,757,-30
39407444691,39407444698,7,2776,953,-30
39408804334,39408804338,4,1493,764,-30
39409952603,39409952608,5,2641,2064,-30
39410618773,39410618778,5,1916,1222,-30
39411326242,39411326227,-15,565,310,-30
39412007165,39412007169,4,2239,1164,-30
39416957629,39416957636,7,2005,1300,-30
39418006821,39418006822,1,1665,1893,-30
39422860059,39422860062,3,2092,1372,-30
39423886173,39423886178,5,2129,1526,-30
39425593620,39425593622,2,1907,1576,-30
39427286802,39427286806,4,2386,1066,-30
39432796647,39432796651,4,3291,1471,-30
39439756964,39439756954,-10,2063,27847,-30
39441025034,39441025038,4,2005,905,-30
39441387754,39441387758,4,2384,1526,-30
39443323233,39443323237,4,1897,1246,-30
39443605511,39443605515,4,2218,1377,-30
39444695549,39444695554,5,2326,1525,-30
39444831131,39444831135,4,1461,1113,-30
39447962966,39447962971,5,2429,890,-30
39450757957,39450757952,-5,1057,4573,-30
39452951351,39452951355,4,2029,1139,-30
39456417377,39456417382,5,2029,854,-30
39457690566,39457690574,8,3059,1309,-30
39457920277,39457920281,4,1532,1578,-30
39458963274,39458963280,6,2859,1594,-30
39461430921,39461430924,3,2529,1771,-30
39467894015,39467894011,-4,1788,3689,-30
39468796482,39468796488,6,3059,1887,-30
39469368681,39469368686,5,2012,1703,-30
39473104172,39473104186,14,110,976,-30
39475159945,39475159950,5,3175,1527,-30
39483696996,39483697002,6,2557,1428,-30
39486399978,39486399983,5,1589,1316,-30
39487179387,39487179393,6,1897,1039,-30
39490368351,39490368354,3,2294,1214,-30
39492219957,39492219961,4,2066,1127,-30
39495979679,39495979684,5,2630,1713,-30
39496512414,39496512418,4,1661,1684,-30
39504090130,39504090137,7,3337,1390,-30
39511344584,39511344589,5,1660,1015,-30
39511808636,39511808640,4,1805,1282,-30
39515763385,39515763391,6,2396,1337,-30
39518183155,39518183160,5,2175,1322,-30
39518706929,39518706930,1,1577,1296,-30
39520914125,39520914128,3,1447,789,-30
39521799658,39521799663,5,2976,2270,-30
39522167429,39522167434,5,3040,1403,-30
39523579670,39523579675,5,2019,1404,-30
39524011042,39524011027,-15,951,717,-30
39525465676,39525465680,4,1912,1405,-30
39528524866,39528524870,4,2180,1009,-30
39528888555,39528888538,-17,1700,1539,-30
39534789050,39534789054,4,1948,1158,-30
39535587135,39535587139,4,1930,1315,-30
39536512318,39536512325,7,2769,1442,-30
39538812067,39538812075,8,3155,1535,-30
39540650037,39540650043,6,2212,2021,-30
39540770149,39540770155,6,1809,1230,-30
39543770108,39543770102,-6,1480,5427,-30
39545524588,39545524592,4,1957,1229,-30
39547992594,39547992599,5,3113,1444,-30
39549546736,39549546740,4,1753,1394,-30
39550491190,39550491195,5,1244,975,-30
39551089260,39551089265,5,3352,1808,-30
39551321485,39551321492,7,2888,1009,-30
39555000687,39555000689,2,1381,1586,-30
39556366714,39556366717,3,2112,1739,-30
39558181966,39558181963,-3,918,2841,-30
39564033418,39564033425,7,1739,1483,-30
39564161281,39564161286,5,2483,1496,-30
39564698266,39564698271,5,2923,1542,-30
39566250775,39566250778,3,2182,1604,-30
39567351590,39567351594,4,2267,1209,-30
39569283402,39569283407,5,1179,1237,-30
39569497751,39569497756,5,1823,1173,-30
39570148762,39570148767,5,2618,1514,-30
39571156816,39571156814,-2,1730,984,-30
39575065440,39575065445,5,1640,1336,-30
39576309740,39576309745,5,1596,1291,-30
39581692154,39581692158,4,1660,1085,-30
39582244455,39582244461,6,10604,6609,-30
39582434375,39582434381,6,2399,1349,-30
39582706209,39582706213,4,1982,1648,-30
39583542262,39583542267,5,2014,1156,-30
39583825934,39583825939,5,2575,1468,-30
39584998926,39584998931,5,1788,889,-30
39585607278,39585607258,-20,2674,1607,-30
39587188517,39587188524,7,3097,1350,-30
39587949069,39587949070,1,1889,1217,-30
39597235330,39597235335,5,2331,1368,-30
39601548873,39601548870,-3,1421,2575,-30
39605330930,39605330937,7,2799,1491,-30
39607266922,39607266927,5,2412,1374,-30
39607550020,39607550027,7,1166,412,-30
39609958033,39609958037,4,2001,1205,-30
39614066793,39614066798,5,2374,1348,-30
39616655106,39616655111,5,1766,1308,-30
39620132620,39620132626,6,1793,1243,-30
39620381110,39620381114,4,897,715,-30
39621711216,39621711221,5,2303,1474,-30
39621933951,39621933963,12,1805,1357,-30
39627683237,39627683240,3,3874,2684,-30
39633265173,39633265189,16,1884,1166,-30
39633481603,39633481609,6,2032,1807,-30
39634468011,39634468016,5,1157,1271,-30
39634864808,39634864814,6,1716,958,-30
39637092749,39637092751,2,1328,898,-30
39637409834,39637409837,3,2042,1197,-30
39637887118,39637887121,3,1145,221,-30
39639818750,39639818754,4,1705,1182,-30
39640135015,39640135003,-12,820,113,-30
39641790582,39641790587,5,2822,1162,-30
39653454187,39653454191,4,2779,1198,-30
39654359962,39654359967,5,2343,1190,-30
39657382130,39657382135,5,1776,1266,-30
39661111357,39661111363,6,3129,1627,-30
39661479326,39661479306,-20,1722,1015,-30
39667363454,39667363458,4,1284,1209,-30
39674002653,39674002656,3,1321,1372,-30
39678380925,39678380930,5,3794,1330,-30
39679369774,39679369778,4,2615,1507,-30
39681373662,39681373667,5,1754,1506,-30
39686709577,39686709583,6,1534,1476,-30
39686939090,39686939094,4,2076,1804,-30
39689579735,39689579738,3,1831,1275,-30
39690414339,39690414328,-11,210,1632,-30
39693754966,39693754971,5,2413,1592,-30
39694457589,39694457595,6,1907,1524,-30
39697418343,39697418346,3,2466,1399,-30
39702888962,39702888966,4,2329,1368,-30
39703909192,39703909179,-13,1256,305,-30
39705173666,39705173666,0,37218,21168,-30
39705726432,39705726432,0,2058,1231,-30
39707669803,39707669809,6,11186,27775,-30
39707955488,39707955475,-13,1391,833,-30
39711951885,39711951890,5,1468,1499,-30
39712215021,39712215004,-17,2236,1301,-30
39712711733,39712711740,7,2387,1362,-30
39713024321,39713024339,18,1676,1293,-30
39715896305,39715896311,6,2271,1960,-30
39717238610,39717238617,7,2355,1876,-30
39718435734,39718435739,5,2552,1194,-30
39718973815,39718973819,4,1750,1258,-30
39722266141,39722266145,4,3093,1256,-30
39723744742,39723744749,7,1441,1103,-30
39725321790,39725321793,3,5079,5141,-30
39725651448,39725651453,5,1747,1451,-30
39731548171,39731548170,-1,1332,1841,-30
39739242712,39739242706,-6,1397,1026,-30
39740409414,39740409418,4,3613,1869,-30
39742738058,39742738062,4,1418,1335,-30
39744736125,39744736128,3,1897,2124,-30
39745461429,39745461431,2,3191,1756,-30
39747438773,39747438779,6,1350,1084,-30
39750809822,39750809825,3,1728,939,-30
39752119085,39752119089,4,1706,1209,-30
39753372478,39753372483,5,1311,963,-30
39756559773,39756559780,7,2394,1492,-30
39756591138,39756591146,8,1346,337,-30
39757990846,39757990851,5,1593,1385,-30
39758522532,39758522537,5,2316,1319,-30
39760741854,39760741859,5,2484,1254,-30
39763045525,39763045530,5,2320,1317,-30
39763098657,39763098642,-15,2067,892,-30
39771646033,39771646037,4,2328,1639,-30
39773527664,39773527671,7,1621,935,-30
39775056543,39775056546,3,1171,809,-30
39776259823,39776259833,10,739,270,-30
39781408641,39781408646,5,2003,1214,-30
39783786227,39783786227,0,2562,2000,-30
39788145487,39788145492,5,3978,2038,-30
39789001058,39789001062,4,2411,1420,-30
39791364880,39791364883,3,1707,1385,-30
39794966730,39794966733,3,2225,1659,-30
39797488875,39797488881,6,2558,1041,-30
39798778648,39798778653,5,2238,1102,-30
39798974006,39798973986,-20,2243,1413,-30
39802356483,39802356489,6,1871,1101,-30
39806658458,39806658462,4,2520,1301,-30
39812468270,39812468275,5,2022,1548,-30
39813808477,39813808483,6,2219,1282,-30
39816433901,39816433907,6,2057,1012,-30
39817213298,39817213304,6,2558,1111,-30
39819484728,39819484734,6,2018,1228,-30
39821206388,39821206387,-1,1175,2374,-30
39824359000,39824359007,7,3044,1673,-30
39828417530,39828417537,7,2018,860,-30
39829222823,39829222828,5,2586,1691,-30
39830908281,39830908286,5,1339,759,-30
39831829122,39831829126,4,1905,1363,-30
39833079361,39833079366,5,1967,1744,-30
39835581588,39835581592,4,1898,1411,-30
39837428421,39837428426,5,2970,1490,-30
39840843694,39840843699,5,1174,745,-30
39841450110,39841450115,5,2151,1448,-30
39843355885,39843355890,5,2122,1405,-30
39844861838,39844861843,5,1846,1743,-30
39845421670,39845421674,4,2064,1478,-30
39847345538,39847345543,5,2695,1496,-30
39847754766,39847754766,0,1514,1364,-30
39852623450,39852623451,1,1765,2041,-30
39853124088,39853124093,5,2353,1118,-30
39853190791,39853190795,4,905,699,-30
39854568917,39854568921,4,1643,1507,-30
39858403078,39858403079,1,1464,1607,-30
39860811057,39860811062,5,2060,1241,-30
39862928085,39862928089,4,2676,1510,-30
39863512625,39863512623,-2,2275,3695,-30
39872586701,39872586707,6,2608,1438,-30
39874115645,39874115651,6,1246,986,-30
39879060134,39879060140,6,2327,1655,-30
39879321205,39879321211,6,3030,937,-30
39882759367,39882759371,4,2817,1221,-30
39886716795,39886716801,6,3199,1141,-30
39887492325,39887492330,5,1904,1689,-30
39888265348,39888265353,5,1704,1406,-30
39889202722,39889202731,9,9691,36832,-30
39889668610,39889668615,5,1862,804,-30
39900530932,39900530937,5,2379,1529,-30
39909427242,39909427246,4,3029,1690,-30
39909623979,39909623983,4,2774,1652,-30
39913117926,39913117930,4,2039,1240,-30
39913817166,39913817171,5,2296,1129,-30
39920115644,39920115647,3,2505,1404,-30
39922528379,39922528386,7,2340,1440,-30
39922992015,39922992021,6,2358,2427,-30
39923359393,39923359397,4,2294,1569,-30
39924791609,39924791615,6,2373,914,-30
39931712290,39931712293,3,2064,1184,-30
39936187246,39936187251,5,1989,852,-30
39936949845,39936949850,5,2255,1335,-30
39944332481,39944332486,5,1992,1797,-30
39947524830,39947524835,5,1202,867,-30
39950798832,39950798842,10,2319,1025,-30
39951996660,39951996664,4,1884,965,-30
39953405528,39953405533,5,2184,1774,-30
39954186294,39954186299,5,2064,1120,-30
39957131113,39957131117,4,2992,1383,-30
39959197553,39959197558,5,2766,787,-30
39960848083,39960848088,5,2009,796,-30
39962546988,39962546994,6,1382,873,-30
39963029742,39963029748,6,1796,1534,-30
39966063913,39966063925,12,9904,46778,-30
39967714714,39967714712,-2,20188,36527,-30
39969144576,39969144581,5,3019,1336,-30
39971888598,39971888603,5,2343,1269,-30
39973845629,39973845634,5,1201,1025,-30
39997864703,39997864706,3,1570,980,-30
39999027213,39999027216,3,1833,969,-30
40001455211,40001455218,7,1959,1296,-30
40001529069,40001529074,5,1531,882,-30
40005404765,40005404769,4,1359,960,-30
40005619239,40005619243,4,1853,827,-30
40006702798,40006702795,-3,1255,3535,-30
40007261262,40007261263,1,1203,1197,-30
40007629770,40007629777,7,2206,1480,-30
40009086231,40009086238,7,2318,1346,-30
40009202985,40009202990,5,2046,1377,-30
40015210974,40015210978,4,2190,1161,-30
40021083953,40021083958,5,1963,1323,-30
40022292242,40022292245,3,1743,1140,-30
40027625530,40027625534,4,2525,1121,-30
40027959814,40027959819,5,2078,1530,-30
40028758340,40028758345,5,3279,1411,-30
40033306037,40033306044,7,2874,1606,-30
40038240188,40038240193,5,2054,1245,-30
40038453006,40038453013,7,2436,1234,-30
40040239515,40040239523,8,2272,1470,-30
40042507499,40042507506,7,2328,1215,-30
40044046261,40044046267,6,1770,1257,-30
40046052617,40046052621,4,2353,1401,-30
40048290926,40048290930,4,2334,1386,-30
40048890995,40048890992,-3,1696,17143,-30
40049725101,40049725103,2,2222,1346,-30
40051073121,40051073123,2,1892,1510,-30
40054394093,40054394099,6,2411,1578,-30
40056672540,40056672544,4,1966,1136,-30
40057045254,40057045241,-13,781,439,-30
40058466586,40058466590,4,2836,1646,-30
40060995137,40060995143,6,2621,1891,-30
40061099949,40061099955,6,1617,650,-30
40062190658,40062190663,5,2141,1606,-30
40064483230,40064483235,5,2785,1526,-30
40066064735,40066064741,6,6572,2872,-30
40071454691,40071454693,2,1396,1566,-30
40076300605,40076300610,5,2009,1293,-30
40083766258,40083766266,8,2584,1339,-30
40084082566,40084082571,5,2448,994,-30
40090898525,40090898530,5,1380,1298,-30
40092309713,40092309716,3,2707,2069,-30
40093355350,40093355354,4,1062,735,-30
40095911754,40095911752,-2,1301,2548,-30
40095952308,40095952314,6,3174,1799,-30
40096105342,40096105342,0,1241,1412,-30
40096149424,40096149437,13,247,1111,-30
40100857470,40100857474,4,1084,1084,-30
40101304542,40101304546,4,2853,1333,-30
40102129476,40102129465,-11,25565,15190,-30
40107804790,40107804795,5,2557,1705,-30
40113968691,40113968697,6,2699,1479,-30
40121658421,40121658425,4,1835,1430,-30
40122967198,40122967203,5,2566,1158,-30
40123061001,40123061019,18,1954,1240,-30
40123436134,40123436136,2,1613,1392,-30
40128646550,40128646551,1,1863,1875,-30
40130128332,40130128338,6,3762,2021,-30
40130943917,40130943922,5,2650,1568,-30
40134859043,40134859047,4,1208,946,-30
40137252964,40137252974,10,3440,990,-30
40140696360,40140696359,-1,1385,1504,-30
40145237308,40145237313,5,1590,980,-30
40146272545,40146272550,5,1786,1302,-30
40146447831,40146447836,5,2340,1324,-30
40146729325,40146729330,5,2082,1065,-30
40151194071,40151194078,7,3444,1559,-30
40154155089,40154155093,4,1582,1144,-30
40156273308,40156273312,4,1997,1962,-30
40157818273,40157818279,6,2347,1232,-30
40157988944,40157988948,4,2080,1198,-30
40163856743,40163856743,0,1070,865,-30
40165802831,40165802826,-5,761,211,-30
40169160885,40169160890,5,1975,998,-30
40169772774,40169772778,4,3012,1819,-30
40169870470,40169870474,4,2810,1252,-30
40170878238,40170878241,3,2550,1765,-30
40172449798,40172449802,4,2738,1582,-30
40176755486,40176755487,1,1485,2179,-30
40176955514,40176955518,4,1924,1759,-30
40177917048,40177917052,4,2851,1650,-30
40178698294,40178698298,4,2157,1403,-30
40183399101,40183399109,8,1692,675,-30
40185389616,40185389619,3,2220,1778,-30
40185757966,40185757969,3,2068,1352,-30
40187151227,40187151230,3,1872,1092,-30
40187963839,40187963843,4,1278,1419,-30
40192023681,40192023685,4,2038,960,-30
40193866310,40193866314,4,2664,1644,-30
40195820315,40195820321,6,4357,1953,-30
40199790814,40199790817,3,2017,1239,-30
40200219646,40200219649,3,1906,1507,-30
40201087406,40201087410,4,2552,1389,-30
40202454814,40202454819,5,2418,1158,-30
40205801906,40205801894,-12,722,372,-30
40208457668,40208457666,-2,1701,3041,-30
40213767659,40213767665,6,1695,1360,-30
40216070073,40216070077,4,1265,1039,-30
40217388511,40217388515,4,3085,1727,-30
40219144368,40219144365,-3,1212,1718,-30
40219803942,40219803947,5,1539,963,-30
40221753604,40221753607,3,1706,1555,-30
40221871754,40221871758,4,2146,1478,-30
40226440657,40226440662,5,2384,1574,-30
40227317133,40227317138,5,2230,1515,-30
40228591222,40228591226,4,1864,806,-30
40228799842,40228799856,14,2020,1100,-30
40230009789,40230009792,3,1334,1284,-30
40232031103,40232031108,5,2087,1186,-30
40233198942,40233198947,5,2418,1412,-30
40236066549,40236066553,4,1634,1338,-30
40240382692,40240382697,5,1649,1982,-30
40240589846,40240589850,4,1965,762,-30
40240918077,40240918099,22,1773,1271,-30
40243168440,40243168446,6,2173,1003,-30
40247100481,40247100486,5,3173,1572,-30
40263703154,40263703153,-1,805,2384,-30
40266829269,40266829274,5,2994,1468,-30
40268338701,40268338707,6,2145,1551,-30
40271379809,40271379812,3,2849,1707,-30
40272787390,40272787386,-4,1444,2742,-30
40276107760,40276107775,15,1061,392,-30
40278673805,40278673809,4,1686,1261,-30
40283771722,40283771725,3,2375,1337,-30
40284157870,40284157877,7,3265,1474,-30
40285488704,40285488690,-14,892,489,-30
40288322933,40288322939,6,2650,1454,-30
40291551345,40291551350,5,2964,1112,-30
40291915615,40291915593,-22,880,438,-30
40293540713,40293540719,6,2353,1500,-30
40294191910,40294191915,5,2227,1495,-30
40300729929,40300729935,6,2170,1053,-30
40306927738,40306927743,5,2573,1343,-30
40307231793,40307231798,5,2028,1171,-30
40310315328,40310315333,5,2254,1669,-30
40311357474,40311357478,4,2285,1096,-30
40313573949,40313573955,6,2451,638,-30
40315248573,40315248577,4,2054,1373,-30
40318677092,40318677094,2,1398,821,-30
40320160286,40320160292,6,3090,1478,-30
40320458381,40320458387,6,2313,1575,-30
40321374074,40321374074,0,1350,1979,-30
40324227506,40324227510,4,2665,1504,-30
40326820796,40326820793,-3,34387,22057,-30
40327629560,40327629564,4,2185,1684,-30
40328029470,40328029476,6,2514,1299,-30
40337572081,40337572086,5,2133,1480,-30
40337682886,40337682891,5,2455,1312,-30
40340278567,40340278570,3,2349,1080,-30
40344367512,40344367518,6,2138,1031,-30
40345081477,40345081490,13,2074,1169,-30
40345577901,40345577880,-21,1686,1254,-30
40346162674,40346162680,6,1626,747,-30
40358371874,40358371878,4,2703,1270,-30
40359262346,40359262352,6,2521,1406,-30
40360313918,40360313922,4,1667,1125,-30
40360989195,40360989200,5,2392,1293,-30
40361275138,40361275143,5,2430,1412,-30
40362943598,40362943605,7,2365,1044,-30
40363738858,40363738842,-16,1977,1331,-30
40368631316,40368631335,19,588,1209,-30
40371185549,40371185554,5,1726,1247,-30
40371467550,40371467529,-21,2205,902,-30
40372307387,40372307392,5,2980,1660,-30
40373992174,40373992177,3,1521,1343,-30
40375573813,40375573818,5,1395,762,-30
40379201636,40379201640,4,1399,1011,-30
40381499517,40381499523,6,1907,1333,-30
40381711438,40381711445,7,2896,1533,-30
40382002097,40382002101,4,1685,1214,-30
40383016302,40383016309,7,2784,1557,-30
40383641206,40383641202,-4,837,1850,-30
40386280358,40386280363,5,2026,759,-30
40387522435,40387522440,5,1601,778,-30
40387976704,40387976689,-15,1022,2951,-30
40388678837,40388678840,3,1796,1066,-30
40389503672,40389503677,5,1946,1079,-30
40390032182,40390032185,3,2181,1199,-30
40391816864,40391816871,7,1209,894,-30
40393775427,40393775433,6,1996,1125,-30
40394331405,40394331407,2,1984,1008,-30
40394639457,40394639441,-16,1568,660,-30
40399364642,40399364647,5,2527,1261,-30
40399857805,40399857817,12,1876,1658,-30
40403418661,40403418665,4,2803,1429,-30
40404220179,40404220183,4,2179,1196,-30
40405521057,40405521063,6,2934,1202,-30
40405773243,40405773249,6,2016,1669,-30
40406347074,40406347082,8,12566,24762,-30
40407031746,40407031752,6,2410,1592,-30
40409814175,40409814181,6,2173,1416,-30
40410062110,40410062121,11,1147,1337,-30
40411008834,40411008842,8,1626,1179,-30
40412380596,40412380603,7,2640,1329,-30
40412553145,40412553150,5,2632,1371,-30
40413619665,40413619670,5,2410,1219,-30
40415232615,40415232619,4,868,577,-30
40417468597,40417468603,6,2013,1374,-30
40421859806,40421859812,6,1629,916,-30
40424224691,40424224695,4,2899,1583,-30
40432924058,40432924062,4,1397,1207,-30
40433548478,40433548483,5,2506,1422,-30
40435005628,40435005635,7,13259,22330,-30
40442836024,40442836029,5,2310,1540,-30
40444820740,40444820746,6,3548,1358,-30
40446144645,40446144651,6,3022,1466,-30
40446258017,40446258023,6,1307,707,-30
40447942590,40447942598,8,1739,1464,-30
40449359098,40449359103,5,1657,1259,-30
40451072846,40451072852,6,2070,1085,-30
40451508278,40451508282,4,2412,1552,-30
40452152463,40452152467,4,1948,1446,-30
40452480469,40452480474,5,1343,749,-30
40456324254,40456324258,4,2002,1460,-30
40457567208,40457567214,6,2181,1375,-30
40459530374,40459530382,8,11586,31590,-30
40459878767,40459878763,-4,1240,2539,-30
40461777978,40461777983,5,1578,1074,-30
40473355923,40473355919,-4,1337,3163,-30
40473550737,40473550731,-6,856,4101,-30
40475759522,40475759526,4,4892,1284,-30
40478715437,40478715442,5,2226,1545,-30
40481400594,40481400598,4,1573,1153,-30
40482823409,40482823414,5,2251,1450,-30
40484190287,40484190292,5,2712,1416,-30
40487422129,40487422134,5,2227,1044,-30
40491358830,40491358835,5,2579,1398,-30
40500805110,40500805115,5,1772,1624,-30
40502311203,40502311206,3,2890,1782,-30
40511225051,40511225057,6,2447,1111,-30
40511979146,40511979149,3,1695,1292,-30
40516420086,40516420090,4,2966,1255,-30
40520782757,40520782759,2,1295,1187,-30
40526411445,40526411449,4,1010,1163,-30
40531298574,40531298557,-17,2613,1114,-30
40532962793,40532962790,-3,2240,4432,-30
40533069622,40533069627,5,1865,1039,-30
40534684047,40534684025,-22,2148,1032,-30
40535302792,40535302797,5,2648,1637,-30
40537534846,40537534850,4,2404,2116,-30
40544060149,40544060153,4,2302,1556,-30
40544578861,40544578866,5,3739,1824,-30
40549160110,40549160114,4,1993,1493,-30
40549926906,40549926910,4,2081,2122,-30
40550279539,40550279545,6,2087,1436,-30
40550937347,40550937353,6,1948,887,-30
40555216551,40555216552,1,16120,5952,-30
40558008607,40558008613,6,2187,1318,-30
40558034183,40558034189,6,2778,1635,-30
40561413725,40561413744,19,801,151,-30
40563576186,40563576194,8,2186,1126,-30
40565279995,40565280000,5,2432,1521,-30
40565368487,40565368490,3,862,130,-30
40566209557,40566209550,-7,135,879,-30
40567460035,40567460040,5,2217,1603,-30
40572062955,40572062938,-17,2216,791,-30
40572793621,40572793625,4,1928,1767,-30
40580728212,40580728216,4,2524,1487,-30
40581856580,40581856582,2,2316,1409,-30
40583741054,40583741059,5,2234,1245,-30
40585999393,40585999398,5,2927,1350,-30
40586132534,40586132539,5,1681,944,-30
40587571161,40587571167,6,2601,953,-30
40587714139,40587714145,6,1805,1351,-30
40592212362,40592212365,3,1802,1349,-30
40594205084,40594205089,5,1595,805,-30
40594668654,40594668659,5,2140,1123,-30
40601267090,40601267095,5,1633,1263,-30
40602659882,40602659877,-5,1208,3548,-30
40605545878,40605545893,15,673,2794,-30
40608377201,40608377199,-2,1635,3714,-30
40609380286,40609380292,6,2470,1594,-30
40610052408,40610052414,6,2917,1697,-30
40613133617,40613133622,5,3314,1480,-30
40618124929,40618124934,5,2367,1207,-30
40623037881,40623037887,6,5701,2640,-30
40623707974,40623707979,5,2290,1545,-30
40624582470,40624582475,5,2304,1368,-30
40624759556,40624759562,6,1783,1124,-30
40627038347,40627038353,6,1905,1635,-30
40632155454,40632155461,7,2520,908,-30
40635630844,40635630849,5,3087,1557,-30
40644811626,40644811631,5,2478,1153,-30
40645721186,40645721203,17,2123,1492,-30
40646547178,40646547183,5,1461,883,-30
40647306198,40647306178,-20,2332,1488,-30
40651699852,40651699859,7,1868,1377,-30
40652007379,40652007384,5,1917,1269,-30
40653111210,40653111215,5,2252,1160,-30
40653756002,40653756006,4,2598,1013,-30
40658978086,40658978092,6,2038,1131,-30
40659895897,40659895902,5,2278,1135,-30
40665668374,40665668379,5,2574,1325,-30
40672245645,40672245649,4,2207,1225,-30
40675724667,40675724671,4,2112,1225,-30
40676037183,40676037169,-14,988,305,-30
40678095141,40678095144,3,2529,1629,-30
40686748441,40686748445,4,2556,1272,-30
40690946055,40690946060,5,1931,819,-30
40691038718,40691038724,6,2863,927,-30
40695323805,40695323808,3,2748,1626,-30
40697368093,40697368099,6,1861,1329,-30
40699078360,40699078363,3,1609,1018,-30
40699340606,40699340610,4,1871,967,-30
40701916497,40701916502,5,1763,1183,-30
40706562446,40706562450,4,2367,1690,-30
40711489631,40711489635,4,1870,999,-30
40711530233,40711530216,-17,2422,1031,-30
40712955663,40712955665,2,1492,1184,-30
40715012541,40715012547,6,2889,1322,-30
40715612418,40715612422,4,1936,1110,-30
40716169155,40716169159,4,2310,1351,-30
40718586777,40718586783,6,1993,1559,-30
40721710345,40721710353,8,2559,1109,-30
40722018017,40722018022,5,1064,693,-30
40723853373,40723853379,6,1531,1193,-30
40725610002,40725610007,5,1541,1212,-30
40727408806,40727408810,4,1035,809,-30
40733027930,40733027935,5,2370,1339,-30
40737350483,40737350488,5,12118,5404,-30
40738330886,40738330892,6,2142,1378,-30
40739390366,40739390363,-3,1279,1064,-30
40744616280,40744616283,3,1920,651,-30
40745882250,40745882256,6,1506,1284,-30
40750997293,40750997306,13,2036,1144,-30
40751771621,40751771627,6,1983,868,-30
40753256869,40753256873,4,1606,908,-30
40754577728,40754577715,-13,995,179,-30
40757119136,40757119143,7,2379,1262,-30
40769676860,40769676866,6,2224,1332,-30
40770875562,40770875556,-6,1155,3176,-30
40774880488,40774880495,7,1560,1028,-30
40774967282,40774967287,5,1934,1053,-30
40775880597,40775880601,4,1934,923,-30
40778571341,40778571346,5,2666,1188,-30
40790058331,40790058333,2,1947,2639,-30
40790529836,40790529839,3,2188,1145,-30
40790631702,40790631705,3,2153,1664,-30
40793317123,40793317126,3,1544,1125,-30
40793797897,40793797902,5,2258,1370,-30
40797746525,40797746526,1,31403,31544,-30
40798234183,40798234188,5,1444,1139,-30
40798413270,40798413251,-19,647,310,-30
40799778591,40799778586,-5,3296,9845,-30
40801235673,40801235678,5,2023,1130,-30
40802005411,40802005417,6,1424,1006,-30
40806127937,40806127941,4,3636,1285,-30
40809556288,40809556292,4,2215,1671,-30
40811112249,40811112253,4,2132,1520,-30
40812352246,40812352253,7,1790,1356,-30
40813210890,40813210895,5,3203,1317,-30
40814089138,40814089141,3,2247,1796,-30
40815543805,40815543811,6,1654,1403,-30
40816690730,40816690736,6,3171,2091,-30
40819186534,40819186539,5,2000,1341,-30
40821667634,40821667638,4,2051,1287,-30
40826839678,40826839674,-4,1128,3550,-30
40831092687,40831092681,-6,929,3462,-30
40838013923,40838013929,6,2746,1662,-30
40838182303,40838182303,0,1209,2415,-30
40838852265,40838852270,5,1569,1239,-30
40841866713,40841866718,5,1771,1095,-30
40843012187,40843012178,-9,42620,12092,-30
40846181338,40846181343,5,2429,1415,-30
40846223516,40846223522,6,2582,1486,-30
40847849273,40847849277,4,2806,1816,-30
40852661170,40852661174,4,3234,1821,-30
40860557930,40860557934,4,2326,1736,-30
40862593441,40862593444,3,2115,1149,-30
40862933650,40862933657,7,1144,845,-30
40863928271,40863928291,20,2350,1444,-30
40865009402,40865009406,4,2394,738,-30
40868473197,40868473202,5,1983,1383,-30
40870526902,40870526907,5,2098,1266,-30
40875356325,40875356330,5,1891,1485,-30
40880500289,40880500295,6,2772,1490,-30
40880777627,40880777609,-18,1657,1245,-30
40881952068,40881952079,11,14434,24123,-30
40882332506,40882332511,5,2262,1204,-30
40882420047,40882420050,3,2946,1643,-30
40884918770,40884918776,6,3080,1870,-30
40889432535,40889432541,6,2038,1633,-30
40889498753,40889498758,5,2795,1390,-30
40891821378,40891821357,-21,2737,1857,-30
40893423993,40893423998,5,2701,1272,-30
40894088001,40894088006,5,1817,1287,-30
40894473082,40894473086,4,2127,1539,-30
40894994731,40894994726,-5,1106,4807,-30
40895647426,40895647433,7,2241,1018,-30
40896667247,40896667251,4,1507,952,-30
40900974638,40900974643,5,2542,1155,-30
40909430134,40909430138,4,1843,1452,-30
40910335435,40910335439,4,1880,981,-30
40910416950,40910416960,10,1932,792,-30
40915268709,40915268699,-10,15149,27563,-30
40918312365,40918312369,4,2410,1375,-30
40920583918,40920583899,-19,693,376,-30
40921048758,40921048765,7,1862,988,-30
40921858263,40921858267,4,1881,1409,-30
40933159457,40933159460,3,2194,1388,-30
40934086938,40934086943,5,2480,1154,-30
40938217436,40938217439,3,2495,928,-30
40938606354,40938606359,5,2178,1399,-30
40946065927,40946065921,-6,1231,4793,-30
40948545619,40948545622,3,1957,1281,-30
40951478902,40951478906,4,2256,1354,-30
40952987973,40952987977,4,2490,1203,-30
40954673358,40954673361,3,1602,1400,-30
40959459443,40959459441,-2,2928,5126,-30
40965507559,40965507564,5,1742,1186,-30
40968978602,40968978607,5,1504,984,-30
40971520421,40971520425,4,2398,977,-30
40972975742,40972975746,4,1651,1101,-30
40973540158,40973540162,4,1995,1057,-30
40975963438,40975963444,6,1372,678,-30
40980703326,40980703329,3,2216,1409,-30
40982335448,40982335455,7,2886,1411,-30
40986173174,40986173178,4,1339,822,-30
40996768470,40996768474,4,1603,732,-30
40998817031,40998817034,3,2563,2032,-30
41003113506,41003113514,8,2203,1337,-30
41006819982,41006819986,4,2489,1565,-30
41010806254,41010806257,3,1347,846,-30
41015686853,41015686852,-1,2763,4415,-30
41022936791,41022936795,4,1606,1136,-30
41024240338,41024240354,16,2240,1320,-30
41029924714,41029924721,7,1234,1057,-30
41041752522,41041752527,5,2623,1448,-30
41041998325,41041998308,-17,1381,1073,-30
41043987662,41043987666,4,2123,1497,-30
41044857656,41044857660,4,2600,1556,-30
41048288705,41048288711,6,1384,918,-30
41050371009,41050371015,6,2011,1052,-30
41050805553,41050805559,6,1566,1300,-30
41051168973,41051168978,5,2054,1596,-30
41051407862,41051407866,4,1291,871,-30
41052492429,41052492432,3,1879,1220,-30
41053499243,41053499247,4,1724,906,-30
41054239556,41054239563,7,2661,1217,-30
41058481464,41058481469,5,2918,1233,-30
41063472420,41063472427,7,2998,1016,-30
41063999022,41063999026,4,2806,1841,-30
41067110031,41067110035,4,2047,1752,-30
41070457153,41070457163,10,17726,22208,-30
41071331585,41071331590,5,3404,1607,-30
41073047853,41073047858,5,1873,979,-30
41075262477,41075262482,5,3437,1905,-30
41079522338,41079522342,4,2047,1371,-30
41079767154,41079767161,7,2331,915,-30
41081904970,41081904976,6,2264,1135,-30
41082149286,41082149290,4,2230,1764,-30
41085902634,41085902640,6,2162,1663,-30
41088105505,41088105507,2,2040,918,-30
41090663404,41090663407,3,1634,1005,-30
41093014635,41093014642,7,1700,1042,-30
41094175833,41094175838,5,1847,1296,-30
41095399269,41095399273,4,2172,1987,-30
41097168933,41097168939,6,2385,1260,-30
41097227395,41097227378,-17,1132,517,-30
41105376378,41105376382,4,2785,1928,-30
41107592045,41107592049,4,2222,1291,-30
41107900760,41107900763,3,2183,1420,-30
41108030663,41108030676,13,659,122,-30
41111036390,41111036395,5,2232,1449,-30
41113622777,41113622782,5,2197,1303,-30
41118672904,41118672901,-3,599,2146,-30
41119699441,41119699425,-16,1357,1202,-30
41119728763,41119728767,4,2442,1440,-30
41120981458,41120981464,6,3047,1609,-30
41121692819,41121692824,5,1656,1417,-30
41126055086,41126055093,7,2724,1288,-30
41128120450,41128120453,3,2203,1929,-30
41130031566,41130031574,8,2531,1165,-30
41130126505,41130126489,-16,727,839,-30
41130613513,41130613512,-1,33889,54466,-30
41132156390,41132156397,7,2716,1661,-30
41133213781,41133213786,5,1861,871,-30
41134271499,41134271502,3,1229,1798,-30
41134664359,41134664363,4,2095,887,-30
41134948103,41134948113,10,2768,1383,-30
41135334923,41135334929,6,2328,1487,-30
41139795932,41139795937,5,2953,1428,-30
41140533578,41140533583,5,2884,1509,-30
41142636646,41142636654,8,2362,1154,-30
41143124321,41143124327,6,2258,1397,-30
41148626878,41148626882,4,1610,1306,-30
41155308454,41155308458,4,1697,1776,-30
41157101415,41157101420,5,2274,1572,-30
41162038662,41162038667,5,1809,842,-30
41164736342,41164736344,2,1829,1866,-30
41166443130,41166443137,7,854,360,-30
41167883026,41167883031,5,2537,1712,-30
41169528808,41169528813,5,1889,1514,-30
41175717451,41175717456,5,2850,1900,-30
41177141493,41177141497,4,1902,1410,-30
41177203553,41177203540,-13,1384,759,-30
41177450072,41177450078,6,2044,1210,-30
41178550435,41178550449,14,859,279,-30
41181939474,41181939459,-15,1134,854,-30
41182356672,41182356676,4,2459,1534,-30
41185693361,41185693364,3,2042,1477,-30
41194297931,41194297936,5,3022,1600,-30
41202544349,41202544354,5,1568,1692,-30
41208101971,41208101976,5,1108,1101,-30
41208738270,41208738288,18,578,196,-30
41210165885,41210165891,6,2061,1256,-30
41210601537,41210601542,5,1798,1630,-30
41212317218,41212317222,4,2319,1175,-30
41212972702,41212972684,-18,1612,1557,-30
41213543226,41213543230,4,1339,1262,-30
41215072320,41215072326,6,1889,1218,-30
41215507235,41215507240,5,2542,1372,-30
41221632990,41221632996,6,2063,1201,-30
41221717127,41221717113,-14,1123,363,-30
41223589826,41223589831,5,1737,823,-30
41227978441,41227978447,6,2149,1160,-30
41228174100,41228174115,15,2183,1191,-30
41228278397,41228278403,6,2668,1444,-30
41228724701,41228724707,6,1526,1271,-30
41229133497,41229133501,4,1842,1325,-30
41229927983,41229927989,6,2429,1540,-30
41231243226,41231243232,6,1863,1396,-30
41231546927,41231546933,6,2289,1216,-30
41231768808,41231768814,6,2334,1619,-30
41236919366,41236919368,2,6582,17144,-30
41237547635,41237547639,4,2333,1429,-30
41238159914,41238159917,3,2193,1341,-30
41241000408,41241000414,6,1983,1404,-30
41243371199,41243371206,7,2134,1188,-30
41249515774,41249515778,4,2739,1381,-30
41250209544,41250209548,4,1938,1631,-30
41250616660,41250616666,6,2358,1401,-30
41254345921,41254345926,5,2716,1087,-30
41259603097,41259603102,5,1629,1306,-30
41260276665,41260276669,4,2423,1599,-30
41261873043,41261873046,3,1626,1225,-30
41263212525,41263212531,6,2576,1393,-30
41263816310,41263816314,4,2279,1473,-30
41264381111,41264381117,6,2572,1052,-30
41268491739,41268491743,4,1668,1066,-30
41271654414,41271654419,5,2012,1598,-30
41272977818,41272977825,7,2354,1071,-30
41276393526,41276393524,-2,1815,2792,-30
41279149006,41279149023,17,16485,52519,-30
41283867598,41283867603,5,1622,1254,-30
41285252543,41285252545,2,1873,2143,-30
41285916464,41285916467,3,1966,1166,-30
41288340771,41288340775,4,1451,1007,-30
41289456882,41289456888,6,3635,1748,-30
41291348567,41291348573,6,2439,1274,-30
41296849308,41296849312,4,1441,946,-30
41306018033,41306018038,5,2630,1213,-30
41307270802,41307270807,5,2612,1925,-30
41308631927,41308631930,3,3294,2035,-30
41312384715,41312384720,5,2732,2025,-30
41315161772,41315161777,5,1551,1244,-30
41315511956,41315511961,5,3110,1437,-30
41316388171,41316388174,3,1482,898,-30
41320337883,41320337889,6,1636,1273,-30
41323507585,41323507591,6,1919,946,-30
41324256866,41324256871,5,2289,1380,-30
41325871536,41325871539,3,2511,1208,-30
41325974753,41325974762,9,2411,803,-30
41327402954,41327402940,-14,1608,674,-30
41328389972,41328389978,6,2128,1465,-30
41330054682,41330054686,4,2195,1180,-30
41331265998,41331266004,6,2132,1162,-30
41331385797,41331385801,4,1841,1240,-30
41332786510,41332786516,6,2602,1471,-30
41333229828,41333229834,6,2544,2091,-30
41333818846,41333818853,7,4050,1102,-30
41338245644,41338245650,6,2046,1659,-30
41339061958,41339061963,5,1526,1238,-30
41342674734,41342674739,5,3238,1023,-30
41343434798,41343434803,5,3163,1663,-30
41346241713,41346241715,2,1068,1589,-30
41346888857,41346888863,6,2787,1307,-30
41349676557,41349676562,5,3361,1459,-30
41350381673,41350381676,3,1825,1163,-30
41350637811,41350637812,1,2889,3722,-30
41352409691,41352409695,4,3492,1740,-30
41353544353,41353544358,5,2074,1374,-30
41357448333,41357448339,6,2936,1349,-30
41360698794,41360698799,5,2461,1293,-30
41361872453,41361872458,5,2499,1287,-30
41362712506,41362712510,4,1986,1330,-30
41363000786,41363000772,-14,1703,602,-30
41367034550,41367034554,4,2654,1063,-30
41367171514,41367171519,5,2288,1587,-30
41369662668,41369662669,1,1374,1025,-30
41369744720,41369744714,-6,41313,15748,-30
41370040176,41370040181,5,1788,1686,-30
41372881530,41372881529,-1,1873,4572,-30
41374630517,41374630522,5,2171,1424,-30
41376158855,41376158860,5,2335,1032,-30
41377659139,41377659143,4,1911,1106,-30
41380528884,41380528886,2,2204,1832,-30
41380746322,41380746326,4,2908,1665,-30
41381348798,41381348802,4,1271,609,-30
41382826414,41382826421,7,3727,1258,-30
41382949027,41382949034,7,2758,1268,-30
41389596581,41389596582,1,1842,1333,-30
41389958814,41389958818,4,2354,1295,-30
41390077550,41390077557,7,2403,1491,-30
41391301110,41391301117,7,2091,1473,-30
41393955921,41393955925,4,2309,1328,-30
41394970595,41394970599,4,1857,1286,-30
41396246346,41396246328,-18,731,456,-30
41401673217,41401673217,0,1476,2477,-30
41402084791,41402084796,5,1564,730,-30
41408859932,41408859937,5,1138,655,-30
41419479423,41419479430,7,15843,16039,-30
41423881589,41423881593,4,2204,1372,-30
41430190666,41430190670,4,2511,1204,-30
41430300218,41430300222,4,1913,838,-30
41430607521,41430607539,18,1997,1102,-30
41431837391,41431837390,-1,1634,2978,-30
41432189021,41432189024,3,1857,1274,-30
41435508581,41435508561,-20,1480,504,-30
41437056305,41437056310,5,2391,1476,-30
41438500650,41438500653,3,1431,1296,-30
41440002950,41440002965,15,15331,43306,-30
41440450033,41440450038,5,2000,1402,-30
41441673582,41441673587,5,2348,1364,-30
41442254041,41442254044,3,2040,1357,-30
41442586660,41442586666,6,1327,803,-30
41445248682,41445248685,3,1703,1062,-30
41446477685,41446477689,4,2316,1336,-30
41448468833,41448468837,4,2488,1019,-30
41452413199,41452413176,-23,710,398,-30
41453595858,41453595857,-1,630,111,-30
41461839079,41461839083,4,2703,1693,-30
41465431705,41465431710,5,3203,1672,-30
41465730106,41465730110,4,1745,650,-30
41477723713,41477723713,0,2266,2876,-30
41478525879,41478525885,6,2133,1428,-30
41478612605,41478612610,5,2488,1432,-30
41486809891,41486809898,7,1940,973,-30
41487460144,41487460130,-14,2444,1088,-30
41495615692,41495615695,3,2586,1189,-30
41495664204,41495664207,3,1328,1200,-30
41496204938,41496204945,7,1663,1512,-30
41498227781,41498227785,4,2248,1435,-30
41498477570,41498477554,-16,2242,1183,-30
41501869777,41501869782,5,2605,1272,-30
41503732238,41503732242,4,1585,769,-30
41505408334,41505408340,6,3041,1315,-30
41507662774,41507662778,4,2216,1516,-30
41508024162,41508024167,5,1835,1303,-30
41511103862,41511103871,9,3351,1105,-30
41514320502,41514320507,5,3185,1639,-30
41516830713,41516830718,5,1419,1495,-30
41518126658,41518126652,-6,1788,5425,-30
41519258197,41519258202,5,1458,936,-30
41519389620,41519389624,4,1537,1288,-30
41519662654,41519662659,5,2288,1191,-30
41521316238,41521316241,3,2762,1531,-30
41522608554,41522608558,4,2368,1284,-30
41524965738,41524965745,7,3022,1633,-30
41537637398,41537637402,4,2209,966,-30
41541413438,41541413443,5,3954,1923,-30
41542683994,41542683999,5,2017,1289,-30
41548713559,41548713563,4,1381,1264,-30
41550567607,41550567611,4,2157,1422,-30
41550649153,41550649158,5,1978,1428,-30
41556287053,41556287059,6,1981,1215,-30
41556596041,41556596045,4,2150,1315,-30
41558260113,41558260118,5,2045,1255,-30
41558514758,41558514778,20,2458,1274,-30
41566924493,41566924498,5,2959,1786,-30
41567708432,41567708437,5,2056,1197,-30
41569917874,41569917878,4,5826,3116,-30
41574948223,41574948229,6,2482,1474,-30
41575990038,41575990030,-8,1257,1536,-30
41582881381,41582881386,5,1423,994,-30
41584006141,41584006146,5,1643,1691,-30
41584166148,41584166151,3,1816,1383,-30
41588531861,41588531861,0,20033,29100,-30
41589332901,41589332907,6,2688,1476,-30
41594748751,41594748755,4,1245,931,-30
41595026754,41595026761,7,2832,1572,-30
41596634094,41596634101,7,2193,1074,-30
41597108434,41597108429,-5,1010,2556,-30
41597752240,41597752246,6,1465,1336,-30
41597959826,41597959829,3,2021,1584,-30
41605458571,41605458576,5,3627,1348,-30
41606272958,41606272952,-6,631,3650,-30
41607524356,41607524359,3,2151,1557,-30
41607620494,41607620499,5,2722,1535,-30
41609521959,41609521957,-2,659,1924,-30
41612717697,41612717702,5,1868,1358,-30
41613070453,41613070458,5,1794,936,-30
41613235186,41613235189,3,2324,1405,-30
41614321428,41614321433,5,4079,1851,-30
41616107574,41616107578,4,2548,1591,-30
41619088870,41619088874,4,5831,2316,-30
41623750594,41623750601,7,2397,1461,-30
41626511406,41626511409,3,1058,759,-30
41627568466,41627568471,5,2351,1702,-30
41628660150,41628660155,5,3033,1469,-30
41629763601,41629763607,6,1906,1497,-30
41629810521,41629810507,-14,2036,1478,-30
41632063211,41632063219,8,2608,1280,-30
41633205282,41633205288,6,2599,1183,-30
41633811551,41633811554,3,2803,1077,-30
41637767045,41637767050,5,3341,997,-30
41640072124,41640072130,6,3286,1323,-30
41647930038,41647930042,4,2232,1905,-30
41650709794,41650709802,8,2587,1292,-30
41660149750,41660149755,5,1653,1575,-30
41660921157,41660921164,7,2803,1534,-30
41661304128,41661304132,4,3456,1606,-30
41665193414,41665193415,1,1050,908,-30
41668931925,41668931930,5,2362,1401,-30
41669685050,41669685054,4,1440,1023,-30
41669950250,41669950253,3,2394,2486,-30
41680374426,41680374431,5,1753,1186,-30
41684672147,41684672151,4,3281,1755,-30
41690344196,41690344202,6,2436,1299,-30
41690816170,41690816174,4,1973,1107,-30
41692632830,41692632837,7,1763,1131,-30
41693866104,41693866106,2,1632,837,-30
41695148831,41695148837,6,3012,1660,-30
41696680931,41696680931,0,1262,1757,-30
41697195615,41697195618,3,1996,1414,-30
41700357390,41700357395,5,1168,669,-30
41703155149,41703155149,0,1304,1924,-30
41703666598,41703666602,4,2240,1521,-30
41705018450,41705018456,6,2381,1266,-30
41708183209,41708183213,4,2093,903,-30
41712418694,41712418698,4,3081,1370,-30
41716852043,41716852050,7,1625,732,-30
41718411332,41718411337,5,2064,1390,-30
41726459674,41726459677,3,2980,1766,-30
41728643242,41728643248,6,3018,1340,-30
41730674318,41730674322,4,2275,1079,-30
41737652177,41737652183,6,2670,1734,-30
41738971373,41738971371,-2,1468,3083,-30
41740912001,41740912006,5,1936,1741,-30
41741243909,41741243914,5,2077,1636,-30
41741843392,41741843397,5,2110,1107,-30
41742103721,41742103725,4,3293,1695,-30
41744029034,41744029038,4,2271,1256,-30
41749638008,41749638015,7,2394,1075,-30
41756402081,41756402087,6,2057,1214,-30
41758636538,41758636542,4,2596,1077,-30
41758942073,41758942076,3,1584,1498,-30
41759073490,41759073497,7,2019,1434,-30
41760260426,41760260431,5,1734,1072,-30
41761245289,41761245293,4,2697,1560,-30
41764823833,41764823837,4,1514,1661,-30
41765735308,41765735311,3,1611,850,-30
41768002242,41768002245,3,1736,1320,-30
41770184391,41770184395,4,2570,1187,-30
41771129414,41771129418,4,2572,1637,-30
41776690858,41776690862,4,2652,1120,-30
41780936949,41780936953,4,2232,1880,-30
41784373005,41784373008,3,2071,1582,-30
41787085204,41787085207,3,3002,996,-30
41787891852,41787891856,4,2673,1200,-30
41798496514,41798496519,5,2403,1489,-30
41798671190,41798671199,9,2205,1111,-30
41800722335,41800722340,5,2650,1665,-30
41801637746,41801637750,4,3214,2379,-30
41801808634,41801808638,4,947,1619,-30
41803609206,41803609211,5,2319,1376,-30
41806548105,41806548110,5,2751,1462,-30
41808158322,41808158327,5,1039,1108,-30
41809979692,41809979690,-2,2933,4839,-30
41813429609,41813429614,5,1478,1077,-30
41817555787,41817555785,-2,1106,3375,-30
41819921489,41819921493,4,2626,1700,-30
41820573597,41820573595,-2,980,152,-30
41821639517,41821639510,-7,1258,4494,-30
41837237155,41837237159,4,2762,1605,-30
41839313646,41839313639,-7,1703,6531,-30
41840516885,41840516890,5,2502,1474,-30
41842259291,41842259294,3,1526,1291,-30
41843047705,41843047710,5,2998,1790,-30
41843365680,41843365686,6,1064,811,-30
41851082442,41851082461,19,1306,905,-30
41853256985,41853256987,2,1823,1158,-30
41853745834,41853745838,4,1721,1142,-30
41854569773,41854569776,3,2439,1909,-30
41857561601,41857561605,4,1112,1262,-30
41857945682,41857945686,4,1389,1096,-30
41858451776,41858451781,5,2838,1447,-30
41859811119,41859811122,3,2307,1520,-30
41861574725,41861574735,10,1902,999,-30
41867617305,41867617309,4,1900,1604,-30
41869918874,41869918880,6,2819,1453,-30
41870816170,41870816174,4,1498,1151,-30
41873315806,41873315811,5,2919,1024,-30
41873655091,41873655086,-5,558,1661,-30
41875505719,41875505725,6,3620,1578,-30
41885412344,41885412350,6,2742,1199,-30
41888282398,41888282402,4,2667,1592,-30
41888675999,41888675993,-6,1643,7379,-30
41889085090,41889085094,4,2282,1186,-30
41889311977,41889311979,2,2961,3392,-30
41896498413,41896498418,5,2379,1318,-30
41900220262,41900220267,5,2954,1578,-30
41903316804,41903316809,5,2632,1379,-30
41904791326,41904791332,6,1845,1899,-30
41913290854,41913290859,5,2223,1338,-30
41916459227,41916459232,5,2416,1324,-30
41926983798,41926983802,4,2004,1371,-30
41927443152,41927443139,-13,1396,159,-30
41929383519,41929383526,7,2114,1391,-30
41929662297,41929662302,5,2129,1187,-30
41930010021,41930010025,4,1935,1305,-30
41930069154,41930069137,-17,1289,368,-30
41932101062,41932101067,5,2715,1072,-30
41936766947,41936766949,2,1653,1502,-30
41939863650,41939863658,8,2626,955,-30
41942315482,41942315487,5,1240,1099,-30
41943804027,41943804030,3,1523,1205,-30
41944992980,41944992984,4,2485,1342,-30
41947265086,41947265083,-3,1790,2039,-30
41947427466,41947427469,3,1631,1301,-30
41947524993,41947524998,5,2220,1109,-30
41948787075,41948787070,-5,1483,3750,-30
41949261087,41949261093,6,1593,1398,-30
41952078207,41952078215,8,5210,2318,-30
41959371870,41959371873,3,1473,1118,-30
41960613801,41960613806,5,2520,1435,-30
41962949831,41962949837,6,3152,1185,-30
41963625756,41963625761,5,2118,1182,-30
41964624230,41964624230,0,4149,3125,-30
41974452830,41974452834,4,2859,1683,-30
41976996670,41976996674,4,2453,1464,-30
41977934519,41977934522,3,1700,1363,-30
41978074498,41978074503,5,2698,1605,-30
41979532053,41979532058,5,2172,1157,-30
41980118701,41980118705,4,1339,1121,-30
41982136405,41982136411,6,2336,1154,-30
41982291818,41982291821,3,1494,2228,-30
41984814530,41984814534,4,1500,856,-30
41989807537,41989807543,6,2316,1196,-30
41989905918,41989905922,4,1771,975,-30
41992754551,41992754557,6,3494,1697,-30
41995107525,41995107531,6,2537,2109,-30
41997388294,41997388299,5,1808,1322,-30
41998418117,41998418122,5,1915,1200,-30
42000771994,42000771999,5,2915,1124,-30
42001250291,42001250290,-1,848,188,-30
42008489683,42008489688,5,2514,1202,-30
42008897034,42008897037,3,3224,1715,-30
42011327045,42011327049,4,2961,2051,-30
42011871406,42011871395,-11,607,369,-30
42014722966,42014722971,5,2768,1026,-30
42014989917,42014989923,6,2644,1986,-30
42016394469,42016394474,5,1557,1211,-30
42018216953,42018216955,2,1497,1502,-30
42022241520,42022241524,4,3128,1616,-30
42023776482,42023776487,5,2167,1220,-30
42024424544,42024424566,22,1394,2388,-30
42024725410,42024725416,6,4466,1506,-30
42024989582,42024989586,4,1457,888,-30
42032000299,42032000305,6,1816,1104,-30
42034506246,42034506252,6,1842,1081,-30
42034539988,42034539970,-18,1472,804,-30
42037248755,42037248759,4,1693,1144,-30
42045169121,42045169107,-14,3867,13057,-30
42051151796,42051151802,6,1791,1293,-30
42053663161,42053663167,6,2113,1139,-30
42055529071,42055529075,4,1415,1101,-30
42058997959,42058997963,4,1787,1055,-30
42060188429,42060188433,4,2899,1251,-30
42060928365,42060928376,11,1569,1509,-30
42061585303,42061585282,-21,595,191,-30
42072496161,42072496164,3,2211,1822,-30
42072908853,42072908857,4,2057,1927,-30
42073625550,42073625554,4,2036,1472,-30
42080523854,42080523852,-2,1165,2192,-30
42080572938,42080572943,5,2253,992,-30
42089291856,42089291857,1,3102,3142,-30
42089460668,42089460673,5,2113,1451,-30
42095808450,42095808455,5,2191,1529,-30
42101436301,42101436306,5,2226,1887,-30
42101626282,42101626289,7,2752,1448,-30
42103200333,42103200340,7,8431,2550,-30
42109161554,42109161560,6,2149,1797,-30
42116191430,42116191434,4,2179,1001,-30
42116671082,42116671087,5,2295,1323,-30
42118667787,42118667794,7,1110,1197,-30
42121877106,42121877109,3,2174,1236,-30
42122908750,42122908757,7,2778,1882,-30
42128826679,42128826658,-21,729,614,-30
42131725286,42131725290,4,2353,1602,-30
42133477966,42133477970,4,4187,3203,-30
42142245674,42142245670,-4,2147,4820,-30
42144592882,42144592887,5,2139,1283,-30
42146498809,42146498828,19,810,394,-30
42147748027,42147748034,7,2657,920,-30
42150114703,42150114707,4,1955,1125,-30
42154437467,42154437473,6,2329,1446,-30
42155564327,42155564332,5,3102,1914,-30
42158992697,42158992702,5,2327,978,-30
42160421615,42160421619,4,2251,1382,-30
42161529140,42161529143,3,1657,857,-30
42162409885,42162409891,6,3055,1224,-30
42164396209,42164396215,6,2574,1751,-30
42165770250,42165770255,5,2645,1485,-30
42169122448,42169122454,6,3229,1992,-30
42169647878,42169647882,4,2122,950,-30
42172314411,42172314413,2,2752,3377,-30
42172677019,42172677027,8,2463,1159,-30
42173540504,42173540520,16,2303,1276,-30
42175460493,42175460499,6,2662,1179,-30
42176759616,42176759622,6,2510,1243,-30
42180686030,42180686036,6,2188,1220,-30
42180866627,42180866633,6,1974,1338,-30
42180978529,42180978537,8,2722,1244,-30
42181614306,42181614310,4,2854,1922,-30
42181746552,42181746558,6,2876,1429,-30
42182775050,42182775054,4,2602,1743,-30
42183959388,42183959394,6,1984,1105,-30
42184034906,42184034912,6,2139,1646,-30
42186844825,42186844830,5,2692,1601,-30
42189830829,42189830833,4,1633,1036,-30
42190896914,42190896920,6,3042,988,-30
42193996960,42193996966,6,2838,1531,-30
42194530042,42194530037,-5,999,4186,-30
42197181236,42197181242,6,2894,709,-30
42203302100,42203302103,3,2468,1622,-30
42206131231,42206131234,3,2594,1507,-30
42206504185,42206504190,5,1213,689,-30
42206580058,42206580048,-10,1652,157,-30
42207596341,42207596346,5,2331,1396,-30
42211612034,42211612041,7,2074,1121,-30
42213214518,42213214499,-19,1570,876,-30
42220673487,42220673490,3,1103,1387,-30
42220976618,42220976622,4,1691,1284,-30
42221234357,42221234361,4,1271,884,-30
42223442542,42223442544,2,2593,2306,-30
42224038329,42224038335,6,2773,1059,-30
42228265674,42228265680,6,1918,1277,-30
42228676618,42228676623,5,1180,877,-30
42230086576,42230086579,3,2484,1140,-30
42230607678,42230607683,5,2331,1377,-30
42235923590,42235923594,4,2238,1148,-30
42236198648,42236198657,9,2133,1210,-30
42239050725,42239050730,5,2828,1697,-30
42241408010,42241408018,8,2296,1165,-30
42244727982,42244727987,5,1872,1246,-30
42249348460,42249348466,6,3854,1898,-30
42251876147,42251876154,7,3676,1492,-30
42254315362,42254315366,4,2300,1351,-30
42257581714,42257581720,6,2822,2042,-30
42260743386,42260743391,5,2166,1099,-30
42260993202,42260993207,5,1754,1173,-30
42262875932,42262875938,6,1559,1204,-30
42265152988,42265152994,6,2629,1368,-30
42267312874,42267312878,4,2422,1511,-30
42271682988,42271682990,2,1876,1440,-30
42273078792,42273078798,6,2430,1757,-30
42273667496,42273667515,19,673,647,-30
42275544269,42275544265,-4,1303,3328,-30
42279959397,42279959404,7,2542,1002,-30
42282047253,42282047236,-17,2067,1225,-30
42282546781,42282546786,5,1610,830,-30
42283236188,42283236194,6,2208,956,-30
42284673657,42284673661,4,2735,1157,-30
42284765153,42284765169,16,1965,1263,-30
42290684825,42290684830,5,3595,1290,-30
42294795557,42294795563,6,2201,1507,-30
42296088098,42296088103,5,1787,1127,-30
42297082297,42297082304,7,3462,1433,-30
42297342310,42297342317,7,1820,898,-30
42297437469,42297437475,6,944,115,-30
42300555313,42300555316,3,2144,1719,-30
42302320848,42302320855,7,2472,1246,-30
42303589685,42303589691,6,1414,974,-30
42305078371,42305078374,3,2508,1184,-30
42308977514,42308977519,5,1806,979,-30
42312821171,42312821170,-1,694,1169,-30
42315697824,42315697829,5,2503,1026,-30
42316373055,42316373057,2,2793,1391,-30
42317536071,42317536075,4,4222,2441,-30
42318681611,42318681618,7,2673,1309,-30
42321552387,42321552394,7,2683,1203,-30
42325287577,42325287583,6,2606,1391,-30
42327145310,42327145315,5,1417,1007,-30
42328141370,42328141375,5,2239,1010,-30
42329154858,42329154873,15,40254,11291,-30
42330999830,42330999824,-6,1160,2369,-30
42338838794,42338838797,3,2597,1504,-30
42339081726,42339081730,4,2452,1054,-30
42341236028,42341236033,5,2631,1523,-30
42342501981,42342501962,-19,1385,1659,-30
42344122893,42344122898,5,2370,972,-30
42346236374,42346236378,4,2161,1264,-30
42353103618,42353103622,4,2711,1468,-30
42359409842,42359409834,-8,1277,4404,-30
42361067553,42361067558,5,1420,1128,-30
42362191457,42362191460,3,1887,1029,-30
42362801378,42362801384,6,2907,1072,-30
42364156570,42364156574,4,2119,1545,-30
42365650465,42365650470,5,2710,1458,-30
42369308306,42369308313,7,4728,2305,-30
42369842980,42369842985,5,2503,1014,-30
42376355446,42376355453,7,2786,1578,-30
42379539293,42379539299,6,3006,1799,-30
42379821505,42379821507,2,1775,1451,-30
42382218793,42382218798,5,2045,1384,-30
42383148277,42383148282,5,2458,1982,-30
42384756696,42384756697,1,1295,1470,-30
42385860686,42385860685,-1,1140,1601,-30
42386230471,42386230449,-22,1177,247,-30
42388255079,42388255083,4,1329,979,-30
42390701937,42390701933,-4,1866,4685,-30
42392699609,42392699614,5,1983,1154,-30
42392887859,42392887840,-19,1630,934,-30
42397690501,42397690507,6,2781,1369,-30
42400663037,42400663038,1,3244,3987,-30
42401614483,42401614489,6,2284,1273,-30
42403574807,42403574810,3,3423,1513,-30
42404097767,42404097748,-19,1825,1255,-30
42411432205,42411432210,5,2506,1359,-30
42412465394,42412465398,4,2407,1949,-30
42414331442,42414331447,5,1685,1283,-30
42416428843,42416428849,6,3101,1472,-30
42417437118,42417437122,4,2311,1426,-30
42420589267,42420589262,-5,786,2283,-30
42424338942,42424338946,4,1463,783,-30
42425307049,42425307051,2,1231,854,-30
42426554022,42426554023,1,2071,2527,-30
42426789545,42426789550,5,1794,924,-30
42428292680,42428292684,4,1881,1445,-30
42432298398,42432298399,1,1106,1095,-30
42436905954,42436905959,5,4719,2908,-30
42440232794,42440232799,5,2230,1324,-30
42441786891,42441786895,4,2213,1005,-30
42443232004,42443232010,6,3200,1351,-30
42444482415,42444482422,7,3355,1330,-30
42447439918,42447439924,6,2064,1723,-30
42447762021,42447762025,4,2382,1398,-30
42453225275,42453225282,7,1769,879,-30
42456796142,42456796146,4,1437,814,-30
42457228959,42457228940,-19,2616,1764,-30
42457413411,42457413418,7,2888,1513,-30
42460358674,42460358680,6,2542,1044,-30
42460505677,42460505682,5,3118,1588,-30
42461004641,42461004645,4,2517,889,-30
42461875976,42461875970,-6,1348,2812,-30
42463491928,42463491934,6,2631,1312,-30
42464382542,42464382548,6,2584,1563,-30
42468105312,42468105318,6,1688,617,-30
42470588950,42470588953,3,1802,964,-30
42471449159,42471449138,-21,2890,1186,-30
42473925214,42473925219,5,2358,1333,-30
42473993541,42473993549,8,2448,1477,-30
42481600739,42481600743,4,3102,1416,-30
42483100269,42483100274,5,2861,1045,-30
42487294959,42487294965,6,2101,1016,-30
42493094179,42493094185,6,2111,1561,-30
42493927497,42493927501,4,847,751,-30
42495379907,42495379910,3,1237,787,-30
42498103118,42498103124,6,2055,1562,-30
42498726851,42498726855,4,2330,1027,-30
42498761862,42498761870,8,1178,1167,-30
42503700068,42503700071,3,4482,2960,-30
42504020958,42504020963,5,1283,861,-30
42505212513,42505212513,0,1596,1944,-30
42507034714,42507034722,8,2606,977,-30
42507774992,42507774998,6,2861,1448,-30
42508882965,42508882970,5,2079,1336,-30
42509653015,42509653022,7,1870,956,-30
42511090129,42511090134,5,2245,1032,-30
42511587037,42511587042,5,1666,1507,-30
42512255011,42512255014,3,1374,1239,-30
42514190503,42514190522,19,152,1066,-30
42519232422,42519232425,3,1838,1712,-30
42524023881,42524023864,-17,1055,1187,-30
42526692274,42526692281,7,3108,1419,-30
42531082654,42531082655,1,1024,1118,-30
42532447001,42532447006,5,1876,1082,-30
42533094890,42533094895,5,2330,1364,-30
42533478857,42533478862,5,2505,1941,-30
42534687047,42534687050,3,2015,1160,-30
42536760079,42536760085,6,2560,1563,-30
42536871834,42536871839,5,2088,988,-30
42542486815,42542486821,6,2802,1567,-30
42544123857,42544123860,3,1372,1253,-30
42544321224,42544321209,-15,659,251,-30
42546395398,42546395401,3,1440,1024,-30
42549625098,42549625102,4,2969,1310,-30
42552797771,42552797777,6,1913,1259,-30
42554888390,42554888394,4,1813,1142,-30
42555293436,42555293414,-22,344,1391,-30
42558760366,42558760371,5,2465,1620,-30
42559043422,42559043427,5,2926,1439,-30
42559788210,42559788217,7,2880,1100,-30
42560716630,42560716634,4,1891,1850,-30
42561069745,42561069749,4,2735,1609,-30
42568714390,42568714395,5,2108,1436,-30
42569826437,42569826442,5,2063,1164,-30
42575178003,42575178009,6,2914,1249,-30
42577198963,42577198967,4,3175,1349,-30
42582155191,42582155197,6,1982,1220,-30
42586122552,42586122555,3,2246,2020,-30
42589698917,42589698921,4,3057,1551,-30
42594282626,42594282633,7,2114,1104,-30
42595332742,42595332747,5,1762,1180,-30
42596705190,42596705195,5,1957,817,-30
42597969210,42597969214,4,2161,863,-30
42599288677,42599288682,5,1928,1119,-30
42605892020,42605892021,1,3896,4432,-30
42607221009,42607221011,2,1094,806,-30
42609195777,42609195774,-3,883,2182,-30
42609384356,42609384359,3,1493,1193,-30
42610168510,42610168517,7,2878,1851,-30
42613477981,42613477982,1,1707,1579,-30
42613623517,42613623523,6,1308,1239,-30
42623895149,42623895155,6,1751,922,-30
42628487467,42628487475,8,2864,1921,-30
42631244790,42631244793,3,1698,1388,-30
42634791331,42634791337,6,2793,1373,-30
42635724145,42635724150,5,2533,1375,-30
42636409322,42636409329,7,1712,1302,-30
42643383187,42643383190,3,1839,1587,-30
42647493612,42647493618,6,2160,1600,-30
42647849190,42647849194,4,1826,1162,-30
42649177522,42649177526,4,1547,1017,-30
42654668453,42654668457,4,2234,1026,-30
42654728390,42654728387,-3,424,138,-30
42655330382,42655330386,4,2141,1500,-30
42657973952,42657973951,-1,1808,2097,-30
42659371290,42659371295,5,1323,907,-30
42662970345,42662970354,9,2486,1123,-30
42664906477,42664906481,4,2591,1684,-30
42666593823,42666593829,6,3088,1355,-30
42671783374,42671783378,4,2913,1295,-30
42673519194,42673519198,4,1848,1618,-30
42673778718,42673778722,4,2493,1381,-30
42674269554,42674269558,4,2555,1462,-30
42676316949,42676316951,2,932,509,-30
42676525018,42676525022,4,1787,1262,-30
42682266625,42682266629,4,1600,903,-30
42686869288,42686869294,6,1099,1332,-30
42688518937,42688518943,6,1951,1347,-30
42689910809,42689910813,4,2046,1440,-30
42691273303,42691273323,20,1032,260,-30
42693571785,42693571799,14,18282,40745,-30
42693846590,42693846594,4,1522,1293,-30
42694180078,42694180083,5,2743,1172,-30
42697179943,42697179950,7,1700,782,-30
42698768796,42698768801,5,1906,1349,-30
42699520882,42699520886,4,1932,1442,-30
42700351745,42700351750,5,2747,1470,-30
42701059163,42701059168,5,2340,1306,-30
42705715345,42705715350,5,2191,1281,-30
42706748254,42706748259,5,1808,1037,-30
42709925910,42709925913,3,2291,1350,-30
42716623217,42716623222,5,1548,974,-30
42716687702,42716687709,7,1099,1054,-30
42716993478,42716993483,5,1168,597,-30
42721086427,42721086430,3,2003,1240,-30
42721412610,42721412618,8,3627,1503,-30
42721901021,42721901026,5,1567,943,-30
42722000928,42722000930,2,2102,1726,-30
42722819774,42722819771,-3,1343,2388,-30
42724995262,42724995269,7,2440,1752,-30
42728793093,42728793111,18,2198,5518,-30
42730841778,42730841784,6,2494,1303,-30
42731213032,42731213037,5,3494,1742,-30
42733182754,42733182761,7,1852,1021,-30
42733613792,42733613793,1,1639,1696,-30
42737539995,42737539998,3,1503,1270,-30
42742292018,42742292018,0,1439,1971,-30
42745209062,42745209067,5,2745,1187,-30
42748800903,42748800906,3,1981,1169,-30
42749942622,42749942626,4,2178,1446,-30
42750621379,42750621382,3,1797,1224,-30
42752904508,42752904514,6,3828,1513,-30
42755684179,42755684183,4,1923,1280,-30
42756233111,42756233091,-20,826,473,-30
42757109867,42757109874,7,3309,1189,-30
42757666585,42757666590,5,1817,952,-30
42760420374,42760420379,5,3792,1560,-30
42762307856,42762307854,-2,819,1015,-30
42763421474,42763421469,-5,1467,5373,-30
42765491725,42765491729,4,1979,1123,-30
42766307015,42766307018,3,1608,875,-30
42767835063,42767835058,-5,2121,7713,-30
42770351390,42770351394,4,2112,1509,-30
42775343165,42775343171,6,1993,1025,-30
42775583957,42775583963,6,2849,1515,-30
42775897301,42775897284,-17,2800,1704,-30
42778162547,42778162551,4,1745,939,-30
42780282006,42780282026,20,762,3745,-30
42781140835,42781140837,2,2123,992,-30
42784023131,42784023139,8,932,320,-30
42784056658,42784056667,9,1767,874,-30
42784131008,42784130993,-15,2056,833,-30
42784516004,42784516009,5,1268,962,-30
42785669931,42785669936,5,783,847,-30
42792047762,42792047767,5,2176,1028,-30
42792375215,42792375196,-19,2259,1279,-30
42793965817,42793965822,5,1828,1050,-30
42794147045,42794147053,8,2052,815,-30
42794481602,42794481586,-16,2716,1386,-30
42794725629,42794725634,5,2501,1299,-30
42795912082,42795912086,4,1509,1282,-30
42796413030,42796413031,1,791,1195,-30
42800676590,42800676594,4,2096,1278,-30
42801745358,42801745363,5,2325,1143,-30
42807767957,42807767963,6,2126,1366,-30
42814400238,42814400243,5,2018,1035,-30
42814757346,42814757353,7,1729,1375,-30
42817268581,42817268585,4,2336,1367,-30
42817527294,42817527299,5,1855,1451,-30
42821377138,42821377142,4,2036,1270,-30
42821810405,42821810412,7,5762,1011,-30
42824206996,42824206997,1,2193,1361,-30
42827616517,42827616521,4,2071,1424,-30
42827822583,42827822560,-23,2693,1432,-30
42828266838,42828266842,4,2620,1412,-30
42829079442,42829079447,5,2524,1171,-30
42833533737,42833533742,5,1950,1165,-30
42833778735,42833778743,8,1922,1210,-30
42836814873,42836814877,4,2392,1080,-30
42839944367,42839944373,6,2018,1657,-30
42840432329,42840432315,-14,2111,930,-30
42840918237,42840918240,3,2644,1880,-30
42848565806,42848565812,6,3180,2181,-30
42850199985,42850199989,4,1879,1546,-30
42851262586,42851262589,3,2069,1129,-30
42854927843,42854927848,5,2371,1637,-30
42857810581,42857810582,1,2939,2811,-30
42860094126,42860094130,4,1724,1862,-30
42862894125,42862894129,4,2408,958,-30
42865646151,42865646153,2,1213,2266,-30
42868023286,42868023290,4,2312,1335,-30
42870702015,42870702021,6,2262,1526,-30
42870874494,42870874498,4,1504,988,-30
42876892364,42876892370,6,4172,1429,-30
42878867125,42878867130,5,2785,1909,-30
42879600634,42879600639,5,1024,361,-30
42880501734,42880501732,-2,745,1575,-30
42882663714,42882663719,5,2127,697,-30
42884133310,42884133306,-4,894,1320,-30
42885270822,42885270826,4,1706,711,-30
42885948118,42885948123,5,2954,1346,-30
42887487130,42887487134,4,2571,1405,-30
42892213270,42892213275,5,2686,2021,-30
42893331192,42893331198,6,2793,1328,-30
42895258973,42895258968,-5,821,1149,-30
42897755865,42897755873,8,2378,1439,-30
42908458964,42908458968,4,3437,1197,-30
42908624993,42908624994,1,1738,1491,-30
42911570358,42911570363,5,2934,1676,-30
42912729801,42912729805,4,2128,1307,-30
42914360019,42914360021,2,1220,1276,-30
42914523926,42914523930,4,2068,1373,-30
42915045158,42915045162,4,1651,891,-30
42916921641,42916921647,6,2581,1324,-30
42920961779,42920961787,8,1470,912,-30
42923414097,42923414102,5,2070,1356,-30
42923829822,42923829820,-2,1290,2586,-30
42925102377,42925102381,4,1980,1384,-30
42930060970,42930060972,2,1153,1077,-30
42933656726,42933656732,6,2594,1606,-30
42936638433,42936638440,7,2441,1220,-30
42937974926,42937974934,8,2084,1053,-30
42941011501,42941011507,6,1929,1387,-30
42941182222,42941182227,5,2257,1705,-30
42942858569,42942858572,3,1865,1041,-30
42944203910,42944203910,0,1681,2063,-30
42953112554,42953112559,5,2519,986,-30
42953837053,42953837042,-11,535,172,-30
42955124069,42955124075,6,2057,1104,-30
42955434764,42955434767,3,2219,1837,-30
42957206853,42957206857,4,1831,1031,-30
42959073961,42959073965,4,1525,969,-30
42959725037,42959725043,6,1656,1362,-30
42964629147,42964629153,6,1946,1397,-30
42967149881,42967149887,6,2137,1335,-30
42968420942,42968420948,6,2202,1661,-30
42970092805,42970092808,3,1465,1288,-30
42973002050,42973002055,5,2981,1390,-30
42974317251,42974317256,5,1569,990,-30
42978477482,42978477486,4,2457,938,-30
42979352768,42979352781,13,622,2025,-30
42980955780,42980955785,5,2000,1199,-30
42985758630,42985758626,-4,1611,4179,-30
42989314537,42989314541,4,2036,957,-30
42991614247,42991614248,1,1439,1296,-30
42992218529,42992218531,2,2289,1524,-30
42993616614,42993616621,7,2227,1623,-30
42998115543,42998115546,3,1891,1423,-30
42998996857,42998996863,6,2063,1896,-30
42999618770,42999618770,0,1352,1189,-30
43001249106,43001249111,5,1991,1299,-30
43002998825,43002998825,0,1594,1755,-30
43003421933,43003421935,2,1309,899,-30
43004538351,43004538357,6,2809,1599,-30
43006757617,43006757623,6,2106,1785,-30
43010525102,43010525108,6,2141,1291,-30
43012061111,43012061117,6,2534,1848,-30
43012640116,43012640121,5,2130,1797,-30
43014400433,43014400439,6,2092,1529,-30
43017761518,43017761527,9,12544,23412,-30
43020049082,43020049089,7,1557,785,-30
43020688271,43020688276,5,2334,1500,-30
43021268804,43021268809,5,1564,563,-30
43023444788,43023444790,2,3135,2859,-30
43025645525,43025645526,1,1437,1526,-30
43028281420,43028281425,5,4496,2761,-30
43030687869,43030687874,5,1383,1246,-30
43032208693,43032208696,3,2176,1659,-30
43032478397,43032478401,4,2188,1077,-30
43033422714,43033422721,7,4559,1256,-30
43034029582,43034029561,-21,1857,1001,-30
43035211768,43035211771,3,2202,1198,-30
43036181954,43036181959,5,2540,1510,-30
43036433359,43036433353,-6,669,1566,-30
43037071561,43037071558,-3,1634,2472,-30
43041121595,43041121599,4,1500,967,-30
43043643738,43043643739,1,1263,1314,-30
43045836398,43045836394,-4,5177,12508,-30
43047058844,43047058850,6,2661,1240,-30
43047278180,43047278185,5,1312,705,-30
43049522047,43049522050,3,2978,1541,-30
43054460743,43054460751,8,2042,1058,-30
43058416018,43058416022,4,2095,1365,-30
43061548448,43061548448,0,1379,23496,-30
43062619418,43062619410,-8,35311,16808,-30
43069627730,43069627734,4,1982,1613,-30
43070318397,43070318403,6,2627,1111,-30
43074539924,43074539919,-5,59750,93857,-30
43077121579,43077121585,6,2734,1438,-30
43077880010,43077880014,4,2008,1434,-30
43083199744,43083199748,4,1515,1305,-30
43093273618,43093273612,-6,1154,5377,-30
43093721261,43093721260,-1,1234,2285,-30
43099568878,43099568878,0,1531,1918,-30
43104018961,43104018968,7,1942,1171,-30
43107158487,43107158493,6,2687,1304,-30
43111490665,43111490672,7,2239,1147,-30
43111600734,43111600715,-19,1571,910,-30
43111736657,43111736661,4,2030,979,-30
43115433825,43115433830,5,2501,1192,-30
43120173851,43120173857,6,1757,850,-30
43120655337,43120655342,5,2936,1167,-30
43122417816,43122417817,1,1696,1646,-30
43122496810,43122496814,4,2155,1439,-30
43123641691,43123641693,2,1379,931,-30
43128158287,43128158282,-5,829,2471,-30
43128790406,43128790411,5,1940,1753,-30
43129236226,43129236231,5,2365,1283,-30
43132672530,43132672535,5,2270,1303,-30
43136037669,43136037672,3,1509,1733,-30
43139564431,43139564430,-1,973,1757,-30
43141592179,43141592184,5,2527,1685,-30
43142255793,43142255798,5,2251,1312,-30
43142838429,43142838443,14,2629,1342,-30
43144922983,43144922989,6,2676,1202,-30
43146902746,43146902725,-21,1737,1297,-30
43162880389,43162880394,5,1836,1594,-30
43164532194,43164532203,9,2177,1242,-30
43165542598,43165542576,-22,3342,1414,-30
43175318395,43175318399,4,1859,1031,-30
43176150709,43176150714,5,2460,1795,-30
43179958950,43179958955,5,2509,1401,-30
43180077051,43180077056,5,657,229,-30
43188137167,43188137173,6,2673,1421,-30
43189626621,43189626627,6,1973,975,-30
43190086950,43190086956,6,1917,1092,-30
43191371391,43191371390,-1,971,1919,-30
43199797016,43199797023,7,4628,1745,-30
43201752990,43201752995,5,2578,1733,-30
43202291578,43202291580,2,1742,1495,-30
43203125194,43203125199,5,1192,744,-30
43204441885,43204441890,5,1556,1140,-30
43204765253,43204765258,5,1321,818,-30
43205018546,43205018531,-15,954,818,-30
43209185279,43209185286,7,1475,1197,-30
43214165809,43214165814,5,2909,1829,-30
43214697282,43214697286,4,2028,1396,-30
43219154122,43219154127,5,2985,1509,-30
43223849254,43223849259,5,2098,953,-30
43226048783,43226048790,7,1782,980,-30
43230004098,43230004093,-5,826,2256,-30
43231022527,43231022531,4,1520,671,-30
43236693776,43236693779,3,2673,1425,-30
43237228146,43237228151,5,3388,1537,-30
43239284668,43239284670,2,1900,1289,-30
43240810890,43240810871,-19,2179,928,-30
43244160702,43244160706,4,2219,1150,-30
43244272261,43244272282,21,1915,948,-30
43247849850,43247849855,5,2768,1597,-30
43249386759,43249386755,-4,612,169,-30
43249451050,43249451054,4,1957,1370,-30
43251524096,43251524098,2,1040,718,-30
43251975604,43251975607,3,2860,1312,-30
43254026866,43254026870,4,4422,2127,-30
43254886282,43254886289,7,2163,817,-30
43255437037,43255437044,7,2465,1470,-30
43255756239,43255756219,-20,2030,1004,-30
43256817081,43256817084,3,19476,45523,-30
43256943782,43256943788,6,2187,1119,-30
43257708563,43257708559,-4,387,425,-30
43258152951,43258152956,5,1991,1151,-30
43260059466,43260059471,5,1814,1424,-30
43260502361,43260502367,6,1943,1339,-30
43263328853,43263328861,8,2342,1040,-30
43263671352,43263671354,2,2046,1476,-30
43266666147,43266666148,1,1702,2656,-30
43268473738,43268473742,4,1587,1117,-30
43268632189,43268632191,2,9484,9349,-30
43269861152,43269861158,6,2508,1281,-30
43273790920,43273790923,3,2885,1678,-30
43277161975,43277161980,5,1601,1361,-30
43279945482,43279945487,5,2738,1243,-30
43288765137,43288765143,6,2369,1069,-30
43291305926,43291305931,5,1223,1224,-30
43291961266,43291961271,5,2210,1212,-30
43292797983,43292797986,3,1885,1494,-30
43295688557,43295688562,5,2190,1833,-30
43299655815,43299655821,6,2891,1900,-30
43303139970,43303139974,4,2073,1067,-30
43304904661,43304904665,4,2403,1168,-30
43305016322,43305016337,15,2504,1291,-30
43305610699,43305610706,7,2449,1296,-30
43307427818,43307427824,6,1888,1208,-30
43309154706,43309154710,4,1874,947,-30
43311673866,43311673872,6,2126,1560,-30
43313076746,43313076746,0,1116,1263,-30
43315502536,43315502539,3,1744,1265,-30
43316440058,43316440062,4,1385,958,-30
43316959499,43316959489,-10,1258,756,-30
43319453613,43319453610,-3,925,1433,-30
43319861202,43319861207,5,2091,1532,-30
43319910589,43319910594,5,1360,1009,-30
43325231514,43325231519,5,2020,1191,-30
43327173228,43327173231,3,1536,1182,-30
43327918903,43327918909,6,3073,1646,-30
43328005918,43328005921,3,2177,1151,-30
43328254808,43328254811,3,1837,959,-30
43329003725,43329003730,5,3048,1406,-30
43333067005,43333067010,5,2266,1221,-30
43335185201,43335185206,5,2440,932,-30
43337102660,43337102666,6,2514,1339,-30
43337289421,43337289426,5,3249,1003,-30
43343936454,43343936459,5,1551,1086,-30
43343982553,43343982562,9,2060,1172,-30
43350907988,43350907992,4,2095,1406,-30
43351786467,43351786473,6,2115,1266,-30
43352688285,43352688286,1,2919,3269,-30
43353003869,43353003874,5,2000,1343,-30
43354813422,43354813426,4,2225,1365,-30
43356208956,43356208961,5,2975,1729,-30
43357196945,43357196946,1,1081,1063,-30
43362487924,43362487928,4,2191,1707,-30
43364325338,43364325343,5,2915,1188,-30
43366050462,43366050467,5,2383,1144,-30
43366191290,43366191295,5,1607,726,-30
43368854927,43368854931,4,2838,1423,-30
43369842056,43369842059,3,1377,908,-30
43370083311,43370083312,1,1369,1327,-30
43370254565,43370254570,5,2115,1448,-30
43370413930,43370413937,7,5353,2942,-30
43371760170,43371760174,4,4302,1591,-30
43374204635,43374204640,5,1102,1500,-30
43375266398,43375266398,0,1857,2866,-30
43375671884,43375671887,3,1812,1110,-30
43377032480,43377032486,6,1732,1224,-30
43377282291,43377282298,7,1896,1459,-30
43378045293,43378045278,-15,40591,15173,-30
43378225585,43378225593,8,1654,1088,-30
43378401363,43378401345,-18,2224,989,-30
43380784901,43380784906,5,2199,1236,-30
43380929181,43380929170,-11,588,299,-30
43381270747,43381270753,6,2173,1200,-30
43385989993,43385989998,5,2962,1350,-30
43386112962,43386112947,-15,1771,781,-30
43390181863,43390181868,5,2230,1289,-30
43390620137,43390620141,4,2317,1149,-30
43391300543,43391300546,3,2454,1405,-30
43393796566,43393796568,2,2242,1716,-30
43394203193,43394203199,6,2086,1149,-30
43400855590,43400855602,12,2843,1390,-30
43401338369,43401338375,6,3085,1539,-30
43405833865,43405833869,4,2331,1225,-30
43411324653,43411324635,-18,2380,1462,-30
43412869091,43412869095,4,2482,1321,-30
43414711101,43414711106,5,1291,1060,-30
43414801540,43414801533,-7,1975,9097,-30
43415211472,43415211475,3,55352,48003,-30
43415767780,43415767784,4,1943,1314,-30
43416717030,43416717034,4,2505,1463,-30
43417097850,43417097855,5,1864,1330,-30
43420035704,43420035709,5,2254,1410,-30
43421066703,43421066706,3,2216,1380,-30
43422152401,43422152407,6,2654,1436,-30
43422888665,43422888669,4,2489,1381,-30
43427870057,43427870063,6,2110,1426,-30
43428192078,43428192067,-11,859,304,-30
43431458042,43431458037,-5,1237,3316,-30
43432638413,43432638419,6,1304,1055,-30
43443120829,43443120836,7,1614,1130,-30
43443729646,43443729651,5,1803,1018,-30
43445173784,43445173791,7,2251,1181,-30
43445706861,43445706867,6,2482,1530,-30
43448455347,43448455352,5,2068,1022,-30
43450519153,43450519157,4,2433,1444,-30
43451350121,43451350126,5,2530,1192,-30
43459821437,43459821440,3,1200,1037,-30
43461695545,43461695550,5,2257,1220,-30
43462311074,43462311078,4,1095,1334,-30
43463097916,43463097923,7,10,1531,-30
43466911446,43466911450,4,1796,1446,-30
43467102891,43467102895,4,2040,1325,-30
43468604989,43468604995,6,1672,1251,-30
43470076888,43470076894,6,2894,1649,-30
43470284274,43470284268,-6,879,3898,-30
43473641117,43473641121,4,2224,1410,-30
43474005890,43474005894,4,2413,1426,-30
43474418342,43474418347,5,1495,940,-30
43475113059,43475113065,6,3026,1560,-30
43479361150,43479361155,5,1480,894,-30
43481920942,43481920945,3,1812,939,-30
43483767410,43483767415,5,2643,1391,-30
43486762093,43486762099,6,3400,1684,-30
43493836850,43493836854,4,2287,963,-30
43494191371,43494191377,6,2041,1222,-30
43497224665,43497224661,-4,20594,17843,-30
43498070867,43498070874,7,2889,1198,-30
43502550941,43502550944,3,1463,1128,-30
43506397248,43506397242,-6,951,2274,-30
43512393390,43512393395,5,2294,1304,-30
43515673208,43515673213,5,2934,1894,-30
43517983420,43517983424,4,2182,1531,-30
43520079331,43520079338,7,1839,1303,-30
43520385127,43520385133,6,4572,2434,-30
43526083101,43526083107,6,2164,1139,-30
43528904954,43528904958,4,2527,1967,-30
43531620134,43531620139,5,2441,1625,-30
43533504263,43533504268,5,2561,1595,-30
43533766628,43533766634,6,3229,1691,-30
43534488621,43534488627,6,2695,1485,-30
43534871941,43534871939,-2,916,1402,-30
43538089102,43538089101,-1,1100,885,-30
43543090662,43543090665,3,1156,779,-30
43544220901,43544220907,6,3037,1359,-30
43548184006,43548184012,6,1709,1243,-30
43549751382,43549751386,4,2272,1303,-30
43550010154,43550010158,4,1721,1474,-30
43550039734,43550039739,5,1624,1274,-30
43551837125,43551837130,5,1891,1010,-30
43554181930,43554181935,5,1463,1239,-30
43555968741,43555968746,5,2026,1364,-30
43557167507,43557167513,6,2401,1437,-30
43558979358,43558979363,5,1593,1442,-30
43559504926,43559504931,5,1955,748,-30
43560473705,43560473709,4,1414,1278,-30
43566771974,43566771980,6,2196,1667,-30
43568288694,43568288699,5,3161,1071,-30
43568338228,43568338234,6,1597,1071,-30
43568461045,43568461048,3,1866,1247,-30
43570237726,43570237731,5,1860,1106,-30
43570989101,43570989107,6,1494,961,-30
43573533185,43573533190,5,2496,1189,-30
43580122725,43580122728,3,1385,906,-30
43581087441,43581087456,15,15321,44248,-30
43585946945,43585946951,6,1789,1344,-30
43586786406,43586786412,6,1813,1302,-30
43586964481,43586964485,4,2383,1362,-30
43589218610,43589218610,0,1345,1149,-30
43590504435,43590504438,3,2452,1464,-30
43591100562,43591100568,6,2263,1308,-30
43594148952,43594148957,5,3197,1798,-30
43594205325,43594205327,2,1953,1039,-30
43597261782,43597261787,5,2587,1526,-30
43597731686,43597731691,5,1234,1094,-30
43597957190,43597957169,-21,1827,1048,-30
43601247283,43601247270,-13,42255,13120,-30
43603244458,43603244464,6,2933,1603,-30
43603588329,43603588333,4,1284,822,-30
43604688038,43604688043,5,2315,1558,-30
43605002353,43605002371,18,1640,1099,-30
43609729054,43609729058,4,2561,887,-30
43609891614,43609891619,5,1337,1295,-30
43610530201,43610530204,3,2279,1461,-30
43611393497,43611393502,5,3046,1265,-30
43613590281,43613590286,5,2257,1381,-30
43614720906,43614720911,5,1870,926,-30
43615171755,43615171758,3,2067,1432,-30
43615711098,43615711115,17,8111,50883,-30
43620578833,43620578838,5,2132,1570,-30
43621202970,43621202974,4,1579,988,-30
43621901880,43621901884,4,2290,1343,-30
43625132446,43625132450,4,1959,1181,-30
43634518302,43634518305,3,2117,1936,-30
43635171646,43635171651,5,2436,1560,-30
43640489041,43640489046,5,5149,1878,-30
43640629465,43640629472,7,1901,904,-30
43640912537,43640912544,7,1317,965,-30
43643098786,43643098786,0,2365,2188,-30
43644586525,43644586529,4,2725,1244,-30
43645511678,43645511659,-19,1794,897,-30
43645831337,43645831342,5,2194,1127,-30
43648927279,43648927281,2,3675,4017,-30
43649075978,43649075983,5,1754,1441,-30
43660979324,43660979328,4,2118,1270,-30
43664747041,43664747046,5,2503,1280,-30
43669666541,43669666547,6,2126,854,-30
43670906853,43670906859,6,1757,1072,-30
43671367545,43671367550,5,2081,1125,-30
43674381956,43674381969,13,2715,1169,-30
43676025065,43676025069,4,1778,1585,-30
43683055757,43683055762,5,1720,1046,-30
43686019082,43686019088,6,3443,1625,-30
43687289548,43687289532,-16,2373,1091,-30
43687829393,43687829398,5,2348,1153,-30
43688339557,43688339559,2,1749,2519,-30
43692975089,43692975094,5,2273,1299,-30
43694653350,43694653353,3,1235,786,-30
43697380229,43697380234,5,2303,1218,-30
43697973483,43697973491,8,1029,1674,-30
43701587244,43701587250,6,2849,1108,-30
43702074255,43702074234,-21,971,534,-30
43702512379,43702512385,6,2622,1201,-30
43707259629,43707259633,4,1968,1352,-30
43713755698,43713755706,8,2021,1049,-30
43716243294,43716243290,-4,1594,3056,-30
43718907710,43718907716,6,2401,1373,-30
43719587875,43719587876,1,1180,986,-30
43720811319,43720811322,3,1224,1641,-30
43721853853,43721853857,4,2267,1498,-30
43726251386,43726251397,11,2093,1019,-30
43733377813,43733377817,4,1879,1077,-30
43733909908,43733909914,6,1326,1277,-30
43737144641,43737144645,4,796,469,-30
43738955610,43738955614,4,2753,1044,-30
43740914234,43740914240,6,1972,1015,-30
43743087894,43743087898,4,2652,1384,-30
43751650762,43751650767,5,1410,1101,-30
43758657197,43758657203,6,2012,1736,-30
43763182936,43763182939,3,1961,1343,-30
43764752494,43764752498,4,2483,1581,-30
43765060629,43765060634,5,1493,885,-30
43768279809,43768279814,5,3292,1415,-30
43768646365,43768646346,-19,2623,1169,-30
43772967718,43772967724,6,4473,2529,-30
43774294685,43774294690,5,2192,1270,-30
43775109948,43775109954,6,1598,1010,-30
43776697180,43776697185,5,3096,1614,-30
43784064990,43784064994,4,2096,827,-30
43790330530,43790330535,5,2640,1299,-30
43797860782,43797860787,5,2789,1421,-30
43798564929,43798564931,2,1488,1022,-30
43799264906,43799264909,3,2472,1056,-30
43799360708,43799360691,-17,1362,553,-30
43799695241,43799695246,5,2223,1464,-30
43799814322,43799814306,-16,1496,758,-30
43803532207,43803532214,7,3317,1306,-30
43807230453,43807230455,2,1744,2226,-30
43821069507,43821069513,6,2127,1366,-30
43822089831,43822089828,-3,1172,628,-30
43825344518,43825344523,5,1674,1037,-30
43827694069,43827694075,6,2621,1044,-30
43828777317,43828777320,3,2707,1555,-30
43834084130,43834084136,6,3297,1393,-30
43834388457,43834388463,6,2032,1194,-30
43836551985,43836551986,1,2400,1810,-30
43838359366,43838359371,5,2207,1496,-30
43841564422,43841564424,2,2084,1539,-30
43842944621,43842944626,5,3040,1761,-30
43846299771,43846299777,6,3316,1779,-30
43847697121,43847697127,6,2505,1368,-30
43848326239,43848326246,7,2088,1130,-30
43849066299,43849066305,6,1860,1279,-30
43851091833,43851091838,5,3089,1841,-30
43851529542,43851529521,-21,816,422,-30
43852532362,43852532367,5,2023,1135,-30
43856121113,43856121118,5,2781,1123,-30
43860223304,43860223309,5,2176,1058,-30
43861175815,43861175820,5,1857,1424,-30
43862085715,43862085719,4,2225,1374,-30
43863604711,43863604711,0,1575,1353,-30
43868299924,43868299923,-1,1053,1316,-30
43869042050,43869042055,5,2356,1133,-30
43871303412,43871303418,6,2259,1373,-30
43873136237,43873136245,8,2235,1004,-30
43874277765,43874277771,6,1843,1103,-30
43876125992,43876125995,3,2277,1351,-30
43880305417,43880305422,5,2248,1524,-30
43887083866,43887083870,4,2873,1388,-30
43889113179,43889113185,6,2470,1998,-30
43891391821,43891391826,5,2600,1418,-30
43892644808,43892644811,3,2427,1104,-30
43896065518,43896065524,6,2702,1685,-30
43896645053,43896645038,-15,2830,1413,-30
43902349638,43902349643,5,2256,1036,-30
43903640492,43903640497,5,2743,1510,-30
43906516378,43906516382,4,2245,1446,-30
43908225476,43908225479,3,3122,1518,-30
43921174702,43921174686,-16,972,487,-30
43921973650,43921973654,4,1388,735,-30
43923861745,43923861750,5,1884,1054,-30
43925007440,43925007446,6,2285,1383,-30
43928938326,43928938330,4,2831,1894,-30
43936899161,43936899165,4,2416,1021,-30
43937896303,43937896310,7,2959,1231,-30
43947210070,43947210071,1,2122,1037,-30
43947298607,43947298614,7,3336,1777,-30
43948391647,43948391651,4,2179,1340,-30
43950484407,43950484414,7,3041,1350,-30
43956950719,43956950724,5,7953,34681,-30
43958617453,43958617459,6,3213,2073,-30
43963071496,43963071501,5,2670,1938,-30
43964291265,43964291270,5,3345,1345,-30
43965964853,43965964858,5,1714,1240,-30
43966629868,43966629876,8,3002,1033,-30
43968223830,43968223836,6,2714,1917,-30
43969247690,43969247696,6,3385,1797,-30
43971235365,43971235368,3,2150,1188,-30
43971648551,43971648557,6,2663,1433,-30
43973965346,43973965362,16,3011,1751,-30
43977282574,43977282579,5,2056,1513,-30
43981039146,43981039150,4,1550,1121,-30
43985008963,43985008965,2,1651,1341,-30
43986145425,43986145431,6,2293,1526,-30
43986574554,43986574561,7,2118,917,-30
43989526665,43989526669,4,2666,979,-30
43989556751,43989556750,-1,1373,1423,-30
43994668518,43994668522,4,2246,1228,-30
43996313135,43996313139,4,3404,2302,-30
43997799138,43997799142,4,2621,1364,-30
44000257306,44000257310,4,2463,1428,-30
44007353412,44007353419,7,2784,1294,-30
44007922102,44007922109,7,2272,1227,-30
44009859612,44009859617,5,1672,1135,-30
44011717631,44011717636,5,2140,1458,-30
44012805261,44012805262,1,3237,3931,-30
44014892589,44014892594,5,3226,1330,-30
44015415046,44015415050,4,2007,1474,-30
44017605025,44017605030,5,4127,1722,-30
44019913706,44019913706,0,1382,1365,-30
44020968954,44020968958,4,1961,1376,-30
44026406590,44026406596,6,2288,1662,-30
44026543007,44026542986,-21,2285,1271,-30
44028766417,44028766421,4,2193,1649,-30
44034156124,44034156130,6,2114,1319,-30
44035285131,44035285136,5,1981,1632,-30
44043781709,44043781716,7,2099,1353,-30
44044018410,44044018426,16,2019,622,-30
44044888611,44044888615,4,2724,1413,-30
44047655558,44047655563,5,2327,1510,-30
44047901772,44047901777,5,2001,1488,-30
44048017543,44048017548,5,1595,902,-30
44051207702,44051207706,4,2463,1208,-30
44054638396,44054638400,4,1138,796,-30
44058066814,44058066818,4,2234,1398,-30
44058802921,44058802924,3,10067,20250,-30
44062421309,44062421314,5,2344,1237,-30
44064446646,44064446650,4,2307,1260,-30
44066029998,44066030002,4,53988,40169,-30
44066758902,44066758906,4,1741,1047,-30
44066795803,44066795809,6,2031,1121,-30
44069003785,44069003793,8,1997,1410,-30
44070753452,44070753457,5,2604,1780,-30
44072404884,44072404890,6,2857,1059,-30
44073222897,44073222882,-15,560,139,-30
44078256597,44078256601,4,2276,1449,-30
44079308491,44079308495,4,1633,922,-30
44084031623,44084031629,6,2428,1386,-30
44084093065,44084093070,5,2033,1244,-30
44085205369,44085205376,7,3107,1353,-30
44087455909,44087455912,3,1640,1612,-30
44088888674,44088888679,5,2398,1415,-30
44090310030,44090310034,4,1731,1258,-30
44091422577,44091422571,-6,1004,3940,-30
44091812697,44091812703,6,3150,1450,-30
44092782084,44092782090,6,2791,1364,-30
44093448119,44093448123,4,2482,1415,-30
44094038630,44094038634,4,1725,1403,-30
44094569979,44094569973,-6,923,4530,-30
44096494110,44096494115,5,1730,1304,-30
44104585953,44104585954,1,1794,2027,-30
44105682118,44105682119,1,1452,914,-30
44108307905,44108307909,4,2077,1277,-30
44109759735,44109759741,6,1951,1030,-30
44110832065,44110832070,5,2416,1440,-30
44113396615,44113396623,8,1682,826,-30
44114575353,44114575360,7,3125,1596,-30
44120988265,44120988268,3,1530,983,-30
44124061846,44124061851,5,2275,1490,-30
44130143397,44130143402,5,2734,1608,-30
44131687841,44131687846,5,2338,1314,-30
44136226257,44136226256,-1,942,1262,-30
44139247042,44139247047,5,2179,1970,-30
44140960003,44140960007,4,3030,1576,-30
44145354973,44145354982,9,12323,26726,-30
44146132551,44146132554,3,2523,2286,-30
44147405881,44147405883,2,1581,1119,-30
44150085111,44150085109,-2,1047,2440,-30
44159520919,44159520922,3,2184,1120,-30
44162589000,44162589006,6,3022,1229,-30
44168579003,44168579008,5,1848,1364,-30
44174950035,44174950036,1,1428,2157,-30
44174990165,44174990169,4,2505,1599,-30
44177891746,44177891750,4,2455,1160,-30
44179783621,44179783624,3,1671,1679,-30
44182736644,44182736647,3,1649,930,-30
44190416644,44190416649,5,1836,1257,-30
44192907018,44192907025,7,2426,1670,-30
44195955246,44195955246,0,3715,2868,-30
44202393501,44202393505,4,2169,1323,-30
44202545305,44202545311,6,2223,1648,-30
44203507275,44203507279,4,2804,1434,-30
44205090098,44205090103,5,1880,1129,-30
44207418934,44207418939,5,1776,1329,-30
44208486417,44208486425,8,2023,1342,-30
44211023023,44211023027,4,1852,1685,-30
44214934746,44214934750,4,1337,1089,-30
44220875967,44220875973,6,1682,749,-30
44232469065,44232469070,5,2006,1139,-30
44236132787,44236132791,4,2608,1027,-30
44237782778,44237782762,-16,1904,948,-30
44238744116,44238744121,5,1338,1023,-30
44243910492,44243910497,5,2319,1731,-30
44245310229,44245310234,5,2080,1320,-30
44248060953,44248060958,5,2196,1091,-30
44248157172,44248157177,5,2548,1586,-30
44248190142,44248190146,4,2318,1151,-30
44250957907,44250957903,-4,1548,3062,-30
44253186217,44253186222,5,2103,976,-30
44256302454,44256302458,4,1316,1195,-30
44258890478,44258890476,-2,28030,20344,-30
44258959578,44258959583,5,2173,1283,-30
44260429929,44260429933,4,2007,1471,-30
44261752112,44261752110,-2,1240,480,-30
44264486687,44264486691,4,2633,1398,-30
44264532333,44264532314,-19,1696,1829,-30
44264637008,44264637015,7,128,845,-30
44269257184,44269257189,5,2526,1086,-30
44271213100,44271213105,5,2833,1512,-30
44272414914,44272414919,5,1450,1470,-30
44272899015,44272899021,6,2902,1872,-30
44280244764,44280244767,3,2305,1327,-30
44283750373,44283750378,5,2127,1502,-30
44283963220,44283963234,14,768,3448,-30
44286678238,44286678219,-19,1050,743,-30
44289187161,44289187166,5,2707,1046,-30
44289269185,44289269171,-14,1723,1435,-30
44293503879,44293503877,-2,1626,1759,-30
44297731734,44297731743,9,2241,977,-30
44299415795,44299415798,3,2132,1323,-30
44308453737,44308453742,5,1371,683,-30
44309956670,44309956670,0,898,1179,-30
44313330753,44313330757,4,1328,1033,-30
44315390492,44315390497,5,2008,1172,-30
44321206083,44321206090,7,2391,1378,-30
44321993829,44321993836,7,2519,1657,-30
44323237503,44323237509,6,2115,1528,-30
44326690297,44326690291,-6,1841,7779,-30
44327186150,44327186154,4,1469,1053,-30
44327440099,44327440103,4,988,442,-30
44327777410,44327777395,-15,2783,1061,-30
44331639107,44331639111,4,2673,1540,-30
44336018614,44336018621,7,2243,1023,-30
44336313873,44336313879,6,1736,1213,-30
44337843242,44337843225,-17,1646,688,-30
44338341489,44338341490,1,1122,1628,-30
44341408954,44341408959,5,1385,946,-30
44341907097,44341907102,5,1276,761,-30
44346486714,44346486718,4,1631,1456,-30
44348031454,44348031463,9,1826,1042,-30
44351080630,44351080635,5,3025,1772,-30
44352191346,44352191350,4,1705,1332,-30
44354982513,44354982518,5,2089,980,-30
44357836875,44357836870,-5,930,4765,-30
44358450070,44358450075,5,2234,1383,-30
44364368531,44364368537,6,2337,1199,-30
44365251529,44365251534,5,5219,2568,-30
44374966355,44374966358,3,1726,1299,-30
44378208667,44378208671,4,2067,990,-30
44380061037,44380061042,5,1901,1270,-30
44382507052,44382507058,6,1929,1596,-30
44386473886,44386473891,5,2238,1496,-30
44388427609,44388427616,7,2546,1590,-30
44398516563,44398516567,4,2672,1312,-30
44401003601,44401003606,5,1901,1710,-30
44405038430,44405038435,5,2801,1653,-30
44405457801,44405457806,5,1525,1164,-30
44410226563,44410226569,6,2837,1616,-30
44411205678,44411205683,5,1717,986,-30
44412734525,44412734507,-18,476,646,-30
44416277032,44416277039,7,3516,1421,-30
44418819032,44418819035,3,1957,1279,-30
44419202057,44419202059,2,1735,1448,-30
44422690499,44422690505,6,1765,1051,-30
44423571379,44423571384,5,2049,1486,-30
44425135841,44425135843,2,1494,1086,-30
44425859006,44425858988,-18,954,200,-30
44426189624,44426189612,-12,23200,15998,-30
44430218259,44430218259,0,1073,1197,-30
44431393959,44431393964,5,2714,1563,-30
44435373990,44435373998,8,1501,1059,-30
44435441425,44435441408,-17,2157,1396,-30
44439830583,44439830590,7,2212,1314,-30
44440861490,44440861494,4,2174,1350,-30
44441429592,44441429598,6,2214,1275,-30
44444196320,44444196326,6,3582,1874,-30
44445985726,44445985742,16,446,2348,-30
44450520788,44450520790,2,1317,1250,-30
44450714486,44450714490,4,1063,822,-30
44452267664,44452267670,6,2338,1118,-30
44455667370,44455667376,6,2635,1524,-30
44455787402,44455787407,5,3750,1138,-30
44459016289,44459016292,3,2066,1236,-30
44459363467,44459363448,-19,1587,1053,-30
44475130786,44475130793,7,1195,1092,-30
44476363469,44476363473,4,2356,1307,-30
44476585969,44476585975,6,3937,1835,-30
44485479656,44485479661,5,1685,1586,-30
44488219588,44488219591,3,1690,1355,-30
44488327958,44488327963,5,1947,1450,-30
44490359403,44490359409,6,2784,1654,-30
44490668437,44490668428,-9,1292,3330,-30
44491325962,44491325966,4,1670,1003,-30
44498953537,44498953542,5,2533,1342,-30
44507501046,44507501050,4,2514,1266,-30
44508707228,44508707234,6,2578,1435,-30
44510675084,44510675090,6,2052,946,-30
44510828542,44510828523,-19,2258,1048,-30
44510914439,44510914438,-1,1349,2433,-30
44512929212,44512929208,-4,5926,13557,-30
44513483077,44513483081,4,2512,1768,-30
44514839822,44514839827,5,3195,1384,-30
44516071945,44516071950,5,2400,1264,-30
44518028600,44518028606,6,1988,1239,-30
44519208064,44519208082,18,1356,1160,-30
44520196406,44520196412,6,2979,1455,-30
44522731512,44522731518,6,2662,2057,-30
44526709738,44526709733,-5,994,4690,-30
44527823850,44527823857,7,1855,1175,-30
44529225591,44529225597,6,1661,905,-30
44538485977,44538485982,5,1948,1183,-30
44543366556,44543366563,7,2051,926,-30
44544580409,44544580414,5,1101,1041,-30
44545051812,44545051793,-19,1511,686,-30
44546203252,44546203257,5,2470,1929,-30
44551428343,44551428338,-5,1234,2894,-30
44554261394,44554261399,5,2605,1357,-30
44556620792,44556620797,5,2383,1387,-30
44558494339,44558494343,4,1908,1279,-30
44560457784,44560457789,5,2047,1623,-30
44561554413,44561554418,5,2564,1296,-30
44563688930,44563688910,-20,2028,1412,-30
44564881180,44564881183,3,1121,733,-30
44568062117,44568062119,2,2181,1921,-30
44574032382,44574032386,4,2217,1424,-30
44575398651,44575398659,8,2657,1366,-30
44578389566,44578389570,4,1796,919,-30
44578643769,44578643752,-17,836,204,-30
44580218893,44580218901,8,2500,1071,-30
44582778841,44582778841,0,1376,1962,-30
44582805167,44582805167,0,2294,2740,-30
44587600918,44587600924,6,2620,1144,-30
44590865817,44590865822,5,2086,1209,-30
44592125718,44592125725,7,1675,1260,-30
44592953038,44592953042,4,2344,1139,-30
44593613090,44593613095,5,2397,1458,-30
44596231314,44596231318,4,2054,1781,-30
44597371635,44597371641,6,2826,1228,-30
44597582281,44597582285,4,3537,2055,-30
44600748139,44600748144,5,2218,1140,-30
44607561487,44607561481,-6,952,10448,-30
44608551375,44608551380,5,2711,1086,-30
44616148934,44616148938,4,2837,1683,-30
44616223942,44616223945,3,2053,1840,-30
44617155533,44617155536,3,2605,1483,-30
44620615028,44620615027,-1,388,828,-30
44623979685,44623979687,2,1698,1040,-30
44624138941,44624138947,6,2361,926,-30
44625761701,44625761707,6,1622,1453,-30
44627442171,44627442177,6,1475,1267,-30
44639215294,44639215299,5,1827,838,-30
44639397645,44639397651,6,2277,1088,-30
44642100859,44642100866,7,2712,1239,-30
44642433551,44642433530,-21,747,202,-30
44642563591,44642563576,-15,628,588,-30
44647961945,44647961951,6,2302,1006,-30
44654616426,44654616430,4,4598,2983,-30
44658406851,44658406856,5,2373,1746,-30
44659025780,44659025786,6,2586,1046,-30
44659964597,44659964603,6,1555,878,-30
44663526682,44663526690,8,1699,1230,-30
44663598128,44663598131,3,2234,1148,-30
44664908253,44664908247,-6,2324,9152,-30
44668588767,44668588771,4,1675,1367,-30
44668809683,44668809688,5,1749,1147,-30
44669878491,44669878497,6,2698,1802,-30
44672047066,44672047069,3,1076,889,-30
44673862061,44673862065,4,1441,1127,-30
44679498212,44679498214,2,1651,1342,-30
44683765450,44683765457,7,2133,1282,-30
44684020470,44684020458,-12,1214,471,-30
44684625363,44684625366,3,2719,1213,-30
44685771410,44685771406,-4,1190,4198,-30
44691527504,44691527510,6,2336,1602,-30
44693045236,44693045240,4,1711,1270,-30
44697884125,44697884130,5,1783,1262,-30
44699418799,44699418803,4,2037,1397,-30
44705024346,44705024350,4,2531,1151,-30
44707346702,44707346706,4,2478,1226,-30
44708221635,44708221640,5,2090,1303,-30
44712158428,44712158435,7,2628,1368,-30
44713341952,44713341958,6,2235,821,-30
44714168707,44714168705,-2,1182,1289,-30
44717676222,44717676226,4,2256,1426,-30
44720136402,44720136407,5,3701,1463,-30
44721682978,44721682984,6,1747,1410,-30
44722431075,44722431079,4,1981,1223,-30
44722997202,44722997207,5,1336,885,-30
44723091854,44723091832,-22,1383,1197,-30
44724274002,44724274008,6,3523,1742,-30
44725419949,44725419950,1,1614,1662,-30
44730226286,44730226293,7,1502,1605,-30
44730737723,44730737707,-16,842,528,-30
44731893598,44731893605,7,2352,1320,-30
44735023603,44735023607,4,2459,1383,-30
44735510158,44735510163,5,2009,1047,-30
44735647526,44735647531,5,2656,1621,-30
44735979246,44735979249,3,2015,1191,-30
44736328085,44736328091,6,1929,908,-30
44736665365,44736665370,5,744,148,-30
44740606522,44740606528,6,2698,1566,-30
44743650155,44743650161,6,2411,1263,-30
44744275208,44744275196,-12,1835,776,-30
44744640606,44744640611,5,1557,1086,-30
44749138725,44749138730,5,2545,1426,-30
44749295154,44749295159,5,2284,1247,-30
44750989710,44750989715,5,2893,1775,-30
44751607041,44751607045,4,2298,1406,-30
44751635155,44751635157,2,2492,2577,-30
44753626634,44753626638,4,2560,1051,-30
44753951522,44753951527,5,2669,1766,-30
44758917394,44758917399,5,2821,1532,-30
44759396418,44759396426,8,2516,1280,-30
44764793373,44764793378,5,2593,1899,-30
44767916854,44767916859,5,1834,1279,-30
44777227283,44777227286,3,868,1406,-30
44778363549,44778363553,4,2609,1001,-30
44778636208,44778636214,6,2010,1313,-30
44779584124,44779584103,-21,372,1003,-30
44783275625,44783275618,-7,1414,858,-30
44784148962,44784148966,4,1747,997,-30
44790974893,44790974899,6,1903,921,-30
44798444520,44798444524,4,1911,1637,-30
44804232454,44804232459,5,1700,1290,-30
44806603674,44806603678,4,1757,863,-30
44807209865,44807209870,5,3382,1980,-30
44807399263,44807399269,6,3096,1948,-30
44807817966,44807817971,5,4776,2482,-30
44808926851,44808926856,5,1643,1297,-30
44811096213,44811096219,6,2389,1216,-30
44812302145,44812302150,5,1863,1187,-30
44813288123,44813288126,3,1470,702,-30
44814026414,44814026432,18,3320,1346,-30
44818434026,44818434031,5,2175,1449,-30
44818598589,44818598593,4,2273,887,-30
44819593118,44819593122,4,1962,1267,-30
44820591986,44820591978,-8,1013,3019,-30
44826310033,44826310037,4,2601,1607,-30
44829985097,44829985102,5,1578,1251,-30
44833200698,44833200701,3,1853,1286,-30
44835951065,44835951070,5,2048,1602,-30
44843757814,44843757819,5,1903,1082,-30
44844145410,44844145392,-18,962,528,-30
44846389430,44846389435,5,1815,1498,-30
44846415370,44846415375,5,2733,1438,-30
44846614311,44846614315,4,1919,1248,-30
44847323549,44847323537,-12,1105,411,-30
44848160882,44848160886,4,2342,1362,-30
44849672771,44849672777,6,2901,1510,-30
44850629501,44850629507,6,1031,974,-30
44854365466,44854365470,4,1666,1352,-30
44854411386,44854411392,6,2013,1245,-30
44855229514,44855229521,7,3223,1854,-30
44858832097,44858832103,6,5402,2813,-30
44860001633,44860001638,5,2600,1637,-30
44860626952,44860626958,6,2482,919,-30
44861373459,44861373462,3,1589,991,-30
44866717804,44866717808,4,2135,829,-30
44870116901,44870116908,7,3042,1325,-30
44871128786,44871128770,-16,1009,434,-30
44871757395,44871757397,2,2882,3817,-30
44873085059,44873085058,-1,1668,2595,-30
44879859330,44879859335,5,2482,1299,-30
44880355238,44880355243,5,2109,970,-30
44881511349,44881511355,6,2721,1590,-30
44882746047,44882746052,5,5481,3687,-30
44886869218,44886869223,5,1779,1014,-30
44887463283,44887463288,5,3098,1948,-30
44888317597,44888317602,5,2101,1395,-30
44888834462,44888834441,-21,2425,1279,-30
44889483975,44889483980,5,2251,1251,-30
44896138821,44896138818,-3,5016,11093,-30
44902362922,44902362927,5,1762,1230,-30
44904895902,44904895906,4,2018,1359,-30
44904924126,44904924130,4,2799,1996,-30
44912974110,44912974114,4,1530,1087,-30
44914200587,44914200593,6,1931,1519,-30
44915915137,44915915144,7,2797,1604,-30
44918553353,44918553360,7,2578,1128,-30
44922480588,44922480595,7,2528,1290,-30
44926914335,44926914341,6,1451,1096,-30
44927889142,44927889147,5,3052,905,-30
44931154777,44931154777,0,1518,1431,-30
44931565746,44931565741,-5,965,2989,-30
44933550341,44933550348,7,3080,1269,-30
44934662498,44934662504,6,2919,1751,-30
44935173293,44935173299,6,2420,1295,-30
44937535031,44937535035,4,1890,1503,-30
44940321547,44940321553,6,1145,967,-30
44943225052,44943225058,6,2918,1303,-30
44944578583,44944578586,3,2508,2313,-30
44949669959,44949669962,3,1734,918,-30
44951135794,44951135811,17,1831,988,-30
44960096202,44960096207,5,2245,1256,-30
44960199014,44960198995,-19,1760,1023,-30
44961897644,44961897649,5,2370,1443,-30
44966622840,44966622845,5,2646,1800,-30
44966852777,44966852782,5,3612,1152,-30
44970501365,44970501370,5,2181,1350,-30
44971004148,44971004154,6,2815,1748,-30
44971261644,44971261651,7,1867,1090,-30
44972786463,44972786467,4,2267,1482,-30
44978037961,44978037966,5,2091,885,-30
44980469244,44980469252,8,3001,1725,-30
44980914179,44980914186,7,1825,826,-30
44984419431,44984419433,2,3573,3364,-30
44990379859,44990379863,4,1442,622,-30
44992555849,44992555852,3,2005,944,-30
44992775051,44992775056,5,2123,1633,-30
44995417023,44995417025,2,1998,1459,-30
44998026010,44998026014,4,1516,787,-30
45000928130,45000928123,-7,1467,5935,-30
45005585267,45005585275,8,2608,1124,-30
45010723858,45010723843,-15,2366,733,-30
45011777415,45011777419,4,2895,1337,-30
45022124109,45022124113,4,2319,1644,-30
45028318436,45028318442,6,2315,1167,-30
45030161300,45030161306,6,2180,1376,-30
45031827283,45031827288,5,2185,1770,-30
45031867656,45031867661,5,2659,1533,-30
45032607224,45032607229,5,1616,1305,-30
45037037871,45037037877,6,1551,883,-30
45037280726,45037280731,5,2792,1661,-30
45037591102,45037591106,4,1349,994,-30
45039369745,45039369749,4,1784,1659,-30
45040997797,45040997802,5,2435,1473,-30
45047991251,45047991254,3,2213,1526,-30
45048296375,45048296360,-15,3605,1516,-30
45051066075,45051066079,4,2480,816,-30
45053263710,45053263714,4,2234,1487,-30
45053435210,45053435219,9,1788,854,-30
45054997496,45054997502,6,2684,1722,-30
45058816621,45058816626,5,2208,1486,-30
45059297387,45059297371,-16,377,117,-30
45061076635,45061076629,-6,1091,6244,-30
45063134759,45063134763,4,3254,2347,-30
45063229218,45063229202,-16,2696,1171,-30
45064112465,45064112470,5,2791,966,-30
45068472038,45068472032,-6,1208,1618,-30
45068689958,45068689962,4,2461,1094,-30
45071232926,45071232930,4,2013,1330,-30
45073770270,45073770272,2,586,211,-30
45075734294,45075734300,6,1958,1399,-30
45075776521,45075776527,6,2633,1501,-30
45079570070,45079570076,6,1821,1006,-30
45084100103,45084100108,5,1996,1176,-30
45087031539,45087031536,-3,1389,1501,-30
45090621143,45090621150,7,2711,1119,-30
45092503841,45092503844,3,2027,1542,-30
45105789094,45105789099,5,2360,1140,-30
45106056149,45106056150,1,3400,2739,-30
45108246454,45108246457,3,2253,1388,-30
45108363039,45108363027,-12,762,247,-30
45109026258,45109026262,4,2547,1498,-30
45109107902,45109107908,6,1583,1253,-30
45109936987,45109936993,6,2050,1276,-30
45111100038,45111100042,4,2765,1242,-30
45112114084,45112114067,-17,1877,731,-30
45112250977,45112250982,5,2801,1876,-30
45115045032,45115045031,-1,1052,2107,-30
45116826069,45116826066,-3,18297,15033,-30
45119627089,45119627092,3,2366,1002,-30
45123209888,45123209894,6,3105,1448,-30
45126397021,45126397026,5,2473,1738,-30
45129131814,45129131820,6,2725,1003,-30
45134189598,45134189600,2,2103,1644,-30
45136600033,45136600038,5,2202,1133,-30
45141313136,45141313132,-4,1337,3595,-30
45142912067,45142912072,5,2686,1121,-30
45144498851,45144498847,-4,319,246,-30
45145468001,45145467994,-7,2480,7551,-30
45145968387,45145968391,4,1868,1120,-30
45146896850,45146896855,5,2126,1350,-30
45148904629,45148904633,4,1724,933,-30
45150156748,45150156753,5,2312,999,-30
45152472113,45152472118,5,2422,1184,-30
45154208175,45154208153,-22,2985,1609,-30
45157693881,45157693863,-18,2763,1739,-30
45159001117,45159001136,19,1853,1897,-30
45159380398,45159380411,13,1697,1059,-30
45160305171,45160305178,7,3900,1372,-30
45161378742,45161378746,4,2115,1038,-30
45162229150,45162229155,5,1600,1006,-30
45163809981,45163809988,7,2248,1459,-30
45164911275,45164911281,6,4236,1474,-30
45166224694,45166224699,5,1818,1208,-30
45166550818,45166550825,7,4635,1074,-30
45166847834,45166847837,3,1309,1188,-30
45166995775,45166995770,-5,1469,6225,-30
45171557977,45171557979,2,2140,1509,-30
45172804249,45172804256,7,5501,1386,-30
45172982997,45172982999,2,2508,1081,-30
45174315057,45174315062,5,2002,1165,-30
45175255582,45175255587,5,1981,1172,-30
45175730311,45175730329,18,2319,926,-30
45181724985,45181724995,10,14193,25025,-30
45182931757,45182931761,4,2706,1279,-30
45183367644,45183367627,-17,1805,704,-30
45192777282,45192777286,4,2405,1038,-30
45192932169,45192932167,-2,808,1733,-30
45194089650,45194089657,7,2886,1238,-30
45196222179,45196222185,6,2321,1005,-30
45202957354,45202957362,8,1904,992,-30
45205002148,45205002153,5,2230,1276,-30
45215769902,45215769906,4,2526,1238,-30
45216067299,45216067303,4,1874,1198,-30
45218075634,45218075639,5,2327,1725,-30
45219080522,45219080527,5,1869,1027,-30
45219732624,45219732629,5,2190,1136,-30
45224069006,45224069011,5,1631,940,-30
45225714442,45225714445,3,2309,1284,-30
45226043797,45226043795,-2,1020,455,-30
45226859046,45226859052,6,2541,1751,-30
45227454451,45227454454,3,1919,1366,-30
45237654023,45237654028,5,1695,1494,-30
45239777994,45239777998,4,2331,1482,-30
45240021645,45240021651,6,1542,1066,-30
45240769340,45240769324,-16,1931,1324,-30
45241251342,45241251346,4,1574,764,-30
45243274551,45243274556,5,1976,1256,-30
45243502500,45243502507,7,1888,1571,-30
45244373514,45244373519,5,1523,1268,-30
45254206809,45254206814,5,2000,1235,-30
45260977428,45260977435,7,1602,993,-30
45262761068,45262761074,6,1530,1013,-30
45265796059,45265796059,0,1613,1387,-30
45266312523,45266312526,3,2377,1144,-30
45271950822,45271950815,-7,2218,8710,-30
45278071961,45278071962,1,1123,1420,-30
45279439295,45279439289,-6,1821,1130,-30
45282919518,45282919524,6,2580,1502,-30
45284245817,45284245824,7,3145,1610,-30
45284363401,45284363405,4,2122,1093,-30
45287385971,45287385975,4,2219,851,-30
45290015225,45290015230,5,1158,555,-30
45299421521,45299421535,14,12939,49582,-30
45300512117,45300512122,5,2505,1166,-30
45304968502,45304968507,5,1602,992,-30
45305256886,45305256867,-19,685,52,-30
45317148113,45317148118,5,3405,1619,-30
45318302077,45318302082,5,2013,747,-30
45318492682,45318492666,-16,1650,998,-30
45319095601,45319095607,6,3363,1419,-30
45322913505,45322913510,5,1892,1072,-30
45324911577,45324911583,6,2390,1553,-30
45328885726,45328885724,-2,3185,6302,-30
45329716837,45329716833,-4,977,1327,-30
45338491913,45338491919,6,2990,1654,-30
45341006893,45341006898,5,2530,1448,-30
45342125608,45342125613,5,2562,1194,-30
45345362214,45345362218,4,2431,1915,-30
45345426345,45345426350,5,1815,1449,-30
45346043076,45346043081,5,1973,1414,-30
45346370866,45346370851,-15,1916,2125,-30
45346905665,45346905667,2,1058,1092,-30
45350017270,45350017267,-3,2401,4827,-30
45350453382,45350453387,5,1923,1508,-30
45364214434,45364214439,5,2817,1778,-30
45367037545,45367037527,-18,973,304,-30
45369166410,45369166415,5,2873,1613,-30
45370275665,45370275674,9,1848,1045,-30
45370440706,45370440710,4,2976,1445,-30
45374009021,45374009025,4,2339,1823,-30
45375023554,45375023554,0,2710,2407,-30
45375615070,45375615065,-5,1939,5597,-30
45377082099,45377082102,3,1593,989,-30
45378200477,45378200482,5,1462,1200,-30
45379034866,45379034870,4,2223,1764,-30
45380555723,45380555730,7,1681,1275,-30
45382043346,45382043353,7,3336,1603,-30
45383606428,45383606433,5,2567,993,-30
45383945835,45383945831,-4,1502,3386,-30
45384449403,45384449409,6,1794,1333,-30
45387357769,45387357773,4,2079,1699,-30
45392462918,45392462923,5,1880,1352,-30
45393105183,45393105189,6,1780,926,-30
45394627490,45394627495,5,2421,1314,-30
45394785830,45394785834,4,2160,951,-30
45399844195,45399844199,4,2598,1373,-30
45401360198,45401360203,5,3041,1390,-30
45402885578,45402885582,4,1926,1498,-30
45404426492,45404426497,5,2074,1235,-30
45411394932,45411394937,5,2490,1551,-30
45414876616,45414876622,6,1910,1383,-30
45415237030,45415237034,4,2745,1509,-30
45415686979,45415686984,5,1872,1463,-30
45423136540,45423136546,6,2342,1404,-30
45424603578,45424603581,3,2555,1491,-30
45426124861,45426124866,5,1896,1379,-30
45427896670,45427896667,-3,1198,2684,-30
45428079658,45428079662,4,2178,1070,-30
45434646107,45434646110,3,1199,998,-30
45441547807,45441547813,6,3434,1500,-30
45441823431,45441823440,9,2866,1318,-30
45445940844,45445940849,5,1965,1380,-30
45452592478,45452592484,6,2518,1576,-30
45455091478,45455091483,5,2743,1392,-30
45455265300,45455265305,5,2399,1278,-30
45455981558,45455981540,-18,1426,801,-30
45459618581,45459618583,2,1233,868,-30
45460310349,45460310356,7,2560,838,-30
45460367490,45460367497,7,1202,175,-30
45461105589,45461105572,-17,5087,1140,-30
45461961444,45461961449,5,2872,1838,-30
45462407603,45462407606,3,2073,1090,-30
45463391405,45463391410,5,1299,1114,-30
45464428249,45464428234,-15,1092,622,-30
45468462507,45468462505,-2,1180,1803,-30
45469754622,45469754628,6,2457,1361,-30
45469932074,45469932057,-17,2480,1608,-30
45471788993,45471788993,0,1164,1258,-30
45472143994,45472143994,0,1493,1752,-30
45473342644,45473342649,5,1552,1092,-30
45476262241,45476262234,-7,1079,3647,-30
45478876441,45478876446,5,2531,1559,-30
45479005311,45479005316,5,2542,1092,-30
45490330165,45490330169,4,1821,1465,-30
45493984706,45493984709,3,2110,1466,-30
45497847614,45497847606,-8,1362,7822,-30
45498563089,45498563094,5,3004,1630,-30
45498864353,45498864359,6,1362,842,-30
45500526637,45500526642,5,1602,1090,-30
45502465270,45502465274,4,2613,1313,-30
45505143189,45505143194,5,2070,726,-30
45509687270,45509687277,7,2823,1951,-30
45510056615,45510056620,5,1836,1127,-30
45511040706,45511040710,4,1911,1424,-30
45511236281,45511236285,4,1708,1985,-30
45516271709,45516271713,4,2149,1142,-30
45517271789,45517271793,4,2290,1115,-30
45521589013,45521589018,5,2013,1491,-30
45526690569,45526690573,4,2354,1273,-30
45527351961,45527351967,6,3574,1969,-30
45527468334,45527468339,5,2091,1475,-30
45527681539,45527681543,4,1562,1294,-30
45529965470,45529965477,7,1884,1221,-30
45530133125,45530133114,-11,1287,549,-30
45533750270,45533750275,5,1381,1247,-30
45536479439,45536479430,-9,1120,4677,-30
45541359457,45541359462,5,1443,879,-30
45543067917,45543067921,4,3531,1473,-30
45545079147,45545079153,6,2724,1360,-30
45548076112,45548076117,5,1875,1656,-30
45551491118,45551491122,4,2317,1660,-30
45553599111,45553599115,4,2736,1559,-30
45555913141,45555913146,5,2675,1551,-30
45556556358,45556556358,0,985,1724,-30
45556894281,45556894266,-15,2944,1385,-30
45558424774,45558424779,5,2600,1881,-30
45561348946,45561348949,3,1570,2031,-30
45562661652,45562661659,7,2691,1562,-30
45563412125,45563412131,6,2572,827,-30
45564214796,45564214799,3,2668,1441,-30
45566644716,45566644719,3,1524,1073,-30
45567483933,45567483939,6,1923,930,-30
45573152638,45573152642,4,1385,1145,-30
45578621487,45578621492,5,2275,1180,-30
45579921111,45579921114,3,2127,694,-30
45580297916,45580297922,6,2320,1054,-30
45580779124,45580779128,4,1554,730,-30
45585124990,45585124994,4,1843,1300,-30
45591820469,45591820475,6,2853,1405,-30
45593808310,45593808314,4,2257,1245,-30
45596255989,45596255996,7,2238,1440,-30
45596613016,45596613022,6,2112,1187,-30
45597291839,45597291842,3,2251,1349,-30
45600626560,45600626565,5,4640,1697,-30
45604069905,45604069910,5,1883,1223,-30
45605181857,45605181861,4,2664,1610,-30
45606877790,45606877787,-3,1004,2656,-30
45615102057,45615102051,-6,1492,4344,-30
45618409902,45618409907,5,2602,1640,-30
45622173426,45622173432,6,2052,1505,-30
45625278802,45625278798,-4,1493,3215,-30
45625799533,45625799538,5,2321,1626,-30
45626173354,45626173349,-5,2299,7396,-30
45626527546,45626527546,0,1387,2201,-30
45626896833,45626896838,5,1951,1385,-30
45628350933,45628350938,5,2521,1587,-30
45632182570,45632182575,5,1834,1148,-30
45636540446,45636540451,5,1671,1396,-30
45648762181,45648762185,4,2603,1653,-30
45651094841,45651094847,6,2091,1293,-30
45655215880,45655215886,6,1998,1411,-30
45658577415,45658577420,5,1860,1490,-30
45659824903,45659824912,9,1471,1306,-30
45664171268,45664171273,5,3831,1619,-30
45667775950,45667775944,-6,1655,5238,-30
45667830321,45667830326,5,2358,1594,-30
45669342140,45669342147,7,2101,1058,-30
45671822045,45671822049,4,1958,1412,-30
45672987514,45672987518,4,2514,1052,-30
45673258034,45673258018,-16,2070,1487,-30
45676271856,45676271861,5,1702,967,-30
45682161126,45682161126,0,1581,1489,-30
45686109175,45686109179,4,2063,1367,-30
45687536964,45687536969,5,3204,1657,-30
45696270284,45696270290,6,1718,1289,-30
45702330804,45702330809,5,2628,1539,-30
45704755148,45704755149,1,1811,862,-30
45706040836,45706040841,5,1555,914,-30
45708359101,45708359107,6,2113,1066,-30
45708604166,45708604169,3,1675,1544,-30
45711075858,45711075862,4,2422,1234,-30
45712749751,45712749757,6,2575,1187,-30
45713725911,45713725915,4,2304,1163,-30
45715296491,45715296495,4,3030,1455,-30
45716500860,45716500861,1,1756,1779,-30
45719666233,45719666237,4,3159,1269,-30
45722886369,45722886374,5,2397,1600,-30
45727093308,45727093311,3,2146,1493,-30
45727268359,45727268360,1,1443,1227,-30
45730798902,45730798907,5,1422,1225,-30
45730958637,45730958640,3,2281,1368,-30
45733865439,45733865441,2,2337,1782,-30
45736472995,45736472998,3,1862,1256,-30
45739391991,45739391990,-1,1215,1429,-30
45743926489,45743926486,-3,18410,12543,-30
45749196214,45749196217,3,3924,2330,-30
45749689987,45749689981,-6,748,4099,-30
45750496082,45750496089,7,3359,1812,-30
45754325470,45754325474,4,2463,1010,-30
45754719448,45754719453,5,2251,1399,-30
45754800758,45754800764,6,2246,1446,-30
45759614186,45759614190,4,1097,849,-30
45762099978,45762099984,6,1131,659,-30
45765338657,45765338659,2,2106,1296,-30
45778341287,45778341289,2,1659,1432,-30
45786479423,45786479427,4,1969,1305,-30
45786790399,45786790403,4,2084,1303,-30
45788540673,45788540679,6,2180,1632,-30
45788997525,45788997529,4,2033,985,-30
45789487095,45789487090,-5,996,3995,-30
45793239122,45793239126,4,2303,1587,-30
45795455944,45795455963,19,736,1436,-30
45796505712,45796505718,6,2776,1508,-30
45797784414,45797784418,4,2960,1586,-30
45800163509,45800163512,3,1868,1379,-30
45802442555,45802442559,4,1946,1335,-30
45802647828,45802647833,5,1611,1625,-30
45805891889,45805891894,5,2488,1534,-30
45809553099,45809553106,7,1750,1460,-30
45810324397,45810324403,6,1681,665,-30
45813771878,45813771897,19,2203,1042,-30
45815670412,45815670418,6,3294,1412,-30
45819210081,45819210085,4,1598,1455,-30
45820635745,45820635749,4,2480,1947,-30
45821584474,45821584478,4,1924,1222,-30
45822111316,45822111297,-19,2090,1231,-30
45825198097,45825198095,-2,3049,4059,-30
45825489719,45825489724,5,2885,1477,-30
45826163413,45826163417,4,3246,1837,-30
45827361730,45827361733,3,1194,1872,-30
45831045265,45831045271,6,2006,1022,-30
45837581803,45837581799,-4,1586,2672,-30
45838004893,45838004897,4,3392,2066,-30
45839379290,45839379293,3,1827,1147,-30
45842359029,45842359035,6,1650,865,-30
45845101105,45845101111,6,2690,1380,-30
45846266357,45846266361,4,2019,1463,-30
45851248394,45851248398,4,3339,2128,-30
45851965573,45851965577,4,2087,1075,-30
45853043937,45853043942,5,2349,1419,-30
45855032081,45855032085,4,2206,1997,-30
45858066925,45858066929,4,2641,1372,-30
45862886217,45862886223,6,2145,1814,-30
45869853328,45869853333,5,2058,1390,-30
45870728774,45870728778,4,1862,1486,-30
45874465154,45874465160,6,4828,2324,-30
45877895454,45877895455,1,1508,2531,-30
45877959696,45877959694,-2,1014,1375,-30
45878208643,45878208634,-9,854,4516,-30
45881616953,45881616950,-3,1232,2264,-30
45885271658,45885271665,7,2100,1404,-30
45885664222,45885664227,5,1540,1218,-30
45885753810,45885753815,5,2295,1260,-30
45890803892,45890803898,6,2183,1384,-30
45894891126,45894891132,6,2587,1331,-30
45898107201,45898107206,5,3245,1509,-30
45901106886,45901106891,5,1592,1345,-30
45902186489,45902186493,4,1555,1540,-30
45902424078,45902424078,0,2356,3242,-30
45905126815,45905126819,4,1475,1026,-30
45906569474,45906569478,4,2112,1063,-30
45910524061,45910524065,4,2897,1617,-30
45912662266,45912662272,6,3088,1511,-30
45913660251,45913660256,5,2708,1588,-30
45914167801,45914167786,-15,2245,1078,-30
45917168975,45917168980,5,2203,1808,-30
45917453998,45917454003,5,1456,750,-30
45920711010,45920711018,8,2902,1321,-30
45926214717,45926214714,-3,1056,1881,-30
45927183341,45927183346,5,1757,1392,-30
45933321929,45933321936,7,7034,2893,-30
45933843318,45933843322,4,37032,34119,-30
45941521900,45941521899,-1,1369,703,-30
45942039535,45942039534,-1,1582,2129,-30
45944790245,45944790250,5,2091,1498,-30
45946041303,45946041309,6,3011,1839,-30
45946799612,45946799614,2,1679,1018,-30
45954255234,45954255235,1,1801,1176,-30
45955823542,45955823547,5,1490,1354,-30
45957951144,45957951149,5,1373,1209,-30
45959783148,45959783152,4,2153,1321,-30
45960572315,45960572319,4,1994,1722,-30
45961054951,45961054957,6,2036,1340,-30
45962310347,45962310352,5,2737,1462,-30
45962978299,45962978305,6,2654,1528,-30
45963700121,45963700127,6,2454,948,-30
45965839099,45965839094,-5,965,4180,-30
45968102478,45968102484,6,2029,1105,-30
45970709517,45970709522,5,1460,1030,-30
45972649112,45972649115,3,1232,970,-30
45973589110,45973589118,8,3317,1416,-30
45974222650,45974222655,5,2229,1282,-30
45976922895,45976922903,8,2010,978,-30
45977425736,45977425734,-2,2122,3580,-30
45978040424,45978040430,6,1290,1032,-30
45979629014,45979629014,0,15308,7661,-30
45986248001,45986248007,6,2987,1115,-30
45988975040,45988975041,1,1602,2130,-30
45989405933,45989405935,2,1299,1148,-30
45989812265,45989812269,4,2149,1602,-30
45990573971,45990573979,8,1618,1208,-30
45992490158,45992490163,5,2220,1176,-30
45993501131,45993501137,6,2287,1291,-30
45994577912,45994577917,5,2656,1361,-30
45998139614,45998139620,6,2711,1453,-30
45999084255,45999084234,-21,2036,413,-30
46000324192,46000324194,2,1601,1130,-30
46005515560,46005515565,5,3390,1868,-30
46007195257,46007195263,6,1841,944,-30
46008452805,46008452810,5,2064,1068,-30
46012304946,46012304949,3,3477,1831,-30
46012976966,46012976971,5,1709,1224,-30
46015521627,46015521633,6,2449,1100,-30
46017219640,46017219647,7,2417,1462,-30
46024051978,46024051983,5,3005,1743,-30
46031466005,46031466009,4,3169,2447,-30
46032377655,46032377648,-7,1029,2331,-30
46033565345,46033565350,5,3252,1287,-30
46034941887,46034941893,6,2581,1242,-30
46037639538,46037639543,5,2459,1460,-30
46041981677,46041981682,5,2440,1466,-30
46045320641,46045320647,6,1965,1253,-30
46048162245,46048162249,4,2406,1250,-30
46055449962,46055449966,4,1526,1557,-30
46055878530,46055878533,3,2324,1190,-30
46056569675,46056569659,-16,813,299,-30
46062333914,46062333921,7,1420,894,-30
46063145270,46063145274,4,2379,1033,-30
46064966119,46064966123,4,1733,1028,-30
46065996737,46065996731,-6,2036,6594,-30
46070151637,46070151642,5,2978,1665,-30
46071392253,46071392260,7,2295,890,-30
46072946237,46072946242,5,1732,908,-30
46073845073,46073845080,7,1407,985,-30
46079205209,46079205215,6,2539,1497,-30
46079474670,46079474663,-7,2101,8849,-30
46080140307,46080140310,3,2114,1396,-30
46081404155,46081404159,4,1281,1194,-30
46087372354,46087372361,7,3127,1486,-30
46090418052,46090418058,6,6533,1222,-30
46090920379,46090920386,7,2366,1460,-30
46091612696,46091612702,6,2470,1562,-30
46093003487,46093003492,5,2762,1382,-30
46096411191,46096411195,4,2993,2011,-30
46096811292,46096811298,6,1092,1014,-30
46098022664,46098022670,6,2105,1511,-30
46098688032,46098688037,5,2162,1181,-30
46100365526,46100365531,5,2018,1356,-30
46101595395,46101595401,6,2175,1328,-30
46103799185,46103799190,5,2865,1476,-30
46104310790,46104310794,4,868,994,-30
46109120147,46109120150,3,2335,1198,-30
46109455866,46109455870,4,1702,838,-30
46114788750,46114788754,4,2083,1398,-30
46115021781,46115021786,5,1576,1092,-30
46115177622,46115177627,5,2252,1317,-30
46126395927,46126395931,4,2748,1691,-30
46132976148,46132976153,5,2434,1121,-30
46136007162,46136007166,4,2149,1585,-30
46138228883,46138228887,4,2566,1432,-30
46139018167,46139018174,7,1818,1434,-30
46140159776,46140159781,5,1896,991,-30
46140226840,46140226859,19,2397,877,-30
46146845569,46146845573,4,2094,1172,-30
46147123401,46147123418,17,2130,1681,-30
46149854674,46149854678,4,1562,1054,-30
46157876113,46157876110,-3,1367,2684,-30
46164267497,46164267503,6,1843,1139,-30
46164879662,46164879666,4,2288,1299,-30
46165146770,46165146776,6,1736,993,-30
46169377994,46169377998,4,1902,1198,-30
46175810567,46175810570,3,2012,1712,-30
46182416970,46182416975,5,2382,2210,-30
46182450500,46182450506,6,2068,1018,-30
46184461069,46184461074,5,1557,1432,-30
46184518411,46184518414,3,2054,1955,-30
46185788706,46185788711,5,2826,1502,-30
46186157822,46186157827,5,2785,1449,-30
46189070364,46189070371,7,1475,885,-30
46189320876,46189320873,-3,2723,7107,-30
46190062006,46190062013,7,2017,2001,-30
46195505885,46195505892,7,1970,1131,-30
46197858566,46197858570,4,2014,1254,-30
46199024643,46199024647,4,1933,1314,-30
46202716918,46202716923,5,2356,1686,-30
46204208499,46204208505,6,2624,1369,-30
46205487539,46205487542,3,2148,1234,-30
46205977158,46205977165,7,3286,1372,-30
46207017711,46207017715,4,2012,1929,-30
46219650174,46219650179,5,1786,1276,-30
46228227643,46228227650,7,2188,1461,-30
46228376182,46228376186,4,2473,1822,-30
46230767921,46230767923,2,1784,1271,-30
46230980030,46230980010,-20,2221,1320,-30
46232906421,46232906425,4,2314,1499,-30
46233385670,46233385674,4,2355,1139,-30
46234126772,46234126775,3,1920,1407,-30
46234591146,46234591151,5,1946,1381,-30
46234733930,46234733934,4,2685,1568,-30
46234872768,46234872757,-11,1103,489,-30
46235507382,46235507379,-3,833,2441,-30
46241219021,46241219026,5,2678,1511,-30
46242358409,46242358415,6,3073,1171,-30
46242834151,46242834156,5,3876,1347,-30
46246942283,46246942288,5,1916,1187,-30
46247176517,46247176518,1,1627,801,-30
46249365107,46249365113,6,1039,1265,-30
46252756534,46252756535,1,857,773,-30
46254244832,46254244838,6,2179,1434,-30
46258271005,46258271010,5,1840,1261,-30
46258498960,46258498965,5,1935,1367,-30
46258625119,46258625128,9,767,87,-30
46260193398,46260193399,1,1450,1314,-30
46261318057,46261318059,2,1496,1069,-30
46263577322,46263577327,5,3021,1427,-30
46264224609,46264224614,5,3090,1129,-30
46264367835,46264367819,-16,624,258,-30
46264440614,46264440622,8,1797,974,-30
46264760582,46264760562,-20,2635,1011,-30
46264879716,46264879738,22,424,68,-30
46268965408,46268965414,6,1608,1230,-30
46271495153,46271495158,5,1386,978,-30
46278760354,46278760359,5,1277,1133,-30
46281763389,46281763394,5,2100,1220,-30
46282048493,46282048498,5,1369,1198,-30
46284709954,46284709958,4,1747,1160,-30
46288267302,46288267305,3,1678,1312,-30
46289438246,46289438251,5,1920,1109,-30
46290112421,46290112425,4,3158,1566,-30
46291868321,46291868326,5,1102,1568,-30
46294743850,46294743855,5,2051,1348,-30
46294774582,46294774578,-4,1832,4986,-30
46303086991,46303086997,6,3069,1667,-30
46309893457,46309893462,5,1844,1388,-30
46311309975,46311309980,5,1936,1401,-30
46314987571,46314987570,-1,1464,2081,-30
46315181704,46315181706,2,1402,1459,-30
46315362133,46315362116,-17,4166,974,-30
46318415069,46318415075,6,1951,1016,-30
46319315080,46319315087,7,1758,1227,-30
46319636434,46319636419,-15,879,240,-30
46323702097,46323702104,7,2784,1455,-30
46325958437,46325958445,8,4821,1224,-30
46328648993,46328648989,-4,960,2743,-30
46331138950,46331138955,5,2051,1311,-30
46331971146,46331971153,7,2965,1432,-30
46333072203,46333072208,5,1893,1468,-30
46333793010,46333793016,6,2679,1551,-30
46333864295,46333864273,-22,2076,997,-30
46335176702,46335176708,6,3291,1430,-30
46336238323,46336238326,3,2531,1141,-30
46336673941,46336673939,-2,1965,3973,-30
46338059050,46338059054,4,2330,1336,-30
46338529446,46338529427,-19,1415,763,-30
46340273851,46340273854,3,1752,1390,-30
46340617620,46340617623,3,2111,1484,-30
46340645395,46340645401,6,2248,1371,-30
46342731350,46342731354,4,2314,1459,-30
46344565171,46344565176,5,2852,1282,-30
46348174423,46348174427,4,2221,1451,-30
46354060215,46354060222,7,2063,1326,-30
46357460479,46357460485,6,1811,1146,-30
46360460129,46360460129,0,1341,1641,-30
46363127665,46363127670,5,2495,962,-30
46365739077,46365739081,4,2251,1634,-30
46366696818,46366696825,7,2727,1469,-30
46366864259,46366864263,4,1772,910,-30
46367539873,46367539883,10,1079,293,-30
46369309289,46369309293,4,1762,1398,-30
46379373374,46379373378,4,1489,1373,-30
46380781355,46380781359,4,2094,1240,-30
46384077362,46384077369,7,1712,1461,-30
46386643663,46386643642,-21,1149,766,-30
46387475170,46387475173,3,1284,908,-30
46390438626,46390438631,5,2412,1358,-30
46390620291,46390620296,5,2373,1911,-30
46390949171,46390949176,5,2220,1510,-30
46391868362,46391868367,5,1922,1089,-30
46391946662,46391946667,5,1813,1335,-30
46392765366,46392765370,4,2068,1421,-30
46393402372,46393402354,-18,1948,823,-30
46394232303,46394232302,-1,2373,3608,-30
46397564267,46397564274,7,3206,1883,-30
46398825982,46398825986,4,1579,1309,-30
46400853636,46400853640,4,1835,1019,-30
46404243892,46404243896,4,1919,1074,-30
46408376794,46408376800,6,2385,1457,-30
46410090633,46410090637,4,3024,1595,-30
46413505675,46413505681,6,1765,1213,-30
46414702634,46414702642,8,8063,26895,-30
46415495575,46415495582,7,2593,1289,-30
46420695287,46420695282,-5,1528,950,-30
46421590800,46421590804,4,1684,1453,-30
46422701723,46422701729,6,2687,1599,-30
46424290009,46424290002,-7,883,4152,-30
46428471941,46428471946,5,2112,1282,-30
46428895320,46428895331,11,1891,1160,-30
46429093193,46429093209,16,1331,1492,-30
46430190717,46430190722,5,2199,1215,-30
46432394342,46432394346,4,1854,1046,-30
46434287070,46434287074,4,3508,2863,-30
46434358589,46434358594,5,2850,1220,-30
46435261854,46435261858,4,1658,1325,-30
46441194949,46441194954,5,2073,1025,-30
46441822658,46441822662,4,1219,848,-30
46442285971,46442285975,4,2716,1440,-30
46442854965,46442854970,5,2625,1381,-30
46445504267,46445504273,6,2358,1484,-30
46446035183,46446035189,6,2138,1630,-30
46452273056,46452273061,5,2543,1403,-30
46459294070,46459294075,5,2299,1725,-30
46461574369,46461574375,6,2127,1370,-30
46462313315,46462313319,4,2460,1339,-30
46462628750,46462628754,4,2317,1147,-30
46462671433,46462671448,15,2150,871,-30
46466608934,46466608942,8,1443,492,-30
46467327530,46467327535,5,2171,1387,-30
46472757202,46472757207,5,2237,1172,-30
46473049181,46473049186,5,1720,1426,-30
46473431306,46473431309,3,1815,1018,-30
46473720921,46473720925,4,3165,1814,-30
46474140898,46474140903,5,1510,984,-30
46477223834,46477223848,14,13124,53742,-30
46478627823,46478627826,3,2110,1768,-30
46479626180,46479626185,5,2048,1510,-30
46482894329,46482894337,8,5918,2040,-30
46485316246,46485316251,5,2098,1411,-30
46486343718,46486343724,6,2865,1734,-30
46490340942,46490340944,2,2701,1414,-30
46493032005,46493032011,6,2260,929,-30
46505403361,46505403366,5,2489,1311,-30
46508501069,46508501066,-3,1034,2058,-30
46511613271,46511613277,6,3125,1932,-30
46519713414,46519713421,7,3802,1980,-30
46520618234,46520618238,4,2283,1610,-30
46521853422,46521853426,4,1291,1199,-30
46522559695,46522559701,6,2622,1294,-30
46526792125,46526792128,3,2140,1340,-30
46527496286,46527496266,-20,1955,711,-30
46527901606,46527901610,4,2477,1538,-30
46529374354,46529374359,5,1548,1486,-30
46533110337,46533110339,2,1784,1387,-30
46536697262,46536697267,5,1907,1146,-30
46538258378,46538258384,6,2478,1811,-30
46539715401,46539715407,6,1742,1199,-30
46543154170,46543154174,4,2245,1268,-30
46547037523,46547037527,4,2922,1734,-30
46548944962,46548944967,5,2019,1010,-30
46552235224,46552235230,6,1937,1087,-30
46558260593,46558260599,6,2261,1009,-30
46560028738,46560028743,5,2122,1159,-30
46562738086,46562738091,5,1880,1048,-30
46576940771,46576940775,4,1679,1528,-30
46578829155,46578829151,-4,1189,2179,-30
46581324473,46581324477,4,2335,1443,-30
46590234546,46590234551,5,1906,1347,-30
46592498376,46592498382,6,5343,1231,-30
46596019073,46596019078,5,1642,1145,-30
46601223512,46601223515,3,2105,1258,-30
46605051541,46605051546,5,1966,1301,-30
46605651039,46605651043,4,1651,1421,-30
46606141075,46606141081,6,9044,24113,-30
46610524352,46610524352,0,1414,1428,-30
46611152898,46611152892,-6,1351,183,-30
46612930938,46612930945,7,2643,1453,-30
46614846454,46614846459,5,2761,1545,-30
46615235159,46615235166,7,1907,1255,-30
46615284158,46615284163,5,2319,904,-30
46615502732,46615502738,6,2401,1182,-30
46617911921,46617911926,5,2539,1299,-30
46618961713,46618961718,5,1588,1523,-30
46619427878,46619427882,4,2725,1793,-30
46620420239,46620420246,7,1651,1584,-30
46620584118,46620584138,20,2441,1501,-30
46623433700,46623433706,6,2397,1033,-30
46625244495,46625244499,4,2516,1255,-30
46626144139,46626144143,4,2135,1454,-30
46631148466,46631148470,4,1885,948,-30
46632037922,46632037928,6,2151,1419,-30
46632828033,46632828037,4,3061,1201,-30
46633261971,46633261966,-5,1680,3035,-30
46639432329,46639432331,2,1729,1392,-30
46639869334,46639869336,2,1828,1610,-30
46640226647,46640226624,-23,1850,1173,-30
46646322741,46646322746,5,2471,1464,-30
46648295063,46648295059,-4,665,1890,-30
46648543873,46648543878,5,2080,1315,-30
46648967654,46648967659,5,2731,1565,-30
46649407539,46649407542,3,1819,1113,-30
46655943877,46655943883,6,2859,1677,-30
46656709855,46656709860,5,1567,1298,-30
46656739442,46656739451,9,2186,1256,-30
46659156482,46659156487,5,2858,1926,-30
46664543958,46664543963,5,2682,1350,-30
46669598172,46669598176,4,2568,1776,-30
46675554449,46675554443,-6,10642,15662,-30
46680161115,46680161125,10,1786,837,-30
46681878690,46681878694,4,2018,1077,-30
46682037509,46682037513,4,2474,1620,-30
46683118179,46683118162,-17,607,288,-30
46683325770,46683325775,5,3057,1722,-30
46684946947,46684946950,3,1761,1156,-30
46687317424,46687317429,5,2928,1628,-30
46687810605,46687810611,6,1934,1161,-30
46688378126,46688378131,5,795,603,-30
46691075782,46691075778,-4,2512,4704,-30
46695337680,46695337685,5,1794,1343,-30
46696060148,46696060155,7,1716,967,-30
46705182672,46705182677,5,1970,1541,-30
46706073531,46706073535,4,2061,1218,-30
46706736218,46706736226,8,2725,1276,-30
46708348243,46708348247,4,1843,1434,-30
46709572174,46709572174,0,984,1593,-30
46713778194,46713778199,5,1620,1797,-30
46720011927,46720011933,6,2033,1756,-30
46720292319,46720292325,6,2169,1131,-30
46722143101,46722143106,5,2677,1748,-30
46728455182,46728455186,4,1350,816,-30
46734421085,46734421091,6,2993,1479,-30
46737437783,46737437787,4,2097,1242,-30
46741499226,46741499231,5,2494,1323,-30
46743401681,46743401686,5,1859,1132,-30
46744189474,46744189481,7,2913,1839,-30
46745748763,46745748761,-2,1139,2443,-30
46753815722,46753815725,3,2210,893,-30
46754445658,46754445662,4,2495,1873,-30
46755359746,46755359751,5,2111,1189,-30
46756120938,46756120945,7,2530,1168,-30
46757023461,46757023465,4,1845,833,-30
46758303326,46758303330,4,2169,1215,-30
46764233125,46764233129,4,2857,1449,-30
46765021124,46765021130,6,2600,1362,-30
46765499353,46765499365,12,123,1664,-30
46766185902,46766185906,4,2321,1269,-30
46769115034,46769115039,5,2562,1201,-30
46772799730,46772799734,4,1739,900,-30
46773677464,46773677469,5,2497,1166,-30
46781470623,46781470629,6,2014,1224,-30
46781725018,46781725003,-15,1232,788,-30
46787728884,46787728889,5,2315,1582,-30
46788129692,46788129714,22,2300,1229,-30
46788957837,46788957841,4,2249,1268,-30
46790019651,46790019659,8,2132,1047,-30
46791414058,46791414065,7,2011,1144,-30
46791939658,46791939661,3,1759,1749,-30
46792597718,46792597723,5,2174,901,-30
46797278923,46797278929,6,3951,1629,-30
46799672269,46799672274,5,2408,1397,-30
46802178495,46802178500,5,2713,1918,-30
46805795565,46805795568,3,1422,679,-30
46807851402,46807851406,4,1367,879,-30
46811326900,46811326908,8,2793,1154,-30
46812472778,46812472782,4,2494,971,-30
46812844855,46812844860,5,2746,1885,-30
46815208836,46815208839,3,2393,1227,-30
46816805294,46816805298,4,2382,1569,-30
46817957884,46817957890,6,2347,1403,-30
46822913366,46822913371,5,1891,1207,-30
46823314878,46823314886,8,1221,1038,-30
46825012081,46825012087,6,1705,1383,-30
46826211449,46826211455,6,2311,1305,-30
46827140950,46827140957,7,3256,1538,-30
46828897511,46828897513,2,1587,1323,-30
46829393070,46829393090,20,1832,1174,-30
46829585739,46829585742,3,2393,1501,-30
46833262034,46833262035,1,949,1618,-30
46834060790,46834060796,6,3171,1698,-30
46840350634,46840350640,6,2570,1252,-30
46840853437,46840853441,4,3000,1310,-30
46841423874,46841423878,4,1447,992,-30
46843207845,46843207851,6,1668,1102,-30
46844684410,46844684417,7,3241,1718,-30
46850352175,46850352171,-4,852,2980,-30
46850601632,46850601638,6,1538,837,-30
46850840929,46850840936,7,1236,669,-30
46850965058,46850965043,-15,902,605,-30
46855726437,46855726442,5,2189,1085,-30
46860879356,46860879361,5,2144,1106,-30
46861136777,46861136782,5,2948,1453,-30
46863574744,46863574746,2,2154,1409,-30
46864927454,46864927458,4,1892,1271,-30
46868452842,46868452825,-17,1572,1313,-30
46873372791,46873372795,4,2443,1648,-30
46873430951,46873430954,3,2491,1351,-30
46878218863,46878218868,5,1979,1385,-30
46879284621,46879284635,14,10368,45019,-30
46881675341,46881675345,4,1826,1387,-30
46885103594,46885103598,4,2396,1536,-30
46886038763,46886038768,5,2678,1211,-30
46886333109,46886333130,21,2429,1227,-30
46888804067,46888804071,4,2290,1535,-30
46896047852,46896047858,6,2314,1495,-30
46898220057,46898220064,7,1660,1584,-30
46905483706,46905483712,6,3036,1616,-30
46908775342,46908775346,4,1944,1148,-30
46909958443,46909958440,-3,2417,5233,-30
46918037261,46918037266,5,3076,1640,-30
46919667544,46919667549,5,2172,1232,-30
46921939878,46921939899,21,2576,1388,-30
46927830163,46927830169,6,2235,1228,-30
46928124258,46928124262,4,2869,1616,-30
46928445501,46928445482,-19,1732,911,-30
46929207249,46929207255,6,2142,1264,-30
46930392636,46930392640,4,1690,1099,-30
46935033781,46935033786,5,2113,929,-30
46935134327,46935134325,-2,1189,1586,-30
46936540225,46936540231,6,2762,1295,-30
46952154987,46952154994,7,2265,1320,-30
46955945651,46955945659,8,1793,1345,-30
46956653782,46956653795,13,179,704,-30
46957459191,46957459195,4,1977,1194,-30
46959935159,46959935158,-1,1533,969,-30
46960085515,46960085534,19,1744,3312,-30
46963318882,46963318888,6,1907,1142,-30
46965426366,46965426370,4,2005,1039,-30
46965503688,46965503694,6,2679,1661,-30
46967216017,46967216021,4,1421,968,-30
46969630671,46969630671,0,2720,3694,-30
46971349928,46971349933,5,2894,1619,-30
46974687446,46974687450,4,2002,996,-30
46975625545,46975625551,6,3154,1279,-30
46980259762,46980259766,4,2440,1313,-30
46981138607,46981138614,7,4761,1194,-30
46981853437,46981853450,13,2560,1723,-30
46982741976,46982741981,5,1328,1247,-30
46984518642,46984518647,5,2741,1262,-30
46984553246,46984553225,-21,2098,587,-30
46988317514,46988317519,5,1811,860,-30
46990685778,46990685782,4,1992,1518,-30
46991454846,46991454856,10,18792,36165,-30
46992086319,46992086326,7,2075,1231,-30
46996186370,46996186374,4,2203,1585,-30
47000812212,47000812218,6,2168,1157,-30
47007821247,47007821254,7,3478,1459,-30
47011256476,47011256486,10,3518,1054,-30
47013651942,47013651947,5,2942,1292,-30
47013729310,47013729315,5,2301,1549,-30
47017977338,47017977335,-3,941,1337,-30
47022088710,47022088714,4,1736,1162,-30
47026674563,47026674568,5,2095,1328,-30
47027695934,47027695930,-4,1636,4260,-30
47032292771,47032292774,3,2171,1351,-30
47036305886,47036305891,5,2029,1240,-30
47046973714,47046973719,5,3436,1531,-30
47052773416,47052773421,5,2312,1369,-30
47053219647,47053219654,7,2410,1601,-30
47054742321,47054742326,5,1627,1331,-30
47058935553,47058935557,4,3031,1296,-30
47061412220,47061412224,4,2893,1617,-30
47062694342,47062694347,5,2176,1203,-30
47064675450,47064675457,7,3866,1258,-30
47065602822,47065602840,18,2276,1258,-30
47067866910,47067866914,4,2266,1530,-30
47068941618,47068941614,-4,852,2736,-30
47072259330,47072259335,5,2083,667,-30
47073514320,47073514324,4,1693,1008,-30
47078481918,47078481923,5,2421,1002,-30
47079240449,47079240454,5,2633,1761,-30
47079778903,47079778907,4,1959,1144,-30
47081206567,47081206572,5,2532,1704,-30
47081293872,47081293876,4,2147,1364,-30
47082189723,47082189729,6,2374,1322,-30
47083880638,47083880643,5,2080,1328,-30
47089011637,47089011642,5,2266,917,-30
47090605142,47090605147,5,4479,2256,-30
47091086665,47091086671,6,2953,1394,-30
47091720438,47091720440,2,1684,1449,-30
47092314316,47092314318,2,4085,3073,-30
47094473454,47094473454,0,1428,1157,-30
47096093597,47096093603,6,1576,1407,-30
47098299291,47098299296,5,2635,1520,-30
47101541314,47101541318,4,2624,1411,-30
47102586455,47102586459,4,1888,1268,-30
47106526049,47106526054,5,2417,1159,-30
47106637778,47106637783,5,3407,1481,-30
47109073525,47109073530,5,2825,1328,-30
47113110867,47113110870,3,2383,2090,-30
47114166842,47114166846,4,2093,1531,-30
47116811794,47116811798,4,2662,1064,-30
47117395163,47117395161,-2,1043,396,-30
47120198201,47120198194,-7,1622,5084,-30
47120512945,47120512951,6,3421,1177,-30
47121210853,47121210858,5,2519,1712,-30
47123034478,47123034482,4,2125,1415,-30
47125203205,47125203211,6,2289,1477,-30
47126935022,47126935026,4,2158,1964,-30
47128311748,47128311753,5,2401,1408,-30
47129028478,47129028483,5,1641,989,-30
47130420457,47130420449,-8,1168,4212,-30
47131204837,47131204842,5,1696,1082,-30
47135090315,47135090320,5,1887,1337,-30
47136750891,47136750894,3,2012,1322,-30
47138578306,47138578311,5,1780,1170,-30
47141903646,47141903649,3,1389,1311,-30
47144071342,47144071349,7,2698,1067,-30
47148985447,47148985450,3,1464,1544,-30
47153160683,47153160690,7,1416,1373,-30
47154109791,47154109770,-21,2401,1426,-30
47154371452,47154371457,5,2008,1864,-30
47155721009,47155721015,6,2491,1220,-30
47155900326,47155900331,5,2078,1322,-30
47173404972,47173404975,3,2599,794,-30
47173652444,47173652447,3,1398,1263,-30
47178220622,47178220626,4,2392,1019,-30
47178421294,47178421300,6,2265,1241,-30
47178697343,47178697322,-21,2150,1417,-30
47183402847,47183402855,8,2718,1376,-30
47183660606,47183660613,7,2091,1164,-30
47184322906,47184322890,-16,2128,747,-30
47185364030,47185364035,5,3274,1923,-30
47187086298,47187086305,7,3033,1232,-30
47187489245,47187489249,4,2709,1457,-30
47188902182,47188902186,4,3177,1324,-30
47190127667,47190127666,-1,1318,2511,-30
47190783785,47190783789,4,3208,1447,-30
47195717182,47195717187,5,1674,831,-30
47199149250,47199149255,5,2352,1197,-30
47200910847,47200910851,4,1424,910,-30
47211246085,47211246088,3,1629,1171,-30
47211374694,47211374706,12,1806,998,-30
47211813315,47211813319,4,6846,4935,-30
47211937543,47211937550,7,2052,1273,-30
47212493193,47212493199,6,2226,1502,-30
47216110926,47216110930,4,3588,2613,-30
47219571651,47219571658,7,2252,1546,-30
47222480759,47222480763,4,2471,1493,-30
47222967005,47222967010,5,2140,853,-30
47223070146,47223070151,5,2009,1292,-30
47226166385,47226166391,6,2245,1336,-30
47226267418,47226267403,-15,1778,1330,-30
47229101735,47229101743,8,2899,1327,-30
47230099210,47230099216,6,2166,1345,-30
47230174287,47230174267,-20,811,380,-30
47237871294,47237871299,5,2413,1221,-30
47238252865,47238252870,5,2303,1023,-30
47239561957,47239561963,6,2205,1175,-30
47239965923,47239965919,-4,2816,5633,-30
47240447017,47240447024,7,2248,1522,-30
47243583529,47243583535,6,2574,1388,-30
47244977266,47244977271,5,1907,1028,-30
47248478540,47248478544,4,2532,1551,-30
47250023894,47250023899,5,1515,933,-30
47258355122,47258355127,5,2233,1076,-30
47259369905,47259369910,5,2882,1557,-30
47263036781,47263036782,1,3081,1846,-30
47263170915,47263170919,4,2225,1039,-30
47264037173,47264037193,20,1983,1017,-30
47264610215,47264610220,5,2112,1419,-30
47265071214,47265071219,5,2161,1370,-30
47265527243,47265527250,7,4201,1070,-30
47267130303,47267130308,5,1922,1447,-30
47268553892,47268553898,6,1436,1168,-30
47270688628,47270688631,3,2794,2437,-30
47270757210,47270757211,1,1612,1164,-30
47272533006,47272533009,3,1696,1844,-30
47275705654,47275705659,5,1807,939,-30
47279366642,47279366646,4,2329,1714,-30
47281014402,47281014407,5,2529,1255,-30
47283174771,47283174777,6,1425,882,-30
47287212522,47287212527,5,3684,1770,-30
47287846774,47287846778,4,1495,1207,-30
47289665622,47289665621,-1,1274,2098,-30
47292878464,47292878468,4,2498,1311,-30
47293997389,47293997395,6,4237,1580,-30
47294301430,47294301435,5,2082,1387,-30
47300067279,47300067283,4,3419,1395,-30
47304671510,47304671515,5,1843,793,-30
47305758011,47305758015,4,2343,1191,-30
47311797148,47311797154,6,2498,1408,-30
47315049590,47315049594,4,2344,1016,-30
47317188137,47317188141,4,1940,1289,-30
47320419430,47320419443,13,27232,58525,-30
47325540986,47325540990,4,2480,1452,-30
47326537050,47326537053,3,1175,1056,-30
47327182953,47327182960,7,1660,936,-30
47328423115,47328423121,6,2518,1380,-30
47330690659,47330690663,4,2305,1485,-30
47335698149,47335698155,6,2824,1232,-30
47337263371,47337263378,7,2977,1642,-30
47337305937,47337305943,6,2993,1370,-30
47343313763,47343313765,2,1879,1692,-30
47343372541,47343372546,5,2095,1238,-30
47343929416,47343929422,6,2266,887,-30
47346810281,47346810286,5,3056,1803,-30
47347715900,47347715906,6,2833,928,-30
47349738345,47349738348,3,2449,1414,-30
47350879973,47350879978,5,1891,1254,-30
47354761582,47354761587,5,1770,1031,-30
47354799826,47354799817,-9,786,248,-30
47360454129,47360454134,5,2840,1403,-30
47361536614,47361536621,7,1463,904,-30
47364242198,47364242202,4,2143,1340,-30
47368096667,47368096671,4,2278,1478,-30
47369269577,47369269583,6,1636,1356,-30
47375450369,47375450373,4,4026,1194,-30
47379173799,47379173795,-4,818,2587,-30
47385855924,47385855947,23,979,2212,-30
47387065923,47387065927,4,1501,743,-30
47387381890,47387381895,5,1727,1183,-30
47388527558,47388527562,4,1856,1552,-30
47390159226,47390159231,5,2046,1130,-30
47392331171,47392331166,-5,1094,3194,-30
47392801686,47392801689,3,2207,2513,-30
47396259530,47396259534,4,2470,1739,-30
47397320239,47397320246,7,1840,958,-30
47397571134,47397571115,-19,895,1118,-30
47399347998,47399347994,-4,1905,6231,-30
47400196642,47400196644,2,1384,1300,-30
47405174549,47405174555,6,3318,1468,-30
47406264314,47406264308,-6,1593,4597,-30
47406645418,47406645423,5,2835,1663,-30
47407154265,47407154266,1,1376,1072,-30
47412597318,47412597322,4,2156,1416,-30
47417976810,47417976818,8,2597,1019,-30
47418632802,47418632797,-5,1529,5022,-30
47420546483,47420546489,6,2807,1091,-30
47423624477,47423624482,5,2384,1355,-30
47424081173,47424081179,6,1449,1004,-30
47424722233,47424722236,3,2398,1393,-30
47428409030,47428409033,3,1128,951,-30
47435016854,47435016858,4,1378,1031,-30
47436919846,47436919852,6,1708,1694,-30
47438749126,47438749131,5,1751,1382,-30
47439451461,47439451465,4,2706,1384,-30
47441560181,47441560181,0,3985,4357,-30
47444744987,47444744990,3,1762,1410,-30
47446930525,47446930530,5,1687,655,-30
47447082339,47447082344,5,2283,1608,-30
47447589773,47447589778,5,3127,1729,-30
47451932842,47451932845,3,1099,839,-30
47453164602,47453164607,5,2152,1711,-30
47453807856,47453807852,-4,1216,2009,-30
47455114202,47455114207,5,1895,1190,-30
47457877195,47457877179,-16,2476,1429,-30
47464729201,47464729205,4,1568,1095,-30
47467227902,47467227910,8,2144,1376,-30
47470513116,47470513121,5,1749,936,-30
47471947182,47471947185,3,2111,1790,-30
47473584399,47473584402,3,2233,1579,-30
47474674179,47474674186,7,1963,1364,-30
47476980195,47476980190,-5,2562,6857,-30
47477511413,47477511418,5,2213,1657,-30
47479600378,47479600382,4,1452,1297,-30
47480509109,47480509088,-21,2098,671,-30
47483906233,47483906253,20,2985,1289,-30
47490417390,47490417392,2,1425,1406,-30
47491888631,47491888637,6,2371,1280,-30
47493696750,47493696756,6,1667,1125,-30
47493979542,47493979546,4,1978,1211,-30
47502111378,47502111382,4,2707,1071,-30
47507089214,47507089221,7,1928,1526,-30
47511172022,47511172027,5,2577,1352,-30
47515394865,47515394869,4,2480,1472,-30
47516553412,47516553417,5,2031,1628,-30
47519444950,47519444955,5,2352,1499,-30
47521579555,47521579558,3,1992,1568,-30
47525072815,47525072821,6,3212,1383,-30
47525761041,47525761046,5,2093,1328,-30
47526763800,47526763805,5,1851,1567,-30
47527486232,47527486227,-5,1331,620,-30
47528569706,47528569706,0,1075,1860,-30
47531213667,47531213673,6,2739,1644,-30
47532323463,47532323468,5,2001,1190,-30
47534277774,47534277779,5,2233,1227,-30
47534545046,47534545064,18,1542,873,-30
47541885758,47541885764,6,3491,1906,-30
47542381159,47542381158,-1,1157,1568,-30
47545118590,47545118596,6,2256,1652,-30
47547528026,47547528033,7,3256,1332,-30
47549732438,47549732442,4,2296,1228,-30
47555493233,47555493240,7,2744,1181,-30
47559872261,47559872265,4,2001,1359,-30
47563455762,47563455766,4,2133,1446,-30
47563854628,47563854632,4,2476,1754,-30
47565248431,47565248436,5,1858,1307,-30
47566066926,47566066905,-21,619,428,-30
47566452344,47566452350,6,1831,1298,-30
47570024439,47570024443,4,2153,1013,-30
47570385346,47570385328,-18,2741,1411,-30
47571408226,47571408232,6,2972,1561,-30
47574869938,47574869942,4,1490,1094,-30
47577746098,47577746102,4,2670,1780,-30
47577797073,47577797077,4,1929,1832,-30
47579404762,47579404769,7,1724,1429,-30
47584640302,47584640307,5,2683,1377,-30
47586669757,47586669762,5,1842,1139,-30
47589560600,47589560602,2,24808,45725,-30
47598656356,47598656360,4,2454,1419,-30
47599993993,47599994000,7,2117,1330,-30
47601531826,47601531833,7,2433,1644,-30
47605195247,47605195243,-4,1261,3387,-30
47611098932,47611098937,5,2162,1164,-30
47611481251,47611481234,-17,623,470,-30
47613816693,47613816698,5,2060,1373,-30
47614372016,47614372022,6,4057,1748,-30
47614561875,47614561881,6,2592,1571,-30
47615719937,47615719942,5,2866,1619,-30
47617801596,47617801598,2,2138,1855,-30
47618462150,47618462153,3,4149,2181,-30
47619131047,47619131046,-1,1210,1042,-30
47621675210,47621675213,3,1837,1551,-30
47622326566,47622326546,-20,782,652,-30
47625186006,47625186013,7,3621,1406,-30
47627198255,47627198263,8,3150,1241,-30
47627458010,47627458014,4,2195,1284,-30
47630451474,47630451470,-4,1259,3387,-30
47631574636,47631574640,4,1894,1242,-30
47631653545,47631653529,-16,1261,398,-30
47632029053,47632029051,-2,1734,2992,-30
47634507426,47634507434,8,2036,1294,-30
47636035522,47636035527,5,1920,1549,-30
47636312746,47636312750,4,1179,1094,-30
47640519157,47640519161,4,1779,1299,-30
47641430823,47641430802,-21,2218,1096,-30
47645522177,47645522181,4,2308,1200,-30
47647884733,47647884730,-3,1012,1685,-30
47649493601,47649493607,6,1120,918,-30
47649818529,47649818536,7,1754,1502,-30
47651755706,47651755706,0,875,1384,-30
47653578010,47653578005,-5,2053,6782,-30
47654655635,47654655640,5,1459,1282,-30
47662260428,47662260433,5,2276,1217,-30
47663486616,47663486621,5,1573,1137,-30
47666552878,47666552883,5,2819,1134,-30
47668457797,47668457803,6,2529,1546,-30
47671889056,47671889060,4,2259,1597,-30
47674311598,47674311602,4,2107,1396,-30
47677472876,47677472881,5,1840,1195,-30
47677560025,47677560030,5,2415,1339,-30
47679165662,47679165669,7,2022,1148,-30
47679911821,47679911801,-20,2625,699,-30
47684608995,47684608976,-19,1675,854,-30
47687441200,47687441206,6,1512,1060,-30
47691410710,47691410715,5,2372,2096,-30
47697786758,47697786763,5,1812,1332,-30
47697971744,47697971751,7,2821,871,-30
47699029282,47699029288,6,2804,1748,-30
47707091488,47707091494,6,2418,1305,-30
47708075778,47708075782,4,1956,1661,-30
47709154113,47709154097,-16,2388,1286,-30
47709568866,47709568871,5,1500,1448,-30
47711732814,47711732817,3,1668,1969,-30
47714163938,47714163946,8,3113,1287,-30
47715885379,47715885383,4,2174,1710,-30
47716711523,47716711529,6,3065,1794,-30
47717622237,47717622241,4,1835,882,-30
47719456748,47719456732,-16,2396,1352,-30
47725041002,47725041007,5,2643,1224,-30
47729995444,47729995449,5,2195,1488,-30
47730395375,47730395360,-15,1735,819,-30
47732542147,47732542150,3,2072,1493,-30
47733003594,47733003598,4,2756,1969,-30
47733322869,47733322873,4,3450,2121,-30
47745177942,47745177947,5,1854,1102,-30
47752016359,47752016357,-2,1771,1683,-30
47753345323,47753345326,3,2404,2125,-30
47754942115,47754942120,5,2406,1340,-30
47755514044,47755514048,4,2121,1399,-30
47756037277,47756037281,4,2367,1651,-30
47759615894,47759615902,8,2386,1012,-30
47761676381,47761676387,6,9837,4241,-30
47770395694,47770395698,4,2151,1307,-30
47770929838,47770929816,-22,934,571,-30
47772746838,47772746842,4,2095,1304,-30
47779282581,47779282585,4,1688,1161,-30
47779676559,47779676564,5,2596,1312,-30
47780714521,47780714525,4,2166,1303,-30
47785837794,47785837798,4,2238,1266,-30
47786537528,47786537532,4,1411,1279,-30
47787829182,47787829187,5,1900,859,-30
47788131882,47788131898,16,2133,890,-30
47789096917,47789096920,3,3535,2776,-30
47789990752,47789990756,4,3030,1072,-30
47790922283,47790922267,-16,1885,1447,-30
47792824189,47792824196,7,3699,1239,-30
47795237962,47795237966,4,3064,1229,-30
47795913402,47795913406,4,1340,901,-30
47795949863,47795949856,-7,1320,6045,-30
47801907914,47801907919,5,3743,1490,-30
47803268830,47803268834,4,2023,1269,-30
47804187530,47804187538,8,1918,1056,-30
47805502081,47805502086,5,2231,1528,-30
47807785958,47807785963,5,1341,1260,-30
47808687299,47808687307,8,2865,1631,-30
47810027433,47810027438,5,2105,1338,-30
47815466994,47815466999,5,1173,1014,-30
47816024480,47816024486,6,2524,1194,-30
47816978594,47816978600,6,2883,1077,-30
47817812370,47817812375,5,2321,1388,-30
47818762343,47818762363,20,815,296,-30
47819353078,47819353086,8,2508,1192,-30
47819482473,47819482476,3,1598,984,-30
47819853015,47819853018,3,2571,1738,-30
47820562357,47820562360,3,3694,2898,-30
47821733725,47821733731,6,3245,1264,-30
47821981802,47821981806,4,1897,969,-30
47822706563,47822706567,4,1695,876,-30
47823437593,47823437597,4,2342,1863,-30
47824019703,47824019685,-18,612,274,-30
47824676042,47824676048,6,2349,1161,-30
47825746709,47825746715,6,1574,1305,-30
47827786953,47827786961,8,2081,1228,-30
47830817642,47830817646,4,1538,1168,-30
47832487785,47832487791,6,2996,1370,-30
47833074108,47833074113,5,1467,918,-30
47841152726,47841152731,5,1818,1028,-30
47841347719,47841347729,10,973,1080,-30
47844514074,47844514077,3,1804,1461,-30
47849507500,47849507504,4,2095,1543,-30
47853489778,47853489785,7,1914,944,-30
47854804946,47854804950,4,1994,1112,-30
47861637251,47861637255,4,2789,1697,-30
47865895235,47865895239,4,1793,966,-30
47869663112,47869663117,5,1272,1455,-30
47875691065,47875691070,5,1338,1079,-30
47884773078,47884773074,-4,1080,3351,-30
47885583879,47885583882,3,1515,1414,-30
47888268854,47888268859,5,3220,1861,-30
47890703053,47890703059,6,3132,1192,-30
47892185870,47892185876,6,1057,894,-30
47893508881,47893508885,4,2871,2111,-30
47893851995,47893851999,4,1145,883,-30
47895580598,47895580604,6,2939,1354,-30
47897984242,47897984245,3,2627,1882,-30
47898384726,47898384730,4,1579,1660,-30
47899134067,47899134071,4,2458,1096,-30
47903809843,47903809842,-1,1754,2962,-30
47908173934,47908173936,2,1545,1284,-30
47910297011,47910297014,3,1996,1332,-30
47915650421,47915650427,6,1757,1195,-30
47919116747,47919116754,7,3250,1777,-30
47920449377,47920449383,6,2626,1162,-30
47925334775,47925334782,7,1522,1002,-30
47930702416,47930702422,6,2695,1159,-30
47932053913,47932053917,4,1867,1344,-30
47932875854,47932875858,4,1977,1041,-30
47933508109,47933508115,6,2247,1218,-30
47934524887,47934524893,6,2892,1230,-30
47935171939,47935171946,7,2329,1318,-30
47939154640,47939154645,5,1442,958,-30
47940486264,47940486271,7,2147,949,-30
47942012308,47942012311,3,1998,2081,-30
47944917069,47944917075,6,1930,1220,-30
47947045801,47947045807,6,3050,1255,-30
47949440018,47949440025,7,1782,1339,-30
47952482171,47952482176,5,1506,1515,-30
47952803449,47952803453,4,2719,1755,-30
47953285773,47953285775,2,1736,1333,-30
47957912146,47957912150,4,2180,1143,-30
47958452923,47958452927,4,2356,1262,-30
47958831469,47958831473,4,2688,1454,-30
47960869689,47960869694,5,2301,1106,-30
47961495962,47961495968,6,1830,1228,-30
47964575822,47964575827,5,2271,1222,-30
47970417290,47970417295,5,1940,1183,-30
47978017594,47978017598,4,1920,1358,-30
47981214629,47981214644,15,1108,754,-30
47981871796,47981871802,6,2198,1363,-30
47982298242,47982298248,6,2233,1741,-30
47982643949,47982643954,5,2168,1065,-30
47983621606,47983621613,7,3511,1428,-30
47987000546,47987000567,21,3102,1299,-30
47987491414,47987491420,6,1539,1540,-30
47988906869,47988906872,3,3330,2728,-30
47994029285,47994029290,5,2770,1081,-30
47995992634,47995992639,5,2269,1017,-30
47996371495,47996371514,19,282,1518,-30
47999463686,47999463690,4,1694,1075,-30
48002035718,48002035721,3,2226,918,-30
48003443385,48003443389,4,1900,1021,-30
48008095978,48008095983,5,1902,927,-30
48008276753,48008276771,18,613,134,-30
48009568873,48009568878,5,1638,1062,-30
48011832434,48011832439,5,2262,1707,-30
48012176202,48012176207,5,2212,1321,-30
48015059198,48015059202,4,2064,1100,-30
48017577962,48017577967,5,1736,1392,-30
48019912870,48019912874,4,1806,1180,-30
48024777381,48024777386,5,3289,1156,-30
48026879345,48026879343,-2,1567,2379,-30
48027914929,48027914933,4,2170,1205,-30
48029696333,48029696337,4,2006,1816,-30
48032734670,48032734675,5,2546,1162,-30
48033669597,48033669603,6,2510,1182,-30
48034289998,48034290003,5,1765,1303,-30
48035366283,48035366288,5,1784,1234,-30
48037265637,48037265644,7,2025,1216,-30
48037705018,48037705022,4,1610,1033,-30
48038378191,48038378202,11,9743,43587,-30
48038863518,48038863522,4,1739,954,-30
48039438542,48039438545,3,2159,1825,-30
48039799034,48039799049,15,2654,887,-30
48042824594,48042824587,-7,1351,7080,-30
48043424819,48043424823,4,2295,1368,-30
48049048114,48049048119,5,2051,937,-30
48049439969,48049439974,5,1658,817,-30
48051224541,48051224545,4,972,1210,-30
48061032573,48061032578,5,2011,1018,-30
48064246962,48064246966,4,1666,1595,-30
48065427770,48065427775,5,1503,1346,-30
48066482251,48066482258,7,2718,777,-30
48076908156,48076908163,7,3264,1510,-30
48078446729,48078446734,5,2044,1286,-30
48078493629,48078493650,21,1101,825,-30
48078832192,48078832197,5,2732,1388,-30
48080179414,48080179418,4,2915,1322,-30
48080871916,48080871921,5,2483,1163,-30
48082709995,48082710001,6,2332,1161,-30
48084611594,48084611596,2,1742,1573,-30
48086074004,48086074006,2,1241,1239,-30
48088026288,48088026294,6,2233,1138,-30
48090920078,48090920083,5,2418,1452,-30
48101565160,48101565162,2,1947,1543,-30
48106475595,48106475598,3,1364,1511,-30
48111179841,48111179845,4,1821,1037,-30
48112491181,48112491186,5,2049,1356,-30
48112543589,48112543593,4,3045,1429,-30
48112717678,48112717665,-13,869,437,-30
48114368946,48114368950,4,3682,1468,-30
48114602389,48114602394,5,3160,1289,-30
48117031634,48117031638,4,2109,973,-30
48118201342,48118201345,3,2038,1644,-30
48121009607,48121009612,5,2971,1445,-30
48122840798,48122840802,4,1750,970,-30
48125839818,48125839797,-21,1572,4731,-30
48127680722,48127680726,4,1670,1416,-30
48129095278,48129095283,5,2022,1289,-30
48131667329,48131667330,1,1206,1048,-30
48132183038,48132183018,-20,922,532,-30
48134174106,48134174111,5,4007,2927,-30
48137068544,48137068549,5,1641,1134,-30
48138629438,48138629442,4,2137,1448,-30
48141588025,48141588030,5,2600,1668,-30
48141928638,48141928657,19,1766,1535,-30
48146220535,48146220539,4,2083,1129,-30
48152903178,48152903182,4,1973,1407,-30
48153812711,48153812716,5,3419,1604,-30
48157670947,48157670952,5,2774,1639,-30
48160053124,48160053130,6,1185,541,-30
48163408155,48163408159,4,2189,1342,-30
48164310144,48164310149,5,1797,1227,-30
48164660475,48164660481,6,2299,1491,-30
48168820286,48168820291,5,1807,1372,-30
48169591992,48169591998,6,39155,12603,-30
48169971618,48169971601,-17,2602,1938,-30
48170774519,48170774523,4,2230,1425,-30
48172070325,48172070330,5,1438,915,-30
48173866898,48173866901,3,1776,1194,-30
48174474434,48174474439,5,2145,1458,-30
48174961833,48174961839,6,981,749,-30
48176354279,48176354284,5,2087,1353,-30
48177961423,48177961425,2,1040,1441,-30
48179704120,48179704124,4,2164,1149,-30
48180891335,48180891341,6,2751,1010,-30
48181323399,48181323409,10,978,200,-30
48184407558,48184407562,4,2738,1619,-30
48187160567,48187160573,6,2935,1042,-30
48192341469,48192341475,6,1739,1441,-30
48197509397,48197509403,6,1945,1113,-30
48198735881,48198735886,5,2689,1623,-30
48198839434,48198839438,4,3177,1583,-30
48200516210,48200516217,7,629,142,-30
48201936415,48201936409,-6,1049,3643,-30
48204156185,48204156190,5,1764,1272,-30
48208482589,48208482594,5,2373,848,-30
48209644041,48209644047,6,2457,1240,-30
48210705579,48210705574,-5,1787,3715,-30
48215944785,48215944791,6,4389,1328,-30
48218770342,48218770346,4,2389,1265,-30
48218835917,48218835925,8,2688,1021,-30
48222555693,48222555697,4,1848,1195,-30
48223917077,48223917082,5,2414,1572,-30
48224331117,48224331122,5,2034,1369,-30
48225909346,48225909351,5,2438,1374,-30
48227449712,48227449715,3,1900,1162,-30
48228841209,48228841215,6,1653,1071,-30
48229755177,48229755186,9,1107,1178,-30
48234333958,48234333964,6,2629,1623,-30
48234747890,48234747899,9,2764,927,-30
48235949239,48235949233,-6,2169,6120,-30
48236090202,48236090208,6,3137,1506,-30
48237440147,48237440149,2,12310,10782,-30
48238318009,48238318014,5,2342,1374,-30
48240806445,48240806451,6,1915,820,-30
48243174878,48243174882,4,2377,1295,-30
48248610799,48248610806,7,2734,1311,-30
48249470269,48249470272,3,2302,1385,-30
48251505265,48251505270,5,1878,1327,-30
48254887333,48254887338,5,2074,941,-30
48257208599,48257208602,3,2147,1490,-30
48258683269,48258683275,6,3925,1814,-30
48259178199,48259178205,6,1172,1359,-30
48264689058,48264689064,6,1793,1170,-30
48264832129,48264832135,6,2196,1188,-30
48267695457,48267695462,5,2394,1287,-30
48269386087,48269386094,7,2591,1387,-30
48271189075,48271189071,-4,831,2566,-30
48272618539,48272618543,4,3169,1755,-30
48276525314,48276525319,5,920,982,-30
48277408418,48277408425,7,2420,1466,-30
48279649747,48279649751,4,3233,2057,-30
48281240498,48281240501,3,1579,1491,-30
48281739018,48281739016,-2,2366,4764,-30
48282230385,48282230386,1,1883,1776,-30
48282352621,48282352618,-3,1487,3594,-30
48285439704,48285439708,4,2181,1084,-30
48286163825,48286163825,0,1563,1419,-30
48287186061,48287186066,5,2884,1732,-30
48288663928,48288663934,6,1972,1199,-30
48293237403,48293237409,6,2372,1259,-30
48293578624,48293578627,3,1972,884,-30
48294152086,48294152092,6,1572,1196,-30
48294379678,48294379682,4,2330,1206,-30
48296018986,48296018982,-4,1666,3443,-30
48297757255,48297757250,-5,1350,3575,-30
48300577895,48300577901,6,2963,1585,-30
48304176189,48304176196,7,3644,755,-30
48304378124,48304378107,-17,2211,1408,-30
48311051777,48311051782,5,1479,979,-30
48312072446,48312072447,1,2022,1745,-30
48313784330,48313784334,4,2268,1402,-30
48316408001,48316408001,0,1399,1540,-30
48319058723,48319058727,4,2493,1729,-30
48321872077,48321872094,17,544,166,-30
48325647865,48325647869,4,3103,1741,-30
48326288515,48326288498,-17,969,422,-30
48326532185,48326532188,3,2167,1703,-30
48327263823,48327263827,4,1605,855,-30
48331497756,48331497762,6,3298,1710,-30
48335531898,48335531903,5,2673,1256,-30
48335709406,48335709411,5,2590,1067,-30
48338726138,48338726142,4,2173,1895,-30
48338823302,48338823306,4,2287,1572,-30
48355285475,48355285480,5,1877,1410,-30
48355911883,48355911886,3,2515,1389,-30
48357055754,48357055757,3,2216,1895,-30
48361292662,48361292666,4,2073,1139,-30
48370906139,48370906141,2,1502,1540,-30
48375012056,48375012062,6,3618,1897,-30
48376970197,48376970199,2,2328,1890,-30
48379664043,48379664055,12,18063,11525,-30
48383242126,48383242130,4,2839,1631,-30
48384522437,48384522441,4,2274,1458,-30
48390525582,48390525587,5,2726,1509,-30
48391976997,48391977003,6,2084,895,-30
48393005399,48393005378,-21,877,357,-30
48394799635,48394799639,4,2283,1098,-30
48396403941,48396403947,6,3066,1724,-30
48396649353,48396649361,8,12105,24120,-30
48396719706,48396719710,4,2501,1378,-30
48399516839,48399516842,3,2029,872,-30
48408688691,48408688694,3,1635,903,-30
48415802146,48415802154,8,2687,1489,-30
48418033049,48418033053,4,2059,1104,-30
48418374051,48418374057,6,2889,1415,-30
48420798811,48420798817,6,2089,2113,-30
48425027596,48425027601,5,2695,1515,-30
48425522997,48425523002,5,2635,1572,-30
48426965343,48426965347,4,2295,1218,-30
48427528331,48427528337,6,3017,1405,-30
48429394822,48429394826,4,1678,1274,-30
48430001370,48430001355,-15,4110,1224,-30
48430219271,48430219273,2,1648,1582,-30
48431138050,48431138051,1,1290,1607,-30
48432315267,48432315271,4,2390,1244,-30
48434832990,48434832994,4,2041,1270,-30
48436187023,48436187029,6,1225,1258,-30
48438489917,48438489922,5,856,996,-30
48444763255,48444763248,-7,19993,15826,-30
48445299785,48445299789,4,2370,1482,-30
48445869346,48445869329,-17,2966,1362,-30
48447612913,48447612918,5,2254,1522,-30
48447866370,48447866374,4,1838,1582,-30
48449012107,48449012116,9,2797,1671,-30
48449382073,48449382078,5,2858,1791,-30
48450946775,48450946779,4,1168,784,-30
48452308549,48452308553,4,2185,1645,-30
48452933417,48452933419,2,2028,999,-30
48457118555,48457118561,6,1686,1231,-30
48457157870,48457157852,-18,1589,919,-30
48457197171,48457197154,-17,1300,1032,-30
48463442590,48463442590,0,1325,2478,-30
48468396998,48468396977,-21,546,240,-30
48472487167,48472487170,3,1464,1686,-30
48477393906,48477393910,4,2367,1272,-30
48479055614,48479055604,-10,1128,1250,-30
48480643693,48480643697,4,1882,1491,-30
48482026853,48482026858,5,2797,1481,-30
48483882885,48483882891,6,3421,934,-30
48484884229,48484884234,5,1760,1140,-30
48489355219,48489355225,6,2195,1104,-30
48493765583,48493765586,3,2667,1455,-30
48496170662,48496170665,3,2219,1488,-30
48496633233,48496633237,4,1965,1623,-30
48502934150,48502934155,5,1462,1300,-30
48509972306,48509972284,-22,1484,917,-30
48510550805,48510550807,2,943,985,-30
48511076342,48511076328,-14,2462,1342,-30
48511862149,48511862154,5,1350,1282,-30
48512052997,48512052979,-18,2290,1151,-30
48512166843,48512166826,-17,2249,731,-30
48514651401,48514651405,4,2335,1363,-30
48519428242,48519428246,4,1974,1220,-30
48519734254,48519734261,7,2459,1638,-30
48525418189,48525418194,5,2158,1188,-30
48526392391,48526392396,5,1346,758,-30
48527338638,48527338643,5,1501,1414,-30
48541397374,48541397379,5,2230,878,-30
48541569594,48541569577,-17,1251,973,-30
48545556870,48545556876,6,1703,1043,-30
48545738530,48545738535,5,3012,1586,-30
48547809077,48547809083,6,1527,936,-30
48549072850,48549072854,4,2339,1206,-30
48549175764,48549175769,5,2597,1543,-30
48550652129,48550652133,4,2207,1101,-30
48553917326,48553917333,7,3383,1171,-30
48555258489,48555258494,5,2401,1204,-30
48555320593,48555320593,0,1464,1499,-30
48556400983,48556400990,7,2632,1368,-30
48558878955,48558878963,8,3189,1250,-30
48560042846,48560042851,5,3355,1604,-30
48561802107,48561802111,4,1723,1311,-30
48562117926,48562117930,4,2325,1196,-30
48569214900,48569214909,9,648,16248,-30
48569958183,48569958190,7,2297,1141,-30
48570449378,48570449374,-4,1799,5508,-30
48571421729,48571421733,4,2495,1335,-30
48571965354,48571965359,5,2166,1385,-30
48578534854,48578534859,5,1852,976,-30
48579329737,48579329743,6,2040,1623,-30
48579687595,48579687602,7,1812,1069,-30
48580906693,48580906697,4,2391,1085,-30
48582146461,48582146466,5,2294,1456,-30
48584620374,48584620378,4,2193,1420,-30
48585076979,48585076982,3,2717,1421,-30
48589374438,48589374443,5,2036,1089,-30
48589557100,48589557098,-2,1905,2636,-30
48590061221,48590061226,5,2789,1064,-30
48591762170,48591762163,-7,1685,5031,-30
48591882694,48591882700,6,2851,1803,-30
48592650211,48592650219,8,3010,1477,-30
48594753261,48594753266,5,2673,1282,-30
48605339889,48605339897,8,3504,1028,-30
48605441605,48605441586,-19,930,201,-30
48621910339,48621910340,1,1299,1736,-30
48629161675,48629161658,-17,546,1576,-30
48629591074,48629591078,4,1953,1441,-30
48630012161,48630012165,4,1868,1183,-30
48633123588,48633123594,6,1652,1062,-30
48633803551,48633803554,3,2182,1079,-30
48633832011,48633832017,6,2774,1093,-30
48635811950,48635811956,6,2775,1633,-30
48637887482,48637887486,4,2316,1273,-30
48638211091,48638211076,-15,1630,690,-30
48640734270,48640734274,4,1831,1095,-30
48644383008,48644383011,3,1660,1062,-30
48645163449,48645163453,4,1642,1259,-30
48645433690,48645433694,4,3087,1925,-30
48648028270,48648028278,8,1456,977,-30
48649975010,48649975015,5,2291,1018,-30
48654027727,48654027734,7,2863,1025,-30
48655894225,48655894227,2,1719,1090,-30
48657634938,48657634946,8,2653,1308,-30
48658462206,48658462209,3,2523,1558,-30
48659030079,48659030083,4,2374,1433,-30
48660064293,48660064298,5,3399,1299,-30
48661493526,48661493533,7,3250,1663,-30
48661874788,48661874794,6,2353,1065,-30
48663840908,48663840912,4,2581,1441,-30
48675646425,48675646429,4,2349,1225,-30
48682428774,48682428774,0,31405,22870,-30
48683426783,48683426789,6,2959,1707,-30
48685434308,48685434313,5,2709,1569,-30
48688845258,48688845263,5,1286,1072,-30
48689189215,48689189219,4,2665,1536,-30
48690229535,48690229540,5,3245,1184,-30
48690620200,48690620205,5,2675,1370,-30
48695751298,48695751283,-15,860,277,-30
48696963231,48696963238,7,2500,1436,-30
48700548838,48700548843,5,2638,1425,-30
48701011896,48701011900,4,2871,1648,-30
48704784956,48704784961,5,2598,992,-30
48704872154,48704872157,3,1992,1258,-30
48706980267,48706980273,6,1746,1102,-30
48711839840,48711839826,-14,1640,833,-30
48714669616,48714669623,7,2969,1585,-30
48717689922,48717689927,5,2734,1506,-30
48718279729,48718279734,5,1951,1349,-30
48720278018,48720278024,6,3725,1722,-30
48726782470,48726782476,6,2310,1300,-30
48729711277,48729711282,5,2106,1184,-30
48729980824,48729980830,6,1846,615,-30
48730385498,48730385502,4,1440,818,-30
48730764337,48730764340,3,1543,1050,-30
48733011866,48733011872,6,2348,1513,-30
48736192448,48736192441,-7,184,1550,-30
48739192606,48739192611,5,2152,826,-30
48743312108,48743312115,7,2160,1372,-30
48748340825,48748340823,-2,1107,2595,-30
48749411603,48749411608,5,3161,1949,-30
48757619394,48757619399,5,2334,1151,-30
48758264427,48758264432,5,1454,1058,-30
48759532471,48759532477,6,2899,1085,-30
48760075759,48760075763,4,2116,1177,-30
48760281616,48760281622,6,3134,1736,-30
48762721806,48762721810,4,2519,1687,-30
48762756173,48762756153,-20,1251,696,-30
48763802759,48763802760,1,1207,1358,-30
48764201817,48764201822,5,2728,1089,-30
48764925938,48764925944,6,3140,1761,-30
48769136006,48769136012,6,1821,1685,-30
48770064257,48770064263,6,2486,1497,-30
48771015021,48771015026,5,1950,1129,-30
48771408417,48771408422,5,6896,2694,-30
48772088945,48772088951,6,1360,1002,-30
48774728122,48774728121,-1,7658,13726,-30
48776328064,48776328069,5,1878,1193,-30
48781253975,48781253979,4,2388,1357,-30
48787683742,48787683747,5,2215,1627,-30
48787891111,48787891111,0,858,837,-30
48788824746,48788824754,8,2041,1736,-30
48789988275,48789988277,2,1498,1678,-30
48792817678,48792817685,7,2943,1248,-30
48794053842,48794053846,4,1951,1263,-30
48800272538,48800272542,4,2548,1210,-30
48801825703,48801825707,4,1610,715,-30
48802978684,48802978689,5,2671,1815,-30
48805258819,48805258822,3,3510,1940,-30
48806068041,48806068045,4,1136,769,-30
48809596581,48809596574,-7,1757,5998,-30
48813678587,48813678591,4,1467,1211,-30
48816081422,48816081427,5,2364,1307,-30
48816804245,48816804247,2,1955,1183,-30
48818194210,48818194215,5,2273,1078,-30
48823114818,48823114824,6,2933,1533,-30
48824729046,48824729050,4,1858,921,-30
48831205983,48831205988,5,2548,1552,-30
48834485920,48834485924,4,1916,1123,-30
48839423313,48839423318,5,2719,1494,-30
48843244258,48843244265,7,2660,1561,-30
48849379335,48849379341,6,2461,643,-30
48850419338,48850419344,6,2303,1529,-30
48853014535,48853014537,2,1107,1172,-30
48853438755,48853438753,-2,27814,16824,-30
48856657244,48856657249,5,1903,1005,-30
48856900414,48856900395,-19,2195,1620,-30
48857866393,48857866384,-9,773,221,-30
48859149338,48859149345,7,2113,1400,-30
48864708995,48864709002,7,1624,998,-30
48866081140,48866081143,3,2188,1424,-30
48866132988,48866132994,6,1960,1568,-30
48871519836,48871519839,3,1942,1394,-30
48872269597,48872269599,2,1073,1124,-30
48874714014,48874714019,5,2276,1392,-30
48879080854,48879080858,4,1213,921,-30
48881038913,48881038918,5,2987,1676,-30
48882929473,48882929478,5,2371,1187,-30
48883744758,48883744762,4,1584,893,-30
48885073840,48885073845,5,2361,1192,-30
48887190725,48887190731,6,1549,950,-30
48888609143,48888609146,3,2022,1104,-30
48888751770,48888751773,3,2826,1362,-30
48891339944,48891339949,5,1088,852,-30
48893363750,48893363757,7,1981,1580,-30
48893935918,48893935925,7,1817,1377,-30
48897453032,48897453038,6,2642,1533,-30
48897700204,48897700200,-4,20286,13202,-30
48900850194,48900850199,5,2621,1334,-30
48901729458,48901729462,4,2563,1439,-30
48902490071,48902490074,3,1543,1033,-30
48902550626,48902550630,4,1146,938,-30
48903260722,48903260726,4,1567,967,-30
48904277030,48904277034,4,3102,1997,-30
48906211970,48906211975,5,3445,1323,-30
48907275650,48907275657,7,2642,1385,-30
48909599214,48909599218,4,2076,1546,-30
48913276913,48913276917,4,3022,1081,-30
48914874621,48914874626,5,2077,1449,-30
48915617313,48915617315,2,1469,964,-30
48916507463,48916507466,3,2876,1297,-30
48917453589,48917453593,4,2445,1303,-30
48920418278,48920418283,5,1637,1711,-30
48920595652,48920595657,5,2432,1550,-30
48930342982,48930342986,4,2321,1320,-30
48933720874,48933720873,-1,1735,1850,-30
48934884658,48934884663,5,1940,1366,-30
48938999322,48938999327,5,1742,935,-30
48942173495,48942173502,7,2095,1528,-30
48944098202,48944098206,4,2917,1508,-30
48947913475,48947913479,4,2255,2151,-30
48949735288,48949735293,5,2201,1665,-30
48955155442,48955155450,8,2900,1501,-30
48959143597,48959143601,4,2423,1520,-30
48961236774,48961236780,6,2367,1372,-30
48967070637,48967070642,5,1871,1267,-30
48968334755,48968334761,6,3193,1929,-30
48969045100,48969045105,5,2558,1284,-30
48969622189,48969622193,4,2249,1292,-30
48970675465,48970675470,5,2557,1208,-30
48977220890,48977220894,4,2346,1375,-30
48978127449,48978127452,3,1941,1490,-30
48988636960,48988636963,3,2306,1232,-30
48989586818,48989586810,-8,2445,460,-30
48992953831,48992953838,7,3814,1317,-30
48993171673,48993171682,9,1556,1381,-30
48994751143,48994751147,4,2160,1086,-30
48998786325,48998786330,5,2532,1292,-30
49002090441,49002090438,-3,1644,3445,-30
49003012111,49003012115,4,2063,1151,-30
49007052882,49007052886,4,2133,1183,-30
49007975846,49007975853,7,1879,906,-30
49009430843,49009430846,3,3151,1261,-30
49009707678,49009707682,4,1803,1274,-30
49011163145,49011163150,5,2090,874,-30
49011472020,49011472001,-19,2140,1281,-30
49012332685,49012332689,4,2567,1714,-30
49012645709,49012645714,5,2008,1112,-30
49014131901,49014131906,5,1144,939,-30
49017865290,49017865294,4,2338,1709,-30
49022394407,49022394388,-19,1555,1390,-30
49027462031,49027462035,4,1996,552,-30
49028162433,49028162438,5,2669,1768,-30
49028652709,49028652714,5,2797,1599,-30
49029391310,49029391311,1,1353,1403,-30
49031644468,49031644473,5,1898,1378,-30
49032472179,49032472173,-6,678,12536,-30
49035296623,49035296626,3,1959,1284,-30
49035523502,49035523506,4,2231,924,-30
49036046483,49036046464,-19,1075,263,-30
49037318450,49037318457,7,908,700,-30
49040341899,49040341903,4,2235,1396,-30
49045019401,49045019406,5,2394,1455,-30
49046156698,49046156703,5,2838,1298,-30
49050283386,49050283391,5,2019,1144,-30
49052065554,49052065558,4,2833,1343,-30
49054195694,49054195700,6,3345,1733,-30
49054788786,49054788783,-3,2206,5216,-30
49058980637,49058980643,6,1656,918,-30
49062959334,49062959338,4,2122,1783,-30
49063166256,49063166255,-1,1071,2034,-30
49063244269,49063244273,4,2041,1026,-30
49063338505,49063338509,4,2490,1257,-30
49064792369,49064792373,4,1688,1446,-30
49068800414,49068800421,7,1596,773,-30
49068876418,49068876424,6,1894,1250,-30
49070717393,49070717398,5,2885,938,-30
49073345666,49073345674,8,1302,648,-30
49073453990,49073453994,4,2663,1692,-30
49073844994,49073844999,5,2670,1690,-30
49075777157,49075777167,10,14955,10902,-30
49077140821,49077140826,5,2814,1096,-30
49077410522,49077410525,3,3039,1745,-30
49086069019,49086069024,5,2413,1205,-30
49086998412,49086998426,14,1314,1277,-30
49094537766,49094537770,4,5079,2681,-30
49101319266,49101319272,6,2173,1364,-30
49101811798,49101811799,1,1823,1614,-30
49102821005,49102821002,-3,984,1883,-30
49103104135,49103104140,5,1607,1075,-30
49103337802,49103337807,5,2944,1377,-30
49103502335,49103502340,5,3169,1496,-30
49104704754,49104704760,6,14121,27326,-30
49106941385,49106941390,5,1949,1154,-30
49107681885,49107681890,5,1770,1319,-30
49108110929,49108110934,5,1774,1552,-30
49112888602,49112888606,4,2114,1330,-30
49113122189,49113122194,5,2442,1305,-30
49113332188,49113332193,5,1563,1080,-30
49114950493,49114950498,5,1455,1025,-30
49116892930,49116892935,5,2772,1421,-30
49118103761,49118103767,6,1986,1082,-30
49119826136,49119826142,6,1414,849,-30
49120481439,49120481446,7,2350,981,-30
49121029711,49121029715,4,1486,1135,-30
49125358628,49125358631,3,2082,980,-30
49132309092,49132309097,5,1411,1108,-30
49133980615,49133980620,5,1708,1374,-30
49140927250,49140927255,5,2298,1232,-30
49144397142,49144397146,4,1725,696,-30
49152809719,49152809725,6,2182,1049,-30
49178017489,49178017494,5,2358,1372,-30
49178826668,49178826673,5,2754,1898,-30
49179340011,49179340019,8,3099,1273,-30
49180037741,49180037747,6,2175,1044,-30
49182826440,49182826446,6,2488,1416,-30
49186299281,49186299284,3,1492,1107,-30
49186738670,49186738648,-22,3420,1458,-30
49189948631,49189948626,-5,1767,3555,-30
49190435238,49190435243,5,2889,2605,-30
49191611212,49191611231,19,1460,1762,-30
49192326939,49192326943,4,1382,871,-30
49194612985,49194612989,4,2345,1333,-30
49196247146,49196247151,5,2586,1487,-30
49198545185,49198545206,21,626,4480,-30
49198643118,49198643122,4,1160,1089,-30
49201523165,49201523168,3,2284,1438,-30
49204738902,49204738907,5,2275,1501,-30
49205337285,49205337290,5,2242,1156,-30
49207114335,49207114341,6,1884,1106,-30
49207162367,49207162362,-5,983,262,-30
49207814401,49207814406,5,2496,1214,-30
49208374985,49208374986,1,8829,10142,-30
49212602170,49212602175,5,1965,1054,-30
49212656749,49212656771,22,2543,1449,-30
49215386198,49215386205,7,2911,1321,-30
49216691549,49216691554,5,2194,1611,-30
49218714070,49218714075,5,1642,940,-30
49222468979,49222468983,4,1515,1177,-30
49222529207,49222529212,5,1638,950,-30
49223286452,49223286457,5,2504,1048,-30
49233864365,49233864370,5,2308,1493,-30
49235694922,49235694926,4,1820,1029,-30
49237805882,49237805888,6,2138,1661,-30
49239061106,49239061100,-6,1437,6048,-30
49245309488,49245309481,-7,1847,5113,-30
49246931558,49246931566,8,2833,1137,-30
49250464202,49250464207,5,1763,1070,-30
49252071796,49252071786,-10,223,816,-30
49253683075,49253683054,-21,1635,1008,-30
49257593590,49257593595,5,1998,1432,-30
49260533619,49260533623,4,2014,915,-30
49261199527,49261199527,0,2105,3003,-30
49262789521,49262789526,5,2098,1332,-30
49263226949,49263226971,22,970,211,-30
49264676053,49264676056,3,3465,1742,-30
49269302023,49269302027,4,2403,1301,-30
49271736695,49271736698,3,2194,2549,-30
49273811697,49273811701,4,2801,1650,-30
49277100127,49277100132,5,2954,1679,-30
49284990623,49284990629,6,1767,880,-30
49286325401,49286325404,3,1882,1293,-30
49287308594,49287308594,0,1391,1970,-30
49288576271,49288576249,-22,2498,1266,-30
49291493049,49291493054,5,2647,1382,-30
49292454373,49292454378,5,1770,1014,-30
49293093775,49293093764,-11,642,237,-30
49294529908,49294529907,-1,1657,2165,-30
49294635399,49294635402,3,1920,1277,-30
49295247899,49295247903,4,2414,1723,-30
49313944945,49313944947,2,1840,1596,-30
49314938941,49314938944,3,2377,1307,-30
49315292737,49315292741,4,2411,1390,-30
49320196345,49320196348,3,2596,1349,-30
49324481164,49324481168,4,2839,1052,-30
49324877977,49324877962,-15,2391,1368,-30
49327477804,49327477810,6,2462,1051,-30
49329825511,49329825516,5,2495,1397,-30
49332257619,49332257625,6,2808,1147,-30
49332719311,49332719305,-6,670,4277,-30
49333547148,49333547153,5,2762,1677,-30
49334817371,49334817378,7,2173,1112,-30
49336171060,49336171066,6,1849,1224,-30
49336693057,49336693054,-3,641,2420,-30
49337190862,49337190866,4,2665,1409,-30
49337246056,49337246042,-14,1631,865,-30
49338366692,49338366701,9,3141,1144,-30
49338726705,49338726708,3,1607,1173,-30
49339767450,49339767455,5,1535,917,-30
49342410771,49342410774,3,1129,1476,-30
49342694298,49342694301,3,1906,1171,-30
49347211336,49347211339,3,1536,847,-30
49349032224,49349032230,6,2426,1228,-30
49354650195,49354650201,6,1551,1227,-30
49358129970,49358129973,3,1699,1206,-30
49359863419,49359863424,5,1769,1414,-30
49362870561,49362870559,-2,1092,2675,-30
49363355465,49363355469,4,1204,1443,-30
49364150221,49364150204,-17,1207,633,-30
49368166558,49368166565,7,3027,1412,-30
49368459038,49368459045,7,2514,1176,-30
49371550278,49371550282,4,2609,1676,-30
49371946217,49371946213,-4,833,1911,-30
49372942500,49372942505,5,1578,1116,-30
49374241613,49374241618,5,4568,1532,-30
49374793559,49374793567,8,1735,1073,-30
49375475931,49375475936,5,2372,1955,-30
49380008107,49380008106,-1,1237,2803,-30
49381186991,49381186996,5,3056,1898,-30
49381986834,49381986838,4,2481,1321,-30
49383115350,49383115353,3,1576,965,-30
49383303085,49383303091,6,1415,938,-30
49383401391,49383401370,-21,1756,1390,-30
49384516727,49384516731,4,1871,1516,-30
49385913127,49385913130,3,1706,1220,-30
49386500253,49386500247,-6,811,3271,-30
49389008807,49389008814,7,2230,1265,-30
49389068147,49389068162,15,1187,1120,-30
49390170977,49390170982,5,2548,1459,-30
49392223234,49392223240,6,1640,1233,-30
49397741798,49397741800,2,1389,1617,-30
49399569622,49399569628,6,2988,1633,-30
49400166041,49400166051,10,741,250,-30
49402657021,49402657027,6,3004,1466,-30
49402750042,49402750046,4,1960,1508,-30
49405176035,49405176040,5,2595,1910,-30
49406623882,49406623889,7,3150,1470,-30
49411632570,49411632588,18,452,3426,-30
49412162460,49412162467,7,3177,1935,-30
49413178474,49413178482,8,2190,1088,-30
49416525394,49416525398,4,2202,1027,-30
49417434886,49417434890,4,2142,1349,-30
49418805083,49418805090,7,3795,1703,-30
49419293054,49419293047,-7,46850,16663,-30
49420164927,49420164933,6,2106,1547,-30
49421539749,49421539754,5,1854,1137,-30
49422866591,49422866595,4,2575,1190,-30
49426813476,49426813481,5,2136,1353,-30
49437402333,49437402339,6,2648,1627,-30
49438803338,49438803343,5,2618,1291,-30
49440254542,49440254547,5,2253,1283,-30
49440631550,49440631563,13,2035,964,-30
49441386921,49441386926,5,2814,1345,-30
49442312372,49442312381,9,76,1235,-30
49446014952,49446014957,5,1875,1033,-30
49446723591,49446723603,12,1515,1137,-30
49447059968,49447059974,6,4237,1862,-30
49447185277,49447185282,5,3333,1719,-30
49448525533,49448525538,5,4671,2691,-30
49452702053,49452702057,4,2811,1769,-30
49456867681,49456867685,4,2457,1781,-30
49457616572,49457616577,5,2678,1744,-30
49457932026,49457932009,-17,1873,1168,-30
49459479922,49459479927,5,1928,1104,-30
49466229714,49466229717,3,2113,928,-30
49475976717,49475976723,6,2949,1880,-30
49479785000,49479785006,6,2266,1389,-30
49480905999,49480905993,-6,1107,4042,-30
49481253866,49481253870,4,2982,1615,-30
49483523721,49483523727,6,2486,1411,-30
49486965596,49486965599,3,1427,1272,-30
49490919213,49490919216,3,2217,1576,-30
49495799989,49495799994,5,2798,1229,-30
49497177611,49497177615,4,2716,1568,-30
49497767871,49497767876,5,2645,1847,-30
49502278369,49502278374,5,1759,1151,-30
49502385742,49502385739,-3,1114,1544,-30
49502427429,49502427435,6,2180,1350,-30
49502631957,49502631938,-19,1536,738,-30
49503284145,49503284146,1,2017,1544,-30
49503462129,49503462133,4,2212,1436,-30
49508262266,49508262270,4,3744,2722,-30
49514888423,49514888426,3,1330,886,-30
49517016442,49517016447,5,2581,1608,-30
49517736716,49517736719,3,2762,1238,-30
49519705135,49519705138,3,1770,1254,-30
49522126858,49522126863,5,1279,1136,-30
49522555810,49522555814,4,2477,1671,-30
49523320032,49523320039,7,2648,1209,-30
49526534310,49526534313,3,1652,1441,-30
49526708963,49526708967,4,1601,1176,-30
49527347930,49527347936,6,1442,1218,-30
49528100009,49528100010,1,2335,2770,-30
49528209829,49528209834,5,2368,1556,-30
49534294663,49534294667,4,2334,1399,-30
49534377674,49534377679,5,1521,1377,-30
49534416535,49534416540,5,1829,1254,-30
49534762433,49534762450,17,1905,1658,-30
49538130432,49538130430,-2,1128,1261,-30
49539208685,49539208690,5,2724,1287,-30
49539973951,49539973931,-20,971,475,-30
49544839562,49544839568,6,2536,1550,-30
49546197730,49546197735,5,1875,1304,-30
49548159054,49548159060,6,2792,1364,-30
49556028569,49556028574,5,1835,1335,-30
49559604019,49559604023,4,1945,1439,-30
49560646489,49560646494,5,1939,1635,-30
49563006878,49563006883,5,1533,860,-30
49563357842,49563357848,6,2214,1674,-30
49571061398,49571061404,6,2978,1648,-30
49573223133,49573223139,6,2155,1186,-30
49574421969,49574421975,6,1882,736,-30
49575211947,49575211951,4,2153,1479,-30
49577048134,49577048137,3,1861,1491,-30
49579629970,49579629967,-3,1627,2850,-30
49580254740,49580254741,1,10124,9855,-30
49580615841,49580615845,4,2395,1523,-30
49586048721,49586048727,6,2954,1174,-30
49592286095,49592286100,5,1862,1091,-30
49594157158,49594157165,7,2260,1199,-30
49595247270,49595247273,3,2186,1085,-30
49596097633,49596097638,5,1520,796,-30
49600152118,49600152122,4,1308,1126,-30
49600585966,49600585970,4,2474,1272,-30
49601818662,49601818666,4,1404,1554,-30
49602033770,49602033782,12,14888,26238,-30
49609550142,49609550146,4,2016,1396,-30
49613404309,49613404314,5,1798,652,-30
49613801818,49613801825,7,3379,1560,-30
49618219237,49618219239,2,1434,1113,-30
49619906093,49619906097,4,2007,1399,-30
49621724403,49621724407,4,2140,1183,-30
49623170574,49623170579,5,3632,1505,-30
49625822173,49625822178,5,2401,1519,-30
49626310332,49626310338,6,1960,935,-30
49628619461,49628619466,5,1927,1268,-30
49628997246,49628997251,5,1087,329,-30
49629804606,49629804588,-18,2021,1033,-30
49633076456,49633076460,4,1970,1584,-30
49635145803,49635145811,8,3872,29261,-30
49640241002,49640241007,5,2482,1192,-30
49641632910,49641632915,5,1665,1103,-30
49651073510,49651073517,7,6554,1852,-30
49653382402,49653382406,4,2643,1487,-30
49655698385,49655698388,3,1521,1267,-30
49658324189,49658324193,4,2364,1464,-30
49669162826,49669162831,5,1407,954,-30
49673707961,49673707966,5,1723,1165,-30
49675004908,49675004914,6,2329,1424,-30
49680558468,49680558472,4,2110,1805,-30
49682707485,49682707489,4,1913,1276,-30
49683984834,49683984833,-1,1225,2337,-30
49684281924,49684281927,3,2103,1534,-30
49685449058,49685449065,7,2630,1513,-30
49687829737,49687829741,4,2198,962,-30
49689144146,49689144151,5,2445,1980,-30
49692306343,49692306356,13,2245,1287,-30
49695671633,49695671639,6,2149,1182,-30
49697881974,49697881979,5,2285,1858,-30
49698229850,49698229857,7,1792,1021,-30
49702115631,49702115637,6,2121,1407,-30
49703629434,49703629437,3,2868,1294,-30
49703682037,49703682018,-19,2742,1434,-30
49706026394,49706026399,5,2498,1529,-30
49709662480,49709662486,6,2358,1286,-30
49715113142,49715113148,6,2765,1653,-30
49715170274,49715170279,5,2343,1206,-30
49716338467,49716338473,6,1178,936,-30
49720674404,49720674410,6,1483,1439,-30
49720977006,49720977013,7,2719,1811,-30
49721902178,49721902195,17,669,2446,-30
49725391245,49725391251,6,2577,1369,-30
49726735514,49726735519,5,1885,1170,-30
49732900726,49732900731,5,673,1244,-30
49736126487,49736126493,6,2198,1127,-30
49737651517,49737651521,4,2036,1293,-30
49738054800,49738054805,5,1747,1305,-30
49738829151,49738829155,4,2012,1294,-30
49743812144,49743812147,3,1494,1056,-30
49745213999,49745214005,6,1794,1475,-30
49746388597,49746388607,10,17163,21673,-30
49749593701,49749593706,5,2519,1416,-30
49750709258,49750709264,6,2307,1395,-30
49752989503,49752989507,4,2551,1402,-30
49762037290,49762037295,5,1664,982,-30
49764773641,49764773647,6,2451,1579,-30
49766189430,49766189416,-14,772,248,-30
49770190295,49770190302,7,3201,2046,-30
49776330601,49776330606,5,2161,934,-30
49780487722,49780487727,5,1556,456,-30
49784397489,49784397488,-1,1418,2277,-30
49784573119,49784573122,3,1951,1285,-30
49787458497,49787458502,5,1990,1627,-30
49788401089,49788401093,4,2247,1225,-30
49788446578,49788446585,7,2770,1213,-30
49790509125,49790509130,5,1895,1311,-30
49802300888,49802300893,5,2465,1289,-30
49805573570,49805573578,8,2105,949,-30
49809254623,49809254629,6,2157,1141,-30
49809778975,49809778953,-22,1497,861,-30
49812104883,49812104888,5,1722,1083,-30
49813224142,49813224147,5,2261,1750,-30
49816359187,49816359190,3,1859,1264,-30
49817920750,49817920757,7,3125,1703,-30
49818574650,49818574636,-14,1899,1087,-30
49819211906,49819211911,5,2632,1843,-30
49820116912,49820116903,-9,18060,29057,-30
49820810106,49820810108,2,24821,24363,-30
49825239175,49825239179,4,2647,1611,-30
49825727815,49825727821,6,1145,784,-30
49836052141,49836052146,5,1991,1666,-30
49838295593,49838295599,6,2085,858,-30
49840350015,49840350017,2,2762,2031,-30
49841271047,49841271052,5,1815,1227,-30
49841437837,49841437828,-9,991,56,-30
49841569686,49841569667,-19,2167,1725,-30
49842563136,49842563119,-17,2420,1295,-30
49846712506,49846712501,-5,504,1829,-30
49847579263,49847579265,2,1365,1817,-30
49850357603,49850357593,-10,1612,942,-30
49851460441,49851460445,4,2143,1162,-30
49855732661,49855732663,2,4481,4201,-30
49859879534,49859879538,4,1843,1189,-30
49860243901,49860243906,5,2227,1219,-30
49861270523,49861270527,4,2033,1020,-30
49862200226,49862200230,4,2115,1831,-30
49871807154,49871807159,5,2620,1749,-30
49872896129,49872896133,4,2153,1355,-30
49883032790,49883032794,4,2237,1279,-30
49883674178,49883674185,7,2851,1779,-30
49883725702,49883725705,3,2714,1548,-30
49890223045,49890223050,5,1879,1280,-30
49894795727,49894795729,2,1998,1725,-30
49897763741,49897763746,5,2823,1355,-30
49901161279,49901161282,3,1648,1498,-30
49905863265,49905863270,5,1704,1263,-30
49906120978,49906120982,4,2035,1328,-30
49907158954,49907158961,7,2123,1638,-30
49916759526,49916759530,4,2574,1302,-30
49918709296,49918709302,6,1839,1235,-30
49924042936,49924042931,-5,1757,7323,-30
49924353230,49924353234,4,2807,1801,-30
49926088363,49926088367,4,1801,1375,-30
49926466896,49926466899,3,2048,1387,-30
49930155825,49930155829,4,1468,1126,-30
49933745718,49933745722,4,2874,1289,-30
49938066726,49938066722,-4,2961,7388,-30
49939416326,49939416331,5,2691,1105,-30
49941880958,49941880962,4,1701,1436,-30
49943438613,49943438610,-3,29592,13582,-30
49943586740,49943586747,7,2807,1740,-30
49952821055,49952821060,5,2024,1064,-30
49957558506,49957558510,4,2082,1580,-30
49957722466,49957722470,4,2812,1284,-30
49959645820,49959645825,5,1568,1217,-30
49960672358,49960672365,7,4060,2057,-30
49961968953,49961968958,5,2245,1320,-30
49962188594,49962188599,5,2595,1590,-30
49962420047,49962420051,4,2108,1371,-30
49963306805,49963306809,4,1584,1134,-30
49965436081,49965436086,5,1666,1278,-30
49966275706,49966275712,6,1748,903,-30
49967790063,49967790044,-19,2376,1276,-30
49969379491,49969379495,4,2346,1615,-30
49975032273,49975032275,2,1924,1666,-30
49975695005,49975695011,6,3394,2169,-30
49976534383,49976534385,2,1590,1275,-30
49978557845,49978557853,8,2741,1150,-30
49981946807,49981946811,4,1950,1356,-30
49982072094,49982072099,5,2345,1286,-30
49986241171,49986241177,6,2510,1713,-30
49987679616,49987679620,4,3111,2209,-30
49989058534,49989058534,0,1166,1754,-30
49990978795,49990978801,6,2516,1381,-30
49995775104,49995775107,3,3867,2896,-30
49996352361,49996352366,5,2998,1936,-30
49996474179,49996474183,4,3320,1488,-30
50002091358,50002091362,4,2233,1318,-30
50004876376,50004876379,3,1615,828,-30
50005644230,50005644234,4,2885,2078,-30
50006715289,50006715294,5,2605,1171,-30
50007767091,50007767094,3,1719,957,-30
50010025751,50010025757,6,1379,1003,-30
50012106593,50012106593,0,1640,2513,-30
50017380317,50017380322,5,1977,1203,-30
50018928283,50018928286,3,1134,1443,-30
50022751590,50022751595,5,2468,1320,-30
50023229371,50023229377,6,2200,1968,-30
50023874882,50023874887,5,2782,2348,-30
50026623161,50026623165,4,1664,1336,-30
50027041542,50027041542,0,996,1590,-30
50032902254,50032902259,5,2443,691,-30
50035687437,50035687442,5,3120,1950,-30
50036032858,50036032862,4,1815,1192,-30
50036489997,50036490002,5,1408,732,-30
50038364797,50038364802,5,2184,1012,-30
50038565720,50038565704,-16,1122,295,-30
50039168725,50039168726,1,1684,1319,-30
50044841998,50044842003,5,2557,1673,-30
50045076067,50045076072,5,1716,1086,-30
50049210825,50049210824,-1,1396,1857,-30
50050117450,50050117455,5,2053,1206,-30
50055505765,50055505769,4,2374,1862,-30
50058294559,50058294562,3,2273,1387,-30
50059019708,50059019711,3,1950,888,-30
50059204550,50059204531,-19,3229,1394,-30
50063717029,50063717035,6,3013,1316,-30
50066501595,50066501599,4,1602,1111,-30
50067601335,50067601344,9,1853,1050,-30
50067682862,50067682866,4,2173,1557,-30
50068581097,50068581101,4,2180,1336,-30
50068856870,50068856874,4,2342,1284,-30
50069286641,50069286646,5,1718,752,-30
50070351307,50070351312,5,1476,1121,-30
50070751757,50070751763,6,3228,1624,-30
50071527860,50071527873,13,88,1243,-30
50073120217,50073120222,5,1939,1478,-30
50078099407,50078099409,2,2611,2642,-30
50085587299,50085587303,4,2053,1420,-30
50088924748,50088924749,1,1257,1253,-30
50090592478,50090592481,3,2603,1473,-30
50090670266,50090670270,4,784,736,-30
50091615684,50091615687,3,1663,1466,-30
50095808908,50095808914,6,2049,1708,-30
50095963006,50095963016,10,1604,539,-30
50100439907,50100439910,3,16870,35619,-30
50103533063,50103533071,8,2801,1116,-30
50106162623,50106162627,4,2389,969,-30
50107153609,50107153614,5,3894,1794,-30
50109943836,50109943840,4,1893,1585,-30
50110156573,50110156552,-21,658,393,-30
50113387142,50113387147,5,2878,1754,-30
50113651346,50113651352,6,1711,1351,-30
50114438185,50114438189,4,2056,1318,-30
50114686004,50114685985,-19,646,105,-30
50115477107,50115477090,-17,1619,1447,-30
50120281198,50120281199,1,2468,3257,-30
50121060269,50121060273,4,3039,1736,-30
50121928606,50121928611,5,1885,1081,-30
50122875224,50122875230,6,2236,1323,-30
50127036806,50127036810,4,2142,1403,-30
50129522183,50129522189,6,2194,1590,-30
50129961228,50129961233,5,2278,1234,-30
50131907313,50131907318,5,1285,1254,-30
50138944741,50138944744,3,2608,1488,-30
50140786222,50140786227,5,1015,504,-30
50143182854,50143182858,4,1918,1144,-30
50143780257,50143780263,6,1872,1299,-30
50146376679,50146376674,-5,1020,1279,-30
50149438995,50149439001,6,1818,1208,-30
50150312938,50150312942,4,1938,1879,-30
50154672840,50154672845,5,1633,1169,-30
50155784562,50155784545,-17,2624,1630,-30
50161395796,50161395799,3,2145,1384,-30
50168333357,50168333360,3,2069,1285,-30
50173240740,50173240743,3,1816,1076,-30
50178238156,50178238144,-12,1596,1532,-30
50179538626,50179538621,-5,912,2941,-30
50180086835,50180086839,4,2278,1208,-30
50182959410,50182959415,5,2138,1154,-30
50184736630,50184736633,3,1482,1343,-30
50186407921,50186407925,4,3349,1703,-30
50191735556,50191735550,-6,1137,3035,-30
50192712012,50192712015,3,1730,1124,-30
50195341035,50195341033,-2,1322,2380,-30
50196080351,50196080365,14,853,3248,-30
50197003028,50197003034,6,2036,1153,-30
50197441415,50197441395,-20,1724,1677,-30
50199440338,50199440338,0,2073,1660,-30
50200465981,50200465986,5,2034,1213,-30
50202694457,50202694461,4,2150,1461,-30
50204437493,50204437498,5,2220,1378,-30
50209060331,50209060333,2,1645,1302,-30
50209479644,50209479649,5,2009,1419,-30
50212141849,50212141854,5,2747,1775,-30
50213316626,50213316631,5,1937,1406,-30
50215597985,50215597989,4,1954,641,-30
50215649742,50215649746,4,1800,852,-30
50217253522,50217253526,4,2047,1168,-30
50221098471,50221098475,4,3636,1988,-30
50224297221,50224297226,5,1566,1304,-30
50224676242,50224676248,6,2643,1662,-30
50225464638,50225464642,4,1309,1082,-30
50228051974,50228051955,-19,1493,936,-30
50233761258,50233761262,4,1297,887,-30
50233880101,50233880082,-19,2106,1504,-30
50236045728,50236045734,6,2834,1275,-30
50236842263,50236842266,3,1465,979,-30
50237392562,50237392567,5,2865,1699,-30
50239158413,50239158418,5,1675,1032,-30
50240798201,50240798205,4,2075,1390,-30
50240948318,50240948322,4,1785,1164,-30
50241121305,50241121310,5,2997,1389,-30
50247942506,50247942513,7,1701,1276,-30
50248597662,50248597644,-18,1481,857,-30
50248679767,50248679772,5,2968,1720,-30
50248732284,50248732306,22,2553,1289,-30
50249548024,50249548029,5,3113,1282,-30
50250682655,50250682660,5,3060,1704,-30
50250791605,50250791608,3,1967,710,-30
50251932131,50251932128,-3,2196,3913,-30
50254117248,50254117254,6,4644,1612,-30
50256045411,50256045416,5,2434,1121,-30
50260280070,50260280076,6,2545,1175,-30
50261235594,50261235600,6,1494,692,-30
50263695178,50263695182,4,2720,1193,-30
50264594138,50264594140,2,1456,1924,-30
50272070619,50272070625,6,2157,1151,-30
50273210767,50273210773,6,2316,1303,-30
50275328546,50275328550,4,3102,1451,-30
50276715226,50276715231,5,3232,1652,-30
50276991107,50276991109,2,1026,1529,-30
50278622336,50278622342,6,14836,20659,-30
50280366583,50280366586,3,1806,991,-30
50282910805,50282910809,4,2314,1422,-30
50283144967,50283144973,6,3061,1668,-30
50283999774,50283999779,5,1388,1014,-30
50287361259,50287361265,6,1635,1045,-30
50287486009,50287485993,-16,1827,1469,-30
50288536520,50288536525,5,2556,1504,-30
50288597537,50288597541,4,2144,1743,-30
50289563000,50289563005,5,3276,1960,-30
50291650587,50291650593,6,2992,1706,-30
50294847058,50294847066,8,1296,697,-30
50296516505,50296516510,5,1582,1440,-30
50299299322,50299299325,3,3058,2068,-30
50301135617,50301135622,5,2145,1057,-30
50301779497,50301779501,4,2322,1286,-30
50302026885,50302026864,-21,1344,474,-30
50303599074,50303599080,6,1440,1269,-30
50304937654,50304937661,7,3247,1322,-30
50305300993,50305300999,6,2565,1267,-30
50305652133,50305652138,5,2754,1273,-30
50306815854,50306815858,4,2168,1421,-30
50307562261,50307562267,6,2699,1204,-30
50311477017,50311477020,3,2068,1749,-30
50314670306,50314670310,4,2918,1589,-30
50317670741,50317670721,-20,1429,865,-30
50319660657,50319660660,3,2406,1381,-30
50320073761,50320073767,6,1954,1122,-30
50320556642,50320556649,7,1994,1334,-30
50323059249,50323059252,3,2297,937,-30
50328034098,50328034102,4,2008,1423,-30
50328297348,50328297351,3,2107,1484,-30
50336918241,50336918247,6,2536,916,-30
50337143302,50337143307,5,2953,1499,-30
50337716314,50337716319,5,1961,1006,-30
50341710573,50341710578,5,2199,1098,-30
50342655173,50342655177,4,3172,1380,-30
50343531149,50343531154,5,3332,1898,-30
50344369226,50344369233,7,2227,1377,-30
50344575791,50344575798,7,2819,1147,-30
50346759405,50346759409,4,1791,1272,-30
50349194925,50349194928,3,1766,777,-30
50357871293,50357871299,6,2474,1548,-30
50358059830,50358059834,4,2770,1796,-30
50360805759,50360805756,-3,965,1836,-30
50363704527,50363704531,4,1898,1038,-30
50372684762,50372684767,5,1804,1104,-30
50374108944,50374108946,2,1787,1893,-30
50376329166,50376329170,4,2074,1959,-30
50376567586,50376567590,4,2669,1004,-30
50378669358,50378669362,4,2719,1354,-30
50380332493,50380332498,5,2263,1128,-30
50383351248,50383351253,5,1479,946,-30
50386507300,50386507298,-2,1346,2150,-30
50387777446,50387777451,5,1359,1127,-30
50390814377,50390814382,5,1764,1161,-30
50393219357,50393219363,6,1761,1130,-30
50393933310,50393933291,-19,941,559,-30
50401568017,50401568022,5,2459,1931,-30
50405252761,50405252765,4,2808,1754,-30
50405881970,50405881976,6,2232,1377,-30
50406525442,50406525442,0,1383,1516,-30
50410693127,50410693131,4,2906,1433,-30
50411692387,50411692372,-15,1095,270,-30
50411729498,50411729502,4,2359,1139,-30
50412376418,50412376416,-2,1979,4132,-30
50414297465,50414297465,0,915,1696,-30
50417737670,50417737673,3,2516,1144,-30
50418730834,50418730825,-9,25029,17912,-30
50419236215,50419236220,5,1955,1155,-30
50424422331,50424422337,6,2447,1315,-30
50425392485,50425392491,6,390,341,-30
50425669991,50425669999,8,2453,922,-30
50428043757,50428043763,6,1946,1312,-30
50429243383,50429243388,5,2138,1564,-30
50430572015,50430572021,6,2429,1271,-30
50430656366,50430656378,12,2200,1051,-30
50431223336,50431223336,0,1864,1594,-30
50441902642,50441902650,8,2595,1550,-30
50444549818,50444549797,-21,1810,1219,-30
50446055406,50446055410,4,3210,1388,-30
50449427854,50449427857,3,1910,895,-30
50455276732,50455276738,6,2591,951,-30
50455523224,50455523243,19,1750,884,-30
50460613301,50460613303,2,1577,1428,-30
50468479895,50468479901,6,1650,1231,-30
50469281158,50469281159,1,433,904,-30
50471093752,50471093754,2,1454,954,-30
50473587725,50473587716,-9,1297,663,-30
50475411210,50475411215,5,2580,1300,-30
50477135158,50477135164,6,3313,1122,-30
50478249565,50478249565,0,1302,2550,-30
50478818180,50478818186,6,1203,716,-30
50480717355,50480717362,7,2123,982,-30
50481756508,50481756511,3,1444,985,-30
50495711237,50495711242,5,3801,1720,-30
50497059424,50497059427,3,3003,1970,-30
50499023987,50499023991,4,2142,1389,-30
50499518448,50499518452,4,1741,1099,-30
50502315841,50502315846,5,4753,3078,-30
50504833947,50504833953,6,1917,757,-30
50505675301,50505675306,5,2303,1448,-30
50514268249,50514268255,6,2950,1224,-30
50519277470,50519277476,6,2872,1698,-30
50521456080,50521456087,7,3139,1302,-30
50525495345,50525495348,3,1843,1466,-30
50525858874,50525858878,4,1375,1280,-30
50525963341,50525963349,8,3211,1206,-30
50526661545,50526661549,4,2183,1484,-30
50533760617,50533760632,15,2464,1248,-30
50534518597,50534518577,-20,1872,898,-30
50535481586,50535481591,5,2035,1106,-30
50537118312,50537118316,4,2021,1065,-30
50539857892,50539857894,2,1900,1692,-30
50541233245,50541233249,4,2526,1295,-30
50543177590,50543177595,5,2841,1383,-30
50557845238,50557845242,4,1648,1282,-30
50561786211,50561786217,6,2163,1253,-30
50566836036,50566836036,0,24095,19900,-30
50569903816,50569903819,3,2254,1535,-30
50570577632,50570577637,5,2041,1479,-30
50573692653,50573692658,5,1757,1326,-30
50573835784,50573835789,5,1621,1093,-30
50574357034,50574357037,3,2371,1615,-30
50576935944,50576935950,6,2897,1607,-30
50578354465,50578354466,1,1956,1222,-30
50582306255,50582306243,-12,2181,1058,-30
50583612532,50583612536,4,2407,1591,-30
50584123534,50584123540,6,3979,1460,-30
50585190898,50585190903,5,1307,909,-30
50587560706,50587560710,4,2042,1043,-30
50588003990,50588003993,3,2887,2349,-30
50589510835,50589510835,0,1154,1935,-30
50593580425,50593580429,4,2666,1143,-30
50594721666,50594721671,5,1908,1279,-30
50596333269,50596333273,4,2941,1771,-30
50598560657,50598560662,5,2523,1511,-30
50601189207,50601189213,6,2210,1406,-30
50602051218,50602051222,4,2715,1220,-30
50602096090,50602096095,5,3077,1902,-30
50602234962,50602234967,5,1766,901,-30
50607616829,50607616826,-3,1235,1721,-30
50613067446,50613067450,4,3134,2172,-30
50613169937,50613169942,5,1890,1406,-30
50613492213,50613492219,6,3297,1124,-30
50616538337,50616538324,-13,1397,831,-30
50622560014,50622560018,4,2094,1501,-30
50626166076,50626166078,2,2127,1425,-30
50630327880,50630327887,7,2302,1165,-30
50631190469,50631190470,1,1914,1701,-30
50631789174,50631789178,4,1656,1366,-30
50632632526,50632632515,-11,1138,98,-30
50634311142,50634311148,6,2515,1357,-30
50634575838,50634575842,4,769,178,-30
50635421288,50635421293,5,81691,45095,-30
50645814289,50645814294,5,2157,1119,-30
50647899690,50647899693,3,1222,703,-30
50659098913,50659098917,4,1721,1305,-30
50666351664,50666351669,5,2928,1880,-30
50670185985,50670185991,6,1699,1003,-30
50672581913,50672581917,4,2163,1370,-30
50673508607,50673508600,-7,544,4011,-30
50678996125,50678996130,5,3122,1329,-30
50680502145,50680502150,5,2845,1494,-30
50680802167,50680802173,6,2420,1259,-30
50683415062,50683415067,5,2047,1034,-30
50689622169,50689622171,2,1631,869,-30
50690315839,50690315843,4,2068,1459,-30
50691914298,50691914302,4,3037,1571,-30
50693083434,50693083438,4,2215,1402,-30
50698099005,50698099012,7,4131,1680,-30
50700423093,50700423078,-15,100,1150,-30
50705050910,50705050912,2,1602,1857,-30
50707711852,50707711856,4,2439,1156,-30
50709047174,50709047179,5,3060,1699,-30
50710427194,50710427213,19,124,1082,-30
50711691050,50711691055,5,1077,679,-30
50711835982,50711835986,4,2017,1487,-30
50713996305,50713996309,4,2935,1694,-30
50717886841,50717886846,5,2751,1872,-30
50719728010,50719728012,2,3717,2064,-30
50720216786,50720216789,3,2342,1403,-30
50721488446,50721488450,4,2719,1646,-30
50722267666,50722267670,4,2402,1981,-30
50728058586,50728058591,5,2987,1698,-30
50729177908,50729177913,5,2656,2032,-30
50733530361,50733530346,-15,1187,821,-30
50735733040,50735733045,5,2317,1831,-30
50737218204,50737218209,5,2223,912,-30
50740230233,50740230239,6,2538,1343,-30
50749270264,50749270269,5,2105,1365,-30
50754280856,50754280859,3,2025,1061,-30
50754351474,50754351476,2,1336,1645,-30
50759344284,50759344285,1,1718,1631,-30
50761718098,50761718103,5,1406,1124,-30
50766484734,50766484738,4,3480,1673,-30
50768974759,50768974766,7,3140,1125,-30
50771997380,50771997385,5,2216,1083,-30
50773831942,50773831946,4,1840,1333,-30
50774748527,50774748533,6,2308,1622,-30
50778840019,50778840025,6,1543,1174,-30
50779345713,50779345718,5,2302,1229,-30
50779610014,50779610018,4,1563,684,-30
50783693409,50783693412,3,3614,1553,-30
50785137802,50785137807,5,1940,1729,-30
50789178733,50789178737,4,1694,840,-30
50790148293,50790148298,5,2775,1216,-30
50791836577,50791836583,6,2876,1637,-30
50792513889,50792513894,5,2356,1862,-30
50792619238,50792619242,4,2092,1291,-30
50794093219,50794093222,3,1431,652,-30
50800824843,50800824847,4,1599,1501,-30
50804517558,50804517563,5,1633,1350,-30
50804738885,50804738866,-19,1464,854,-30
50804884971,50804884975,4,2040,1539,-30
50810725954,50810725955,1,1578,1670,-30
50810908405,50810908411,6,2436,1677,-30
50811987898,50811987904,6,2995,2228,-30
50812692377,50812692374,-3,1248,3607,-30
50814718518,50814718522,4,2000,1200,-30
50820176742,50820176742,0,2250,1208,-30
50820897705,50820897713,8,2400,1336,-30
50824503410,50824503416,6,3177,1126,-30
50825945376,50825945382,6,1958,1554,-30
50832759246,50832759251,5,1376,1189,-30
50835472198,50835472203,5,1320,1104,-30
50843579331,50843579337,6,3314,1506,-30
50847096322,50847096326,4,2513,1142,-30
50850271010,50850271014,4,1804,778,-30
50850348150,50850348157,7,2184,1442,-30
50851290335,50851290339,4,2201,1278,-30
50852895455,50852895453,-2,2126,3238,-30
50853834306,50853834311,5,2160,1187,-30
50859703218,50859703223,5,2292,1109,-30
50860908014,50860908019,5,2504,1064,-30
50862122923,50862122922,-1,695,148,-30
50865343282,50865343287,5,2338,1350,-30
50875818556,50875818562,6,1812,869,-30
50876913644,50876913648,4,2363,1851,-30
50878667795,50878667798,3,1805,1006,-30
50880976825,50880976831,6,2371,1070,-30
50885016889,50885016893,4,2419,1321,-30
50892662859,50892662855,-4,1033,2435,-30
50896558645,50896558649,4,2279,1293,-30
50899826898,50899826898,0,665,665,-30
50899913789,50899913794,5,2359,1181,-30
50903877845,50903877849,4,2747,1441,-30
50904213457,50904213462,5,3263,1501,-30
50906508693,50906508692,-1,1559,1131,-30
50909011114,50909011119,5,2945,2000,-30
50910478915,50910478917,2,1770,1493,-30
50912999465,50912999471,6,2427,1388,-30
50913520963,50913520970,7,1777,1253,-30
50914840942,50914840935,-7,780,249,-30
50917681936,50917681942,6,3864,1828,-30
50918762395,50918762400,5,3297,1883,-30
50919447603,50919447609,6,2489,1108,-30
50920196481,50920196486,5,2187,1045,-30
50922500201,50922500205,4,2265,1204,-30
50927021782,50927021787,5,1131,786,-30
50933199702,50933199709,7,2349,1673,-30
50934394989,50934394994,5,3276,1281,-30
50938090520,50938090523,3,2758,1275,-30
50941728446,50941728451,5,2490,1005,-30
50943262640,50943262646,6,2461,1264,-30
50945375923,50945375928,5,2395,1243,-30
50947839495,50947839501,6,2161,1359,-30
50965521366,50965521346,-20,1070,636,-30
50970740610,50970740616,6,2754,1273,-30
50974361002,50974361006,4,2382,1376,-30
50977191372,50977191374,2,1352,1354,-30
50978481602,50978481607,5,1793,1010,-30
50980760969,50980760971,2,1713,1331,-30
50983304863,50983304869,6,2611,1308,-30
50984723070,50984723075,5,2072,1327,-30
50987633143,50987633146,3,2419,1287,-30
50988194982,50988194986,4,2616,1677,-30
50989035314,50989035317,3,1758,1324,-30
50989792290,50989792293,3,1679,1222,-30
50994164947,50994164953,6,2507,1797,-30
50996998054,50996998036,-18,997,642,-30
50997252810,50997252816,6,2048,1975,-30
51002268727,51002268734,7,2055,815,-30
51008348273,51008348279,6,2939,1623,-30
51010418346,51010418349,3,1935,1209,-30
51013783868,51013783873,5,1117,789,-30
51018338794,51018338801,7,2277,1490,-30
51018767575,51018767577,2,1493,1260,-30
51019695197,51019695202,5,2446,1534,-30
51024966326,51024966320,-6,2354,4440,-30
51029119238,51029119241,3,2255,1797,-30
51029788461,51029788466,5,1763,1342,-30
51030480385,51030480390,5,2404,1258,-30
51030649866,51030649852,-14,1673,967,-30
51031082533,51031082554,21,1793,1298,-30
51031653894,51031653899,5,1714,1222,-30
51033847269,51033847273,4,2105,1510,-30
51038277674,51038277678,4,1746,1005,-30
51039243571,51039243552,-19,1359,882,-30
51039632354,51039632358,4,2741,1537,-30
51040205824,51040205829,5,1782,1398,-30
51041102737,51041102728,-9,760,278,-30
51041443645,51041443632,-13,615,167,-30
51045158270,51045158265,-5,1196,4380,-30
51045684338,51045684343,5,1428,997,-30
51047929284,51047929282,-2,1494,4112,-30
51049183782,51049183787,5,2613,1266,-30
51057151131,51057151125,-6,1293,5439,-30
51059364878,51059364881,3,2030,1397,-30
51061691644,51061691650,6,1224,998,-30
51064334995,51064335001,6,1268,1261,-30
51064939991,51064939995,4,1863,987,-30
51068670777,51068670783,6,3348,1790,-30
51068840831,51068840834,3,1269,1275,-30
51071022545,51071022550,5,2630,1781,-30
51071976898,51071976900,2,1430,1173,-30
51074318709,51074318714,5,2987,1698,-30
51074832506,51074832510,4,2094,1701,-30
51075362194,51075362197,3,20737,33002,-30
51077434218,51077434225,7,2812,1283,-30
51080897859,51080897865,6,3756,2339,-30
51083287214,51083287219,5,1418,629,-30
51084342944,51084342947,3,1305,828,-30
51087477469,51087477473,4,2380,1392,-30
51088981262,51088981266,4,2378,1699,-30
51093321683,51093321687,4,2274,1529,-30
51095089441,51095089446,5,2691,1344,-30
51099620994,51099620998,4,2190,1098,-30
51102251337,51102251342,5,2186,709,-30
51102788090,51102788097,7,3442,1398,-30
51105762189,51105762194,5,2752,1089,-30
51116497614,51116497620,6,2886,1465,-30
51116842982,51116842983,1,1567,1306,-30
51122134333,51122134339,6,3183,2116,-30
51122303415,51122303421,6,9345,4388,-30
51124157970,51124157977,7,2281,956,-30
51125048515,51125048522,7,12065,22839,-30
51129528108,51129528114,6,2065,1242,-30
51132690819,51132690826,7,2130,1296,-30
51141074470,51141074476,6,2839,1857,-30
51143019366,51143019369,3,1846,1638,-30
51151504869,51151504857,-12,1065,994,-30
51151826979,51151826984,5,2171,1424,-30
51154072769,51154072774,5,1230,786,-30
51154563490,51154563497,7,2600,1204,-30
51156411466,51156411483,17,3107,1328,-30
51159767775,51159767778,3,2392,1178,-30
51162148585,51162148591,6,1952,1273,-30
51163720902,51163720906,4,2296,1015,-30
51164071628,51164071623,-5,1170,2650,-30
51168482838,51168482843,5,2730,1259,-30
51168969487,51168969494,7,2725,1263,-30
51170433462,51170433469,7,2802,1864,-30
51172093574,51172093581,7,2720,2109,-30
51172394118,51172394117,-1,7360,10713,-30
51172758343,51172758348,5,1852,1210,-30
51174108674,51174108678,4,1124,864,-30
51177619878,51177619873,-5,1328,4371,-30
51178365707,51178365709,2,2329,2662,-30
51178851297,51178851297,0,1668,1051,-30
51185381094,51185381098,4,2227,1346,-30
51185539782,51185539786,4,1551,1377,-30
51185627900,51185627902,2,2074,1449,-30
51186492533,51186492538,5,1937,1328,-30
51186723286,51186723290,4,2712,1886,-30
51187850634,51187850638,4,1483,1250,-30
51188037959,51188037966,7,2764,1451,-30
51191624693,51191624697,4,1408,1174,-30
51192145966,51192145971,5,1191,656,-30
51192854989,51192854994,5,2442,1603,-30
51196864248,51196864251,3,1777,1603,-30
51198584371,51198584376,5,1394,1403,-30
51200397570,51200397576,6,3694,1568,-30
51206047077,51206047083,6,2023,1112,-30
51206445379,51206445364,-15,1670,1010,-30
51209820784,51209820778,-6,432,4135,-30
51216768756,51216768758,2,1672,1158,-30
51217012049,51217012054,5,2983,1994,-30
51222413321,51222413327,6,2745,1678,-30
51224132914,51224132917,3,1585,909,-30
51231091709,51231091714,5,2221,1427,-30
51233716389,51233716391,2,14226,14610,-30
51236469665,51236469669,4,1941,1515,-30
51236514393,51236514398,5,2893,2057,-30
51238011128,51238011132,4,2244,1896,-30
51239095958,51239095963,5,1345,1339,-30
51239603769,51239603777,8,1960,1243,-30
51243541955,51243541953,-2,1379,1959,-30
51244595490,51244595495,5,1601,960,-30
51245122698,51245122701,3,1809,1598,-30
51245184719,51245184723,4,1524,981,-30
51245842835,51245842839,4,1570,1202,-30
51250909667,51250909650,-17,1224,806,-30
51252577582,51252577581,-1,854,1855,-30
51254893889,51254893892,3,1527,1384,-30
51260753421,51260753425,4,2513,1367,-30
51265678710,51265678715,5,1966,1143,-30
51267221545,51267221550,5,3001,983,-30
51268739725,51268739729,4,1703,2008,-30
51269212977,51269212983,6,1719,1277,-30
51270812766,51270812770,4,2072,1117,-30
51271122764,51271122770,6,3537,1482,-30
51274010541,51274010544,3,1701,1405,-30
51274619386,51274619391,5,2581,1425,-30
51278234109,51278234114,5,2538,1075,-30
51279370371,51279370375,4,1665,1434,-30
51286038328,51286038331,3,1910,1255,-30
51287172609,51287172594,-15,1758,1298,-30
51288013902,51288013906,4,1720,1161,-30
51289253279,51289253286,7,3142,1283,-30
51289462943,51289462946,3,2195,1193,-30
51290875151,51290875155,4,2439,1004,-30
51291962869,51291962873,4,2245,1254,-30
51297414266,51297414271,5,2873,1248,-30
51298964795,51298964798,3,2835,1562,-30
51301207628,51301207633,5,1888,1414,-30
51314218466,51314218470,4,3032,1970,-30
51316146697,51316146703,6,6019,1298,-30
51319267150,51319267154,4,1980,1294,-30
51322514894,51322514898,4,1396,880,-30
51323356915,51323356909,-6,675,4688,-30
51323873272,51323873269,-3,21135,14723,-30
51324221617,51324221618,1,1547,1934,-30
51324518500,51324518504,4,2338,1466,-30
51325249466,51325249471,5,2325,1221,-30
51325313426,51325313427,1,1166,2264,-30
51331976330,51331976338,8,1938,1041,-30
51334350264,51334350270,6,1346,791,-30
51338475489,51338475495,6,2397,1675,-30
51338718296,51338718299,3,1685,839,-30
51341537663,51341537666,3,2899,2119,-30
51342443978,51342443983,5,1193,845,-30
51346460333,51346460338,5,1404,1132,-30
51346879502,51346879498,-4,852,2671,-30
51347860608,51347860597,-11,1454,904,-30
51348922637,51348922642,5,2074,1061,-30
51349912258,51349912265,7,1316,814,-30
51351101498,51351101503,5,2902,1425,-30
51351421854,51351421862,8,3768,1236,-30
51353089094,51353089101,7,2846,1442,-30
51356856742,51356856746,4,1372,1028,-30
51361126986,51361126991,5,1629,746,-30
51363250726,51363250724,-2,1755,2240,-30
51364931995,51364932010,15,1437,791,-30
51369270610,51369270614,4,1946,1080,-30
51369385645,51369385649,4,2231,1477,-30
51369647149,51369647153,4,1992,1160,-30
51369682237,51369682237,0,1605,1918,-30
51372347609,51372347602,-7,1622,6450,-30
51372922641,51372922645,4,2528,1947,-30
51375428299,51375428302,3,2869,1281,-30
51379581225,51379581221,-4,26345,15759,-30
51380166527,51380166532,5,2670,1259,-30
51381638524,51381638527,3,2496,1671,-30
51384534394,51384534398,4,2202,1635,-30
51386112822,51386112826,4,2315,1660,-30
51389809073,51389809078,5,1201,881,-30
51393414990,51393414995,5,2334,1212,-30
51393677290,51393677294,4,2690,922,-30
51394340787,51394340790,3,2518,1839,-30
51397773030,51397773034,4,2469,1781,-30
51405058833,51405058837,4,2250,1464,-30
51410400437,51410400442,5,2604,1139,-30
51410589607,51410589586,-21,1725,468,-30
51410801010,51410801010,0,1196,1658,-30
51411240429,51411240435,6,2667,1484,-30
51414168773,51414168778,5,3547,1175,-30
51414651398,51414651395,-3,1012,368,-30
51416411398,51416411402,4,2144,1382,-30
51417417811,51417417817,6,1975,1101,-30
51417704551,51417704556,5,3102,1355,-30
51421195313,51421195319,6,2454,1383,-30
51421245391,51421245391,0,1097,1218,-30
51421501582,51421501587,5,2496,1024,-30
51422096936,51422096936,0,32456,25257,-30
51423302250,51423302254,4,2002,1244,-30
51425750957,51425750960,3,1052,754,-30
51429940486,51429940490,4,1954,1254,-30
51431295770,51431295781,11,2025,1609,-30
51432862359,51432862363,4,2068,1272,-30
51434490942,51434490937,-5,1336,2888,-30
51437090669,51437090674,5,1245,1159,-30
51439038414,51439038419,5,2593,1172,-30
51441279666,51441279667,1,1251,1818,-30
51447277808,51447277811,3,1807,1114,-30
51449376403,51449376408,5,1557,1475,-30
51450700413,51450700421,8,2678,660,-30
51457117699,51457117705,6,2568,1220,-30
51457572357,51457572338,-19,1471,284,-30
51458122103,51458122103,0,1581,1763,-30
51458316079,51458316086,7,1557,878,-30
51458807823,51458807828,5,2199,775,-30
51459742834,51459742841,7,1786,1156,-30
51461826942,51461826936,-6,175,2240,-30
51471563578,51471563585,7,3494,1455,-30
51476160613,51476160617,4,2893,1500,-30
51476613342,51476613341,-1,1136,1624,-30
51476978885,51476978889,4,2713,1598,-30
51478349448,51478349451,3,1659,1475,-30
51478796529,51478796545,16,2071,1342,-30
51481414837,51481414842,5,2339,1431,-30
51481561812,51481561793,-19,914,373,-30
51482991337,51482991343,6,2489,1289,-30
51488079237,51488079243,6,2515,1007,-30
51492490793,51492490798,5,2731,1115,-30
51494812009,51494812013,4,1052,1262,-30
51497275183,51497275187,4,2893,1368,-30
51499643901,51499643905,4,2152,1017,-30
51500116847,51500116827,-20,2788,1487,-30
51504409235,51504409241,6,2339,1353,-30
51505424602,51505424606,4,1830,1286,-30
51506610569,51506610573,4,2233,1182,-30
51508891943,51508891950,7,2073,1226,-30
51511296849,51511296865,16,846,2541,-30
51514069421,51514069426,5,1479,1290,-30
51518049793,51518049799,6,2306,1566,-30
51521261873,51521261878,5,2234,1377,-30
51526967559,51526967563,4,2039,1107,-30
51531306826,51531306824,-2,1861,4351,-30
51531606812,51531606815,3,1136,1010,-30
51538880379,51538880380,1,1164,948,-30
51543231307,51543231313,6,2167,1457,-30
51547328257,51547328261,4,2542,899,-30
51550963777,51550963781,4,2638,1989,-30
51551795982,51551795990,8,1297,1013,-30
51556695827,51556695830,3,2942,1632,-30
51558297990,51558297995,5,1314,661,-30
51561136830,51561136834,4,2648,1899,-30
51564052530,51564052535,5,2936,1237,-30
51565757413,51565757417,4,2470,1119,-30
51566212160,51566212148,-12,1749,1346,-30
51569143613,51569143618,5,2303,850,-30
51570348471,51570348476,5,3116,1079,-30
51570883358,51570883362,4,2557,1176,-30
51572921109,51572921115,6,1838,1293,-30
51574961817,51574961820,3,1875,1859,-30
51575876841,51575876846,5,1987,1709,-30
51576073842,51576073846,4,2343,1722,-30
51579725358,51579725363,5,1065,876,-30
51580454838,51580454844,6,1712,1039,-30
51580927805,51580927813,8,2570,13226,-30
51586097306,51586097309,3,2197,1476,-30
51587739494,51587739499,5,1377,1157,-30
51589393458,51589393461,3,1339,1814,-30
51592302569,51592302573,4,1926,1418,-30
51596333151,51596333146,-5,651,245,-30
51598995438,51598995443,5,2780,1225,-30
51600293186,51600293186,0,11307,12014,-30
51606845159,51606845162,3,1057,1227,-30
51608969425,51608969430,5,1509,1090,-30
51610492429,51610492431,2,2475,1633,-30
51612230241,51612230246,5,1481,1250,-30
51614741074,51614741080,6,2140,1388,-30
51617454646,51617454652,6,2221,1218,-30
51622242784,51622242790,6,2304,1609,-30
51634184326,51634184330,4,2079,1265,-30
51638653382,51638653384,2,1912,1446,-30
51645588706,51645588711,5,2651,1117,-30
51647944689,51647944692,3,1813,1888,-30
51650560101,51650560106,5,2193,1194,-30
51651496453,51651496457,4,1939,1490,-30
51652238506,51652238511,5,1938,1267,-30
51653080894,51653080894,0,1443,1583,-30
51654975614,51654975617,3,1957,1395,-30
51662403487,51662403491,4,1900,926,-30
51664096122,51664096126,4,2555,1672,-30
51665352902,51665352899,-3,1695,2680,-30
51668647098,51668647105,7,3736,1266,-30
51671158477,51671158482,5,2721,1996,-30
51672332713,51672332718,5,2413,1336,-30
51673290326,51673290329,3,2829,1337,-30
51678059034,51678059039,5,2630,1390,-30
51686034629,51686034633,4,1798,1349,-30
51686173880,51686173886,6,1864,1373,-30
51689593256,51689593261,5,2883,1583,-30
51692875278,51692875277,-1,1099,1743,-30
51693017121,51693017127,6,2423,1248,-30
51698221909,51698221915,6,2878,1560,-30
51701309906,51701309904,-2,1286,1787,-30
51705577193,51705577195,2,1363,1203,-30
51705744989,51705744994,5,1623,1409,-30
51706310501,51706310506,5,2003,1043,-30
51706663830,51706663834,4,2074,939,-30
51710537726,51710537730,4,3559,2124,-30
51714001590,51714001593,3,1333,1093,-30
51714442644,51714442624,-20,46,1350,-30
51716107583,51716107589,6,2663,1730,-30
51717369166,51717369166,0,1238,1304,-30
51718410244,51718410258,14,1452,1050,-30
51719887755,51719887759,4,2262,1720,-30
51721731266,51721731270,4,2518,1268,-30
51723488477,51723488481,4,1583,925,-30
51725578855,51725578852,-3,25380,18775,-30
51726124949,51726124951,2,2779,1265,-30
51727613699,51727613704,5,3168,1427,-30
51727924318,51727924322,4,2295,1570,-30
51731304602,51731304606,4,1968,1407,-30
51732223346,51732223350,4,1928,1244,-30
51738446931,51738446934,3,2196,1252,-30
51743601597,51743601603,6,2030,1254,-30
51743890991,51743890999,8,20524,52050,-30
51747099587,51747099591,4,1583,1048,-30
51753032331,51753032337,6,2105,1532,-30
51754740615,51754740618,3,1991,1214,-30
51758412071,51758412078,7,3495,1960,-30
51765279054,51765279059,5,3282,1436,-30
51766740034,51766740039,5,1448,1369,-30
51767100171,51767100177,6,2189,951,-30
51771424683,51771424678,-5,833,3264,-30
51772856334,51772856340,6,1739,1137,-30
51779577098,51779577105,7,6246,2216,-30
51780747430,51780747435,5,1720,1187,-30
51782252245,51782252247,2,1880,1728,-30
51785634066,51785634070,4,2073,778,-30
51786605561,51786605566,5,3370,1235,-30
51787631733,51787631739,6,2131,863,-30
51792258626,51792258631,5,1505,1048,-30
51796229215,51796229219,4,821,633,-30
51796494030,51796494011,-19,2037,1411,-30
51800802685,51800802686,1,1679,1357,-30
51801819374,51801819393,19,1346,1599,-30
51802251797,51802251802,5,2076,1104,-30
51804245561,51804245566,5,1849,1272,-30
51805792722,51805792727,5,2383,1252,-30
51807755485,51807755490,5,1995,823,-30
51808427416,51808427421,5,3056,1244,-30
51808661953,51808661958,5,2017,1226,-30
51811022071,51811022075,4,2437,1423,-30
51812191890,51812191892,2,2223,2268,-30
51813315009,51813315015,6,2092,1875,-30
51815301642,51815301647,5,1804,1327,-30
51817262435,51817262439,4,1944,1713,-30
51818348231,51818348234,3,1171,773,-30
51818431651,51818431636,-15,1706,879,-30
51819653702,51819653706,4,1902,1498,-30
51819918886,51819918906,20,2658,1465,-30
51821446533,51821446540,7,1312,962,-30
51821866470,51821866473,3,2267,1040,-30
51829007540,51829007545,5,2020,1170,-30
51831950229,51831950235,6,2539,1110,-30
51836015521,51836015525,4,1830,1546,-30
51839321626,51839321632,6,3608,1753,-30
51840810510,51840810515,5,1647,1014,-30
51841553248,51841553251,3,1770,938,-30
51845242142,51845242148,6,2168,1389,-30
51845976592,51845976598,6,2969,1399,-30
51850770427,51850770433,6,2439,1293,-30
51850802021,51850802042,21,2385,1013,-30
51858877610,51858877617,7,2854,1536,-30
51861995881,51861995887,6,1708,1364,-30
51863434313,51863434312,-1,1248,1290,-30
51864178008,51864178015,7,2542,1342,-30
51864694544,51864694549,5,2658,1380,-30
51864956189,51864956171,-18,2396,1338,-30
51866570814,51866570819,5,1887,1318,-30
51869873069,51869873074,5,1475,1116,-30
51869958121,51869958106,-15,953,424,-30
51870260133,51870260138,5,2417,1265,-30
51872566403,51872566409,6,3105,1838,-30
51876272087,51876272081,-6,1091,4244,-30
51877783432,51877783438,6,2699,1292,-30
51884122546,51884122551,5,2472,1132,-30
51886112620,51886112625,5,3033,2292,-30
51886143991,51886143996,5,7145,29968,-30
51888925589,51888925595,6,1944,1347,-30
51893784704,51893784709,5,2119,1285,-30
51894629586,51894629593,7,1579,1326,-30
51895343950,51895343946,-4,2331,4153,-30
51898214830,51898214835,5,1326,922,-30
51899608978,51899608981,3,1405,953,-30
51899885119,51899885125,6,2651,1400,-30
51899956507,51899956507,0,1384,1095,-30
51900383002,51900383007,5,2233,1166,-30
51902089142,51902089149,7,2574,2003,-30
51906888630,51906888635,5,2544,1364,-30
51907426945,51907426941,-4,918,2728,-30
51909008995,51909009001,6,2328,1669,-30
51911956705,51911956706,1,845,972,-30
51912100183,51912100187,4,1556,1432,-30
51913087629,51913087634,5,1979,1193,-30
51925619054,51925619059,5,1144,742,-30
51927864156,51927864162,6,3212,2180,-30
51930080286,51930080290,4,1958,1468,-30
51930188283,51930188297,14,778,86,-30
51930661824,51930661830,6,1355,866,-30
51930751180,51930751185,5,1549,1368,-30
51931624890,51931624904,14,2251,1402,-30
51933147074,51933147072,-2,776,1629,-30
51933751148,51933751144,-4,1074,3509,-30
51934288547,51934288551,4,2063,1551,-30
51938193253,51938193258,5,1944,1040,-30
51938558678,51938558684,6,2089,1701,-30
51940290198,51940290204,6,2313,1157,-30
51943075854,51943075857,3,1262,915,-30
51944057876,51944057882,6,3204,1369,-30
51946462463,51946462468,5,2190,1137,-30
51947071098,51947071082,-16,678,383,-30
51949979657,51949979661,4,2671,1488,-30
51952121830,51952121834,4,2283,1247,-30
51953383462,51953383467,5,2214,1394,-30
51957426241,51957426245,4,2171,1371,-30
51958667982,51958667989,7,2454,1566,-30
51960001702,51960001706,4,1822,1653,-30
51962626697,51962626690,-7,1555,7914,-30
51963130218,51963130223,5,2613,897,-30
51968702842,51968702847,5,1101,818,-30
51978706389,51978706372,-17,25,865,-30
51989006150,51989006153,3,1846,1882,-30
51989917029,51989917034,5,1815,1511,-30
51993131043,51993131049,6,2345,1626,-30
51993880331,51993880334,3,2192,1474,-30
51994645990,51994645994,4,1900,1031,-30
52003719727,52003719731,4,2328,1266,-30
52009335537,52009335541,4,2898,1450,-30
52009394959,52009394965,6,2126,899,-30
52010882093,52010882097,4,3009,1547,-30
52015483858,52015483863,5,2526,1475,-30
52016867331,52016867325,-6,1324,4195,-30
52020518410,52020518414,4,3032,1810,-30
52026573302,52026573307,5,3746,1970,-30
52027129717,52027129721,4,2268,1345,-30
52028738262,52028738266,4,1607,1143,-30
52031539390,52031539394,4,1692,830,-30
52038741617,52038741622,5,3360,1275,-30
52040300865,52040300870,5,1966,1058,-30
52041196958,52041196938,-20,3410,1405,-30
52042614168,52042614171,3,2570,1842,-30
52045429150,52045429145,-5,1010,2469,-30
52050801027,52050801029,2,1446,871,-30
52053390406,52053390410,4,2290,1042,-30
52055436898,52055436904,6,2048,1612,-30
52057347288,52057347294,6,1950,1072,-30
52060471279,52060471284,5,2172,1177,-30
52060892514,52060892518,4,1377,888,-30
52064023814,52064023820,6,2443,1426,-30
52064477743,52064477747,4,2334,1100,-30
52065590167,52065590169,2,2816,2827,-30
52069462845,52069462847,2,2018,1641,-30
52072673562,52072673567,5,2219,864,-30
52074590289,52074590294,5,2065,1131,-30
52076435093,52076435099,6,3656,1767,-30
52080254276,52080254282,6,2027,1475,-30
52081979392,52081979397,5,1890,1323,-30
52083169023,52083169027,4,2683,1615,-30
52085739601,52085739605,4,1999,1341,-30
52086257411,52086257419,8,2994,1197,-30
52089845565,52089845570,5,2387,1602,-30
52090811754,52090811759,5,1783,1306,-30
52091696993,52091697001,8,3511,1574,-30
52093140000,52093140006,6,2718,1242,-30
52095773396,52095773402,6,2615,1333,-30
52096954234,52096954239,5,1921,1371,-30
52097210945,52097210950,5,2096,1589,-30
52101796179,52101796169,-10,58,2443,-30
52108223423,52108223430,7,3701,1395,-30
52112962665,52112962670,5,2867,1045,-30
52116482006,52116482011,5,2699,1308,-30
52117574733,52117574738,5,1764,1656,-30
52120803339,52120803346,7,2944,1227,-30
52124702938,52124702942,4,1774,1233,-30
52126078875,52126078880,5,2247,832,-30
52130272805,52130272801,-4,1440,1768,-30
52131362152,52131362157,5,1940,1179,-30
52133335729,52133335732,3,1724,993,-30
52134501462,52134501462,0,1588,2168,-30
52134598141,52134598148,7,2869,1437,-30
52137293418,52137293425,7,2439,1127,-30
52138260871,52138260875,4,1998,995,-30
52142696812,52142696816,4,1879,1576,-30
52143139527,52143139533,6,2740,1991,-30
52143482717,52143482723,6,2345,1534,-30
52152721292,52152721295,3,1628,835,-30
52156716897,52156716901,4,2455,975,-30
52158050268,52158050270,2,1467,1334,-30
52161407950,52161407954,4,2702,1368,-30
52162450230,52162450234,4,2428,1648,-30
52162785572,52162785578,6,2357,1256,-30
52165896243,52165896237,-6,1453,3719,-30
52170482042,52170482045,3,1897,1755,-30
52172129534,52172129539,5,2524,1441,-30
52172358391,52172358377,-14,1190,356,-30
52172506782,52172506787,5,2561,1564,-30
52173756931,52173756936,5,2626,1283,-30
52175498637,52175498641,4,2447,1505,-30
52176212912,52176212918,6,888,256,-30
52176903680,52176903683,3,1422,842,-30
52177450246,52177450251,5,2175,1259,-30
52178196161,52178196147,-14,807,398,-30
52178728621,52178728619,-2,1836,3814,-30
52179021039,52179021042,3,2565,1373,-30
52179432886,52179432893,7,2724,1330,-30
52183776333,52183776338,5,2437,971,-30
52187098717,52187098722,5,2306,1401,-30
52189783561,52189783566,5,1935,1613,-30
52190194694,52190194699,5,2089,1127,-30
52192573222,52192573227,5,1607,1274,-30
52193190870,52193190874,4,1413,930,-30
52195406498,52195406501,3,2089,1874,-30
52196415575,52196415578,3,1107,1118,-30
52198298378,52198298385,7,2878,1859,-30
52201741749,52201741754,5,1708,1047,-30
52202037475,52202037484,9,68579,129276,-30
52204355057,52204355063,6,1567,1168,-30
52204436857,52204436863,6,2477,959,-30
52206390560,52206390565,5,2704,1448,-30
52208552732,52208552746,14,1185,142,-30
52210239136,52210239141,5,2194,1364,-30
52217283781,52217283786,5,2059,1244,-30
52224182127,52224182121,-6,526,2001,-30
52226061640,52226061635,-5,1178,4201,-30
52227439229,52227439234,5,2461,1219,-30
52228358037,52228358044,7,2864,1206,-30
52234117561,52234117565,4,2193,1414,-30
52235890310,52235890289,-21,908,395,-30
52240316169,52240316177,8,1855,1149,-30
52241565417,52241565422,5,2083,1198,-30
52245319486,52245319493,7,3294,1783,-30
52246365810,52246365815,5,3312,1410,-30
52250532357,52250532361,4,1486,1171,-30
52252481485,52252481489,4,1934,1437,-30
52253087700,52253087704,4,2788,2048,-30
52253143778,52253143783,5,2468,1402,-30
52253218526,52253218539,13,1332,741,-30
52253772402,52253772386,-16,2228,1425,-30
52253961990,52253961994,4,1672,1079,-30
52258738377,52258738382,5,2762,1295,-30
52259857900,52259857905,5,2383,1268,-30
52262034777,52262034779,2,2321,1231,-30
52262849214,52262849218,4,2911,1520,-30
52263282646,52263282653,7,2777,1496,-30
52264194681,52264194685,4,2335,1153,-30
52270237845,52270237852,7,2460,1224,-30
52270305110,52270305123,13,818,68,-30
52270857358,52270857363,5,1885,1309,-30
52272571386,52272571369,-17,971,591,-30
52274109293,52274109298,5,1211,986,-30
52276411077,52276411078,1,1216,1645,-30
52277325238,52277325243,5,2263,1246,-30
52282186101,52282186106,5,2030,1239,-30
52286497751,52286497755,4,1943,1350,-30
52292651305,52292651310,5,2973,1755,-30
52295320214,52295320219,5,2450,1247,-30
52296259693,52296259685,-8,2309,9033,-30
52296407046,52296407054,8,2738,1122,-30
52298280501,52298280505,4,3079,814,-30
52300641951,52300641947,-4,60096,37806,-30
52306204871,52306204869,-2,1005,1562,-30
52306738834,52306738838,4,1803,1093,-30
52307176349,52307176332,-17,2445,983,-30
52310182734,52310182735,1,1751,1799,-30
52315049301,52315049306,5,2827,1285,-30
52315916402,52315916407,5,2887,1025,-30
52319672802,52319672806,4,2114,1202,-30
52326008305,52326008312,7,2661,1206,-30
52326358525,52326358544,19,2680,1394,-30
52328123884,52328123893,9,2182,1055,-30
52328408354,52328408361,7,2262,1097,-30
52331649093,52331649101,8,3159,1281,-30
52339235693,52339235686,-7,3665,13366,-30
52339669825,52339669827,2,1538,1157,-30
52345843822,52345843827,5,1978,1471,-30
52346995664,52346995670,6,2217,881,-30
52349543029,52349543034,5,2744,1335,-30
52349606771,52349606767,-4,1309,3654,-30
52349995009,52349995014,5,2833,1516,-30
52360255312,52360255314,2,1706,1434,-30
52360891404,52360891408,4,1473,1089,-30
52363178703,52363178707,4,2798,1286,-30
52363362494,52363362473,-21,2960,1436,-30
52370453582,52370453587,5,3026,1846,-30
52370526101,52370526101,0,1340,1532,-30
52372124897,52372124898,1,3448,3607,-30
52374244382,52374244387,5,2131,1104,-30
52374429807,52374429785,-22,817,525,-30
52374826219,52374826217,-2,2039,3177,-30
52376199433,52376199438,5,1385,1266,-30
52378012245,52378012250,5,2228,1434,-30
52378085838,52378085841,3,20000,25274,-30
52380490166,52380490170,4,1591,1273,-30
52384247134,52384247138,4,2673,1200,-30
52384726890,52384726893,3,1486,1845,-30
52385835767,52385835775,8,2693,1501,-30
52387876006,52387876012,6,2435,1551,-30
52389171086,52389171091,5,1775,1244,-30
52389240516,52389240523,7,3633,1640,-30
52389416438,52389416442,4,2456,1781,-30
52391413964,52391413971,7,1339,1161,-30
52394752101,52394752106,5,3445,2007,-30
52397115510,52397115505,-5,1466,2755,-30
52397938514,52397938519,5,1964,862,-30
52398945139,52398945134,-5,1627,5381,-30
52402396425,52402396431,6,2614,1165,-30
52402564230,52402564211,-19,1251,1034,-30
52406002448,52406002441,-7,1773,1231,-30
52407284905,52407284910,5,2868,1444,-30
52414392512,52414392516,4,2513,1668,-30
52418739016,52418739020,4,1971,1537,-30
52424706925,52424706929,4,2349,743,-30
52431061118,52431061123,5,2620,1608,-30
52436935161,52436935165,4,1902,1252,-30
52439223470,52439223475,5,2452,1294,-30
52439670998,52439671003,5,1345,942,-30
52443490425,52443490426,1,2968,2984,-30
52444979810,52444979815,5,1941,1301,-30
52452269549,52452269551,2,1640,1489,-30
52456687027,52456687007,-20,2308,1473,-30
52458534485,52458534491,6,2019,1599,-30
52459268431,52459268437,6,2263,979,-30
52460070387,52460070394,7,1670,1432,-30
52460663430,52460663410,-20,1692,916,-30
52464105991,52464105991,0,1272,1943,-30
52464449322,52464449329,7,4173,2101,-30
52469678485,52469678490,5,2155,1332,-30
52470405150,52470405155,5,1841,1445,-30
52476092563,52476092569,6,1791,1470,-30
52477092038,52477092051,13,1703,1294,-30
52478651154,52478651156,2,1605,1780,-30
52479100558,52479100564,6,3461,1563,-30
52479345146,52479345150,4,1593,1073,-30
52481041846,52481041850,4,1884,886,-30
52481862416,52481862421,5,1976,1104,-30
52489944372,52489944376,4,1953,1391,-30
52492187749,52492187744,-5,1261,4339,-30
52497686282,52497686286,4,2279,1657,-30
52499906398,52499906402,4,2335,820,-30
52501180170,52501180174,4,1873,1250,-30
52502064101,52502064110,9,2993,1342,-30
52504748790,52504748795,5,1960,897,-30
52505885553,52505885559,6,2421,1248,-30
52506597429,52506597423,-6,566,4410,-30
52519235485,52519235490,5,1992,1263,-30
52526077633,52526077637,4,2068,1222,-30
52528096214,52528096219,5,1593,1775,-30
52530681633,52530681638,5,1976,1542,-30
52530707057,52530707061,4,2251,1217,-30
52531110513,52531110517,4,2137,1550,-30
52532473523,52532473527,4,1884,849,-30
52534412978,52534412982,4,2108,1185,-30
52543881500,52543881495,-5,2477,6130,-30
52548263324,52548263330,6,1895,1494,-30
52549331334,52549331338,4,2278,1242,-30
52550804273,52550804275,2,1492,1080,-30
52551472730,52551472728,-2,682,99,-30
52552596616,52552596621,5,3375,1539,-30
52555200607,52555200607,0,1187,1234,-30
52556348249,52556348254,5,2989,1032,-30
52556456397,52556456404,7,1810,1438,-30
52558754266,52558754269,3,2311,1355,-30
52560695162,52560695166,4,1960,1159,-30
52560742618,52560742622,4,1533,1736,-30
52564083946,52564083950,4,1871,1320,-30
52564139618,52564139601,-17,2207,1265,-30
52567949717,52567949729,12,115,292,-30
52570328515,52570328518,3,1953,1001,-30
52572919981,52572919985,4,2271,930,-30
52574136088,52574136094,6,2440,1391,-30
52574996105,52574996109,4,2555,1472,-30
52575050912,52575050918,6,1832,1572,-30
52577215174,52577215170,-4,1483,2820,-30
52583813330,52583813334,4,2588,2007,-30
52584050986,52584050991,5,2375,1073,-30
52589076934,52589076939,5,3204,1832,-30
52590344515,52590344521,6,3427,1374,-30
52590400302,52590400307,5,2497,1529,-30
52590572779,52590572783,4,2654,1951,-30
52592893005,52592893010,5,2389,1467,-30
52599661335,52599661341,6,2892,1680,-30
52601143341,52601143346,5,1839,1214,-30
52601973246,52601973250,4,2608,1798,-30
52603718145,52603718151,6,2401,1437,-30
52606507525,52606507533,8,2455,1507,-30
52615047178,52615047183,5,2388,1192,-30
52617573397,52617573401,4,2341,1172,-30
52628134243,52628134249,6,3538,1793,-30
52630581615,52630581619,4,2359,999,-30
52631326951,52631326955,4,2160,962,-30
52636291920,52636291925,5,2004,1444,-30
52637045030,52637045034,4,3298,1840,-30
52641004258,52641004263,5,1974,938,-30
52643786706,52643786710,4,2804,1250,-30
52645150969,52645150973,4,1520,1163,-30
52645719969,52645719966,-3,731,1918,-30
52649513299,52649513306,7,2093,1090,-30
52649580432,52649580437,5,2402,1291,-30
52653036320,52653036326,6,2382,1277,-30
52657719547,52657719555,8,1815,932,-30
52659157614,52659157618,4,1373,796,-30
52659939036,52659939037,1,1480,2108,-30
52660460791,52660460795,4,2359,1240,-30
52664654753,52664654757,4,1762,1241,-30
52669790866,52669790871,5,2649,1390,-30
52670098116,52670098121,5,2128,1304,-30
52670222742,52670222755,13,1794,1103,-30
52673162113,52673162119,6,2690,1202,-30
52677363558,52677363557,-1,2181,3518,-30
52677396259,52677396262,3,1854,1571,-30
52678119383,52678119387,4,1065,1170,-30
52687707042,52687707047,5,2612,1568,-30
52687787025,52687787026,1,1327,1923,-30
52688740990,52688740995,5,3050,1638,-30
52692092693,52692092698,5,2181,1448,-30
52692660873,52692660878,5,2032,1099,-30
52693414341,52693414346,5,2134,1409,-30
52694224509,52694224516,7,4397,1577,-30
52695076674,52695076678,4,3783,1794,-30
52696242502,52696242508,6,2735,1496,-30
52698041330,52698041335,5,832,516,-30
52699455361,52699455365,4,2041,1531,-30
52700717286,52700717287,1,1435,1043,-30
52701723413,52701723414,1,3839,4161,-30
52703539485,52703539490,5,1613,1106,-30
52703694938,52703694936,-2,1042,409,-30
52708717374,52708717378,4,3048,1608,-30
52711273403,52711273410,7,1739,899,-30
52711661766,52711661769,3,2820,1273,-30
52712204982,52712204986,4,2292,1281,-30
52714160306,52714160311,5,1939,969,-30
52715198509,52715198519,10,1836,1081,-30
52717849096,52717849103,7,2070,1222,-30
52718554200,52718554207,7,2331,1199,-30
52718671021,52718671027,6,3992,1826,-30
52718747942,52718747946,4,2632,1244,-30
52720179421,52720179428,7,1168,810,-30
52725406227,52725406232,5,2586,1871,-30
52725597773,52725597779,6,2639,1031,-30
52727011474,52727011476,2,1922,962,-30
52734668242,52734668246,4,938,973,-30
52735777924,52735777931,7,4862,1998,-30
52736065790,52736065798,8,2684,1416,-30
52736160246,52736160251,5,1929,1562,-30
52736674017,52736674023,6,2942,1206,-30
52740438062,52740438066,4,2610,1476,-30
52743249091,52743249095,4,2007,1177,-30
52744046588,52744046593,5,2114,1337,-30
52747675614,52747675618,4,2075,1107,-30
52747784737,52747784743,6,2780,996,-30
52747937750,52747937754,4,2431,1261,-30
52748713916,52748713939,23,2616,1151,-30
52749010378,52749010381,3,2412,853,-30
52750314004,52750314010,6,2787,1436,-30
52753595433,52753595439,6,2105,1189,-30
52756178992,52756178998,6,2261,1159,-30
52756539631,52756539637,6,1782,961,-30
52759000489,52759000492,3,2326,1382,-30
52759026694,52759026675,-19,2389,1678,-30
52759895429,52759895434,5,1887,1329,-30
52761561944,52761561949,5,2862,1523,-30
52761861190,52761861198,8,1907,1328,-30
52762368014,52762368019,5,1823,1167,-30
52773062109,52773062115,6,2135,1042,-30
52775002035,52775002041,6,1791,734,-30
52776349497,52776349502,5,908,217,-30
52778509090,52778509094,4,1993,1611,-30
52779002811,52779002795,-16,2520,939,-30
52780519474,52780519479,5,1872,1132,-30
52784127570,52784127575,5,2026,1329,-30
52788884305,52788884311,6,2426,1221,-30
52790369970,52790369976,6,2898,1496,-30
52791175181,52791175201,20,2025,1105,-30
52793002674,52793002679,5,2011,1245,-30
52799558457,52799558479,22,1283,771,-30
52803716310,52803716311,1,768,1405,-30
52803844149,52803844155,6,2267,1189,-30
52804758163,52804758167,4,3662,1907,-30
52806712950,52806712955,5,2768,1185,-30
52811854446,52811854452,6,1825,1332,-30
52812512783,52812512781,-2,2109,3269,-30
52815231318,52815231322,4,1774,829,-30
52818209978,52818209983,5,2041,1455,-30
52825315243,52825315250,7,2455,1071,-30
52826657026,52826657026,0,937,2208,-30
52829048026,52829048030,4,1450,882,-30
52829226930,52829226944,14,444,247,-30
52834366197,52834366204,7,2335,1561,-30
52834886458,52834886463,5,2139,1151,-30
52835495349,52835495353,4,2765,1638,-30
52836832630,52836832634,4,2015,1198,-30
52841224641,52841224642,1,1455,1640,-30
52841271851,52841271863,12,468,1278,-30
52844249486,52844249491,5,1626,1382,-30
52844978530,52844978536,6,2134,1030,-30
52848997165,52848997170,5,2344,1185,-30
52850108121,52850108139,18,2010,4436,-30
52850180369,52850180356,-13,1626,816,-30
52856275646,52856275652,6,2435,1742,-30
52857401525,52857401531,6,2698,1160,-30
52858378337,52858378341,4,2828,1610,-30
52858568451,52858568457,6,2144,1343,-30
52860043311,52860043316,5,2299,1053,-30
52862830526,52862830530,4,2626,1236,-30
52865235130,52865235134,4,2522,1253,-30
52868683618,52868683617,-1,936,1425,-30
52871574260,52871574266,6,2556,967,-30
52876833495,52876833501,6,1816,1220,-30
52877458209,52877458213,4,2110,1604,-30
52878354502,52878354502,0,1478,1946,-30
52879138494,52879138501,7,2347,1435,-30
52880809968,52880809974,6,3512,2196,-30
52880962984,52880962991,7,2299,1216,-30
52885772534,52885772536,2,1416,1105,-30
52889533478,52889533482,4,2718,1036,-30
52891739037,52891739041,4,2503,1108,-30
52893259699,52893259703,4,2245,1666,-30
52895195722,52895195729,7,1363,1001,-30
52896089296,52896089301,5,2213,1319,-30
52898552590,52898552596,6,5209,3049,-30
52903035094,52903035098,4,2418,1764,-30
52906703795,52906703802,7,2931,1154,-30
52907140629,52907140633,4,2290,1521,-30
52915970373,52915970374,1,1684,1482,-30
52919312877,52919312860,-17,1452,947,-30
52920670417,52920670422,5,2891,1322,-30
52922671076,52922671077,1,1986,2738,-30
52923530158,52923530163,5,1454,1102,-30
52923636710,52923636706,-4,1033,3224,-30
52926487202,52926487209,7,1936,1266,-30
52929592689,52929592694,5,1606,1203,-30
52933675879,52933675883,4,2422,1343,-30
52934438978,52934438985,7,1212,828,-30
52935578545,52935578550,5,3440,1785,-30
52936763359,52936763365,6,2472,1114,-30
52937782396,52937782401,5,1787,1486,-30
52939072156,52939072138,-18,418,106,-30
52939936509,52939936513,4,1199,1783,-30
52941786905,52941786909,4,2228,1056,-30
52942458454,52942458458,4,1953,1494,-30
52948630806,52948630813,7,3345,1739,-30
52951461045,52951461049,4,2311,1337,-30
52951913908,52951913915,7,2642,1541,-30
52956444829,52956444831,2,1982,1214,-30
52965370812,52965370814,2,2270,1628,-30
52967633751,52967633756,5,3022,1113,-30
52968590527,52968590530,3,1655,1095,-30
52968921914,52968921896,-18,688,204,-30
52969301684,52969301689,5,2026,1132,-30
52969452803,52969452816,13,2235,1383,-30
52969495961,52969495946,-15,2605,904,-30
52977336525,52977336530,5,2317,1065,-30
52980212635,52980212639,4,2014,1384,-30
52981867770,52981867774,4,3923,1036,-30
52987304554,52987304547,-7,2400,7288,-30
52993707863,52993707867,4,1630,1057,-30
52994039541,52994039523,-18,2344,1606,-30
52996118025,52996118029,4,2529,1303,-30
53001147952,53001147957,5,2640,1655,-30
53004021161,53004021162,1,1450,1776,-30
53009748890,53009748897,7,2230,1024,-30
53011102899,53011102906,7,3445,1489,-30
53014898826,53014898829,3,2220,1593,-30
53016239929,53016239933,4,2090,1385,-30
53016915486,53016915493,7,2700,1276,-30
53017800560,53017800566,6,2409,1178,-30
53025287463,53025287466,3,1497,842,-30
53025955243,53025955250,7,1952,1257,-30
53026131832,53026131834,2,1464,1082,-30
53026296702,53026296706,4,2958,1507,-30
53027763812,53027763817,5,2135,842,-30
53029735469,53029735474,5,2036,1222,-30
53036854624,53036854629,5,8399,4577,-30
53037782502,53037782505,3,1409,1116,-30
53038368143,53038368151,8,1990,997,-30
53038828032,53038828038,6,3415,1572,-30
53042173562,53042173567,5,1945,1619,-30
53043360122,53043360118,-4,1055,2390,-30
53044674614,53044674619,5,2799,1451,-30
53046842724,53046842728,4,1638,1361,-30
53058799005,53058799006,1,1747,1132,-30
53061436817,53061436823,6,2457,1156,-30
53064544896,53064544901,5,1770,1182,-30
53068320050,53068320056,6,1866,1170,-30
53076727712,53076727718,6,2073,1100,-30
53079615306,53079615313,7,2009,891,-30
53080102841,53080102828,-13,2266,1174,-30
53080635474,53080635478,4,1785,931,-30
53081787478,53081787483,5,1633,1180,-30
53083286746,53083286750,4,2370,1190,-30
53087904624,53087904630,6,1980,1439,-30
53088429546,53088429529,-17,2634,1647,-30
53093578093,53093578095,2,1563,1053,-30
53093764178,53093764164,-14,2090,1291,-30
53095512030,53095512028,-2,1812,1885,-30
53096044310,53096044317,7,3007,1602,-30
53097007088,53097007091,3,2245,1741,-30
53098844133,53098844139,6,2960,1392,-30
53104104729,53104104735,6,1844,1415,-30
53105564010,53105564014,4,2551,1138,-30
53107902034,53107902017,-17,1798,1046,-30
53109208840,53109208845,5,2123,1086,-30
53110036385,53110036389,4,1512,1589,-30
53111704769,53111704773,4,1291,1240,-30
53113759417,53113759422,5,1967,1120,-30
53113960061,53113960067,6,1564,1227,-30
53117330162,53117330165,3,922,1245,-30
53119104035,53119104039,4,2472,1151,-30
53121665375,53121665381,6,2401,1563,-30
53121822100,53121822123,23,2500,1320,-30
53122406727,53122406729,2,1486,1246,-30
53122579837,53122579843,6,1990,1196,-30
53123183355,53123183359,4,2630,1491,-30
53129324072,53129324077,5,1491,943,-30
53130578881,53130578865,-16,722,344,-30
53132086253,53132086258,5,2138,1041,-30
53135955205,53135955206,1,1859,1206,-30
53140100918,53140100922,4,1794,1127,-30
53143504424,53143504430,6,2466,1790,-30
53144668006,53144668002,-4,1328,3423,-30
53145413951,53145413954,3,1934,1731,-30
53145894862,53145894867,5,2218,1479,-30
53147137674,53147137681,7,2350,1298,-30
53147702589,53147702593,4,1344,1291,-30
53148031875,53148031879,4,1681,1593,-30
53148531307,53148531314,7,2023,974,-30
53150890164,53150890169,5,2821,1529,-30
53151356410,53151356415,5,2019,1397,-30
53153266968,53153266974,6,2538,1331,-30
53153361125,53153361130,5,2932,1419,-30
53155051579,53155051584,5,2710,1393,-30
53155214846,53155214859,13,904,213,-30
53156126517,53156126519,2,1408,1068,-30
53157515586,53157515589,3,3341,1701,-30
53160312938,53160312944,6,2311,1484,-30
53161008602,53161008607,5,2296,1159,-30
53162120918,53162120922,4,1846,889,-30
53164243678,53164243686,8,1814,917,-30
53165812430,53165812436,6,1930,813,-30
53168648587,53168648581,-6,991,6592,-30
53168953878,53168953883,5,2766,1294,-30
53169596558,53169596577,19,2168,1262,-30
53171762798,53171762803,5,3601,1786,-30
53173673234,53173673238,4,1851,1387,-30
53176459497,53176459502,5,2474,1116,-30
53177934659,53177934663,4,2454,1618,-30
53178016524,53178016531,7,2376,1333,-30
53178153693,53178153697,4,2429,1627,-30
53178522905,53178522908,3,1581,855,-30
53181243229,53181243233,4,1705,1288,-30
53185252883,53185252891,8,3423,1488,-30
53185368278,53185368284,6,2661,1127,-30
53186940834,53186940838,4,2401,1610,-30
53187035533,53187035516,-17,1851,1136,-30
53190518454,53190518458,4,1559,1019,-30
53191694672,53191694671,-1,1772,2088,-30
53194728640,53194728644,4,2254,805,-30
53196577562,53196577566,4,2113,1390,-30
53197042734,53197042755,21,1366,1009,-30
53197322846,53197322850,4,2242,1504,-30
53198722323,53198722328,5,2192,1058,-30
53198768936,53198768939,3,1474,931,-30
53199863253,53199863257,4,2318,1103,-30
53201298184,53201298189,5,2459,1817,-30
53204073170,53204073174,4,1627,1583,-30
53204411425,53204411430,5,1406,953,-30
53205341226,53205341231,5,2252,1656,-30
53205610106,53205610113,7,982,610,-30
53206276293,53206276298,5,1112,834,-30
53207814034,53207814038,4,1807,1168,-30
53208050742,53208050746,4,2019,849,-30
53211928004,53211928008,4,2741,1502,-30
53214309094,53214309099,5,2662,1268,-30
53214562849,53214562853,4,1623,1208,-30
53215018455,53215018464,9,610,103,-30
53215550296,53215550282,-14,1316,607,-30
53215861627,53215861625,-2,1025,2480,-30
53215985648,53215985632,-16,698,264,-30
53218929044,53218929051,7,2902,1675,-30
53220342836,53220342841,5,2197,1193,-30
53220956538,53220956542,4,2657,1959,-30
53222957259,53222957264,5,2146,1138,-30
53229064801,53229064808,7,1334,762,-30
53230574258,53230574243,-15,2584,1175,-30
53231701718,53231701723,5,2703,1298,-30
53235031253,53235031258,5,1566,975,-30
53257641457,53257641461,4,1895,1502,-30
53257894673,53257894677,4,1807,2250,-30
53260323617,53260323618,1,1277,1099,-30
53263389662,53263389666,4,2002,1048,-30
53263908146,53263908141,-5,1261,3982,-30
53265462481,53265462487,6,3071,1398,-30
53266090012,53266090018,6,5596,2766,-30
53268360491,53268360492,1,1624,1547,-30
53275314443,53275314437,-6,1262,4178,-30
53280276748,53280276751,3,2172,1413,-30
53280712564,53280712563,-1,1218,2031,-30
53281258505,53281258501,-4,1412,2685,-30
53283778553,53283778556,3,1789,1519,-30
53289560136,53289560142,6,2182,1140,-30
53289735309,53289735310,1,1659,1087,-30
53295535465,53295535470,5,3047,1230,-30
53299417750,53299417754,4,807,725,-30
53304655727,53304655733,6,1591,1217,-30
53306190626,53306190633,7,2121,1301,-30
53308326458,53308326440,-18,2368,1272,-30
53312361174,53312361178,4,1658,1454,-30
53313329796,53313329800,4,2615,1835,-30
53314753394,53314753399,5,2206,1112,-30
53323560986,53323560990,4,2382,1343,-30
53323669351,53323669350,-1,904,1131,-30
53329565728,53329565732,4,1488,1382,-30
53329614255,53329614261,6,3485,1239,-30
53330261472,53330261470,-2,885,2618,-30
53331207992,53331207998,6,2274,1037,-30
53334204145,53334204153,8,1710,1297,-30
53337020473,53337020457,-16,1562,829,-30
53343172174,53343172173,-1,2531,2850,-30
53345662315,53345662333,18,905,947,-30
53348943910,53348943909,-1,942,1179,-30
53350574589,53350574594,5,1882,1061,-30
53350791553,53350791560,7,10222,4952,-30
53353355793,53353355797,4,2292,1344,-30
53354981625,53354981630,5,2677,1152,-30
53356383673,53356383678,5,2246,1214,-30
53362316475,53362316480,5,1650,1525,-30
53362487331,53362487338,7,1952,1133,-30
53363057235,53363057218,-17,1208,563,-30
53363094667,53363094671,4,1292,1110,-30
53366464366,53366464370,4,2098,1605,-30
53370788781,53370788787,6,2134,991,-30
53375893722,53375893727,5,1653,1356,-30
53383098729,53383098748,19,2300,11364,-30
53383722641,53383722647,6,2166,1147,-30
53385631249,53385631253,4,2866,1644,-30
53390937468,53390937474,6,1735,1281,-30
53396031798,53396031803,5,2030,816,-30
53396184245,53396184225,-20,2254,1473,-30
53398061062,53398061067,5,2297,1111,-30
53400183142,53400183147,5,1809,1131,-30
53401406894,53401406890,-4,1240,2676,-30
53403760045,53403760048,3,2909,1995,-30
53410271554,53410271559,5,1926,1362,-30
53411987734,53411987734,0,1614,1395,-30
53413082614,53413082618,4,2249,1423,-30
53414798911,53414798917,6,5184,28614,-30
53423682545,53423682560,15,2576,1271,-30
53424426729,53424426734,5,2790,1286,-30
53424909016,53424909015,-1,1856,3095,-30
53425168047,53425168055,8,4056,1613,-30
53431998646,53431998654,8,4446,1378,-30
53433371299,53433371303,4,1992,1201,-30
53434414807,53434414813,6,3286,2027,-30
53437016224,53437016227,3,35036,24925,-30
53441865636,53441865639,3,1919,1395,-30
53442842402,53442842407,5,3740,1785,-30
53443223423,53443223426,3,1582,758,-30
53444631006,53444631009,3,1770,1110,-30
53445031301,53445031305,4,1771,1124,-30
53445379254,53445379249,-5,2369,4564,-30
53448062608,53448062614,6,1856,1132,-30
53448418274,53448418278,4,1710,1114,-30
53450337492,53450337494,2,1294,1430,-30
53452055686,53452055690,4,1859,1306,-30
53452613876,53452613881,5,1896,957,-30
53453251597,53453251602,5,1338,1524,-30
53454384754,53454384758,4,2002,1364,-30
53454552212,53454552219,7,3481,1373,-30
53458097338,53458097343,5,2234,1912,-30
53458457006,53458457001,-5,1035,2812,-30
53458913802,53458913809,7,2151,1787,-30
53459026879,53459026886,7,2496,1162,-30
53463650942,53463650946,4,2422,2007,-30
53463934717,53463934722,5,1595,1411,-30
53464889826,53464889831,5,1552,608,-30
53465713821,53465713827,6,2507,1035,-30
53465851648,53465851656,8,2228,1145,-30
53470900281,53470900286,5,2134,912,-30
53473643072,53473643077,5,2234,1168,-30
53475035815,53475035817,2,2187,1303,-30
53477067002,53477067006,4,1996,1393,-30
53479972930,53479972926,-4,885,2269,-30
53480999818,53480999824,6,2692,1342,-30
53481104071,53481104075,4,1232,871,-30
53486234718,53486234722,4,13457,9005,-30
53487828622,53487828627,5,3848,1526,-30
53487995974,53487995979,5,1824,1034,-30
53491330895,53491330898,3,1562,1202,-30
53494284709,53494284717,8,9793,2255,-30
53500996798,53500996803,5,2398,1710,-30
53501830134,53501830139,5,2607,1385,-30
53502301382,53502301378,-4,618,326,-30
53502592927,53502592935,8,1746,1615,-30
53503889404,53503889410,6,2737,1169,-30
53505148586,53505148589,3,2153,1193,-30
53506856579,53506856559,-20,840,332,-30
53510494434,53510494438,4,2192,1643,-30
53510549338,53510549342,4,2157,1266,-30
53513660203,53513660205,2,1585,1796,-30
53513945443,53513945448,5,1796,1112,-30
53515942520,53515942523,3,1421,1216,-30
53518339317,53518339322,5,1840,1210,-30
53519403209,53519403214,5,2518,1425,-30
53520221125,53520221129,4,1872,1358,-30
53521789737,53521789739,2,1981,1454,-30
53527280866,53527280871,5,1820,1407,-30
53532029394,53532029398,4,10196,17051,-30
53534404509,53534404514,5,1859,1457,-30
53534715389,53534715394,5,1638,705,-30
53536619010,53536619005,-5,2024,3768,-30
53539388062,53539388067,5,1759,873,-30
53546593074,53546593078,4,1848,809,-30
53550166470,53550166475,5,3384,1504,-30
53550634334,53550634337,3,2659,971,-30
53551464359,53551464365,6,2678,1118,-30
53552139747,53552139751,4,1993,1513,-30
53553676605,53553676611,6,2292,1281,-30
53555808593,53555808598,5,2147,1133,-30
53558303043,53558303048,5,2948,1793,-30
53558488138,53558488145,7,2422,1064,-30
53558672089,53558672106,17,2690,760,-30
53558745194,53558745198,4,1932,1045,-30
53559025074,53559025058,-16,2413,1045,-30
53559301509,53559301531,22,3181,1285,-30
53560836753,53560836758,5,2341,1097,-30
53562510792,53562510795,3,3267,2339,-30
53565555565,53565555570,5,2706,1954,-30
53571540602,53571540608,6,4698,2680,-30
53572154357,53572154363,6,2059,1382,-30
53575183473,53575183478,5,2903,1794,-30
53576988014,53576988018,4,2228,1378,-30
53577051026,53577051033,7,2357,924,-30
53577085138,53577085136,-2,790,276,-30
53578963643,53578963647,4,1308,841,-30
53579002362,53579002354,-8,912,175,-30
53579916265,53579916273,8,2765,1319,-30
53580529404,53580529406,2,1587,1085,-30
53582097946,53582097953,7,2226,1211,-30
53583529748,53583529742,-6,952,996,-30
53583789410,53583789426,16,2002,1190,-30
53587293018,53587293025,7,1448,779,-30
53589453922,53589453927,5,1792,1514,-30
53592434346,53592434350,4,2198,1067,-30
53596197322,53596197326,4,3019,1227,-30
53599040716,53599040722,6,1880,1195,-30
53599993641,53599993646,5,1461,965,-30
53605656676,53605656682,6,3593,1412,-30
53605775489,53605775504,15,2309,1474,-30
53606463028,53606463033,5,1546,1133,-30
53607520179,53607520186,7,2202,1113,-30
53609965783,53609965788,5,1927,1221,-30
53611833006,53611833018,12,12398,20189,-30
53612087866,53612087871,5,2120,1318,-30
53613925045,53613925038,-7,1092,2647,-30
53617500442,53617500446,4,1915,1226,-30
53620017381,53620017383,2,4132,2956,-30
53620829741,53620829746,5,2696,1725,-30
53624767737,53624767743,6,2881,1523,-30
53624902672,53624902678,6,3815,1770,-30
53625004663,53625004668,5,1940,1215,-30
53625146458,53625146461,3,2211,1734,-30
53625618249,53625618254,5,2290,1851,-30
53627115132,53627115136,4,2950,2012,-30
53631782926,53631782930,4,2143,1495,-30
53636476276,53636476281,5,1991,1149,-30
53643415101,53643415105,4,10811,8047,-30
53647464072,53647464075,3,2870,1386,-30
53648959938,53648959944,6,1911,1408,-30
53650618276,53650618281,5,1791,1506,-30
53652140678,53652140684,6,2406,1345,-30
53654835027,53654835031,4,2272,1553,-30
53654976213,53654976217,4,1804,1535,-30
53656388515,53656388497,-18,1301,330,-30
53656598614,53656598634,20,2218,1225,-30
53657937622,53657937631,9,2575,1088,-30
53659656289,53659656292,3,2559,1176,-30
53665448537,53665448542,5,2340,1270,-30
53668676830,53668676834,4,1338,847,-30
53669458792,53669458797,5,2861,1501,-30
53672995769,53672995773,4,1601,1222,-30
53676442370,53676442374,4,1617,1207,-30
53682119001,53682119002,1,1487,2949,-30
53683960243,53683960248,5,1923,1716,-30
53687681428,53687681431,3,1294,1574,-30
53689346359,53689346363,4,1149,977,-30
53691099422,53691099427,5,2217,1386,-30
53691842721,53691842726,5,3076,1593,-30
53692216507,53692216513,6,2782,1646,-30
53696918515,53696918518,3,1779,808,-30
53702598710,53702598714,4,2857,1472,-30
53703032443,53703032448,5,2309,1127,-30
53709067622,53709067627,5,1734,1088,-30
53710028963,53710028966,3,2035,1260,-30
53712886374,53712886379,5,2826,1479,-30
53714662953,53714662958,5,1936,1367,-30
53716012503,53716012502,-1,1249,1357,-30
53717589058,53717589063,5,2113,1179,-30
53718537589,53718537593,4,2352,1898,-30
53720817899,53720817903,4,2305,1550,-30
53723620420,53723620423,3,1800,1807,-30
53725049350,53725049355,5,3050,1171,-30
53726691581,53726691586,5,1804,1215,-30
53734817674,53734817678,4,1789,1227,-30
53742710713,53742710717,4,3384,2023,-30
53747212754,53747212750,-4,1163,2782,-30
53747389285,53747389292,7,1920,1095,-30
53755259702,53755259706,4,2460,1109,-30
53755287938,53755287955,17,1454,997,-30
53756417516,53756417509,-7,1321,5977,-30
53760671978,53760671983,5,1879,1623,-30
53762989135,53762989141,6,2927,1119,-30
53765228844,53765228838,-6,1086,3680,-30
53765415009,53765415008,-1,1640,3659,-30
53769126452,53769126451,-1,1603,2363,-30
53771085541,53771085548,7,3181,1734,-30
53771257910,53771257905,-5,1231,4183,-30
53773024198,53773024201,3,1988,1292,-30
53775617914,53775617918,4,2542,1888,-30
53779253575,53779253579,4,1959,1795,-30
53779561562,53779561568,6,2849,1390,-30
53780476641,53780476646,5,1774,922,-30
53780586022,53780586028,6,2478,1101,-30
53786993909,53786993915,6,2358,1270,-30
53788398975,53788398974,-1,1067,2611,-30
53789926241,53789926246,5,3028,1344,-30
53790613898,53790613898,0,1379,903,-30
53794194968,53794194973,5,1993,1316,-30
53794503453,53794503457,4,1843,1014,-30
53797807654,53797807658,4,1998,1518,-30
53799405722,53799405727,5,3186,1574,-30
53805756874,53805756877,3,1974,1153,-30
53810032669,53810032675,6,3110,1532,-30
53814490645,53814490648,3,1915,1513,-30
53814731763,53814731778,15,1989,1097,-30
53815938544,53815938548,4,2208,1350,-30
53818074861,53818074873,12,9011,44507,-30
53819119333,53819119339,6,3111,1793,-30
53819158119,53819158099,-20,2310,1466,-30
53825966757,53825966762,5,1506,976,-30
53826110775,53826110779,4,1003,936,-30
53827196355,53827196361,6,1390,1240,-30
53827405206,53827405227,21,2187,1643,-30
53828357551,53828357559,8,2594,1408,-30
53829015629,53829015632,3,1062,1116,-30
53829774627,53829774633,6,2080,1553,-30
53830400518,53830400523,5,2258,1371,-30
53830895933,53830895936,3,1859,1668,-30
53835204510,53835204515,5,1635,1364,-30
53837074591,53837074597,6,5681,2984,-30
53838225008,53838225012,4,2216,1821,-30
53845413278,53845413283,5,1906,1612,-30
53847995334,53847995339,5,6189,2900,-30
53853119178,53853119183,5,2828,1249,-30
53858399305,53858399311,6,2766,1207,-30
53859152650,53859152656,6,2691,1247,-30
53861673009,53861673007,-2,1120,1595,-30
53864228421,53864228426,5,1852,1205,-30
53864419279,53864419296,17,2124,1209,-30
53865189857,53865189864,7,2077,948,-30
53865641914,53865641919,5,1675,717,-30
53866089061,53866089065,4,2319,1140,-30
53867709093,53867709096,3,1902,1424,-30
53872654466,53872654472,6,1380,812,-30
53882836035,53882836040,5,2955,1328,-30
53887206005,53887206010,5,2261,1183,-30
53888132762,53888132766,4,1960,1128,-30
53894444457,53894444457,0,635,1548,-30
53895284297,53895284303,6,2268,1375,-30
53902932054,53902932059,5,1742,1377,-30
53905264680,53905264685,5,2573,1414,-30
53908105469,53908105473,4,1628,1044,-30
53912386213,53912386217,4,1666,933,-30
53912708030,53912708035,5,3091,1772,-30
53917776650,53917776655,5,2414,1997,-30
53918825739,53918825745,6,1867,1517,-30
53922699216,53922699221,5,2901,1858,-30
53923928918,53923928923,5,2249,1337,-30
53927428102,53927428106,4,1476,1397,-30
53929368197,53929368203,6,1958,1777,-30
53939730725,53939730730,5,2148,1373,-30
53939841409,53939841392,-17,1980,1110,-30
53941233018,53941233023,5,1636,1114,-30
53942327412,53942327394,-18,3191,1666,-30
53945032514,53945032520,6,1677,1157,-30
53946216589,53946216595,6,2356,1118,-30
53947625855,53947625845,-10,30003,15239,-30
53949141306,53949141311,5,1648,930,-30
53949332051,53949332056,5,1929,969,-30
53949840269,53949840274,5,2607,1184,-30
53951855002,53951855007,5,1508,1066,-30
53956652178,53956652182,4,1266,1215,-30
53957748041,53957748039,-2,919,1654,-30
53957985181,53957985187,6,2244,1240,-30
53963175623,53963175629,6,2589,1218,-30
53968737782,53968737787,5,2231,1535,-30
53969282994,53969282998,4,2934,1235,-30
53969777072,53969777076,4,1406,1250,-30
53972035494,53972035499,5,2276,1329,-30
53972093131,53972093123,-8,605,300,-30
53982181595,53982181601,6,1331,723,-30
53983431151,53983431156,5,1453,1104,-30
53984880833,53984880837,4,1784,1589,-30
53985072804,53985072809,5,2764,1515,-30
53986469870,53986469874,4,1863,1195,-30
53987365080,53987365086,6,3683,1184,-30
53987818017,53987818021,4,1137,1061,-30
53990864677,53990864682,5,1440,1167,-30
53992519673,53992519679,6,2345,1099,-30
53993408852,53993408858,6,2669,1327,-30
53996020371,53996020374,3,2549,1486,-30
53996696647,53996696653,6,2449,1548,-30
53996783544,53996783549,5,1969,1445,-30
54003785449,54003785454,5,824,860,-30
54009618885,54009618889,4,2480,1536,-30
54013876673,54013876679,6,2672,1268,-30
54016937884,54016937890,6,2033,1185,-30
54019569952,54019569958,6,2393,1550,-30
54021029945,54021029951,6,2423,1754,-30
54022574648,54022574636,-12,253,1013,-30
54026264286,54026264291,5,2602,1543,-30
54029994101,54029994105,4,1710,1026,-30
54030995279,54030995285,6,3183,1391,-30
54034144533,54034144538,5,3625,1851,-30
54034536260,54034536265,5,2773,1775,-30
54035609417,54035609419,2,1933,1546,-30
54037747656,54037747659,3,2385,1305,-30
54038182094,54038182099,5,1969,1818,-30
54038762622,54038762630,8,6225,2511,-30
54042438189,54042438193,4,3310,1242,-30
54042875769,54042875774,5,2339,1202,-30
54043185127,54043185130,3,2696,1088,-30
54046165631,54046165635,4,2189,1272,-30
54049452714,54049452721,7,1678,1091,-30
54057342290,54057342296,6,2106,1808,-30
54057801172,54057801169,-3,733,1969,-30
54058092502,54058092506,4,3407,2069,-30
54059804637,54059804642,5,1429,1436,-30
54064063368,54064063374,6,1673,1408,-30
54067389982,54067389986,4,2171,1257,-30
54068727766,54068727763,-3,666,1343,-30
54072951770,54072951774,4,1532,882,-30
54074523189,54074523192,3,13767,8999,-30
54081546407,54081546414,7,1957,798,-30
54081830318,54081830322,4,2563,1373,-30
54093453435,54093453441,6,2272,1566,-30
54094311385,54094311387,2,1248,1220,-30
54095056289,54095056278,-11,2416,1111,-30
54098732556,54098732561,5,2377,1263,-30
54102728937,54102728943,6,2001,1560,-30
54103528359,54103528364,5,1745,1059,-30
54110116359,54110116364,5,2402,1503,-30
54117479093,54117479097,4,1770,1151,-30
54117666833,54117666835,2,1821,1343,-30
54120657662,54120657667,5,2277,1312,-30
54127670418,54127670402,-16,1294,888,-30
54130657300,54130657302,2,41934,17729,-30
54133362155,54133362162,7,4273,1643,-30
54138167396,54138167399,3,2073,1277,-30
54139604771,54139604767,-4,541,1128,-30
54140781716,54140781722,6,2120,1495,-30
54143272609,54143272615,6,2112,977,-30
54143549494,54143549500,6,95,225,-30
54144464665,54144464669,4,2441,1371,-30
54145843474,54145843479,5,1787,1432,-30
54148181885,54148181891,6,3051,1254,-30
54149034426,54149034430,4,2893,1362,-30
54164690697,54164690700,3,1340,971,-30
54165296203,54165296207,4,1304,299,-30
54166531873,54166531876,3,2083,1177,-30
54170834754,54170834758,4,2154,1128,-30
54172314763,54172314767,4,3086,1504,-30
54172882451,54172882451,0,2806,4101,-30
54180771050,54180771054,4,2335,1393,-30
54181962184,54181962186,2,2678,1101,-30
54182291515,54182291519,4,2323,1334,-30
54188906873,54188906878,5,3468,2438,-30
54189380413,54189380427,14,26793,1132,-30
54191772077,54191772082,5,1743,872,-30
54193496002,54193496007,5,2785,1946,-30
54194592685,54194592690,5,1866,1468,-30
54196565258,54196565254,-4,1056,2776,-30
54197411557,54197411562,5,2157,1407,-30
54199284727,54199284731,4,2008,1208,-30
54202356262,54202356266,4,1379,998,-30
54204373139,54204373146,7,3687,1851,-30
54209090332,54209090334,2,1995,1436,-30
54210363916,54210363920,4,2916,2079,-30
54212546046,54212546050,4,1684,1327,-30
54213636119,54213636123,4,2545,1635,-30
54213908587,54213908568,-19,48419,118945,-30
54216460101,54216460106,5,1745,1169,-30
54219256192,54219256196,4,2405,1461,-30
54220949109,54220949114,5,2965,1393,-30
54222646387,54222646392,5,2773,2578,-30
54224330246,54224330250,4,1803,1224,-30
54224997195,54224997196,1,930,1124,-30
54228858078,54228858074,-4,1619,4305,-30
54230630036,54230630040,4,2747,1882,-30
54231317389,54231317394,5,3060,1191,-30
54231555449,54231555454,5,2207,1506,-30
54231618570,54231618575,5,2278,1089,-30
54232032834,54232032838,4,2259,1184,-30
54238709404,54238709410,6,2549,1293,-30
54241455105,54241455110,5,2705,1644,-30
54243333485,54243333490,5,2596,1270,-30
54244298965,54244298970,5,1809,804,-30
54245870268,54245870272,4,2783,1549,-30
54254994545,54254994551,6,1844,1146,-30
54260547213,54260547217,4,2217,1128,-30
54261749217,54261749223,6,2403,1567,-30
54263045424,54263045430,6,2726,1229,-30
54263665230,54263665234,4,1464,862,-30
54264518536,54264518541,5,2730,1273,-30
54265579339,54265579345,6,2077,1136,-30
54270061974,54270061978,4,1868,1302,-30
54270808246,54270808247,1,1364,1925,-30
54275795742,54275795748,6,2046,1440,-30
54280881397,54280881401,4,2080,1147,-30
54282053854,54282053860,6,2562,1564,-30
54283915422,54283915427,5,2848,1636,-30
54288468517,54288468522,5,2686,1531,-30
54291768666,54291768671,5,2346,1184,-30
54293376984,54293376990,6,2344,1225,-30
54293540457,54293540451,-6,1469,2862,-30
54296101359,54296101367,8,2166,970,-30
54298082606,54298082610,4,1795,1234,-30
54299618389,54299618394,5,2542,1478,-30
54300648975,54300648981,6,1789,1594,-30
54303023033,54303023038,5,2552,1148,-30
54304846606,54304846614,8,3177,1594,-30
54306426262,54306426266,4,3501,1306,-30
54310836252,54310836232,-20,1764,973,-30
54311483529,54311483535,6,2198,1335,-30
54311601698,54311601680,-18,2594,1449,-30
54315693300,54315693303,3,2469,1247,-30
54319346653,54319346659,6,1750,1131,-30
54319573284,54319573283,-1,1313,1957,-30
54320382347,54320382351,4,2317,1447,-30
54321864750,54321864752,2,2043,1770,-30
54324062898,54324062904,6,2354,1516,-30
54325218208,54325218215,7,1678,975,-30
54326847385,54326847389,4,2230,1182,-30
54327173398,54327173377,-21,2577,1597,-30
54328026007,54328026012,5,3185,1672,-30
54332188122,54332188128,6,1992,975,-30
54338027023,54338027029,6,2517,1473,-30
54340245047,54340245050,3,1126,876,-30
54347971644,54347971647,3,2694,1641,-30
54351336937,54351336942,5,2423,1516,-30
54352554376,54352554361,-15,290,1182,-30
54355360169,54355360174,5,2288,1390,-30
54367322777,54367322781,4,2877,1329,-30
54368492986,54368492991,5,1515,799,-30
54371125239,54371125243,4,2077,1008,-30
54377387461,54377387466,5,976,836,-30
54378211718,54378211723,5,1499,1035,-30
54380571295,54380571300,5,2601,1427,-30
54380606571,54380606552,-19,298,153,-30
54381850657,54381850662,5,2111,1115,-30
54384699592,54384699599,7,2494,1304,-30
54391731591,54391731595,4,1822,1282,-30
54393851401,54393851406,5,2445,1432,-30
54396265130,54396265135,5,2023,1177,-30
54397263048,54397263053,5,2326,1252,-30
54398158290,54398158296,6,1825,1566,-30
54401287814,54401287820,6,2298,1654,-30
54403518796,54403518802,6,2673,1323,-30
54405719826,54405719832,6,2007,1183,-30
54406737578,54406737583,5,1959,1268,-30
54409211716,54409211719,3,2188,1295,-30
54409276903,54409276923,20,2416,1369,-30
54414704492,54414704497,5,1423,865,-30
54416230457,54416230462,5,2031,1210,-30
54416402034,54416402035,1,1751,1319,-30
54419415076,54419415079,3,2037,1944,-30
54420626726,54420626732,6,2193,960,-30
54420944863,54420944868,5,1152,967,-30
54421009252,54421009257,5,5812,3720,-30
54433806023,54433806030,7,2281,1484,-30
54437490849,54437490857,8,2028,902,-30
54444186927,54444186934,7,1455,937,-30
54445547354,54445547358,4,3084,1254,-30
54448807154,54448807158,4,2720,1233,-30
54449704436,54449704443,7,1014,978,-30
54450359910,54450359915,5,1670,1197,-30
54452798205,54452798210,5,4793,2009,-30
54453779255,54453779262,7,2256,1593,-30
54463314905,54463314907,2,1540,1172,-30
54463364137,54463364139,2,1711,1461,-30
54464081411,54464081416,5,2029,1658,-30
54466905906,54466905910,4,1811,1026,-30
54468033182,54468033187,5,1974,1010,-30
54468401780,54468401785,5,1664,1165,-30
54471465714,54471465718,4,2253,1255,-30
54473527875,54473527879,4,1579,742,-30
54475044058,54475044062,4,1950,1043,-30
54477256752,54477256757,5,1655,1207,-30
54477312846,54477312852,6,2983,1739,-30
54479859051,54479859054,3,2215,1431,-30
54480336058,54480336064,6,2442,1644,-30
54481528038,54481528044,6,2023,1275,-30
54490987798,54490987803,5,2196,1315,-30
54492641618,54492641622,4,1349,986,-30
54495146743,54495146747,4,2009,1000,-30
54498412226,54498412231,5,2403,1359,-30
54498660224,54498660229,5,1809,1357,-30
54503224800,54503224803,3,2390,1619,-30
54505199274,54505199280,6,2136,1459,-30
54506789744,54506789742,-2,1168,2022,-30
54508274477,54508274481,4,1775,1430,-30
54510281258,54510281263,5,1468,1090,-30
54511742387,54511742394,7,2286,1490,-30
54512014948,54512014962,14,1678,1141,-30
54512871894,54512871900,6,2889,1412,-30
54517471357,54517471363,6,2919,1709,-30
54521860134,54521860140,6,2654,1578,-30
54525445336,54525445342,6,2529,1731,-30
54527367259,54527367271,12,790,230,-30
54536424587,54536424570,-17,2641,1196,-30
54539278849,54539278854,5,2786,1492,-30
54541081142,54541081145,3,2199,1066,-30
54545444997,54545445002,5,1788,1441,-30
54545916351,54545916355,4,2237,1030,-30
54548599817,54548599822,5,2338,1517,-30
54559656618,54559656624,6,3213,1280,-30
54560711280,54560711286,6,2765,1371,-30
54561486365,54561486370,5,2516,1317,-30
54561610490,54561610474,-16,2157,1340,-30
54562089938,54562089943,5,1866,1469,-30
54567229362,54567229365,3,2748,1483,-30
54569473319,54569473326,7,2125,922,-30
54569730214,54569730218,4,2639,1537,-30
54570943739,54570943742,3,1603,1688,-30
54571765398,54571765401,3,2118,1370,-30
54572722795,54572722800,5,2142,1755,-30
54572911351,54572911370,19,2831,1604,-30
54573175983,54573175978,-5,1352,3558,-30
54576261614,54576261618,4,2449,1573,-30
54579328873,54579328879,6,2007,1273,-30
54579537280,54579537285,5,2672,1263,-30
54580119718,54580119725,7,1506,1448,-30
54580811158,54580811140,-18,1451,755,-30
54588064758,54588064760,2,1456,1468,-30
54591029370,54591029375,5,2210,1135,-30
54592118957,54592118961,4,1785,960,-30
54597942816,54597942830,14,8265,49904,-30
54600833723,54600833727,4,2588,1106,-30
54601276445,54601276451,6,1531,1092,-30
54602816242,54602816247,5,2495,1839,-30
54602863045,54602863049,4,1420,1116,-30
54603810707,54603810711,4,1720,1044,-30
54606737035,54606737035,0,1136,1780,-30
54607494708,54607494715,7,2134,1316,-30
54607727505,54607727489,-16,2219,1295,-30
54608971054,54608971057,3,1904,1477,-30
54609299462,54609299468,6,2510,1607,-30
54612435655,54612435660,5,1642,1208,-30
54613177446,54613177448,2,1119,1197,-30
54615147262,54615147267,5,2030,1309,-30
54618129969,54618129974,5,2377,1456,-30
54621511208,54621511216,8,1295,988,-30
54623648495,54623648502,7,2940,1253,-30
54627193597,54627193602,5,2123,1437,-30
54629972845,54629972849,4,3962,2391,-30
54632419390,54632419394,4,1397,941,-30
54633620977,54633620982,5,2797,1775,-30
54635052085,54635052090,5,3879,1426,-30
54648221027,54648221030,3,1680,799,-30
54648740475,54648740478,3,1585,868,-30
54649134206,54649134211,5,1888,1269,-30
54650785256,54650785262,6,3577,1147,-30
54652178133,54652178137,4,2187,1137,-30
54653549076,54653549081,5,3027,1634,-30
54656003387,54656003390,3,1946,1594,-30
54657381669,54657381673,4,2363,1269,-30
54657600908,54657600909,1,2083,1492,-30
54657776125,54657776130,5,1300,1015,-30
54661602901,54661602906,5,1939,1455,-30
54666020166,54666020174,8,1489,856,-30
54668762245,54668762248,3,1936,1361,-30
54671227173,54671227170,-3,1247,2473,-30
54676933562,54676933567,5,3007,1875,-30
54677038920,54677038924,4,2045,1404,-30
54679892203,54679892209,6,1423,674,-30
54681358309,54681358315,6,2112,1145,-30
54685097586,54685097593,7,2077,1230,-30
54686790385,54686790390,5,2760,970,-30
54689272878,54689272883,5,2147,1529,-30
54689675718,54689675717,-1,1418,1976,-30
54691363916,54691363922,6,2238,1649,-30
54694797510,54694797503,-7,688,247,-30
54696841430,54696841435,5,2254,991,-30
54698737425,54698737430,5,2312,1330,-30
54699890093,54699890097,4,2065,1083,-30
54709558723,54709558728,5,2043,1679,-30
54724084353,54724084356,3,1942,963,-30
54726409329,54726409333,4,2755,1284,-30
54726648733,54726648737,4,2113,1100,-30
54729546317,54729546322,5,2189,1360,-30
54734986162,54734986167,5,2636,1117,-30
54735050954,54735050938,-16,2697,1703,-30
54736799079,54736799086,7,3320,1813,-30
54738875866,54738875873,7,2506,1573,-30
54740878063,54740878067,4,1905,1258,-30
54744167798,54744167783,-15,1086,609,-30
54748011198,54748011205,7,2396,1428,-30
54755673041,54755673045,4,2813,1348,-30
54757323693,54757323700,7,2220,1158,-30
54761482657,54761482660,3,1801,1262,-30
54762984625,54762984629,4,2472,1081,-30
54763429290,54763429294,4,2453,1362,-30
54764334010,54764334015,5,1922,1697,-30
54764790053,54764790055,2,1476,968,-30
54772390386,54772390391,5,3110,926,-30
54773528659,54773528652,-7,1103,5002,-30
54775442330,54775442335,5,1637,1007,-30
54775802611,54775802617,6,1962,1257,-30
54776016434,54776016437,3,2016,1017,-30
54777356606,54777356610,4,3224,1373,-30
54779493434,54779493438,4,1704,1421,-30
54780175757,54780175762,5,1632,1080,-30
54780892903,54780892895,-8,1088,736,-30
54782150481,54782150487,6,1876,1304,-30
54782576014,54782576019,5,2350,1075,-30
54785070071,54785070076,5,1688,1625,-30
54793548244,54793548249,5,2489,1211,-30
54800510174,54800510178,4,1354,1302,-30
54800583798,54800583802,4,1629,1038,-30
54810098643,54810098645,2,1943,1614,-30
54816230742,54816230746,4,2322,1702,-30
54820439415,54820439421,6,2198,1325,-30
54821399748,54821399754,6,3791,1463,-30
54824110422,54824110427,5,1901,1156,-30
54825480929,54825480935,6,3515,2100,-30
54829256301,54829256307,6,1584,967,-30
54829842127,54829842132,5,2315,1406,-30
54833140569,54833140574,5,1971,1692,-30
54833513601,54833513605,4,2540,1462,-30
54833893165,54833893168,3,1292,1178,-30
54835946769,54835946777,8,4220,1620,-30
54836168046,54836168034,-12,1560,716,-30
54839264090,54839264086,-4,791,283,-30
54840383157,54840383139,-18,942,366,-30
54841524926,54841524946,20,2158,1394,-30
54841634613,54841634617,4,1854,1773,-30
54841663214,54841663218,4,1811,978,-30
54844911622,54844911626,4,2010,1532,-30
54847825894,54847825899,5,2061,1627,-30
54849732442,54849732447,5,3474,1495,-30
54850970985,54850970991,6,2255,1321,-30
54851463307,54851463311,4,1258,1104,-30
54852503387,54852503392,5,1688,1101,-30
54853340798,54853340802,4,3136,1736,-30
54857181194,54857181199,5,2393,856,-30
54863934687,54863934684,-3,708,2534,-30
54868775177,54868775170,-7,732,2266,-30
54873335666,54873335674,8,2700,1477,-30
54873621494,54873621499,5,2120,1430,-30
54877061973,54877061977,4,1677,1307,-30
54877569029,54877569050,21,1262,811,-30
54878864350,54878864355,5,874,118,-30
54880212130,54880212135,5,980,1019,-30
54880695482,54880695488,6,1739,1538,-30
54883383085,54883383090,5,1654,1426,-30
54885461026,54885461029,3,2235,1392,-30
54885610345,54885610328,-17,2718,1501,-30
54885901618,54885901634,16,2389,1299,-30
54886064958,54886064964,6,2164,1142,-30
54887513035,54887513039,4,1804,1476,-30
54887634406,54887634412,6,2030,1308,-30
54888416559,54888416565,6,1641,1363,-30
54889575289,54889575294,5,2291,866,-30
54890536429,54890536433,4,2182,953,-30
54892770784,54892770791,7,2822,1005,-30
54893792545,54893792546,1,1343,1382,-30
54898778402,54898778407,5,1222,973,-30
54898937697,54898937701,4,2849,1755,-30
54902538707,54902538712,5,1799,1117,-30
54905022972,54905022975,3,9785,7893,-30
54905851864,54905851870,6,2138,997,-30
54909160173,54909160177,4,1477,953,-30
54911715498,54911715503,5,1810,937,-30
54912933622,54912933626,4,1769,1023,-30
54913026399,54913026387,-12,549,352,-30
54916660742,54916660745,3,1582,838,-30
54916751869,54916751872,3,700,385,-30
54921626141,54921626147,6,2480,1741,-30
54925884006,54925884011,5,1269,1259,-30
54933202158,54933202163,5,1112,1141,-30
54934029006,54934029010,4,1524,1434,-30
54939608762,54939608767,5,1999,1417,-30
54945217096,54945217094,-2,1510,2445,-30
54945776737,54945776741,4,2422,1336,-30
54947391208,54947391214,6,3322,1139,-30
54953275277,54953275282,5,3131,1716,-30
54955062171,54955062177,6,2383,1438,-30
54960358754,54960358758,4,1649,1146,-30
54960452054,54960452040,-14,11666,56516,-30
54963029745,54963029750,5,1659,1262,-30
54964677895,54964677902,7,2501,1078,-30
54965737238,54965737243,5,1631,1497,-30
54966098077,54966098081,4,2193,1484,-30
54967897673,54967897676,3,1773,1359,-30
54975724208,54975724213,5,2028,1276,-30
54980052316,54980052321,5,1871,900,-30
54980959269,54980959275,6,1728,1095,-30
54981008946,54981008928,-18,757,361,-30
54982458794,54982458799,5,2288,1705,-30
54983560179,54983560186,7,1872,995,-30
54986023838,54986023842,4,1249,897,-30
54987784535,54987784538,3,1758,971,-30
54988671859,54988671860,1,697,1076,-30
54990638301,54990638307,6,2498,1904,-30
54996636818,54996636821,3,2589,2613,-30
54997539713,54997539719,6,2114,1420,-30
54997724856,54997724859,3,1863,1381,-30
54998659926,54998659930,4,2701,1485,-30
55001863306,55001863310,4,2089,1109,-30
55002083982,55002083986,4,2594,1751,-30
55004267817,55004267822,5,2912,1395,-30
55004708964,55004708969,5,1322,699,-30
55005942502,55005942506,4,1615,1315,-30
55006674202,55006674207,5,1771,1097,-30
55007121526,55007121530,4,1860,1233,-30
55007403690,55007403694,4,2438,1480,-30
55008224702,55008224710,8,3745,1787,-30
55014074117,55014074121,4,2292,1032,-30
55014346807,55014346814,7,2751,1143,-30
55014943245,55014943245,0,2156,1841,-30
55015054799,55015054806,7,1696,1316,-30
55017591012,55017591018,6,1668,1123,-30
55018434242,55018434248,6,2319,1285,-30
55019191532,55019191538,6,2325,1311,-30
55019907087,55019907091,4,1601,1224,-30
55020030931,55020030934,3,2985,1910,-30
55020881213,55020881210,-3,1005,1345,-30
55021723286,55021723292,6,2624,1346,-30
55023872858,55023872863,5,2556,1017,-30
55025065314,55025065318,4,1603,916,-30
55027492830,55027492835,5,1377,768,-30
55033695088,55033695091,3,1673,1136,-30
55033858553,55033858560,7,2757,1139,-30
55035184504,55035184506,2,1124,1176,-30
55037861895,55037861900,5,2377,1160,-30
55041377763,55041377770,7,3310,1589,-30
55047523085,55047523090,5,2732,1213,-30
55048412361,55048412366,5,1149,1230,-30
55049123890,55049123895,5,1719,1350,-30
55049759617,55049759621,4,1923,1581,-30
55050756971,55050756975,4,2351,1144,-30
55051905399,55051905405,6,2174,1446,-30
55051932848,55051932852,4,2426,1237,-30
55053702071,55053702077,6,1513,959,-30
55054025632,55054025635,3,1252,1093,-30
55054599394,55054599399,5,1208,1119,-30
55056663837,55056663839,2,1738,1468,-30
55058050158,55058050163,5,2716,1619,-30
55058810025,55058810030,5,2917,1404,-30
55064294331,55064294337,6,2480,1388,-30
55064620295,55064620301,6,1455,919,-30
55066952976,55066952982,6,2584,1075,-30
55068414830,55068414842,12,2058,1249,-30
55071434463,55071434459,-4,1062,3594,-30
55072466382,55072466389,7,3159,1342,-30
55074518249,55074518253,4,2384,1279,-30
55079439613,55079439610,-3,2303,4571,-30
55080684479,55080684473,-6,1048,4680,-30
55081072371,55081072375,4,2186,796,-30
55086835608,55086835613,5,2033,961,-30
55089332198,55089332203,5,2799,1606,-30
55090982573,55090982579,6,3060,1266,-30
55091183674,55091183679,5,1965,1038,-30
55095170230,55095170233,3,2606,2551,-30
55098198398,55098198402,4,2804,1621,-30
55098382329,55098382333,4,2037,2189,-30
55106947214,55106947222,8,2514,1455,-30
55107172425,55107172429,4,1815,1534,-30
55107268194,55107268200,6,1889,1377,-30
55110839164,55110839168,4,2149,1127,-30
55110953670,55110953675,5,1952,1197,-30
55111022950,55111022955,5,2688,1583,-30
55112781851,55112781855,4,1414,1150,-30
55115056035,55115056039,4,1658,1017,-30
55115307234,55115307239,5,1470,833,-30
55115798104,55115798110,6,2324,976,-30
55115954306,55115954308,2,2419,1748,-30
55118036426,55118036431,5,1189,743,-30
55120885057,55120885063,6,1458,1204,-30
55126589502,55126589507,5,2030,1182,-30
55127982603,55127982602,-1,1406,2196,-30
55130104373,55130104380,7,1849,1110,-30
55132150635,55132150641,6,2035,1284,-30
55132665623,55132665629,6,2936,1580,-30
55135560209,55135560213,4,1956,1164,-30
55138195834,55138195839,5,1521,1028,-30
55144301005,55144301010,5,3620,1066,-30
55146042633,55146042637,4,2694,1383,-30
55146068023,55146068027,4,930,1166,-30
55146081586,55146081586,0,47,72,-30
55147090296,55147090302,6,2024,1080,-30
55147955084,55147955089,5,2353,1127,-30
55149569378,55149569386,8,2523,1492,-30
55150608726,55150608731,5,1362,942,-30
55150720960,55150720980,20,2725,1629,-30
55152603587,55152603589,2,1806,1965,-30
55154408834,55154408838,4,1333,892,-30
55155650470,55155650477,7,2319,1383,-30
55157708619,55157708627,8,2565,1093,-30
55161323151,55161323155,4,2500,1186,-30
55161487660,55161487664,4,1478,1285,-30
55164595729,55164595735,6,1987,1003,-30
55168350068,55168350074,6,3813,2109,-30
55170999482,55170999489,7,2218,1176,-30
55171818014,55171818019,5,2147,1137,-30
55173085950,55173085954,4,1857,1321,-30
55173754930,55173754934,4,2578,1579,-30
55174980466,55174980460,-6,2061,10239,-30
55177438962,55177438958,-4,1959,3508,-30
55178116625,55178116631,6,2471,1255,-30
55181081029,55181081034,5,2105,1236,-30
55181950185,55181950190,5,2542,1632,-30
55187914915,55187914913,-2,1403,2886,-30
55188202965,55188202985,20,15248,51271,-30
55191975155,55191975161,6,2017,1177,-30
55192035958,55192035952,-6,534,274,-30
55194056775,55194056778,3,1122,1225,-30
55200737222,55200737226,4,2452,1648,-30
55203818850,55203818855,5,1906,988,-30
55203874771,55203874775,4,1368,1077,-30
55207241745,55207241749,4,1973,1168,-30
55207374916,55207374921,5,2021,1411,-30
55207861802,55207861804,2,1722,1575,-30
55207890834,55207890817,-17,385,268,-30
55213884266,55213884272,6,2827,1442,-30
55220759210,55220759214,4,1675,1302,-30
55227520515,55227520519,4,2346,2001,-30
55228005049,55228005052,3,1301,1197,-30
55237173773,55237173778,5,2043,1070,-30
55239115073,55239115078,5,2441,1101,-30
55239558030,55239558042,12,1439,1059,-30
55241604523,55241604529,6,2389,987,-30
55243662572,55243662577,5,2840,1112,-30
55246170363,55246170370,7,2520,1458,-30
55249490238,55249490238,0,600,8686,-30
55250149152,55250149156,4,2246,1357,-30
55250771597,55250771602,5,2642,1318,-30
55255178909,55255178915,6,2121,1171,-30
55256367720,55256367718,-2,2217,4314,-30
55257627236,55257627241,5,2067,990,-30
55257670918,55257670899,-19,792,644,-30
55262993942,55262993943,1,2391,1935,-30
55265817146,55265817143,-3,2022,2752,-30
55271230258,55271230262,4,2726,1561,-30
55272973312,55272973317,5,1552,1211,-30
55274837091,55274837090,-1,872,1413,-30
55276634050,55276634059,9,2610,1002,-30
55279111070,55279111062,-8,870,2886,-30
55284053578,55284053581,3,1706,1048,-30
55284626013,55284626017,4,1614,1560,-30
55286357495,55286357500,5,2249,1512,-30
55286769784,55286769790,6,3066,1956,-30
55291376813,55291376815,2,1671,1147,-30
55293229703,55293229698,-5,1219,3652,-30
55295037696,55295037698,2,1445,1365,-30
55301266736,55301266742,6,1962,914,-30
55301556146,55301556152,6,2324,1156,-30
55303390822,55303390827,5,1456,1307,-30
55305728742,55305728747,5,1673,1305,-30
55306065182,55306065202,20,1846,1133,-30
55306534698,55306534706,8,2321,1178,-30
55307295309,55307295290,-19,1347,685,-30
55309586832,55309586837,5,2669,2000,-30
55313285180,55313285184,4,2199,1340,-30
55318195401,55318195406,5,1956,1215,-30
55318854375,55318854373,-2,1876,3803,-30
55319007450,55319007450,0,1864,2160,-30
55323347152,55323347155,3,2004,1533,-30
55325056166,55325056144,-22,2445,1287,-30
55325296741,55325296747,6,2740,1502,-30
55325953938,55325953945,7,1944,1286,-30
55328322272,55328322279,7,2825,1168,-30
55332209325,55332209328,3,2784,1099,-30
55337782451,55337782456,5,2093,1029,-30
55338028154,55338028159,5,2068,1417,-30
55345144153,55345144159,6,1972,1024,-30
55346053891,55346053897,6,2593,1448,-30
55349608790,55349608786,-4,1255,3251,-30
55349847722,55349847726,4,2228,1413,-30
55350628840,55350628842,2,1374,1422,-30
55352333301,55352333303,2,2923,1788,-30
55358895818,55358895822,4,2350,1681,-30
55364945620,55364945625,5,2490,1508,-30
55365590401,55365590402,1,1764,1287,-30
55366963223,55366963223,0,972,849,-30
55367036410,55367036396,-14,2216,1200,-30
55367583566,55367583571,5,2237,1210,-30
55370025414,55370025419,5,1700,1344,-30
55372682885,55372682887,2,2164,2205,-30
55372921469,55372921473,4,2000,1261,-30
55380307958,55380307963,5,2467,1211,-30
55381834670,55381834673,3,1937,1635,-30
55383116605,55383116610,5,2552,1736,-30
55387650077,55387650077,0,1901,1794,-30
55389609839,55389609842,3,1895,1231,-30
55389973900,55389973907,7,2567,1207,-30
55393508718,55393508723,5,2377,1318,-30
55395259102,55395259107,5,2530,1217,-30
55397639589,55397639594,5,2634,1141,-30
55397964218,55397964224,6,2534,1530,-30
55404331182,55404331186,4,3064,1490,-30
55412804530,55412804534,4,1875,1027,-30
55413883112,55413883105,-7,1346,3946,-30
55414595409,55414595410,1,1509,1258,-30
55414884635,55414884634,-1,482,55,-30
55420631734,55420631739,5,3457,1568,-30
55421810113,55421810118,5,3002,1087,-30
55425432197,55425432202,5,2641,1683,-30
55426800967,55426800970,3,2742,1478,-30
55431053197,55431053205,8,1125,588,-30
55434799209,55434799214,5,3130,1347,-30
55435888598,55435888603,5,2455,1291,-30
55440975096,55440975098,2,1963,2020,-30
55441148977,55441148985,8,3642,2218,-30
55443584514,55443584517,3,2436,1554,-30
55444058789,55444058795,6,2154,1198,-30
55453098860,55453098865,5,1882,1795,-30
55453769767,55453769770,3,2304,1459,-30
55455898821,55455898825,4,1843,1144,-30
55460100382,55460100385,3,2272,1026,-30
55462334161,55462334156,-5,1613,7523,-30
55462778132,55462778136,4,2165,1304,-30
55464288822,55464288826,4,1974,1227,-30
55464564339,55464564322,-17,4729,1927,-30
55467128570,55467128574,4,1413,781,-30
55468434424,55468434417,-7,1685,7209,-30
55470454859,55470454858,-1,2950,2692,-30
55470662222,55470662227,5,2491,1617,-30
55471759903,55471759907,4,2885,773,-30
55474165462,55474165468,6,1768,1229,-30
55476272864,55476272870,6,2392,1468,-30
55477353790,55477353794,4,1091,617,-30
55477768679,55477768686,7,2113,1340,-30
55478568697,55478568702,5,1786,1301,-30
55478806602,55478806607,5,3014,1489,-30
55479020816,55479020823,7,1819,1022,-30
55481827798,55481827804,6,2753,1377,-30
55486128218,55486128224,6,2399,1401,-30
55487966329,55487966334,5,2624,1653,-30
55490006015,55490006019,4,1935,902,-30
55495405777,55495405781,4,1801,1123,-30
55496558586,55496558589,3,1597,1108,-30
55497142830,55497142835,5,2101,1342,-30
55499690594,55499690596,2,984,1197,-30
55501233202,55501233208,6,2462,1560,-30
55501660882,55501660867,-15,1808,683,-30
55503377740,55503377744,4,1954,1904,-30
55503421421,55503421426,5,1876,966,-30
55504693233,55504693238,5,1630,1251,-30
55509787142,55509787146,4,1970,1157,-30
55511415381,55511415383,2,1340,839,-30
55516985191,55516985197,6,1608,1399,-30
55517104064,55517104067,3,2409,1365,-30
55517305366,55517305371,5,2149,989,-30
55519052411,55519052418,7,2492,1307,-30
55520030265,55520030270,5,1903,1114,-30
55520814526,55520814530,4,1796,1258,-30
55523224205,55523224211,6,2644,1110,-30
55526141347,55526141350,3,1809,898,-30
55527566525,55527566529,4,1932,1197,-30
55529323008,55529323011,3,1768,1294,-30
55532430173,55532430179,6,1886,1308,-30
55532501519,55532501531,12,2540,1439,-30
55534369954,55534369959,5,2292,1743,-30
55542225356,55542225362,6,2189,1110,-30
55543597698,55543597702,4,2635,1054,-30
55544623482,55544623485,3,1980,1499,-30
55546050166,55546050170,4,1914,1284,-30
55549412969,55549412974,5,2812,1293,-30
55550194343,55550194347,4,2101,1940,-30
55552515250,55552515255,5,2997,1499,-30
55555658945,55555658951,6,2189,1311,-30
55557983878,55557983871,-7,1127,4033,-30
55558620111,55558620117,6,3242,1958,-30
55558862296,55558862294,-2,1329,1986,-30
55561518506,55561518511,5,2208,1106,-30
55562299519,55562299525,6,1769,1672,-30
55567966038,55567966043,5,1432,1249,-30
55570370054,55570370058,4,1087,973,-30
55572404316,55572404321,5,2413,1831,-30
55577358943,55577358948,5,2788,1224,-30
55577543458,55577543462,4,6064,17523,-30
55578266132,55578266139,7,2901,1141,-30
55579157423,55579157430,7,3426,1285,-30
55585809642,55585809646,4,1766,1478,-30
55592111412,55592111418,6,3404,1719,-30
55593385730,55593385735,5,1392,719,-30
55595547727,55595547733,6,2940,1652,-30
55597650651,55597650647,-4,2341,5908,-30
55602833547,55602833553,6,2067,1687,-30
55604890094,55604890097,3,1940,1206,-30
55613759110,55613759116,6,2029,1434,-30
55616509002,55616509006,4,2895,1251,-30
55617091768,55617091775,7,2593,785,-30
55622600605,55622600610,5,1705,1262,-30
55622688343,55622688346,3,2179,2002,-30
55626407754,55626407759,5,1329,887,-30
55626742018,55626742022,4,1834,1149,-30
55627613562,55627613567,5,2419,1533,-30
55629774777,55629774782,5,2816,1357,-30
55632014011,55632014017,6,2957,1552,-30
55632720526,55632720531,5,2837,1037,-30
55632997646,55632997649,3,1443,2071,-30
55633566706,55633566710,4,1871,1616,-30
55633680622,55633680630,8,3008,1347,-30
55639311299,55639311304,5,3304,1514,-30
55640203208,55640203208,0,1470,2033,-30
55643969554,55643969561,7,3072,1571,-30
55647883966,55647883969,3,4816,3696,-30
55648281326,55648281329,3,1740,1278,-30
55648482398,55648482405,7,2225,1247,-30
55650000765,55650000768,3,2337,1386,-30
55651430582,55651430588,6,1548,1358,-30
55656294046,55656294051,5,1605,812,-30
55658016551,55658016555,4,2239,1352,-30
55658489404,55658489425,21,79752,52505,-30
55659147529,55659147533,4,2157,1544,-30
55660827008,55660827013,5,2836,1877,-30
55665281946,55665281948,2,3821,3329,-30
55672569056,55672569061,5,2478,1250,-30
55676672726,55676672731,5,1650,715,-30
55676818690,55676818672,-18,1398,252,-30
55681348801,55681348807,6,3133,1213,-30
55685685250,55685685254,4,1595,967,-30
55695001316,55695001319,3,2467,1325,-30
55698912351,55698912369,18,1715,864,-30
55700922821,55700922825,4,2504,1755,-30
55703081083,55703081087,4,2653,1099,-30
55703384193,55703384189,-4,23178,13819,-30
55703424148,55703424149,1,3147,3239,-30
55703643162,55703643166,4,1711,774,-30
55704813033,55704813037,4,2474,1539,-30
55706227309,55706227300,-9,888,8988,-30
55707917789,55707917793,4,2129,1245,-30
55708397585,55708397589,4,2014,1523,-30
55712113327,55712113333,6,1910,1598,-30
55716764825,55716764823,-2,30790,50753,-30
55717783374,55717783381,7,6349,1789,-30
55718136596,55718136602,6,2213,1584,-30
55721038061,55721038064,3,1746,1128,-30
55721928541,55721928547,6,2117,1106,-30
55722632324,55722632330,6,1988,1387,-30
55726102646,55726102646,0,1568,1472,-30
55726380203,55726380209,6,2233,1180,-30
55731761431,55731761437,6,2758,1705,-30
55736460431,55736460435,4,1843,1394,-30
55738679097,55738679102,5,1970,1424,-30
55742486946,55742486953,7,1786,1199,-30
55742529665,55742529649,-16,2518,1564,-30
55742973047,55742973051,4,2870,1671,-30
55745915741,55745915747,6,1515,1065,-30
55747370249,55747370252,3,1624,1188,-30
55749415594,55749415601,7,2366,1621,-30
55754073234,55754073238,4,2054,1513,-30
55757519276,55757519278,2,1389,1134,-30
55765404009,55765404014,5,2088,1060,-30
55766928215,55766928214,-1,974,1309,-30
55768089191,55768089198,7,3191,1708,-30
55769938157,55769938163,6,2006,1130,-30
55772230979,55772230983,4,2572,1193,-30
55772444701,55772444706,5,2071,1376,-30
55775059235,55775059235,0,2037,1442,-30
55776969346,55776969350,4,2214,1929,-30
55786448363,55786448358,-5,1052,4129,-30
55790288410,55790288415,5,2191,1504,-30
55791076810,55791076815,5,3176,1082,-30
55791476741,55791476742,1,1486,1139,-30
55794467826,55794467831,5,2089,1305,-30
55801314734,55801314741,7,3107,1754,-30
55803530053,55803530057,4,2357,1261,-30
55803875548,55803875552,4,3121,1768,-30
55804898568,55804898571,3,1480,1317,-30
55811534118,55811534124,6,1265,1132,-30
55814144289,55814144293,4,2468,1698,-30
55814429135,55814429146,11,907,200,-30
55818298230,55818298234,4,2954,1444,-30
55820398998,55820399005,7,2598,1631,-30
55821564919,55821564925,6,1887,974,-30
55823333371,55823333376,5,2098,1252,-30
55827009985,55827009988,3,1765,1092,-30
55830205393,55830205397,4,1586,1338,-30
55838489394,55838489398,4,2810,1495,-30
55839172945,55839172950,5,1906,1382,-30
55839490070,55839490075,5,2462,1115,-30
55840037307,55840037312,5,2095,1097,-30
55840562139,55840562141,2,1050,1090,-30
55842334578,55842334560,-18,2864,1447,-30
55842366512,55842366518,6,2955,1187,-30
55843798985,55843798993,8,1900,1179,-30
55846173408,55846173413,5,2426,1827,-30
55849246185,55849246190,5,2888,1021,-30
55852698040,55852698045,5,1862,990,-30
55853346497,55853346503,6,2533,916,-30
55858774771,55858774775,4,1646,1145,-30
55863638199,55863638203,4,2891,1273,-30
55865406538,55865406542,4,2533,1675,-30
55867780863,55867780871,8,2421,1040,-30
55869431485,55869431490,5,3370,2284,-30
55871644089,55871644094,5,2277,1502,-30
55872873901,55872873906,5,1653,1013,-30
55874781459,55874781462,3,2010,1430,-30
55876347402,55876347397,-5,1140,4609,-30
55880115482,55880115482,0,1669,1921,-30
55880562884,55880562889,5,2093,1275,-30
55885011741,55885011745,4,3017,1645,-30
55887669942,55887669946,4,2245,1468,-30
55889209159,55889209165,6,2696,2220,-30
55890750853,55890750859,6,2656,1282,-30
55893577003,55893577010,7,2890,1278,-30
55895717960,55895717963,3,2476,1347,-30
55899514934,55899514937,3,2041,1353,-30
55899895646,55899895650,4,2280,1321,-30
55901793187,55901793185,-2,1220,1091,-30
55903521558,55903521562,4,2206,1349,-30
55905362265,55905362271,6,2393,1534,-30
55911293091,55911293096,5,2553,1057,-30
55913934100,55913934106,6,4002,1353,-30
55916632657,55916632655,-2,1017,1407,-30
55922656013,55922656018,5,2846,834,-30
55923381355,55923381355,0,810,1629,-30
55928335658,55928335662,4,1895,1240,-30
55932166445,55932166452,7,2522,1449,-30
55935748858,55935748863,5,2955,1396,-30
55935784382,55935784400,18,1549,1401,-30
55938612433,55938612438,5,1748,1006,-30
55939366135,55939366134,-1,1156,1650,-30
55939484428,55939484425,-3,898,253,-30
55943646746,55943646753,7,2119,1118,-30
55946905326,55946905329,3,1933,1320,-30
55950021185,55950021178,-7,1158,4254,-30
55953179451,55953179454,3,1181,1178,-30
55954382746,55954382755,9,11900,25121,-30
55962842575,55962842582,7,2523,1160,-30
55966311794,55966311795,1,969,1377,-30
55967041648,55967041652,4,2471,1668,-30
55968614809,55968614807,-2,1512,2307,-30
55969132388,55969132393,5,1948,1384,-30
55972738442,55972738448,6,2720,1429,-30
55974099246,55974099252,6,2634,1667,-30
55974975902,55974975906,4,1798,1190,-30
55977569845,55977569841,-4,1022,2680,-30
55978611849,55978611853,4,1717,1428,-30
55984615249,55984615253,4,1451,1582,-30
55985232710,55985232714,4,1735,1214,-30
55985478493,55985478498,5,1903,1091,-30
55988983583,55988983589,6,2285,1260,-30
55994030645,55994030650,5,1393,1190,-30
55999397781,55999397785,4,1668,1220,-30
55999886371,55999886376,5,2670,1679,-30
56003531523,56003531529,6,118,1864,-30
56005563243,56005563246,3,1615,1905,-30
56005654836,56005654840,4,2165,998,-30
56006564229,56006564233,4,1519,983,-30
56010784443,56010784444,1,1976,1403,-30
56012069374,56012069378,4,1876,1140,-30
56014154146,56014154150,4,1672,1061,-30
56014552166,56014552186,20,1900,1864,-30
56017183403,56017183409,6,1753,1363,-30
56019639527,56019639507,-20,24496,28040,-30
56020955522,56020955526,4,3271,1305,-30
56024027572,56024027575,3,1154,925,-30
56024350247,56024350254,7,2840,1303,-30
56027255877,56027255882,5,2680,1262,-30
56030106758,56030106763,5,1946,1263,-30
56036063093,56036063098,5,1332,819,-30
56040900381,56040900387,6,917,945,-30
56043992390,56043992393,3,1472,1256,-30
56045343531,56045343533,2,1202,1746,-30
56045797092,56045797098,6,1692,1397,-30
56046901066,56046901066,0,1307,1344,-30
56047278129,56047278133,4,2729,1161,-30
56049402510,56049402514,4,2342,1072,-30
56049433754,56049433739,-15,2473,1321,-30
56052082883,56052082887,4,1097,801,-30
56055264065,56055264069,4,1825,1528,-30
56056435738,56056435742,4,1394,776,-30
56058192935,56058192939,4,2332,1271,-30
56060672766,56060672767,1,1347,792,-30
56060882901,56060882906,5,2338,1308,-30
56064027061,56064027066,5,2516,1319,-30
56065110944,56065110929,-15,2013,1384,-30
56071669753,56071669759,6,2034,1166,-30
56071870727,56071870707,-20,1350,973,-30
56083510142,56083510146,4,876,835,-30
56085199995,56085200001,6,1750,1437,-30
56088735766,56088735768,2,3035,3810,-30
56089925958,56089925961,3,2883,1743,-30
56091458685,56091458690,5,2123,1344,-30
56097720572,56097720577,5,2335,1296,-30
56102356439,56102356443,4,1467,730,-30
56104194459,56104194465,6,2135,1384,-30
56110171960,56110171957,-3,3007,4874,-30
56113105763,56113105770,7,2540,1198,-30
56113866474,56113866478,4,2118,1136,-30
56116030853,56116030858,5,2394,1797,-30
56122052006,56122052010,4,2440,1653,-30
56122933631,56122933630,-1,1481,2470,-30
56124337014,56124337019,5,2562,1020,-30
56125433966,56125433972,6,3932,1918,-30
56126299322,56126299326,4,1771,1229,-30
56126950659,56126950657,-2,661,153,-30
56129902761,56129902766,5,1962,1251,-30
56130306044,56130306032,-12,896,1978,-30
56130578711,56130578715,4,1969,1329,-30
56132505066,56132505070,4,2454,1256,-30
56135856405,56135856407,2,1753,1054,-30
56135896383,56135896362,-21,1390,1538,-30
56141790693,56141790698,5,2202,1472,-30
56143109384,56143109389,5,2372,1785,-30
56143883557,56143883563,6,2838,1387,-30
56145423061,56145423083,22,377,1025,-30
56145775199,56145775185,-14,622,440,-30
56147077992,56147077998,6,2002,922,-30
56148031476,56148031482,6,2719,1460,-30
56148464020,56148464034,14,1649,1693,-30
56157335882,56157335886,4,2510,1663,-30
56162741251,56162741257,6,2086,1245,-30
56163072085,56163072090,5,2170,1274,-30
56164308349,56164308353,4,1875,1559,-30
56164780117,56164780122,5,2022,1347,-30
56165361016,56165361019,3,2148,1059,-30
56167531155,56167531163,8,3196,1250,-30
56168025838,56168025845,7,2525,1377,-30
56169739716,56169739720,4,1894,1041,-30
56171927963,56171927966,3,1841,952,-30
56175529590,56175529594,4,2393,1564,-30
56179142893,56179142898,5,2631,1118,-30
56179354260,56179354265,5,2088,1395,-30
56179624693,56179624674,-19,2920,1479,-30
56180239437,56180239441,4,2427,1405,-30
56187049839,56187049844,5,2060,1224,-30
56187128150,56187128155,5,3327,1530,-30
56187626280,56187626287,7,3324,1142,-30
56192840309,56192840314,5,2733,1618,-30
56195887554,56195887559,5,1829,1502,-30
56198918906,56198918911,5,2484,1335,-30
56204863926,56204863931,5,1593,1234,-30
56205523529,56205523533,4,2306,1278,-30
56207142855,56207142855,0,1534,1751,-30
56219173323,56219173328,5,1376,1127,-30
56220294652,56220294656,4,2475,1363,-30
56221336808,56221336811,3,1781,1203,-30
56221520759,56221520763,4,2892,1460,-30
56224667132,56224667137,5,2529,1331,-30
56228403796,56228403802,6,1880,1332,-30
56231905738,56231905743,5,2785,1481,-30
56233782607,56233782613,6,2200,1302,-30
56234535268,56234535273,5,2473,1096,-30
56238997031,56238997037,6,2500,1745,-30
56239653215,56239653216,1,982,119,-30
56239989182,56239989186,4,2000,1352,-30
56241060556,56241060562,6,3890,1129,-30
56242016471,56242016475,4,2193,1351,-30
56244341538,56244341542,4,2464,1311,-30
56246943775,56246943781,6,2605,1010,-30
56247544351,56247544350,-1,1574,1958,-30
56249811461,56249811479,18,360,808,-30
56250795813,56250795810,-3,2529,5129,-30
56251462332,56251462337,5,2563,1191,-30
56254872089,56254872088,-1,2173,3184,-30
56257084803,56257084810,7,1773,943,-30
56257262938,56257262943,5,1287,977,-30
56257925239,56257925246,7,2380,1688,-30
56259671754,56259671759,5,972,580,-30
56261687410,56261687414,4,2229,1486,-30
56268840274,56268840279,5,1368,1263,-30
56272844610,56272844614,4,2106,1086,-30
56277241873,56277241878,5,2544,1336,-30
56278521773,56278521777,4,2462,1665,-30
56278895935,56278895942,7,2455,1148,-30
56281539479,56281539483,4,2127,1248,-30
56283608958,56283608962,4,2776,1273,-30
56289394864,56289394870,6,1722,1449,-30
56295990288,56295990289,1,2629,1866,-30
56296778714,56296778721,7,1542,567,-30
56298594446,56298594442,-4,70527,122374,-30
56300291446,56300291450,4,2052,1136,-30
56300407536,56300407541,5,2682,1574,-30
56301651519,56301651526,7,2389,1476,-30
56303630405,56303630407,2,1911,1606,-30
56303919346,56303919348,2,2384,1427,-30
56303976596,56303976599,3,1895,1687,-30
56306775720,56306775725,5,2316,1034,-30
56307653626,56307653633,7,1989,967,-30
56309181495,56309181500,5,2099,1476,-30
56311672637,56311672641,4,1607,1468,-30
56314988013,56314988017,4,1913,1484,-30
56315600541,56315600523,-18,1310,590,-30
56322543761,56322543768,7,1829,1275,-30
56323375393,56323375398,5,2084,883,-30
56323655652,56323655658,6,3353,1224,-30
56324733240,56324733241,1,1162,1856,-30
56325362793,56325362797,4,1875,1178,-30
56325737903,56325737905,2,1690,1230,-30
56328382637,56328382642,5,3829,2923,-30
56331554211,56331554210,-1,931,2421,-30
56334127520,56334127526,6,2998,1657,-30
56342583177,56342583183,6,3272,1404,-30
56344687269,56344687273,4,2843,1107,-30
56344738229,56344738234,5,1548,1225,-30
56345985049,56345985054,5,3304,1676,-30
56349205901,56349205906,5,1936,1029,-30
56351245206,56351245213,7,2506,1382,-30
56352859641,56352859645,4,2705,1728,-30
56355130106,56355130111,5,2060,1552,-30
56356169362,56356169367,5,2962,1192,-30
56357557077,56357557082,5,3420,1733,-30
56359179789,56359179792,3,2807,2085,-30
56359512324,56359512318,-6,1087,3419,-30
56362975406,56362975410,4,2213,1646,-30
56363249377,56363249381,4,2016,1271,-30
56364609662,56364609667,5,1811,1083,-30
56366027809,56366027814,5,2412,822,-30
56366353049,56366353054,5,3109,2026,-30
56369668950,56369668953,3,3974,3045,-30
56370158921,56370158925,4,1714,954,-30
56370550036,56370550050,14,568,1669,-30
56370605074,56370605078,4,1379,1179,-30
56372276892,56372276898,6,2412,1172,-30
56373088703,56373088706,3,1633,1152,-30
56374144917,56374144922,5,1096,1022,-30
56375070660,56375070654,-6,1185,4584,-30
56376216869,56376216873,4,1939,1106,-30
56377918825,56377918831,6,2611,1599,-30
56382423642,56382423634,-8,1166,5439,-30
56385822313,56385822319,6,1155,1259,-30
56386524466,56386524473,7,1704,744,-30
56388994930,56388994935,5,2355,1458,-30
56389360821,56389360825,4,1847,962,-30
56390799080,56390799086,6,2110,1357,-30
56398326505,56398326510,5,2214,1380,-30
56398897265,56398897269,4,2044,1555,-30
56399444142,56399444146,4,2731,2009,-30
56400665510,56400665514,4,2247,837,-30
56404374483,56404374487,4,1200,1045,-30
56410789642,56410789647,5,2250,1074,-30
56413316381,56413316380,-1,1504,2937,-30
56413499177,56413499180,3,1277,679,-30
56418370282,56418370286,4,1636,1397,-30
56418964392,56418964390,-2,1325,2227,-30
56419737321,56419737326,5,2791,1692,-30
56422884468,56422884487,19,1930,1716,-30
56425077198,56425077202,4,2746,1207,-30
56430733055,56430733061,6,2725,1775,-30
56433437678,56433437682,4,2113,1249,-30
56436903509,56436903505,-4,27631,13868,-30
56439633887,56439633892,5,2743,1812,-30
56444908306,56444908310,4,2479,1490,-30
56444983095,56444983100,5,1957,1656,-30
56445186640,56445186645,5,2473,1597,-30
56447797957,56447797965,8,2830,1269,-30
56449310397,56449310402,5,2319,1741,-30
56458376760,56458376765,5,2904,1503,-30
56464934067,56464934073,6,2311,1379,-30
56471588420,56471588425,5,2323,1206,-30
56471886150,56471886155,5,2008,1532,-30
56472052869,56472052872,3,2453,1799,-30
56472224438,56472224457,19,2023,1241,-30
56473081934,56473081941,7,1952,1175,-30
56473995314,56473995323,9,1293,1007,-30
56477174363,56477174367,4,2238,1237,-30
56480614333,56480614338,5,2633,1888,-30
56486569037,56486569042,5,3143,2301,-30
56501272514,56501272518,4,1267,1139,-30
56510673666,56510673678,12,38,2642,-30
56512476943,56512476947,4,2773,1464,-30
56515961658,56515961662,4,3253,3054,-30
56522362551,56522362555,4,1882,1451,-30
56526560092,56526560099,7,2265,1084,-30
56527812378,56527812379,1,1198,1734,-30
56528102938,56528102942,4,2105,1257,-30
56533079013,56533079018,5,1646,1261,-30
56533764193,56533764199,6,3026,1672,-30
56539400103,56539400110,7,2520,1236,-30
56539621791,56539621796,5,2689,1378,-30
56539766602,56539766585,-17,2248,990,-30
56539834732,56539834737,5,1796,1161,-30
56542811329,56542811333,4,2435,2198,-30
56544081406,56544081411,5,1484,1021,-30
56544770831,56544770835,4,1974,1172,-30
56544889954,56544889947,-7,752,238,-30
56553326084,56553326088,4,2003,1367,-30
56554773577,56554773581,4,6499,27872,-30
56554929374,56554929376,2,1368,1370,-30
56557946169,56557946173,4,1694,1112,-30
56557980078,56557980080,2,1965,1346,-30
56560320442,56560320448,6,2671,1896,-30
56566059724,56566059730,6,2148,1219,-30
56568316173,56568316179,6,1998,1694,-30
56576350713,56576350718,5,1866,974,-30
56579769286,56579769294,8,2158,913,-30
56581484042,56581484045,3,2069,1045,-30
56589539797,56589539798,1,1824,1150,-30
56590228816,56590228819,3,2194,1129,-30
56596415775,56596415777,2,1798,1170,-30
56599038473,56599038478,5,1248,1115,-30
56601176652,56601176658,6,2380,1121,-30
56601512482,56601512487,5,1881,1255,-30
56608632622,56608632626,4,2259,1183,-30
56609764677,56609764683,6,2441,1949,-30
56610310787,56610310791,4,1784,1877,-30
56613471970,56613471976,6,1995,1273,-30
56614392345,56614392352,7,2334,854,-30
56615118201,56615118205,4,2824,1615,-30
56616215556,56616215562,6,1631,903,-30
56618729420,56618729425,5,2482,1289,-30
56619525197,56619525199,2,2916,1409,-30
56620283664,56620283666,2,1500,1867,-30
56621903364,56621903368,4,1779,908,-30
56622129561,56622129569,8,922,160,-30
56626607404,56626607410,6,2394,1520,-30
56627928118,56627928119,1,1740,2021,-30
56632959705,56632959690,-15,2127,1300,-30
56633825530,56633825535,5,2442,1548,-30
56635619982,56635619983,1,2127,2005,-30
56640386560,56640386563,3,1791,1103,-30
56643623519,56643623525,6,2964,1453,-30
56646538784,56646538770,-14,844,5340,-30
56649055358,56649055362,4,1791,1155,-30
56657141886,56657141890,4,1399,1020,-30
56658746081,56658746089,8,2465,1415,-30
56659898328,56659898330,2,1694,1150,-30
56660024461,56660024467,6,2879,1955,-30
56663300877,56663300882,5,2377,1310,-30
56664134614,56664134618,4,2182,1678,-30
56675016821,56675016825,4,2164,1140,-30
56681968830,56681968834,4,2616,1402,-30
56684127933,56684127939,6,1291,1068,-30
56684886938,56684886943,5,1315,1027,-30
56685209306,56685209310,4,1922,1252,-30
56685790191,56685790195,4,3342,1142,-30
56686710751,56686710753,2,1877,1183,-30
56687096921,56687096925,4,1625,1261,-30
56687544413,56687544414,1,1429,1688,-30
56689297210,56689297215,5,2927,1610,-30
56691003275,56691003279,4,2228,1629,-30
56692019863,56692019869,6,2197,1192,-30
56692405294,56692405298,4,2477,1490,-30
56694460989,56694460996,7,2333,1205,-30
56696289368,56696289374,6,1397,823,-30
56696897362,56696897366,4,1684,957,-30
56697784479,56697784485,6,2841,2023,-30
56697929341,56697929346,5,1940,953,-30
56698088109,56698088115,6,2143,1189,-30
56698960195,56698960202,7,2447,1036,-30
56707421949,56707421954,5,3163,1526,-30
56708031566,56708031571,5,3077,1400,-30
56708566162,56708566167,5,2253,1059,-30
56708685321,56708685325,4,1749,1256,-30
56709078898,56709078901,3,1890,1115,-30
56712038290,56712038293,3,1779,908,-30
56718900631,56718900635,4,1470,947,-30
56723225651,56723225656,5,2458,1644,-30
56724877770,56724877774,4,1700,1226,-30
56725492729,56725492734,5,3162,1698,-30
56728203763,56728203770,7,2476,1377,-30
56729309869,56729309875,6,2759,1516,-30
56741488810,56741488814,4,2473,1643,-30
56746159870,56746159874,4,1962,1625,-30
56747834932,56747834937,5,3327,2129,-30
56749274758,56749274759,1,1210,1783,-30
56750934862,56750934858,-4,770,2737,-30
56754487094,56754487101,7,3520,1335,-30
56755580638,56755580643,5,2164,1230,-30
56756431533,56756431538,5,3044,1561,-30
56756566363,56756566347,-16,2201,1331,-30
56756839042,56756839046,4,2975,1728,-30
56761569252,56761569258,6,2899,1286,-30
56763050013,56763050018,5,2232,1229,-30
56764669440,56764669446,6,1900,852,-30
56765847994,56765848009,15,1499,1381,-30
56766399600,56766399598,-2,1099,1390,-30
56767993026,56767993030,4,2195,1257,-30
56772727250,56772727253,3,1870,1400,-30
56774788806,56774788811,5,1916,1094,-30
56774879334,56774879315,-19,2233,784,-30
56776222101,56776222106,5,2124,1139,-30
56781670114,56781670120,6,2365,1701,-30
56782068902,56782068905,3,2090,1057,-30
56782210102,56782210106,4,2220,1354,-30
56782338459,56782338465,6,3192,1737,-30
56782425126,56782425132,6,2363,1279,-30
56784514174,56784514183,9,2443,1002,-30
56786647017,56786647021,4,2253,996,-30
56788939161,56788939166,5,2152,1562,-30
56791855591,56791855590,-1,2075,4323,-30
56793084094,56793084094,0,1889,1610,-30
56795971917,56795971922,5,2437,1636,-30
56796864391,56796864398,7,2200,2038,-30
56798498501,56798498483,-18,152,1574,-30
56799193765,56799193770,5,2298,1435,-30
56806517153,56806517157,4,2307,1331,-30
56808381221,56808381226,5,2716,1708,-30
56808701518,56808701512,-6,1043,3191,-30
56810394136,56810394130,-6,729,5326,-30
56812034038,56812034045,7,2430,971,-30
56813720524,56813720517,-7,1235,1436,-30
56814523133,56814523138,5,6198,2404,-30
56815872725,56815872709,-16,166,1043,-30
56816418954,56816418947,-7,936,1297,-30
56816806338,56816806334,-4,1458,1049,-30
56818133590,56818133595,5,2023,1244,-30
56818926318,56818926324,6,1968,1204,-30
56819625980,56819625995,15,2343,792,-30
56819679785,56819679788,3,1579,1322,-30
56820730520,56820730525,5,2968,1632,-30
56821766757,56821766762,5,2704,1538,-30
56824355018,56824355023,5,2321,1642,-30
56826046450,56826046455,5,2039,1509,-30
56826369801,56826369802,1,2251,3453,-30
56826800198,56826800208,10,1590,876,-30
56827532758,56827532761,3,1942,1467,-30
56827852828,56827852830,2,1531,1203,-30
56828637181,56828637186,5,2773,1322,-30
56831099413,56831099419,6,2021,1165,-30
56831201943,56831201920,-23,2863,1507,-30
56831815525,56831815529,4,1818,1452,-30
56836504110,56836504114,4,1877,1243,-30
56841056438,56841056442,4,2157,1050,-30
56841699539,56841699521,-18,1528,1199,-30
56850386118,56850386126,8,1795,1497,-30
56851856670,56851856675,5,858,1083,-30
56855523372,56855523378,6,2224,1122,-30
56862725625,56862725631,6,2509,1492,-30
56866896362,56866896367,5,2695,1031,-30
56875085826,56875085831,5,1715,1082,-30
56877662746,56877662751,5,2373,1594,-30
56877703680,56877703682,2,2090,1694,-30
56879120614,56879120618,4,1402,844,-30
56879270274,56879270257,-17,2119,1191,-30
56882099721,56882099729,8,11472,1810,-30
56882772178,56882772185,7,1908,1326,-30
56882888290,56882888274,-16,2444,1257,-30
56883672222,56883672227,5,1511,1142,-30
56885705330,56885705336,6,3235,1363,-30
56887211946,56887211952,6,2823,1738,-30
56887557420,56887557416,-4,1092,2433,-30
56888327892,56888327897,5,2385,1096,-30
56888630915,56888630898,-17,1340,751,-30
56893151341,56893151359,18,971,1967,-30
56893207080,56893207085,5,2192,1882,-30
56893345741,56893345745,4,3239,1592,-30
56893936972,56893936978,6,1801,1219,-30
56894409928,56894409934,6,1929,1166,-30
56894947982,56894947986,4,2159,1168,-30
56895107458,56895107465,7,2607,1156,-30
56904604326,56904604334,8,2360,569,-30
56905944818,56905944822,4,2847,1633,-30
56906996906,56906996909,3,2184,1460,-30
56914550757,56914550761,4,2570,1515,-30
56922575910,56922575914,4,2317,1075,-30
56922756866,56922756850,-16,1751,1226,-30
56924373330,56924373335,5,1279,1118,-30
56928801171,56928801177,6,1296,1109,-30
56932555425,56932555431,6,4004,1589,-30
56934304535,56934304524,-11,762,275,-30
56936145714,56936145721,7,2111,1075,-30
56936485914,56936485919,5,2484,892,-30
56939586246,56939586252,6,2243,1253,-30
56942270250,56942270255,5,1923,575,-30
56943091058,56943091063,5,1857,1396,-30
56945992108,56945992110,2,2355,1322,-30
56946873758,56946873765,7,2063,2261,-30
56951165877,56951165883,6,2975,1184,-30
56951961054,56951961062,8,3477,956,-30
56953329688,56953329691,3,1318,1157,-30
56953551918,56953551912,-6,1353,5253,-30
56954889880,56954889883,3,2885,1375,-30
56955772945,56955772951,6,1950,1258,-30
56955986957,56955986961,4,2741,1673,-30
56963192146,56963192151,5,2499,1506,-30
56963258323,56963258326,3,2418,1543,-30
56963979630,56963979634,4,2012,761,-30
56964386390,56964386395,5,1704,1015,-30
56964585802,56964585808,6,2409,1117,-30
56964710099,56964710101,2,1284,1492,-30
56974075920,56974075925,5,2045,1265,-30
56980827442,56980827450,8,2306,1194,-30
56981455064,56981455068,4,2281,1315,-30
56984974427,56984974431,4,2414,1441,-30
56986457153,56986457158,5,2140,1315,-30
56986807290,56986807290,0,2676,2433,-30
56987274021,56987274026,5,2554,1940,-30
56990051834,56990051839,5,3075,1350,-30
56991724103,56991724107,4,2149,1299,-30
56996212400,56996212404,4,2297,1578,-30
57002413854,57002413859,5,1774,1174,-30
57006926770,57006926776,6,2614,1352,-30
57007034718,57007034704,-14,641,173,-30
57010911019,57010911025,6,2252,1336,-30
57011753307,57011753311,4,1469,1207,-30
57023474042,57023474046,4,2263,1422,-30
57028548974,57028548979,5,2441,980,-30
57033769503,57033769507,4,2097,1010,-30
57035075367,57035075369,2,2562,1779,-30
57035537939,57035537923,-16,996,412,-30
57036917587,57036917593,6,1444,1221,-30
57037818938,57037818943,5,3753,1788,-30
57041078630,57041078630,0,1397,2398,-30
57046114147,57046114151,4,1511,1008,-30
57048054125,57048054130,5,3553,1621,-30
57048986968,57048986974,6,2103,1300,-30
57051575551,57051575532,-19,1745,1162,-30
57055848840,57055848845,5,2123,1235,-30
57058930390,57058930390,0,1958,1420,-30
57060692737,57060692742,5,2897,1365,-30
57061235464,57061235469,5,2070,704,-30
57063101549,57063101553,4,2250,1403,-30
57065645114,57065645120,6,1850,1318,-30
57067107908,57067107914,6,1576,834,-30
57071501011,57071501018,7,2625,1134,-30
57072038195,57072038201,6,1921,1190,-30
57072666803,57072666785,-18,1360,767,-30
57074659378,57074659378,0,1297,1607,-30
57075324974,57075324981,7,2297,1047,-30
57077627965,57077627971,6,2005,1172,-30
57080210070,57080210074,4,2258,1722,-30
57086323521,57086323525,4,2337,1117,-30
57088517734,57088517739,5,1535,839,-30
57089989388,57089989373,-15,1927,525,-30
57095859301,57095859306,5,1663,982,-30
57095889572,57095889575,3,2413,1017,-30
57096130173,57096130178,5,1999,939,-30
57096736055,57096736058,3,1928,1056,-30
57099056009,57099056012,3,2109,1425,-30
57099723174,57099723179,5,2212,1610,-30
57100403578,57100403583,5,2436,1070,-30
57104235882,57104235886,4,1647,902,-30
57108573721,57108573726,5,2197,1387,-30
57108739325,57108739344,19,1381,1083,-30
57112419235,57112419239,4,1805,1134,-30
57113082180,57113082184,4,3139,1086,-30
57114452034,57114452038,4,1830,1291,-30
57118425469,57118425474,5,2004,1379,-30
57121833749,57121833750,1,1598,1860,-30
57122293829,57122293830,1,1278,1546,-30
57122819478,57122819474,-4,1195,3561,-30
57125009564,57125009570,6,10032,24884,-30
57127022579,57127022583,4,2773,1548,-30
57127841555,57127841562,7,2476,1062,-30
57131494237,57131494239,2,1032,722,-30
57131848053,57131848058,5,2207,1546,-30
57132411254,57132411258,4,2292,1322,-30
57136486202,57136486211,9,839,472,-30
57137540535,57137540539,4,2007,1102,-30
57139989400,57139989400,0,1762,1644,-30
57140210021,57140210023,2,2085,1481,-30
57141635369,57141635375,6,3008,1145,-30
57145168612,57145168615,3,1590,834,-30
57145305788,57145305791,3,2032,873,-30
57146657938,57146657943,5,1657,1024,-30
57148852311,57148852316,5,2056,975,-30
57149925663,57149925669,6,2909,1406,-30
57152905905,57152905911,6,2898,1209,-30
57153461205,57153461209,4,2653,1933,-30
57155761469,57155761473,4,2922,1755,-30
57157044154,57157044149,-5,708,3508,-30
57158165294,57158165301,7,1821,1284,-30
57161731388,57161731402,14,976,1748,-30
57167964287,57167964290,3,1035,1668,-30
57169451206,57169451210,4,2144,1187,-30
57177290355,57177290359,4,2118,1347,-30
57179267586,57179267592,6,2506,1283,-30
57187496722,57187496727,5,2438,1528,-30
57192891689,57192891697,8,2151,2002,-30
57195313158,57195313152,-6,1079,3704,-30
57198121196,57198121199,3,3957,2875,-30
57200003770,57200003776,6,2038,1436,-30
57200096720,57200096723,3,2192,2504,-30
57201468466,57201468471,5,2031,1143,-30
57201712203,57201712210,7,2365,1531,-30
57202132295,57202132301,6,3119,1459,-30
57207565714,57207565719,5,2139,1090,-30
57209286886,57209286891,5,2546,1090,-30
57210934440,57210934442,2,1622,1116,-30
57218018666,57218018672,6,1664,839,-30
57219795363,57219795368,5,1921,1222,-30
57221933390,57221933395,5,2713,1734,-30
57221974608,57221974613,5,2293,1458,-30
57222996995,57222997001,6,1893,1524,-30
57225593766,57225593771,5,3573,1258,-30
57225690630,57225690611,-19,2062,1714,-30
57225801285,57225801287,2,1371,1674,-30
57226458292,57226458294,2,1681,2208,-30
57227295169,57227295175,6,1101,756,-30
57228240342,57228240346,4,1264,978,-30
57230203029,57230203034,5,2177,1591,-30
57230404441,57230404441,0,1585,744,-30
57232155926,57232155930,4,1516,1237,-30
57237400439,57237400416,-23,1084,2111,-30
57238315790,57238315795,5,2684,1373,-30
57241424671,57241424676,5,1564,1355,-30
57241627993,57241627979,-14,2525,1138,-30
57245912754,57245912761,7,2976,1383,-30
57246721903,57246721907,4,1702,1431,-30
57247095578,57247095562,-16,1208,1168,-30
57247780899,57247780903,4,2433,1725,-30
57249463991,57249463997,6,2690,1490,-30
57256547732,57256547736,4,2597,1564,-30
57257140950,57257140954,4,2758,1291,-30
57259203874,57259203879,5,2037,1125,-30
57263433715,57263433710,-5,1485,5417,-30
57263587621,57263587619,-2,1117,1611,-30
57263659551,57263659557,6,2159,1781,-30
57263893193,57263893193,0,1824,2658,-30
57264092783,57264092789,6,2217,1243,-30
57264669278,57264669283,5,1678,1009,-30
57265327681,57265327685,4,1738,1260,-30
57267396631,57267396635,4,2042,1311,-30
57268523881,57268523866,-15,497,652,-30
57270622903,57270622907,4,1927,1252,-30
57271290725,57271290730,5,2164,1060,-30
57276196523,57276196526,3,1650,1310,-30
57277106642,57277106646,4,3465,1490,-30
57278197703,57278197709,6,1990,2026,-30
57279373917,57279373923,6,1989,1159,-30
57280085685,57280085685,0,1154,1431,-30
57280889433,57280889439,6,2228,1152,-30
57284126176,57284126182,6,2087,1196,-30
57285448036,57285448028,-8,759,452,-30
57286909432,57286909436,4,2562,1484,-30
57286997074,57286997077,3,2004,1355,-30
57288055365,57288055371,6,2065,1236,-30
57294047862,57294047867,5,1116,744,-30
57296236468,57296236473,5,2142,1089,-30
57305898986,57305898986,0,1545,2237,-30
57307263349,57307263350,1,1835,1312,-30
57311474565,57311474559,-6,21574,12000,-30
57312022099,57312022103,4,2631,1309,-30
57312877843,57312877850,7,2115,1354,-30
57317438413,57317438417,4,2512,2080,-30
57318330080,57318330086,6,1903,1104,-30
57320942287,57320942293,6,2448,1300,-30
57323517812,57323517816,4,2431,1253,-30
57324169486,57324169490,4,2401,1293,-30
57324473366,57324473373,7,4150,1567,-30
57333967274,57333967281,7,1531,867,-30
57334601860,57334601866,6,2347,1066,-30
57334663526,57334663530,4,2025,1323,-30
57334860399,57334860402,3,1649,1358,-30
57341135065,57341135070,5,2290,1433,-30
57341178929,57341178934,5,2730,1166,-30
57341810513,57341810517,4,1603,1319,-30
57343902153,57343902158,5,3448,1463,-30
57345721170,57345721174,4,2670,1055,-30
57345948362,57345948365,3,991,1436,-30
57347846933,57347846933,0,1637,2062,-30
57349770879,57349770896,17,1071,531,-30
57354482201,57354482204,3,2099,1690,-30
57355027410,57355027401,-9,1238,3326,-30
57362502042,57362502047,5,2278,1545,-30
57362944069,57362944050,-19,697,116,-30
57363463167,57363463166,-1,629,1354,-30
57364088238,57364088258,20,398,122,-30
57364151807,57364151785,-22,1152,546,-30
57364475437,57364475443,6,2345,1610,-30
57367746629,57367746634,5,2476,2177,-30
57369406948,57369406953,5,3126,1659,-30
57370378742,57370378746,4,2187,917,-30
57370610446,57370610450,4,1747,1352,-30
57375468770,57375468772,2,3323,3792,-30
57376665490,57376665495,5,3017,1732,-30
57376734618,57376734622,4,1888,1085,-30
57383081669,57383081676,7,2139,1073,-30
57383214697,57383214702,5,2195,1008,-30
57383927308,57383927314,6,2512,1718,-30
57386212480,57386212485,5,1938,2236,-30
57386875142,57386875148,6,3579,1885,-30
57387823577,57387823583,6,1794,1227,-30
57389753422,57389753429,7,2680,1286,-30
57390987876,57390987881,5,2241,1328,-30
57392849250,57392849251,1,1914,1509,-30
57392914018,57392914025,7,2052,1240,-30
57394797265,57394797268,3,1894,1496,-30
57394943983,57394943990,7,2454,1402,-30
57395777119,57395777100,-19,2138,1363,-30
57396297862,57396297843,-19,1796,1121,-30
57397172221,57397172227,6,2213,978,-30
57399815664,57399815667,3,1589,1485,-30
57400123593,57400123586,-7,124,4068,-30
57404542414,57404542418,4,2189,1363,-30
57406474481,57406474487,6,5096,1091,-30
57408263917,57408263922,5,1763,1383,-30
57410985955,57410985957,2,26262,20381,-30
57412549608,57412549615,7,1809,523,-30
57414825090,57414825092,2,1991,1631,-30
57420888718,57420888723,5,2586,1527,-30
57422719294,57422719298,4,2401,1727,-30
57423436833,57423436837,4,1787,1347,-30
57424297093,57424297099,6,2875,1144,-30
57431365013,57431365019,6,2126,1637,-30
57435093557,57435093560,3,1860,1722,-30
57435271902,57435271906,4,1768,1254,-30
57436072685,57436072690,5,2124,1125,-30
57438350676,57438350680,4,1795,1233,-30
57441390773,57441390778,5,1609,847,-30
57442856646,57442856651,5,2648,1502,-30
57444133970,57444133952,-18,3296,1683,-30
57444826503,57444826500,-3,1050,2242,-30
57446401838,57446401842,4,1422,1362,-30
57446924378,57446924384,6,2496,1224,-30
57447436022,57447436026,4,2160,1025,-30
57451789006,57451789011,5,3337,1761,-30
57454823731,57454823734,3,1368,1565,-30
57457157354,57457157360,6,2715,1503,-30
57457993686,57457993692,6,2885,1656,-30
57470669716,57470669722,6,3187,1583,-30
57470883607,57470883613,6,3339,1803,-30
57470909321,57470909326,5,3235,1498,-30
57474182134,57474182139,5,4127,2171,-30
57474976888,57474976889,1,1572,1372,-30
57477696046,57477696042,-4,1631,3268,-30
57481246687,57481246688,1,1441,1280,-30
57482556171,57482556170,-1,973,1450,-30
57486910363,57486910367,4,2647,941,-30
57492489087,57492489084,-3,1150,3234,-30
57494721229,57494721235,6,1708,1180,-30
57494997698,57494997703,5,2477,1203,-30
57495548668,57495548673,5,2258,1929,-30
57497408053,57497408054,1,1598,1363,-30
57499397543,57499397549,6,2052,1451,-30
57499825426,57499825431,5,3691,1972,-30
57499863757,57499863762,5,1933,1393,-30
57502893501,57502893506,5,4633,1500,-30
57507380844,57507380847,3,2192,1300,-30
57507477164,57507477163,-1,1807,1749,-30
57509265358,57509265349,-9,40728,15531,-30
57509922431,57509922437,6,3537,1862,-30
57510316201,57510316205,4,2764,1516,-30
57514237294,57514237300,6,2305,1120,-30
57514279893,57514279898,5,2798,1981,-30
57517411129,57517411134,5,1807,1342,-30
57521201827,57521201833,6,1596,1505,-30
57531589954,57531589954,0,1591,1191,-30
57535352346,57535352350,4,2319,1119,-30
57537918247,57537918252,5,2832,1162,-30
57540101217,57540101222,5,2572,1006,-30
57545421846,57545421847,1,1417,1404,-30
57550356362,57550356367,5,1151,499,-30
57557689867,57557689871,4,2448,1926,-30
57561749515,57561749522,7,1235,487,-30
57565954642,57565954647,5,2356,1248,-30
57566202899,57566202904,5,2194,1144,-30
57567028081,57567028086,5,1675,778,-30
57568606314,57568606309,-5,1756,3323,-30
57570853429,57570853434,5,2598,1306,-30
57573030169,57573030173,4,38310,34362,-30
57575197434,57575197438,4,2325,1622,-30
57582380533,57582380529,-4,860,1569,-30
57584757397,57584757403,6,1615,837,-30
57585558758,57585558762,4,1836,1034,-30
57586672174,57586672178,4,1281,1063,-30
57589293973,57589293978,5,1759,1214,-30
57589579887,57589579891,4,1868,1317,-30
57592452015,57592452019,4,3029,1481,-30
57595503166,57595503168,2,1444,1191,-30
57604506462,57604506462,0,673,1072,-30
57607796070,57607796076,6,1905,929,-30
57610833114,57610833117,3,2352,1863,-30
57611552194,57611552200,6,2480,1302,-30
57612595224,57612595228,4,2681,1194,-30
57613871770,57613871772,2,1552,1401,-30
57614063333,57614063312,-21,2029,998,-30
57621306679,57621306685,6,2320,1606,-30
57624244950,57624244953,3,1331,894,-30
57630999521,57630999527,6,1910,1246,-30
57633444226,57633444233,7,3820,1748,-30
57633974159,57633974164,5,3173,1894,-30
57634424438,57634424445,7,2196,975,-30
57635343019,57635343025,6,2769,1434,-30
57636348153,57636348157,4,1475,1032,-30
57641548006,57641548011,5,2019,1215,-30
57642525201,57642525205,4,2003,1259,-30
57642632578,57642632585,7,3229,1232,-30
57642660250,57642660257,7,527,209,-30
57645747410,57645747415,5,2585,1089,-30
57646598623,57646598622,-1,939,1183,-30
57646789043,57646789023,-20,41258,30660,-30
57654031735,57654031738,3,1884,1373,-30
57654128368,57654128384,16,2245,1333,-30
57655133873,57655133874,1,1244,1570,-30
57656640754,57656640754,0,1531,1748,-30
57657122965,57657122972,7,1841,1276,-30
57657149656,57657149632,-24,3173,2597,-30
57657690210,57657690217,7,1942,1235,-30
57658124423,57658124429,6,2574,1446,-30
57668466849,57668466855,6,1721,1135,-30
57669210138,57669210142,4,1848,1269,-30
57669867934,57669867940,6,3277,1100,-30
57670998043,57670998045,2,1674,1439,-30
57675974962,57675974967,5,2526,945,-30
57676898181,57676898187,6,2010,1385,-30
57681874538,57681874543,5,1760,1161,-30
57682582729,57682582733,4,2068,1263,-30
57683684650,57683684645,-5,1670,7328,-30
57686236423,57686236427,4,3011,1310,-30
57686408741,57686408722,-19,2232,1616,-30
57687445174,57687445181,7,3513,1704,-30
57688506723,57688506728,5,1302,1162,-30
57689010638,57689010643,5,2789,930,-30
57693383854,57693383862,8,2128,977,-30
57693723261,57693723244,-17,1803,1411,-30
57696428193,57696428198,5,3069,850,-30
57696830321,57696830326,5,2611,2002,-30
57698800366,57698800371,5,2134,930,-30
57702117929,57702117932,3,2110,1750,-30
57704533130,57704533133,3,3791,3294,-30
57708308260,57708308265,5,2276,1356,-30
57708783921,57708783927,6,2341,1112,-30
57710229130,57710229135,5,2265,1020,-30
57716715069,57716715074,5,2557,1355,-30
57718295828,57718295834,6,1789,949,-30
57718586613,57718586618,5,1751,990,-30
57719802842,57719802849,7,1644,1198,-30
57720087198,57720087179,-19,2211,979,-30
57721170385,57721170389,4,2799,1955,-30
57722448130,57722448129,-1,1188,1921,-30
57723537086,57723537091,5,3049,1530,-30
57728438442,57728438436,-6,1299,3659,-30
57731351401,57731351407,6,2526,1526,-30
57732739802,57732739802,0,1568,1456,-30
57733223215,57733223206,-9,26116,14400,-30
57739902370,57739902375,5,1650,1137,-30
57740498215,57740498220,5,1755,1438,-30
57741032983,57741032987,4,1653,869,-30
57747711929,57747711933,4,1405,1581,-30
57751701654,57751701661,7,3347,1226,-30
57753943747,57753943752,5,2604,1221,-30
57754839832,57754839836,4,2658,1020,-30
57758371658,57758371661,3,1652,840,-30
57765057182,57765057189,7,3076,1354,-30
57765325750,57765325771,21,848,162,-30
57765681650,57765681654,4,2631,1988,-30
57769057255,57769057258,3,2784,1409,-30
57769361811,57769361796,-15,1150,676,-30
57774561489,57774561484,-5,25024,19360,-30
57775179414,57775179427,13,38,2322,-30
57775557694,57775557699,5,1334,1168,-30
57776556403,57776556409,6,1529,746,-30
57782703627,57782703631,4,3601,1744,-30
57783731036,57783731042,6,2324,1046,-30
57784075703,57784075690,-13,1501,1852,-30
57787253973,57787253978,5,2619,975,-30
57795661320,57795661326,6,2103,1485,-30
57796173546,57796173547,1,1111,1303,-30
57798669994,57798669998,4,3411,1717,-30
57799016898,57799016903,5,2224,1237,-30
57803488366,57803488369,3,1231,965,-30
57806289598,57806289603,5,2673,1100,-30
57808533094,57808533098,4,2481,1449,-30
57808941468,57808941471,3,2310,893,-30
57810499770,57810499776,6,3009,1401,-30
57813677346,57813677353,7,1744,998,-30
57815864826,57815864831,5,2637,1254,-30
57816851386,57816851389,3,1884,977,-30
57817613874,57817613874,0,2100,2897,-30
57820533195,57820533195,0,1855,2814,-30
57825076797,57825076802,5,2002,1265,-30
57832272018,57832272023,5,2250,1516,-30
57838583772,57838583777,5,1740,1454,-30
57840400730,57840400730,0,2620,4069,-30
57840487503,57840487507,4,2399,1474,-30
57843644803,57843644807,4,1548,876,-30
57846179701,57846179706,5,2473,1155,-30
57847801543,57847801547,4,2143,1106,-30
57850762112,57850762117,5,2668,1399,-30
57851738913,57851738919,6,2586,1419,-30
57853635673,57853635678,5,2236,1409,-30
57853964421,57853964400,-21,2526,1485,-30
57857537966,57857537967,1,1861,1701,-30
57858870989,57858871006,17,2089,1314,-30
57858949505,57858949510,5,2075,1191,-30
57865206428,57865206427,-1,3443,43465,-30
57865635705,57865635710,5,2292,1440,-30
57866441697,57866441703,6,1675,1449,-30
57867320827,57867320825,-2,1630,2635,-30
57867904233,57867904238,5,1480,590,-30
57871272380,57871272385,5,2222,1386,-30
57871685485,57871685496,11,1756,1180,-30
57871836354,57871836339,-15,2738,1604,-30
57872093564,57872093569,5,2062,1229,-30
57873794136,57873794141,5,2259,1173,-30
57879299249,57879299254,5,1907,982,-30
57882019812,57882019818,6,2033,1266,-30
57883115186,57883115191,5,2269,1255,-30
57886796001,57886796006,5,1920,1476,-30
57887360035,57887360038,3,1613,877,-30
57888151222,57888151240,18,1775,1281,-30
57892240249,57892240254,5,1461,1006,-30
57895149880,57895149885,5,2223,1657,-30
57895380002,57895380007,5,1661,1698,-30
57900291948,57900291954,6,2684,1288,-30
57900434123,57900434104,-19,1660,587,-30
57900568342,57900568348,6,2537,1187,-30
57900967001,57900967006,5,3154,1396,-30
57901912959,57901912964,5,2191,1292,-30
57907621403,57907621407,4,2097,1144,-30
57910471039,57910471041,2,5664,5947,-30
57916898513,57916898506,-7,1399,8109,-30
57917909177,57917909182,5,1509,1099,-30
57918961605,57918961604,-1,821,1790,-30
57919829946,57919829951,5,3198,1510,-30
57920855077,57920855064,-13,30871,14755,-30
57923141337,57923141339,2,1987,1537,-30
57924227151,57924227155,4,1808,1479,-30
57929974347,57929974350,3,1875,1091,-30
57930675279,57930675283,4,2343,1509,-30
57931399570,57931399575,5,2021,1401,-30
57932556041,57932556046,5,1542,1103,-30
57933938135,57933938130,-5,1296,4287,-30
57934867758,57934867763,5,2448,1562,-30
57935108417,57935108421,4,1556,1174,-30
57936287757,57936287762,5,2006,1164,-30
57936492953,57936492959,6,1601,1036,-30
57937333483,57937333489,6,1975,1061,-30
57940398809,57940398813,4,2660,1549,-30
57943657531,57943657536,5,2819,1513,-30
57944516678,57944516668,-10,1707,431,-30
57945546572,57945546575,3,2489,1462,-30
57950256790,57950256791,1,2249,1355,-30
57952608699,57952608705,6,3222,1546,-30
57953644772,57953644777,5,2084,1527,-30
57955704934,57955704939,5,1754,1442,-30
57958547212,57958547218,6,1507,870,-30
57961016626,57961016625,-1,8660,14139,-30
57962698154,57962698158,4,2128,1276,-30
57962935580,57962935586,6,2467,1199,-30
57963469505,57963469509,4,2379,1509,-30
57965360707,57965360714,7,7089,2882,-30
57965734195,57965734201,6,2569,1347,-30
57966676570,57966676575,5,2130,1338,-30
57969731106,57969731087,-19,1358,326,-30
57970169870,57970169872,2,2207,2254,-30
57972167839,57972167843,4,934,498,-30
57973715903,57973715902,-1,1031,1547,-30
57976804730,57976804735,5,2693,1274,-30
57977744417,57977744420,3,2539,1700,-30
57979319109,57979319117,8,4308,1777,-30
57982660602,57982660605,3,2637,1543,-30
57985067568,57985067573,5,2145,1472,-30
57987305119,57987305125,6,1553,1343,-30
57990302999,57990303006,7,2517,1318,-30
57993450226,57993450231,5,1875,1307,-30
57993563818,57993563822,4,2181,1411,-30
57994447618,57994447622,4,3036,1597,-30
57995151955,57995151958,3,2191,2019,-30
57995301290,57995301295,5,2532,1316,-30
57996553797,57996553800,3,2085,996,-30
57996706587,57996706593,6,2424,1011,-30
57996760994,57996761000,6,2197,1179,-30
57997671017,57997671022,5,2593,1095,-30
58002800366,58002800374,8,3125,1839,-30
58003810149,58003810142,-7,870,6508,-30
58006422728,58006422734,6,1971,1539,-30
58007085066,58007085070,4,1755,1209,-30
58007716761,58007716767,6,1552,969,-30
58008755202,58008755208,6,6270,3033,-30
58011392223,58011392230,7,3196,1112,-30
58011803509,58011803514,5,2036,1488,-30
58011987374,58011987379,5,2199,1033,-30
58015757014,58015757011,-3,1020,2382,-30
58016172199,58016172205,6,2235,1568,-30
58016609242,58016609247,5,1831,1377,-30
58016807280,58016807284,4,1996,1068,-30
58016903319,58016903307,-12,798,279,-30
58017133530,58017133545,15,2260,1128,-30
58020173838,58020173845,7,4082,1103,-30
58032481980,58032481985,5,2057,1080,-30
58033798734,58033798739,5,2281,934,-30
58034406881,58034406886,5,2471,1203,-30
58034682031,58034682035,4,2885,1511,-30
58039719782,58039719786,4,2329,1527,-30
58040745043,58040745049,6,2823,1588,-30
58042475426,58042475430,4,2279,1110,-30
58045098300,58045098302,2,1804,1166,-30
58045893593,58045893599,6,2486,1626,-30
58048932670,58048932675,5,2668,1282,-30
58052824542,58052824547,5,2347,1391,-30
58053358926,58053358906,-20,2161,988,-30
58054370529,58054370535,6,2589,1152,-30
58056438538,58056438543,5,2091,1017,-30
58056464926,58056464933,7,2659,1886,-30
58056531267,58056531274,7,2535,1581,-30
58057782394,58057782400,6,3499,1742,-30
58059650273,58059650280,7,2716,1406,-30
58060382655,58060382654,-1,2997,5112,-30
58062153657,58062153662,5,1333,833,-30
58064052970,58064052977,7,2587,1335,-30
58064117121,58064117131,10,2183,1447,-30
58064463465,58064463475,10,1650,1165,-30
58065085810,58065085816,6,2053,1071,-30
58073262927,58073262930,3,1892,1282,-30
58074860812,58074860817,5,1403,569,-30
58076110818,58076110823,5,3248,1739,-30
58077082581,58077082586,5,2378,1208,-30
58079488130,58079488133,3,1939,1440,-30
58080355018,58080355022,4,1953,1384,-30
58084051862,58084051865,3,2216,1734,-30
58088548335,58088548338,3,1119,978,-30
58089126870,58089126874,4,2180,1357,-30
58090747649,58090747654,5,2176,1248,-30
58095836374,58095836377,3,1418,1129,-30
58097437594,58097437599,5,3064,1488,-30
58098271338,58098271343,5,2246,1005,-30
58099197074,58099197079,5,1506,920,-30
58099866863,58099866843,-20,1960,574,-30
58101343059,58101343061,2,1665,1518,-30
58101748938,58101748942,4,2517,1420,-30
58107294777,58107294776,-1,1400,2351,-30
58108968411,58108968415,4,1928,1212,-30
58109051976,58109051983,7,3217,1383,-30
58115268329,58115268326,-3,801,2387,-30
58115404122,58115404139,17,521,224,-30
58116900664,58116900670,6,4186,1936,-30
58118446963,58118446969,6,2095,1025,-30
58120910607,58120910602,-5,874,2312,-30
58121050976,58121050966,-10,1228,9332,-30
58121801806,58121801811,5,2898,1784,-30
58122661127,58122661128,1,1520,1566,-30
58124128289,58124128294,5,2506,1636,-30
58124626339,58124626347,8,2011,1068,-30
58127265782,58127265787,5,2549,1354,-30
58129675681,58129675687,6,2831,1461,-30
58138708469,58138708473,4,1896,1322,-30
58139584574,58139584578,4,3060,1330,-30
58146988655,58146988661,6,2029,1293,-30
58148494489,58148494493,4,2217,1346,-30
58157172214,58157172220,6,2903,1322,-30
58158535374,58158535378,4,2091,1096,-30
58160141171,58160141174,3,1887,1426,-30
58160400213,58160400218,5,2525,1220,-30
58160445428,58160445408,-20,1431,1108,-30
58161518844,58161518847,3,3244,1884,-30
58162144660,58162144666,6,2266,1375,-30
58163099458,58163099462,4,2676,1332,-30
58164961977,58164961982,5,1386,1472,-30
58166138826,58166138828,2,1737,1306,-30
58167643239,58167643218,-21,875,700,-30
58171238669,58171238675,6,1654,1330,-30
58171590448,58171590454,6,2877,1768,-30
58171865227,58171865233,6,2662,1337,-30
58176049573,58176049576,3,5539,4633,-30
58177541094,58177541099,5,2388,1806,-30
58178829790,58178829796,6,11185,24344,-30
58180130329,58180130334,5,2629,1680,-30
58182745902,58182745918,16,16260,38872,-30
58183618633,58183618637,4,2371,1698,-30
58183859816,58183859823,7,2083,1044,-30
58186934339,58186934343,4,2645,1190,-30
58193740479,58193740486,7,1764,1208,-30
58195137611,58195137616,5,1932,1265,-30
58195261306,58195261288,-18,1288,797,-30
58198635961,58198635958,-3,1102,2669,-30
58199016182,58199016186,4,2797,1387,-30
58201900161,58201900167,6,1771,1397,-30
58203162410,58203162425,15,14684,50206,-30
58205017822,58205017826,4,2410,1071,-30
58205638717,58205638722,5,2629,1464,-30
58206795848,58206795849,1,17214,7353,-30
58206829054,58206829058,4,1984,1455,-30
58209350858,58209350864,6,1933,1329,-30
58209938502,58209938506,4,1905,1581,-30
58212257016,58212257023,7,3063,1271,-30
58221017541,58221017546,5,1583,955,-30
58221199358,58221199365,7,18356,46519,-30
58226239006,58226239014,8,2809,1509,-30
58227988571,58227988575,4,2294,1384,-30
58229227449,58229227454,5,1632,1048,-30
58231002487,58231002489,2,1610,1714,-30
58231182526,58231182533,7,1834,1363,-30
58232707454,58232707459,5,2787,2150,-30
58233293903,58233293881,-22,1734,831,-30
58238034016,58238034020,4,1415,1081,-30
58239596079,58239596084,5,2266,1426,-30
58239781490,58239781495,5,2208,1685,-30
58241163316,58241163321,5,1748,1278,-30
58243853671,58243853671,0,42008,47164,-30
58244582655,58244582659,4,1566,1046,-30
58246119346,58246119350,4,2923,1536,-30
58246629306,58246629311,5,2297,879,-30
58250827906,58250827910,4,2405,1561,-30
58254935323,58254935325,2,3129,2651,-30
58257245745,58257245731,-14,2083,1175,-30
58258291921,58258291926,5,1679,1601,-30
58260048789,58260048794,5,1760,1497,-30
58263246245,58263246249,4,1591,1510,-30
58264455178,58264455184,6,2750,1453,-30
58267392235,58267392242,7,2938,1441,-30
58268178351,58268178357,6,2588,1092,-30
58268540636,58268540642,6,1683,1001,-30
58270194478,58270194482,4,2228,1191,-30
58271352937,58271352943,6,1946,1111,-30
58272210489,58272210494,5,2417,1671,-30
58274644006,58274644011,5,1995,1572,-30
58275932418,58275932418,0,2334,2477,-30
58276026342,58276026348,6,2568,1650,-30
58277681381,58277681387,6,2523,1097,-30
58282983874,58282983879,5,1024,1040,-30
58285673598,58285673605,7,2757,1874,-30
58287861706,58287861711,5,2153,1075,-30
58294821750,58294821767,17,143,846,-30
58295951558,58295951566,8,10280,20047,-30
58296456365,58296456365,0,9290,13648,-30
58297516265,58297516269,4,2334,1573,-30
58298911531,58298911537,6,2691,1280,-30
58301260197,58301260194,-3,3058,6431,-30
58303586349,58303586342,-7,841,784,-30
58304628998,58304629005,7,1468,1028,-30
58305403114,58305403119,5,1128,724,-30
58311081695,58311081697,2,2234,1408,-30
58312174411,58312174418,7,2791,1346,-30
58314315219,58314315225,6,1944,1367,-30
58318042053,58318042058,5,3007,1589,-30
58318736069,58318736075,6,1465,744,-30
58318769045,58318769051,6,3031,1872,-30
58319615429,58319615434,5,1852,1205,-30
58320759194,58320759201,7,2352,1373,-30
58321620013,58321620018,5,1974,1145,-30
58322265846,58322265850,4,1977,1106,-30
58322515921,58322515906,-15,658,421,-30
58323897998,58323898003,5,2292,1154,-30
58327747690,58327747694,4,3165,1501,-30
58329280245,58329280249,4,1923,1171,-30
58335913594,58335913587,-7,777,2556,-30
58336460885,58336460890,5,1388,1507,-30
58336579169,58336579187,18,1640,986,-30
58336669983,58336669987,4,2167,1528,-30
58340175170,58340175174,4,2070,1691,-30
58341888317,58341888321,4,1562,973,-30
58345330770,58345330775,5,2433,1243,-30
58345904310,58345904313,3,2478,1711,-30
58348824934,58348824939,5,2883,1807,-30
58348875399,58348875405,6,2717,1438,-30
58349066362,58349066368,6,1571,841,-30
58349545767,58349545773,6,2688,1186,-30
58351745638,58351745643,5,1705,1592,-30
58355375262,58355375266,4,2116,901,-30
58357045564,58357045560,-4,795,2012,-30
58359446550,58359446555,5,1853,1283,-30
58359956193,58359956197,4,2581,1198,-30
58361098546,58361098546,0,1117,2152,-30
58363719648,58363719670,22,3027,1045,-30
58365400091,58365400091,0,959,1561,-30
58366012450,58366012455,5,1208,1387,-30
58367175291,58367175296,5,1235,1116,-30
58367766112,58367766117,5,3574,2050,-30
58367930524,58367930527,3,1598,1730,-30
58371372260,58371372265,5,2464,1386,-30
58372135784,58372135788,4,2367,2004,-30
58378084620,58378084627,7,2196,1192,-30
58378116858,58378116863,5,1591,1417,-30
58378277602,58378277600,-2,1099,2622,-30
58385690406,58385690411,5,3946,1143,-30
58391398526,58391398527,1,1404,1561,-30
58393512951,58393512955,4,945,859,-30
58398439629,58398439634,5,2714,1535,-30
58398561926,58398561930,4,1837,1631,-30
58401253933,58401253938,5,2948,1556,-30
58403095766,58403095771,5,2089,1001,-30
58403200526,58403200530,4,1984,1310,-30
58403269693,58403269674,-19,2076,839,-30
58403884175,58403884182,7,3544,1768,-30
58409075353,58409075357,4,1477,1038,-30
58409965782,58409965787,5,2904,1271,-30
58410421590,58410421597,7,1947,1429,-30
58413052935,58413052939,4,1913,1085,-30
58417034802,58417034810,8,6251,1915,-30
58418779020,58418779015,-5,66072,81393,-30
58422103339,58422103346,7,2324,961,-30
58422238194,58422238200,6,2660,1292,-30
58428037521,58428037526,5,1834,1203,-30
58432551758,58432551762,4,1365,812,-30
58433188651,58433188670,19,701,1909,-30
58434794461,58434794465,4,2451,1346,-30
58437169834,58437169840,6,1816,1063,-30
58438719317,58438719323,6,1962,1278,-30
58441694860,58441694865,5,2885,1489,-30
58446631915,58446631922,7,2144,1429,-30
58447863131,58447863136,5,1894,1378,-30
58450040078,58450040083,5,2205,1358,-30
58451378541,58451378542,1,1438,1678,-30
58454593220,58454593226,6,2166,1368,-30
58461910823,58461910826,3,1706,1705,-30
58463137367,58463137373,6,1824,978,-30
58468888849,58468888854,5,2039,742,-30
58469403672,58469403677,5,2526,1533,-30
58470661383,58470661387,4,1121,884,-30
58473428424,58473428428,4,2385,1010,-30
58474680938,58474680945,7,4883,1639,-30
58476349556,58476349559,3,1434,941,-30
58479812542,58479812541,-1,1055,2903,-30
58482578685,58482578690,5,2592,1806,-30
58488024826,58488024831,5,2327,1383,-30
58488309006,58488309010,4,2101,1435,-30
58490122425,58490122430,5,2163,1063,-30
58493171557,58493171563,6,2759,1304,-30
58495763082,58495763088,6,1126,1030,-30
58496061537,58496061530,-7,1698,5047,-30
58497060175,58497060182,7,2604,821,-30
58497877195,58497877199,4,1283,711,-30
58499468606,58499468606,0,1454,2030,-30
58500304413,58500304419,6,2980,1098,-30
58502172472,58502172477,5,2558,1714,-30
58506945451,58506945455,4,2068,1607,-30
58508376862,58508376867,5,2008,1087,-30
58510246791,58510246794,3,2442,1402,-30
58510476595,58510476601,6,1164,800,-30
58511754633,58511754627,-6,1705,1120,-30
58513759749,58513759741,-8,1001,4838,-30
58515959072,58515959071,-1,1329,2168,-30
58519979651,58519979646,-5,958,3945,-30
58520767277,58520767283,6,2114,795,-30
58522004373,58522004379,6,2834,1184,-30
58523847597,58523847602,5,2434,1862,-30
58527447201,58527447207,6,2671,1540,-30
58527939186,58527939190,4,2271,1444,-30
58530874306,58530874311,5,2201,1235,-30
58531019145,58531019153,8,2775,985,-30
58531966031,58531966038,7,3034,1449,-30
58534043897,58534043893,-4,1693,3310,-30
58538961865,58538961871,6,2261,1557,-30
58543553025,58543553030,5,1750,1085,-30
58546475167,58546475176,9,5730,1985,-30
58547300266,58547300282,16,14423,21899,-30
58549838248,58549838254,6,2959,1463,-30
58554408077,58554408083,6,2219,1520,-30
58554821162,58554821168,6,1863,1454,-30
58555433038,58555433049,11,2721,1175,-30
58556913206,58556913211,5,3489,1473,-30
58557006825,58557006830,5,1636,1459,-30
58561215174,58561215179,5,2774,1482,-30
58564076703,58564076708,5,1129,712,-30
58566823059,58566823062,3,3017,1177,-30
58570100943,58570100947,4,3048,1934,-30
58572070556,58572070563,7,3002,1177,-30
58572727078,58572727082,4,1170,603,-30
58575263698,58575263705,7,5157,1301,-30
58576365698,58576365705,7,2719,1186,-30
58579359825,58579359829,4,1780,1279,-30
58579783909,58579783906,-3,1146,1994,-30
58579827914,58579827919,5,2381,1363,-30
58582426892,58582426896,4,2248,1525,-30
58596778700,58596778705,5,4166,2106,-30
58597547281,58597547286,5,1221,1164,-30
58598028131,58598028138,7,1809,1121,-30
58599765158,58599765158,0,3399,3356,-30
58603646374,58603646379,5,2272,1382,-30
58604323650,58604323655,5,9903,5544,-30
58606009040,58606009045,5,1520,1190,-30
58607150647,58607150653,6,3178,1909,-30
58610192410,58610192411,1,1121,714,-30
58611828769,58611828770,1,1449,1525,-30
58614298563,58614298566,3,2649,1363,-30
58619079139,58619079128,-11,48,1130,-30
58619589501,58619589506,5,1828,1121,-30
58626022255,58626022260,5,1151,1034,-30
58628297587,58628297592,5,2350,1314,-30
58631488415,58631488419,4,2656,1387,-30
58632509847,58632509853,6,2414,1159,-30
58634838742,58634838747,5,1884,1185,-30
58635977298,58635977303,5,1504,973,-30
58639014058,58639014061,3,1430,1323,-30
58639137614,58639137621,7,2289,1277,-30
58639674273,58639674280,7,1890,1407,-30
58644065415,58644065422,7,3560,1271,-30
58645522970,58645522975,5,1330,1454,-30
58650606108,58650606114,6,1602,935,-30
58651142268,58651142273,5,2896,1271,-30
58663324690,58663324696,6,2714,2017,-30
58664901601,58664901606,5,1689,1185,-30
58666033139,58666033135,-4,1376,2230,-30
58666192625,58666192619,-6,1888,9065,-30
58669098583,58669098588,5,2675,1533,-30
58669677537,58669677541,4,3600,1442,-30
58670677324,58670677329,5,2719,1183,-30
58673682232,58673682237,5,2305,1559,-30
58674209779,58674209785,6,3102,1670,-30
58674547417,58674547419,2,2066,1432,-30
58680856181,58680856187,6,2617,1478,-30
58681703599,58681703603,4,2139,1579,-30
58682249880,58682249885,5,2208,1319,-30
58684331631,58684331638,7,3147,1623,-30
58685767714,58685767723,9,3062,890,-30
58686023553,58686023537,-16,450,132,-30
58687373122,58687373125,3,2152,1038,-30
58688291774,58688291779,5,2924,1034,-30
58691277847,58691277849,2,1333,1405,-30
58692050819,58692050821,2,1502,1287,-30
58694952610,58694952592,-18,816,175,-30
58696476385,58696476389,4,1780,1743,-30
58699833006,58699833010,4,1766,948,-30
58700525806,58700525811,5,2349,1697,-30
58706590627,58706590633,6,2840,1626,-30
58706899413,58706899418,5,2093,1663,-30
58706958368,58706958373,5,2384,910,-30
58709895477,58709895483,6,3861,1743,-30
58711981164,58711981168,4,2177,2090,-30
58712072723,58712072729,6,9503,4562,-30
58719813029,58719813034,5,2664,1208,-30
58721206907,58721206911,4,2424,1574,-30
58721419902,58721419897,-5,2409,8414,-30
58722405480,58722405483,3,24727,20538,-30
58722493661,58722493665,4,2829,1629,-30
58726821305,58726821307,2,1468,894,-30
58726853410,58726853392,-18,2432,1600,-30
58731811935,58731811940,5,1748,1520,-30
58731947124,58731947129,5,2001,1302,-30
58733663270,58733663250,-20,2668,1373,-30
58736103462,58736103472,10,2211,990,-30
58739168977,58739168982,5,2262,1204,-30
58739437744,58739437752,8,2292,1423,-30
58741266751,58741266757,6,5094,1448,-30
58747703846,58747703850,4,2123,1124,-30
58750189897,58750189901,4,3081,1379,-30
58755904930,58755904935,5,2266,1365,-30
58757682346,58757682351,5,2106,1344,-30
58758766978,58758766981,3,6031,5246,-30
58764258926,58764258931,5,3078,1256,-30
58765423002,58765423008,6,5800,2506,-30
58770772225,58770772230,5,3265,1320,-30
58770995226,58770995230,4,1098,840,-30
58773582542,58773582547,5,2093,1739,-30
58774451143,58774451146,3,2350,1564,-30
58778312307,58778312314,7,2726,830,-30
58780537802,58780537807,5,2296,1593,-30
58781079666,58781079670,4,1870,1192,-30
58790045939,58790045945,6,1897,862,-30
58792767785,58792767789,4,1831,1443,-30
58795470084,58795470087,3,2874,1681,-30
58795547686,58795547675,-11,3238,1270,-30
58798873930,58798873934,4,1669,1110,-30
58803005302,58803005306,4,1638,1326,-30
58803726270,58803726276,6,2132,1332,-30
58804343894,58804343912,18,1616,675,-30
58804686184,58804686190,6,2003,996,-30
58806162949,58806162956,7,1937,1118,-30
58808740635,58808740640,5,2212,1130,-30
58811338988,58811338992,4,2334,1304,-30
58811490390,58811490397,7,1920,1102,-30
58814224335,58814224341,6,1222,653,-30
58819518070,58819518074,4,2996,1078,-30
58819729048,58819729054,6,2040,940,-30
58820420122,58820420126,4,1886,1023,-30
58825760385,58825760364,-21,1054,392,-30
58830091049,58830091054,5,1584,1042,-30
58836232618,58836232622,4,2447,1719,-30
58839372202,58839372206,4,2159,1503,-30
58840285785,58840285790,5,1465,791,-30
58840956550,58840956555,5,3094,1601,-30
58841084773,58841084779,6,2822,1573,-30
58841661598,58841661603,5,2348,933,-30
58848935608,58848935613,5,3482,1464,-30
58850197460,58850197466,6,2468,1281,-30
58850531442,58850531446,4,2376,1649,-30
58852118006,58852118011,5,2249,1274,-30
58852926553,58852926558,5,3852,1589,-30
58855136332,58855136336,4,2292,1021,-30
58855947064,58855947069,5,1909,975,-30
58856458217,58856458222,5,2099,1391,-30
58857322768,58857322771,3,2705,1211,-30
58858141630,58858141635,5,1854,1392,-30
58859327442,58859327447,5,2454,1638,-30
58860367458,58860367465,7,1746,890,-30
58867066564,58867066566,2,2055,1022,-30
58869743663,58869743669,6,3943,1909,-30
58870820579,58870820586,7,2614,1203,-30
58879806314,58879806318,4,1667,1051,-30
58881350218,58881350223,5,2186,1226,-30
58883535806,58883535790,-16,2149,1048,-30
58888353923,58888353928,5,1162,883,-30
58890231539,58890231542,3,1997,1123,-30
58890276159,58890276171,12,12512,33621,-30
58890556234,58890556240,6,2057,1517,-30
58891804686,58891804691,5,943,799,-30
58893066099,58893066089,-10,1060,1810,-30
58893978742,58893978747,5,2439,1239,-30
58895922778,58895922781,3,2298,1146,-30
58895985273,58895985266,-7,2131,2725,-30
58898316485,58898316490,5,1800,918,-30
58899810003,58899809987,-16,728,367,-30
58899835737,58899835753,16,1252,170,-30
58902647884,58902647891,7,3162,2031,-30
58903052079,58903052083,4,2298,1364,-30
58904494463,58904494471,8,3914,950,-30
58906397766,58906397771,5,2574,1612,-30
58908840451,58908840449,-2,50323,27137,-30
58910379374,58910379379,5,2573,1328,-30
58914581202,58914581197,-5,950,1490,-30
58917988036,58917988039,3,2730,1431,-30
58918664976,58918664982,6,2985,1544,-30
58922550051,58922550056,5,2826,1733,-30
58926523470,58926523474,4,3661,1433,-30
58929151708,58929151713,5,2806,1080,-30
58931414776,58931414782,6,2064,1008,-30
58934664844,58934664850,6,2555,1923,-30
58934714669,58934714671,2,1946,1398,-30
58935685193,58935685195,2,1418,1433,-30
58938918454,58938918459,5,1950,1337,-30
58939811882,58939811889,7,2382,1813,-30
58941396827,58941396824,-3,766,131,-30
58941646270,58941646275,5,2335,1245,-30
58945393253,58945393257,4,3256,1944,-30
58945427571,58945427574,3,2855,1380,-30
58947365725,58947365730,5,2354,1548,-30
58949862620,58949862623,3,1832,1239,-30
58950726445,58950726450,5,2334,1165,-30
58953331146,58953331149,3,2330,1258,-30
58955588303,58955588306,3,1849,1611,-30
58957505762,58957505770,8,2622,1257,-30
58959724297,58959724304,7,2510,1452,-30
58964906921,58964906926,5,1902,1131,-30
58965068030,58965068035,5,1883,1382,-30
58967201374,58967201374,0,1786,1257,-30
58978862654,58978862658,4,2760,1237,-30
58980616086,58980616091,5,1981,1211,-30
58982854009,58982854014,5,1919,936,-30
58984354838,58984354843,5,1929,753,-30
58987179024,58987179026,2,23385,22515,-30
58989665414,58989665418,4,2073,1304,-30
58989904494,58989904481,-13,729,77,-30
58991536637,58991536642,5,2196,1147,-30
58993518915,58993518921,6,3371,1900,-30
58994872826,58994872833,7,1916,990,-30
58996707724,58996707708,-16,1704,849,-30
58996977717,58996977722,5,2369,1185,-30
58998052992,58998052995,3,2022,1502,-30
59001283154,59001283158,4,1781,1536,-30
59001354781,59001354785,4,2317,1904,-30
59002030646,59002030651,5,2437,1375,-30
59002421237,59002421242,5,2579,1284,-30
59003449509,59003449514,5,1776,923,-30
59003663728,59003663715,-13,1214,636,-30
59008260564,59008260559,-5,1861,5810,-30
59008444619,59008444615,-4,1322,1527,-30
59011448950,59011448955,5,1907,1242,-30
59012930581,59012930586,5,2402,1312,-30
59014884849,59014884854,5,1514,1169,-30
59016924155,59016924161,6,2244,1282,-30
59018128687,59018128691,4,1809,1385,-30
59021555381,59021555385,4,2570,1281,-30
59028987030,59028987035,5,2097,1383,-30
59030809869,59030809874,5,2521,1063,-30
59032321732,59032321731,-1,59525,29010,-30
59035771859,59035771865,6,2863,1284,-30
59036724109,59036724113,4,2441,1306,-30
59038203218,59038203221,3,1588,1062,-30
59040046062,59040046067,5,4185,1809,-30
59042480913,59042480918,5,2222,901,-30
59043595087,59043595093,6,2078,1425,-30
59047375323,59047375329,6,1566,1275,-30
59049001265,59049001269,4,3655,2067,-30
59051403349,59051403354,5,3208,1832,-30
59051882034,59051882037,3,1464,919,-30
59052851110,59052851115,5,2495,1921,-30
59055334635,59055334642,7,2295,1010,-30
59057131699,59057131703,4,1890,1035,-30
59064019368,59064019372,4,2179,1408,-30
59064933334,59064933338,4,2102,1160,-30
59065882814,59065882800,-14,1682,923,-30
59065954341,59065954346,5,3432,1381,-30
59066722942,59066722938,-4,1252,2955,-30
59067425062,59067425066,4,2933,1961,-30
59071641697,59071641703,6,2144,1104,-30
59071787173,59071787178,5,2099,874,-30
59073972919,59073972924,5,1915,919,-30
59077706937,59077706943,6,2430,1317,-30
59082932825,59082932831,6,3430,1666,-30
59085152621,59085152627,6,3477,1160,-30
59087124820,59087124825,5,2997,1598,-30
59087671413,59087671417,4,1827,916,-30
59088661296,59088661299,3,2105,1247,-30
59089248409,59089248412,3,2297,1290,-30
59094318953,59094318960,7,8484,4790,-30
59094815644,59094815650,6,2135,1497,-30
59096071988,59096071994,6,2369,898,-30
59096461071,59096461070,-1,1374,1192,-30
59098659593,59098659597,4,2304,917,-30
59098957845,59098957850,5,2553,1258,-30
59099006559,59099006544,-15,1266,551,-30
59100577678,59100577682,4,2783,1192,-30
59104014892,59104014897,5,24224,30592,-30
59104415398,59104415401,3,1435,992,-30
59111707159,59111707165,6,2145,1300,-30
59112954510,59112954518,8,2045,1307,-30
59114010098,59114010103,5,1858,1268,-30
59114696005,59114696009,4,3056,1518,-30
59119906317,59119906310,-7,1425,7981,-30
59122648897,59122648905,8,2598,1343,-30
59125011751,59125011755,4,2715,1330,-30
59126957926,59126957930,4,2414,857,-30
59129636546,59129636550,4,2569,1331,-30
59131339082,59131339088,6,2219,1198,-30
59131696582,59131696586,4,2667,1126,-30
59143546373,59143546390,17,2703,1307,-30
59143580206,59143580210,4,3141,1554,-30
59145330170,59145330174,4,2574,1442,-30
59146260013,59146260018,5,2129,1413,-30
59146346914,59146346923,9,1594,1486,-30
59151155815,59151155819,4,1925,1208,-30
59153510758,59153510763,5,2112,770,-30
59155429040,59155429046,6,1858,1154,-30
59155458533,59155458538,5,2258,1126,-30
59155906344,59155906349,5,2452,1372,-30
59161431591,59161431596,5,2000,998,-30
59162409598,59162409602,4,2454,1024,-30
59162509000,59162509003,3,1722,1030,-30
59167223455,59167223459,4,2619,1521,-30
59168301869,59168301887,18,15861,28383,-30
59170545456,59170545459,3,2557,1778,-30
59171135254,59171135259,5,2861,1389,-30
59173065214,59173065217,3,2044,1251,-30
59173638177,59173638182,5,1443,960,-30
59175691576,59175691581,5,1973,1117,-30
59177820726,59177820731,5,2424,1150,-30
59179018532,59179018538,6,2026,644,-30
59181366794,59181366800,6,2059,1310,-30
59182479867,59182479874,7,1604,997,-30
59183810201,59183810206,5,1664,721,-30
59185477029,59185477035,6,1999,1113,-30
59191762543,59191762547,4,2216,1291,-30
59192953508,59192953513,5,1779,1431,-30
59199891195,59199891197,2,1367,1221,-30
59202673928,59202673932,4,2228,1383,-30
59204085827,59204085833,6,2673,1318,-30
59204161070,59204161075,5,1320,819,-30
59205068798,59205068780,-18,2321,966,-30
59206243497,59206243502,5,1727,1538,-30
59207272290,59207272294,4,1540,1123,-30
59212732353,59212732358,5,1514,772,-30
59213640365,59213640346,-19,2635,1363,-30
59215620911,59215620915,4,1537,737,-30
59219937367,59219937374,7,3603,1814,-30
59220707661,59220707666,5,2542,1496,-30
59220958347,59220958353,6,1580,902,-30
59221445466,59221445472,6,2566,1224,-30
59223704870,59223704874,4,2712,1568,-30
59224798042,59224798045,3,2508,1675,-30
59225005821,59225005827,6,2477,1216,-30
59227551297,59227551302,5,1291,871,-30
59228344221,59228344234,13,1142,1719,-30
59229883970,59229883974,4,3503,1510,-30
59232256377,59232256382,5,3209,1792,-30
59238741039,59238741045,6,3253,1548,-30
59240711997,59240711998,1,5965,5867,-30
59244582777,59244582783,6,2081,1105,-30
59247448911,59247448915,4,1930,1248,-30
59247639806,59247639787,-19,1190,1529,-30
59249487182,59249487186,4,1651,1183,-30
59251781814,59251781818,4,2065,1254,-30
59255448547,59255448552,5,1611,1661,-30
59259296632,59259296637,5,2821,1733,-30
59263051512,59263051526,14,1594,4750,-30
59264368684,59264368692,8,2335,1440,-30
59265813418,59265813426,8,2383,1165,-30
59266765713,59266765719,6,2436,1377,-30
59266931550,59266931532,-18,1166,542,-30
59271611441,59271611446,5,2532,1096,-30
59272689402,59272689410,8,2341,1363,-30
59272852842,59272852826,-16,2334,745,-30
59277245557,59277245563,6,2963,1255,-30
59281803978,59281803978,0,1641,1496,-30
59282710090,59282710099,9,1998,1473,-30
59283439049,59283439053,4,2246,1276,-30
59284956202,59284956207,5,2075,1184,-30
59284991347,59284991352,5,2506,1298,-30
59287291229,59287291234,5,1325,1042,-30
59287590277,59287590282,5,1857,1234,-30
59292815809,59292815814,5,2252,1219,-30
59293582927,59293582933,6,2393,1158,-30
59293837928,59293837934,6,2416,1741,-30
59296300802,59296300809,7,1717,863,-30
59300116419,59300116408,-11,545,110,-30
59301280686,59301280693,7,1551,1050,-30
59302570475,59302570480,5,2584,1351,-30
59303545941,59303545946,5,1907,1236,-30
59304908251,59304908257,6,2809,1545,-30
59305289603,59305289597,-6,1006,3984,-30
59305792329,59305792334,5,2944,1646,-30
59306129803,59306129806,3,1741,1094,-30
59309148910,59309148915,5,1561,685,-30
59309683054,59309683034,-20,1897,1616,-30
59312373542,59312373539,-3,1546,2975,-30
59312769934,59312769926,-8,1176,3319,-30
59315104030,59315104031,1,1339,1362,-30
59318633366,59318633371,5,2366,1382,-30
59320389183,59320389189,6,3198,1652,-30
59322607002,59322607007,5,2344,1518,-30
59325663393,59325663397,4,2184,1401,-30
59326386563,59326386568,5,2139,1304,-30
59328889482,59328889486,4,2085,825,-30
59332547030,59332547035,5,2365,1326,-30
59332573638,59332573642,4,1990,1406,-30
59334058957,59334058962,5,3089,966,-30
59334444505,59334444511,6,1564,884,-30
59336266185,59336266190,5,3311,1267,-30
59336401940,59336401955,15,3013,1128,-30
59338582593,59338582598,5,1302,934,-30
59341801778,59341801783,5,1367,769,-30
59342752506,59342752512,6,2052,984,-30
59343817393,59343817399,6,2264,1576,-30
59344141982,59344141987,5,2298,1346,-30
59344457085,59344457090,5,3207,1219,-30
59347371191,59347371194,3,2021,970,-30
59350380770,59350380775,5,2829,1906,-30
59353474659,59353474663,4,2239,1515,-30
59359708700,59359708706,6,2669,1493,-30
59360596057,59360596063,6,2837,1273,-30
59363653981,59363653985,4,2114,1522,-30
59366093761,59366093766,5,3618,1656,-30
59369182498,59369182505,7,13650,28794,-30
59371818145,59371818149,4,2065,1269,-30
59372245662,59372245666,4,1924,1216,-30
59375884226,59375884231,5,2224,1350,-30
59378288472,59378288480,8,2585,1027,-30
59379560162,59379560167,5,2751,1735,-30
59381087449,59381087455,6,1980,1127,-30
59383987807,59383987813,6,2417,1915,-30
59388872790,59388872797,7,2926,1867,-30
59389988843,59389988846,3,2432,1511,-30
59391370837,59391370841,4,2433,1740,-30
59391995251,59391995258,7,1969,994,-30
59393822877,59393822882,5,2639,1511,-30
59395861510,59395861515,5,1988,1007,-30
59399042005,59399042011,6,2554,1047,-30
59402015607,59402015610,3,2612,1495,-30
59402367537,59402367542,5,1794,1474,-30
59405799689,59405799694,5,2357,1027,-30
59407070091,59407070097,6,2425,1023,-30
59410425025,59410425031,6,1108,1094,-30
59412449421,59412449426,5,2577,1340,-30
59414083207,59414083192,-15,2397,1122,-30
59415266993,59415266999,6,2223,1077,-30
59416169272,59416169277,5,1911,1167,-30
59416207773,59416207792,19,1953,1165,-30
59416653467,59416653448,-19,2426,984,-30
59417702002,59417701998,-4,2282,6772,-30
59424360900,59424360904,4,2434,1212,-30
59426859396,59426859399,3,2371,1415,-30
59427835578,59427835582,4,1922,1176,-30
59430825902,59430825907,5,2653,1565,-30
59431636758,59431636762,4,1957,944,-30
59432907490,59432907498,8,1900,925,-30
59432992332,59432992337,5,3408,1085,-30
59433426601,59433426609,8,2297,1230,-30
59436352708,59436352711,3,1723,1012,-30
59437129029,59437129033,4,1600,1283,-30
59437182817,59437182806,-11,67,2103,-30
59438863957,59438863959,2,1499,1487,-30
59441640610,59441640617,7,3013,1203,-30
59444063890,59444063895,5,2957,1679,-30
59444865302,59444865307,5,4156,1595,-30
59447767127,59447767130,3,1519,1353,-30
59452387838,59452387845,7,2673,1222,-30
59453369250,59453369255,5,2679,1139,-30
59453595561,59453595562,1,1482,1058,-30
59456377457,59456377462,5,2889,1240,-30
59457522014,59457522006,-8,1414,6765,-30
59459829014,59459829018,4,2163,1247,-30
59463064961,59463064966,5,1948,867,-30
59465189289,59465189295,6,951,782,-30
59466262610,59466262614,4,909,1025,-30
59467289902,59467289905,3,1995,1093,-30
59468296494,59468296499,5,2784,1522,-30
59468610667,59468610673,6,2318,1050,-30
59469696498,59469696502,4,2552,1042,-30
59472563526,59472563531,5,2657,1053,-30
59473442322,59473442329,7,3315,1407,-30
59473880230,59473880235,5,2511,1196,-30
59475947609,59475947614,5,1356,1021,-30
59480094487,59480094493,6,3055,1390,-30
59486795107,59486795109,2,1255,1428,-30
59487823310,59487823317,7,2100,830,-30
59489329828,59489329834,6,1362,791,-30
59496274081,59496274085,4,2765,1520,-30
59497398889,59497398892,3,2482,1754,-30
59498368811,59498368815,4,1851,1027,-30
59498920553,59498920553,0,1277,2053,-30
59501532666,59501532670,4,2480,1223,-30
59501596302,59501596307,5,2171,1041,-30
59507731047,59507731051,4,2314,1232,-30
59509759408,59509759409,1,1432,1167,-30
59514747567,59514747573,6,2294,1095,-30
59514973726,59514973729,3,1175,680,-30
59515392797,59515392801,4,2484,1765,-30
59516186101,59516186106,5,1120,1149,-30
59519172200,59519172206,6,2128,1236,-30
59519351710,59519351697,-13,1571,646,-30
59519696890,59519696885,-5,1040,2699,-30
59526173546,59526173551,5,2247,1634,-30
59527611206,59527611211,5,2314,1344,-30
59528281674,59528281678,4,2127,1247,-30
59528649362,59528649366,4,1463,1239,-30
59532072642,59532072648,6,3043,1020,-30
59534189201,59534189202,1,1306,1328,-30
59535140972,59535140975,3,1901,832,-30
59537357913,59537357918,5,1066,693,-30
59541842682,59541842686,4,1752,1184,-30
59546684881,59546684874,-7,1684,3677,-30
59546898138,59546898143,5,1737,715,-30
59547425941,59547425922,-19,1120,362,-30
59547509486,59547509493,7,4320,1886,-30
59547619042,59547619047,5,2736,1489,-30
59548152615,59548152622,7,2928,1294,-30
59549720022,59549720027,5,998,1407,-30
59551509027,59551509033,6,1847,952,-30
59552754400,59552754394,-6,1564,6669,-30
59553393049,59553393054,5,2799,1339,-30
59555150379,59555150385,6,1321,824,-30
59558165209,59558165213,4,1891,1349,-30
59560966517,59560966523,6,2206,1558,-30
59562181715,59562181722,7,2447,1316,-30
59562653333,59562653339,6,2301,1320,-30
59565679360,59565679360,0,2415,3029,-30
59566500378,59566500358,-20,847,512,-30
59567338242,59567338247,5,2480,1320,-30
59570895835,59570895840,5,2384,1030,-30
59573103939,59573103946,7,5886,2487,-30
59573313726,59573313731,5,3374,2127,-30
59578189940,59578189933,-7,996,3395,-30
59578272627,59578272630,3,3009,2118,-30
59583034192,59583034198,6,2222,1005,-30
59584720677,59584720682,5,1529,1132,-30
59593695430,59593695430,0,954,1075,-30
59594975384,59594975391,7,2089,1117,-30
59596750041,59596750044,3,2483,1104,-30
59601204490,59601204497,7,2339,1035,-30
59602079705,59602079709,4,1985,1343,-30
59603521094,59603521099,5,1436,903,-30
59603617813,59603617793,-20,2087,1072,-30
59603868005,59603868009,4,2164,1415,-30
59605225874,59605225879,5,2239,1309,-30
59608059539,59608059545,6,2247,1106,-30
59608248055,59608248063,8,1364,974,-30
59610734435,59610734442,7,8442,2882,-30
59612453750,59612453745,-5,1124,3115,-30
59617010374,59617010379,5,2016,1018,-30
59620354931,59620354937,6,3490,1593,-30
59623901814,59623901817,3,1258,1495,-30
59630848385,59630848389,4,2666,1436,-30
59631330763,59631330762,-1,42645,4942,-30
59633981725,59633981728,3,1641,1232,-30
59635150155,59635150174,19,1268,1755,-30
59636124109,59636124113,4,2108,1398,-30
59636328418,59636328426,8,2364,1598,-30
59636489500,59636489506,6,3014,1455,-30
59642189510,59642189517,7,2961,1312,-30
59643700770,59643700774,4,1381,1144,-30
59646827711,59646827714,3,1344,753,-30
59648765685,59648765689,4,1863,1326,-30
59651440915,59651440919,4,932,638,-30
59654666086,59654666091,5,2520,1561,-30
59657635847,59657635850,3,2044,1132,-30
59658049681,59658049685,4,2369,1514,-30
59663197226,59663197230,4,2258,1456,-30
59665092518,59665092516,-2,1303,2080,-30
59665278447,59665278451,4,2846,1626,-30
59668005095,59668005089,-6,29094,10878,-30
59668081934,59668081939,5,2248,969,-30
59669949535,59669949540,5,2228,1206,-30
59676052184,59676052190,6,2478,1649,-30
59677861658,59677861665,7,2278,1035,-30
59678953707,59678953690,-17,1574,1168,-30
59680027018,59680027023,5,2394,1964,-30
59681932326,59681932331,5,2147,1427,-30
59683637042,59683637048,6,1822,685,-30
59684713654,59684713658,4,2715,1532,-30
59686451366,59686451369,3,2235,1565,-30
59689196813,59689196816,3,1138,972,-30
59691933522,59691933520,-2,3442,5409,-30
59692638872,59692638879,7,1841,1122,-30
59693957409,59693957406,-3,1629,2678,-30
59694780805,59694780812,7,2583,1237,-30
59695669216,59695669217,1,47533,51599,-30
59695806402,59695806408,6,1918,1115,-30
59697775880,59697775877,-3,1087,2617,-30
59698482570,59698482574,4,2074,1522,-30
59702597422,59702597427,5,1528,762,-30
59704986889,59704986894,5,3169,1776,-30
59706362444,59706362449,5,2077,1205,-30
59707056771,59707056771,0,1403,1726,-30
59709986514,59709986519,5,2545,1235,-30
59711389153,59711389158,5,2470,951,-30
59713051498,59713051505,7,1939,1379,-30
59715249864,59715249870,6,3339,1424,-30
59715512465,59715512467,2,1655,1510,-30
59717160658,59717160663,5,1997,1355,-30
59719865333,59719865338,5,1836,1008,-30
59722499773,59722499777,4,1532,1430,-30
59722770181,59722770187,6,2896,1291,-30
59722975744,59722975749,5,2668,1150,-30
59724548814,59724548818,4,2627,1157,-30
59724999342,59724999324,-18,2394,1132,-30
59726260986,59726260990,4,1097,779,-30
59731301763,59731301767,4,2154,1298,-30
59735930102,59735930107,5,1473,1304,-30
59740127618,59740127623,5,2320,1672,-30
59741999127,59741999130,3,1538,734,-30
59751313616,59751313621,5,2136,1245,-30
59753841014,59753841019,5,2334,1416,-30
59757855158,59757855162,4,1930,1110,-30
59757883310,59757883315,5,1929,1435,-30
59759678919,59759678923,4,2434,1485,-30
59761786646,59761786653,7,1758,1002,-30
59762774786,59762774790,4,2127,1314,-30
59765195485,59765195491,6,2413,1516,-30
59772621861,59772621866,5,2224,1162,-30
59776167931,59776167934,3,1887,1359,-30
59779085403,59779085403,0,2894,3878,-30
59785219839,59785219842,3,961,1153,-30
59787285135,59787285138,3,2040,1404,-30
59791888615,59791888623,8,3298,1231,-30
59791964475,59791964480,5,1454,758,-30
59792940750,59792940754,4,2247,1169,-30
59794795978,59794795978,0,1407,2152,-30
59808205355,59808205359,4,1715,970,-30
59810816466,59810816466,0,6044,6868,-30
59814343470,59814343466,-4,2828,5056,-30
59818762527,59818762533,6,2634,1430,-30
59825465489,59825465491,2,1538,1351,-30
59827616065,59827616072,7,2607,1500,-30
59832194430,59832194437,7,2485,1602,-30
59832657452,59832657454,2,3764,3336,-30
59837556233,59837556238,5,1571,1621,-30
59839466149,59839466152,3,2654,1497,-30
59839783071,59839783079,8,5070,1280,-30
59842664208,59842664214,6,2374,1165,-30
59843184406,59843184410,4,2197,1405,-30
59846031273,59846031278,5,2156,1216,-30
59852504151,59852504150,-1,1042,1427,-30
59852948089,59852948090,1,1367,1297,-30
59853220742,59853220747,5,3546,1520,-30
59854599612,59854599624,12,1468,1146,-30
59857999006,59857999010,4,2653,1243,-30
59858083623,59858083608,-15,2494,956,-30
59858692114,59858692116,2,3869,2597,-30
59860161586,59860161590,4,2309,1236,-30
59864573696,59864573694,-2,969,1549,-30
59865023743,59865023750,7,1866,1497,-30
59865396840,59865396827,-13,882,599,-30
59866399930,59866399934,4,1645,1441,-30
59866962410,59866962414,4,1702,990,-30
59869585695,59869585701,6,3005,1632,-30
59870178158,59870178136,-22,2107,1640,-30
59870327420,59870327424,4,2642,1456,-30
59870538429,59870538435,6,2377,1334,-30
59871229382,59871229385,3,3565,3058,-30
59873185117,59873185112,-5,1086,3420,-30
59875049596,59875049602,6,3393,1684,-30
59875218970,59875218975,5,1367,1042,-30
59883236907,59883236911,4,2288,1371,-30
59884844096,59884844098,2,2209,1995,-30
59885595386,59885595391,5,1388,910,-30
59889603833,59889603838,5,5939,3191,-30
59892975033,59892975039,6,1966,1149,-30
59893178397,59893178407,10,2345,1030,-30
59894404237,59894404243,6,6430,2283,-30
59895779074,59895779077,3,2431,1120,-30
59896213338,59896213342,4,1861,1053,-30
59897192983,59897192988,5,2004,1412,-30
59898456349,59898456354,5,1557,845,-30
59903029176,59903029181,5,2110,1033,-30
59904552032,59904552037,5,2693,1221,-30
59904711238,59904711228,-10,1850,556,-30
59907799753,59907799759,6,2490,1405,-30
59907832638,59907832646,8,1307,887,-30
59908762411,59908762419,8,2321,1419,-30
59909651239,59909651243,4,1637,1156,-30
59909678400,59909678401,1,1662,2239,-30
59910787010,59910787016,6,2182,1192,-30
59912637269,59912637265,-4,2849,5932,-30
59913393860,59913393863,3,2588,1174,-30
59914404685,59914404664,-21,2515,1171,-30
59915235139,59915235145,6,2000,1261,-30
59915675272,59915675277,5,2447,993,-30
59915723598,59915723602,4,2450,1095,-30
59917140732,59917140734,2,1848,1390,-30
59920229618,59920229623,5,1937,1128,-30
59921117445,59921117445,0,1813,1569,-30
59921887993,59921887998,5,2027,1061,-30
59927718390,59927718395,5,2083,1098,-30
59931153466,59931153471,5,2343,1228,-30
59933572347,59933572351,4,2275,1445,-30
59933745925,59933745939,14,2550,1419,-30
59940074940,59940074946,6,4004,1776,-30
59945585445,59945585454,9,3728,1189,-30
59946944263,59946944268,5,2430,1136,-30
59947702613,59947702595,-18,2011,1445,-30
59948247025,59948247031,6,2356,1160,-30
59949078506,59949078510,4,2280,1125,-30
59949363173,59949363178,5,1702,969,-30
59949831513,59949831517,4,1915,1164,-30
59951038305,59951038310,5,1872,1419,-30
59953736581,59953736585,4,2329,1445,-30
59953810835,59953810840,5,2342,1543,-30
59955814223,59955814226,3,1463,1233,-30
59956872317,59956872322,5,2878,1578,-30
59957434548,59957434552,4,3428,1311,-30
59958809299,59958809304,5,2225,1314,-30
59963678525,59963678530,5,1967,815,-30
59966129869,59966129873,4,1930,1401,-30
59972497950,59972497951,1,1184,1445,-30
59975333790,59975333798,8,1724,1492,-30
59979084645,59979084647,2,1252,1186,-30
59985522569,59985522574,5,2745,2163,-30
59986369813,59986369818,5,2224,981,-30
59989484301,59989484305,4,2396,1402,-30
59991392030,59991392035,5,2380,1437,-30
59996414950,59996414954,4,2858,1702,-30
59997829039,59997829044,5,2281,1191,-30
59998514730,59998514738,8,2060,1153,-30
60001992292,60001992297,5,2228,1575,-30
60005385714,60005385696,-18,1368,2103,-30
60011446538,60011446541,3,2003,1169,-30
60011572082,60011572087,5,2813,1359,-30
60011997209,60011997215,6,2487,1158,-30
60017261334,60017261338,4,2261,1226,-30
60017818221,60017818226,5,2063,1087,-30
60018292893,60018292899,6,2198,1185,-30
60020389550,60020389550,0,1747,2199,-30
60020814917,60020814914,-3,1163,1742,-30
60021555477,60021555484,7,3857,1984,-30
60025192984,60025192987,3,2222,1346,-30
60026587518,60026587519,1,1581,1132,-30
60029315152,60029315154,2,1883,1354,-30
60032892394,60032892384,-10,55198,33735,-30
60033136530,60033136533,3,1382,1570,-30
60033808777,60033808782,5,2949,1436,-30
60042291998,60042292003,5,2458,1239,-30
60044075006,60044075011,5,1331,952,-30
60046529241,60046529245,4,1383,1349,-30
60048484814,60048484818,4,2042,1423,-30
60048525912,60048525905,-7,1851,5165,-30
60048787364,60048787368,4,1956,1296,-30
60049184162,60049184168,6,3305,1472,-30
60050241390,60050241395,5,2003,1735,-30
60051362982,60051362986,4,1965,1176,-30
60051501463,60051501440,-23,1657,1280,-30
60051674943,60051674947,4,1595,1004,-30
60055489178,60055489181,3,2308,1238,-30
60059348305,60059348310,5,2326,1396,-30
60062940322,60062940327,5,2466,1294,-30
60064692902,60064692903,1,1348,978,-30
60065952618,60065952622,4,2525,1333,-30
60066378674,60066378678,4,2087,1194,-30
60066882287,60066882283,-4,682,1560,-30
60068915373,60068915379,6,3152,1512,-30
60073126558,60073126566,8,2055,1428,-30
60074860476,60074860482,6,3006,1008,-30
60076579086,60076579090,4,2388,1191,-30
60077521806,60077521811,5,2120,1439,-30
60077612122,60077612126,4,2201,1273,-30
60078196975,60078196982,7,2392,1413,-30
60081685358,60081685361,3,2038,1411,-30
60087267095,60087267099,4,843,1111,-30
60089264566,60089264566,0,1295,1705,-30
60089828046,60089828050,4,1825,1676,-30
60090468784,60090468787,3,2428,1176,-30
60091060121,60091060123,2,1917,2069,-30
60093173137,60093173138,1,1347,2237,-30
60094226991,60094226994,3,1312,1138,-30
60096624221,60096624224,3,2688,2020,-30
60101829201,60101829205,4,719,630,-30
60103579312,60103579315,3,2600,1442,-30
60110017972,60110017955,-17,1726,882,-30
60110090142,60110090145,3,2191,1127,-30
60116449765,60116449770,5,1650,1481,-30
60116780422,60116780425,3,2730,2661,-30
60120209813,60120209815,2,1554,1225,-30
60122904260,60122904266,6,4009,1355,-30
60125287176,60125287181,5,2561,1413,-30
60126717942,60126717948,6,2682,1316,-30
60129442843,60129442846,3,1226,1115,-30
60129997498,60129997505,7,1962,920,-30
60134143116,60134143120,4,1884,1390,-30
60139758509,60139758509,0,1265,1521,-30
60140837258,60140837261,3,2774,1702,-30
60142136275,60142136282,7,1906,1039,-30
60142553179,60142553182,3,2158,1428,-30
60143548656,60143548661,5,1993,1140,-30
60145056689,60145056695,6,2209,1375,-30
60151313210,60151313214,4,1797,1126,-30
60154845921,60154845926,5,2860,1169,-30
60159941007,60159941012,5,1874,1309,-30
60160365520,60160365522,2,1976,1885,-30
60161711576,60161711580,4,2491,1730,-30
60161908575,60161908578,3,1452,1277,-30
60167763673,60167763679,6,3415,941,-30
60168937910,60168937914,4,1787,1391,-30
60175100893,60175100898,5,2946,2050,-30
60178955953,60178955958,5,2182,1340,-30
60179944202,60179944205,3,1857,1435,-30
60183242671,60183242675,4,2222,1182,-30
60184257703,60184257709,6,2241,1527,-30
60186848490,60186848490,0,2205,1544,-30
60193479622,60193479625,3,2163,1869,-30
60194893555,60194893560,5,3762,3019,-30
60198812089,60198812094,5,2154,1196,-30
60201887961,60201887968,7,2175,1206,-30
60203716642,60203716647,5,2421,1320,-30
60207022275,60207022271,-4,1572,4126,-30
60207416309,60207416314,5,3042,1241,-30
60209798130,60209798135,5,2119,1402,-30
60214465911,60214465889,-22,318,993,-30
60219069746,60219069751,5,286,994,-30
60219632175,60219632180,5,2961,1177,-30
60221335242,60221335249,7,2616,1398,-30
60222476726,60222476731,5,1734,1688,-30
60224960613,60224960619,6,2356,1070,-30
60228322357,60228322362,5,2801,1122,-30
60228387451,60228387443,-8,1085,3248,-30
60229089757,60229089761,4,2618,1481,-30
60232028151,60232028128,-23,2090,1411,-30
60232520240,60232520244,4,2091,2060,-30
60235585481,60235585488,7,2181,1225,-30
60248040278,60248040284,6,2183,1339,-30
60249363811,60249363816,5,2104,1605,-30
60250856766,60250856771,5,1619,1079,-30
60252603528,60252603533,5,2359,1261,-30
60252700096,60252700100,4,1567,1476,-30
60253258767,60253258773,6,3333,1784,-30
60254233974,60254233978,4,1225,910,-30
60256146050,60256146054,4,2552,1785,-30
60257068984,60257068985,1,1809,1697,-30
60260679211,60260679217,6,1992,1215,-30
60261038346,60261038331,-15,694,290,-30
60261496233,60261496235,2,2797,2222,-30
60263726855,60263726860,5,2449,1128,-30
60266845455,60266845468,13,43,1628,-30
60268336867,60268336870,3,1578,1115,-30
60272651696,60272651700,4,1941,1382,-30
60274288818,60274288822,4,2034,1223,-30
60275670595,60275670601,6,1244,979,-30
60286184501,60286184506,5,2620,1562,-30
60286702956,60286702959,3,2090,1153,-30
60287742824,60287742828,4,2003,1175,-30
60289634299,60289634306,7,4854,1626,-30
60295688885,60295688891,6,3218,1195,-30
60298758832,60298758837,5,3017,884,-30
60302623234,60302623241,7,3955,1191,-30
60303702987,60303702992,5,2152,1246,-30
60306451866,60306451871,5,1908,1473,-30
60307479276,60307479281,5,2749,1786,-30
60308041885,60308041890,5,1891,1701,-30
60308144654,60308144634,-20,2545,1256,-30
60308965502,60308965507,5,1343,1051,-30
60310516449,60310516454,5,1769,1647,-30
60312001494,60312001499,5,2045,1095,-30
60312066560,60312066562,2,610,112,-30
60315109977,60315109983,6,2769,1384,-30
60316070447,60316070451,4,2005,972,-30
60316221556,60316221576,20,2323,1194,-30
60317364090,60317364098,8,2820,1573,-30
60317478218,60317478223,5,2260,1354,-30
60319298801,60319298806,5,2875,1328,-30
60323979146,60323979150,4,1572,849,-30
60324028529,60324028516,-13,3044,1348,-30
60325185374,60325185380,6,3007,1710,-30
60327031752,60327031758,6,3072,1151,-30
60331820270,60331820275,5,2138,1045,-30
60334610345,60334610349,4,2227,1288,-30
60335245183,60335245190,7,3759,1589,-30
60336580519,60336580522,3,2140,1076,-30
60338994768,60338994774,6,2252,1351,-30
60341407465,60341407469,4,1951,1586,-30
60341880331,60341880337,6,2678,2035,-30
60345043636,60345043642,6,2381,1243,-30
60345263903,60345263888,-15,1208,441,-30
60347774742,60347774747,5,2521,1335,-30
60349552795,60349552798,3,1796,1037,-30
60351583197,60351583196,-1,1287,1569,-30
60351671058,60351671062,4,1903,1632,-30
60362523634,60362523639,5,1976,1313,-30
60363031989,60363031992,3,2474,943,-30
60363862674,60363862659,-15,747,116,-30
60364234878,60364234882,4,7234,21198,-30
60365108210,60365108214,4,2359,1356,-30
60368440086,60368440090,4,2508,1672,-30
60375269261,60375269263,2,1475,982,-30
60376339258,60376339256,-2,1686,3114,-30
60378036887,60378036889,2,3129,3392,-30
60381170642,60381170646,4,1353,1016,-30
60385126281,60385126287,6,2175,1462,-30
60385470797,60385470802,5,3380,1925,-30
60386851770,60386851773,3,2641,1823,-30
60387998950,60387998955,5,2200,1358,-30
60394912707,60394912710,3,1897,1324,-30
60397777874,60397777878,4,2184,1319,-30
60398496901,60398496904,3,2107,1560,-30
60402585585,60402585568,-17,1389,928,-30
60406049608,60406049613,5,3135,1370,-30
60406333519,60406333500,-19,749,451,-30
60406951689,60406951692,3,2603,1246,-30
60415032338,60415032345,7,3563,1517,-30
60425232441,60425232445,4,1630,1146,-30
60431229080,60431229085,5,2381,1022,-30
60433384293,60433384297,4,2072,1097,-30
60435184511,60435184516,5,1794,1402,-30
60440488181,60440488187,6,2447,1182,-30
60440635195,60440635199,4,1813,1232,-30
60440813364,60440813371,7,1647,899,-30
60443106347,60443106341,-6,399,1954,-30
60445090887,60445090871,-16,2301,1360,-30
60445970758,60445970762,4,1941,1304,-30
60446662923,60446662922,-1,1961,2359,-30
60448118194,60448118199,5,1981,1639,-30
60455765021,60455765026,5,3027,1159,-30
60461455546,60461455553,7,3156,1519,-30
60463860397,60463860403,6,651,610,-30
60465535527,60465535531,4,1108,1119,-30
60469030250,60469030255,5,2005,1045,-30
60470345007,60470345011,4,1783,1668,-30
60471284470,60471284474,4,2116,1415,-30
60471351857,60471351862,5,2050,1093,-30
60473441978,60473441991,13,9920,44894,-30
60474201771,60474201768,-3,1200,3306,-30
60474419243,60474419245,2,1549,875,-30
60475787445,60475787450,5,2545,1423,-30
60477147443,60477147450,7,2461,1540,-30
60477324402,60477324406,4,2935,1379,-30
60478615624,60478615630,6,3182,1963,-30
60480966243,60480966249,6,2465,1325,-30
60483743775,60483743778,3,2622,1416,-30
60483782967,60483782974,7,1207,526,-30
60493300984,60493300985,1,914,1447,-30
60495446809,60495446813,4,2382,1629,-30
60495512225,60495512226,1,1533,1510,-30
60497611694,60497611700,6,3656,1023,-30
60499009051,60499009054,3,2130,970,-30
60501194006,60501194010,4,2629,900,-30
60504414983,60504414989,6,1701,1225,-30
60508155583,60508155587,4,3286,1330,-30
60509746439,60509746443,4,2214,1695,-30
60510148078,60510148081,3,2150,1030,-30
60511143551,60511143557,6,2285,892,-30
60512499054,60512499061,7,2444,1426,-30
60516746465,60516746470,5,985,1095,-30
60517776210,60517776214,4,2775,1505,-30
60518163910,60518163914,4,1694,929,-30
60519541058,60519541062,4,974,796,-30
60528490466,60528490471,5,1516,971,-30
60528710421,60528710427,6,1722,1169,-30
60529948042,60529948047,5,2451,1455,-30
60532832622,60532832626,4,2427,1323,-30
60533127515,60533127520,5,2385,1450,-30
60533959682,60533959686,4,2446,1487,-30
60537771303,60537771308,5,2032,1356,-30
60538619995,60538620003,8,2092,1268,-30
60542066074,60542066094,20,1291,3015,-30
60542179755,60542179759,4,2252,1162,-30
60545262378,60545262382,4,2105,709,-30
60550867257,60550867263,6,2495,1546,-30
60552370370,60552370375,5,2155,1705,-30
60555170590,60555170597,7,2161,1016,-30
60559435006,60559435011,5,1630,748,-30
60561880744,60561880747,3,2050,1102,-30
60564055154,60564055159,5,1952,1424,-30
60570448931,60570448937,6,1976,764,-30
60570788519,60570788523,4,1679,939,-30
60571606062,60571606067,5,1738,1091,-30
60574406262,60574406265,3,1241,1361,-30
60582678097,60582678102,5,2751,1494,-30
60587207847,60587207851,4,2459,1114,-30
60587607084,60587607096,12,1972,1589,-30
60588569758,60588569762,4,1321,1281,-30
60592290742,60592290747,5,2360,1439,-30
60592639189,60592639190,1,2405,2032,-30
60594894057,60594894062,5,1231,1300,-30
60595895115,60595895120,5,6265,2423,-30
60600139945,60600139947,2,1847,1160,-30
60601375498,60601375498,0,1484,1002,-30
60602989930,60602989933,3,1287,1158,-30
60603846893,60603846898,5,1789,1421,-30
60605367443,60605367448,5,2208,1554,-30
60608694238,60608694244,6,1740,1405,-30
60611317933,60611317918,-15,1492,744,-30
60615061812,60615061818,6,2454,1507,-30
60615140778,60615140778,0,825,1173,-30
60615911823,60615911826,3,2188,1543,-30
60619387813,60619387818,5,2748,1087,-30
60620266596,60620266604,8,2545,1623,-30
60623037437,60623037439,2,1766,1675,-30
60623814570,60623814575,5,2069,1241,-30
60626478435,60626478431,-4,15684,53819,-30
60628598612,60628598616,4,2117,1170,-30
60629051317,60629051322,5,2439,1504,-30
60629603759,60629603764,5,2747,1551,-30
60631347906,60631347911,5,1211,1423,-30
60632126953,60632126958,5,2308,1357,-30
60633292586,60633292584,-2,1023,2213,-30
60636236853,60636236860,7,2673,1034,-30
60636576941,60636576940,-1,19282,11021,-30
60639861464,60639861468,4,2073,1900,-30
60639983235,60639983217,-18,948,251,-30
60646882049,60646882053,4,2784,1323,-30
60649291121,60649291123,2,1815,1236,-30
60659619275,60659619280,5,2636,1370,-30
60661524779,60661524785,6,1859,1151,-30
60662869907,60662869888,-19,1546,509,-30
60667518557,60667518562,5,2990,1219,-30
60667810413,60667810411,-2,1085,2292,-30
60668666035,60668666039,4,1252,804,-30
60671760378,60671760382,4,1600,802,-30
60673086644,60673086648,4,2025,820,-30
60674360099,60674360110,11,1921,768,-30
60674723406,60674723410,4,1522,1003,-30
60675249798,60675249803,5,1762,1269,-30
60675633547,60675633553,6,2316,1171,-30
60676127671,60676127677,6,2469,1137,-30
60676213542,60676213524,-18,1505,1187,-30
60679617598,60679617605,7,2266,1288,-30
60681395926,60681395931,5,2115,1053,-30
60681793307,60681793314,7,2231,1054,-30
60688946759,60688946765,6,2423,1310,-30
60689181410,60689181415,5,1875,1704,-30
60692639733,60692639739,6,3003,1626,-30
60696370262,60696370267,5,2533,1378,-30
60697123094,60697123076,-18,2464,843,-30
60698324816,60698324812,-4,1253,2336,-30
60699910861,60699910865,4,2514,1700,-30
60702757590,60702757596,6,2601,1269,-30
60706818941,60706818945,4,2266,1454,-30
60707156573,60707156578,5,1803,1425,-30
60707194437,60707194443,6,1826,1270,-30
60708779381,60708779387,6,1789,1687,-30
60711128377,60711128382,5,2054,1388,-30
60712651261,60712651267,6,1707,1050,-30
60714841571,60714841577,6,2641,1351,-30
60718829292,60718829298,6,2114,1272,-30
60720386706,60720386710,4,1510,1322,-30
60720458542,60720458546,4,2300,1555,-30
60720862821,60720862826,5,2676,1614,-30
60722092001,60722092006,5,2750,1348,-30
60725058875,60725058878,3,1023,663,-30
60730252704,60730252710,6,1896,1151,-30
60732496329,60732496334,5,1932,1102,-30
60734057151,60734057155,4,2386,1193,-30
60734123197,60734123180,-17,1001,432,-30
60742783380,60742783385,5,2582,1573,-30
60749335982,60749335974,-8,1724,7509,-30
60753910805,60753910811,6,2565,1321,-30
60756951956,60756951964,8,3139,1288,-30
60761138026,60761138032,6,1584,1261,-30
60764314700,60764314704,4,2469,1910,-30
60766365322,60766365323,1,52025,50771,-30
60769267566,60769267571,5,2269,1218,-30
60770303490,60770303498,8,2433,1368,-30
60774243314,60774243320,6,1077,794,-30
60774302821,60774302826,5,2707,1642,-30
60782007094,60782007100,6,2774,1624,-30
60785756328,60785756334,6,2948,1031,-30
60788167562,60788167569,7,2084,1146,-30
60791762171,60791762175,4,2449,1101,-30
60791901403,60791901408,5,1639,940,-30
60796265752,60796265757,5,1653,1578,-30
60796465785,60796465789,4,2685,1259,-30
60803877021,60803877035,14,15260,31885,-30
60804362756,60804362762,6,3374,1565,-30
60806214653,60806214658,5,2463,1067,-30
60808197328,60808197333,5,2110,1076,-30
60810989908,60810989913,5,2782,1405,-30
60812371781,60812371786,5,2156,991,-30
60813657246,60813657249,3,2343,1367,-30
60813993173,60813993177,4,2999,1833,-30
60820786705,60820786709,4,2084,1146,-30
60821112846,60821112850,4,1989,1769,-30
60825512418,60825512422,4,1815,1185,-30
60826136209,60826136212,3,1047,1118,-30
60827350303,60827350307,4,2091,1405,-30
60829973787,60829973792,5,3024,1171,-30
60839009343,60839009350,7,2515,1364,-30
60840993250,60840993254,4,1955,1285,-30
60841262212,60841262217,5,2194,1274,-30
60842950585,60842950590,5,2452,1067,-30
60843259770,60843259775,5,1874,1300,-30
60843354109,60843354114,5,2770,1921,-30
60845483066,60845483071,5,2412,1794,-30
60846056301,60846056308,7,2106,1147,-30
60846533725,60846533738,13,1515,323,-30
60846815888,60846815891,3,2695,1689,-30
60849418299,60849418305,6,2151,1008,-30
60854702282,60854702287,5,2721,1139,-30
60860387203,60860387207,4,2260,1652,-30
60861301554,60861301559,5,2456,1208,-30
60861375159,60861375168,9,2462,1508,-30
60862047156,60862047159,3,2315,1058,-30
60863243250,60863243255,5,1096,459,-30
60865603093,60865603098,5,2489,1412,-30
60867773389,60867773395,6,2798,1322,-30
60868405874,60868405877,3,2239,1342,-30
60870826808,60870826810,2,2198,1346,-30
60872383850,60872383855,5,1472,1482,-30
60872841086,60872841093,7,2595,1387,-30
60876069732,60876069737,5,2058,961,-30
60879294697,60879294702,5,2009,1082,-30
60880727901,60880727907,6,1703,980,-30
60881497667,60881497671,4,1655,1579,-30
60884378034,60884378041,7,4332,1693,-30
60892771713,60892771718,5,2570,1659,-30
60893824122,60893824123,1,2063,2110,-30
60897987790,60897987793,3,2003,1822,-30
60902575490,60902575498,8,2146,996,-30
60904964546,60904964550,4,2000,1466,-30
60906578254,60906578259,5,2297,1465,-30
60913892161,60913892167,6,1365,1123,-30
60914603695,60914603701,6,2636,1311,-30
60916087506,60916087510,4,2362,1617,-30
60916188284,60916188287,3,2476,1571,-30
60916995771,60916995777,6,2491,1653,-30
60918642334,60918642337,3,1659,1190,-30
60919901347,60919901348,1,1107,1835,-30
60920303925,60920303931,6,2283,1319,-30
60921353869,60921353873,4,1759,1218,-30
60922451727,60922451706,-21,1308,735,-30
60924159315,60924159319,4,1652,1645,-30
60929519577,60929519581,4,1426,1204,-30
60930460213,60930460218,5,1965,1292,-30
60931795198,60931795203,5,2090,1246,-30
60935888561,60935888567,6,3831,1409,-30
60939149322,60939149327,5,2291,1379,-30
60941202266,60941202269,3,2192,1105,-30
60947877953,60947877959,6,2558,1473,-30
60948248466,60948248469,3,2449,1769,-30
60949917430,60949917436,6,2398,1445,-30
60951007178,60951007184,6,2759,1591,-30
60951557982,60951557988,6,2059,963,-30
60951757654,60951757642,-12,1198,948,-30
60956561890,60956561895,5,1425,1045,-30
60956652817,60956652824,7,1835,953,-30
60960259891,60960259896,5,1385,1025,-30
60963208678,60963208682,4,1948,946,-30
60963329186,60963329192,6,3389,1570,-30
60968542230,60968542233,3,2294,1345,-30
60975517740,60975517745,5,1746,1498,-30
60976361539,60976361535,-4,1262,2065,-30
60976768461,60976768466,5,2118,1222,-30
60976957520,60976957513,-7,358,84,-30
60982638422,60982638426,4,3067,1241,-30
60983786055,60983786061,6,2217,1172,-30
60989723098,60989723101,3,1256,1312,-30
60994812718,60994812722,4,1712,1535,-30
60994970785,60994970790,5,2348,1601,-30
60999007469,60999007473,4,1795,1363,-30
61000988132,61000988135,3,2585,1120,-30
61001433246,61001433250,4,2671,1540,-30
61002174229,61002174234,5,1958,1441,-30
61003891856,61003891858,2,1763,1487,-30
61005758526,61005758533,7,2711,1318,-30
61007565649,61007565654,5,2124,899,-30
61009515302,61009515305,3,1500,1440,-30
61010663240,61010663246,6,2274,1147,-30
61013039411,61013039415,4,1827,1321,-30
61015231358,61015231370,12,2558,1593,-30
61015529869,61015529872,3,1978,1172,-30
61015711359,61015711363,4,2032,1044,-30
61017295837,61017295818,-19,2310,1214,-30
61018085305,61018085307,2,2156,1186,-30
61019220770,61019220776,6,3840,1572,-30
61021858266,61021858270,4,2053,1235,-30
61023777961,61023777965,4,2269,1344,-30
61023810808,61023810811,3,1591,1331,-30
61031652998,61031653003,5,1868,983,-30
61037678222,61037678228,6,2757,1488,-30
61044318762,61044318767,5,2575,1397,-30
61045518737,61045518742,5,2103,986,-30
61047012871,61047012871,0,1458,1714,-30
61048226653,61048226652,-1,1584,2207,-30
61048959834,61048959838,4,2812,1558,-30
61049085418,61049085425,7,2942,803,-30
61049981893,61049981898,5,2176,1411,-30
61052964811,61052964805,-6,1073,2944,-30
61053135724,61053135729,5,2949,1909,-30
61058494806,61058494810,4,3031,1409,-30
61059495995,61059495997,2,1926,1866,-30
61062410026,61062410031,5,5269,2497,-30
61063799388,61063799394,6,1484,789,-30
61069338657,61069338662,5,2243,1280,-30
61070993485,61070993492,7,1977,1552,-30
61072034894,61072034900,6,2126,1052,-30
61073016920,61073016926,6,2520,1287,-30
61073142693,61073142698,5,2354,1710,-30
61075493518,61075493523,5,2340,1419,-30
61076420331,61076420338,7,2515,1321,-30
61082253210,61082253206,-4,1652,4749,-30
61083818301,61083818309,8,2754,1267,-30
61085167088,61085167094,6,2601,1331,-30
61088118151,61088118144,-7,19304,13145,-30
61095548046,61095548049,3,1933,1109,-30
61098570790,61098570782,-8,991,5601,-30
61098865928,61098865933,5,1697,1001,-30
61099489522,61099489527,5,1753,954,-30
61100171743,61100171722,-21,897,391,-30
61100198691,61100198698,7,2372,1216,-30
61102037358,61102037343,-15,1209,730,-30
61113721364,61113721367,3,2091,1081,-30
61115285743,61115285749,6,2200,1112,-30
61115331425,61115331431,6,1895,1278,-30
61115510866,61115510873,7,2747,1426,-30
61116642118,61116642123,5,4862,1067,-30
61116848865,61116848883,18,2976,1534,-30
61118160266,61118160270,4,2468,1355,-30
61120728145,61120728151,6,2200,1192,-30
61122475030,61122475027,-3,1063,3304,-30
61123064198,61123064202,4,1991,1195,-30
61124897426,61124897431,5,2454,1165,-30
61128752902,61128752899,-3,923,1674,-30
61131005958,61131005962,4,2105,1356,-30
61133749230,61133749237,7,2299,1153,-30
61133920962,61133920966,4,809,601,-30
61134959274,61134959274,0,1892,1618,-30
61135571985,61135571989,4,11022,25463,-30
61136622299,61136622306,7,2394,1124,-30
61139650639,61139650643,4,2276,1795,-30
61140530103,61140530113,10,1045,386,-30
61142327170,61142327175,5,1677,1331,-30
61145389494,61145389501,7,2624,1047,-30
61146520551,61146520556,5,1849,1323,-30
61148187153,61148187155,2,1655,1486,-30
61148843376,61148843381,5,3022,1748,-30
61152085507,61152085513,6,2831,1744,-30
61153144085,61153144089,4,2228,990,-30
61153568471,61153568483,12,805,309,-30
61155968457,61155968461,4,2040,1260,-30
61156070661,61156070672,11,2031,1414,-30
61156258403,61156258407,4,1915,1168,-30
61159183014,61159183019,5,2410,1349,-30
61160842818,61160842822,4,2703,1267,-30
61172257581,61172257583,2,1697,2083,-30
61173013583,61173013589,6,1563,815,-30
61175381030,61175381035,5,2676,950,-30
61176119929,61176119934,5,2165,1009,-30
61178389127,61178389133,6,2369,1119,-30
61179452242,61179452242,0,1855,1514,-30
61190616258,61190616262,4,2902,1237,-30
61191737898,61191737906,8,1805,766,-30
61200470617,61200470622,5,1865,1390,-30
61209814605,61209814611,6,1704,894,-30
61210934605,61210934610,5,2409,1104,-30
61212908022,61212908026,4,1918,1573,-30
61213425130,61213425136,6,1448,693,-30
61216575168,61216575170,2,2905,3495,-30
61221436828,61221436835,7,1836,1231,-30
61225319814,61225319797,-17,1071,505,-30
61229576393,61229576397,4,2325,1380,-30
61233875367,61233875370,3,1609,1444,-30
61236139686,61236139692,6,2900,1834,-30
61238084145,61238084149,4,2082,1112,-30
61238212974,61238212955,-19,868,125,-30
61246396222,61246396225,3,2030,1340,-30
61248114250,61248114254,4,1882,1296,-30
61249676204,61249676210,6,1118,1037,-30
61251919947,61251919953,6,2116,1262,-30
61252440043,61252440055,12,14913,23337,-30
61259841398,61259841402,4,2333,1642,-30
61262298010,61262298015,5,1189,1009,-30
61265925618,61265925624,6,1690,1325,-30
61266229171,61266229153,-18,828,369,-30
61267250022,61267250027,5,2091,1102,-30
61268282754,61268282758,4,1822,1440,-30
61274096177,61274096183,6,1335,1057,-30
61274294677,61274294681,4,839,411,-30
61274639001,61274638985,-16,899,477,-30
61277389295,61277389295,0,1677,1521,-30
61278565906,61278565910,4,1778,1052,-30
61281100009,61281099992,-17,1952,999,-30
61283530351,61283530356,5,2288,1947,-30
61283701392,61283701397,5,2593,1169,-30
61287194491,61287194496,5,2324,1512,-30
61287497464,61287497451,-13,2754,1413,-30
61288821181,61288821185,4,2038,1482,-30
61291913741,61291913750,9,8444,30322,-30
61294774882,61294774887,5,2552,954,-30
61296952269,61296952272,3,2346,1303,-30
61298057549,61298057553,4,1910,1261,-30
61298871963,61298871969,6,1974,1375,-30
61304730594,61304730599,5,2118,1073,-30
61304878685,61304878698,13,1658,1060,-30
61305635872,61305635873,1,6140,8116,-30
61308790950,61308790955,5,2469,1262,-30
61309591578,61309591582,4,2325,1041,-30
61310228561,61310228566,5,1799,1658,-30
61314333807,61314333810,3,2063,1474,-30
61318054610,61318054614,4,1881,1275,-30
61321245900,61321245905,5,1898,1074,-30
61322214763,61322214763,0,1382,728,-30
61325179846,61325179850,4,2289,1198,-30
61328551420,61328551424,4,1715,765,-30
61334698738,61334698745,7,2552,966,-30
61336200070,61336200078,8,2142,1254,-30
61348335024,61348335027,3,1675,1324,-30
61349107149,61349107154,5,1753,1082,-30
61349895301,61349895303,2,2223,1442,-30
61350136678,61350136666,-12,1294,826,-30
61350898607,61350898613,6,2290,1201,-30
61355234018,61355234023,5,3385,1820,-30
61356656121,61356656126,5,2428,1358,-30
61362335259,61362335263,4,2522,1136,-30
61367772214,61367772214,0,873,857,-30
61372610550,61372610554,4,2426,1565,-30
61375540585,61375540591,6,2030,1055,-30
61375838071,61375838075,4,2313,1427,-30
61384037947,61384037963,16,2470,1532,-30
61385788518,61385788523,5,3076,1591,-30
61388265939,61388265944,5,2202,1471,-30
61391030080,61391030083,3,1794,1116,-30
61393225755,61393225758,3,2026,1428,-30
61395084522,61395084526,4,2422,1193,-30
61398052064,61398052064,0,1607,1454,-30
61401463801,61401463806,5,2086,1607,-30
61403773910,61403773910,0,1976,1943,-30
61405920863,61405920867,4,2025,1174,-30
61406224281,61406224299,18,2940,1423,-30
61409282219,61409282226,7,2624,1160,-30
61412504075,61412504081,6,3305,1611,-30
61413360062,61413360067,5,2018,1236,-30
61416117961,61416117965,4,2496,1446,-30
61419486862,61419486866,4,2298,1470,-30
61420265978,61420265983,5,2435,1357,-30
61420316214,61420316219,5,2743,1270,-30
61422490317,61422490322,5,2329,1655,-30
61426582622,61426582620,-2,1685,2395,-30
61427799477,61427799483,6,1547,990,-30
61428219473,61428219478,5,2117,1131,-30
61437318467,61437318468,1,1271,1802,-30
61440489586,61440489585,-1,729,1970,-30
61441159161,61441159165,4,1719,1503,-30
61444150576,61444150581,5,2473,1337,-30
61444877737,61444877735,-2,1221,2432,-30
61444939007,61444939014,7,2119,1303,-30
61448772046,61448772053,7,2115,882,-30
61449658388,61449658394,6,2341,862,-30
61450377782,61450377795,13,2426,1388,-30
61451477953,61451477958,5,2878,1707,-30
61452479433,61452479439,6,2288,979,-30
61453350991,61453350995,4,1908,1019,-30
61455268414,61455268392,-22,2381,1300,-30
61456079361,61456079347,-14,1377,697,-30
61458270439,61458270446,7,1522,901,-30
61462070781,61462070787,6,1432,1163,-30
61462174078,61462174083,5,1376,994,-30
61463771681,61463771688,7,2582,1587,-30
61469443865,61469443868,3,784,775,-30
61470532495,61470532502,7,2274,1199,-30
61472127775,61472127779,4,2239,1213,-30
61474095976,61474095983,7,2713,1440,-30
61483584197,61483584202,5,1296,889,-30
61486599834,61486599838,4,1745,1540,-30
61494746205,61494746216,11,10263,44713,-30
61499885230,61499885224,-6,1035,5262,-30
61504301510,61504301515,5,2270,1357,-30
61508055355,61508055355,0,1707,2121,-30
61510774256,61510774261,5,2227,1059,-30
61511550016,61511550018,2,2011,1393,-30
61514750374,61514750377,3,2136,1265,-30
61520093766,61520093771,5,1038,581,-30
61523482734,61523482738,4,2497,1320,-30
61524653536,61524653531,-5,1711,1917,-30
61526115742,61526115746,4,3076,1304,-30
61529151729,61529151734,5,3580,2120,-30
61532407025,61532407029,4,2877,2373,-30
61532959298,61532959303,5,2025,1173,-30
61536752605,61536752612,7,2349,1078,-30
61538804858,61538804863,5,1748,903,-30
61539102555,61539102559,4,2528,1267,-30
61539354055,61539354058,3,1539,1317,-30
61540608828,61540608831,3,2763,2576,-30
61541324063,61541324070,7,1729,1080,-30
61542973342,61542973343,1,1143,1160,-30
61547514745,61547514750,5,2257,1664,-30
61549330368,61549330373,5,2132,1099,-30
61550672694,61550672701,7,2969,1513,-30
61555114513,61555114517,4,1621,1185,-30
61556310433,61556310438,5,1604,1050,-30
61557702135,61557702139,4,1877,1394,-30
61560131702,61560131707,5,1847,1146,-30
61562942734,61562942737,3,1498,1361,-30
61564513541,61564513547,6,3255,1525,-30
61566164465,61566164457,-8,1637,5816,-30
61567378142,61567378148,6,2262,1372,-30
61571130901,61571130906,5,2321,1726,-30
61573329486,61573329492,6,2313,1318,-30
61576502762,61576502766,4,2090,1332,-30
61580212668,61580212674,6,1879,1152,-30
61583462025,61583462031,6,2624,1289,-30
61585592293,61585592293,0,35911,22488,-30
61586037338,61586037342,4,1521,1006,-30
61588675175,61588675182,7,1758,978,-30
61588846721,61588846708,-13,1912,987,-30
61589437966,61589437963,-3,887,196,-30
61591177232,61591177237,5,1622,1894,-30
61591558554,61591558558,4,1910,1366,-30
61591894262,61591894244,-18,2436,1239,-30
61598721786,61598721785,-1,1488,2066,-30
61599111236,61599111241,5,1821,1447,-30
61599949462,61599949469,7,2159,1011,-30
61611152869,61611152871,2,2367,1386,-30
61612339441,61612339445,4,2468,1377,-30
61619144254,61619144258,4,1504,1522,-30
61622731034,61622731038,4,1267,840,-30
61624502755,61624502762,7,2486,1109,-30
61626321766,61626321746,-20,839,157,-30
61635886939,61635886944,5,2762,2007,-30
61641022697,61641022700,3,1792,1246,-30
61644074302,61644074309,7,2722,1700,-30
61649651102,61649651105,3,2129,1491,-30
61651590442,61651590446,4,2382,1315,-30
61652939691,61652939698,7,1713,1204,-30
61655584688,61655584693,5,1297,1206,-30
61658208453,61658208457,4,2652,1443,-30
61662746031,61662746035,4,1853,1356,-30
61664611051,61664611055,4,1606,1119,-30
61668289926,61668289932,6,2447,1451,-30
61671198096,61671198097,1,1575,1308,-30
61671989294,61671989294,0,4965,5475,-30
61672043453,61672043456,3,1525,1067,-30
61672630719,61672630725,6,1832,1114,-30
61672720985,61672720984,-1,520,418,-30
61675325374,61675325378,4,2591,1437,-30
61676699165,61676699170,5,3198,1096,-30
61677440458,61677440458,0,621,27,-30
61685719571,61685719577,6,3173,1470,-30
61691172618,61691172623,5,3169,1770,-30
61691537125,61691537132,7,2910,1182,-30
61691798130,61691798135,5,2858,1302,-30
61692946658,61692946663,5,1891,1221,-30
61694935741,61694935746,5,1304,899,-30
61695357862,61695357869,7,2777,962,-30
61705873508,61705873512,4,1875,1719,-30
61712896021,61712896026,5,2354,1245,-30
61716039209,61716039214,5,2810,1514,-30
61716265805,61716265809,4,2852,1572,-30
61717226964,61717226974,10,120,931,-30
61718771788,61718771792,4,1990,1002,-30
61720077206,61720077205,-1,2124,2962,-30
61721356058,61721356058,0,1385,2028,-30
61722472605,61722472610,5,2901,1208,-30
61723124682,61723124686,4,2030,1003,-30
61724280812,61724280818,6,2180,879,-30
61724314641,61724314647,6,2108,1378,-30
61732088871,61732088883,12,1082,212,-30
61734025223,61734025218,-5,940,2530,-30
61735258880,61735258885,5,1775,1321,-30
61736979055,61736979061,6,2242,1026,-30
61738959717,61738959722,5,2375,1396,-30
61740432217,61740432221,4,2064,1421,-30
61745477033,61745477038,5,2929,1842,-30
61747468102,61747468095,-7,1233,6718,-30
61752223442,61752223447,5,1711,1107,-30
61754365836,61754365829,-7,1034,4647,-30
61756497762,61756497766,4,2050,1368,-30
61763099179,61763099181,2,1293,1154,-30
61767479379,61767479382,3,1642,1269,-30
61767531215,61767531217,2,2251,1892,-30
61768314887,61768314896,9,2005,1465,-30
61770551691,61770551695,4,2517,1405,-30
61772663140,61772663142,2,1777,1076,-30
61772760842,61772760843,1,945,263,-30
61774691007,61774691012,5,2097,1735,-30
61776401211,61776401216,5,1857,1096,-30
61779238356,61779238362,6,1809,1383,-30
61782207513,61782207514,1,1741,1780,-30
61782794586,61782794591,5,2243,1113,-30
61785747670,61785747677,7,1986,1867,-30
61786841150,61786841151,1,1677,1136,-30
61790721811,61790721812,1,1726,1811,-30
61792840761,61792840753,-8,27247,16165,-30
61796351939,61796351936,-3,578,1141,-30
61801777854,61801777859,5,2021,1463,-30
61802248664,61802248670,6,2078,1416,-30
61803401647,61803401657,10,2545,1368,-30
61803495986,61803495989,3,1418,1476,-30
61803546171,61803546171,0,965,252,-30
61804766081,61804766087,6,2683,1679,-30
61809343675,61809343681,6,2961,1575,-30
61811605622,61811605620,-2,1319,2184,-30
61813995574,61813995579,5,1981,1079,-30
61814428586,61814428582,-4,1332,5156,-30
61820236700,61820236706,6,2529,1176,-30
61821312498,61821312502,4,2148,1527,-30
61823612644,61823612650,6,2643,1245,-30
61824320505,61824320509,4,1942,1136,-30
61826835099,61826835106,7,2939,994,-30
61827255554,61827255559,5,1994,1479,-30
61827439151,61827439151,0,1548,2401,-30
61831521136,61831521139,3,1844,1357,-30
61833292713,61833292718,5,1645,1232,-30
61836946378,61836946384,6,1213,674,-30
61839658683,61839658686,3,1953,1525,-30
61847084172,61847084177,5,2614,1152,-30
61849922416,61849922423,7,1041,688,-30
61853084170,61853084173,3,1839,851,-30
61857183988,61857183992,4,2151,1351,-30
61857232349,61857232353,4,1640,1713,-30
61866367134,61866367139,5,1755,1402,-30
61871046457,61871046461,4,2036,1543,-30
61873080740,61873080736,-4,23135,10419,-30
61874443249,61874443255,6,2358,1145,-30
61876054662,61876054666,4,2064,922,-30
61876410809,61876410814,5,2621,1250,-30
61879281630,61879281636,6,1944,1368,-30
61879586541,61879586546,5,1816,1199,-30
61881962882,61881962889,7,3681,1756,-30
61882649504,61882649509,5,2366,1307,-30
61883373704,61883373709,5,1241,871,-30
61886814769,61886814775,6,3124,1211,-30
61888657478,61888657483,5,1029,1151,-30
61888713130,61888713138,8,1415,1002,-30
61890326658,61890326663,5,2717,1077,-30
61890780851,61890780855,4,1992,1203,-30
61901025859,61901025854,-5,1399,5024,-30
61901190340,61901190343,3,1335,991,-30
61901748879,61901748889,10,842,265,-30
61902043678,61902043660,-18,842,207,-30
61905848314,61905848319,5,2577,1019,-30
61907708715,61907708721,6,1918,1212,-30
61910408226,61910408229,3,1991,1189,-30
61910981765,61910981769,4,1522,1170,-30
61911109804,61911109810,6,1928,1522,-30
61912071861,61912071865,4,3458,1137,-30
61917442103,61917442105,2,2624,2983,-30
61920486538,61920486544,6,1958,1490,-30
61923748945,61923748951,6,1479,1043,-30
61928755633,61928755639,6,1808,1214,-30
61930914907,61930914913,6,3968,2576,-30
61931639780,61931639787,7,2204,1328,-30
61935571770,61935571775,5,3155,1239,-30
61936679446,61936679454,8,2947,1332,-30
61936935216,61936935223,7,1795,1540,-30
61937617698,61937617699,1,1008,1687,-30
61938575493,61938575498,5,2034,1327,-30
61939990445,61939990449,4,2196,1362,-30
61942816309,61942816314,5,2122,796,-30
61945101122,61945101119,-3,1680,2361,-30
61946231135,61946231141,6,1204,1187,-30
61946892014,61946892019,5,1621,752,-30
61951713557,61951713561,4,2007,1231,-30
61952351330,61952351334,4,5840,4065,-30
61954856578,61954856582,4,2410,1216,-30
61958267449,61958267455,6,2850,1161,-30
61962320459,61962320464,5,1981,1207,-30
61966282178,61966282183,5,1944,1159,-30
61966571538,61966571538,0,2118,3288,-30
61966711801,61966711806,5,2344,1663,-30
61969313410,61969313404,-6,1235,4987,-30
61973169060,61973169065,5,2026,1157,-30
61973223134,61973223115,-19,1222,943,-30
61973832020,61973832026,6,2601,1338,-30
61979147377,61979147382,5,2211,1368,-30
61979905509,61979905515,6,1750,1381,-30
61983422759,61983422756,-3,988,3240,-30
61984374168,61984374173,5,2935,1187,-30
61986676606,61986676613,7,2874,1309,-30
61988315819,61988315822,3,2214,1154,-30
61989962803,61989962809,6,2685,1517,-30
61991786078,61991786083,5,2595,1121,-30
61992438618,61992438622,4,1458,1041,-30
61994858750,61994858755,5,1530,1245,-30
61995280571,61995280575,4,1794,1784,-30
62000426032,62000426034,2,2100,1509,-30
62000921926,62000921930,4,1764,1155,-30
62002211758,62002211763,5,2912,1970,-30
62004163909,62004163914,5,3091,1974,-30
62005550367,62005550371,4,2436,1693,-30
62007019348,62007019351,3,2927,1252,-30
62007061245,62007061227,-18,3124,1103,-30
62010493117,62010493123,6,2125,874,-30
62010615416,62010615420,4,2902,1312,-30
62013777335,62013777341,6,3254,1619,-30
62018419429,62018419432,3,1595,1063,-30
62024443473,62024443471,-2,3073,4796,-30
62024802898,62024802903,5,2829,2045,-30
62026271158,62026271163,5,1709,1799,-30
62026816585,62026816587,2,2738,1321,-30
62028327198,62028327194,-4,833,2160,-30
62028805679,62028805684,5,2240,1573,-30
62031011074,62031011079,5,1726,1186,-30
62038292534,62038292533,-1,1452,2674,-30
62038878118,62038878122,4,1761,1556,-30
62047981961,62047981968,7,1782,954,-30
62050108016,62050108020,4,1984,1089,-30
62052266558,62052266557,-1,1301,2177,-30
62054123329,62054123332,3,1808,1716,-30
62056904324,62056904329,5,2668,1445,-30
62057657801,62057657808,7,13856,5712,-30
62061128282,62061128290,8,2648,996,-30
62062819819,62062819822,3,1581,1428,-30
62064901869,62064901874,5,3064,1808,-30
62068957949,62068957955,6,1985,920,-30
62069178589,62069178594,5,2851,1891,-30
62069266078,62069266084,6,3114,1484,-30
62070593574,62070593578,4,2268,1453,-30
62071205762,62071205766,4,586,589,-30
62072376485,62072376490,5,2346,1422,-30
62072917541,62072917545,4,2207,1126,-30
62073852594,62073852580,-14,1192,847,-30
62074658987,62074658991,4,1921,975,-30
62076411605,62076411586,-19,2209,1110,-30
62079379974,62079379982,8,2635,1481,-30
62081467551,62081467554,3,1245,896,-30
62093231117,62093231121,4,2016,842,-30
62093948139,62093948144,5,2513,1390,-30
62095664441,62095664446,5,3142,2258,-30
62096261917,62096261923,6,2546,947,-30
62097197744,62097197747,3,2283,1524,-30
62098594654,62098594658,4,1558,736,-30
62099275140,62099275145,5,2366,1465,-30
62100422900,62100422905,5,3565,1928,-30
62101201461,62101201466,5,2895,1324,-30
62101805773,62101805780,7,2028,773,-30
62102821636,62102821641,5,2665,1205,-30
62103160565,62103160546,-19,1422,952,-30
62103381668,62103381682,14,1158,889,-30
62103732882,62103732888,6,2376,1345,-30
62106864025,62106864019,-6,1293,3714,-30
62107791450,62107791449,-1,1248,2108,-30
62108055261,62108055265,4,2006,1237,-30
62111500838,62111500842,4,1451,1121,-30
62114139715,62114139721,6,85527,42959,-30
62128736007,62128736011,4,1287,750,-30
62129852546,62129852550,4,3059,1637,-30
62130744191,62130744191,0,993,2539,-30
62134151282,62134151286,4,2178,1493,-30
62135394850,62135394854,4,1259,1100,-30
62137906751,62137906753,2,1631,2216,-30
62141386710,62141386717,7,2639,1086,-30
62141844677,62141844682,5,2801,1539,-30
62144556940,62144556945,5,2176,1175,-30
62144713679,62144713688,9,1056,278,-30
62145910678,62145910684,6,3122,1173,-30
62148381254,62148381258,4,1623,1169,-30
62150127558,62150127561,3,1989,1897,-30
62150987041,62150987046,5,1576,995,-30
62153824807,62153824790,-17,1297,790,-30
62155437117,62155437122,5,1932,1409,-30
62160343258,62160343263,5,2405,1313,-30
62161548761,62161548766,5,2739,1499,-30
62162162513,62162162519,6,1702,1341,-30
62162665179,62162665183,4,3046,1392,-30
62163898010,62163898002,-8,818,2866,-30
62172222680,62172222686,6,2891,1436,-30
62174586197,62174586202,5,2033,1171,-30
62176102185,62176102190,5,1681,943,-30
62178041573,62178041554,-19,3014,1457,-30
62178640439,62178640443,4,2233,1304,-30
62180837754,62180837761,7,3431,1424,-30
62181532003,62181532007,4,2207,965,-30
62182777436,62182777441,5,1826,1246,-30
62183797390,62183797395,5,2822,1964,-30
62187340878,62187340886,8,334,815,-30
62188450492,62188450472,-20,1505,981,-30
62190372209,62190372214,5,1900,1351,-30
62194466777,62194466782,5,2075,1786,-30
62195506194,62195506199,5,9518,3941,-30
62196712494,62196712499,5,2213,1681,-30
62202346674,62202346679,5,2172,1211,-30
62203434406,62203434411,5,2497,1290,-30
62204911755,62204911760,5,1653,1230,-30
62205856359,62205856364,5,2294,1187,-30
62206963839,62206963843,4,2633,1229,-30
62212572905,62212572913,8,2346,1238,-30
62215488501,62215488504,3,1938,2122,-30
62219226351,62219226357,6,1561,913,-30
62222167599,62222167600,1,1407,1588,-30
62222197951,62222197962,11,2062,1077,-30
62223468402,62223468406,4,1588,883,-30
62226366678,62226366683,5,1566,1135,-30
62228710346,62228710353,7,1474,1181,-30
62231046910,62231046915,5,2442,1378,-30
62231422442,62231422448,6,2039,1848,-30
62231775360,62231775367,7,2267,1159,-30
62232123058,62232123064,6,3372,1831,-30
62233217904,62233217908,4,2347,1623,-30
62233659071,62233659049,-22,1420,1045,-30
62234168333,62234168335,2,1805,1367,-30
62242786249,62242786253,4,3461,1247,-30
62243103510,62243103514,4,2762,987,-30
62249378210,62249378214,4,2111,1788,-30
62251291032,62251291037,5,1670,1512,-30
62251424330,62251424334,4,1297,1596,-30
62254699427,62254699413,-14,740,495,-30
62257375238,62257375242,4,1996,1027,-30
62257714482,62257714488,6,2676,1663,-30
62257849122,62257849116,-6,1625,6367,-30
62258794824,62258794827,3,2061,1315,-30
62259922498,62259922518,20,218,1885,-30
62264617182,62264617181,-1,1693,2937,-30
62270605489,62270605495,6,1418,1054,-30
62271760448,62271760453,5,2499,1434,-30
62273993380,62273993385,5,2072,905,-30
62274196730,62274196736,6,2066,1640,-30
62275562982,62275562987,5,2403,1466,-30
62276286767,62276286753,-14,668,546,-30
62277922556,62277922570,14,14881,6059,-30
62281742962,62281742967,5,2009,1542,-30
62283187995,62283187999,4,3583,1562,-30
62288278153,62288278157,4,1374,777,-30
62298962607,62298962612,5,1565,1061,-30
62304514438,62304514443,5,1213,872,-30
62305759038,62305759043,5,2189,1953,-30
62310344517,62310344522,5,2114,1432,-30
62310945605,62310945610,5,2731,1528,-30
62312245885,62312245891,6,1063,985,-30
62316282395,62316282399,4,2054,1368,-30
62316710737,62316710744,7,2293,1413,-30
62320505874,62320505879,5,2409,1344,-30
62321424576,62321424580,4,1646,723,-30
62324917854,62324917859,5,1865,1161,-30
62325024785,62325024789,4,2217,1375,-30
62326692159,62326692164,5,1738,1031,-30
62328941094,62328941098,4,2161,1296,-30
62339711725,62339711727,2,1255,918,-30
62344412320,62344412323,3,2168,1306,-30
62346367114,62346367119,5,1696,1482,-30
62348272116,62348272114,-2,1351,2762,-30
62361468360,62361468366,6,3096,1474,-30
62365889619,62365889623,4,2430,1948,-30
62367363778,62367363782,4,1795,1315,-30
62370585398,62370585403,5,1052,657,-30
62375898306,62375898311,5,2167,1195,-30
62381622395,62381622401,6,3142,1761,-30
62384688771,62384688775,4,2425,1580,-30
62387564083,62387564088,5,1536,1384,-30
62391497199,62391497205,6,2525,1102,-30
62394567658,62394567662,4,2256,1377,-30
62394972278,62394972282,4,2303,1350,-30
62400299664,62400299668,4,2417,1637,-30
62402173426,62402173430,4,1997,1405,-30
62402530507,62402530515,8,1038,930,-30
62405873319,62405873325,6,2751,1410,-30
62410011651,62410011655,4,2262,1336,-30
62413133440,62413133445,5,3466,1701,-30
62413694979,62413694982,3,1696,1285,-30
62424126649,62424126655,6,2267,1509,-30
62425124247,62425124248,1,2043,1952,-30
62429261535,62429261539,4,1908,1338,-30
62429487930,62429487936,6,2467,1088,-30
62430008803,62430008807,4,2719,1241,-30
62435326519,62435326526,7,2710,1317,-30
62439636706,62439636710,4,2396,1205,-30
62442846285,62442846290,5,2529,1169,-30
62447503495,62447503503,8,2724,656,-30
62448290788,62448290793,5,2162,1836,-30
62448702862,62448702867,5,2312,1620,-30
62449379549,62449379556,7,3156,1380,-30
62449741107,62449741111,4,45350,35749,-30
62450764845,62450764853,8,2342,1202,-30
62452978174,62452978179,5,1098,708,-30
62453867374,62453867379,5,2066,1420,-30
62456845683,62456845688,5,2817,1473,-30
62456956798,62456956786,-12,393,195,-30
62458197662,62458197666,4,2471,1840,-30
62459257158,62459257162,4,1703,873,-30
62459284849,62459284832,-17,2245,694,-30
62460837805,62460837810,5,2346,1615,-30
62468599814,62468599821,7,3209,1913,-30
62469992257,62469992260,3,1361,1024,-30
62474260262,62474260267,5,2617,1075,-30
62474862003,62474862007,4,1979,1484,-30
62478492154,62478492152,-2,1038,1660,-30
62487224010,62487224014,4,1971,1223,-30
62490554603,62490554607,4,2073,1329,-30
62490776557,62490776562,5,2290,1243,-30
62495320014,62495320019,5,3322,1193,-30
62499550233,62499550237,4,1713,1309,-30
62500036889,62500036894,5,2139,1143,-30
62505967570,62505967574,4,2597,1172,-30
62506835955,62506835962,7,2712,1282,-30
62512204929,62512204935,6,1926,1167,-30
62515082345,62515082349,4,1997,1199,-30
62515225427,62515225410,-17,1280,479,-30
62519058322,62519058326,4,1989,1378,-30
62519199842,62519199849,7,1994,1230,-30
62523859989,62523859993,4,1757,680,-30
62528760774,62528760779,5,2583,1250,-30
62529564284,62529564287,3,2622,1181,-30
62533861760,62533861766,6,2907,1480,-30
62534978313,62534978319,6,1653,1071,-30
62535148928,62535148932,4,2419,1265,-30
62535544114,62535544110,-4,992,3415,-30
62536901050,62536901046,-4,2461,5038,-30
62537316002,62537316007,5,2835,1110,-30
62537584223,62537584229,6,2399,1145,-30
62540260559,62540260564,5,2413,1504,-30
62546421626,62546421632,6,3675,1617,-30
62547001365,62547001370,5,2849,1612,-30
62547663745,62547663750,5,2862,1607,-30
62549327626,62549327605,-21,1083,918,-30
62549536623,62549536619,-4,1293,2746,-30
62550179546,62550179544,-2,1736,4195,-30
62554790942,62554790948,6,2743,1497,-30
62555046358,62555046361,3,1375,1195,-30
62555469216,62555469196,-20,815,617,-30
62561775690,62561775695,5,1746,1226,-30
62564052186,62564052195,9,10940,31603,-30
62569836765,62569836771,6,2007,1551,-30
62570296073,62570296077,4,2969,1870,-30
62574917958,62574917964,6,2842,836,-30
62575287365,62575287370,5,2549,1065,-30
62577145619,62577145625,6,2839,1248,-30
62582251954,62582251958,4,2638,1190,-30
62582668785,62582668790,5,2429,1443,-30
62583200117,62583200122,5,2146,1272,-30
62583727286,62583727291,5,2289,1304,-30
62584047491,62584047498,7,3518,1366,-30
62589018082,62589018086,4,2560,1606,-30
62590613566,62590613573,7,2610,1208,-30
62593421965,62593421970,5,9144,4192,-30
62596588059,62596588046,-13,1758,700,-30
62599749854,62599749859,5,2004,1087,-30
62600641438,62600641442,4,2447,911,-30
62600710575,62600710586,11,1960,1111,-30
62603402059,62603402063,4,2462,1246,-30
62609270822,62609270830,8,2247,1241,-30
62610660394,62610660399,5,3196,1674,-30
62611294750,62611294754,4,1333,874,-30
62614684475,62614684481,6,1891,1452,-30
62615727525,62615727530,5,2519,1567,-30
62619555730,62619555735,5,1332,878,-30
62620958505,62620958511,6,2521,1533,-30
62628972578,62628972585,7,2635,1641,-30
62629712365,62629712369,4,2478,1122,-30
62630410698,62630410703,5,2563,984,-30
62630441295,62630441302,7,1682,1404,-30
62631483910,62631483915,5,1973,1047,-30
62632318808,62632318814,6,3185,1254,-30
62633749653,62633749658,5,2504,1549,-30
62635647274,62635647279,5,1990,1402,-30
62638053560,62638053565,5,3024,1336,-30
62638153730,62638153712,-18,1969,1330,-30
62639277231,62639277230,-1,2390,4702,-30
62641661112,62641661119,7,2810,1571,-30
62643652201,62643652202,1,18179,21514,-30
62643861301,62643861307,6,1656,1084,-30
62647165402,62647165407,5,2531,1313,-30
62648476323,62648476327,4,2762,1011,-30
62648806220,62648806200,-20,2462,1441,-30
62649235202,62649235208,6,1846,1235,-30
62651244399,62651244403,4,2782,1110,-30
62651638534,62651638538,4,1937,1262,-30
62652684173,62652684178,5,3855,1247,-30
62652809633,62652809631,-2,1455,3272,-30
62653158715,62653158721,6,2693,2152,-30
62653690557,62653690562,5,2029,1248,-30
62654621381,62654621386,5,1676,762,-30
62654709618,62654709636,18,2497,1298,-30
62658311165,62658311170,5,1468,1057,-30
62659276366,62659276370,4,2282,1273,-30
62659466994,62659467002,8,1365,1052,-30
62663295257,62663295262,5,1851,1592,-30
62666549360,62666549364,4,2209,1395,-30
62666784667,62666784681,14,2384,1159,-30
62668568005,62668568009,4,2141,1314,-30
62673887140,62673887137,-3,22194,9262,-30
62677210506,62677210511,5,2433,1008,-30
62682853817,62682853823,6,2934,1909,-30
62687507820,62687507826,6,3375,1154,-30
62688859690,62688859695,5,2241,1419,-30
62689515167,62689515174,7,2068,1430,-30
62690779483,62690779465,-18,2272,1092,-30
62694022161,62694022164,3,2347,1422,-30
62694212497,62694212501,4,1903,941,-30
62695200733,62695200747,14,1931,935,-30
62695855792,62695855799,7,2297,1067,-30
62697956498,62697956504,6,1337,1321,-30
62698966399,62698966376,-23,1222,195,-30
62701927945,62701927942,-3,632,1636,-30
62703797127,62703797133,6,2323,1468,-30
62707804328,62707804334,6,1940,1015,-30
62709570928,62709570933,5,2236,1926,-30
62711949084,62711949094,10,203,597,-30
62715317078,62715317085,7,2915,1420,-30
62715754833,62715754817,-16,1832,935,-30
62716699987,62716699984,-3,1514,2587,-30
62717659715,62717659710,-5,1926,4542,-30
62724097340,62724097341,1,1685,1654,-30
62727733941,62727733947,6,2648,1701,-30
62729459888,62729459893,5,2373,1308,-30
62730356842,62730356845,3,1632,1336,-30
62731571814,62731571820,6,1979,1742,-30
62732019655,62732019661,6,4260,1789,-30
62733287230,62733287232,2,1202,1442,-30
62734768173,62734768177,4,1854,1817,-30
62739603904,62739603902,-2,2348,4744,-30
62741341291,62741341297,6,3044,1768,-30
62742959513,62742959514,1,1579,1883,-30
62745179608,62745179613,5,2384,1698,-30
62745857060,62745857065,5,2311,1520,-30
62746556786,62746556796,10,2093,1038,-30
62747521614,62747521618,4,2641,1460,-30
62747690288,62747690294,6,2287,1063,-30
62750292788,62750292793,5,2547,1286,-30
62752538297,62752538298,1,2293,1587,-30
62758241426,62758241431,5,2202,1092,-30
62759070421,62759070426,5,2032,1021,-30
62762058105,62762058107,2,1406,1317,-30
62764075782,62764075785,3,1918,1080,-30
62764925601,62764925605,4,2574,1184,-30
62771365054,62771365059,5,2191,1015,-30
62772254505,62772254510,5,2534,1058,-30
62776181523,62776181525,2,2620,1643,-30
62776680201,62776680205,4,2131,1090,-30
62776912215,62776912220,5,1921,859,-30
62777254684,62777254689,5,2542,1184,-30
62777354423,62777354426,3,2115,1694,-30
62777528683,62777528687,4,2415,1721,-30
62778497549,62778497554,5,2830,1130,-30
62784062381,62784062377,-4,99,1938,-30
62784742737,62784742742,5,2850,1353,-30
62786231527,62786231530,3,1680,1735,-30
62788036526,62788036531,5,1028,904,-30
62788946850,62788946854,4,2804,1209,-30
62789424584,62789424589,5,1420,1089,-30
62789607294,62789607296,2,1275,1790,-30
62790283259,62790283259,0,760,1254,-30
62790465258,62790465263,5,1097,716,-30
62792380084,62792380090,6,3220,1828,-30
62800073802,62800073806,4,2442,1452,-30
62801494006,62801494012,6,1853,1157,-30
62801589803,62801589806,3,1614,1055,-30
62802787809,62802787814,5,3357,1985,-30
62805145622,62805145626,4,1816,1288,-30
62806237857,62806237865,8,2778,1501,-30
62806384956,62806384963,7,933,214,-30
62806704788,62806704794,6,2048,1491,-30
62819986114,62819986121,7,2686,1220,-30
62821932333,62821932338,5,2040,1122,-30
62823462207,62823462211,4,1985,1182,-30
62826781962,62826781966,4,2559,1651,-30
62827660413,62827660419,6,2197,1419,-30
62828459555,62828459562,7,2473,1183,-30
62829701093,62829701095,2,1725,1341,-30
62840729063,62840729064,1,1688,2117,-30
62843948146,62843948151,5,3412,1430,-30
62847109397,62847109397,0,1664,1584,-30
62849129795,62849129802,7,2744,1283,-30
62850222346,62850222350,4,1497,670,-30
62854118776,62854118782,6,2581,1167,-30
62860590746,62860590752,6,1583,1143,-30
62864487909,62864487913,4,3086,1545,-30
62867650126,62867650105,-21,2157,1263,-30
62869406273,62869406277,4,5082,3487,-30
62870399482,62870399486,4,2687,1337,-30
62870961002,62870961008,6,2886,1773,-30
62871954389,62871954395,6,1945,959,-30
62872945427,62872945432,5,2044,1362,-30
62883462479,62883462485,6,2864,1831,-30
62885096931,62885096935,4,2160,1341,-30
62888670513,62888670517,4,2671,1569,-30
62890575010,62890575015,5,2171,1137,-30
62892138299,62892138303,4,2385,1471,-30
62894509046,62894509048,2,2344,2533,-30
62895771118,62895771122,4,2353,1443,-30
62896420137,62896420140,3,29478,78132,-30
62896448119,62896448123,4,1592,1338,-30
62899676447,62899676455,8,2351,1898,-30
62903078919,62903078917,-2,8959,15868,-30
62903248817,62903248822,5,2146,1000,-30
62906878615,62906878618,3,2263,1469,-30
62907657268,62907657249,-19,1928,887,-30
62914747554,62914747561,7,3140,1646,-30
62916883838,62916883844,6,2124,1366,-30
62919184893,62919184899,6,2606,1590,-30
62919863891,62919863883,-8,24306,12156,-30
62920747513,62920747517,4,2111,1476,-30
62922790349,62922790354,5,2111,1147,-30
62924032373,62924032377,4,2090,1107,-30
62931076746,62931076738,-8,6347,13825,-30
62931309238,62931309242,4,1616,830,-30
62931954883,62931954886,3,2439,1562,-30
62933112406,62933112410,4,3204,1571,-30
62939020346,62939020354,8,3297,1311,-30
62942842174,62942842179,5,3073,1363,-30
62943151094,62943151101,7,2696,1252,-30
62944572079,62944572074,-5,1515,7630,-30
62945880094,62945880097,3,1565,1673,-30
62947141449,62947141454,5,2762,853,-30
62948938933,62948938938,5,1564,1185,-30
62955852329,62955852333,4,2090,968,-30
62956232497,62956232502,5,2294,1160,-30
62956988589,62956988595,6,2406,1135,-30
62957981051,62957981056,5,1916,1207,-30
62960712691,62960712696,5,3186,1451,-30
62961237124,62961237129,5,2007,1219,-30
62963349791,62963349806,15,624,2140,-30
62963398129,62963398130,1,886,1074,-30
62968224342,62968224343,1,1765,2258,-30
62979961297,62979961303,6,2128,1346,-30
62982992873,62982992879,6,3278,1506,-30
62983071025,62983071030,5,2516,1595,-30
62983347145,62983347149,4,1690,1748,-30
62983562766,62983562770,4,2359,952,-30
62983917355,62983917359,4,2036,974,-30
62989282229,62989282232,3,1995,1387,-30
62995361007,62995361011,4,2087,1390,-30
62996313271,62996313257,-14,1260,521,-30
62996387085,62996387090,5,3172,2080,-30
62998521185,62998521190,5,1605,932,-30
62998736358,62998736363,5,2935,1276,-30
63001074360,63001074365,5,2442,1994,-30
63006319313,63006319317,4,2387,1505,-30
63008070561,63008070567,6,3177,2047,-30
63008293004,63008293009,5,2343,993,-30
63009893319,63009893325,6,1247,520,-30
63010561369,63010561374,5,1903,1492,-30
63011722077,63011722083,6,1929,1345,-30
63014765682,63014765688,6,2654,1506,-30
63021410886,63021410891,5,3181,1457,-30
63023399954,63023399959,5,2178,1086,-30
63029359090,63029359094,4,1869,1453,-30
63040162059,63040162063,4,2499,1744,-30
63041982757,63041982763,6,2114,1529,-30
63053294255,63053294260,5,2766,1494,-30
63053705045,63053705050,5,2088,1237,-30
63054231749,63054231729,-20,1216,235,-30
63056595857,63056595859,2,1319,805,-30
63061228678,63061228682,4,2981,1941,-30
63065107197,63065107203,6,2596,1224,-30
63066631296,63066631301,5,1964,1223,-30
63067296522,63067296526,4,2228,981,-30
63068765010,63068765014,4,1231,578,-30
63068875737,63068875739,2,2166,1134,-30
63072542925,63072542929,4,3101,1758,-30
63073182780,63073182783,3,2546,1428,-30
63077215999,63077216005,6,1549,981,-30
63080718642,63080718638,-4,1215,3575,-30
63084598340,63084598350,10,15577,40933,-30
63087230724,63087230728,4,1431,1560,-30
63090839163,63090839167,4,1981,1110,-30
63091591327,63091591333,6,1726,1099,-30
63097665988,63097665994,6,2004,1372,-30
63102568818,63102568824,6,3869,1790,-30
63104440849,63104440855,6,1931,1369,-30
63104950367,63104950366,-1,1137,1769,-30
63107863510,63107863514,4,1830,1094,-30
63111211001,63111211001,0,1229,1359,-30
63113437965,63113437970,5,2022,1098,-30
63117886032,63117886035,3,2584,1495,-30
63117923372,63117923352,-20,1868,810,-30
63122190049,63122190054,5,2939,1784,-30
63125387393,63125387398,5,1742,1026,-30
63127161424,63127161430,6,2910,1235,-30
63130224714,63130224721,7,2663,1425,-30
63134939088,63134939092,4,1955,1251,-30
63139185089,63139185094,5,1538,967,-30
63139233322,63139233305,-17,1907,1138,-30
63139725654,63139725662,8,3604,1313,-30
63139795433,63139795438,5,1758,910,-30
63140116815,63140116821,6,1338,762,-30
63141241663,63141241674,11,372,7,-30
63147472308,63147472314,6,2414,1089,-30
63148616021,63148616025,4,2269,1177,-30
63149785174,63149785181,7,1842,1534,-30
63152269892,63152269897,5,3021,1603,-30
63157385653,63157385654,1,2178,1373,-30
63159065459,63159065463,4,1944,1297,-30
63159395463,63159395467,4,1694,988,-30
63160731861,63160731867,6,2021,1666,-30
63161298513,63161298518,5,2824,1392,-30
63163788086,63163788091,5,1125,1038,-30
63167255213,63167255218,5,2906,1198,-30
63169121666,63169121670,4,2417,986,-30
63169705766,63169705770,4,2497,1171,-30
63173734105,63173734110,5,2666,1018,-30
63174862281,63174862285,4,1655,1078,-30
63175399790,63175399795,5,1254,581,-30
63179986625,63179986630,5,2278,1061,-30
63180397729,63180397728,-1,1154,2037,-30
63180940404,63180940405,1,9517,8839,-30
63182008691,63182008694,3,1439,1258,-30
63184556780,63184556781,1,1301,944,-30
63186356386,63186356391,5,88,358,-30
63187474716,63187474721,5,2352,1569,-30
63187842966,63187842971,5,2102,1377,-30
63187981726,63187981730,4,1429,1335,-30
63188513818,63188513823,5,1739,1075,-30
63189295715,63189295719,4,2496,1661,-30
63189637566,63189637570,4,2041,1064,-30
63190660502,63190660509,7,2264,1701,-30
63193761891,63193761908,17,14615,44413,-30
63193809679,63193809684,5,2685,1293,-30
63197049337,63197049342,5,2199,1333,-30
63199206880,63199206885,5,1702,813,-30
63200881181,63200881188,7,6714,2724,-30
63202542490,63202542493,3,1789,1631,-30
63203762098,63203762104,6,3144,1306,-30
63205979291,63205979295,4,1066,485,-30
63206237939,63206237944,5,2097,1573,-30
63207010845,63207010847,2,1775,1547,-30
63208438598,63208438602,4,1672,1178,-30
63208877171,63208877170,-1,1736,2500,-30
63210034826,63210034830,4,1973,1224,-30
63210333989,63210333989,0,7410,8175,-30
63211713620,63211713625,5,2793,1275,-30
63212036178,63212036163,-15,467,419,-30
63212308409,63212308413,4,2124,1107,-30
63221378362,63221378368,6,2397,1233,-30
63221874013,63221873993,-20,1630,883,-30
63223228372,63223228378,6,2702,765,-30
63223301080,63223301085,5,2208,1046,-30
63223985275,63223985275,0,9145,12230,-30
63224361586,63224361591,5,2165,1316,-30
63224984390,63224984394,4,2586,1333,-30
63225182137,63225182138,1,2669,1821,-30
63226336268,63226336274,6,2891,1544,-30
63228970505,63228970509,4,2747,1403,-30
63231201927,63231201942,15,894,298,-30
63231527173,63231527178,5,1857,970,-30
63232531449,63232531454,5,1778,1195,-30
63232716387,63232716393,6,3266,1498,-30
63236665959,63236665954,-5,834,3135,-30
63240057725,63240057730,5,1802,1071,-30
63247843238,63247843245,7,2175,924,-30
63248261366,63248261347,-19,1399,523,-30
63248735517,63248735523,6,1867,1063,-30
63249870278,63249870282,4,2117,1532,-30
63251776813,63251776813,0,1577,2661,-30
63260453114,63260453109,-5,1603,4916,-30
63261685945,63261685942,-3,108,871,-30
63262919527,63262919533,6,2423,1381,-30
63263394089,63263394092,3,2861,1342,-30
63264369677,63264369681,4,2469,1290,-30
63264397847,63264397834,-13,920,310,-30
63265563418,63265563422,4,2958,1289,-30
63266400690,63266400693,3,1765,1366,-30
63267120302,63267120308,6,3538,1745,-30
63268873014,63268873017,3,1435,1204,-30
63269968157,63269968174,17,2078,880,-30
63270348210,63270348215,5,2210,1731,-30
63271460042,63271460047,5,1802,1068,-30
63272199625,63272199633,8,2560,1509,-30
63272520081,63272520085,4,1469,1225,-30
63275109714,63275109727,13,18279,25187,-30
63278856518,63278856523,5,1840,1198,-30
63280836242,63280836246,4,2082,1364,-30
63281591263,63281591269,6,1734,1084,-30
63283854325,63283854318,-7,1765,5530,-30
63285438829,63285438836,7,2999,1074,-30
63285860197,63285860201,4,2519,1359,-30
63287191881,63287191886,5,2010,1410,-30
63289484425,63289484429,4,2538,1137,-30
63292057945,63292057950,5,2854,1934,-30
63298681627,63298681631,4,1528,1245,-30
63299263855,63299263860,5,2535,1392,-30
63302083193,63302083198,5,2007,1222,-30
63306394245,63306394248,3,2222,966,-30
63309976465,63309976467,2,1794,1216,-30
63310575743,63310575747,4,2620,1451,-30
63310974314,63310974316,2,1552,1947,-30
63316181680,63316181677,-3,1482,2103,-30
63316268450,63316268456,6,1871,1048,-30
63318766076,63318766071,-5,910,2749,-30
63318885197,63318885203,6,2122,1526,-30
63319755035,63319755039,4,2211,1192,-30
63322542517,63322542521,4,1605,1541,-30
63326019076,63326019061,-15,1214,1687,-30
63327034052,63327034057,5,1353,892,-30
63331010072,63331010078,6,1573,1149,-30
63333776488,63333776489,1,1491,1133,-30
63334361759,63334361762,3,1267,1166,-30
63336558321,63336558325,4,1935,1098,-30
63338112111,63338112118,7,2365,1577,-30
63338262640,63338262644,4,2043,1786,-30
63338764868,63338764873,5,2065,1015,-30
63344645087,63344645089,2,2025,865,-30
63345629153,63345629159,6,2572,1096,-30
63347437313,63347437319,6,1916,1125,-30
63348442502,63348442506,4,3982,3438,-30
63350321909,63350321914,5,3232,1527,-30
63354251725,63354251710,-15,1625,4234,-30
63357767138,63357767133,-5,1161,3228,-30
63363049918,63363049922,4,1569,1137,-30
63364479580,63364479585,5,1858,1247,-30
63364767377,63364767368,-9,495,410,-30
63370146998,63370147004,6,2494,1414,-30
63373318274,63373318279,5,2298,1427,-30
63378051656,63378051660,4,2180,1283,-30
63381618480,63381618487,7,2921,1729,-30
63382830708,63382830714,6,2737,1195,-30
63383134015,63383134003,-12,1009,616,-30
63383580799,63383580805,6,2168,1346,-30
63387925714,63387925718,4,2285,1295,-30
63388572530,63388572534,4,2556,1344,-30
63391084070,63391084077,7,3658,1681,-30
63392476419,63392476427,8,905,682,-30
63394344362,63394344367,5,2128,1042,-30
63394857117,63394857123,6,1004,830,-30
63398504457,63398504463,6,1929,1266,-30
63400592809,63400592814,5,2117,1497,-30
63402404506,63402404511,5,2304,1583,-30
63403579793,63403579798,5,2113,1195,-30
63408578579,63408578585,6,2386,1435,-30
63409048445,63409048447,2,1750,1033,-30
63413313560,63413313566,6,3811,1935,-30
63414846816,63414846821,5,1145,886,-30
63415383486,63415383491,5,2031,1154,-30
63415432905,63415432911,6,1586,1048,-30
63419565089,63419565094,5,2415,1917,-30
63421530628,63421530634,6,2117,917,-30
63421864070,63421864070,0,7244,19930,-30
63423910423,63423910421,-2,1165,2507,-30
63424920362,63424920374,12,11035,44208,-30
63426320210,63426320212,2,940,539,-30
63430093194,63430093199,5,1922,1396,-30
63430457309,63430457313,4,1476,1065,-30
63431255055,63431255062,7,2216,1083,-30
63431511178,63431511164,-14,1842,1674,-30
63435058404,63435058425,21,2258,897,-30
63435885247,63435885252,5,2536,1438,-30
63436323800,63436323805,5,2695,1116,-30
63441280476,63441280483,7,1818,1323,-30
63444812540,63444812545,5,1910,1057,-30
63447634646,63447634650,4,1821,1702,-30
63450667863,63450667865,2,1741,1513,-30
63451102901,63451102906,5,1599,976,-30
63453355575,63453355571,-4,986,3471,-30
63453770038,63453770036,-2,1212,2278,-30
63454432502,63454432484,-18,2599,1371,-30
63455114647,63455114654,7,2133,1455,-30
63457877420,63457877425,5,2054,1429,-30
63462453330,63462453335,5,1042,1185,-30
63463604175,63463604171,-4,2711,6809,-30
63466177172,63466177173,1,1578,1642,-30
63467651906,63467651910,4,2106,1544,-30
63473353826,63473353830,4,2296,1723,-30
63477440954,63477440959,5,3242,1845,-30
63478541486,63478541489,3,1779,1226,-30
63482540354,63482540359,5,2714,1278,-30
63484979405,63484979401,-4,597,1444,-30
63486331251,63486331258,7,1368,447,-30
63488557388,63488557390,2,2667,1572,-30
63488762673,63488762677,4,1828,1147,-30
63494691477,63494691482,5,3050,1869,-30
63497519810,63497519815,5,1886,924,-30
63499351745,63499351747,2,2300,1353,-30
63500211283,63500211290,7,3436,1463,-30
63502723529,63502723534,5,2120,1381,-30
63502766186,63502766191,5,2471,1464,-30
63503362485,63503362489,4,1926,1140,-30
63503951118,63503951137,19,1878,1009,-30
63508520286,63508520286,0,2318,2679,-30
63509075725,63509075727,2,1375,1266,-30
63515746518,63515746524,6,2018,1622,-30
63516666110,63516666115,5,3209,1827,-30
63517534886,63517534891,5,2753,1308,-30
63524379473,63524379478,5,3093,1428,-30
63526836026,63526836030,4,2108,1650,-30
63529780701,63529780706,5,1812,1251,-30
63531853294,63531853299,5,2614,1317,-30
63533037126,63533037146,20,2754,1250,-30
63536434119,63536434123,4,3160,1730,-30
63539571748,63539571753,5,1995,1080,-30
63543039636,63543039641,5,2460,1499,-30
63546629434,63546629440,6,2552,1039,-30
63546902518,63546902518,0,1817,1878,-30
63546974543,63546974549,6,2484,1471,-30
63548272687,63548272692,5,3130,1335,-30
63553614322,63553614327,5,2904,1334,-30
63554642421,63554642422,1,2016,1894,-30
63561300281,63561300287,6,2451,1344,-30
63562165284,63562165287,3,1458,1290,-30
63562477648,63562477653,5,3114,1369,-30
63567695487,63567695491,4,1158,764,-30
63570517117,63570517122,5,2630,1133,-30
63571671320,63571671324,4,1983,997,-30
63572833782,63572833787,5,2467,1453,-30
63572873160,63572873168,8,2172,1098,-30
63573233243,63573233249,6,2373,1542,-30
63575361657,63575361661,4,1672,1426,-30
63576174585,63576174578,-7,29137,13505,-30
63577166340,63577166346,6,1995,808,-30
63589604891,63589604897,6,1919,1797,-30
63594035652,63594035657,5,1311,582,-30
63595242450,63595242455,5,2314,1354,-30
63595641386,63595641391,5,2316,1124,-30
63597015126,63597015131,5,2487,1083,-30
63598559574,63598559579,5,2268,1612,-30
63600775605,63600775610,5,2312,901,-30
63601819498,63601819502,4,1213,969,-30
63603976336,63603976346,10,13991,21199,-30
63606041657,63606041663,6,2210,1185,-30
63606641431,63606641429,-2,1413,3301,-30
63610646647,63610646652,5,2071,1511,-30
63612752176,63612752183,7,2374,1250,-30
63614699573,63614699595,22,762,298,-30
63614988880,63614988886,6,2342,1055,-30
63616907287,63616907292,5,2402,1209,-30
63617423565,63617423571,6,2452,1042,-30
63618250762,63618250768,6,1897,1014,-30
63618439791,63618439768,-23,866,235,-30
63618987058,63618987043,-15,2364,924,-30
63624566597,63624566602,5,1778,1488,-30
63626650149,63626650148,-1,1774,2776,-30
63627424729,63627424733,4,2596,1506,-30
63633668968,63633668972,4,2113,1364,-30
63634703724,63634703730,6,2023,801,-30
63636359191,63636359197,6,2044,1306,-30
63637533733,63637533734,1,1316,1763,-30
63639085882,63639085886,4,1948,1309,-30
63639803391,63639803398,7,2344,1382,-30
63642851373,63642851378,5,1847,1470,-30
63643270457,63643270461,4,1485,977,-30
63644198330,63644198333,3,1340,1096,-30
63646454742,63646454747,5,1206,871,-30
63648081277,63648081281,4,1651,1200,-30
63648686901,63648686906,5,3012,1426,-30
63648966214,63648966194,-20,2263,1188,-30
63653444271,63653444277,6,1691,1128,-30
63655161646,63655161650,4,2694,1251,-30
63655574350,63655574354,4,2651,1201,-30
63657863077,63657863081,4,2422,1714,-30
63663788301,63663788309,8,1806,1192,-30
63667137368,63667137373,5,1960,1557,-30
63668349622,63668349627,5,2827,1563,-30
63672476343,63672476349,6,2764,1374,-30
63676101023,63676101027,4,1763,1154,-30
63684569086,63684569092,6,3010,1295,-30
63685897883,63685897888,5,2493,1868,-30
63690386959,63690386964,5,2859,1390,-30
63692504910,63692504914,4,2850,980,-30
63693234089,63693234097,8,5747,1770,-30
63694268780,63694268787,7,2084,1122,-30
63696681513,63696681517,4,2903,1497,-30
63697188091,63697188098,7,2911,1509,-30
63697792269,63697792270,1,1562,1687,-30
63699106134,63699106138,4,2739,1356,-30
63701932295,63701932299,4,1935,1521,-30
63702211109,63702211114,5,2042,880,-30
63703990685,63703990689,4,1854,1428,-30
63705945090,63705945095,5,2761,1264,-30
63706933780,63706933785,5,1440,1109,-30
63710570386,63710570391,5,1313,812,-30
63713656437,63713656442,5,1929,1558,-30
63718203423,63718203428,5,2332,1625,-30
63723029399,63723029405,6,2309,1311,-30
63723735071,63723735076,5,2419,1510,-30
63725246507,63725246514,7,3978,1768,-30
63728277848,63728277851,3,2304,1762,-30
63728963325,63728963330,5,3080,1715,-30
63735861889,63735861895,6,2087,1045,-30
63739678338,63739678341,3,3205,1292,-30
63743038378,63743038383,5,2071,1346,-30
63743970923,63743970927,4,2000,1349,-30
63745215115,63745215122,7,2460,1395,-30
63758406781,63758406786,5,1637,1598,-30
63758591996,63758592002,6,1758,1497,-30
63759512798,63759512802,4,1585,1096,-30
63760736354,63760736360,6,2188,815,-30
63763629709,63763629713,4,1724,1418,-30
63764677566,63764677570,4,2302,1118,-30
63765366014,63765366014,0,1607,2024,-30
63765809029,63765809034,5,2934,1402,-30
63769611446,63769611453,7,1752,901,-30
63774519481,63774519487,6,2486,1276,-30
63774713341,63774713348,7,1305,1077,-30
63779473373,63779473379,6,2528,1017,-30
63779607046,63779607041,-5,1041,2888,-30
63781567311,63781567317,6,2699,1291,-30
63785544930,63785544935,5,3378,1513,-30
63785787685,63785787690,5,2234,1353,-30
63786444645,63786444650,5,2195,1507,-30
63790880655,63790880661,6,2811,1365,-30
63791414745,63791414746,1,2528,2606,-30
63792445352,63792445356,4,3236,1792,-30
63796170686,63796170690,4,2883,1627,-30
63797967295,63797967288,-7,17275,54560,-30
63798669777,63798669776,-1,60747,48411,-30
63799147204,63799147211,7,2163,34322,-30
63801045635,63801045631,-4,61,587,-30
63801416555,63801416560,5,3176,1981,-30
63807532598,63807532602,4,1778,1342,-30
63808524182,63808524182,0,1670,1999,-30
63810282428,63810282433,5,2581,1558,-30
63811202622,63811202613,-9,1175,13835,-30
63815186393,63815186399,6,2805,1455,-30
63816558628,63816558632,4,2213,1361,-30
63816977458,63816977462,4,1898,1445,-30
63818125338,63818125343,5,2023,836,-30
63819360479,63819360482,3,1943,1252,-30
63819882506,63819882510,4,1423,1094,-30
63821196758,63821196762,4,1873,1296,-30
63826543406,63826543410,4,2035,943,-30
63828681298,63828681303,5,3313,1893,-30
63831559778,63831559783,5,1631,1182,-30
63834678403,63834678409,6,2497,1351,-30
63839036782,63839036788,6,2254,1337,-30
63842707429,63842707433,4,2167,1301,-30
63843530474,63843530478,4,2638,1193,-30
63845442160,63845442163,3,1697,1028,-30
63855887100,63855887104,4,3031,1183,-30
63861939674,63861939678,4,1513,796,-30
63862005446,63862005453,7,2921,1627,-30
63865644514,63865644519,5,2194,1309,-30
63871417277,63871417281,4,2024,1276,-30
63878922019,63878922023,4,2048,1667,-30
63880564265,63880564262,-3,1399,1681,-30
63881349334,63881349339,5,1793,1503,-30
63882775209,63882775210,1,1544,1946,-30
63885062827,63885062829,2,1551,2057,-30
63886963706,63886963711,5,2085,1283,-30
63887912354,63887912361,7,1782,1012,-30
63890822501,63890822506,5,2732,1442,-30
63893269157,63893269161,4,2639,1177,-30
63894388458,63894388463,5,1854,1094,-30
63899585783,63899585790,7,2001,1222,-30
63908137694,63908137699,5,3299,1499,-30
63910023031,63910023034,3,1423,1315,-30
63911748660,63911748667,7,2483,1248,-30
63912120259,63912120264,5,2962,1844,-30
63912840603,63912840609,6,2025,993,-30
63913731664,63913731669,5,2139,1709,-30
63915361779,63915361783,4,2672,1604,-30
63915457101,63915457081,-20,1264,567,-30
63916758979,63916758983,4,2213,1257,-30
63918749675,63918749680,5,1921,1020,-30
63919446752,63919446754,2,1330,1355,-30
63923961843,63923961847,4,2825,2343,-30
63925211591,63925211594,3,2461,1277,-30
63926060579,63926060583,4,1323,888,-30
63926495494,63926495499,5,1818,1122,-30
63927629154,63927629157,3,2014,1808,-30
63928562765,63928562768,3,1315,1010,-30
63929903400,63929903406,6,2343,1319,-30
63932612573,63932612577,4,2035,1383,-30
63933319665,63933319671,6,1662,892,-30
63939143827,63939143816,-11,687,529,-30
63943088782,63943088787,5,1203,629,-30
63943272416,63943272421,5,2183,1261,-30
63949360586,63949360593,7,1958,984,-30
63952664638,63952664643,5,1788,1533,-30
63956373324,63956373329,5,2228,1003,-30
63956835914,63956835921,7,3023,906,-30
63957695982,63957695983,1,1422,1192,-30
63957973668,63957973673,5,2365,1021,-30
63959839380,63959839384,4,1942,1147,-30
63960543086,63960543092,6,2115,1125,-30
63961708139,63961708122,-17,814,509,-30
63968499423,63968499427,4,1212,1076,-30
63970372595,63970372579,-16,2374,1172,-30
63970435862,63970435881,19,2545,1433,-30
63972726997,63972727001,4,2039,1417,-30
63973290397,63973290403,6,1934,1489,-30
63977328292,63977328298,6,2028,1224,-30
63978660198,63978660202,4,3115,1425,-30
63978809581,63978809587,6,2040,869,-30
63980273253,63980273258,5,1890,1150,-30
63980496277,63980496262,-15,1137,944,-30
63983423503,63983423509,6,2438,1261,-30
63986764125,63986764130,5,1650,857,-30
63990072390,63990072395,5,1498,805,-30
63990577187,63990577192,5,2594,1960,-30
63994011577,63994011585,8,1845,1230,-30
63996429146,63996429150,4,2904,1958,-30
63997165109,63997165114,5,2010,1503,-30
63997705599,63997705602,3,2750,1562,-30
63997781755,63997781763,8,3887,1573,-30
64004218966,64004218970,4,2028,1096,-30
64005425486,64005425491,5,2281,1351,-30
64007341734,64007341740,6,1671,826,-30
64010354953,64010354957,4,2219,1118,-30
64010600415,64010600400,-15,732,345,-30
64012801724,64012801732,8,11611,43139,-30
64013154743,64013154746,3,1628,1113,-30
64014185143,64014185149,6,2637,1250,-30
64016328963,64016328971,8,2229,1159,-30
64018251778,64018251780,2,1293,1320,-30
64024399146,64024399151,5,2336,1493,-30
64025646219,64025646218,-1,24383,19001,-30
64026064534,64026064537,3,1220,1017,-30
64030225489,64030225496,7,2300,1561,-30
64031019449,64031019445,-4,1395,1134,-30
64031527778,64031527785,7,1950,1509,-30
64034844122,64034844129,7,1621,1040,-30
64035564347,64035564351,4,2701,1317,-30
64035944165,64035944169,4,1655,1091,-30
64036518969,64036518974,5,2603,1222,-30
64038057228,64038057233,5,2290,1168,-30
64039012161,64039012158,-3,852,1982,-30
64039116902,64039116905,3,1654,1511,-30
64047737277,64047737282,5,2090,1210,-30
64049789048,64049789053,5,1574,1002,-30
64051612210,64051612214,4,2269,1511,-30
64054105289,64054105292,3,2144,1254,-30
64054179806,64054179811,5,1804,1305,-30
64055958652,64055958658,6,2545,988,-30
64059049218,64059049223,5,1994,990,-30
64062389375,64062389380,5,2289,1774,-30
64063172961,64063172964,3,1743,1116,-30
64063341141,64063341146,5,3923,1957,-30
64063801342,64063801347,5,1874,1493,-30
64065744376,64065744381,5,1458,1029,-30
64068023565,64068023570,5,1707,922,-30
64069034481,64069034485,4,2698,1323,-30
64074224638,64074224645,7,2702,1024,-30
64077704751,64077704755,4,2077,1385,-30
64081204698,64081204700,2,1743,1566,-30
64081570199,64081570203,4,2422,1108,-30
64083057037,64083057042,5,2922,1712,-30
64083110156,64083110161,5,3364,1327,-30
64084603051,64084603056,5,2803,1736,-30
64084871466,64084871472,6,2334,1235,-30
64085073579,64085073578,-1,754,1686,-30
64085314001,64085314006,5,2649,1060,-30
64087524452,64087524457,5,2260,1114,-30
64088569506,64088569510,4,2148,1597,-30
64088704727,64088704733,6,2539,1457,-30
64089911065,64089911085,20,365,1699,-30
64091419944,64091419946,2,1482,980,-30
64091447958,64091447959,1,1218,1370,-30
64092952927,64092952932,5,1892,1440,-30
64093299665,64093299670,5,2909,1338,-30
64094456498,64094456497,-1,1311,1266,-30
64095511811,64095511815,4,2229,1374,-30
64097443838,64097443842,4,1551,964,-30
64097754253,64097754258,5,2491,1522,-30
64099353226,64099353228,2,16923,14612,-30
64101422639,64101422646,7,3933,1780,-30
64102996653,64102996632,-21,1721,979,-30
64105494316,64105494321,5,2767,1506,-30
64105782465,64105782480,15,1029,268,-30
64109279573,64109279578,5,2426,1617,-30
64111483166,64111483170,4,1328,1126,-30
64114045979,64114045983,4,2195,1209,-30
64114089207,64114089213,6,3339,1336,-30
64126341787,64126341793,6,2405,1203,-30
64129064410,64129064414,4,1923,902,-30
64129834020,64129834015,-5,1237,4198,-30
64141523787,64141523793,6,2335,1615,-30
64142421993,64142422000,7,2032,1371,-30
64142651656,64142651658,2,1830,1779,-30
64142861885,64142861890,5,2087,1160,-30
64144161267,64144161271,4,2503,1563,-30
64157971120,64157971130,10,10950,40807,-30
64159028809,64159028814,5,2379,1080,-30
64159311410,64159311414,4,2349,1097,-30
64165086979,64165086984,5,2142,1161,-30
64167609647,64167609649,2,2091,1461,-30
64167993834,64167993838,4,2461,1666,-30
64168768066,64168768068,2,1611,982,-30
64169471663,64169471667,4,1968,1307,-30
64172589891,64172589897,6,2953,1761,-30
64172820390,64172820393,3,3539,2721,-30
64173354153,64173354158,5,2402,1140,-30
64177655782,64177655786,4,3438,1681,-30
64177758694,64177758700,6,2323,1736,-30
64179155411,64179155415,4,1667,1152,-30
64180975325,64180975330,5,2118,1277,-30
64185752541,64185752547,6,2270,1612,-30
64187738614,64187738610,-4,1473,5646,-30
64188602657,64188602659,2,1330,1146,-30
64191757230,64191757235,5,3300,1687,-30
64191817003,64191817008,5,1582,1493,-30
64194593255,64194593253,-2,1007,1732,-30
64195490367,64195490370,3,1490,987,-30
64198499047,64198499054,7,2501,1634,-30
64206919295,64206919298,3,2393,1047,-30
64208846119,64208846128,9,39658,11140,-30
64210533834,64210533842,8,3330,1510,-30
64210613631,64210613637,6,2443,1320,-30
64212225497,64212225504,7,1194,917,-30
64216093395,64216093399,4,1336,504,-30
64216288669,64216288674,5,2306,1287,-30
64217726226,64217726230,4,1585,1127,-30
64218557455,64218557462,7,1613,1018,-30
64219403358,64219403363,5,2781,1204,-30
64226906197,64226906203,6,2690,1251,-30
64229164229,64229164210,-19,1617,1081,-30
64229936974,64229936980,6,2414,1116,-30
64230744518,64230744522,4,2428,1826,-30
64231185143,64231185147,4,1368,1799,-30
64231271923,64231271929,6,3200,1774,-30
64231521068,64231521072,4,2482,1453,-30
64232176546,64232176553,7,3070,1165,-30
64232993942,64232993947,5,1632,1141,-30
64233791087,64233791092,5,2102,1509,-30
64251614837,64251614841,4,1647,1169,-30
64253967612,64253967617,5,2727,1611,-30
64259569996,64259570005,9,10953,33898,-30
64259877561,64259877566,5,2845,1265,-30
64261562579,64261562586,7,3601,2024,-30
64261950296,64261950301,5,2186,1280,-30
64265203916,64265203922,6,1927,966,-30
64265481752,64265481755,3,1717,1037,-30
64266336269,64266336273,4,1449,1273,-30
64267246507,64267246503,-4,778,181,-30
64269718387,64269718393,6,2018,1173,-30
64271629287,64271629291,4,1699,1065,-30
64271979841,64271979859,18,1455,1122,-30
64272551664,64272551668,4,1293,381,-30
64276070277,64276070280,3,2083,1648,-30
64277525753,64277525758,5,2568,1412,-30
64281814046,64281814053,7,2702,1418,-30
64282357257,64282357264,7,2106,1321,-30
64284512165,64284512169,4,1602,865,-30
64290653161,64290653167,6,4895,1988,-30
64291287950,64291287961,11,12588,47264,-30
64292622253,64292622259,6,2282,1441,-30
64297692418,64297692423,5,1853,1078,-30
64298252593,64298252597,4,1311,1193,-30
64304384722,64304384729,7,1968,1139,-30
64308607769,64308607774,5,3042,1444,-30
64308936237,64308936241,4,1562,1575,-30
64309657309,64309657314,5,1987,996,-30
64313111749,64313111753,4,2245,1422,-30
64315267982,64315267985,3,2393,1808,-30
64319686679,64319686684,5,2276,1229,-30
64319847734,64319847735,1,879,425,-30
64321197584,64321197591,7,2319,1381,-30
64325235305,64325235305,0,2012,1906,-30
64327879854,64327879861,7,1600,1201,-30
64328218764,64328218767,3,1368,1012,-30
64330624381,64330624387,6,2264,1373,-30
64331889476,64331889482,6,1833,1250,-30
64333744871,64333744856,-15,1369,663,-30
64336125246,64336125253,7,1833,1384,-30
64337428765,64337428770,5,2503,1104,-30
64337756544,64337756549,5,1661,1022,-30
64342831148,64342831151,3,2165,857,-30
64343990118,64343990123,5,1699,1241,-30
64346078774,64346078778,4,2090,1324,-30
64350840710,64350840715,5,3004,1395,-30
64352095622,64352095602,-20,2387,1483,-30
64359897808,64359897814,6,2181,1086,-30
64363546179,64363546184,5,2768,1577,-30
64364343229,64364343233,4,2007,1335,-30
64366968792,64366968797,5,1865,1028,-30
64367509981,64367509987,6,2968,1176,-30
64369426978,64369426985,7,2188,1515,-30
64370042639,64370042642,3,1834,1657,-30
64370212101,64370212106,5,3168,1748,-30
64380441265,64380441267,2,1771,1282,-30
64381379470,64381379476,6,2539,1541,-30
64384060977,64384060983,6,2618,812,-30
64391139953,64391139957,4,2102,1340,-30
64391871313,64391871317,4,2104,1477,-30
64393134325,64393134317,-8,831,4228,-30
64393340450,64393340456,6,1723,929,-30
64395231591,64395231595,4,1449,1342,-30
64398846716,64398846719,3,2113,1117,-30
64401332302,64401332307,5,1981,1012,-30
64403950983,64403950987,4,2473,1822,-30
64404805778,64404805782,4,2118,1304,-30
64408893525,64408893531,6,1631,1150,-30
64409092057,64409092062,5,1415,766,-30
64414256142,64414256148,6,2778,1736,-30
64414990445,64414990425,-20,854,916,-30
64416488173,64416488171,-2,1429,2228,-30
64421171879,64421171879,0,2824,3615,-30
64422067296,64422067301,5,1693,1160,-30
64429424542,64429424547,5,2001,1419,-30
64430030250,64430030234,-16,771,332,-30
64432876098,64432876103,5,2288,1647,-30
64434837555,64434837559,4,2147,1382,-30
64437443594,64437443598,4,2804,1727,-30
64437786893,64437786899,6,1948,1678,-30
64437869798,64437869803,5,1693,812,-30
64441686533,64441686539,6,2099,1604,-30
64441802337,64441802339,2,1131,277,-30
64443653321,64443653326,5,2244,1283,-30
64452358513,64452358519,6,1591,841,-30
64453423466,64453423474,8,1970,1423,-30
64453467235,64453467242,7,2784,1185,-30
64455220363,64455220369,6,2008,1023,-30
64455583714,64455583721,7,1339,1071,-30
64456436529,64456436512,-17,883,341,-30
64460051421,64460051427,6,2881,1226,-30
64461579740,64461579747,7,3183,1333,-30
64461769807,64461769811,4,2093,1208,-30
64462746926,64462746930,4,1871,1128,-30
64464812674,64464812681,7,2262,1236,-30
64465798033,64465798039,6,1941,1561,-30
64466859740,64466859744,4,2893,1547,-30
64468141599,64468141599,0,1353,1348,-30
64468338083,64468338089,6,2683,1472,-30
64468837969,64468837976,7,15877,31585,-30
64472523281,64472523285,4,2241,1375,-30
64474806177,64474806185,8,3643,1613,-30
64475472985,64475472991,6,2782,974,-30
64478173491,64478173497,6,2488,1630,-30
64479484086,64479484092,6,2058,1044,-30
64479754646,64479754650,4,1421,1163,-30
64480612356,64480612361,5,1663,1509,-30
64484938658,64484938663,5,3055,1911,-30
64487976150,64487976154,4,1616,922,-30
64493282463,64493282466,3,1748,1161,-30
64494557326,64494557332,6,1970,1247,-30
64494624120,64494624127,7,2009,1319,-30
64494763857,64494763861,4,3018,1816,-30
64496748018,64496748022,4,3167,1335,-30
64497065439,64497065443,4,2203,1421,-30
64503654949,64503654952,3,1918,1710,-30
64503885534,64503885539,5,2006,1278,-30
64504329495,64504329499,4,1742,931,-30
64512625009,64512625013,4,2085,1572,-30
64516485386,64516485389,3,2232,1247,-30
64518620642,64518620648,6,1796,1415,-30
64519496519,64519496524,5,1909,1673,-30
64520589394,64520589400,6,3573,1752,-30
64525205878,64525205883,5,1956,1442,-30
64526417508,64526417513,5,2248,1475,-30
64527247451,64527247457,6,2820,1752,-30
64527809204,64527809210,6,3076,1457,-30
64530188076,64530188080,4,2054,1802,-30
64530275898,64530275903,5,2865,1238,-30
64530369312,64530369328,16,1525,1347,-30
64531931242,64531931237,-5,1795,3507,-30
64532691401,64532691407,6,3182,1542,-30
64537528049,64537528054,5,2944,1152,-30
64541370863,64541370867,4,2790,1235,-30
64542303619,64542303623,4,2382,1160,-30
64552214115,64552214119,4,2531,1332,-30
64557347403,64557347408,5,1953,1120,-30
64560055939,64560055944,5,1758,1369,-30
64560163602,64560163586,-16,2035,1063,-30
64560910034,64560910030,-4,4389,13773,-30
64561179798,64561179802,4,1723,1204,-30
64564991302,64564991306,4,2800,1518,-30
64565055968,64565055972,4,2239,1055,-30
64565798541,64565798547,6,1521,1133,-30
64568447610,64568447615,5,3107,2262,-30
64569029982,64569029986,4,1819,1133,-30
64569374506,64569374511,5,2216,1548,-30
64573556969,64573556973,4,1970,1078,-30
64574158099,64574158097,-2,1074,1939,-30
64575081623,64575081627,4,1314,1711,-30
64575946470,64575946470,0,1689,1626,-30
64576119902,64576119907,5,1836,933,-30
64577811493,64577811514,21,2736,1843,-30
64581102608,64581102613,5,2084,1485,-30
64582785989,64582785994,5,2067,1137,-30
64583761708,64583761713,5,1932,1648,-30
64586907446,64586907450,4,1554,1647,-30
64593330465,64593330469,4,1932,1115,-30
64593484906,64593484912,6,2816,1466,-30
64593708340,64593708346,6,2379,953,-30
64593854400,64593854404,4,2847,2293,-30
64597569213,64597569220,7,2645,1679,-30
64598289132,64598289137,5,2677,1596,-30
64600011442,64600011448,6,3452,1716,-30
64601901630,64601901637,7,2796,1273,-30
64611573155,64611573161,6,2153,1217,-30
64612015550,64612015554,4,1848,1296,-30
64614492532,64614492533,1,1603,1584,-30
64619740141,64619740147,6,1313,918,-30
64622325642,64622325647,5,2104,1471,-30
64625012162,64625012170,8,1702,1435,-30
64625092878,64625092882,4,2560,1680,-30
64628146930,64628146936,6,2801,1479,-30
64628619814,64628619819,5,1866,882,-30
64628712626,64628712627,1,937,166,-30
64633176110,64633176114,4,1784,1522,-30
64634656346,64634656350,4,2441,2210,-30
64638106759,64638106763,4,2308,1026,-30
64638434230,64638434228,-2,5382,17207,-30
64638500529,64638500534,5,2270,1259,-30
64642365890,64642365895,5,2594,1385,-30
64643220810,64643220803,-7,935,5156,-30
64647282879,64647282874,-5,1524,6044,-30
64647430741,64647430746,5,2545,1536,-30
64652429102,64652429106,4,2163,1277,-30
64653145622,64653145622,0,949,1489,-30
64653269951,64653269962,11,2770,1029,-30
64654742391,64654742395,4,2277,1078,-30
64661788222,64661788226,4,1752,1340,-30
64664217938,64664217943,5,1754,1102,-30
64667222831,64667222836,5,2023,1330,-30
64669524921,64669524927,6,2211,1349,-30
64670283341,64670283346,5,1873,1973,-30
64671468523,64671468528,5,3290,1876,-30
64673286463,64673286466,3,1983,1017,-30
64675348506,64675348511,5,2301,1357,-30
64675727413,64675727418,5,2712,1408,-30
64677457983,64677457987,4,2638,1098,-30
64678677417,64678677421,4,1958,1063,-30
64681869802,64681869797,-5,704,1878,-30
64691323123,64691323127,4,1724,1387,-30
64695948021,64695948026,5,3228,1274,-30
64696623067,64696623073,6,2282,946,-30
64698883452,64698883433,-19,1087,912,-30
64700083966,64700083971,5,2746,1073,-30
64703158157,64703158162,5,1790,890,-30
64703831397,64703831402,5,1322,1041,-30
64709549652,64709549657,5,2015,1193,-30
64710449215,64710449215,0,881,1437,-30
64710786761,64710786767,6,1991,1053,-30
64711811609,64711811614,5,2236,1334,-30
64719309461,64719309465,4,2223,1458,-30
64720768890,64720768898,8,1684,688,-30
64721219037,64721219017,-20,1147,920,-30
64721918387,64721918392,5,2405,1517,-30
64730786106,64730786092,-14,1015,472,-30
64733194525,64733194529,4,1846,841,-30
64735124992,64735124997,5,3113,1312,-30
64739313281,64739313287,6,3310,1361,-30
64739619490,64739619494,4,1803,1233,-30
64739761822,64739761821,-1,1215,2398,-30
64741551465,64741551470,5,2711,1638,-30
64742828835,64742828838,3,1450,777,-30
64743916058,64743916062,4,2062,1359,-30
64748395564,64748395569,5,2061,1551,-30
64748560463,64748560470,7,1610,774,-30
64752914330,64752914337,7,1977,1155,-30
64756363908,64756363914,6,1978,1391,-30
64756499711,64756499718,7,3244,861,-30
64757862157,64757862165,8,2852,1306,-30
64758705525,64758705530,5,2198,1294,-30
64759013877,64759013883,6,2438,1005,-30
64761440246,64761440233,-13,1123,401,-30
64761867338,64761867334,-4,1244,2611,-30
64763882938,64763882943,5,2403,1229,-30
64768786629,64768786634,5,2376,1414,-30
64769432295,64769432300,5,1320,1040,-30
64769881310,64769881306,-4,1950,5270,-30
64771262112,64771262114,2,16652,1859,-30
64771461404,64771461386,-18,1926,1080,-30
64774140922,64774140924,2,1815,1584,-30
64781353965,64781353962,-3,1849,2807,-30
64785503216,64785503222,6,2427,1211,-30
64786345085,64786345086,1,1991,1165,-30
64795401870,64795401875,5,3087,1950,-30
64796052430,64796052436,6,1550,981,-30
64799594945,64799594948,3,1684,1291,-30
64799770426,64799770410,-16,1287,478,-30
64800344614,64800344619,5,1774,1279,-30
64800714825,64800714829,4,2639,1167,-30
64801351662,64801351669,7,2006,1279,-30
64803776099,64803776103,4,1560,1098,-30
64807613841,64807613850,9,2309,794,-30
64808773738,64808773743,5,2309,1405,-30
64810055177,64810055183,6,3147,1415,-30
64810267268,64810267261,-7,1737,8238,-30
64810853047,64810853054,7,1674,921,-30
64812793433,64812793438,5,2877,1195,-30
64813589699,64813589682,-17,1734,593,-30
64816506886,64816506890,4,1901,1035,-30
64821130178,64821130183,5,2557,1758,-30
64821860301,64821860307,6,2581,1363,-30
64822318275,64822318278,3,1837,936,-30
64822662302,64822662307,5,1669,1229,-30
64823278039,64823278028,-11,2813,825,-30
64824988017,64824988019,2,1975,1530,-30
64829607095,64829607099,4,1968,1363,-30
64836488387,64836488393,6,3270,1610,-30
64837341810,64837341815,5,2181,1065,-30
64839029785,64839029787,2,1494,1126,-30
64840898663,64840898669,6,2821,1407,-30
64842023834,64842023839,5,3879,1481,-30
64842543634,64842543642,8,2475,1265,-30
64843398853,64843398858,5,1675,1028,-30
64844543686,64844543688,2,1906,981,-30
64846191330,64846191336,6,1996,1202,-30
64846403926,64846403931,5,1819,856,-30
64846682780,64846682786,6,2120,1575,-30
64849400639,64849400644,5,2708,1227,-30
64850022670,64850022675,5,1921,1488,-30
64850192406,64850192411,5,2644,1165,-30
64851236611,64851236616,5,2557,1389,-30
64857513113,64857513119,6,967,688,-30
64858288305,64858288291,-14,3415,1112,-30
64859414818,64859414823,5,1860,1375,-30
64861218143,64861218147,4,2737,1317,-30
64864206768,64864206775,7,4054,1625,-30
64868362450,64868362456,6,1054,1705,-30
64875294074,64875294078,4,3156,1417,-30
64878961033,64878961037,4,1930,1423,-30
64883364903,64883364907,4,1584,1256,-30
64883754654,64883754659,5,3510,1605,-30
64884520763,64884520767,4,2499,1126,-30
64897711625,64897711629,4,2510,1598,-30
64897870910,64897870918,8,3833,1561,-30
64903745081,64903745086,5,2226,1709,-30
64903809798,64903809802,4,2804,1574,-30
64905427038,64905427039,1,2221,1528,-30
64905583157,64905583164,7,1398,756,-30
64905918146,64905918128,-18,1279,872,-30
64908659326,64908659331,5,3088,1418,-30
64920459060,64920459053,-7,2702,10172,-30
64923094477,64923094481,4,2436,1340,-30
64927233979,64927233984,5,2226,1818,-30
64928567194,64928567199,5,2596,1250,-30
64928745425,64928745429,4,1474,1248,-30
64936285665,64936285671,6,1604,1390,-30
64940071288,64940071290,2,2623,1407,-30
64940388743,64940388747,4,1919,1393,-30
64943224130,64943224133,3,2672,1768,-30
64947335941,64947335947,6,2318,1748,-30
64948496603,64948496610,7,4580,1195,-30
64949568630,64949568637,7,7201,2568,-30
64951396204,64951396207,3,109,1393,-30
64951743746,64951743751,5,2199,1275,-30
64956133733,64956133738,5,2067,1317,-30
64959007193,64959007197,4,2633,1280,-30
64959054589,64959054596,7,2330,1118,-30
64960063286,64960063291,5,2297,1621,-30
64961489155,64961489153,-2,1769,2672,-30
64963096489,64963096494,5,1922,1062,-30
64964157392,64964157397,5,2080,1349,-30
64965811623,64965811628,5,2126,1127,-30
64965909157,64965909137,-20,1486,1205,-30
64965978118,64965978106,-12,551,65,-30
64966084242,64966084244,2,1021,1192,-30
64967160411,64967160415,4,1327,1133,-30
64969079315,64969079322,7,2600,1790,-30
64970389479,64970389483,4,2566,1349,-30
64973051346,64973051350,4,2782,1595,-30
64975512142,64975512147,5,1513,718,-30
64976771741,64976771746,5,2833,1425,-30
64982846370,64982846375,5,1992,1175,-30
64983650080,64983650086,6,2514,990,-30
64986134621,64986134625,4,1655,1305,-30
64986766585,64986766569,-16,1708,1574,-30
64989430501,64989430507,6,3071,1348,-30
64991535545,64991535551,6,1626,957,-30
64992788984,64992788989,5,2641,1878,-30
64994132987,64994132992,5,1839,1086,-30
64998827266,64998827271,5,2630,1168,-30
65007362676,65007362684,8,2305,1939,-30
65007405637,65007405643,6,3363,1534,-30
65007882533,65007882529,-4,788,1968,-30
65009092303,65009092308,5,1877,1024,-30
65009540013,65009540024,11,1917,1180,-30
65011892288,65011892292,4,1859,1052,-30
65015517174,65015517170,-4,3271,4859,-30
65015884587,65015884594,7,2147,1429,-30
65022057592,65022057596,4,2069,1732,-30
65022212369,65022212374,5,2347,924,-30
65027516993,65027516999,6,2414,1900,-30
65033671306,65033671313,7,2904,1294,-30
65033929985,65033929982,-3,1676,1771,-30
65034497418,65034497422,4,2067,1102,-30
65043304318,65043304326,8,2361,1019,-30
65043337858,65043337851,-7,1123,305,-30
65045553533,65045553539,6,1200,981,-30
65045690017,65045690022,5,1786,1099,-30
65048751464,65048751475,11,84,637,-30
65050743930,65050743935,5,2923,2660,-30
65052873472,65052873476,4,1965,1476,-30
65056005997,65056005991,-6,1713,6253,-30
65056746173,65056746178,5,1570,892,-30
65059474630,65059474636,6,2103,1349,-30
65065524919,65065524914,-5,22016,13531,-30
65067097862,65067097867,5,2427,1056,-30
65067284046,65067284053,7,2553,1490,-30
65069366987,65069366993,6,3285,2004,-30
65082378997,65082379002,5,2234,1496,-30
65082483528,65082483533,5,1203,893,-30
65084773021,65084773026,5,1807,1345,-30
65087550787,65087550792,5,2703,1807,-30
65089932910,65089932914,4,2202,1759,-30
65093207854,65093207858,4,2175,1201,-30
65093322191,65093322188,-3,968,2942,-30
65100612154,65100612161,7,2577,1348,-30
65102796554,65102796557,3,2286,1595,-30
65104344767,65104344770,3,2715,1627,-30
65105602879,65105602883,4,2493,1427,-30
65105959294,65105959298,4,2306,1282,-30
65109145878,65109145883,5,2449,974,-30
65112921330,65112921335,5,2539,1138,-30
65116015846,65116015853,7,1979,1449,-30
65117997887,65117997890,3,2255,1172,-30
65124388647,65124388656,9,1627,1207,-30
65124793338,65124793321,-17,1623,1160,-30
65124925653,65124925658,5,1522,999,-30
65126832901,65126832906,5,2353,1071,-30
65132078272,65132078278,6,2320,1341,-30
65133047166,65133047172,6,2023,1842,-30
65134081094,65134081096,2,2424,2452,-30
65138417149,65138417154,5,3039,1504,-30
65138585599,65138585610,11,1743,1115,-30
65140477546,65140477552,6,2517,1882,-30
65140823935,65140823918,-17,1875,799,-30
65142746697,65142746702,5,1528,962,-30
65146314842,65146314846,4,2103,1290,-30
65154779896,65154779900,4,2494,1737,-30
65156561870,65156561875,5,2452,1427,-30
65158533878,65158533881,3,2549,1630,-30
65159488021,65159488018,-3,1379,2399,-30
65160000851,65160000857,6,2065,1120,-30
65161804837,65161804841,4,2124,1152,-30
65162225926,65162225933,7,7607,3694,-30
65162584899,65162584906,7,2121,1362,-30
65162628199,65162628178,-21,2584,1250,-30
65165246469,65165246474,5,1013,760,-30
65166870790,65166870797,7,2122,1038,-30
65166911763,65166911763,0,1486,1444,-30
65167842169,65167842165,-4,1980,5793,-30
65168045266,65168045270,4,2052,1548,-30
65168248571,65168248575,4,2421,1195,-30
65169840357,65169840363,6,3223,1244,-30
65173641519,65173641523,4,1454,1192,-30
65179177002,65179177004,2,1782,1238,-30
65181988970,65181988976,6,2541,1269,-30
65192457211,65192457217,6,1278,1019,-30
65196768081,65196768083,2,1702,1784,-30
65206253790,65206253795,5,1879,1499,-30
65206695017,65206695025,8,2352,1344,-30
65207371098,65207371102,4,2313,1341,-30
65208044344,65208044349,5,2070,1574,-30
65208278894,65208278898,4,2207,1557,-30
65208514057,65208514059,2,1384,976,-30
65210915537,65210915523,-14,997,660,-30
65211002440,65211002421,-19,59,3663,-30
65211935982,65211935987,5,2536,1616,-30
65213175979,65213175985,6,3554,1464,-30
65214345046,65214345051,5,2108,1187,-30
65216130612,65216130614,2,2099,1510,-30
65216164974,65216164952,-22,1962,1584,-30
65216398705,65216398706,1,1766,1552,-30
65217205877,65217205883,6,2373,1155,-30
65217374421,65217374429,8,2037,1363,-30
65218454670,65218454675,5,1365,825,-30
65221984202,65221984206,4,2089,1301,-30
65222881650,65222881658,8,2886,1391,-30
65223245818,65223245826,8,2291,1015,-30
65225048642,65225048645,3,2553,1566,-30
65226382678,65226382683,5,2167,1604,-30
65227006602,65227006599,-3,1216,2689,-30
65231076737,65231076741,4,2311,1476,-30
65232178124,65232178130,6,2136,986,-30
65238082398,65238082404,6,1963,1249,-30
65238236779,65238236785,6,1813,1623,-30
65238515711,65238515715,4,2069,1390,-30
65241061114,65241061119,5,2726,1796,-30
65245312045,65245312055,10,74,1279,-30
65247268254,65247268258,4,2178,1362,-30
65259367517,65259367519,2,1732,1376,-30
65261822957,65261822961,4,1587,871,-30
65268472907,65268472912,5,2734,1598,-30
65270240888,65270240895,7,2452,1252,-30
65271099688,65271099673,-15,3152,1307,-30
65273738810,65273738810,0,1392,1115,-30
65281749403,65281749408,5,2668,1806,-30
65285504464,65285504470,6,2207,1218,-30
65289631222,65289631226,4,1927,1470,-30
65290398215,65290398219,4,1875,1597,-30
65291407084,65291407087,3,2101,1564,-30
65293301418,65293301415,-3,1215,1315,-30
65295599455,65295599436,-19,1057,617,-30
65296240561,65296240578,17,174,2026,-30
65296488429,65296488432,3,1833,1101,-30
65302854939,65302854945,6,3455,1799,-30
65308766271,65308766276,5,2002,1072,-30
65318731423,65318731429,6,2367,1474,-30
65320679821,65320679830,9,2029,1043,-30
65320838382,65320838393,11,2453,1041,-30
65320951006,65320951011,5,1705,1436,-30
65321663859,65321663863,4,1711,1093,-30
65324070342,65324070346,4,1846,1054,-30
65327006300,65327006305,5,2310,926,-30
65327883197,65327883201,4,3147,1959,-30
65331747795,65331747799,4,2253,1667,-30
65333133866,65333133870,4,3475,1366,-30
65337161659,65337161662,3,1442,1472,-30
65338537607,65338537613,6,2376,1519,-30
65339303930,65339303948,18,1190,1489,-30
65342635170,65342635180,10,2494,1482,-30
65344383678,65344383683,5,1992,1715,-30
65353273163,65353273161,-2,1238,2696,-30
65353505617,65353505622,5,2139,1353,-30
65355312974,65355312974,0,2120,2223,-30
65356989671,65356989676,5,3046,1277,-30
65361880065,65361880072,7,2986,1506,-30
65362554445,65362554451,6,1379,1059,-30
65365205498,65365205503,5,2242,1116,-30
65367000547,65367000553,6,2533,1190,-30
65373579218,65373579222,4,1141,872,-30
65376568753,65376568757,4,2750,1079,-30
65377086119,65377086122,3,1958,1877,-30
65382003286,65382003291,5,2435,1624,-30
65387056473,65387056478,5,1415,1093,-30
65391332391,65391332395,4,2396,1619,-30
65393064796,65393064799,3,1906,1417,-30
65393370521,65393370526,5,2395,1169,-30
65393412426,65393412433,7,2775,2231,-30
65394033288,65394033291,3,1941,1228,-30
65396213436,65396213441,5,2751,1456,-30
65397428951,65397428958,7,3235,1310,-30
65398463184,65398463188,4,2529,1466,-30
65399847986,65399847990,4,2122,1181,-30
65401174625,65401174629,4,1924,1381,-30
65401331481,65401331466,-15,2290,1344,-30
65412166807,65412166812,5,2923,1506,-30
65412863281,65412863286,5,1935,1435,-30
65413498003,65413498009,6,1514,1221,-30
65416293015,65416293014,-1,2597,5056,-30
65416571635,65416571639,4,1558,863,-30
65416857302,65416857306,4,1951,1070,-30
65417604226,65417604209,-17,1416,494,-30
65419204405,65419204411,6,2078,1180,-30
65419606054,65419606058,4,1839,1202,-30
65420372937,65420372942,5,1619,1271,-30
65421489397,65421489401,4,2886,1880,-30
65426466316,65426466323,7,4602,1917,-30
65426740559,65426740566,7,1479,775,-30
65431881109,65431881115,6,2524,1334,-30
65432866954,65432866959,5,2018,1121,-30
65437650844,65437650849,5,1708,721,-30
65438314470,65438314474,4,1358,1219,-30
65439217775,65439217781,6,2150,1573,-30
65439686250,65439686254,4,2377,1014,-30
65441606227,65441606231,4,1669,660,-30
65443799770,65443799776,6,1843,1276,-30
65446302324,65446302329,5,1855,1148,-30
65446327473,65446327457,-16,1838,945,-30
65448960710,65448960708,-2,1434,1125,-30
65449026070,65449026075,5,1796,1031,-30
65451325853,65451325858,5,2742,1119,-30
65451502181,65451502186,5,1689,746,-30
65453197124,65453197129,5,1272,830,-30
65456213926,65456213933,7,1493,972,-30
65456627537,65456627541,4,2634,1322,-30
65458292115,65458292121,6,2776,1494,-30
65458566678,65458566657,-21,1322,913,-30
65459715936,65459715941,5,1859,1155,-30
65460559680,65460559686,6,1351,997,-30
65462105826,65462105831,5,2282,1230,-30
65463543453,65463543457,4,1442,1032,-30
65464575512,65464575517,5,2582,1885,-30
65465056526,65465056529,3,2036,1294,-30
65466993468,65466993471,3,2152,1984,-30
65471899550,65471899555,5,1867,1212,-30
65473308821,65473308824,3,1678,1341,-30
65478964294,65478964299,5,1268,849,-30
65482306137,65482306142,5,2306,942,-30
65482786860,65482786865,5,2714,1677,-30
65483719793,65483719786,-7,3443,13825,-30
65484788554,65484788558,4,1653,1256,-30
65485360811,65485360816,5,1065,740,-30
65486905984,65486905988,4,1707,1090,-30
65490105180,65490105183,3,2300,1333,-30
65491717210,65491717217,7,2676,990,-30
65493238689,65493238693,4,2687,1614,-30
65494298765,65494298765,0,2682,4609,-30
65497682172,65497682177,5,3038,1681,-30
65499374258,65499374256,-2,1300,2017,-30
65500943589,65500943593,4,3893,3123,-30
65505733451,65505733458,7,1941,1500,-30
65506921474,65506921479,5,1792,1581,-30
65510745434,65510745441,7,1354,1045,-30
65510904457,65510904462,5,1917,1162,-30
65512387293,65512387298,5,2592,1387,-30
65513036913,65513036919,6,2520,1277,-30
65517544957,65517544961,4,2550,1134,-30
65520470223,65520470222,-1,1028,2057,-30
65521596601,65521596605,4,2200,1113,-30
65523598759,65523598765,6,2300,1440,-30
65523625310,65523625314,4,2303,1568,-30
65526696801,65526696806,5,2030,1466,-30
65526964804,65526964807,3,2689,1536,-30
65539674870,65539674874,4,2482,1407,-30
65540818170,65540818173,3,1651,1300,-30
65543333800,65543333804,4,2289,1697,-30
65546474046,65546474053,7,1860,837,-30
65546677772,65546677784,12,2112,742,-30
65547163902,65547163904,2,6551,5838,-30
65547611506,65547611512,6,2397,1910,-30
65549426422,65549426427,5,2751,1300,-30
65552544170,65552544172,2,1344,1284,-30
65552955908,65552955911,3,2571,898,-30
65556824628,65556824633,5,2138,1372,-30
65565014897,65565014901,4,2949,2236,-30
65568251546,65568251550,4,2207,1248,-30
65568602219,65568602223,4,1976,1437,-30
65568900219,65568900222,3,2215,1252,-30
65569579133,65569579138,5,2262,1375,-30
65569881810,65569881816,6,3010,1696,-30
65571196569,65571196575,6,2138,1064,-30
65571709877,65571709882,5,2347,1144,-30
65572109426,65572109410,-16,727,341,-30
65573091294,65573091300,6,2000,1609,-30
65573485505,65573485509,4,1605,1309,-30
65577775299,65577775302,3,1835,838,-30
65578587209,65578587192,-17,1835,964,-30
65578979133,65578979137,4,2663,1911,-30
65585594941,65585594946,5,1451,1180,-30
65586795490,65586795494,4,2517,1445,-30
65587654411,65587654416,5,2345,1241,-30
65588810162,65588810169,7,3001,1625,-30
65590876610,65590876615,5,2695,1486,-30
65591528025,65591528030,5,2468,1108,-30
65592264111,65592264130,19,1048,376,-30
65595439739,65595439745,6,2212,1513,-30
65595725552,65595725557,5,2745,1430,-30
65605649997,65605650002,5,2471,1221,-30
65605697753,65605697740,-13,825,305,-30
65606841478,65606841482,4,2018,947,-30
65611118811,65611118818,7,3007,1545,-30
65611321294,65611321304,10,676,217,-30
65612791330,65612791335,5,1875,1391,-30
65613647261,65613647266,5,1755,948,-30
65618458910,65618458915,5,2837,1429,-30
65621070016,65621070023,7,2871,1058,-30
65621860874,65621860868,-6,1756,8297,-30
65622541658,65622541662,4,1633,1320,-30
65623932632,65623932637,5,3101,1275,-30
65624512564,65624512571,7,1305,910,-30
65625184320,65625184317,-3,1702,1215,-30
65632293883,65632293880,-3,1359,3644,-30
65632544014,65632544018,4,2943,1072,-30
65633512038,65633512045,7,1242,585,-30
65634226787,65634226792,5,3337,1789,-30
65638668916,65638668921,5,1460,1407,-30
65641836074,65641836080,6,2690,1546,-30
65642237139,65642237145,6,1427,1020,-30
65647707101,65647707101,0,1288,1529,-30
65650317188,65650317194,6,2106,1542,-30
65653854009,65653854013,4,2533,1410,-30
65656639969,65656639973,4,2482,1439,-30
65660995249,65660995253,4,2063,1356,-30
65663844442,65663844447,5,2502,1417,-30
65664460896,65664460901,5,2175,1289,-30
65665903961,65665903965,4,2327,1346,-30
65667103778,65667103779,1,902,776,-30
65670607426,65670607431,5,2080,1125,-30
65670935784,65670935778,-6,1236,3818,-30
65671261590,65671261595,5,1785,1050,-30
65673613365,65673613370,5,2571,1772,-30
65674147259,65674147264,5,2064,1080,-30
65677626582,65677626588,6,2232,1245,-30
65677948852,65677948836,-16,1084,814,-30
65679104844,65679104849,5,3078,1496,-30
65680343887,65680343896,9,1630,1017,-30
65680979361,65680979376,15,469,1019,-30
65690670022,65690670026,4,2176,1543,-30
65693049338,65693049343,5,2109,1239,-30
65693212685,65693212691,6,2815,1145,-30
65693851854,65693851835,-19,2298,914,-30
65698125604,65698125608,4,2830,2378,-30
65698260306,65698260314,8,3805,1616,-30
65698790318,65698790323,5,3187,1486,-30
65698841502,65698841513,11,1821,1131,-30
65700601206,65700601211,5,1622,898,-30
65700922150,65700922154,4,2022,1231,-30
65708985275,65708985279,4,2190,1274,-30
65713935142,65713935147,5,2043,1443,-30
65717871189,65717871194,5,2141,1406,-30
65718279851,65718279854,3,2047,1664,-30
65719471258,65719471254,-4,2364,5304,-30
65721969580,65721969586,6,2299,1305,-30
65722955571,65722955579,8,2973,1552,-30
65724946912,65724946918,6,3088,1203,-30
65728993139,65728993145,6,2423,1156,-30
65730243317,65730243321,4,2836,1800,-30
65730622429,65730622449,20,2339,1478,-30
65731736674,65731736679,5,1860,1171,-30
65731883983,65731883962,-21,856,459,-30
65737096287,65737096291,4,1496,867,-30
65741593267,65741593274,7,2788,1117,-30
65743013226,65743013229,3,1576,800,-30
65747801908,65747801913,5,1416,1616,-30
65751969814,65751969819,5,2831,1137,-30
65752730413,65752730418,5,2380,1243,-30
65760517014,65760517021,7,2490,1394,-30
65767168317,65767168323,6,2438,1249,-30
65770750497,65770750502,5,2321,1400,-30
65772118290,65772118294,4,2151,1336,-30
65775323130,65775323136,6,2611,1527,-30
65775753820,65775753825,5,2307,1296,-30
65775938447,65775938456,9,964,621,-30
65777607753,65777607755,2,2276,1960,-30
65778520129,65778520134,5,2680,1305,-30
65779447252,65779447258,6,2238,1138,-30
65780615351,65780615356,5,1672,1122,-30
65785081958,65785081965,7,2417,1464,-30
65788215514,65788215519,5,2145,1157,-30
65789484014,65789484021,7,1704,1185,-30
65792654027,65792654031,4,1966,1201,-30
65795170603,65795170607,4,2010,1321,-30
65804926357,65804926363,6,2113,1385,-30
65807120448,65807120454,6,2030,1071,-30
65807402061,65807402042,-19,840,523,-30
65808934074,65808934078,4,2298,1443,-30
65809657755,65809657760,5,3228,1759,-30
65810413213,65810413217,4,1373,1348,-30
65812020278,65812020284,6,2117,1394,-30
65814461477,65814461482,5,1518,937,-30
65814600607,65814600610,3,1422,1359,-30
65819214261,65819214267,6,2759,1358,-30
65819926933,65819926938,5,1970,1067,-30
65821285362,65821285367,5,2480,1023,-30
65822681162,65822681168,6,2017,1210,-30
65824609744,65824609738,-6,1842,7638,-30
65831099349,65831099355,6,2285,1475,-30
65839037879,65839037884,5,2857,1531,-30
65841920772,65841920776,4,2922,1909,-30
65842010817,65842010823,6,2569,884,-30
65844610684,65844610689,5,1946,1169,-30
65847803130,65847803136,6,2195,1366,-30
65849455618,65849455623,5,1669,1285,-30
65850358281,65850358289,8,2878,880,-30
65857709177,65857709182,5,2589,1754,-30
65858736747,65858736750,3,1603,971,-30
65860173219,65860173223,4,2241,1095,-30
65860971606,65860971611,5,2441,862,-30
65861413954,65861413960,6,1996,891,-30
65862892330,65862892335,5,2254,1053,-30
65863067651,65863067648,-3,822,382,-30
65864244514,65864244518,4,2254,925,-30
65870454618,65870454620,2,2009,1697,-30
65871310213,65871310219,6,2627,1052,-30
65872879686,65872879689,3,1745,1383,-30
65873191874,65873191874,0,1323,1772,-30
65873596475,65873596479,4,2646,1292,-30
65882109480,65882109483,3,1744,1029,-30
65883949715,65883949720,5,1920,809,-30
65884579818,65884579825,7,956,864,-30
65888515901,65888515903,2,1474,862,-30
65891300988,65891300977,-11,52391,13108,-30
65892050714,65892050719,5,1506,1349,-30
65893470656,65893470654,-2,1748,2918,-30
65893689275,65893689280,5,991,636,-30
65896643441,65896643446,5,2017,1139,-30
65896790606,65896790612,6,2639,1523,-30
65897506233,65897506217,-16,1325,809,-30
65898705441,65898705447,6,2540,1961,-30
65901023569,65901023575,6,2293,1363,-30
65901151722,65901151727,5,2503,945,-30
65903003785,65903003790,5,1797,1514,-30
65905220606,65905220610,4,1546,1190,-30
65906767037,65906767042,5,1773,1153,-30
65908286986,65908286991,5,861,587,-30
65912473403,65912473410,7,2802,1432,-30
65914340244,65914340239,-5,1770,4982,-30
65917874670,65917874677,7,3006,1595,-30
65921027371,65921027373,2,1372,1612,-30
65925344393,65925344392,-1,1035,1407,-30
65926859630,65926859634,4,2073,1208,-30
65927073654,65927073647,-7,514,3045,-30
65928431774,65928431781,7,2022,1240,-30
65930165919,65930165925,6,2559,1489,-30
65934618355,65934618361,6,2461,1302,-30
65936367097,65936367102,5,2080,888,-30
65937502663,65937502669,6,2119,1502,-30
65938722344,65938722347,3,800,803,-30
65942666198,65942666204,6,1973,1659,-30
65947778731,65947778737,6,1225,1163,-30
65949320078,65949320082,4,1719,787,-30
65952449309,65952449314,5,2236,1149,-30
65953940270,65953940273,3,2298,1801,-30
65955075134,65955075139,5,1512,1400,-30
65955168614,65955168618,4,1862,1064,-30
65955599149,65955599154,5,1568,1398,-30
65956632402,65956632396,-6,1895,5990,-30
65959601836,65959601821,-15,1280,687,-30
65962253172,65962253176,4,1749,866,-30
65962897067,65962897073,6,2807,1300,-30
65967439110,65967439115,5,2695,1394,-30
65968929645,65968929651,6,2377,1678,-30
65969144570,65969144577,7,1302,1061,-30
65973885634,65973885643,9,2033,1218,-30
65974094594,65974094612,18,1017,1328,-30
65974987233,65974987239,6,2103,1333,-30
65975630973,65975630979,6,1536,852,-30
65978263010,65978262996,-14,3236,1075,-30
65979876399,65979876405,6,1703,1429,-30
65982674847,65982674851,4,1444,897,-30
65983284696,65983284702,6,2128,1300,-30
65985330365,65985330367,2,2572,1524,-30
65986662293,65986662298,5,1787,846,-30
65990353865,65990353869,4,3030,1685,-30
65990761527,65990761533,6,3015,1529,-30
65992657089,65992657095,6,2267,1253,-30
65993615669,65993615674,5,1520,899,-30
65995580490,65995580495,5,2860,1101,-30
65997618015,65997618021,6,3513,1453,-30
66000627601,66000627605,4,1411,871,-30
66003550758,66003550761,3,2894,1548,-30
66004147794,66004147801,7,3098,1474,-30
66009893198,66009893204,6,2307,1465,-30
66010980139,66010980138,-1,1583,2055,-30
66011850630,66011850634,4,1740,1094,-30
66015635965,66015635966,1,2311,1318,-30
66016949899,66016949904,5,1543,1280,-30
66017268522,66017268506,-16,632,424,-30
66017702931,66017702929,-2,1257,1802,-30
66021301710,66021301714,4,2779,1428,-30
66021485026,66021485029,3,2677,2132,-30
66022277625,66022277630,5,2406,1237,-30
66026255850,66026255853,3,2089,1066,-30
66028937082,66028937086,4,1942,1095,-30
66029038915,66029038920,5,3642,2074,-30
66030526502,66030526506,4,2665,1866,-30
66041655634,66041655638,4,1870,1386,-30
66042731721,66042731726,5,1986,1160,-30
66044619265,66044619271,6,2657,1152,-30
66047724798,66047724802,4,2510,1933,-30
66049146833,66049146838,5,1746,1230,-30
66055742026,66055742031,5,2396,1735,-30
66056442124,66056442131,7,1706,1100,-30
66057304452,66057304457,5,2303,1273,-30
66058171772,66058171775,3,1790,1677,-30
66058350429,66058350434,5,1941,1266,-30
66059424033,66059424038,5,2201,1380,-30
66061443415,66061443417,2,1574,1444,-30
66062337222,66062337228,6,1087,934,-30
66063011194,66063011198,4,3206,680,-30
66063458654,66063458653,-1,330,1928,-30
66066072016,66066072022,6,1943,1309,-30
66069122437,66069122441,4,1788,1521,-30
66070573476,66070573481,5,1625,1819,-30
66071939910,66071939915,5,2103,1115,-30
66072711908,66072711912,4,2258,1282,-30
66075248674,66075248678,4,1269,799,-30
66076774133,66076774138,5,2396,1916,-30
66080042798,66080042801,3,2748,1777,-30
66085406039,66085406043,4,1917,829,-30
66090091836,66090091841,5,1633,1176,-30
66091409849,66091409855,6,2199,1077,-30
66091588981,66091588962,-19,1012,317,-30
66092927466,66092927470,4,2459,1062,-30
66095315957,66095315963,6,2293,1006,-30
66099998507,66099998511,4,1249,1275,-30
66104102885,66104102890,5,3085,1239,-30
66104965287,66104965293,6,3114,1395,-30
66107664874,66107664879,5,1884,697,-30
66108039378,66108039381,3,2916,2084,-30
66111118418,66111118423,5,6198,2543,-30
66111707209,66111707217,8,2778,1470,-30
66112384555,66112384561,6,2264,1449,-30
66112917850,66112917857,7,2567,1001,-30
66116166395,66116166401,6,1869,1157,-30
66119057686,66119057691,5,2944,994,-30
66120210457,66120210461,4,1548,1019,-30
66121487239,66121487242,3,1263,1568,-30
66122382826,66122382829,3,845,1300,-30
66124503690,66124503695,5,1525,527,-30
66128614503,66128614506,3,1757,1390,-30
66129103682,66129103686,4,2717,1852,-30
66140425459,66140425462,3,1938,1638,-30
66141698811,66141698817,6,2708,1175,-30
66143499250,66143499255,5,2357,1461,-30
66143959116,66143959122,6,2455,1335,-30
66146864624,66146864630,6,2249,1472,-30
66147966775,66147966772,-3,2360,4745,-30
66151810375,66151810373,-2,1631,2560,-30
66153380209,66153380215,6,2470,1271,-30
66156935149,66156935153,4,2292,1492,-30
66159636577,66159636583,6,2846,1687,-30
66162110955,66162110958,3,1853,1033,-30
66162728523,66162728529,6,2058,1055,-30
66163816833,66163816837,4,2851,1680,-30
66165300915,66165300920,5,1896,1428,-30
66166029066,66166029060,-6,927,291,-30
66168732169,66168732174,5,2692,978,-30
66169560318,66169560319,1,40639,23009,-30
66171801859,66171801863,4,1880,1369,-30
66171831884,66171831887,3,2132,892,-30
66184913635,66184913638,3,1501,1579,-30
66187729362,66187729368,6,1588,1502,-30
66193876734,66193876739,5,3335,1738,-30
66195930529,66195930534,5,1622,1098,-30
66198551778,66198551784,6,2361,1929,-30
66198734694,66198734700,6,13680,24307,-30
66199160824,66199160830,6,3708,1565,-30
66200797225,66200797230,5,1872,1450,-30
66202447085,66202447089,4,1804,1292,-30
66202478256,66202478267,11,2216,1149,-30
66202883366,66202883365,-1,1498,2510,-30
66205806755,66205806747,-8,1045,5114,-30
66206064369,66206064374,5,2521,1160,-30
66206662478,66206662483,5,1558,1069,-30
66207804560,66207804564,4,1601,1290,-30
66210621604,66210621606,2,1751,1351,-30
66216868610,66216868614,4,2076,1635,-30
66217294597,66217294601,4,2523,1819,-30
66217834678,66217834682,4,2697,1708,-30
66218804894,66218804894,0,1203,1746,-30
66219439862,66219439867,5,1678,1037,-30
66221759442,66221759447,5,1729,1128,-30
66222544757,66222544746,-11,702,359,-30
66226081398,66226081404,6,2479,1600,-30
66230317201,66230317206,5,2471,1581,-30
66230360094,66230360095,1,1615,1129,-30
66230721802,66230721794,-8,507,85,-30
66231240864,66231240867,3,2255,1095,-30
66232756959,66232756963,4,2329,1168,-30
66232881439,66232881450,11,750,405,-30
66233494621,66233494621,0,1169,1339,-30
66236708546,66236708550,4,2129,1523,-30
66237329319,66237329305,-14,2366,1023,-30
66242410537,66242410542,5,2520,1812,-30
66244816166,66244816170,4,2332,1690,-30
66245229802,66245229811,9,3343,1197,-30
66250706782,66250706787,5,1885,1056,-30
66251543363,66251543371,8,3809,761,-30
66252541678,66252541684,6,1132,707,-30
66255616091,66255616093,2,1355,1050,-30
66256448674,66256448679,5,1933,1008,-30
66258909865,66258909868,3,4136,2748,-30
66259808762,66259808767,5,1963,1045,-30
66260957802,66260957806,4,2286,1584,-30
66267473537,66267473534,-3,1139,3223,-30
66267819799,66267819804,5,8615,30562,-30
66269411823,66269411827,4,2238,1169,-30
66272420698,66272420703,5,3052,1327,-30
66276782807,66276782811,4,2310,1463,-30
66280914819,66280914818,-1,782,1358,-30
66282932053,66282932058,5,2308,1201,-30
66283522030,66283522026,-4,1058,3374,-30
66293167535,66293167539,4,2000,1130,-30
66297244023,66297244028,5,1612,1180,-30
66297549390,66297549379,-11,1059,507,-30
66298443454,66298443461,7,2712,1414,-30
66301769705,66301769711,6,1646,1016,-30
66301838386,66301838368,-18,2223,1171,-30
66307464282,66307464279,-3,874,1783,-30
66310726239,66310726243,4,2527,1639,-30
66314359062,66314359057,-5,28453,13013,-30
66316294243,66316294248,5,2568,1649,-30
66324113660,66324113665,5,2360,1484,-30
66325505882,66325505887,5,1187,647,-30
66329589362,66329589370,8,2206,1030,-30
66329848107,66329848111,4,4711,2235,-30
66331006086,66331006090,4,1717,1314,-30
66332981522,66332981527,5,1925,857,-30
66333726906,66333726890,-16,1166,533,-30
66333971373,66333971378,5,2127,942,-30
66338235838,66338235843,5,2774,1307,-30
66341926582,66341926589,7,16363,52850,-30
66341986870,66341986875,5,1163,1189,-30
66343216766,66343216771,5,1099,976,-30
66344986601,66344986604,3,2279,1637,-30
66346466756,66346466759,3,985,1159,-30
66354176135,66354176141,6,1409,1039,-30
66357708357,66357708351,-6,953,5335,-30
66358665745,66358665749,4,1928,1162,-30
66359679734,66359679739,5,2607,1666,-30
66359807912,66359807918,6,2559,1158,-30
66362284457,66362284461,4,2754,1436,-30
66363982196,66363982202,6,2730,1342,-30
66369548994,66369548998,4,2179,1614,-30
66370093521,66370093523,2,1620,1625,-30
66370366230,66370366237,7,2363,1122,-30
66370459416,66370459425,9,2053,900,-30
66373665661,66373665667,6,2083,1236,-30
66373734071,66373734077,6,1779,1179,-30
66373992562,66373992568,6,2133,1692,-30
66374922368,66374922374,6,3030,1513,-30
66376641908,66376641914,6,2059,1228,-30
66380554690,66380554695,5,2568,1354,-30
66381796406,66381796428,22,1362,1303,-30
66382942060,66382942066,6,1999,867,-30
66383409946,66383409952,6,2772,2015,-30
66383709736,66383709743,7,2416,1466,-30
66384010369,66384010387,18,1729,1113,-30
66384439679,66384439686,7,3215,1177,-30
66386221238,66386221242,4,1727,1216,-30
66389515477,66389515481,4,2593,1313,-30
66390350965,66390350946,-19,1767,1328,-30
66390582958,66390582962,4,1846,1137,-30
66391768582,66391768588,6,2255,1730,-30
66393555391,66393555397,6,1897,1067,-30
66396188830,66396188834,4,2438,1227,-30
66396918913,66396918906,-7,1358,3676,-30
66398458806,66398458812,6,2138,1153,-30
66403215326,66403215332,6,5556,3368,-30
66403409340,66403409345,5,3360,1714,-30
66404096175,66404096179,4,1704,945,-30
66412872261,66412872267,6,2257,1381,-30
66415497200,66415497211,11,12044,44626,-30
66416726998,66416727005,7,1973,1197,-30
66418004870,66418004867,-3,1324,1571,-30
66419021790,66419021785,-5,549,3644,-30
66420289497,66420289501,4,2113,1412,-30
66420530142,66420530146,4,2118,1158,-30
66421499694,66421499702,8,3097,1276,-30
66421796896,66421796894,-2,2712,5119,-30
66422798178,66422798183,5,1580,1574,-30
66423424540,66423424556,16,288,3,-30
66425667658,66425667662,4,1549,1368,-30
66427621939,66427621945,6,2056,1256,-30
66430423308,66430423310,2,2042,1420,-30
66437306202,66437306207,5,2404,1296,-30
66439292213,66439292217,4,2731,1350,-30
66441418954,66441418959,5,1940,1136,-30
66444820991,66444820997,6,2338,1112,-30
66446026983,66446026970,-13,393,172,-30
66449312697,66449312701,4,2692,1080,-30
66451567722,66451567728,6,2080,1244,-30
66451657037,66451657042,5,2130,1483,-30
66453719302,66453719306,4,3481,1971,-30
66454499419,66454499425,6,3362,1994,-30
66458567365,66458567367,2,1812,1990,-30
66458731018,66458731022,4,3268,1415,-30
66464916314,66464916302,-12,1158,781,-30
66466508126,66466508131,5,1791,631,-30
66467762342,66467762347,5,1151,708,-30
66468219802,66468219802,0,1243,1524,-30
66468308276,66468308281,5,1938,937,-30
66470433612,66470433616,4,2092,1401,-30
66473851317,66473851322,5,2239,1411,-30
66474251818,66474251811,-7,1069,250,-30
66474564006,66474563987,-19,2622,1183,-30
66474639162,66474639144,-18,1700,1525,-30
66475716417,66475716423,6,2193,1424,-30
66475765412,66475765410,-2,1085,1693,-30
66476594681,66476594681,0,878,1219,-30
66477148428,66477148433,5,2231,1695,-30
66481805399,66481805403,4,2615,1399,-30
66483556870,66483556869,-1,1285,1832,-30
66484061281,66484061287,6,2402,1194,-30
66485341221,66485341226,5,2172,1477,-30
66485709406,66485709412,6,1860,1494,-30
66487299220,66487299226,6,5291,1964,-30
66492543986,66492543989,3,2058,1445,-30
66493674630,66493674630,0,1074,1302,-30
66494040925,66494040930,5,2404,1401,-30
66495662002,66495662006,4,1055,922,-30
66495989506,66495989511,5,1911,1006,-30
66499857318,66499857323,5,3824,2250,-30
66508477970,66508477975,5,2278,1526,-30
66510983052,66510983055,3,2740,1459,-30
66511054609,66511054613,4,3090,1413,-30
66512574269,66512574273,4,1614,936,-30
66513313318,66513313320,2,3896,2571,-30
66513422605,66513422609,4,2236,1412,-30
66521330214,66521330219,5,2684,1338,-30
66522690504,66522690503,-1,1340,1457,-30
66525693113,66525693118,5,2698,1514,-30
66525778860,66525778858,-2,1791,1813,-30
66526560359,66526560364,5,2653,1195,-30
66527553626,66527553629,3,2172,1397,-30
66530253822,66530253827,5,2230,1302,-30
66531731858,66531731865,7,3524,1389,-30
66533879517,66533879522,5,2191,1704,-30
66535701834,66535701837,3,1839,1337,-30
66536167669,66536167673,4,1935,1596,-30
66536793395,66536793392,-3,847,1530,-30
66536912827,66536912833,6,2701,1507,-30
66539774667,66539774673,6,1473,1045,-30
66542314251,66542314253,2,1166,1239,-30
66545832972,66545832977,5,1809,1261,-30
66549542546,66549542550,4,2713,1251,-30
66550144162,66550144152,-10,953,217,-30
66550642387,66550642393,6,1244,1148,-30
66551462709,66551462713,4,2434,1528,-30
66553511245,66553511251,6,2623,1104,-30
66554141402,66554141416,14,2186,1267,-30
66554264905,66554264910,5,2309,1377,-30
66557173018,66557173022,4,2825,1840,-30
66559367722,66559367726,4,1887,1461,-30
66561611805,66561611811,6,2494,1134,-30
66563779429,66563779433,4,2886,1725,-30
66563885315,66563885300,-15,2570,774,-30
66565165884,66565165889,5,2590,1592,-30
66573059307,66573059313,6,2255,1367,-30
66574879329,66574879333,4,2441,1838,-30
66577824306,66577824311,5,3425,1414,-30
66578194490,66578194495,5,1529,905,-30
66580254002,66580254006,4,1331,1114,-30
66586209907,66586209912,5,1859,1435,-30
66586792994,66586793000,6,1384,843,-30
66587767966,66587767970,4,1957,1249,-30
66594916086,66594916088,2,1332,1386,-30
66598318137,66598318135,-2,1573,1885,-30
66598516868,66598516873,5,2130,1145,-30
66599058617,66599058621,4,1954,1121,-30
66600196767,66600196771,4,2167,1075,-30
66601417257,66601417261,4,838,835,-30
66604529303,66604529300,-3,1172,3022,-30
66604640440,66604640441,1,1573,863,-30
66605270874,66605270874,0,1041,1811,-30
66606364027,66606364032,5,1760,1705,-30
66607584210,66607584213,3,2982,3375,-30
66609590011,66609590015,4,2317,1308,-30
66610845293,66610845294,1,1581,2061,-30
66612706902,66612706908,6,3330,1378,-30
66613769829,66613769833,4,1740,947,-30
66616947437,66616947441,4,2278,1189,-30
66618377647,66618377650,3,1654,1310,-30
66619314763,66619314767,4,2213,1707,-30
66621512692,66621512697,5,1954,1818,-30
66623867696,66623867702,6,1991,1473,-30
66628532575,66628532581,6,2397,1861,-30
66630575568,66630575570,2,2422,1508,-30
66632565443,66632565437,-6,1150,6339,-30
66633780463,66633780468,5,2512,1418,-30
66637858642,66637858642,0,2201,2801,-30
66638981766,66638981774,8,1990,1187,-30
66639961593,66639961599,6,1375,862,-30
66640940142,66640940140,-2,2035,3957,-30
66643978439,66643978446,7,2654,1216,-30
66649588228,66649588233,5,2102,1353,-30
66651026922,66651026927,5,2462,1346,-30
66651982330,66651982335,5,2124,1148,-30
66653684919,66653684918,-1,806,1156,-30
66654543937,66654543943,6,2376,1307,-30
66654625433,66654625417,-16,1085,696,-30
66655220853,66655220859,6,1531,988,-30
66655973490,66655973491,1,1724,1291,-30
66661520974,66661520978,4,1672,1304,-30
66663074982,66663074987,5,1960,983,-30
66664249186,66664249191,5,1965,1503,-30
66664551425,66664551430,5,2248,1263,-30
66666577948,66666577949,1,1605,1470,-30
66670167560,66670167554,-6,41,2002,-30
66670979537,66670979542,5,2035,992,-30
66677883049,66677883053,4,2421,1439,-30
66680605614,66680605622,8,2170,950,-30
66683187930,66683187936,6,1571,972,-30
66685721313,66685721318,5,1144,877,-30
66686481982,66686481987,5,2459,1267,-30
66687272303,66687272297,-6,1212,4371,-30
66687716625,66687716630,5,3068,1513,-30
66690225138,66690225146,8,2048,1074,-30
66693866742,66693866746,4,3361,1505,-30
66696616756,66696616761,5,2145,1453,-30
66702223430,66702223435,5,2371,1241,-30
66705103051,66705103055,4,1955,1421,-30
66705634538,66705634543,5,2153,1131,-30
66708659421,66708659425,4,1661,840,-30
66709484617,66709484622,5,2621,1486,-30
66709837050,66709837054,4,2299,1058,-30
66712195473,66712195452,-21,1527,850,-30
66713770382,66713770387,5,1787,1224,-30
66715769278,66715769283,5,1863,1638,-30
66719482727,66719482731,4,2675,1370,-30
66719882181,66719882162,-19,898,333,-30
66725832727,66725832732,5,2403,1337,-30
66727433834,66727433838,4,3107,1602,-30
66731392432,66731392439,7,2848,1542,-30
66733446212,66733446215,3,2494,1425,-30
66733904357,66733904363,6,2170,1505,-30
66735840691,66735840689,-2,938,2517,-30
66741183849,66741183843,-6,1239,1176,-30
66741636919,66741636898,-21,1320,2088,-30
66741759274,66741759278,4,1119,1357,-30
66743627225,66743627229,4,3292,1679,-30
66749183513,66749183519,6,1791,1390,-30
66749403024,66749403029,5,2252,1320,-30
66750967149,66750967151,2,1529,1178,-30
66755125210,66755125203,-7,1784,4396,-30
66756112585,66756112591,6,1545,999,-30
66756417998,66756417998,0,2064,1842,-30
66758229977,66758229979,2,1187,1091,-30
66759049742,66759049746,4,44799,49303,-30
66761196276,66761196276,0,1067,1882,-30
66762787106,66762787110,4,2035,1217,-30
66763055350,66763055355,5,2341,1017,-30
66763936440,66763936447,7,2591,1441,-30
66769219461,66769219465,4,2268,1544,-30
66773222233,66773222237,4,2448,1286,-30
66779042689,66779042692,3,1585,870,-30
66782060206,66782060210,4,1852,1160,-30
66782526362,66782526366,4,1551,1155,-30
66785479958,66785479962,4,3244,1863,-30
66790028092,66790028095,3,1447,1310,-30
66790127038,66790127043,5,1485,1091,-30
66793759490,66793759489,-1,1829,4247,-30
66794890207,66794890213,6,2652,1446,-30
66796538510,66796538514,4,2967,1443,-30
66796907318,66796907322,4,2400,1779,-30
66805767277,66805767276,-1,1413,2870,-30
66808162606,66808162610,4,2831,1157,-30
66808281549,66808281531,-18,1879,1387,-30
66810930372,66810930377,5,1756,917,-30
66813333586,66813333590,4,2750,1579,-30
66817071469,66817071472,3,2184,1436,-30
66817352242,66817352246,4,1888,1076,-30
66817850533,66817850538,5,2141,1214,-30
66819979360,66819979367,7,2889,1531,-30
66821379402,66821379407,5,1296,1474,-30
66824030292,66824030294,2,2253,1422,-30
66824969431,66824969435,4,2653,1132,-30
66825017454,66825017459,5,2854,1667,-30
66825350555,66825350560,5,1939,1019,-30
66826319149,66826319149,0,1515,2554,-30
66830849300,66830849302,2,2250,1259,-30
66836708429,66836708434,5,2077,1071,-30
66840316317,66840316324,7,2733,1544,-30
66840366047,66840366027,-20,2159,1143,-30
66842872294,66842872299,5,2378,1503,-30
66849220660,66849220665,5,1790,990,-30
66849446126,66849446134,8,2228,1066,-30
66853963706,66853963711,5,1569,1111,-30
66854331135,66854331141,6,2189,1634,-30
66854769580,66854769586,6,2620,1380,-30
66855198001,66855198005,4,3130,1807,-30
66857945574,66857945579,5,2640,872,-30
66858902690,66858902675,-15,1159,551,-30
66859307066,66859307063,-3,615,1698,-30
66860435910,66860435913,3,1906,1887,-30
66865743950,66865743955,5,2909,1277,-30
66868981795,66868981801,6,3112,2112,-30
66870594865,66870594870,5,1793,1164,-30
66873022836,66873022841,5,2359,979,-30
66873085138,66873085120,-18,2925,1313,-30
66874397244,66874397248,4,1685,1469,-30
66874491847,66874491854,7,2891,1870,-30
66879156034,66879156038,4,2563,1344,-30
66880477494,66880477499,5,3134,1088,-30
66884756630,66884756635,5,2216,1664,-30
66889871876,66889871882,6,2323,1107,-30
66892352785,66892352789,4,2491,1426,-30
66892787869,66892787873,4,2364,1349,-30
66897081667,66897081672,5,1487,1382,-30
66898278947,66898278951,4,1778,1374,-30
66899349786,66899349790,4,2331,1545,-30
66900427285,66900427291,6,1537,27258,-30
66900749167,66900749174,7,3031,1393,-30
66903224235,66903224241,6,1662,1310,-30
66908768211,66908768217,6,2055,1098,-30
66912185516,66912185520,4,2134,1173,-30
66917546563,66917546570,7,2123,1527,-30
66919987929,66919987934,5,3299,1605,-30
66929852349,66929852357,8,2734,1548,-30
66939664200,66939664205,5,2865,868,-30
66942457949,66942457955,6,2323,1276,-30
66944501790,66944501793,3,1269,1401,-30
66947309981,66947309985,4,1808,1024,-30
66955722053,66955722052,-1,1735,2443,-30
66957141476,66957141478,2,2056,1501,-30
66957749685,66957749690,5,2929,1934,-30
66958170456,66958170462,6,1973,1069,-30
66958687681,66958687687,6,2646,1293,-30
66959661890,66959661895,5,1457,1302,-30
66959821583,66959821561,-22,1127,867,-30
66961845916,66961845906,-10,1355,693,-30
66968125470,66968125474,4,1988,1580,-30
66972006806,66972006811,5,2263,1243,-30
66973659447,66973659453,6,1680,1392,-30
66977604582,66977604586,4,1379,1219,-30
66978916789,66978916793,4,2870,1248,-30
66980303502,66980303508,6,2183,1185,-30
66986191933,66986191937,4,2418,1572,-30
66986916087,66986916091,4,5128,2664,-30
66990805309,66990805314,5,2083,1154,-30
66991697302,66991697307,5,2420,1032,-30
66994882609,66994882615,6,2119,1027,-30
66996681601,66996681606,5,2890,1489,-30
66996806255,66996806259,4,1863,1107,-30
67000040086,67000040090,4,1351,796,-30
67003460279,67003460284,5,1874,1473,-30
67004744167,67004744171,4,4951,2984,-30
67006973421,67006973426,5,1504,852,-30
67009884445,67009884449,4,1991,1026,-30
67012270874,67012270878,4,2574,1462,-30
67021348835,67021348837,2,2749,2291,-30
67026411397,67026411403,6,1308,975,-30
67027721082,67027721088,6,2472,1079,-30
67029184284,67029184289,5,2713,1883,-30
67029957637,67029957642,5,2776,1585,-30
67031772235,67031772239,4,2534,1588,-30
67032016003,67032016009,6,2468,1117,-30
67032579911,67032579916,5,2715,1507,-30
67033895009,67033895015,6,2623,1336,-30
67037863570,67037863576,6,3136,1892,-30
67038887852,67038887857,5,2482,741,-30
67045984245,67045984249,4,1906,1382,-30
67053129137,67053129142,5,2863,1417,-30
67055762959,67055762964,5,2127,1197,-30
67055885447,67055885433,-14,402,411,-30
67058078750,67058078755,5,2068,1245,-30
67058947810,67058947818,8,2948,1224,-30
67060660781,67060660786,5,2336,1160,-30
67062932330,67062932334,4,1835,1148,-30
67067519301,67067519303,2,2253,2267,-30
67068506013,67068506014,1,1382,2068,-30
67069639057,67069639062,5,3169,1442,-30
67070625522,67070625529,7,2960,1366,-30
67070865618,67070865604,-14,1632,1145,-30
67071579003,67071579008,5,2608,1539,-30
67076215949,67076215954,5,1443,1207,-30
67080456292,67080456297,5,2736,1513,-30
67081173304,67081173309,5,2387,1054,-30
67082385767,67082385771,4,1982,1171,-30
67083105051,67083105055,4,1895,1896,-30
67083178718,67083178723,5,2266,1276,-30
67084044688,67084044693,5,1754,1312,-30
67084345381,67084345378,-3,6197,14631,-30
67086199285,67086199288,3,7004,5092,-30
67086721411,67086721416,5,3090,1534,-30
67087018199,67087018203,4,1901,1284,-30
67087645770,67087645775,5,2759,2049,-30
67087916662,67087916665,3,2509,1331,-30
67091712330,67091712335,5,2248,1451,-30
67098501905,67098501910,5,2984,1263,-30
67098635229,67098635226,-3,1366,276,-30
67104175430,67104175430,0,2835,3673,-30
67107271822,67107271823,1,3120,3633,-30
67111733061,67111733066,5,2850,1450,-30
67113024721,67113024728,7,13032,27977,-30
67113784937,67113784941,4,2283,1299,-30
67115948339,67115948345,6,2306,1397,-30
67116720541,67116720546,5,2853,1631,-30
67117561209,67117561211,2,2029,1777,-30
67120588029,67120588035,6,1035,1177,-30
67120829922,67120829929,7,3221,1121,-30
67121713811,67121713817,6,5069,1132,-30
67122831171,67122831176,5,2301,1619,-30
67123090211,67123090217,6,2149,1362,-30
67124211722,67124211728,6,2489,1497,-30
67125189424,67125189430,6,2854,1448,-30
67126055029,67126055033,4,2723,1328,-30
67127573273,67127573276,3,2136,1436,-30
67130173918,67130173923,5,1576,409,-30
67130458277,67130458282,5,2581,1256,-30
67130574662,67130574667,5,1999,1161,-30
67131002302,67131002306,4,2074,933,-30
67131521044,67131521047,3,2032,1010,-30
67131689226,67131689227,1,1371,1169,-30
67135825110,67135825112,2,2102,1429,-30
67140097702,67140097707,5,2658,1660,-30
67141504708,67141504713,5,1682,783,-30
67143469294,67143469298,4,2039,1366,-30
67144178337,67144178342,5,2868,1826,-30
67146195763,67146195768,5,2595,1466,-30
67154234614,67154234620,6,1953,1161,-30
67158776458,67158776463,5,1969,1275,-30
67159415876,67159415881,5,1917,1347,-30
67163648908,67163648913,5,2236,1253,-30
67166042510,67166042515,5,1954,1245,-30
67175248726,67175248732,6,2593,1439,-30
67176304422,67176304430,8,1749,1168,-30
67178111186,67178111190,4,1502,1549,-30
67179683637,67179683634,-3,856,1256,-30
67180405225,67180405218,-7,818,2960,-30
67181407171,67181407174,3,1651,1761,-30
67183300045,67183300043,-2,2329,2658,-30
67189372826,67189372831,5,2277,1060,-30
67190188421,67190188426,5,2689,1252,-30
67191012376,67191012382,6,2597,1306,-30
67191639158,67191639162,4,2023,1139,-30
67192004802,67192004800,-2,932,373,-30
67193963860,67193963858,-2,1520,1787,-30
67194281646,67194281651,5,2592,1474,-30
67195223476,67195223479,3,2201,1347,-30
67196139042,67196139046,4,1617,1480,-30
67200380737,67200380739,2,13119,9425,-30
67203029910,67203029915,5,2201,955,-30
67204446721,67204446726,5,2818,1412,-30
67206360919,67206360924,5,3044,1444,-30
67206419489,67206419504,15,2741,939,-30
67209813446,67209813450,4,2481,1409,-30
67211238779,67211238786,7,3118,1385,-30
67212632238,67212632242,4,3085,1984,-30
67214965243,67214965247,4,3235,1137,-30
67214994674,67214994688,14,488,61,-30
67216881534,67216881541,7,5220,1283,-30
67217138574,67217138579,5,2238,1314,-30
67218201935,67218201939,4,2507,1059,-30
67223446772,67223446777,5,2711,1494,-30
67224872886,67224872885,-1,1252,1842,-30
67225395765,67225395769,4,2041,889,-30
67229084409,67229084417,8,2246,1220,-30
67230549261,67230549266,5,2498,1608,-30
67230616469,67230616473,4,1521,894,-30
67232754505,67232754510,5,2874,1680,-30
67232855499,67232855504,5,1613,1191,-30
67233889210,67233889211,1,1319,1456,-30
67236764639,67236764643,4,2955,1201,-30
67238295738,67238295742,4,2702,1310,-30
67241173825,67241173831,6,1603,1358,-30
67242166045,67242166050,5,3158,1295,-30
67243006748,67243006741,-7,1563,8503,-30
67243441487,67243441490,3,1749,1271,-30
67250201514,67250201520,6,2058,1466,-30
67250258415,67250258416,1,36626,44490,-30
67250513435,67250513441,6,2641,1274,-30
67251010910,67251010889,-21,1818,1078,-30
67251222144,67251222149,5,1826,1196,-30
67253212377,67253212382,5,1957,1076,-30
67254974953,67254974958,5,2745,1170,-30
67257169158,67257169162,4,2427,1649,-30
67262171748,67262171754,6,2080,1250,-30
67263018960,67263018966,6,3119,1507,-30
67265284195,67265284201,6,1916,1325,-30
67266738509,67266738513,4,2150,789,-30
67269008054,67269008058,4,2853,1654,-30
67269443619,67269443634,15,2505,1680,-30
67276085982,67276085986,4,2113,1399,-30
67280825616,67280825622,6,2044,1095,-30
67285188385,67285188390,5,1737,848,-30
67286704477,67286704482,5,1857,1134,-30
67292154333,67292154316,-17,1691,693,-30
67294815939,67294815944,5,1787,1214,-30
67296241820,67296241840,20,2651,1296,-30
67296822394,67296822378,-16,1697,511,-30
67296979897,67296979902,5,2226,1476,-30
67297582086,67297582091,5,2600,1591,-30
67299909153,67299909159,6,2645,1368,-30
67302143318,67302143326,8,2933,1069,-30
67310977307,67310977313,6,2717,1950,-30
67312248853,67312248857,4,2570,1772,-30
67314899243,67314899242,-1,2905,3716,-30
67317076353,67317076357,4,1973,1458,-30
67320823001,67320823006,5,1602,1419,-30
67329193922,67329193918,-4,717,243,-30
67330086994,67330087000,6,2146,1490,-30
67330363918,67330363939,21,1579,782,-30
67331309857,67331309861,4,1482,1067,-30
67334222975,67334222979,4,1892,1201,-30
67334533560,67334533563,3,1938,1270,-30
67335936449,67335936454,5,2122,1209,-30
67336132287,67336132295,8,4102,1466,-30
67336289619,67336289622,3,2412,1331,-30
67337628350,67337628355,5,1728,930,-30
67337893967,67337893971,4,1437,978,-30
67338196173,67338196152,-21,2197,1041,-30
67338960461,67338960451,-10,1498,544,-30
67341006565,67341006569,4,2626,1138,-30
67344750242,67344750248,6,3081,1688,-30
67344780635,67344780634,-1,982,1838,-30
67345695802,67345695805,3,2031,1472,-30
67346734954,67346734959,5,1429,1031,-30
67348543101,67348543107,6,3366,1600,-30
67351074254,67351074259,5,2808,1467,-30
67352720062,67352720066,4,2546,1450,-30
67353116485,67353116491,6,2609,1352,-30
67355010007,67355010010,3,1359,867,-30
67356142690,67356142697,7,2792,2543,-30
67358400142,67358400147,5,2336,1090,-30
67361295591,67361295597,6,1697,1039,-30
67367179179,67367179186,7,2748,1022,-30
67368090543,67368090543,0,1211,744,-30
67369901927,67369901930,3,2279,2244,-30
67375603397,67375603400,3,1780,1503,-30
67381161766,67381161771,5,2168,1816,-30
67381804199,67381804204,5,2162,1976,-30
67384198478,67384198477,-1,1291,1798,-30
67385886114,67385886113,-1,1722,2391,-30
67387234370,67387234375,5,2774,1753,-30
67388465264,67388465269,5,3339,2017,-30
67389519923,67389519929,6,1931,1182,-30
67389959702,67389959705,3,2259,1124,-30
67393991605,67393991610,5,1716,1392,-30
67397503078,67397503083,5,2703,1449,-30
67400986834,67400986839,5,2479,1329,-30
67410707378,67410707385,7,2450,1001,-30
67413183117,67413183125,8,2869,1319,-30
67418889585,67418889590,5,1896,1298,-30
67422073758,67422073763,5,2549,1715,-30
67428335883,67428335886,3,2670,1618,-30
67432985817,67432985823,6,1845,1526,-30
67434445370,67434445374,4,1754,1408,-30
67437087665,67437087666,1,1935,3084,-30
67437460384,67437460390,6,2275,1412,-30
67437534108,67437534113,5,1742,1344,-30
67443349510,67443349515,5,1568,1550,-30
67444059515,67444059520,5,3100,1545,-30
67444196169,67444196174,5,2738,1245,-30
67450703408,67450703405,-3,1286,3228,-30
67450878358,67450878364,6,1755,1300,-30
67452458034,67452458039,5,2434,1035,-30
67453660371,67453660377,6,2409,1468,-30
67454240258,67454240242,-16,1232,718,-30
67454769418,67454769423,5,2853,1583,-30
67459072583,67459072587,4,2216,1232,-30
67459335032,67459335034,2,2026,1521,-30
67459688100,67459688105,5,3104,2068,-30
67460846910,67460846914,4,2544,1259,-30
67461150435,67461150443,8,1784,999,-30
67463945916,67463945920,4,2108,1488,-30
67464250044,67464250024,-20,1482,795,-30
67469387843,67469387846,3,2224,1635,-30
67473903646,67473903651,5,2369,1263,-30
67474813639,67474813638,-1,1140,1846,-30
67479990008,67479990012,4,1801,1048,-30
67484457318,67484457322,4,1493,1021,-30
67486496355,67486496360,5,1384,979,-30
67486898595,67486898601,6,3227,1502,-30
67492788530,67492788534,4,2427,1077,-30
67493801715,67493801721,6,1847,1046,-30
67493841822,67493841827,5,2023,1045,-30
67494347186,67494347191,5,3164,1762,-30
67497521726,67497521708,-18,2731,1489,-30
67498014437,67498014432,-5,4578,12887,-30
67501706398,67501706403,5,1975,769,-30
67504642319,67504642309,-10,33827,16228,-30
67505375233,67505375237,4,2675,1709,-30
67509106749,67509106745,-4,1542,3597,-30
67510423419,67510423424,5,1030,1090,-30
67513927929,67513927935,6,2698,1319,-30
67515641669,67515641674,5,2322,970,-30
67517761978,67517761978,0,1270,2642,-30
67521167133,67521167135,2,2007,988,-30
67522835392,67522835398,6,2487,1115,-30
67523479400,67523479404,4,3241,1332,-30
67525452598,67525452604,6,2095,979,-30
67529617142,67529617147,5,2137,1005,-30
67530353999,67530354002,3,2562,2093,-30
67531222686,67531222690,4,1626,737,-30
67531866095,67531866101,6,1891,987,-30
67534395308,67534395312,4,2427,1699,-30
67538666431,67538666434,3,1916,919,-30
67539760943,67539760949,6,3258,1269,-30
67540885214,67540885221,7,2250,1362,-30
67544109264,67544109269,5,3190,1980,-30
67546251374,67546251379,5,1853,1025,-30
67552025841,67552025842,1,1992,980,-30
67557097803,67557097811,8,2932,1091,-30
67557154453,67557154458,5,1631,955,-30
67559478955,67559478961,6,1683,1395,-30
67562248426,67562248431,5,2320,1397,-30
67563108253,67563108259,6,2475,1464,-30
67563418047,67563418025,-22,2366,1602,-30
67564872728,67564872733,5,2315,1771,-30
67567780222,67567780227,5,2189,1464,-30
67568566174,67568566178,4,1690,1133,-30
67569065178,67569065183,5,1925,1406,-30
67572739314,67572739317,3,1265,1519,-30
67573715434,67573715439,5,2363,977,-30
67576715608,67576715614,6,3338,1492,-30
67578292443,67578292445,2,1970,1897,-30
67589021313,67589021319,6,1913,922,-30
67590578698,67590578702,4,2279,1496,-30
67590619813,67590619817,4,2081,1710,-30
67592836878,67592836882,4,2056,1178,-30
67599687845,67599687853,8,1694,670,-30
67599889359,67599889378,19,1826,1293,-30
67600338453,67600338458,5,2094,1478,-30
67600663154,67600663158,4,1352,958,-30
67603116676,67603116682,6,2479,1431,-30
67605383874,67605383879,5,1929,1253,-30
67606673433,67606673439,6,2967,982,-30
67608960298,67608960303,5,1134,1007,-30
67610348923,67610348927,4,2706,1609,-30
67616430327,67616430333,6,2284,1630,-30
67620465217,67620465220,3,1948,1455,-30
67622273742,67622273749,7,2629,1167,-30
67633730173,67633730178,5,1865,966,-30
67634781703,67634781707,4,2346,1462,-30
67635164356,67635164360,4,1852,1218,-30
67637653056,67637653062,6,2680,1299,-30
67638647854,67638647859,5,1648,1075,-30
67644151797,67644151802,5,2536,1454,-30
67646601005,67646601010,5,1938,1661,-30
67648024301,67648024302,1,1491,2330,-30
67650792325,67650792329,4,2183,1034,-30
67651582823,67651582828,5,2504,1519,-30
67653657906,67653657910,4,1817,1014,-30
67654753853,67654753858,5,2882,1842,-30
67654857541,67654857546,5,2329,1145,-30
67659221593,67659221597,4,1955,1937,-30
67663324559,67663324565,6,1792,1058,-30
67664061693,67664061698,5,2269,1140,-30
67667024247,67667024249,2,1581,1236,-30
67667764801,67667764807,6,1696,1392,-30
67669865827,67669865830,3,2663,1227,-30
67671418275,67671418269,-6,1260,3522,-30
67671649753,67671649758,5,1866,1149,-30
67673680382,67673680381,-1,18910,10683,-30
67674412494,67674412499,5,2597,1432,-30
67675341398,67675341404,6,2386,1419,-30
67675970312,67675970309,-3,20409,75740,-30
67682809888,67682809895,7,2330,1636,-30
67684204280,67684204287,7,2346,1142,-30
67684654121,67684654121,0,1217,1055,-30
67695851838,67695851841,3,2194,977,-30
67696293501,67696293505,4,2869,2123,-30
67696561002,67696561006,4,2072,1019,-30
67697327513,67697327518,5,2635,1556,-30
67697424741,67697424743,2,1524,1948,-30
67698265581,67698265586,5,2022,1270,-30
67699036205,67699036209,4,2614,1159,-30
67707151669,67707151674,5,2290,1616,-30
67712648470,67712648477,7,2455,1150,-30
67715342161,67715342167,6,3210,1308,-30
67715674501,67715674506,5,2383,1251,-30
67717499677,67717499681,4,3088,1649,-30
67721199071,67721199089,18,2896,1034,-30
67722445317,67722445322,5,2798,2116,-30
67723248681,67723248685,4,1841,1109,-30
67727583213,67727583206,-7,2432,5636,-30
67732134910,67732134906,-4,1297,633,-30
67734111485,67734111488,3,2312,1588,-30
67735093386,67735093390,4,2957,1418,-30
67736485565,67736485570,5,2053,1136,-30
67739994839,67739994845,6,2196,1209,-30
67740383707,67740383713,6,2372,1497,-30
67751068643,67751068648,5,2159,1494,-30
67765091459,67765091465,6,2376,948,-30
67765935789,67765935810,21,1695,1281,-30
67766431502,67766431507,5,1794,1080,-30
67773529947,67773529952,5,2257,1265,-30
67776934961,67776934954,-7,910,1671,-30
67778500709,67778500714,5,2268,1496,-30
67779205294,67779205282,-12,1121,348,-30
67781281434,67781281438,4,2456,2062,-30
67781591679,67781591685,6,1084,968,-30
67783520050,67783520057,7,3040,1438,-30
67784364839,67784364845,6,3476,1053,-30
67787071331,67787071337,6,1795,1143,-30
67788035220,67788035220,0,18092,8564,-30
67789695013,67789695006,-7,596,1650,-30
67791128625,67791128630,5,1683,1039,-30
67791240637,67791240642,5,2128,1275,-30
67793739770,67793739776,6,2025,1457,-30
67795726507,67795726509,2,692,490,-30
67798764009,67798764011,2,1664,1007,-30
67799516722,67799516727,5,1482,992,-30
67799834461,67799834466,5,2536,1463,-30
67801113330,67801113310,-20,1348,714,-30
67801434526,67801434505,-21,1206,1040,-30
67803239601,67803239606,5,1595,1233,-30
67803915846,67803915850,4,2892,1655,-30
67804241890,67804241895,5,2118,1105,-30
67805014109,67805014089,-20,1026,416,-30
67805643485,67805643493,8,7063,2758,-30
67805901927,67805901934,7,3477,1508,-30
67806446254,67806446233,-21,2212,1463,-30
67810138118,67810138123,5,1773,1221,-30
67810646374,67810646378,4,2342,1362,-30
67811616417,67811616422,5,2420,861,-30
67812551077,67812551076,-1,846,1178,-30
67812875622,67812875628,6,2480,1948,-30
67817393975,67817393956,-19,671,428,-30
67817506550,67817506555,5,1297,802,-30
67818906143,67818906150,7,2869,1480,-30
67820609889,67820609895,6,2077,1143,-30
67820638394,67820638397,3,25503,24122,-30
67828001838,67828001842,4,1830,1373,-30
67833067806,67833067813,7,2729,1336,-30
67834571482,67834571487,5,2249,1434,-30
67841949345,67841949349,4,2817,1352,-30
67844074713,67844074719,6,2829,1333,-30
67850003365,67850003367,2,2219,1442,-30
67852111442,67852111446,4,1636,1233,-30
67859447512,67859447515,3,2061,1201,-30
67864060071,67864060076,5,1869,1804,-30
67865794203,67865794208,5,2675,1812,-30
67866717287,67866717291,4,1795,727,-30
67867902143,67867902146,3,2642,1661,-30
67868274907,67868274911,4,2315,1437,-30
67870502004,67870502005,1,1794,1203,-30
67871300787,67871300794,7,7157,2597,-30
67872187006,67872187014,8,1467,1044,-30
67872865878,67872865883,5,2465,1575,-30
67875231866,67875231871,5,2366,1676,-30
67875384041,67875384046,5,2462,1309,-30
67875663911,67875663916,5,2206,1366,-30
67875689262,67875689266,4,2852,1405,-30
67877163579,67877163583,4,2049,1568,-30
67877302426,67877302430,4,1957,1230,-30
67877426841,67877426846,5,2604,1357,-30
67881717419,67881717419,0,2958,3319,-30
67882571662,67882571666,4,2192,1381,-30
67883594074,67883594079,5,2017,1334,-30
67884421279,67884421282,3,949,835,-30
67885632243,67885632250,7,4063,2485,-30
67886572535,67886572541,6,2542,1132,-30
67890339863,67890339870,7,2174,1268,-30
67895886839,67895886846,7,2506,1387,-30
67896334568,67896334571,3,2862,1151,-30
67899755908,67899755912,4,3232,2108,-30
67900613582,67900613587,5,3054,1780,-30
67901387954,67901387959,5,1852,953,-30
67901944009,67901944015,6,2889,1377,-30
67905181729,67905181734,5,2366,1157,-30
67908225826,67908225830,4,1708,1289,-30
67908648837,67908648827,-10,983,359,-30
67916339094,67916339098,4,2335,1521,-30
67917539070,67917539075,5,3220,1723,-30
67921860428,67921860433,5,2507,1668,-30
67923012303,67923012309,6,2099,1266,-30
67926220766,67926220769,3,2372,1471,-30
67928962914,67928962919,5,2093,1084,-30
67930252321,67930252327,6,2061,1124,-30
67931320094,67931320099,5,3113,1987,-30
67932077375,67932077377,2,1356,1516,-30
67933528167,67933528171,4,1575,712,-30
67937182341,67937182344,3,1517,1091,-30
67943045501,67943045506,5,2205,1029,-30
67943075809,67943075814,5,2448,988,-30
67944275247,67944275244,-3,1605,2317,-30
67945579865,67945579869,4,1949,1058,-30
67946737661,67946737666,5,2501,1719,-30
67948952586,67948952591,5,2564,1373,-30
67952344126,67952344130,4,2263,1083,-30
67955704374,67955704378,4,1561,745,-30
67958349349,67958349348,-1,1117,1925,-30
67965907862,67965907868,6,2252,1278,-30
67974250891,67974250896,5,1954,1103,-30
67977565406,67977565411,5,3206,1179,-30
67983282546,67983282551,5,2371,1621,-30
67985907970,67985907975,5,1859,1024,-30
67988900967,67988900972,5,2027,1142,-30
67989420150,67989420160,10,2309,1043,-30
67990938542,67990938547,5,2431,1493,-30
67993661395,67993661399,4,3161,1680,-30
67994527821,67994527827,6,3211,1543,-30
67995182205,67995182210,5,2196,1575,-30
67998481861,67998481865,4,2372,1439,-30
67999432029,67999432033,4,2707,946,-30
67999600526,67999600530,4,2591,1213,-30
68003979917,68003979922,5,3598,1471,-30
68006186169,68006186175,6,1941,1013,-30
68006884189,68006884194,5,2266,1472,-30
68010987517,68010987523,6,1466,1140,-30
68011341415,68011341399,-16,1210,1021,-30
68012302838,68012302843,5,2651,1305,-30
68013743618,68013743624,6,3767,1807,-30
68017279891,68017279897,6,1825,1417,-30
68017869506,68017869507,1,1541,1343,-30
68020882230,68020882235,5,2042,1297,-30
68025684785,68025684789,4,2738,1686,-30
68027254070,68027254073,3,1827,1309,-30
68027664277,68027664282,5,2179,999,-30
68028035042,68028035059,17,1545,372,-30
68028136678,68028136698,20,2220,1235,-30
68030472461,68030472466,5,2044,1213,-30
68037606075,68037606081,6,7445,27494,-30
68038578230,68038578237,7,1412,787,-30
68042323253,68042323258,5,1847,1148,-30
68042418024,68042418033,9,2310,1275,-30
68043596186,68043596192,6,2095,1132,-30
68043624314,68043624298,-16,1583,1374,-30
68044376345,68044376348,3,2962,1378,-30
68044848834,68044848841,7,3651,851,-30
68046022783,68046022789,6,2235,1285,-30
68048038950,68048038955,5,2069,1351,-30
68054886690,68054886695,5,1746,1429,-30
68055465320,68055465326,6,3304,1141,-30
68057287201,68057287206,5,2249,1520,-30
68058789388,68058789392,4,1998,1288,-30
68059973650,68059973651,1,1515,1082,-30
68062953610,68062953614,4,1217,1493,-30
68064189442,68064189448,6,2085,1254,-30
68067114136,68067114139,3,3696,2551,-30
68068031365,68068031370,5,1996,835,-30
68071542047,68071542050,3,1927,1383,-30
68075418761,68075418767,6,2833,1464,-30
68076666947,68076666954,7,1945,1444,-30
68079450551,68079450557,6,3004,1471,-30
68083261633,68083261638,5,2180,1399,-30
68083719259,68083719241,-18,2512,1207,-30
68085784163,68085784164,1,19383,33607,-30
68090955644,68090955650,6,6716,2085,-30
68091337540,68091337546,6,2075,1206,-30
68094366462,68094366467,5,1323,1272,-30
68097645255,68097645261,6,3090,1507,-30
68097789731,68097789729,-2,1439,2387,-30
68102187092,68102187097,5,1162,1003,-30
68103195189,68103195190,1,1031,1486,-30
68105105561,68105105565,4,2064,758,-30
68106027363,68106027357,-6,1355,6665,-30
68106663967,68106663966,-1,981,1766,-30
68106711015,68106711019,4,1522,1106,-30
68109140984,68109140989,5,1661,1197,-30
68111396577,68111396582,5,2470,800,-30
68119645926,68119645930,4,2823,1843,-30
68122022168,68122022172,4,2380,1551,-30
68122725322,68122725327,5,2241,1665,-30
68124313190,68124313195,5,2160,1121,-30
68125362197,68125362202,5,1845,1047,-30
68127532158,68127532164,6,2315,1349,-30
68128900568,68128900573,5,3150,1335,-30
68130609226,68130609231,5,1907,1356,-30
68131771994,68131771998,4,2585,1509,-30
68132026171,68132026175,4,2286,1404,-30
68133009809,68133009813,4,1083,545,-30
68133354642,68133354649,7,2962,954,-30
68135783053,68135783048,-5,1263,4551,-30
68138964798,68138964802,4,1942,1040,-30
68141103418,68141103423,5,2128,1400,-30
68141729282,68141729278,-4,25993,54995,-30
68143535560,68143535563,3,1405,1280,-30
68147407813,68147407818,5,811,784,-30
68149462505,68149462510,5,1828,974,-30
68151102569,68151102573,4,1315,1057,-30
68153345933,68153345937,4,1401,1218,-30
68154656049,68154656047,-2,1261,2199,-30
68156273147,68156273152,5,2146,1482,-30
68159405193,68159405195,2,2383,1681,-30
68159482840,68159482845,5,2013,804,-30
68159834578,68159834563,-15,989,422,-30
68160232637,68160232642,5,2900,1714,-30
68160890054,68160890048,-6,1357,4583,-30
68168245220,68168245225,5,2174,768,-30
68169553498,68169553505,7,2036,1056,-30
68172691961,68172691964,3,919,976,-30
68173554458,68173554462,4,1958,1373,-30
68175389737,68175389742,5,2290,1348,-30
68176355845,68176355850,5,2194,1248,-30
68177309718,68177309723,5,2495,1214,-30
68184154794,68184154798,4,2337,1548,-30
68186159501,68186159506,5,2569,1406,-30
68186262050,68186262053,3,1912,1253,-30
68188090523,68188090530,7,2254,898,-30
68189851676,68189851681,5,2034,1287,-30
68193728541,68193728545,4,1537,1368,-30
68195051385,68195051387,2,2054,1382,-30
68195239633,68195239634,1,1628,1510,-30
68198416043,68198416050,7,2319,1223,-30
68201569891,68201569890,-1,1686,2018,-30
68201925240,68201925245,5,1608,815,-30
68204741913,68204741920,7,2291,908,-30
68207036830,68207036834,4,2130,1537,-30
68209367924,68209367929,5,2991,1938,-30
68213734033,68213734038,5,3567,1793,-30
68216071081,68216071087,6,2655,1161,-30
68218661147,68218661143,-4,2006,5977,-30
68222813642,68222813643,1,36669,46425,-30
68229857182,68229857186,4,1828,1410,-30
68230042591,68230042584,-7,1199,3586,-30
68230465341,68230465346,5,2327,1234,-30
68231429579,68231429586,7,2743,1603,-30
68233771256,68233771261,5,15372,20979,-30
68233910139,68233910145,6,2008,942,-30
68239556831,68239556838,7,3351,1517,-30
68240482492,68240482498,6,1206,938,-30
68245769413,68245769417,4,2893,1314,-30
68250702377,68250702377,0,1848,1504,-30
68251146049,68251146051,2,2163,1180,-30
68252979619,68252979625,6,2705,964,-30
68254462013,68254462020,7,3314,1633,-30
68254842412,68254842417,5,2483,1787,-30
68255952650,68255952634,-16,1822,1010,-30
68258537906,68258537910,4,1244,905,-30
68259194637,68259194641,4,2330,1740,-30
68259720415,68259720411,-4,658,251,-30
68260313757,68260313762,5,1564,1750,-30
68261638574,68261638577,3,2826,1540,-30
68263107446,68263107450,4,1659,1415,-30
68264532917,68264532921,4,1997,1283,-30
68265736040,68265736043,3,1646,1204,-30
68266719155,68266719162,7,3060,1619,-30
68268949960,68268949960,0,973,1415,-30
68271732180,68271732186,6,1623,1348,-30
68272950870,68272950876,6,3891,1592,-30
68273034282,68273034285,3,2683,1368,-30
68273785296,68273785295,-1,42527,15557,-30
68273945517,68273945498,-19,1855,1067,-30
68273983423,68273983426,3,2041,1158,-30
68274576447,68274576452,5,2118,1415,-30
68275840370,68275840374,4,2217,1298,-30
68277274022,68277274026,4,2454,1380,-30
68280168854,68280168859,5,1585,1126,-30
68281851544,68281851549,5,3330,1534,-30
68282595670,68282595676,6,2484,1981,-30
68285215150,68285215153,3,2368,2337,-30
68287404469,68287404474,5,2817,1347,-30
68291260683,68291260688,5,1572,973,-30
68292222334,68292222337,3,2057,1402,-30
68296856331,68296856340,9,3760,1296,-30
68298171471,68298171474,3,1244,1213,-30
68298929389,68298929392,3,2966,1741,-30
68300970978,68300970982,4,2710,2172,-30
68309451670,68309451675,5,2701,985,-30
68311628885,68311628877,-8,805,4451,-30
68312191673,68312191676,3,1785,1037,-30
68316686386,68316686390,4,2812,1880,-30
68320886341,68320886346,5,1620,1734,-30
68322584963,68322584967,4,1736,789,-30
68324720626,68324720631,5,2646,1190,-30
68325676521,68325676521,0,1013,444,-30
68329042034,68329042040,6,2235,950,-30
68333262602,68333262608,6,3255,1924,-30
68333689422,68333689403,-19,1772,956,-30
68336029121,68336029124,3,1768,1247,-30
68336151606,68336151611,5,1362,835,-30
68338836370,68338836375,5,1460,1093,-30
68339827777,68339827782,5,2069,1607,-30
68340253210,68340253210,0,2099,2390,-30
68341694114,68341694118,4,3272,1514,-30
68342142287,68342142291,4,2105,1521,-30
68347782387,68347782389,2,1543,1175,-30
68347876653,68347876635,-18,2714,1619,-30
68348308390,68348308398,8,6143,1064,-30
68348708205,68348708211,6,2786,1611,-30
68351552184,68351552190,6,3249,1584,-30
68355082717,68355082722,5,1845,1209,-30
68355321389,68355321391,2,1642,1215,-30
68356515062,68356515066,4,2191,1349,-30
68356850967,68356850946,-21,757,499,-30
68358252929,68358252934,5,1861,1530,-30
68359609917,68359609919,2,1142,1118,-30
68364489921,68364489926,5,2618,1224,-30
68366513463,68366513469,6,1425,858,-30
68368132538,68368132542,4,1803,1262,-30
68369952094,68369952099,5,1468,935,-30
68372856634,68372856641,7,1597,558,-30
68374456584,68374456586,2,1647,985,-30
68377132831,68377132835,4,1515,1452,-30
68377506659,68377506666,7,1674,1269,-30
68377935621,68377935627,6,2517,1044,-30
68379589294,68379589297,3,972,891,-30
68383856322,68383856323,1,1517,843,-30
68386439034,68386439033,-1,1536,2037,-30
68390542680,68390542686,6,2225,1713,-30
68391207363,68391207365,2,2129,1420,-30
68393567594,68393567599,5,2745,1417,-30
68395564393,68395564398,5,2787,1736,-30
68397352991,68397352995,4,1663,1475,-30
68400135753,68400135758,5,2031,1272,-30
68404350997,68404351003,6,2410,1419,-30
68407803711,68407803714,3,1695,1636,-30
68408935994,68408935999,5,2759,1779,-30
68414194635,68414194639,4,2445,1469,-30
68417010834,68417010839,5,2396,1626,-30
68419453189,68419453198,9,11368,35688,-30
68420269325,68420269330,5,5271,3141,-30
68420583559,68420583563,4,1530,1172,-30
68422517143,68422517146,3,1849,1518,-30
68422596295,68422596287,-8,861,5498,-30
68424637591,68424637586,-5,363,785,-30
68427118161,68427118168,7,2785,1216,-30
68432256251,68432256256,5,1759,1697,-30
68434838726,68434838731,5,2780,1544,-30
68436733934,68436733940,6,2697,1826,-30
68436836386,68436836391,5,2169,1178,-30
68437460728,68437460732,4,1744,1172,-30
68437931004,68437931010,6,2683,1434,-30
68447852298,68447852302,4,1643,1545,-30
68450204086,68450204092,6,2858,1419,-30
68458076358,68458076364,6,3665,1932,-30
68458820982,68458820987,5,2047,1435,-30
68461457346,68461457342,-4,96,1105,-30
68465346595,68465346599,4,2183,1361,-30
68477463362,68477463362,0,1249,2266,-30
68478589722,68478589726,4,2389,1025,-30
68487779246,68487779253,7,2712,1964,-30
68488303890,68488303896,6,1751,1207,-30
68488760366,68488760370,4,2498,1235,-30
68489109067,68489109068,1,759,189,-30
68489580199,68489580210,11,1271,1572,-30
68491375802,68491375806,4,2250,993,-30
68496864961,68496864967,6,1704,1404,-30
68498420273,68498420278,5,1955,1274,-30
68498769034,68498769040,6,3110,1327,-30
68499619258,68499619265,7,3202,1444,-30
68500040394,68500040401,7,2813,1895,-30
68501675911,68501675914,3,2093,1139,-30
68507025109,68507025114,5,1950,852,-30
68507772971,68507772978,7,1971,1263,-30
68508237726,68508237737,11,2006,1092,-30
68508969286,68508969292,6,2449,1868,-30
68518204973,68518204979,6,3287,1608,-30
68521569259,68521569264,5,2693,2085,-30
68532621026,68532621029,3,1966,1519,-30
68536014902,68536014905,3,2172,1249,-30
68536913726,68536913727,1,2338,1470,-30
68538949312,68538949317,5,2297,1643,-30
68540577246,68540577252,6,2687,1191,-30
68541131496,68541131499,3,2189,1244,-30
68542219299,68542219305,6,2417,1393,-30
68548983626,68548983630,4,2915,1878,-30
68549810989,68549810987,-2,1090,2152,-30
68551197485,68551197485,0,1905,2207,-30
68553205341,68553205347,6,2125,1154,-30
68553334502,68553334507,5,946,740,-30
68555322768,68555322773,5,2526,1165,-30
68555553402,68555553387,-15,2055,1452,-30
68556311713,68556311718,5,2443,1162,-30
68564222007,68564222011,4,2214,1046,-30
68564532346,68564532350,4,1245,1131,-30
68566233046,68566233050,4,2242,1558,-30
68570784561,68570784566,5,2120,1411,-30
68572854324,68572854330,6,2757,1453,-30
68572963045,68572963028,-17,2557,973,-30
68573231887,68573231883,-4,1393,3944,-30
68573778662,68573778644,-18,1454,443,-30
68574740691,68574740697,6,2629,1415,-30
68574905129,68574905132,3,1660,1330,-30
68577337941,68577337944,3,1871,1196,-30
68578267948,68578267951,3,2345,1239,-30
68579282654,68579282657,3,1342,1448,-30
68580257849,68580257852,3,2030,844,-30
68580664941,68580664961,20,592,212,-30
68588119939,68588119946,7,1891,1318,-30
68588834551,68588834553,2,1339,1520,-30
68595821905,68595821910,5,2850,1272,-30
68597837863,68597837869,6,2390,1035,-30
68598870547,68598870550,3,876,697,-30
68602016395,68602016389,-6,2244,9245,-30
68604668626,68604668631,5,2115,1365,-30
68604818730,68604818745,15,3127,975,-30
68607177318,68607177323,5,1581,1148,-30
68608695338,68608695343,5,1543,1064,-30
68608753889,68608753896,7,2791,1439,-30
68609159390,68609159394,4,1641,1342,-30
68609863858,68609863864,6,2109,1507,-30
68612163973,68612163979,6,1531,1177,-30
68613561815,68613561819,4,2451,1587,-30
68613691193,68613691197,4,2790,1842,-30
68621023773,68621023779,6,2418,1277,-30
68623262682,68623262686,4,2613,1165,-30
68625698360,68625698363,3,2211,1560,-30
68629243918,68629243925,7,2231,1267,-30
68631686912,68631686913,1,1485,1060,-30
68632106564,68632106557,-7,778,4835,-30
68632705031,68632705037,6,2781,1624,-30
68634945857,68634945861,4,2485,1127,-30
68635069210,68635069194,-16,2274,802,-30
68638537340,68638537346,6,2116,1155,-30
68640248936,68640248941,5,2343,1359,-30
68641770818,68641770821,3,2249,1358,-30
68642777080,68642777086,6,2175,1133,-30
68644695618,68644695622,4,2287,1335,-30
68647330493,68647330499,6,2789,1033,-30
68647976699,68647976705,6,2495,1636,-30
68648127104,68648127110,6,2080,891,-30
68656506822,68656506826,4,1778,1127,-30
68657641834,68657641838,4,1611,909,-30
68658472243,68658472249,6,2367,1154,-30
68661717955,68661717960,5,1851,923,-30
68661986850,68661986833,-17,1429,995,-30
68662933821,68662933824,3,1754,853,-30
68666182502,68666182507,5,2098,1084,-30
68667714406,68667714405,-1,1157,1878,-30
68674960949,68674960955,6,3580,1820,-30
68675223690,68675223694,4,2484,1634,-30
68676138496,68676138500,4,3477,2299,-30
68678593063,68678593068,5,2255,1407,-30
68680814565,68680814567,2,2207,1157,-30
68682754910,68682754917,7,2004,1379,-30
68684585510,68684585513,3,2551,1690,-30
68686781429,68686781435,6,2557,1228,-30
68688786761,68688786767,6,1588,1174,-30
68693554618,68693554622,4,2157,1539,-30
68696818831,68696818835,4,1923,1513,-30
68701453504,68701453509,5,2474,1667,-30
68701573114,68701573120,6,2015,1127,-30
68702716896,68702716901,5,1424,1362,-30
68703000582,68703000587,5,2097,1671,-30
68706267623,68706267629,6,1741,938,-30
68707000058,68707000063,5,3358,1788,-30
68708925578,68708925582,4,2433,1171,-30
68709293745,68709293751,6,2852,1407,-30
68718632038,68718632045,7,2676,1068,-30
68719584997,68719585003,6,2607,860,-30
68722032360,68722032363,3,1755,1394,-30
68723421624,68723421627,3,1277,1004,-30
68725259818,68725259822,4,2561,1067,-30
68727137653,68727137653,0,1170,1896,-30
68730660963,68730660969,6,2574,1283,-30
68730896954,68730896959,5,2378,1387,-30
68730989233,68730989235,2,1957,1447,-30
68737935809,68737935802,-7,1292,7359,-30
68739370595,68739370602,7,2521,1511,-30
68740348389,68740348394,5,2415,1624,-30
68751338494,68751338501,7,2167,1210,-30
68756885530,68756885535,5,3078,1378,-30
68760610569,68760610574,5,1807,1028,-30
68764246497,68764246502,5,1909,1183,-30
68764845119,68764845124,5,2893,1266,-30
68765892964,68765892963,-1,2883,3996,-30
68766607981,68766607995,14,2243,1161,-30
68767179366,68767179372,6,3631,1824,-30
68769372874,68769372878,4,1998,1409,-30
68771907570,68771907577,7,2735,1540,-30
68773369013,68773369018,5,2877,1469,-30
68774995882,68774995886,4,1822,1485,-30
68775350421,68775350421,0,1256,1231,-30
68782258827,68782258830,3,2267,1411,-30
68784020628,68784020635,7,2080,1212,-30
68787046614,68787046615,1,1050,1132,-30
68787924882,68787924886,4,2293,1675,-30
68800132388,68800132391,3,1634,1171,-30
68803042090,68803042092,2,1692,1375,-30
68803537275,68803537282,7,984,242,-30
68808927678,68808927684,6,2668,1409,-30
68810703605,68810703610,5,2148,1773,-30
68819764726,68819764724,-2,1413,2933,-30
68822650170,68822650175,5,2325,1237,-30
68823197053,68823197060,7,1829,745,-30
68824148486,68824148489,3,2009,1857,-30
68827986687,68827986682,-5,1241,3212,-30
68830024076,68830024082,6,2267,1250,-30
68838167316,68838167321,5,2294,1009,-30
68839367434,68839367439,5,1830,1393,-30
68843025406,68843025411,5,3007,1460,-30
68846192797,68846192801,4,2613,1076,-30
68847523739,68847523742,3,931,859,-30
68850006618,68850006622,4,2208,1563,-30
68850566845,68850566851,6,1902,1465,-30
68855309722,68855309728,6,2552,1765,-30
68860716391,68860716387,-4,643,1520,-30
68861485958,68861485960,2,1821,1149,-30
68862865658,68862865662,4,2435,1543,-30
68863177683,68863177690,7,3194,1069,-30
68868007486,68868007485,-1,751,1446,-30
68873488842,68873488846,4,2213,1132,-30
68875500995,68875501001,6,2263,1694,-30
68876768441,68876768445,4,2054,1554,-30
68880860886,68880860890,4,2113,1471,-30
68884628911,68884628909,-2,1565,2487,-30
68885130185,68885130191,6,2320,1603,-30
68886070368,68886070373,5,2539,1888,-30
68888484934,68888484938,4,2304,1222,-30
68889296942,68889296947,5,2528,1446,-30
68889911774,68889911778,4,2389,1260,-30
68893219509,68893219512,3,2276,1537,-30
68896172793,68896172801,8,1683,850,-30
68896366278,68896366284,6,2318,1189,-30
68896664702,68896664708,6,1824,1320,-30
68897500282,68897500268,-14,1805,1337,-30
68898158979,68898158985,6,2483,1762,-30
68902940149,68902940153,4,1528,1273,-30
68903544077,68903544083,6,1860,956,-30
68904438805,68904438810,5,2772,1281,-30
68905616117,68905616125,8,2989,1581,-30
68906832105,68906832111,6,1817,1009,-30
68907949000,68907949004,4,1847,1182,-30
68908595208,68908595214,6,2593,1426,-30
68908661038,68908661044,6,1644,795,-30
68915064357,68915064359,2,2423,1410,-30
68917884813,68917884817,4,2618,1564,-30
68918771595,68918771602,7,2724,1508,-30
68920349890,68920349886,-4,5686,13500,-30
68923582250,68923582254,4,1975,1210,-30
68925438472,68925438478,6,2389,1603,-30
68925467206,68925467202,-4,643,170,-30
68928958361,68928958365,4,2423,1446,-30
68931213856,68931213862,6,1164,901,-30
68932474077,68932474083,6,2586,1415,-30
68933344014,68933344019,5,1131,869,-30
68935154737,68935154742,5,4153,2542,-30
68935591067,68935591071,4,2113,1535,-30
68936576965,68936576969,4,2240,2123,-30
68939756521,68939756526,5,2189,1294,-30
68941608634,68941608638,4,2302,2024,-30
68943188588,68943188593,5,2317,1612,-30
68944837547,68944837553,6,1176,787,-30
68947740990,68947740989,-1,3891,2949,-30
68949198156,68949198161,5,2353,1462,-30
68952830489,68952830494,5,1955,1057,-30
68952933793,68952933798,5,2262,1098,-30
68955286490,68955286494,4,2438,1133,-30
68960065430,68960065425,-5,1218,2626,-30
68964189265,68964189269,4,2352,1585,-30
68964750937,68964750940,3,2592,1288,-30
68965500755,68965500771,16,778,308,-30
68965813541,68965813562,21,3029,1258,-30
68969112602,68969112606,4,2413,1512,-30
68969305685,68969305690,5,2135,1151,-30
68970389882,68970389886,4,1760,1261,-30
68971657032,68971657038,6,2358,1422,-30
68972245581,68972245586,5,2661,1469,-30
68976597988,68976597993,5,3414,1825,-30
68982347809,68982347815,6,2637,1162,-30
68982432136,68982432123,-13,1639,600,-30
68986207709,68986207710,1,1903,1412,-30
68988279257,68988279259,2,2207,1471,-30
68992184524,68992184530,6,2397,1208,-30
68995177392,68995177391,-1,1911,2060,-30
68997161826,68997161830,4,1844,1244,-30
68998688827,68998688841,14,2121,6344,-30
68999534018,68999534025,7,3002,1631,-30
69004336889,69004336897,8,3366,1352,-30
69011615674,69011615678,4,1937,1077,-30
69017069527,69017069531,4,1496,735,-30
69018066404,69018066409,5,1747,1174,-30
69021034393,69021034398,5,2252,1134,-30
69024424620,69024424622,2,1784,946,-30
69025341200,69025341204,4,2344,1804,-30
69029586603,69029586608,5,2947,1399,-30
69031911074,69031911081,7,1298,782,-30
69033196157,69033196162,5,2136,1230,-30
69033350110,69033350123,13,682,325,-30
69036350754,69036350760,6,2602,1015,-30
69036934369,69036934376,7,2383,1354,-30
69040514712,69040514718,6,1681,1139,-30
69040614727,69040614731,4,782,1254,-30
69041253628,69041253632,4,3204,1532,-30
69041648034,69041648039,5,2585,1437,-30
69042068694,69042068697,3,2590,1199,-30
69045742758,69045742748,-10,938,1765,-30
69046872461,69046872466,5,2162,1479,-30
69048542594,69048542598,4,1759,1359,-30
69048935709,69048935690,-19,1499,941,-30
69049652966,69049652971,5,2345,1604,-30
69050526647,69050526653,6,2335,1282,-30
69054087391,69054087396,5,1930,1210,-30
69055260688,69055260695,7,2568,841,-30
69057222723,69057222727,4,2185,1162,-30
69060085683,69060085680,-3,773,1654,-30
69060277565,69060277568,3,4360,2610,-30
69063503387,69063503397,10,1933,1272,-30
69065485129,69065485133,4,2536,1064,-30
69066674558,69066674564,6,2813,1430,-30
69069463672,69069463675,3,2388,1067,-30
69070168206,69070168211,5,2550,1223,-30
69074750629,69074750631,2,1686,1831,-30
69074930600,69074930603,3,3138,1653,-30
69075679881,69075679887,6,2173,1415,-30
69076601730,69076601735,5,2789,937,-30
69079315496,69079315502,6,2229,1189,-30
69079546075,69079546081,6,2423,1154,-30
69084543805,69084543810,5,2614,1391,-30
69088681479,69088681485,6,2771,1392,-30
69089433706,69089433714,8,2265,1308,-30
69089655286,69089655294,8,2357,1561,-30
69091019722,69091019714,-8,1896,9362,-30
69091339686,69091339664,-22,731,303,-30
69092298595,69092298602,7,3480,1887,-30
69093733965,69093733970,5,1745,929,-30
69093759929,69093759914,-15,538,244,-30
69095303994,69095303999,5,1760,1443,-30
69095590419,69095590423,4,1940,1164,-30
69096299705,69096299710,5,1996,938,-30
69099563502,69099563502,0,1194,1593,-30
69100069913,69100069917,4,2459,1415,-30
69103255195,69103255200,5,3020,1536,-30
69104993125,69104993129,4,2442,1466,-30
69108047778,69108047782,4,1767,990,-30
69111643371,69111643371,0,1829,1784,-30
69111734476,69111734482,6,3251,1008,-30
69111784206,69111784185,-21,2326,1230,-30
69116472710,69116472715,5,3061,1447,-30
69118873426,69118873430,4,1813,1285,-30
69121663213,69121663220,7,2176,1390,-30
69122053308,69122053290,-18,2403,1293,-30
69122482361,69122482362,1,1981,3743,-30
69122516774,69122516767,-7,1194,3819,-30
69126942203,69126942197,-6,2538,5898,-30
69131081991,69131081991,0,1511,1994,-30
69131303690,69131303698,8,2738,1195,-30
69133902818,69133902823,5,4170,1472,-30
69133995050,69133995055,5,2262,1426,-30
69135203402,69135203407,5,1917,1049,-30
69136589190,69136589195,5,2769,1501,-30
69146500398,69146500405,7,1604,777,-30
69150222777,69150222782,5,1531,1056,-30
69154643390,69154643396,6,2287,1049,-30
69156324897,69156324902,5,2110,1388,-30
69156635257,69156635240,-17,2382,1184,-30
69157510385,69157510391,6,2620,1890,-30
69160181169,69160181177,8,2907,939,-30
69160439975,69160439980,5,1945,1238,-30
69161696228,69161696231,3,1834,1332,-30
69164426469,69164426474,5,2993,1306,-30
69164968997,69164968998,1,1709,1002,-30
69165066766,69165066765,-1,1519,2359,-30
69166891495,69166891499,4,2093,1484,-30
69166978102,69166978112,10,901,235,-30
69168618275,69168618279,4,2134,1165,-30
69168837900,69168837904,4,2622,1579,-30
69168946992,69168946996,4,1906,1285,-30
69171434374,69171434381,7,2953,1507,-30
69173562336,69173562334,-2,1644,1201,-30
69177208195,69177208198,3,2863,1796,-30
69177873400,69177873422,22,172,1028,-30
69181865910,69181865915,5,2495,1307,-30
69182875446,69182875439,-7,1062,1370,-30
69185582216,69185582222,6,2013,1261,-30
69187933647,69187933654,7,2806,1242,-30
69190132477,69190132482,5,2534,1438,-30
69190330798,69190330795,-3,1219,1847,-30
69191446597,69191446600,3,2168,1252,-30
69192908413,69192908417,4,1190,1317,-30
69196446774,69196446779,5,3381,1575,-30
69198703274,69198703278,4,1925,1602,-30
69199186410,69199186415,5,2280,1303,-30
69200806407,69200806408,1,2009,2208,-30
69202156931,69202156936,5,1869,1039,-30
69202541359,69202541364,5,1613,1175,-30
69203515712,69203515710,-2,32111,56713,-30
69204737387,69204737390,3,2154,1562,-30
69207887186,69207887191,5,2526,1154,-30
69209918617,69209918623,6,2236,1046,-30
69213486023,69213486029,6,1965,1313,-30
69216142362,69216142365,3,1459,1179,-30
69216348531,69216348538,7,1914,1038,-30
69217684850,69217684856,6,2287,1163,-30
69227802713,69227802716,3,2286,1193,-30
69236868875,69236868879,4,1472,1025,-30
69244362323,69244362329,6,2485,1394,-30
69244729773,69244729794,21,1677,1220,-30
69244822279,69244822264,-15,788,189,-30
69246673610,69246673616,6,2190,999,-30
69250398777,69250398782,5,3171,1876,-30
69254832924,69254832922,-2,1759,2976,-30
69257619515,69257619521,6,2462,1436,-30
69259113426,69259113433,7,2052,1497,-30
69262559868,69262559873,5,2749,1254,-30
69266063269,69266063274,5,1784,1141,-30
69266215765,69266215761,-4,899,3296,-30
69270817414,69270817418,4,2105,1515,-30
69273662529,69273662534,5,2167,1093,-30
69275139889,69275139891,2,2280,1313,-30
69278278396,69278278401,5,2215,1489,-30
69280081967,69280081971,4,1742,1253,-30
69280342650,69280342632,-18,2237,838,-30
69286621686,69286621690,4,1869,1445,-30
69290333914,69290333920,6,2397,1474,-30
69292246978,69292246985,7,3339,1444,-30
69297568235,69297568235,0,5709,9113,-30
69297829346,69297829331,-15,1347,556,-30
69299242709,69299242713,4,1879,1692,-30
69302111213,69302111218,5,3485,1562,-30
69303791370,69303791377,7,2144,1497,-30
69308906411,69308906404,-7,962,223,-30
69310110061,69310110057,-4,1526,3253,-30
69310426567,69310426572,5,1949,1497,-30
69311139118,69311139138,20,441,2044,-30
69321140010,69321140014,4,2452,1855,-30
69323241713,69323241717,4,2250,1242,-30
69329355399,69329355403,4,2393,1290,-30
69334145814,69334145817,3,1593,924,-30
69335110153,69335110158,5,3082,1044,-30
69335136955,69335136963,8,1033,781,-30
69335162121,69335162137,16,2253,1279,-30
69335589562,69335589567,5,2166,1210,-30
69336844431,69336844436,5,2154,1532,-30
69338341355,69338341361,6,2484,1465,-30
69339326918,69339326921,3,1995,1604,-30
69341137606,69341137613,7,2106,983,-30
69341910717,69341910722,5,5842,2303,-30
69344307386,69344307391,5,1677,952,-30
69345327182,69345327186,4,1528,980,-30
69345432707,69345432712,5,2036,1182,-30
69346917736,69346917741,5,2291,1142,-30
69348045670,69348045675,5,2414,1238,-30
69348116783,69348116790,7,2815,916,-30
69352141474,69352141478,4,1697,807,-30
69353634242,69353634247,5,1954,1452,-30
69359269081,69359269086,5,3365,1276,-30
69359339439,69359339443,4,2836,1602,-30
69364653117,69364653124,7,4262,1325,-30
69366833289,69366833293,4,1963,1203,-30
69373174122,69373174129,7,2000,1488,-30
69373258826,69373258826,0,903,1039,-30
69374974393,69374974397,4,2389,1956,-30
69375041714,69375041718,4,2074,1374,-30
69377440020,69377440036,16,1960,986,-30
69380282266,69380282271,5,2071,928,-30
69381220274,69381220256,-18,2298,849,-30
69381690487,69381690490,3,2399,1237,-30
69383080190,69383080195,5,3295,1517,-30
69384046452,69384046454,2,1906,1124,-30
69387676499,69387676503,4,1905,1000,-30
69390253296,69390253301,5,1895,1170,-30
69394939735,69394939741,6,3974,1517,-30
69395014154,69395014158,4,1716,1059,-30
69395306125,69395306131,6,1995,897,-30
69397323387,69397323389,2,2366,1620,-30
69397504247,69397504253,6,1730,1106,-30
69397967074,69397967080,6,1688,1393,-30
69400440485,69400440489,4,1513,1037,-30
69401923197,69401923202,5,2132,1127,-30
69406316885,69406316890,5,2185,1470,-30
69409742971,69409742977,6,2759,1525,-30
69410553795,69410553801,6,1514,1478,-30
69411366146,69411366151,5,2482,1107,-30
69416795757,69416795754,-3,1661,3343,-30
69417251878,69417251882,4,2076,958,-30
69418468286,69418468293,7,1999,1340,-30
69420769661,69420769667,6,2037,944,-30
69421393754,69421393758,4,1386,974,-30
69422385387,69422385390,3,1710,1055,-30
69422567149,69422567153,4,2114,1089,-30
69435802320,69435802326,6,2073,1445,-30
69436652373,69436652378,5,1854,1216,-30
69438770724,69438770727,3,1882,1533,-30
69439700112,69439700118,6,2098,1209,-30
69440396353,69440396358,5,2386,1077,-30
69440537122,69440537125,3,1537,1117,-30
69443670142,69443670147,5,3551,1610,-30
69446859303,69446859309,6,3030,1259,-30
69451755090,69451755094,4,2051,1147,-30
69451906928,69451906923,-5,1298,3960,-30
69456109967,69456109973,6,2095,1214,-30
69456475780,69456475803,23,2102,1659,-30
69459959471,69459959477,6,2608,1521,-30
69469444447,69469444451,4,1762,991,-30
69471505142,69471505146,4,2309,1622,-30
69471850344,69471850347,3,1704,1060,-30
69473041575,69473041579,4,1886,1119,-30
69473615817,69473615822,5,2442,1782,-30
69477460374,69477460379,5,1290,563,-30
69480548080,69480548085,5,2370,1069,-30
69480577595,69480577578,-17,591,299,-30
69486139660,69486139665,5,2208,1189,-30
69488077899,69488077900,1,11716,16097,-30
69489483870,69489483875,5,2620,1823,-30
69495382089,69495382093,4,1747,876,-30
69496150070,69496150074,4,3582,1698,-30
69496387789,69496387795,6,2317,1817,-30
69498097474,69498097479,5,2076,1188,-30
69498423528,69498423531,3,1719,1154,-30
69504048994,69504048995,1,1584,1848,-30
69508033077,69508033081,4,2934,1754,-30
69509155922,69509155929,7,1906,1233,-30
69509592733,69509592738,5,2521,1130,-30
69512974326,69512974330,4,1725,1022,-30
69516135763,69516135769,6,3036,1608,-30
69528380612,69528380617,5,2293,1331,-30
69534535817,69534535822,5,2475,1082,-30
69536124319,69536124323,4,2044,1243,-30
69537220078,69537220083,5,2602,1518,-30
69545403825,69545403830,5,2097,1686,-30
69546191669,69546191673,4,3174,1867,-30
69548268511,69548268514,3,2679,1583,-30
69549389550,69549389550,0,640,717,-30
69550822705,69550822710,5,2041,915,-30
69552698950,69552698945,-5,1954,7934,-30
69556829570,69556829574,4,1454,673,-30
69558558058,69558558065,7,3343,1444,-30
69564454665,69564454669,4,1806,1715,-30
69569104514,69569104519,5,1179,732,-30
69569627498,69569627501,3,2050,1073,-30
69573427052,69573427054,2,1529,477,-30
69573803587,69573803591,4,2213,1208,-30
69580937710,69580937714,4,1751,1473,-30
69583646245,69583646250,5,1934,1345,-30
69584130334,69584130334,0,1557,1323,-30
69587015809,69587015813,4,1306,1114,-30
69591872322,69591872326,4,2045,1192,-30
69594887206,69594887213,7,2963,1398,-30
69595217039,69595217045,6,3657,1835,-30
69595496910,69595496915,5,2256,1132,-30
69600710545,69600710550,5,2488,1648,-30
69601148318,69601148323,5,2495,1332,-30
69602390810,69602390815,5,1570,887,-30
69603526821,69603526801,-20,1924,1114,-30
69605372395,69605372397,2,2908,3022,-30
69607093478,69607093482,4,2721,1488,-30
69607138878,69607138883,5,1724,901,-30
69607633545,69607633550,5,1877,1001,-30
69607949371,69607949377,6,2363,1287,-30
69608726748,69608726751,3,2366,999,-30
69610388745,69610388751,6,3307,864,-30
69612916105,69612916109,4,2656,1578,-30
69612985872,69612985877,5,1857,1450,-30
69614748306,69614748308,2,1510,1227,-30
69616263214,69616263220,6,1832,1695,-30
69616934038,69616934045,7,1679,1252,-30
69617121421,69617121425,4,2004,1274,-30
69618898850,69618898854,4,2289,2084,-30
69620571861,69620571863,2,668,804,-30
69626015150,69626015156,6,2633,1708,-30
69628176052,69628176056,4,1627,1080,-30
69628599403,69628599394,-9,931,1886,-30
69629247233,69629247235,2,1952,1002,-30
69630059118,69630059125,7,2268,1966,-30
69630113700,69630113704,4,2334,1628,-30
69630283113,69630283111,-2,1846,1046,-30
69632834979,69632834981,2,1930,1276,-30
69634621573,69634621578,5,2036,1021,-30
69636005629,69636005635,6,2666,1121,-30
69639159270,69639159275,5,2476,1410,-30
69639283386,69639283390,4,2108,1710,-30
69639457201,69639457205,4,2311,1107,-30
69640706004,69640706007,3,8840,6837,-30
69645156398,69645156402,4,2038,880,-30
69645439855,69645439860,5,2086,1134,-30
69646209941,69646209947,6,2110,1796,-30
69648635454,69648635459,5,2247,993,-30
69649136976,69649136981,5,2345,990,-30
69649759711,69649759708,-3,2026,6100,-30
69656486190,69656486190,0,1075,1610,-30
69662503053,69662503058,5,5875,1572,-30
69663440497,69663440504,7,2523,1100,-30
69665475550,69665475554,4,2119,1039,-30
69668235960,69668235963,3,2388,888,-30
69669558458,69669558464,6,3207,1841,-30
69669770887,69669770881,-6,1380,6763,-30
69673485527,69673485533,6,2104,1212,-30
69673703043,69673703049,6,1979,1419,-30
69675405855,69675405864,9,2641,1721,-30
69677879247,69677879253,6,3289,1492,-30
69679349002,69679349007,5,1679,2099,-30
69679773446,69679773450,4,2318,1444,-30
69683571988,69683571986,-2,1361,1634,-30
69684389772,69684389777,5,17251,42140,-30
69685011987,69685011992,5,3094,1767,-30
69685496416,69685496418,2,2377,1297,-30
69686794093,69686794098,5,3345,1452,-30
69686971675,69686971678,3,1815,1289,-30
69687029207,69687029211,4,860,517,-30
69689247898,69689247904,6,2263,1163,-30
69690899504,69690899509,5,1873,1694,-30
69698038920,69698038925,5,2455,1459,-30
69702180008,69702180009,1,13957,15055,-30
69704454126,69704454131,5,2466,845,-30
69707092814,69707092823,9,1803,1176,-30
69707853165,69707853169,4,1448,1086,-30
69710291532,69710291538,6,2013,1306,-30
69712223358,69712223364,6,2134,1719,-30
69715098308,69715098312,4,1446,989,-30
69715477228,69715477233,5,2760,1599,-30
69716098109,69716098105,-4,1195,2729,-30
69718982535,69718982540,5,1761,1113,-30
69720440972,69720440979,7,6957,2902,-30
69726009211,69726009216,5,2599,1396,-30
69728526405,69728526411,6,1856,1288,-30
69728610406,69728610387,-19,2057,1477,-30
69730048552,69730048557,5,2443,1319,-30
69730769073,69730769059,-14,2666,1128,-30
69732520757,69732520759,2,1063,863,-30
69733902875,69733902880,5,2419,969,-30
69735007472,69735007477,5,2239,1385,-30
69740191197,69740191202,5,2322,947,-30
69740277894,69740277900,6,1279,907,-30
69741084756,69741084760,4,2064,1131,-30
69742928489,69742928493,4,2212,1573,-30
69744297026,69744297031,5,1795,1221,-30
69744545915,69744545921,6,1747,1295,-30
69750065030,69750065036,6,2628,1955,-30
69750259827,69750259841,14,1779,762,-30
69751903533,69751903538,5,877,606,-30
69756377875,69756377879,4,1951,1111,-30
69758773827,69758773834,7,2591,1213,-30
69762296358,69762296362,4,1356,1828,-30
69766507070,69766507074,4,2368,1719,-30
69768851118,69768851126,8,11195,28564,-30
69769043241,69769043245,4,1497,1061,-30
69769393674,69769393679,5,1722,1446,-30
69774634131,69774634135,4,2165,1447,-30
69774897145,69774897151,6,2007,1321,-30
69775235322,69775235327,5,2140,1020,-30
69776042205,69776042227,22,1186,298,-30
69776188643,69776188647,4,3634,3716,-30
69778808747,69778808753,6,1324,1229,-30
69781458268,69781458273,5,1467,1063,-30
69785020956,69785020959,3,2471,1582,-30
69788865126,69788865130,4,1652,976,-30
69788962343,69788962354,11,1900,1291,-30
69791906314,69791906319,5,2300,1552,-30
69793892937,69793892942,5,2056,1297,-30
69794492466,69794492471,5,1649,869,-30
69795031066,69795031049,-17,652,433,-30
69795701953,69795701956,3,1223,1133,-30
69803517107,69803517111,4,2074,1305,-30
69805047313,69805047318,5,1568,1193,-30
69805612736,69805612743,7,3297,1019,-30
69808278556,69808278562,6,3154,1468,-30
69813398878,69813398882,4,2186,1971,-30
69824918516,69824918521,5,2222,1560,-30
69830375014,69830375018,4,1394,692,-30
69834032354,69834032359,5,2405,1269,-30
69836379595,69836379599,4,1365,902,-30
69836692673,69836692677,4,2096,1410,-30
69837352567,69837352571,4,2118,1804,-30
69838939312,69838939318,6,2711,1458,-30
69840573395,69840573400,5,3037,1748,-30
69841267047,69841267054,7,3065,1001,-30
69843085572,69843085577,5,1909,1674,-30
69843245663,69843245667,4,2314,1406,-30
69845306899,69845306903,4,2771,970,-30
69845394741,69845394744,3,2493,1617,-30
69847663993,69847663997,4,2624,1356,-30
69851550946,69851550950,4,1704,1577,-30
69854752186,69854752195,9,1783,886,-30
69857110938,69857110942,4,1543,964,-30
69857228746,69857228754,8,6396,3077,-30
69860913984,69860913990,6,2300,1246,-30
69861393915,69861393919,4,2873,1511,-30
69862242490,69862242495,5,1899,1430,-30
69868507929,69868507937,8,3021,1372,-30
69869018649,69869018651,2,1881,937,-30
69869621758,69869621763,5,2134,1314,-30
69870838641,69870838644,3,1843,1046,-30
69871142213,69871142218,5,2873,1563,-30
69874551118,69874551112,-6,1787,5149,-30
69874708088,69874708092,4,1920,1403,-30
69875540502,69875540507,5,2396,1387,-30
69878338333,69878338340,7,2178,1342,-30
69878622463,69878622463,0,1583,1930,-30
69881099039,69881099047,8,1372,749,-30
69883276321,69883276325,4,1791,1598,-30
69883585705,69883585710,5,3075,2503,-30
69883787376,69883787382,6,3371,1883,-30
69884073029,69884073034,5,2370,1345,-30
69885984494,69885984499,5,2473,1333,-30
69887775808,69887775808,0,2093,2259,-30
69888034121,69888034126,5,2207,1257,-30
69889150078,69889150085,7,2994,1742,-30
69894823634,69894823640,6,2482,1846,-30
69895819162,69895819169,7,2211,1267,-30
69896390333,69896390347,14,1732,1183,-30
69897158187,69897158193,6,1559,1399,-30
69898834650,69898834657,7,3515,1818,-30
69901154663,69901154661,-2,1062,2016,-30
69907055830,69907055831,1,1619,1518,-30
69907585078,69907585079,1,1472,1774,-30
69907882967,69907882973,6,2347,980,-30
69910816156,69910816161,5,2420,1444,-30
69911850458,69911850462,4,1948,1497,-30
69913538710,69913538716,6,2277,1799,-30
69914040657,69914040661,4,2310,1686,-30
69914087236,69914087236,0,34611,24640,-30
69915039786,69915039791,5,2550,1074,-30
69919540653,69919540657,4,1625,1430,-30
69925495853,69925495859,6,2953,1518,-30
69928087171,69928087176,5,1984,1113,-30
69935451526,69935451510,-16,240,4142,-30
69936387499,69936387493,-6,40259,3215,-30
69939633543,69939633547,4,2160,1250,-30
69940297141,69940297143,2,1474,1670,-30
69943877494,69943877499,5,2174,1529,-30
69955126558,69955126563,5,2681,1241,-30
69955234598,69955234602,4,1664,935,-30
69955293071,69955293091,20,2493,1667,-30
69956854551,69956854557,6,1984,1613,-30
69958124261,69958124267,6,1832,954,-30
69958883326,69958883330,4,14005,8704,-30
69965260198,69965260202,4,2207,1605,-30
69968268754,69968268758,4,1305,623,-30
69970062841,69970062846,5,2487,1782,-30
69971329957,69971329962,5,2185,1011,-30
69972247501,69972247506,5,1798,1460,-30
69973646354,69973646359,5,2276,1438,-30
69974025572,69974025562,-10,1495,1313,-30
69974316915,69974316920,5,2064,1277,-30
69979421374,69979421379,5,1599,1095,-30
69981100073,69981100080,7,2140,1606,-30
69981546328,69981546331,3,1966,1211,-30
69991764235,69991764240,5,2042,1338,-30
69992438006,69992438011,5,2191,1192,-30
69993035430,69993035436,6,2753,1343,-30
69993605118,69993605123,5,2356,1336,-30
69998781438,69998781444,6,2305,1367,-30
69999495203,69999495205,2,37633,32279,-30
70001134778,70001134765,-13,721,234,-30
70001682311,70001682310,-1,1345,1937,-30
70002382909,70002382908,-1,1113,1781,-30
70002681572,70002681577,5,1893,954,-30
70002797392,70002797395,3,1754,1111,-30
70004742040,70004742046,6,2090,1383,-30
70004894535,70004894535,0,1163,1385,-30
70005987886,70005987892,6,3211,1475,-30
70006099382,70006099386,4,2290,1137,-30
70006745009,70006745010,1,1484,1565,-30
70011369208,70011369213,5,1315,902,-30
70011924985,70011924991,6,3058,1294,-30
70020562472,70020562478,6,2193,962,-30
70024228347,70024228341,-6,2104,6976,-30
70027704246,70027704251,5,1746,983,-30
70028311682,70028311666,-16,1503,919,-30
70028758797,70028758776,-21,2784,1307,-30
70032163172,70032163174,2,1444,1574,-30
70033438205,70033438215,10,1127,523,-30
70034562218,70034562223,5,1205,931,-30
70038710167,70038710160,-7,2128,35142,-30
70038742362,70038742367,5,1622,793,-30
70042706132,70042706136,4,1490,887,-30
70044324096,70044324100,4,1850,1456,-30
70049349390,70049349387,-3,2074,3543,-30
70051063246,70051063251,5,2842,1289,-30
70059153145,70059153149,4,2232,1157,-30
70059654324,70059654330,6,2706,1159,-30
70060646358,70060646363,5,2479,1463,-30
70060819581,70060819566,-15,1597,274,-30
70061169778,70061169763,-15,695,425,-30
70061907901,70061907905,4,2190,1655,-30
70062052494,70062052497,3,2362,1252,-30
70062945454,70062945457,3,1837,1193,-30
70063335599,70063335578,-21,579,746,-30
70065310560,70065310564,4,1963,1134,-30
70066096598,70066096603,5,3008,1726,-30
70066447082,70066447085,3,2365,893,-30
70068384334,70068384338,4,1074,990,-30
70073694000,70073694006,6,2369,1549,-30
70077427226,70077427230,4,2332,1624,-30
70079567159,70079567165,6,1874,1367,-30
70085182216,70085182221,5,3059,870,-30
70089717647,70089717651,4,2113,1272,-30
70091248188,70091248184,-4,1479,3958,-30
70092758483,70092758488,5,2746,1358,-30
70093469430,70093469437,7,1793,1379,-30
70094992651,70094992658,7,4246,1622,-30
70095052254,70095052255,1,1678,1965,-30
70095179870,70095179875,5,1712,1090,-30
70106391482,70106391487,5,2665,1451,-30
70107680002,70107680008,6,3405,1319,-30
70108298868,70108298849,-19,1318,928,-30
70109764995,70109765001,6,1985,1211,-30
70110326022,70110326004,-18,986,677,-30
70115038610,70115038616,6,2616,1722,-30
70116545090,70116545094,4,2255,1669,-30
70122682599,70122682603,4,2961,1009,-30
70125413919,70125413925,6,3367,1422,-30
70125783501,70125783506,5,1881,1226,-30
70130412674,70130412679,5,2107,1808,-30
70131054550,70131054557,7,2286,1365,-30
70131737005,70131737011,6,2444,1139,-30
70132214829,70132214833,4,2798,1744,-30
70132935690,70132935695,5,1524,1080,-30
70134173697,70134173684,-13,2296,939,-30
70138558614,70138558621,7,2499,1579,-30
70139328142,70139328145,3,1845,1202,-30
70139399245,70139399258,13,1792,1026,-30
70142034461,70142034467,6,843,737,-30
70152261028,70152261033,5,1146,998,-30
70156088037,70156088043,6,2553,1106,-30
70158460369,70158460373,4,1693,1059,-30
70163126340,70163126346,6,1800,727,-30
70164724777,70164724782,5,2335,1023,-30
70166141000,70166141003,3,2428,1454,-30
70166682084,70166682084,0,2853,3959,-30
70171581230,70171581216,-14,2015,1313,-30
70171763191,70171763172,-19,2297,1390,-30
70173495441,70173495445,4,2600,2010,-30
70173527700,70173527705,5,2275,1036,-30
70175976101,70175976105,4,2352,1421,-30
70176956698,70176956705,7,2890,1176,-30
70177210329,70177210332,3,1810,1395,-30
70178507845,70178507851,6,2272,1457,-30
70182824397,70182824406,9,1657,1328,-30
70190421938,70190421943,5,2991,1682,-30
70195724673,70195724677,4,2091,1293,-30
70198960594,70198960602,8,2907,1763,-30
70199632105,70199632110,5,1675,892,-30
70200399724,70200399729,5,1634,1230,-30
70201179962,70201179967,5,2423,1012,-30
70201830321,70201830342,21,1535,8059,-30
70204098428,70204098434,6,2379,1500,-30
70204267152,70204267157,5,2701,1390,-30
70205491590,70205491598,8,2261,910,-30
70209475998,70209476003,5,2580,1513,-30
70210251855,70210251857,2,2204,1349,-30
70210642964,70210642969,5,2323,1462,-30
70218001519,70218001525,6,2528,1982,-30
70219497521,70219497525,4,2240,1484,-30
70222849219,70222849218,-1,597,1456,-30
70223490937,70223490940,3,1855,1169,-30
70224163197,70224163202,5,2418,1396,-30
70237931312,70237931315,3,1547,1054,-30
70240501294,70240501300,6,1673,1434,-30
70243380906,70243380909,3,1798,837,-30
70246417446,70246417449,3,2515,1435,-30
70247654911,70247654913,2,1842,2178,-30
70250043974,70250043982,8,2647,1486,-30
70253284846,70253284852,6,3346,1697,-30
70254162102,70254162107,5,2556,1506,-30
70255294405,70255294410,5,2591,1283,-30
70258189967,70258189971,4,2422,1344,-30
70258441799,70258441806,7,2518,1524,-30
70260687632,70260687636,4,1887,1096,-30
70261392036,70261392058,22,2174,1211,-30
70262541183,70262541187,4,2805,1871,-30
70265071537,70265071542,5,1192,1165,-30
70266650097,70266650100,3,2105,1305,-30
70267560405,70267560410,5,1944,1297,-30
70269912650,70269912656,6,2043,1079,-30
70271244843,70271244826,-17,1842,683,-30
70273170462,70273170467,5,2572,871,-30
70274093007,70274093013,6,2243,1224,-30
70278387392,70278387396,4,204,4946,-30
70279896816,70279896821,5,2086,1325,-30
70281039843,70281039848,5,1827,1652,-30
70281226151,70281226156,5,2137,1671,-30
70285482406,70285482411,5,1590,1307,-30
70285509671,70285509651,-20,707,245,-30
70295484438,70295484443,5,1458,1593,-30
70298955413,70298955417,4,1790,1163,-30
70302340860,70302340866,6,2237,1374,-30
70306300793,70306300798,5,2211,1679,-30
70308240745,70308240750,5,1861,1359,-30
70308921405,70308921409,4,2686,1191,-30
70309236999,70309237002,3,1084,650,-30
70312153649,70312153655,6,2403,1309,-30
70315922914,70315922918,4,2267,1508,-30
70316605109,70316605114,5,1728,1080,-30
70319317637,70319317632,-5,1832,6357,-30
70321243182,70321243186,4,1579,1023,-30
70322637903,70322637907,4,2482,1205,-30
70323455089,70323455101,12,2370,1445,-30
70325933778,70325933783,5,1469,904,-30
70329791020,70329791019,-1,1704,2374,-30
70332559542,70332559547,5,1227,1174,-30
70336710369,70336710369,0,1137,1346,-30
70341045719,70341045723,4,1334,1012,-30
70344801994,70344801972,-22,1215,252,-30
70347402095,70347402098,3,1691,1031,-30
70354329553,70354329558,5,2090,1333,-30
70354980802,70354980798,-4,1846,6100,-30
70355445067,70355445073,6,2377,1975,-30
70362072447,70362072453,6,2718,1769,-30
70369421070,70369421077,7,1759,951,-30
70369685836,70369685819,-17,2545,1756,-30
70372184089,70372184095,6,1871,1619,-30
70372256465,70372256450,-15,1762,935,-30
70373598847,70373598854,7,2268,1273,-30
70375632002,70375632007,5,2142,1194,-30
70377301270,70377301274,4,2095,1816,-30
70377344465,70377344467,2,2019,1287,-30
70389532686,70389532690,4,1947,1232,-30
70395442635,70395442641,6,2553,1363,-30
70397790978,70397790978,0,1259,2138,-30
70399581050,70399581056,6,2314,1193,-30
70404352725,70404352730,5,2229,794,-30
70406683757,70406683762,5,2221,1828,-30
70412258975,70412258979,4,1879,1229,-30
70414454982,70414454987,5,3428,1684,-30
70415204858,70415204863,5,1972,1264,-30
70425944911,70425944916,5,2417,1705,-30
70440750894,70440750899,5,2149,1266,-30
70443128205,70443128209,4,2384,1282,-30
70446091335,70446091331,-4,862,2920,-30
70448306534,70448306534,0,1182,963,-30
70450402098,70450402102,4,3027,1734,-30
70450642469,70450642474,5,2301,1390,-30
70450687838,70450687857,19,619,218,-30
70455123387,70455123389,2,1744,1179,-30
70455810056,70455810060,4,1613,1333,-30
70457608941,70457608943,2,2048,1438,-30
70462312030,70462312034,4,2109,1144,-30
70466679718,70466679723,5,3211,2357,-30
70470568938,70470568943,5,2766,1264,-30
70471594086,70471594088,2,2148,1841,-30
70472974393,70472974399,6,2519,1343,-30
70477739486,70477739491,5,3294,2231,-30
70484919471,70484919476,5,2470,1018,-30
70487295397,70487295402,5,1712,975,-30
70488220596,70488220599,3,2494,1159,-30
70490455601,70490455587,-14,33309,17936,-30
70491202715,70491202722,7,3258,1794,-30
70491397993,70491398011,18,1505,1198,-30
70492444118,70492444123,5,1567,1103,-30
70494528745,70494528750,5,2721,952,-30
70495809340,70495809338,-2,1738,1623,-30
70497695510,70497695515,5,1983,1016,-30
70498707218,70498707225,7,3072,1407,-30
70499185441,70499185425,-16,1583,1173,-30
70504570705,70504570710,5,3391,1579,-30
70505897685,70505897690,5,1900,1930,-30
70507880339,70507880343,4,2283,1285,-30
70509482786,70509482790,4,2125,1329,-30
70510254042,70510254028,-14,2148,876,-30
70510316414,70510316419,5,2400,1256,-30
70511262637,70511262643,6,2023,1737,-30
70513917865,70513917853,-12,497,144,-30
70514427707,70514427713,6,2236,1385,-30
70517532701,70517532706,5,3057,1545,-30
70523681669,70523681669,0,2210,2137,-30
70528930838,70528930835,-3,541,747,-30
70530987158,70530987164,6,3016,1750,-30
70533325397,70533325401,4,2001,1502,-30
70534554655,70534554660,5,2171,1268,-30
70534854891,70534854897,6,2142,1236,-30
70535848773,70535848777,4,3213,2142,-30
70538474634,70538474641,7,1897,1444,-30
70538668409,70538668394,-15,1036,643,-30
70539787713,70539787719,6,2213,1150,-30
70541737253,70541737261,8,2874,1291,-30
70542286172,70542286178,6,1911,1435,-30
70542598576,70542598582,6,2421,849,-30
70548906443,70548906459,16,427,871,-30
70550902793,70550902796,3,4326,4066,-30
70552226306,70552226312,6,1499,915,-30
70559749869,70559749874,5,1834,1090,-30
70560594398,70560594402,4,2172,1763,-30
70560661118,70560661123,5,1323,528,-30
70562358779,70562358795,16,14525,27315,-30
70563659558,70563659556,-2,32294,17990,-30
70567485763,70567485759,-4,2345,4883,-30
70569481525,70569481528,3,2372,1142,-30
70570265990,70570265996,6,2003,999,-30
70573595814,70573595817,3,1917,1251,-30
70576317226,70576317232,6,1547,1042,-30
70577936611,70577936616,5,2347,1167,-30
70580305225,70580305229,4,1793,1260,-30
70583079534,70583079538,4,2052,1322,-30
70594990614,70594990619,5,2535,949,-30
70595399514,70595399506,-8,950,210,-30
70597203362,70597203370,8,2424,1159,-30
70598298473,70598298479,6,2197,1169,-30
70601027425,70601027429,4,3065,1438,-30
70602045710,70602045717,7,1942,1373,-30
70602132557,70602132568,11,2084,1364,-30
70602229510,70602229515,5,3300,1575,-30
70604402633,70604402636,3,23020,23967,-30
70607472845,70607472851,6,2112,1256,-30
70609670838,70609670845,7,3057,1878,-30
70612960311,70612960310,-1,1542,1803,-30
70615658343,70615658349,6,3912,1477,-30
70616540416,70616540421,5,5243,2989,-30
70616791494,70616791498,4,2206,1370,-30
70621202742,70621202746,4,2863,1526,-30
70623560867,70623560870,3,2042,1614,-30
70624109550,70624109554,4,1307,742,-30
70628957942,70628957946,4,2894,1669,-30
70633091771,70633091787,16,712,238,-30
70633515487,70633515481,-6,724,264,-30
70635707959,70635707965,6,1854,1485,-30
70636566642,70636566645,3,1477,1456,-30
70640686856,70640686870,14,413,3084,-30
70644765578,70644765582,4,2309,1375,-30
70650636738,70650636743,5,7727,2779,-30
70651423139,70651423145,6,1826,1232,-30
70652763529,70652763535,6,1830,803,-30
70657670438,70657670445,7,2622,1220,-30
70666239780,70666239786,6,45021,122432,-30
70666578978,70666578983,5,2471,1595,-30
70669399889,70669399894,5,1792,1089,-30
70670488296,70670488298,2,1444,1802,-30
70673746227,70673746221,-6,2002,938,-30
70677033294,70677033298,4,2008,916,-30
70677144458,70677144443,-15,1332,792,-30
70678991205,70678991211,6,3089,1326,-30
70680369516,70680369521,5,1612,1203,-30
70680706432,70680706437,5,1968,1246,-30
70680912897,70680912903,6,2333,1141,-30
70681800144,70681800154,10,1826,1051,-30
70685664401,70685664407,6,2020,1421,-30
70686960227,70686960233,6,2167,995,-30
70691016725,70691016730,5,1914,1510,-30
70691303541,70691303545,4,1367,908,-30
70694798267,70694798272,5,2449,1392,-30
70695225230,70695225210,-20,2335,1312,-30
70695762288,70695762291,3,2007,1450,-30
70697663030,70697663035,5,1998,1154,-30
70699095503,70699095509,6,1975,1035,-30
70699167871,70699167871,0,1505,1622,-30
70703785812,70703785813,1,939,1107,-30
70706896813,70706896818,5,1415,1313,-30
70707645130,70707645133,3,1315,1091,-30
70710640695,70710640692,-3,33822,19243,-30
70712896338,70712896345,7,1774,1023,-30
70715224218,70715224222,4,1523,1053,-30
70717299517,70717299522,5,2413,1217,-30
70717960875,70717960880,5,1886,1101,-30
70723324494,70723324500,6,1797,1121,-30
70725332054,70725332058,4,1739,1344,-30
70725893130,70725893135,5,2436,1736,-30
70726499838,70726499820,-18,1573,1000,-30
70726603365,70726603369,4,2082,1438,-30
70728296859,70728296854,-5,854,1900,-30
70728347236,70728347234,-2,20576,80586,-30
70731219678,70731219677,-1,1764,2335,-30
70732190466,70732190471,5,2521,1322,-30
70734320173,70734320178,5,1748,1063,-30
70736470825,70736470829,4,1717,1247,-30
70740468485,70740468487,2,1953,1460,-30
70740735902,70740735902,0,1003,1385,-30
70741092678,70741092683,5,2402,1557,-30
70742922028,70742922033,5,2027,1518,-30
70743763577,70743763582,5,1749,816,-30
70747816418,70747816425,7,2476,1489,-30
70754024844,70754024850,6,2236,1177,-30
70758123209,70758123215,6,1794,1297,-30
70759937270,70759937276,6,3419,1976,-30
70760355840,70760355845,5,1793,1651,-30
70762955690,70762955695,5,1700,1382,-30
70763301478,70763301478,0,2499,2787,-30
70763609606,70763609602,-4,1142,3610,-30
70765172175,70765172180,5,2364,1340,-30
70765851251,70765851257,6,2580,1366,-30
70768085154,70768085159,5,2196,1110,-30
70773223016,70773223021,5,2686,1203,-30
70774753918,70774753924,6,2721,1409,-30
70777451196,70777451201,5,2519,1459,-30
70779976101,70779976105,4,2369,1154,-30
70783303146,70783303150,4,1917,1443,-30
70783561184,70783561188,4,1449,1404,-30
70791759965,70791759970,5,2174,1542,-30
70793315784,70793315788,4,1980,2267,-30
70796694213,70796694219,6,2208,1057,-30
70799074846,70799074850,4,2187,956,-30
70801918972,70801918978,6,2066,902,-30
70808903357,70808903360,3,1725,1336,-30
70809949033,70809949037,4,2484,1828,-30
70812978955,70812978943,-12,617,3967,-30
70813362089,70813362093,4,2617,1656,-30
70813908417,70813908420,3,1759,1648,-30
70817515778,70817515782,4,1652,1712,-30
70823780179,70823780183,4,2120,1441,-30
70831143828,70831143830,2,1643,1240,-30
70833067997,70833068002,5,2521,1505,-30
70834118307,70834118307,0,1077,1157,-30
70839637709,70839637710,1,1354,1545,-30
70840877989,70840877993,4,2386,1174,-30
70841482554,70841482558,4,2873,1031,-30
70841750722,70841750704,-18,2625,1295,-30
70843370286,70843370290,4,1739,1325,-30
70843614540,70843614537,-3,654,334,-30
70848400085,70848400090,5,2839,1466,-30
70851106350,70851106355,5,1631,817,-30
70857149146,70857149150,4,1038,1215,-30
70858799625,70858799634,9,11044,30008,-30
70858879469,70858879473,4,2310,1673,-30
70859982625,70859982629,4,2338,1429,-30
70863900154,70863900157,3,1282,825,-30
70865382467,70865382471,4,1436,1166,-30
70869505258,70869505264,6,12978,7263,-30
70871847469,70871847472,3,2427,2054,-30
70874902663,70874902667,4,2497,1275,-30
70875938413,70875938419,6,2870,1272,-30
70878066075,70878066079,4,1836,920,-30
70879741073,70879741078,5,2777,2140,-30
70883003030,70883003036,6,2337,1126,-30
70886444519,70886444522,3,1237,1315,-30
70888266982,70888266989,7,2760,1867,-30
70888746498,70888746502,4,1029,701,-30
70889044427,70889044433,6,2099,1306,-30
70894014220,70894014221,1,1685,1130,-30
70895352394,70895352399,5,3056,1630,-30
70896156158,70896156162,4,2042,1085,-30
70896864149,70896864156,7,1897,1216,-30
70898616626,70898616629,3,1889,1326,-30
70904217131,70904217138,7,2056,1062,-30
70904956519,70904956526,7,3765,1180,-30
70908579482,70908579486,4,1472,948,-30
70911319402,70911319407,5,2491,1704,-30
70911851630,70911851634,4,1662,740,-30
70911891083,70911891065,-18,2775,1221,-30
70914552713,70914552718,5,1962,1639,-30
70916370332,70916370337,5,2023,1084,-30
70917817249,70917817254,5,2095,1527,-30
70923749387,70923749371,-16,78,998,-30
70923891698,70923891699,1,52,7627,-30
70929422818,70929422823,5,2484,1146,-30
70934537494,70934537501,7,3568,1703,-30
70935730356,70935730362,6,2053,1241,-30
70937415106,70937415110,4,2219,953,-30
70938297844,70938297850,6,2961,1590,-30
70939698971,70939698976,5,2174,1685,-30
70940465781,70940465786,5,2852,1300,-30
70941197605,70941197610,5,2146,1580,-30
70943350442,70943350443,1,1164,2084,-30
70944349425,70944349430,5,2479,1189,-30
70946152959,70946152964,5,1934,1385,-30
70947144654,70947144659,5,1863,1231,-30
70947997739,70947997745,6,1537,1089,-30
70956915090,70956915094,4,2042,1079,-30
70964001175,70964001181,6,2235,1300,-30
70966265509,70966265515,6,2823,1629,-30
70968685739,70968685744,5,2347,1171,-30
70972484398,70972484402,4,2583,1501,-30
70973847108,70973847114,6,3233,1825,-30
70982024610,70982024614,4,1696,1159,-30
70982916861,70982916866,5,2117,1577,-30
70987422850,70987422855,5,2849,1428,-30
70988025332,70988025336,4,1918,1987,-30
70991442928,70991442927,-1,2310,4038,-30
70992067941,70992067945,4,1815,1479,-30
70995315814,70995315818,4,2635,1840,-30
70998081706,70998081711,5,2129,1338,-30
70999430842,70999430847,5,2509,1345,-30
70999489548,70999489559,11,13555,37060,-30
71003056089,71003056093,4,3001,1642,-30
71004171750,71004171755,5,2132,1317,-30
71004401591,71004401596,5,3014,1508,-30
71005075487,71005075491,4,2790,2279,-30
71007565822,71007565826,4,2506,1715,-30
71008926705,71008926712,7,3121,1183,-30
71009078674,71009078679,5,2274,1399,-30
71010561902,71010561906,4,3102,1399,-30
71012904496,71012904478,-18,1694,966,-30
71016212178,71016212173,-5,1533,3951,-30
71018674150,71018674156,6,2407,1202,-30
71019222919,71019222915,-4,1935,4701,-30
71019856162,71019856166,4,1757,810,-30
71020936451,71020936428,-23,1677,791,-30
71021560758,71021560764,6,1890,1151,-30
71021596660,71021596663,3,2781,1178,-30
71022000579,71022000583,4,1313,1271,-30
71027665219,71027665224,5,2056,1553,-30
71030049367,71030049371,4,3794,1642,-30
71031347050,71031347057,7,1255,1148,-30
71038719850,71038719860,10,908,332,-30
71038827457,71038827462,5,1810,1285,-30
71040057133,71040057137,4,3129,1502,-30
71041538578,71041538582,4,1579,914,-30
71042139054,71042139035,-19,2029,1358,-30
71043069762,71043069766,4,2365,1033,-30
71046862884,71046862889,5,1473,1057,-30
71050010433,71050010441,8,2165,972,-30
71051233317,71051233322,5,2106,1335,-30
71052934258,71052934263,5,2202,1640,-30
71054505602,71054505607,5,2150,1233,-30
71055193649,71055193656,7,3678,1823,-30
71067127499,71067127502,3,1260,896,-30
71068449081,71068449086,5,1917,1160,-30
71068547321,71068547326,5,1804,1193,-30
71069266251,71069266254,3,2213,1223,-30
71069651831,71069651808,-23,2255,1117,-30
71071351954,71071351962,8,3815,1237,-30
71071386696,71071386699,3,2054,1044,-30
71071765933,71071765934,1,1363,1525,-30
71079487505,71079487510,5,2086,1159,-30
71079930297,71079930301,4,2046,1338,-30
71080140005,71080139986,-19,1942,1387,-30
71082860088,71082860094,6,3992,1175,-30
71086011250,71086011255,5,2877,1393,-30
71087577037,71087577035,-2,813,2097,-30
71092972218,71092972225,7,1257,764,-30
71094819353,71094819358,5,2218,1398,-30
71097507304,71097507308,4,4021,1945,-30
71098281762,71098281769,7,1947,1151,-30
71098760433,71098760437,4,2371,1383,-30
71098845665,71098845658,-7,959,371,-30
71099863419,71099863426,7,1050,964,-30
71101075246,71101075251,5,2495,1215,-30
71102805309,71102805313,4,1603,1265,-30
71103395816,71103395819,3,2020,1199,-30
71106131795,71106131801,6,3078,1368,-30
71110892141,71110892149,8,5789,2111,-30
71111024021,71111024026,5,2885,1189,-30
71112811970,71112811974,4,3561,1849,-30
71113836716,71113836719,3,2032,1097,-30
71114973101,71114973107,6,2504,1691,-30
71115569390,71115569382,-8,1408,2353,-30
71121143106,71121143105,-1,952,1209,-30
71122147034,71122147040,6,2965,1168,-30
71123283390,71123283395,5,2203,1522,-30
71123808078,71123808082,4,1674,1253,-30
71124608383,71124608387,4,2613,1078,-30
71127183110,71127183114,4,2920,1619,-30
71134172257,71134172262,5,3337,1699,-30
71134642338,71134642342,4,2086,1076,-30
71134906981,71134906986,5,1973,1063,-30
71135141208,71135141209,1,2126,2351,-30
71136579538,71136579543,5,1657,1240,-30
71138760750,71138760751,1,1706,2422,-30
71142997886,71142997890,4,3051,1563,-30
71143765894,71143765897,3,2662,1565,-30
71147512741,71147512745,4,2261,1340,-30
71149183045,71149183067,22,1301,666,-30
71154126403,71154126399,-4,1166,3573,-30
71156643077,71156643074,-3,628,997,-30
71159594521,71159594526,5,1982,1310,-30
71161517618,71161517622,4,2418,1218,-30
71161645335,71161645355,20,3228,1679,-30
71163848601,71163848607,6,1847,1053,-30
71165322583,71165322561,-22,1693,1219,-30
71169344779,71169344786,7,2817,1621,-30
71179428185,71179428191,6,3124,1760,-30
71181953293,71181953299,6,1704,1308,-30
71182056280,71182056274,-6,1247,2323,-30
71182603754,71182603760,6,2392,1533,-30
71184754311,71184754318,7,1015,1277,-30
71191637822,71191637829,7,1783,1110,-30
71191937951,71191937956,5,2518,1081,-30
71192066090,71192066095,5,2399,1521,-30
71192442714,71192442719,5,2138,1604,-30
71193130026,71193130031,5,1817,784,-30
71197768250,71197768254,4,2721,1925,-30
71197866080,71197866098,18,2127,1220,-30
71199734110,71199734115,5,2475,1277,-30
71203682262,71203682267,5,2766,1680,-30
71205459721,71205459726,5,2495,1390,-30
71205829018,71205829021,3,2317,1619,-30
71209368753,71209368758,5,2756,1316,-30
71210400947,71210400952,5,2643,1301,-30
71210555402,71210555404,2,1405,1457,-30
71210637130,71210637134,4,2793,1445,-30
71213908613,71213908617,4,1460,1104,-30
71214830010,71214830014,4,1817,1306,-30
71215746548,71215746553,5,1818,1031,-30
71219003675,71219003674,-1,1451,1768,-30
71220326850,71220326854,4,2877,1353,-30
71221725846,71221725851,5,2666,1465,-30
71222743045,71222743049,4,2019,1634,-30
71224378578,71224378583,5,3143,1243,-30
71226544596,71226544597,1,1291,1591,-30
71227948203,71227948206,3,1575,1557,-30
71230596386,71230596390,4,1344,1144,-30
71231960689,71231960694,5,1604,1196,-30
71234775674,71234775679,5,1998,1349,-30
71241500905,71241500910,5,2946,1672,-30
71243298182,71243298187,5,1762,1353,-30
71244788450,71244788457,7,6197,2088,-30
71246549682,71246549681,-1,1321,1516,-30
71249099002,71249099011,9,1405,817,-30
71251959742,71251959746,4,2215,1299,-30
71253068391,71253068396,5,2961,1378,-30
71257466647,71257466651,4,2634,1507,-30
71257815561,71257815566,5,3407,1035,-30
71259836122,71259836126,4,2818,1300,-30
71260473942,71260473946,4,1740,1081,-30
71263417122,71263417127,5,2193,1621,-30
71263461807,71263461813,6,2236,1233,-30
71270913813,71270913818,5,1796,1154,-30
71271705726,71271705731,5,2910,1618,-30
71272707381,71272707384,3,12444,17682,-30
71273309126,71273309130,4,2910,1512,-30
71274666970,71274666975,5,2600,1190,-30
71274715890,71274715905,15,2772,1037,-30
71275008680,71275008686,6,1835,832,-30
71276890220,71276890225,5,2620,1590,-30
71284669330,71284669336,6,2177,1561,-30
71286530517,71286530522,5,2127,1043,-30
71289708698,71289708703,5,2250,1419,-30
71289967411,71289967417,6,2680,1540,-30
71293804193,71293804196,3,1632,1179,-30
71297456878,71297456882,4,1924,1315,-30
71305178692,71305178697,5,3002,1760,-30
71305744418,71305744402,-16,2143,1000,-30
71307490329,71307490333,4,1107,905,-30
71310252107,71310252110,3,1350,1185,-30
71316900990,71316900986,-4,1423,3340,-30
71320964279,71320964284,5,1865,1039,-30
71321299146,71321299152,6,2408,1506,-30
71323613334,71323613338,4,1473,1047,-30
71323890950,71323890951,1,1866,1428,-30
71325876473,71325876478,5,2200,1776,-30
71326402305,71326402312,7,2043,1382,-30
71328106122,71328106126,4,2329,1217,-30
71328781117,71328781122,5,2634,1857,-30
71334661150,71334661158,8,3341,1229,-30
71335448326,71335448331,5,969,711,-30
71336246597,71336246601,4,2078,1092,-30
71336922511,71336922515,4,2940,1505,-30
71339215458,71339215462,4,2392,1273,-30
71340166346,71340166350,4,2031,873,-30
71340957498,71340957505,7,1786,1065,-30
71344577349,71344577350,1,1495,1036,-30
71345233398,71345233403,5,2859,1341,-30
71345393374,71345393363,-11,911,491,-30
71347581679,71347581683,4,1843,1405,-30
71347724026,71347724032,6,2459,1308,-30
71350262049,71350262052,3,1244,748,-30
71350511550,71350511531,-19,1536,872,-30
71350688792,71350688796,4,2472,1690,-30
71355440358,71355440363,5,2500,1278,-30
71359428038,71359428033,-5,952,2597,-30
71360565542,71360565547,5,2258,867,-30
71362984134,71362984125,-9,1356,1667,-30
71364464335,71364464316,-19,591,414,-30
71365896513,71365896518,5,2306,1375,-30
71366159627,71366159632,5,2925,1817,-30
71371791357,71371791360,3,1889,1979,-30
71372363877,71372363883,6,2003,1262,-30
71376285550,71376285554,4,2685,1429,-30
71379305861,71379305865,4,2228,1092,-30
71379423298,71379423303,5,2339,1079,-30
71382499524,71382499530,6,3180,1284,-30
71385623505,71385623510,5,2135,1070,-30
71386633062,71386633066,4,2094,1742,-30
71388410810,71388410829,19,3866,1294,-30
71391240754,71391240758,4,2689,1541,-30
71391538961,71391538967,6,2047,2025,-30
71392667601,71392667605,4,2405,1812,-30
71394619492,71394619497,5,2720,1287,-30
71398155618,71398155622,4,2050,1065,-30
71404559348,71404559351,3,1044,860,-30
71407563714,71407563719,5,1288,1027,-30
71409122705,71409122699,-6,1053,2099,-30
71409920351,71409920357,6,2391,1304,-30
71411265578,71411265583,5,2430,1041,-30
71412776414,71412776421,7,2209,1196,-30
71413140726,71413140730,4,1759,1063,-30
71416519175,71416519178,3,2134,1544,-30
71417282908,71417282912,4,3195,1766,-30
71420115670,71420115655,-15,1372,663,-30
71420436528,71420436534,6,2107,995,-30
71421554051,71421554054,3,1415,1397,-30
71421815775,71421815782,7,2407,1270,-30
71423597370,71423597380,10,2254,1377,-30
71429600892,71429600898,6,1881,965,-30
71431771529,71431771534,5,2008,1648,-30
71437423463,71437423469,6,2151,1237,-30
71439867747,71439867753,6,2863,1547,-30
71440423121,71440423125,4,2037,1057,-30
71441086458,71441086462,4,1450,1582,-30
71442522950,71442522955,5,2167,1191,-30
71442556192,71442556197,5,8008,23470,-30
71442811722,71442811726,4,2083,882,-30
71444717533,71444717539,6,2942,1265,-30
71450039278,71450039286,8,8668,30176,-30
71451609400,71451609405,5,1469,1076,-30
71454206222,71454206229,7,2675,1317,-30
71459023322,71459023327,5,2359,1375,-30
71464973820,71464973824,4,2033,1817,-30
71465474781,71465474786,5,2850,1004,-30
71466218082,71466218091,9,2266,1378,-30
71472834921,71472834925,4,2456,1625,-30
71473082561,71473082566,5,3322,1474,-30
71475472138,71475472144,6,1700,1244,-30
71477397081,71477397074,-7,869,3712,-30
71478244754,71478244758,4,1620,989,-30
71483258313,71483258319,6,1897,1047,-30
71489302311,71489302314,3,2387,2031,-30
71490880190,71490880197,7,2022,1343,-30
71491065393,71491065398,5,2493,1725,-30
71491600702,71491600707,5,1775,1340,-30
71493568903,71493568905,2,639,1109,-30
71494287430,71494287435,5,2721,1497,-30
71495108834,71495108838,4,2072,1309,-30
71495934220,71495934225,5,2681,2129,-30
71497063502,71497063506,4,2601,1704,-30
71497713702,71497713703,1,1535,1342,-30
71499629185,71499629184,-1,2191,4181,-30
71501194202,71501194209,7,2527,1352,-30
71504326531,71504326535,4,1694,1471,-30
71504627394,71504627399,5,2436,1555,-30
71505869654,71505869655,1,2037,1835,-30
71510046927,71510046920,-7,831,7805,-30
71513796039,71513796043,4,1947,1389,-30
71514823517,71514823525,8,2385,1665,-30
71515431604,71515431608,4,1585,827,-30
71515785266,71515785250,-16,1464,352,-30
71515961937,71515961939,2,11913,9588,-30
71519614574,71519614579,5,1348,1196,-30
71521719189,71521719194,5,2939,1494,-30
71524503354,71524503359,5,1143,934,-30
71525849397,71525849403,6,3567,1485,-30
71527712516,71527712519,3,2362,1077,-30
71532660721,71532660714,-7,716,3589,-30
71537112345,71537112347,2,2610,1727,-30
71537509871,71537509877,6,2100,963,-30
71543000534,71543000539,5,1104,1051,-30
71548432362,71548432369,7,2410,1060,-30
71548921694,71548921705,11,1598,1072,-30
71552830125,71552830131,6,1912,1170,-30
71554742901,71554742906,5,2482,1240,-30
71558558281,71558558287,6,2511,1218,-30
71559271002,71559271006,4,2136,1720,-30
71559732062,71559732067,5,1595,754,-30
71561307529,71561307534,5,1997,1071,-30
71561449732,71561449738,6,1007,778,-30
71564634723,71564634728,5,1170,375,-30
71564988081,71564988086,5,1735,1147,-30
71566207251,71566207258,7,2710,1553,-30
71572427409,71572427414,5,2070,1302,-30
71573440369,71573440377,8,1332,1155,-30
71577755385,71577755392,7,2241,1439,-30
71579342286,71579342290,4,2807,1197,-30
71583354951,71583354955,4,2187,1159,-30
71588282766,71588282771,5,2047,857,-30
71589771851,71589771853,2,1219,1304,-30
71592118662,71592118666,4,2456,1269,-30
71593770582,71593770562,-20,1251,791,-30
71597639493,71597639499,6,1524,1067,-30
71602320794,71602320795,1,2686,2844,-30
71606430114,71606430118,4,2222,1242,-30
71607058344,71607058349,5,2200,1210,-30
71607466477,71607466479,2,1419,624,-30
71607739733,71607739712,-21,1033,424,-30
71608906645,71608906651,6,2554,1749,-30
71612048963,71612048967,4,2566,1369,-30
71616424548,71616424554,6,2471,835,-30
71621222710,71621222715,5,2636,1743,-30
71621931322,71621931331,9,1605,1043,-30
71623343963,71623343967,4,1417,1526,-30
71628130733,71628130735,2,1084,837,-30
71630183665,71630183674,9,1623,1221,-30
71636125141,71636125146,5,2526,1129,-30
71636153197,71636153202,5,2021,1079,-30
71637841861,71637841867,6,1844,1145,-30
71638244059,71638244063,4,1754,1320,-30
71638781701,71638781705,4,1192,1143,-30
71639867794,71639867793,-1,41380,17584,-30
71641681667,71641681672,5,1400,869,-30
71643088977,71643088982,5,1538,1525,-30
71644203822,71644203823,1,2311,2076,-30
71645906000,71645906003,3,2282,1150,-30
71651658585,71651658591,6,2613,1543,-30
71652655563,71652655570,7,2431,1319,-30
71654239758,71654239765,7,2604,818,-30
71654872471,71654872475,4,1966,960,-30
71657596994,71657596999,5,2214,1271,-30
71662420671,71662420677,6,2557,1243,-30
71662866310,71662866308,-2,1485,1904,-30
71666594212,71666594218,6,1493,1095,-30
71669021679,71669021682,3,1809,783,-30
71670719629,71670719633,4,2184,1582,-30
71675862750,71675862754,4,1944,959,-30
71677501183,71677501186,3,1517,853,-30
71680798734,71680798739,5,2448,1384,-30
71682802936,71682802939,3,1689,1453,-30
71684442081,71684442086,5,2238,1287,-30
71687192467,71687192471,4,1753,1195,-30
71689560566,71689560570,4,1417,913,-30
71689805107,71689805110,3,1864,1260,-30
71692107813,71692107816,3,1629,1120,-30
71692275800,71692275790,-10,45371,10748,-30
71694206592,71694206596,4,2263,1654,-30
71698010706,71698010710,4,2093,1115,-30
71700909661,71700909667,6,3296,1709,-30
71702839306,71702839311,5,1845,1189,-30
71703738478,71703738483,5,1521,779,-30
71704301518,71704301522,4,1736,1901,-30
71708039563,71708039571,8,2136,1193,-30
71708196335,71708196343,8,2190,1034,-30
71709878254,71709878258,4,2078,1085,-30
71710386670,71710386675,5,3072,1462,-30
71713552299,71713552306,7,1541,916,-30
71715671274,71715671279,5,1141,972,-30
71715722996,71715723015,19,1339,3970,-30
71718236467,71718236471,4,1626,844,-30
71718453330,71718453334,4,1983,1281,-30
71721004962,71721004966,4,2569,1015,-30
71724878995,71724878998,3,1994,1897,-30
71725313361,71725313365,4,2924,1478,-30
71727439124,71727439128,4,2432,1655,-30
71728245470,71728245473,3,2101,2924,-30
71730565910,71730565914,4,1164,1295,-30
71735719719,71735719722,3,879,1169,-30
71737069641,71737069646,5,2285,1463,-30
71739657683,71739657689,6,2987,1576,-30
71741208650,71741208655,5,2214,1479,-30
71744000906,71744000913,7,2456,904,-30
71747501067,71747501071,4,2382,1549,-30
71748345817,71748345821,4,2772,1605,-30
71749192709,71749192713,4,2084,1091,-30
71750466405,71750466410,5,2492,1284,-30
71751965874,71751965879,5,2168,1637,-30
71753214562,71753214567,5,2131,885,-30
71753747013,71753747017,4,1502,1047,-30
71759907189,71759907193,4,1488,1075,-30
71761350144,71761350149,5,2326,1366,-30
71762468468,71762468471,3,1847,1606,-30
71762860772,71762860775,3,1807,1306,-30
71763004992,71763004995,3,2985,1628,-30
71767532285,71767532289,4,2561,1159,-30
71768061869,71768061848,-21,1383,563,-30
71768331734,71768331739,5,2085,1188,-30
71769855603,71769855607,4,3142,1684,-30
71770015417,71770015422,5,2200,1289,-30
71771340733,71771340739,6,2335,1093,-30
71771898669,71771898674,5,2229,1370,-30
71773973662,71773973667,5,1887,1480,-30
71777417722,71777417726,4,2375,1464,-30
71778236314,71778236319,5,1761,1134,-30
71778788873,71778788881,8,3740,1234,-30
71780527693,71780527698,5,2186,987,-30
71781490941,71781490946,5,1799,809,-30
71783218782,71783218785,3,1656,1727,-30
71784966758,71784966757,-1,1409,1830,-30
71785322010,71785322014,4,2064,827,-30
71786907335,71786907333,-2,1587,2690,-30
71787203350,71787203354,4,2231,1860,-30
71787233770,71787233775,5,971,981,-30
71787981333,71787981338,5,2315,1520,-30
71788275143,71788275137,-6,1796,9539,-30
71788406991,71788406968,-23,2205,1310,-30
71790157550,71790157558,8,1916,923,-30
71794730035,71794730042,7,3142,1337,-30
71797646589,71797646594,5,2046,1193,-30
71802829270,71802829274,4,1740,1499,-30
71804118705,71804118711,6,1319,1332,-30
71805583457,71805583459,2,918,803,-30
71806524653,71806524657,4,3424,1718,-30
71809867878,71809867882,4,1777,1176,-30
71814107391,71814107397,6,2221,1596,-30
71817194601,71817194605,4,2515,1768,-30
71825442432,71825442435,3,2062,1384,-30
71826694703,71826694682,-21,2572,1331,-30
71828711542,71828711547,5,2604,1341,-30
71831684279,71831684286,7,2421,1527,-30
71833624117,71833624120,3,1802,804,-30
71836261543,71836261555,12,155,1155,-30
71838741375,71838741380,5,1722,1447,-30
71840611245,71840611250,5,2100,1170,-30
71842434395,71842434399,4,1358,693,-30
71842820242,71842820250,8,1853,1007,-30
71845379188,71845379193,5,2984,1693,-30
71846681205,71846681210,5,2336,1583,-30
71847804423,71847804428,5,2042,1344,-30
71857096225,71857096231,6,2112,993,-30
71857900261,71857900260,-1,2452,3466,-30
71858883946,71858883951,5,2310,969,-30
71859426985,71859426989,4,1717,1550,-30
71861239359,71861239365,6,2019,1184,-30
71862961120,71862961131,11,17744,27521,-30
71864086506,71864086502,-4,842,2615,-30
71865432762,71865432765,3,1036,1471,-30
71865630058,71865630063,5,1736,1649,-30
71868142757,71868142762,5,3235,3383,-30
71868381042,71868381046,4,1926,1355,-30
71869689519,71869689525,6,2531,981,-30
71870628971,71870628976,5,2404,1373,-30
71879520071,71879520077,6,2079,1290,-30
71880320097,71880320103,6,1797,1245,-30
71882340784,71882340790,6,2137,993,-30
71882463777,71882463786,9,738,229,-30
71884733208,71884733213,5,2687,1141,-30
71888888895,71888888901,6,2573,1695,-30
71888924102,71888924108,6,2186,1677,-30
71894227802,71894227806,4,1676,929,-30
71894284389,71894284372,-17,2025,862,-30
71894824523,71894824525,2,1585,1915,-30
71895218254,71895218252,-2,2332,3875,-30
71895256742,71895256747,5,2565,1165,-30
71902503689,71902503694,5,2390,1572,-30
71902635176,71902635170,-6,37456,14068,-30
71912713209,71912713214,5,2769,1013,-30
71915517030,71915517035,5,1533,887,-30
71919417065,71919417071,6,2637,1176,-30
71921747476,71921747482,6,2357,1174,-30
71923937085,71923937089,4,2007,1142,-30
71925767394,71925767401,7,2197,1338,-30
71940780908,71940780913,5,2864,1587,-30
71943175730,71943175737,7,2002,1475,-30
71947621310,71947621316,6,2601,1317,-30
71953340009,71953340012,3,1988,1275,-30
71954162529,71954162514,-15,1679,1201,-30
71954195823,71954195827,4,2305,1293,-30
71958731639,71958731641,2,1568,1579,-30
71959660919,71959660925,6,3027,1764,-30
71962173881,71962173878,-3,1267,2901,-30
71963258146,71963258146,0,1698,2283,-30
71964943146,71964943141,-5,1322,3143,-30
71968069824,71968069830,6,2553,1972,-30
71969227160,71969227167,7,125,902,-30
71969618445,71969618450,5,2769,1356,-30
71970987357,71970987362,5,1801,1495,-30
71972569274,71972569278,4,1631,1103,-30
71974092595,71974092601,6,2502,1373,-30
71975507442,71975507437,-5,1972,6887,-30
71981895262,71981895267,5,2367,1275,-30
71982189665,71982189669,4,11655,21521,-30
71984863565,71984863569,4,2869,1549,-30
71987092806,71987092811,5,2100,1399,-30
71987754573,71987754562,-11,640,406,-30
71989008681,71989008686,5,2357,1281,-30
71991153426,71991153431,5,1061,1110,-30
71991670031,71991670034,3,1845,1160,-30
71993035616,71993035619,3,2206,1236,-30
71995052450,71995052449,-1,1288,2381,-30
71997321824,71997321827,3,1866,1706,-30
71998161931,71998161934,3,2142,1184,-30
71998830992,71998830997,5,2345,1555,-30
72000968801,72000968807,6,1904,1023,-30
72001253177,72001253182,5,661,527,-30
72001644849,72001644854,5,3551,1508,-30
72003690810,72003690815,5,2838,1271,-30
72008740983,72008740988,5,2747,1533,-30
72010011320,72010011319,-1,1457,1915,-30
72011134712,72011134717,5,1866,1446,-30
72011423274,72011423278,4,1543,1099,-30
72011934009,72011934013,4,2850,1273,-30
72013356346,72013356350,4,2295,1393,-30
72016659272,72016659275,3,1957,858,-30
72018173581,72018173581,0,1003,2077,-30
72019509547,72019509550,3,3056,2145,-30
72022312242,72022312246,4,2264,1263,-30
72024574405,72024574410,5,2797,1319,-30
72027116473,72027116475,2,2686,1089,-30
72032824498,72032824505,7,2836,1144,-30
72038467109,72038467112,3,2669,1037,-30
72039598214,72039598219,5,3533,1427,-30
72039809764,72039809769,5,2607,1653,-30
72044933670,72044933663,-7,941,4195,-30
72045191114,72045191117,3,176,1070,-30
72046930275,72046930279,4,3025,2272,-30
72051178050,72051178054,4,2413,1976,-30
72051381106,72051381112,6,2436,1702,-30
72052213977,72052213981,4,2128,1094,-30
72052846901,72052846906,5,1706,1423,-30
72053222847,72053222850,3,1340,535,-30
72055890196,72055890201,5,2520,991,-30
72058207378,72058207387,9,26468,43482,-30
72058637989,72058637994,5,2572,1351,-30
72059360395,72059360400,5,2230,1195,-30
72060413922,72060413926,4,1986,1372,-30
72062239276,72062239282,6,1687,1401,-30
72062680574,72062680579,5,1301,799,-30
72067051514,72067051517,3,2215,1099,-30
72068075819,72068075825,6,2255,1152,-30
72072061150,72072061155,5,1936,1228,-30
72072481116,72072481129,13,1783,1435,-30
72072975166,72072975170,4,2518,1036,-30
72074552589,72074552593,4,1812,955,-30
72076332241,72076332247,6,4370,1663,-30
72076875772,72076875777,5,3706,1321,-30
72078750756,72078750758,2,1593,2597,-30
72078919675,72078919679,4,1189,871,-30
72080833059,72080833058,-1,1949,3087,-30
72081068346,72081068341,-5,2904,11228,-30
72081636149,72081636162,13,1984,785,-30
72082233995,72082233977,-18,1797,545,-30
72082319429,72082319408,-21,3029,1442,-30
72082475998,72082476002,4,2210,1224,-30
72085921588,72085921594,6,3632,1769,-30
72086455510,72086455515,5,2720,1191,-30
72088374310,72088374314,4,2144,931,-30
72090863761,72090863767,6,3190,1354,-30
72093254554,72093254561,7,1940,1083,-30
72093419443,72093419449,6,2565,1782,-30
72097925591,72097925597,6,2009,1385,-30
72098447221,72098447225,4,2381,929,-30
72100773994,72100773996,2,1979,1572,-30
72100813588,72100813590,2,2054,1907,-30
72102009127,72102009135,8,3518,1105,-30
72106166214,72106166220,6,2343,1474,-30
72106973573,72106973579,6,3161,1203,-30
72110379665,72110379665,0,1037,1186,-30
72114146837,72114146843,6,1907,835,-30
72115190161,72115190146,-15,1878,1485,-30
72115282413,72115282392,-21,2390,1406,-30
72117260773,72117260778,5,2397,1359,-30
72119236765,72119236772,7,1101,1041,-30
72121046506,72121046511,5,2047,1022,-30
72123515553,72123515537,-16,471,475,-30
72128910517,72128910522,5,1559,1064,-30
72132045978,72132045982,4,2006,1424,-30
72134403583,72134403586,3,2044,1195,-30
72138276822,72138276824,2,1693,2007,-30
72141541286,72141541289,3,1942,1313,-30
72144394810,72144394815,5,2630,1693,-30
72145067208,72145067214,6,3499,1684,-30
72147403317,72147403320,3,1922,1285,-30
72151932377,72151932382,5,2714,1650,-30
72153447422,72153447428,6,3336,1437,-30
72155474385,72155474386,1,2023,1697,-30
72162083606,72162083612,6,2854,1419,-30
72165113497,72165113501,4,1351,1237,-30
72167481409,72167481413,4,1953,1322,-30
72175621144,72175621148,4,2651,1509,-30
72175897034,72175897031,-3,1373,2185,-30
72182506195,72182506198,3,1484,931,-30
72184742762,72184742767,5,3025,1575,-30
72189277789,72189277794,5,1756,1401,-30
72191832823,72191832827,4,1459,1622,-30
72193726606,72193726612,6,2029,1171,-30
72193781654,72193781658,4,2875,1755,-30
72194388394,72194388399,5,2725,1333,-30
72197708366,72197708371,5,2601,1247,-30
72199105114,72199105121,7,2242,911,-30
72202600571,72202600575,4,2251,1340,-30
72204141286,72204141291,5,2426,1533,-30
72205108633,72205108639,6,1692,853,-30
72208822014,72208822018,4,1753,1094,-30
72211784419,72211784426,7,1861,1019,-30
72212640876,72212640882,6,2366,1401,-30
72216469375,72216469383,8,1329,1094,-30
72216583353,72216583358,5,2154,1640,-30
72217183707,72217183714,7,1791,1066,-30
72219237828,72219237835,7,2209,1326,-30
72220659890,72220659894,4,1979,1057,-30
72223186454,72223186458,4,3694,1871,-30
72225075717,72225075723,6,1419,1166,-30
72225216022,72225216022,0,1631,1923,-30
72226967744,72226967754,10,16554,27997,-30
72230629611,72230629615,4,2253,1637,-30
72233309253,72233309258,5,2120,1235,-30
72235905624,72235905630,6,1951,1254,-30
72235996252,72235996255,3,1553,752,-30
72237557803,72237557807,4,2267,1563,-30
72237995974,72237995978,4,2960,1903,-30
72238499073,72238499081,8,3055,1127,-30
72240616346,72240616352,6,1921,984,-30
72247189798,72247189805,7,2455,1086,-30
72247595830,72247595808,-22,1034,472,-30
72249773709,72249773715,6,2168,1481,-30
72249973288,72249973291,3,2628,1894,-30
72250414970,72250414971,1,1166,542,-30
72252122934,72252122939,5,2245,1039,-30
72256468520,72256468525,5,2930,1229,-30
72257365485,72257365488,3,2191,1316,-30
72258700390,72258700394,4,2772,1395,-30
72260381066,72260381070,4,2536,1969,-30
72260456223,72260456229,6,2759,1024,-30
72261204443,72261204448,5,2260,1463,-30
72261854784,72261854787,3,1307,1044,-30
72263968834,72263968841,7,1872,1261,-30
72265142850,72265142854,4,2403,1087,-30
72266710397,72266710401,4,2388,1429,-30
72267063553,72267063557,4,1755,1485,-30
72271245499,72271245503,4,2675,1267,-30
72272248209,72272248214,5,1974,1243,-30
72272828393,72272828399,6,2485,1023,-30
72272976247,72272976259,12,2926,1180,-30
72275273022,72275273026,4,2884,1452,-30
72279612221,72279612226,5,2464,1723,-30
72280040881,72280040886,5,3345,1962,-30
72283320413,72283320418,5,2951,1651,-30
72288798574,72288798581,7,2284,1364,-30
72292740237,72292740242,5,1608,812,-30
72294156477,72294156482,5,1308,1208,-30
72295313622,72295313626,4,2027,1079,-30
72295407597,72295407598,1,1615,1239,-30
72295819110,72295819115,5,1959,1185,-30
72303031390,72303031391,1,31933,40526,-30
72305440215,72305440220,5,2123,1490,-30
72314853217,72314853221,4,2089,1159,-30
72318868717,72318868720,3,1349,825,-30
72319804738,72319804743,5,2408,1086,-30
72320333263,72320333241,-22,2604,1129,-30
72320645913,72320645919,6,3380,1592,-30
72326677921,72326677926,5,2072,1182,-30
72329042223,72329042225,2,1325,1070,-30
72332258539,72332258547,8,11371,25878,-30
72333880789,72333880795,6,1767,942,-30
72337917218,72337917223,5,2840,1687,-30
72344442727,72344442740,13,135,2342,-30
72345461127,72345461132,5,2366,1832,-30
72345719127,72345719135,8,2461,1167,-30
72346926148,72346926156,8,2954,1280,-30
72347720204,72347720211,7,2534,1109,-30
72349931785,72349931790,5,2445,1605,-30
72350782754,72350782762,8,1977,605,-30
72351571762,72351571763,1,1221,1000,-30
72352167078,72352167081,3,2543,1428,-30
72352604618,72352604624,6,3003,2072,-30
72354071951,72354071958,7,2304,1447,-30
72354437496,72354437502,6,2820,1289,-30
72357880932,72357880936,4,1570,856,-30
72361046669,72361046671,2,1280,1351,-30
72362907922,72362907925,3,1673,1313,-30
72367524281,72367524285,4,1764,1749,-30
72369401959,72369401963,4,3244,1821,-30
72371186454,72371186459,5,2018,1082,-30
72377297630,72377297635,5,1913,1541,-30
72377679826,72377679831,5,1954,1234,-30
72377881775,72377881779,4,2258,1450,-30
72379240097,72379240103,6,1637,835,-30
72380492082,72380492082,0,1856,1484,-30
72383869958,72383869962,4,2975,1437,-30
72385460428,72385460434,6,2195,999,-30
72391562990,72391562994,4,3391,1767,-30
72393147710,72393147716,6,2095,1227,-30
72398706085,72398706090,5,1761,1304,-30
72400249881,72400249886,5,2840,950,-30
72401918825,72401918831,6,1560,992,-30
72402603896,72402603901,5,2244,1428,-30
72402866505,72402866510,5,1776,1127,-30
72406933297,72406933302,5,2161,1333,-30
72410827019,72410827023,4,1790,601,-30
72412891941,72412891946,5,1328,1085,-30
72415669162,72415669142,-20,2488,1322,-30
72427715575,72427715570,-5,502,2557,-30
72428282474,72428282479,5,2610,1527,-30
72430075156,72430075162,6,1807,1247,-30
72431665401,72431665407,6,2905,1913,-30
72437678466,72437678472,6,2126,1141,-30
72444309822,72444309828,6,1679,1046,-30
72445003818,72445003824,6,3236,1168,-30
72448239698,72448239676,-22,1174,847,-30
72449483334,72449483335,1,1525,1801,-30
72450736024,72450736028,4,2036,1571,-30
72455539586,72455539590,4,2144,1689,-30
72459154585,72459154590,5,2703,1486,-30
72459645918,72459645924,6,1936,1331,-30
72466907555,72466907559,4,1354,770,-30
72469899044,72469899049,5,3014,1314,-30
72470685418,72470685425,7,1630,1370,-30
72471827612,72471827610,-2,1191,764,-30
72473141719,72473141722,3,2218,1359,-30
72474937301,72474937281,-20,1746,835,-30
72477066558,72477066563,5,2028,1195,-30
72478299711,72478299717,6,2823,1721,-30
72481345481,72481345487,6,2199,1012,-30
72483515530,72483515535,5,2559,1791,-30
72484662463,72484662470,7,2043,1008,-30
72485176860,72485176866,6,2236,1451,-30
72488857878,72488857884,6,3386,1357,-30
72492978970,72492978971,1,1834,1740,-30
72495098877,72495098880,3,1733,1388,-30
72496826038,72496826044,6,2778,1362,-30
72499614782,72499614787,5,2526,1443,-30
72500005720,72500005723,3,1525,1486,-30
72501404230,72501404209,-21,1206,686,-30
72504333242,72504333247,5,1450,1210,-30
72504619032,72504619037,5,2266,1585,-30
72506262465,72506262470,5,2155,1849,-30
72506486662,72506486669,7,2919,1582,-30
72506773606,72506773611,5,1827,1345,-30
72509547886,72509547890,4,2150,1054,-30
72512536539,72512536545,6,1910,1523,-30
72517880067,72517880071,4,2282,1248,-30
72520052058,72520052062,4,2398,1387,-30
72523080926,72523080931,5,2950,1588,-30
72523773877,72523773897,20,105,946,-30
72526296220,72526296226,6,1864,895,-30
72527390942,72527390932,-10,2920,350,-30
72528457413,72528457418,5,1701,961,-30
72528665255,72528665235,-20,1442,1061,-30
72541602810,72541602815,5,3037,1600,-30
72543506207,72543506212,5,2232,1708,-30
72543621759,72543621764,5,2002,966,-30
72549082209,72549082215,6,3455,1301,-30
72552748336,72552748335,-1,2402,4005,-30
72555659334,72555659338,4,3044,1942,-30
72556872142,72556872146,4,1768,1289,-30
72558604115,72558604121,6,2642,1512,-30
72560328510,72560328517,7,3872,1940,-30
72561682474,72561682478,4,2360,1270,-30
72561925183,72561925186,3,1585,1032,-30
72564332243,72564332247,4,821,685,-30
72567757290,72567757294,4,2433,1283,-30
72568979268,72568979272,4,2784,1632,-30
72573363909,72573363913,4,1702,808,-30
72574734522,72574734526,4,2423,1277,-30
72576026775,72576026781,6,3012,1919,-30
72576955139,72576955147,8,4544,976,-30
72580499197,72580499203,6,1654,1300,-30
72583356834,72583356841,7,2372,1177,-30
72584150255,72584150248,-7,1304,4719,-30
72590226265,72590226270,5,3640,2709,-30
72593010587,72593010593,6,2259,1696,-30
72593230513,72593230518,5,2766,1615,-30
72594144012,72594144009,-3,1363,2578,-30
72596147141,72596147146,5,1700,855,-30
72600165285,72600165291,6,1909,1380,-30
72603334329,72603334333,4,2322,1333,-30
72606331676,72606331678,2,1185,827,-30
72613170966,72613170973,7,1802,1318,-30
72615986877,72615986883,6,2039,1150,-30
72616904501,72616904505,4,2662,1276,-30
72621843962,72621843967,5,2067,1295,-30
72623794812,72623794814,2,8821,7179,-30
72624936765,72624936771,6,2995,1176,-30
72626649924,72626649927,3,1891,1348,-30
72628397021,72628397025,4,2812,2075,-30
72628950190,72628950196,6,3114,2007,-30
72629597602,72629597605,3,1920,1344,-30
72631403632,72631403638,6,2762,1995,-30
72631899137,72631899142,5,2237,1022,-30
72638022666,72638022671,5,2546,1503,-30
72639342253,72639342249,-4,15009,14470,-30
72644535262,72644535267,5,2416,1242,-30
72645027272,72645027276,4,2313,1518,-30
72647005155,72647005161,6,2928,1330,-30
72649526697,72649526703,6,1302,824,-30
72654656344,72654656350,6,3246,1399,-30
72656568522,72656568527,5,1893,751,-30
72657299339,72657299346,7,2500,1049,-30
72662166003,72662166003,0,333,1021,-30
72664967558,72664967563,5,2359,1237,-30
72666558978,72666558982,4,1270,957,-30
72667540382,72667540361,-21,2931,1027,-30
72667766117,72667766121,4,1634,1616,-30
72667910090,72667910098,8,2951,1319,-30
72678529660,72678529663,3,1937,1100,-30
72681398134,72681398138,4,2060,1219,-30
72682666884,72682666874,-10,68,564,-30
72685617406,72685617411,5,2785,1180,-30
72685830127,72685830134,7,2398,1152,-30
72686681035,72686681039,4,1573,1212,-30
72688428517,72688428522,5,2662,1332,-30
72689005196,72689005198,2,1536,1372,-30
72699659054,72699659058,4,2890,2210,-30
72703186237,72703186242,5,2419,1664,-30
72704319635,72704319639,4,2086,1405,-30
72705433382,72705433386,4,2536,1327,-30
72710481702,72710481706,4,2020,1120,-30
72711071043,72711071046,3,2257,1530,-30
72716393647,72716393650,3,2901,1585,-30
72718471323,72718471328,5,2062,994,-30
72718826167,72718826174,7,1926,737,-30
72720320088,72720320093,5,2264,1183,-30
72738672813,72738672818,5,2529,1385,-30
72739174174,72739174177,3,1871,1288,-30
72741933615,72741933618,3,2533,1220,-30
72742134511,72742134513,2,3207,1643,-30
72743606749,72743606755,6,2365,1086,-30
72743659817,72743659819,2,773,203,-30
72746677170,72746677175,5,2312,1224,-30
72748087243,72748087245,2,930,1117,-30
72749448930,72749448935,5,2040,1128,-30
72750263267,72750263272,5,2512,1497,-30
72752553643,72752553649,6,2760,1595,-30
72755893153,72755893158,5,2113,1187,-30
72757781548,72757781553,5,2248,1774,-30
72759167046,72759167051,5,1195,1228,-30
72760081946,72760081945,-1,1562,1839,-30
72761351738,72761351743,5,2428,1484,-30
72762099200,72762099206,6,1863,1222,-30
72763280034,72763280039,5,2195,1644,-30
72767543302,72767543306,4,3082,1429,-30
72768995138,72768995142,4,2181,1434,-30
72772663786,72772663792,6,2035,1240,-30
72778673778,72778673759,-19,1090,973,-30
72779441814,72779441818,4,2692,1606,-30
72780003998,72780004005,7,2402,1442,-30
72781716095,72781716101,6,1895,1257,-30
72784848373,72784848377,4,2132,1592,-30
72786361062,72786361066,4,2391,2343,-30
72788837962,72788837966,4,2904,1445,-30
72790215142,72790215147,5,2164,1522,-30
72791313877,72791313883,6,2251,1167,-30
72791478259,72791478266,7,2474,1274,-30
72792283646,72792283653,7,2470,1578,-30
72794826755,72794826762,7,1769,1324,-30
72795708074,72795708078,4,2036,893,-30
72798076078,72798076073,-5,1431,4300,-30
72799096945,72799096951,6,1795,1824,-30
72800155178,72800155180,2,949,832,-30
72803789557,72803789564,7,1925,1092,-30
72810200440,72810200443,3,2440,1139,-30
72811966250,72811966255,5,771,465,-30
72812370563,72812370568,5,1796,1305,-30
72813582134,72813582114,-20,609,487,-30
72814098042,72814098048,6,2093,1442,-30
72814812331,72814812338,7,1736,831,-30
72816984487,72816984493,6,3485,1783,-30
72817657467,72817657475,8,2040,1369,-30
72819707397,72819707401,4,2984,1097,-30
72820306290,72820306276,-14,1029,205,-30
72821076525,72821076529,4,2686,1083,-30
72821319174,72821319177,3,1778,953,-30
72822679536,72822679533,-3,1531,2775,-30
72823042290,72823042295,5,2456,1289,-30
72824274793,72824274799,6,2043,1377,-30
72824616688,72824616694,6,2010,892,-30
72827821103,72827821108,5,2334,1287,-30
72829752318,72829752323,5,1872,1184,-30
72830321758,72830321763,5,2208,1188,-30
72833380616,72833380623,7,2078,815,-30
72836205823,72836205830,7,2493,1041,-30
72836594138,72836594124,-14,2061,1047,-30
72837022086,72837022091,5,1873,1248,-30
72837720617,72837720623,6,2242,1207,-30
72841229718,72841229722,4,2551,1673,-30
72844698027,72844698033,6,2460,1273,-30
72853205410,72853205410,0,505,745,-30
72853511267,72853511272,5,3000,1283,-30
72859516517,72859516522,5,3204,1179,-30
72861098688,72861098693,5,2114,1691,-30
72862331255,72862331260,5,2960,1466,-30
72862639793,72862639795,2,1140,1177,-30
72863058144,72863058147,3,3190,1763,-30
72863826114,72863826119,5,2048,1086,-30
72865247542,72865247545,3,2448,1028,-30
72865939406,72865939404,-2,1057,2611,-30
72868319722,72868319727,5,2323,1142,-30
72871167249,72871167255,6,906,682,-30
72876354666,72876354670,4,2638,1699,-30
72878019858,72878019877,19,599,268,-30
72880472081,72880472087,6,2210,1250,-30
72882025050,72882025069,19,1824,978,-30
72882676526,72882676530,4,1771,1147,-30
72882802282,72882802289,7,2982,1195,-30
72887172179,72887172184,5,2572,1425,-30
72892426030,72892426039,9,3708,1458,-30
72893404441,72893404443,2,1116,1148,-30
72895158605,72895158609,4,2392,1414,-30
72898227998,72898228003,5,2330,1271,-30
72900095482,72900095486,4,1949,1050,-30
72902064634,72902064638,4,2815,1623,-30
72903348771,72903348774,3,1624,1004,-30
72903406824,72903406826,2,803,380,-30
72913279370,72913279375,5,2335,1156,-30
72914866596,72914866602,6,2459,1872,-30
72916030345,72916030349,4,2018,1165,-30
72917274875,72917274882,7,2402,1139,-30
72917533094,72917533096,2,1814,1419,-30
72917560023,72917560003,-20,972,301,-30
72921412317,72921412321,4,2521,1994,-30
72922869513,72922869518,5,3020,1053,-30
72928146866,72928146872,6,2658,1766,-30
72930421389,72930421393,4,4036,2030,-30
72931044934,72931044938,4,2331,1232,-30
72932325597,72932325603,6,2498,1535,-30
72934841087,72934841089,2,1632,755,-30
72937162543,72937162549,6,2287,1259,-30
72937283934,72937283955,21,161,718,-30
72938585482,72938585475,-7,1174,290,-30
72943532643,72943532647,4,2064,1080,-30
72945392896,72945392904,8,2972,1372,-30
72955219561,72955219559,-2,1481,2262,-30
72958561784,72958561787,3,1821,1352,-30
72958956003,72958956015,12,584,2707,-30
72959441215,72959441218,3,2036,1558,-30
72959825670,72959825676,6,1860,1381,-30
72962568986,72962568989,3,1403,1957,-30
72964005792,72964005797,5,2216,1233,-30
72967845093,72967845098,5,2995,1392,-30
72968416398,72968416406,8,1492,1117,-30
72975605011,72975605016,5,2362,1174,-30
72975955629,72975955635,6,1908,1083,-30
72979283878,72979283876,-2,2276,4067,-30
72982352011,72982352017,6,1878,1147,-30
72984703174,72984703178,4,3509,1956,-30
72993552334,72993552337,3,1907,1181,-30
72993795389,72993795394,5,1810,1155,-30
72995716973,72995716977,4,2106,1398,-30
72997029145,72997029146,1,1747,989,-30
72997062053,72997062057,4,3131,1718,-30
72999914606,72999914604,-2,1129,16606,-30
73000665508,73000665507,-1,1216,1949,-30
73003910577,73003910581,4,2882,1389,-30
73006163902,73006163906,4,1554,984,-30
73008699299,73008699306,7,2880,1733,-30
73009271012,73009271017,5,1860,1365,-30
73012474823,73012474829,6,1908,1211,-30
73015235121,73015235125,4,2251,1070,-30
73016903525,73016903531,6,2059,1094,-30
73024832968,73024832973,5,1716,1549,-30
73025727209,73025727213,4,2024,1212,-30
73026033239,73026033243,4,2005,1090,-30
73028497771,73028497775,4,2048,1741,-30
73029392454,73029392458,4,1576,1383,-30
73029835907,73029835911,4,1906,1314,-30
73032129030,73032129034,4,2062,1250,-30
73033918009,73033918015,6,2660,944,-30
73034259169,73034259175,6,3162,1226,-30
73034312827,73034312808,-19,1153,375,-30
73034812476,73034812491,15,16462,17294,-30
73039882357,73039882361,4,2164,1589,-30
73043477578,73043477574,-4,21153,13341,-30
73045050381,73045050386,5,2585,1711,-30
73045998387,73045998394,7,2232,1139,-30
73052246645,73052246650,5,3013,1501,-30
73053876430,73053876434,4,2232,1124,-30
73064226046,73064226050,4,2742,2323,-30
73071656573,73071656578,5,2107,1187,-30
73076407759,73076407762,3,2382,613,-30
73078148234,73078148238,4,1506,790,-30
73078545773,73078545778,5,1834,25446,-30
73080863301,73080863280,-21,2523,1103,-30
73081073074,73081073073,-1,1434,2617,-30
73083335918,73083335922,4,1890,1509,-30
73084473590,73084473594,4,2339,1557,-30
73085660717,73085660722,5,2456,1667,-30
73086457053,73086457059,6,2673,1455,-30
73088722281,73088722288,7,2072,1159,-30
73092354990,73092354995,5,1995,1426,-30
73093778918,73093778914,-4,1734,1939,-30
73099418749,73099418753,4,1828,790,-30
73099987435,73099987441,6,1716,1537,-30
73102741731,73102741735,4,2705,1722,-30
73104660683,73104660688,5,1372,1130,-30
73107955174,73107955179,5,2261,1400,-30
73114031301,73114031306,5,2307,1397,-30
73118801994,73118801999,5,2386,1321,-30
73121809863,73121809862,-1,1120,1068,-30
73121890925,73121890906,-19,3136,1309,-30
73124871626,73124871631,5,1610,1100,-30
73128647337,73128647322,-15,1504,1118,-30
73130351517,73130351522,5,2120,1379,-30
73131088799,73131088777,-22,394,155,-30
73133830381,73133830371,-10,1773,1176,-30
73135974544,73135974550,6,2027,1695,-30
73140947063,73140947066,3,1477,1257,-30
73141818864,73141818858,-6,1988,7200,-30
73143614827,73143614831,4,2548,1645,-30
73143668147,73143668151,4,1416,781,-30
73143988639,73143988620,-19,2265,1058,-30
73145805707,73145805713,6,2831,1505,-30
73154802326,73154802331,5,2136,788,-30
73156086886,73156086891,5,2335,1109,-30
73157554652,73157554658,6,3236,1593,-30
73158650378,73158650383,5,1076,882,-30
73159057359,73159057362,3,1613,1533,-30
73164559062,73164559065,3,2519,1297,-30
73165581088,73165581095,7,1970,948,-30
73167847209,73167847211,2,1709,1407,-30
73170179836,73170179842,6,3127,1559,-30
73171570581,73171570587,6,1770,1138,-30
73172191247,73172191250,3,895,762,-30
73174872355,73174872360,5,2287,1233,-30
73181859870,73181859874,4,2005,1394,-30
73182378794,73182378790,-4,1080,2946,-30
73182968373,73182968379,6,2611,1322,-30
73183661377,73183661381,4,2922,1449,-30
73185500652,73185500657,5,1399,855,-30
73186535113,73186535109,-4,1438,2802,-30
73186934988,73186934989,1,9071,11517,-30
73188419978,73188419983,5,1985,1102,-30
73190141490,73190141475,-15,1210,582,-30
73192482989,73192482993,4,2342,1702,-30
73193285748,73193285750,2,1435,1418,-30
73199605483,73199605489,6,2765,1644,-30
73200005060,73200005066,6,3855,1339,-30
73201639910,73201639915,5,1269,1091,-30
73202143956,73202143940,-16,2156,1487,-30
73206432275,73206432280,5,3579,1465,-30
73207491102,73207491107,5,2423,1216,-30
73207647198,73207647203,5,2066,1159,-30
73208820401,73208820406,5,1769,1118,-30
73209783161,73209783163,2,1487,1878,-30
73216706674,73216706679,5,2109,1099,-30
73218271226,73218271233,7,1854,1482,-30
73220073328,73220073331,3,1467,1415,-30
73223964361,73223964364,3,2154,1061,-30
73227991712,73227991718,6,1723,1070,-30
73229760226,73229760230,4,1511,943,-30
73230894685,73230894689,4,4386,2597,-30
73231117370,73231117373,3,2270,1557,-30
73234266221,73234266226,5,1177,785,-30
73236168650,73236168653,3,2239,1334,-30
73240079897,73240079904,7,3162,1651,-30
73241218424,73241218428,4,1633,1053,-30
73241278445,73241278451,6,2607,1167,-30
73244993166,73244993169,3,2321,1441,-30
73248883227,73248883231,4,2987,1807,-30
73251371217,73251371222,5,2293,1008,-30
73254180349,73254180355,6,2103,1344,-30
73258056624,73258056627,3,1761,1345,-30
73258757684,73258757689,5,370,1933,-30
73262115075,73262115080,5,1820,1300,-30
73266185821,73266185827,6,2755,1478,-30
73267027477,73267027482,5,1534,800,-30
73272652255,73272652260,5,2634,1500,-30
73275592513,73275592519,6,3103,1055,-30
73277281298,73277281277,-21,1425,989,-30
73278221367,73278221371,4,1882,1208,-30
73279327138,73279327143,5,1908,1068,-30
73286464082,73286464086,4,1275,1098,-30
73287438121,73287438123,2,1375,1493,-30
73287961431,73287961436,5,3558,1624,-30
73288282490,73288282497,7,2073,1346,-30
73289425238,73289425243,5,3088,1406,-30
73290839690,73290839690,0,1680,1834,-30
73298278129,73298278134,5,2243,1076,-30
73299233173,73299233177,4,2515,1476,-30
73300354358,73300354360,2,1687,1543,-30
73303794634,73303794639,5,1895,762,-30
73304540270,73304540277,7,1457,1187,-30
73307161449,73307161450,1,1494,1281,-30
73308257837,73308257842,5,2369,1448,-30
73310764111,73310764111,0,1250,1439,-30
73312529226,73312529231,5,2211,1688,-30
73315154801,73315154806,5,2332,1323,-30
73318357469,73318357474,5,1947,1113,-30
73319191989,73319191994,5,2700,1472,-30
73321138807,73321138811,4,1709,1146,-30
73322697334,73322697338,4,2033,908,-30
73325698670,73325698674,4,2794,1802,-30
73326774133,73326774138,5,3441,2306,-30
73327382529,73327382534,5,1735,855,-30
73331272570,73331272574,4,2333,921,-30
73336039447,73336039453,6,2871,1357,-30
73336095202,73336095209,7,1900,779,-30
73336845547,73336845546,-1,1466,2146,-30
73337377226,73337377232,6,1731,1154,-30
73341182645,73341182649,4,1582,1261,-30
73354134115,73354134119,4,2361,1904,-30
73355610325,73355610331,6,2022,1184,-30
73356092516,73356092520,4,1228,1038,-30
73357741193,73357741197,4,1892,1280,-30
73358621168,73358621156,-12,1561,969,-30
73360113447,73360113448,1,2464,3803,-30
73361831825,73361831830,5,1624,1029,-30
73366825311,73366825318,7,1996,999,-30
73368768152,73368768159,7,2171,986,-30
73372388029,73372388035,6,2453,1085,-30
73372849067,73372849051,-16,824,332,-30
73373121062,73373121069,7,2310,1006,-30
73375909150,73375909148,-2,1017,1493,-30
73376430367,73376430373,6,2577,1389,-30
73381151773,73381151766,-7,2341,8074,-30
73386041273,73386041277,4,1881,1299,-30
73386342931,73386342934,3,2290,1772,-30
73388488574,73388488579,5,2119,1376,-30
73390576126,73390576132,6,2364,1209,-30
73391375895,73391375899,4,1734,1282,-30
73402575471,73402575478,7,2624,1469,-30
73406318353,73406318357,4,2012,1279,-30
73413070241,73413070246,5,3047,1497,-30
73414048526,73414048531,5,2789,1223,-30
73417884876,73417884881,5,2556,1459,-30
73419781504,73419781510,6,2714,1425,-30
73422300388,73422300393,5,1788,1155,-30
73424929256,73424929262,6,1994,1094,-30
73426584226,73426584230,4,1200,786,-30
73429975774,73429975779,5,1838,906,-30
73433558731,73433558735,4,1749,1010,-30
73441008745,73441008753,8,2182,995,-30
73441273018,73441273006,-12,898,80,-30
73441826563,73441826566,3,2403,1109,-30
73444356308,73444356314,6,3741,1886,-30
73455725311,73455725317,6,2688,2744,-30
73459584090,73459584097,7,2177,1343,-30
73461068754,73461068758,4,2189,1323,-30
73464988190,73464988193,3,1434,927,-30
73469597570,73469597574,4,2370,1719,-30
73473366185,73473366189,4,1954,1474,-30
73475915929,73475915937,8,2056,1543,-30
73476595919,73476595922,3,2831,1039,-30
73479725034,73479725038,4,2296,1230,-30
73480359501,73480359522,21,2397,1212,-30
73481034383,73481034387,4,1583,1015,-30
73493505469,73493505471,2,1550,1190,-30
73494048624,73494048626,2,1074,629,-30
73495092903,73495092904,1,2260,2526,-30
73496054605,73496054605,0,3320,3744,-30
73502446912,73502446918,6,2293,1444,-30
73502528923,73502528912,-11,1697,1221,-30
73503379746,73503379750,4,1655,1065,-30
73506346032,73506346035,3,1570,1227,-30
73506667898,73506667902,4,751,589,-30
73511739787,73511739784,-3,958,2292,-30
73513721203,73513721207,4,1948,1428,-30
73514708489,73514708491,2,2269,1394,-30
73514777226,73514777233,7,2349,1271,-30
73527453521,73527453526,5,2560,1337,-30
73530289920,73530289925,5,3360,1523,-30
73531726573,73531726578,5,2121,834,-30
73532018311,73532018298,-13,555,499,-30
73534375282,73534375286,4,1968,1388,-30
73535156124,73535156131,7,2593,1174,-30
73536009218,73536009226,8,462,673,-30
73536705457,73536705459,2,2056,1163,-30
73540054191,73540054197,6,2230,1679,-30
73541312453,73541312456,3,1340,1574,-30
73541988662,73541988666,4,2014,1302,-30
73543251736,73543251740,4,2402,1548,-30
73544135458,73544135441,-17,734,617,-30
73549737632,73549737636,4,1815,1394,-30
73552163474,73552163456,-18,1154,595,-30
73553855166,73553855170,4,1854,1159,-30
73561479123,73561479129,6,2276,1438,-30
73564491112,73564491117,5,3005,1739,-30
73564813531,73564813533,2,1814,2422,-30
73565111983,73565111987,4,2328,1189,-30
73565518426,73565518430,4,2033,1215,-30
73567409485,73567409491,6,2595,1541,-30
73568814886,73568814891,5,1480,1058,-30
73569788173,73569788178,5,1113,890,-30
73575388202,73575388209,7,2533,1166,-30
73577200967,73577200965,-2,1418,2196,-30
73577333804,73577333806,2,1581,1335,-30
73581809138,73581809142,4,2339,1264,-30
73582583490,73582583496,6,2556,1786,-30
73583123981,73583123981,0,36515,23309,-30
73583397150,73583397154,4,2068,1313,-30
73587183213,73587183219,6,1528,956,-30
73587861357,73587861362,5,2168,1383,-30
73589580692,73589580697,5,2812,1596,-30
73590504307,73590504313,6,2169,1662,-30
73594271831,73594271838,7,2323,1272,-30
73594736445,73594736450,5,2072,1479,-30
73601707691,73601707694,3,2545,2094,-30
73607813345,73607813350,5,2894,1360,-30
73609105968,73609105971,3,1906,1223,-30
73612074270,73612074267,-3,1585,2057,-30
73612778457,73612778463,6,2444,1660,-30
73620639615,73620639622,7,1813,1302,-30
73624836221,73624836226,5,1867,1407,-30
73626947983,73626947991,8,2597,1080,-30
73627560601,73627560605,4,1814,1346,-30
73631761311,73631761317,6,3162,1756,-30
73632075706,73632075688,-18,1110,609,-30
73632680097,73632680100,3,3542,2400,-30
73642496560,73642496564,4,2922,1981,-30
73647319890,73647319889,-1,1282,1486,-30
73649364498,73649364503,5,2447,1708,-30
73653472267,73653472273,6,2403,1263,-30
73654179588,73654179586,-2,1203,2056,-30
73660887891,73660887898,7,7387,1501,-30
73661665429,73661665436,7,12617,2347,-30
73662050922,73662050928,6,2500,1469,-30
73664113048,73664113054,6,1933,1826,-30
73664850365,73664850369,4,2014,759,-30
73664899182,73664899187,5,1172,1265,-30
73664994587,73664994590,3,874,1226,-30
73668042089,73668042094,5,974,941,-30
73668536838,73668536842,4,2056,1405,-30
73669273776,73669273783,7,3253,1402,-30
73669615910,73669615914,4,2122,1241,-30
73670566561,73670566562,1,2008,1525,-30
73672028248,73672028254,6,2775,1139,-30
73674162920,73674162922,2,2122,1555,-30
73674552377,73674552377,0,877,880,-30
73678336163,73678336176,13,1903,818,-30
73679229228,73679229232,4,1771,879,-30
73679364997,73679365005,8,5877,2401,-30
73679571070,73679571074,4,1612,1446,-30
73680695569,73680695575,6,2762,1508,-30
73681218793,73681218798,5,2625,1224,-30
73681641541,73681641543,2,2023,1503,-30
73682502618,73682502623,5,1601,1279,-30
73684054049,73684054053,4,1910,1690,-30
73685783921,73685783926,5,2959,1430,-30
73688327990,73688327995,5,2382,1138,-30
73689022359,73689022367,8,1791,1157,-30
73691351314,73691351323,9,1756,1142,-30
73692341222,73692341227,5,2201,1158,-30
73692643258,73692643261,3,1586,1042,-30
73704309699,73704309704,5,1928,1512,-30
73707369663,73707369667,4,3439,1637,-30
73707711046,73707711051,5,2973,1702,-30
73711102905,73711102910,5,2369,1103,-30
73713724341,73713724345,4,2153,1148,-30
73714979425,73714979432,7,1634,850,-30
73717455090,73717455095,5,2330,1305,-30
73717784890,73717784874,-16,2340,1137,-30
73726053002,73726053006,4,1979,1214,-30
73727163568,73727163574,6,3141,1997,-30
73729041514,73729041519,5,2874,1793,-30
73737864879,73737864880,1,1152,1246,-30
73740610929,73740610933,4,1723,1074,-30
73741239193,73741239197,4,1628,1208,-30
73744216977,73744216981,4,2182,1286,-30
73747888309,73747888313,4,2259,1300,-30
73749857205,73749857211,6,2004,1404,-30
73751779989,73751779994,5,3129,1981,-30
73756715729,73756715744,15,14055,52994,-30
73757182969,73757182974,5,2558,1199,-30
73759888325,73759888331,6,2306,925,-30
73760337682,73760337686,4,3089,2186,-30
73762102534,73762102537,3,1997,1389,-30
73763491788,73763491794,6,3082,1586,-30
73764925814,73764925819,5,3441,1679,-30
73765177182,73765177188,6,3010,1494,-30
73770065370,73770065376,6,1967,1452,-30
73778334793,73778334798,5,2335,1510,-30
73778428037,73778428042,5,2121,1238,-30
73779173644,73779173648,4,2761,2033,-30
73780178837,73780178842,5,2636,1588,-30
73780975591,73780975597,6,1695,1362,-30
73782794270,73782794274,4,1884,1398,-30
73783311001,73783311006,5,1783,1414,-30
73784689341,73784689346,5,2579,1247,-30
73786790433,73786790439,6,1741,1276,-30
73788215567,73788215572,5,1858,1201,-30
73789960823,73789960829,6,2461,1048,-30
73791343545,73791343550,5,2001,1510,-30
73791545245,73791545247,2,1669,1350,-30
73791851493,73791851499,6,2267,1119,-30
73794960294,73794960299,5,2265,1244,-30
73795155969,73795155977,8,2453,1477,-30
73796005940,73796005945,5,2055,1027,-30
73797505970,73797505977,7,2541,1066,-30
73800994702,73800994707,5,2052,1513,-30
73803444538,73803444543,5,1526,1198,-30
73805748550,73805748549,-1,923,1413,-30
73806024865,73806024869,4,1567,1003,-30
73807634864,73807634868,4,2167,1222,-30
73807930074,73807930078,4,2502,1295,-30
73809123213,73809123215,2,2644,975,-30
73810165228,73810165231,3,1253,1335,-30
73810852954,73810852958,4,2962,2067,-30
73814032510,73814032514,4,2097,1363,-30
73815458823,73815458827,4,1753,1220,-30
73815879196,73815879200,4,2410,1086,-30
73820832851,73820832850,-1,20245,7401,-30
73826758145,73826758148,3,1958,1467,-30
73828613397,73828613400,3,2287,1402,-30
73828758418,73828758422,4,1969,1397,-30
73830919701,73830919705,4,1673,1208,-30
73839743198,73839743206,8,2197,1430,-30
73839774817,73839774822,5,2165,1320,-30
73840246559,73840246538,-21,797,467,-30
73843665958,73843665961,3,1632,1002,-30
73847172982,73847172986,4,1580,942,-30
73848065866,73848065871,5,2231,962,-30
73848292877,73848292896,19,2068,909,-30
73850411492,73850411497,5,3393,1380,-30
73854023740,73854023750,10,13829,25429,-30
73855562509,73855562511,2,1597,1753,-30
73861395038,73861395043,5,2956,1400,-30
73863237113,73863237118,5,2116,1337,-30
73865275734,73865275738,4,2338,1452,-30
73866233189,73866233195,6,1569,913,-30
73867110339,73867110322,-17,1042,360,-30
73871016517,73871016522,5,3395,1491,-30
73876506908,73876506914,6,2355,1172,-30
73877189793,73877189797,4,2135,1299,-30
73877426748,73877426754,6,1354,998,-30
73877571087,73877571065,-22,646,137,-30
73877827348,73877827328,-20,1721,1038,-30
73879774969,73879774975,6,5189,2078,-30
73879925067,73879925072,5,2565,1414,-30
73882819357,73882819362,5,2793,1325,-30
73883560238,73883560244,6,2356,1374,-30
73885554471,73885554476,5,1835,1554,-30
73887878595,73887878601,6,1513,994,-30
73888578320,73888578326,6,2909,1451,-30
73890131199,73890131205,6,2686,1170,-30
73894141528,73894141533,5,2462,1171,-30
73894822715,73894822721,6,1609,1395,-30
73895135418,73895135420,2,1403,1243,-30
73899034106,73899034110,4,1656,1131,-30
73903290789,73903290793,4,2686,1157,-30
73903324670,73903324676,6,3114,1369,-30
73903425385,73903425402,17,1717,1284,-30
73907189379,73907189384,5,1896,1293,-30
73908968390,73908968394,4,2577,1099,-30
73915262858,73915262862,4,2278,1423,-30
73917653291,73917653296,5,1966,1144,-30
73919085549,73919085553,4,1709,1537,-30
73921703702,73921703706,4,3349,1517,-30
73921855998,73921856002,4,2149,1118,-30
73927612337,73927612341,4,2425,1878,-30
73929008270,73929008277,7,2686,1168,-30
73930496422,73930496426,4,2207,1648,-30
73935043777,73935043781,4,2791,1600,-30
73935311547,73935311552,5,2420,1202,-30
73937555317,73937555321,4,2323,1841,-30
73937830277,73937830290,13,2801,1195,-30
73941976601,73941976596,-5,682,2863,-30
73948413634,73948413641,7,1891,1681,-30
73949263290,73949263295,5,2728,1437,-30
73952303231,73952303236,5,2236,1544,-30
73952812464,73952812468,4,2091,1382,-30
73955792297,73955792303,6,2513,1665,-30
73959581033,73959581038,5,2258,1264,-30
73961373449,73961373454,5,1978,1505,-30
73962155735,73962155739,4,1648,1026,-30
73968598078,73968598083,5,1696,1181,-30
73968833215,73968833209,-6,2065,4807,-30
73972032282,73972032286,4,1944,1164,-30
73974872528,73974872534,6,2105,1679,-30
73975032533,73975032538,5,2984,2105,-30
73975848181,73975848186,5,1902,1286,-30
73976235809,73976235814,5,1574,847,-30
73976621525,73976621531,6,2445,1170,-30
73976873131,73976873136,5,3281,1376,-30
73978111082,73978111086,4,2018,1883,-30
73981567199,73981567205,6,3232,1459,-30
73983809849,73983809850,1,1284,719,-30
73985630587,73985630592,5,2969,1363,-30
73986768215,73986768221,6,3017,1298,-30
73988241510,73988241517,7,3349,1460,-30
73990564594,73990564599,5,1910,1364,-30
73991143327,73991143331,4,2099,1656,-30
73994633970,73994633975,5,2743,1552,-30
73995802854,73995802859,5,2437,1414,-30
73996362381,73996362386,5,2272,1300,-30
73996802499,73996802506,7,2321,1129,-30
73999816246,73999816249,3,1846,752,-30
74000680102,74000680084,-18,2041,644,-30
74003152635,74003152641,6,1359,877,-30
74003409963,74003409947,-16,1629,677,-30
74003557371,74003557377,6,2003,1355,-30
74007318350,74007318357,7,1883,935,-30
74010306453,74010306455,2,1891,1735,-30
74015968506,74015968513,7,1568,1575,-30
74018452280,74018452286,6,2070,813,-30
74019207660,74019207660,0,458,324,-30
74022078189,74022078185,-4,857,2186,-30
74025713084,74025713089,5,1929,1200,-30
74025863926,74025863931,5,2438,1328,-30
74026989330,74026989334,4,3369,1715,-30
74027526932,74027526931,-1,1141,1794,-30
74030189638,74030189644,6,2068,1302,-30
74034419161,74034419166,5,2314,1407,-30
74036331094,74036331100,6,2151,1002,-30
74041636358,74041636363,5,2379,1572,-30
74043308198,74043308178,-20,3003,1207,-30
74043692954,74043692940,-14,1277,941,-30
74044156561,74044156565,4,1939,1566,-30
74044191033,74044191037,4,2203,1231,-30
74046957379,74046957383,4,1497,1002,-30
74047809730,74047809722,-8,1185,4311,-30
74048658145,74048658150,5,2087,1264,-30
74051570414,74051570434,20,1088,263,-30
74052085672,74052085678,6,2680,1813,-30
74060100506,74060100511,5,1762,979,-30
74061155801,74061155806,5,2528,1022,-30
74064161733,74064161740,7,3170,1242,-30
74065021417,74065021421,4,2992,1338,-30
74066315725,74066315729,4,1676,1076,-30
74066744219,74066744202,-17,2647,1170,-30
74066893013,74066893018,5,1625,954,-30
74067222074,74067222080,6,2088,1059,-30
74072840772,74072840780,8,2722,1064,-30
74075284969,74075284972,3,1977,1814,-30
74077136265,74077136268,3,2973,1513,-30
74077479062,74077479068,6,2800,1368,-30
74080024812,74080024817,5,2488,911,-30
74083199669,74083199673,4,2231,1431,-30
74086777325,74086777330,5,2702,1604,-30
74087331838,74087331841,3,1637,1143,-30
74089403878,74089403882,4,2229,1430,-30
74089725448,74089725451,3,1961,1057,-30
74093343100,74093343102,2,2739,1045,-30
74096869130,74096869134,4,2295,1223,-30
74101332562,74101332566,4,2019,949,-30
74102870818,74102870808,-10,828,274,-30
74107251514,74107251519,5,1742,1173,-30
74110080290,74110080295,5,2439,1522,-30
74112379216,74112379229,13,70,691,-30
74114190167,74114190171,4,2533,1414,-30
74115639071,74115639075,4,900,1125,-30
74116237339,74116237343,4,1126,856,-30
74117992075,74117992078,3,1783,1406,-30
74123832594,74123832598,4,2559,1728,-30
74128392806,74128392810,4,1954,1445,-30
74129913382,74129913386,4,2985,2077,-30
74133702639,74133702618,-21,1117,860,-30
74134749853,74134749859,6,3240,2076,-30
74137440179,74137440183,4,1972,1257,-30
74137568001,74137568006,5,3027,1546,-30
74137886954,74137886958,4,1671,1238,-30
74141678966,74141678970,4,1412,1104,-30
74143254243,74143254241,-2,1346,3159,-30
74144178378,74144178382,4,1323,1334,-30
74147602390,74147602373,-17,894,250,-30
74148629313,74148629319,6,3338,2005,-30
74148998518,74148998524,6,1861,1058,-30
74150356143,74150356149,6,2951,1670,-30
74151040362,74151040370,8,11340,19793,-30
74152132849,74152132854,5,1649,1237,-30
74153523420,74153523425,5,1549,1229,-30
74156736467,74156736473,6,1477,693,-30
74165072357,74165072362,5,1834,1354,-30
74166482900,74166482906,6,5290,2640,-30
74168663465,74168663471,6,3016,1277,-30
74170405211,74170405214,3,1810,1243,-30
74173451028,74173451035,7,2243,1314,-30
74175096891,74175096896,5,2950,1418,-30
74175590774,74175590769,-5,1358,5568,-30
74177451775,74177451781,6,2565,1363,-30
74179052614,74179052619,5,2435,1590,-30
74180095370,74180095374,4,2024,1250,-30
74185499357,74185499361,4,2076,1140,-30
74190374129,74190374133,4,2333,1141,-30
74194335186,74194335190,4,2652,1490,-30
74194931994,74194931998,4,1921,1085,-30
74200341046,74200341050,4,1758,1761,-30
74201226078,74201226083,5,2757,1887,-30
74204338395,74204338403,8,3846,1523,-30
74205679210,74205679215,5,2131,1188,-30
74207748490,74207748494,4,1810,1250,-30
74208532370,74208532375,5,2511,1308,-30
74211592497,74211592500,3,2212,1685,-30
74211967370,74211967354,-16,2038,1350,-30
74212670338,74212670343,5,990,677,-30
74215065720,74215065725,5,2117,1163,-30
74221003482,74221003485,3,1673,1888,-30
74222715881,74222715886,5,2485,1229,-30
74229312834,74229312837,3,3276,1494,-30
74230295399,74230295407,8,1298,754,-30
74232802622,74232802628,6,1590,1137,-30
74233633071,74233633075,4,2623,1501,-30
74234985822,74234985827,5,1873,1628,-30
74236766519,74236766517,-2,1886,2794,-30
74237145174,74237145178,4,1452,996,-30
74239227982,74239227988,6,1430,1574,-30
74247025894,74247025897,3,2506,1191,-30
74252375142,74252375147,5,1997,1372,-30
74252856246,74252856251,5,2304,1715,-30
74252976042,74252976046,4,1602,1652,-30
74253868857,74253868861,4,2369,1320,-30
74255288535,74255288539,4,877,691,-30
74255485954,74255485938,-16,428,103,-30
74258615232,74258615237,5,3156,1689,-30
74261072678,74261072683,5,2451,1042,-30
74262252414,74262252418,4,2860,2359,-30
74265079877,74265079883,6,2336,926,-30
74267457557,74267457562,5,2182,1488,-30
74269124787,74269124793,6,1610,835,-30
74269836987,74269836993,6,2599,1406,-30
74272617378,74272617385,7,2074,993,-30
74273949114,74273949113,-1,1253,2765,-30
74275202902,74275202903,1,1431,1356,-30
74278561989,74278561993,4,1734,1097,-30
74278999100,74278999106,6,2735,1330,-30
74279081898,74279081903,5,2089,1092,-30
74285451157,74285451163,6,2400,1492,-30
74286489384,74286489383,-1,794,1676,-30
74297263178,74297263183,5,3063,1451,-30
74298598732,74298598743,11,434,3636,-30
74301936320,74301936325,5,2362,1299,-30
74306139537,74306139541,4,2330,1370,-30
74306181906,74306181913,7,2905,1668,-30
74311213378,74311213372,-6,1503,5581,-30
74317388073,74317388076,3,4359,3519,-30
74317474102,74317474107,5,2114,1461,-30
74318674710,74318674714,4,1599,1122,-30
74319580894,74319580899,5,855,1119,-30
74321908006,74321908011,5,2335,1290,-30
74323118144,74323118150,6,1703,1514,-30
74323622239,74323622243,4,2702,1557,-30
74324531165,74324531170,5,1856,881,-30
74324713705,74324713690,-15,1509,719,-30
74325755536,74325755543,7,3025,1440,-30
74335029138,74335029134,-4,889,3261,-30
74336654421,74336654427,6,2057,1644,-30
74339407858,74339407862,4,2580,1472,-30
74339529998,74339530004,6,1660,1538,-30
74340836828,74340836834,6,1990,1367,-30
74350067465,74350067471,6,1938,1515,-30
74352385017,74352385021,4,1985,1332,-30
74353656454,74353656458,4,2517,1127,-30
74354612650,74354612654,4,3013,1802,-30
74354797973,74354797977,4,1823,1107,-30
74356585211,74356585216,5,1655,1110,-30
74357571237,74357571242,5,3220,1360,-30
74358751140,74358751145,5,2120,1345,-30
74358807682,74358807666,-16,1622,1160,-30
74359700210,74359700215,5,2415,1477,-30
74361953284,74361953287,3,2266,1232,-30
74364023778,74364023782,4,2237,1119,-30
74367435362,74367435366,4,1288,1167,-30
74372062914,74372062915,1,1724,1024,-30
74372838165,74372838170,5,3241,1559,-30
74374799733,74374799739,6,2243,988,-30
74376373406,74376373412,6,2325,1405,-30
74378627860,74378627867,7,34127,25073,-30
74382026476,74382026481,5,1873,1013,-30
74382083910,74382083915,5,2965,1605,-30
74390559108,74390559128,20,2872,1277,-30
74391072185,74391072191,6,2678,1600,-30
74391561905,74391561911,6,2057,1167,-30
74391968789,74391968794,5,1311,866,-30
74392080665,74392080669,4,1511,917,-30
74393490946,74393490950,4,5314,2073,-30
74394744274,74394744278,4,1963,1093,-30
74396164410,74396164414,4,2378,1010,-30
74397351783,74397351778,-5,731,3201,-30
74398373898,74398373903,5,1350,1306,-30
74400445557,74400445558,1,1934,1109,-30
74400865191,74400865195,4,2393,1384,-30
74402119715,74402119719,4,1796,1297,-30
74403978118,74403978122,4,1820,1236,-30
74404980934,74404980939,5,2016,1108,-30
74414211028,74414211033,5,2453,1029,-30
74415658786,74415658790,4,2467,1884,-30
74416598322,74416598326,4,1638,1384,-30
74419431681,74419431688,7,1766,1310,-30
74424355378,74424355383,5,2137,1306,-30
74424651183,74424651186,3,2151,1256,-30
74425533318,74425533322,4,2371,1082,-30
74426025127,74426025106,-21,409,284,-30
74426966073,74426966077,4,2152,1389,-30
74429014427,74429014427,0,964,2655,-30
74431000790,74431000796,6,2578,1511,-30
74432476886,74432476891,5,2162,1447,-30
74439425823,74439425830,7,2523,997,-30
74441364528,74441364534,6,2823,1346,-30
74444271912,74444271918,6,1821,1061,-30
74448211155,74448211157,2,2084,1185,-30
74454306413,74454306418,5,1925,1143,-30
74456317272,74456317277,5,1902,974,-30
74464592802,74464592806,4,2337,1221,-30
74465919486,74465919492,6,2894,1204,-30
74466353162,74466353147,-15,3565,1219,-30
74468420130,74468420134,4,1353,1541,-30
74470491051,74470491055,4,2042,1351,-30
74475190574,74475190579,5,1801,1032,-30
74479674995,74479675002,7,1939,1144,-30
74480022565,74480022544,-21,1185,1010,-30
74483059165,74483059171,6,1867,1296,-30
74488093432,74488093431,-1,19394,14117,-30
74493472675,74493472669,-6,2496,7569,-30
74494494084,74494494090,6,2173,1580,-30
74497291574,74497291578,4,1797,650,-30
74500451009,74500451013,4,1238,1250,-30
74502661952,74502661957,5,2946,1546,-30
74509714072,74509714079,7,1520,1084,-30
74515580742,74515580748,6,1538,976,-30
74518826824,74518826829,5,1779,1308,-30
74523292634,74523292638,4,2319,1676,-30
74524606498,74524606502,4,3291,1494,-30
74524715205,74524715210,5,2483,1311,-30
74529105729,74529105734,5,2246,1328,-30
74531212473,74531212480,7,2343,1124,-30
74534515983,74534515987,4,2550,1096,-30
74535441645,74535441648,3,1883,1276,-30
74537085859,74537085865,6,2465,1272,-30
74540117794,74540117799,5,2165,1291,-30
74547439318,74547439324,6,2483,1598,-30
74551462878,74551462885,7,1377,816,-30
74555459082,74555459087,5,2816,1775,-30
74555948618,74555948623,5,2071,1244,-30
74562188755,74562188761,6,2350,967,-30
74572673633,74572673638,5,1381,1672,-30
74572969210,74572969214,4,1710,1211,-30
74573565281,74573565284,3,1361,1391,-30
74573864190,74573864194,4,1117,929,-30
74574709125,74574709131,6,2596,1392,-30
74576624010,74576624016,6,2598,1472,-30
74577811486,74577811491,5,1692,1234,-30
74578402510,74578402512,2,2933,4192,-30
74582552811,74582552815,4,1433,1295,-30
74585050334,74585050340,6,1832,1201,-30
74585091266,74585091271,5,1851,990,-30
74590302577,74590302583,6,1467,1121,-30
74590473008,74590473011,3,1507,947,-30
74593090169,74593090173,4,2011,1317,-30
74596397250,74596397255,5,2639,1280,-30
74596521162,74596521168,6,5696,2982,-30
74597757793,74597757798,5,1461,994,-30
74603582843,74603582848,5,2774,1441,-30
74605013709,74605013714,5,2038,1004,-30
74610432449,74610432455,6,1599,1252,-30
74614725238,74614725243,5,2418,1208,-30
74615084546,74615084544,-2,1411,3864,-30
74618279434,74618279442,8,2496,1281,-30
74622921683,74622921688,5,2541,1462,-30
74625408274,74625408280,6,2217,1536,-30
74633652908,74633652914,6,1933,978,-30
74634573730,74634573734,4,2086,1257,-30
74637341596,74637341603,7,2114,1631,-30
74640763456,74640763462,6,1744,816,-30
74641239482,74641239487,5,1828,1178,-30
74641526055,74641526061,6,3064,1349,-30
74641867547,74641867555,8,1246,874,-30
74645043438,74645043443,5,2694,1848,-30
74646213491,74646213498,7,3357,1314,-30
74647080899,74647080902,3,2328,1840,-30
74648436231,74648436234,3,1509,1505,-30
74652841652,74652841658,6,2025,1534,-30
74654607602,74654607606,4,2967,1784,-30
74654951977,74654951983,6,1193,1217,-30
74655506434,74655506438,4,2377,1408,-30
74656945302,74656945306,4,1629,1745,-30
74657270243,74657270249,6,1980,1186,-30
74657865855,74657865860,5,2438,1798,-30
74659296466,74659296474,8,790,413,-30
74660166170,74660166174,4,2086,1671,-30
74660904105,74660904109,4,3415,1707,-30
74661278985,74661278984,-1,2712,20495,-30
74662170523,74662170527,4,1139,842,-30
74663683699,74663683704,5,2464,1253,-30
74666639894,74666639897,3,1155,835,-30
74669090107,74669090114,7,3056,1475,-30
74673963769,74673963773,4,1615,1333,-30
74674380074,74674380079,5,2319,1223,-30
74675561696,74675561689,-7,884,3545,-30
74682100938,74682100941,3,2534,1386,-30
74683517181,74683517186,5,3413,1054,-30
74689144206,74689144210,4,1251,984,-30
74690375013,74690375019,6,2579,1185,-30
74694576812,74694576815,3,2702,2138,-30
74697132356,74697132361,5,3232,1713,-30
74703226672,74703226678,6,1968,1345,-30
74707563279,74707563283,4,1981,972,-30
74718712702,74718712706,4,890,972,-30
74727569730,74727569735,5,2129,1114,-30
74730616575,74730616582,7,7167,2880,-30
74734201670,74734201675,5,1946,1099,-30
74735161843,74735161848,5,2042,1254,-30
74735784360,74735784365,5,2787,1665,-30
74736073370,74736073377,7,3078,1328,-30
74738677326,74738677326,0,1362,2320,-30
74738886962,74738886967,5,2066,1035,-30
74739999802,74739999782,-20,2203,963,-30
74740943539,74740943545,6,2198,783,-30
74758119862,74758119867,5,2239,1055,-30
74762923589,74762923594,5,2860,1350,-30
74764762147,74764762154,7,2287,1171,-30
74765891435,74765891439,4,1781,1068,-30
74768636552,74768636559,7,2764,994,-30
74770908629,74770908632,3,866,1134,-30
74771447325,74771447330,5,1538,805,-30
74771474802,74771474808,6,2249,1306,-30
74775574415,74775574421,6,2953,1368,-30
74777217960,74777217963,3,1891,1384,-30
74777700646,74777700648,2,943,780,-30
74779168890,74779168897,7,2939,1458,-30
74779378914,74779378918,4,2584,976,-30
74779740285,74779740286,1,1851,2201,-30
74780127033,74780127038,5,2046,1163,-30
74780800866,74780800870,4,1729,1405,-30
74786244878,74786244883,5,2527,1175,-30
74789434553,74789434557,4,2812,843,-30
74789783933,74789783920,-13,1338,395,-30
74790581550,74790581555,5,1197,784,-30
74791574261,74791574266,5,3653,1295,-30
74791618167,74791618169,2,4660,3247,-30
74792339780,74792339775,-5,768,2682,-30
74794528879,74794528884,5,2383,1932,-30
74795170875,74795170880,5,2365,1591,-30
74800551106,74800551111,5,1828,1338,-30
74802005111,74802005110,-1,1421,2323,-30
74804756998,74804756993,-5,2573,6822,-30
74806574810,74806574814,4,1737,1114,-30
74809908549,74809908554,5,2838,1181,-30
74810414547,74810414550,3,1349,1306,-30
74810609061,74810609068,7,2356,2139,-30
74811766885,74811766889,4,2920,1952,-30
74814690987,74814690993,6,3654,2236,-30
74820343140,74820343146,6,2341,1102,-30
74821764362,74821764344,-18,462,393,-30
74822957937,74822957943,6,1947,1019,-30
74826731930,74826731929,-1,1496,1135,-30
74829073985,74829073994,9,3535,763,-30
74830637917,74830637922,5,1731,836,-30
74831040490,74831040474,-16,2068,1276,-30
74832029361,74832029365,4,2203,1448,-30
74833127645,74833127637,-8,522,2299,-30
74840371687,74840371691,4,2963,1441,-30
74844483064,74844483070,6,2572,1438,-30
74857635282,74857635286,4,2173,1374,-30
74858143269,74858143273,4,2356,1613,-30
74859627174,74859627179,5,2474,1467,-30
74862527182,74862527190,8,2760,1371,-30
74862681886,74862681866,-20,2746,1611,-30
74862942374,74862942353,-21,1075,216,-30
74864134069,74864134062,-7,2037,8991,-30
74864630122,74864630126,4,2419,1397,-30
74865433773,74865433777,4,1194,1069,-30
74866303897,74866303898,1,432,198,-30
74872976841,74872976846,5,2360,1171,-30
74873572565,74873572547,-18,2120,1209,-30
74873904605,74873904604,-1,2299,4041,-30
74874127967,74874127972,5,2639,1322,-30
74875705050,74875705055,5,2846,1747,-30
74881714486,74881714491,5,1982,1251,-30
74893091390,74893091393,3,1299,1274,-30
74897060706,74897060712,6,2802,1592,-30
74900082004,74900082010,6,3053,1718,-30
74904551849,74904551854,5,2217,1162,-30
74904890435,74904890419,-16,744,111,-30
74906740500,74906740506,6,3212,1706,-30
74910320911,74910320917,6,2494,1318,-30
74910402058,74910402061,3,1764,1703,-30
74914474627,74914474626,-1,1205,2625,-30
74915670838,74915670842,4,2564,977,-30
74918532041,74918532046,5,2725,1542,-30
74918813746,74918813750,4,3369,1795,-30
74920001937,74920001942,5,2213,1474,-30
74922001097,74922001101,4,1987,1293,-30
74924009433,74924009417,-16,746,400,-30
74925449190,74925449195,5,1659,926,-30
74931834141,74931834146,5,1826,1241,-30
74932000075,74932000056,-19,1970,1695,-30
74934553770,74934553775,5,1581,835,-30
74934727477,74934727458,-19,571,389,-30
74935493426,74935493430,4,2698,1026,-30
74938011481,74938011468,-13,683,368,-30
74941555261,74941555247,-14,1236,797,-30
74943343733,74943343737,4,2349,1779,-30
74945819338,74945819331,-7,1384,6933,-30
74945960779,74945960785,6,1479,749,-30
74947603724,74947603739,15,2583,1066,-30
74949424950,74949424954,4,2295,1380,-30
74957153554,74957153559,5,2418,942,-30
74957910516,74957910519,3,1940,1225,-30
74960889499,74960889502,3,2197,1641,-30
74966141373,74966141377,4,2346,1595,-30
74970688835,74970688842,7,2530,1411,-30
74971306827,74971306833,6,2446,1372,-30
74971991510,74971991515,5,2475,1058,-30
74975695465,74975695471,6,2171,1045,-30
74976802416,74976802422,6,1401,1210,-30
74978153869,74978153873,4,1907,1958,-30
74978355162,74978355167,5,2695,1172,-30
74981919582,74981919590,8,3769,1268,-30
74989485232,74989485235,3,2254,1047,-30
74989743879,74989743882,3,1876,1150,-30
74990297118,74990297120,2,2262,1930,-30
74990761579,74990761582,3,1990,1754,-30
74995346747,74995346752,5,2469,1858,-30
74997190054,74997190058,4,1918,1431,-30
74998035693,74998035698,5,3040,1722,-30
75002906742,75002906746,4,1669,935,-30
75006176013,75006176010,-3,1406,2143,-30
75006613059,75006613063,4,2206,1255,-30
75009340121,75009340123,2,2121,1420,-30
75009750257,75009750262,5,2937,1132,-30
75011139226,75011139232,6,2018,1172,-30
75011966130,75011966134,4,2723,1890,-30
75012566805,75012566810,5,2114,1461,-30
75017689086,75017689093,7,2844,1751,-30
75018413565,75018413577,12,2181,1523,-30
75019116331,75019116335,4,1803,1619,-30
75019272962,75019272967,5,2413,1566,-30
75020704539,75020704544,5,2714,1441,-30
75020758871,75020758857,-14,962,341,-30
75021178651,75021178654,3,1823,1972,-30
75021400912,75021400917,5,3188,1752,-30
75022146882,75022146876,-6,901,3305,-30
75023673122,75023673127,5,3064,1512,-30
75023928511,75023928506,-5,1240,2752,-30
75024016093,75024016097,4,2450,1881,-30
75031278823,75031278831,8,2677,1362,-30
75034573578,75034573584,6,2775,1432,-30
75038135794,75038135798,4,1941,1083,-30
75041167869,75041167875,6,1541,829,-30
75047123831,75047123836,5,2875,1506,-30
75049781523,75049781529,6,1430,999,-30
75052316834,75052316837,3,1612,1974,-30
75052540643,75052540648,5,2167,1441,-30
75055381636,75055381639,3,1132,868,-30
75061272380,75061272387,7,2331,1290,-30
75062069951,75062069932,-19,1462,1031,-30
75063275845,75063275849,4,2921,1502,-30
75067025952,75067025957,5,1685,1156,-30
75067611800,75067611805,5,2054,1214,-30
75069295011,75069295012,1,1843,1561,-30
75070026957,75070026961,4,1783,1359,-30
75072406855,75072406856,1,1119,1094,-30
75073358913,75073358918,5,2085,1753,-30
75074801765,75074801771,6,1662,741,-30
75081249421,75081249426,5,2072,1379,-30
75081569610,75081569614,4,2672,1416,-30
75082491005,75082491009,4,1997,1300,-30
75083971816,75083971821,5,3592,1913,-30
75086423718,75086423723,5,2151,1323,-30
75087327858,75087327859,1,1466,1046,-30
75089278167,75089278171,4,2673,1728,-30
75091009866,75091009871,5,1687,1226,-30
75092808890,75092808889,-1,745,1866,-30
75096907381,75096907386,5,3379,1728,-30
75097121126,75097121130,4,2245,1152,-30
75101194628,75101194633,5,2551,1571,-30
75101948050,75101948046,-4,1072,2636,-30
75108912033,75108912038,5,2250,1083,-30
75114127910,75114127892,-18,2009,1769,-30
75116665300,75116665306,6,2951,1600,-30
75118527753,75118527760,7,3148,1622,-30
75119423053,75119423058,5,2901,1348,-30
75119698659,75119698652,-7,876,205,-30
75121714640,75121714645,5,3121,1707,-30
75122744525,75122744530,5,4567,3038,-30
75125723553,75125723550,-3,700,1210,-30
75129352473,75129352474,1,1731,1734,-30
75130752377,75130752382,5,1835,896,-30
75131381330,75131381334,4,2778,1200,-30
75131563222,75131563226,4,2444,1154,-30
75135031239,75135031239,0,3005,3618,-30
75141190662,75141190663,1,1313,890,-30
75147439285,75147439290,5,2696,917,-30
75149658436,75149658434,-2,1572,2238,-30
75151760622,75151760622,0,1325,1113,-30
75152158655,75152158659,4,2684,1705,-30
75154361629,75154361635,6,2370,1676,-30
75154822550,75154822555,5,2365,1018,-30
75155689803,75155689808,5,2343,1857,-30
75162324097,75162324102,5,2325,1611,-30
75163875000,75163875011,11,911,433,-30
75166270989,75166270993,4,1359,1126,-30
75167345206,75167345210,4,1628,1088,-30
75174025953,75174025957,4,2364,1690,-30
75174702616,75174702622,6,2296,966,-30
75174989717,75174989722,5,1765,1122,-30
75176061365,75176061371,6,3194,1588,-30
75182731377,75182731374,-3,1528,3171,-30
75184427380,75184427383,3,1836,1572,-30
75187529883,75187529888,5,2513,1571,-30
75187795868,75187795880,12,2618,1232,-30
75189090758,75189090764,6,2078,1259,-30
75189854598,75189854605,7,5233,1032,-30
75192679720,75192679726,6,2186,1259,-30
75192877390,75192877409,19,675,121,-30
75194659858,75194659863,5,2242,1204,-30
75201758146,75201758152,6,1695,1300,-30
75201936942,75201936928,-14,1224,273,-30
75202692023,75202692003,-20,843,498,-30
75202988394,75202988398,4,2072,1321,-30
75203311574,75203311581,7,1895,1264,-30
75204999738,75204999742,4,1924,1079,-30
75205421799,75205421778,-21,1843,1595,-30
75216061458,75216061466,8,1542,911,-30
75217251757,75217251763,6,2252,794,-30
75217957818,75217957821,3,1526,1107,-30
75220361182,75220361187,5,3095,1649,-30
75222901757,75222901763,6,2689,947,-30
75226227406,75226227411,5,2693,1075,-30
75226806022,75226806028,6,1718,1153,-30
75231023501,75231023497,-4,929,2528,-30
75233855859,75233855852,-7,975,3779,-30
75235035510,75235035511,1,1810,1066,-30
75236009626,75236009633,7,1628,1108,-30
75236817638,75236817643,5,1538,1213,-30
75244219023,75244219026,3,2277,1450,-30
75246355218,75246355223,5,2096,1422,-30
75247039799,75247039805,6,2583,1760,-30
75251336791,75251336795,4,2099,976,-30
75256192482,75256192488,6,2602,1717,-30
75259981827,75259981833,6,3140,1865,-30
75265659867,75265659872,5,2325,1630,-30
75267687193,75267687197,4,2165,1570,-30
75270049796,75270049799,3,2114,1112,-30
75272103478,75272103481,3,2105,1401,-30
75273600767,75273600773,6,1849,1385,-30
75274808050,75274808054,4,2790,1174,-30
75276337517,75276337522,5,2465,1305,-30
75280612050,75280612056,6,2667,1779,-30
75281474070,75281474073,3,2611,1216,-30
75282151221,75282151225,4,941,683,-30
75284903426,75284903431,5,2247,837,-30
75287058292,75287058297,5,2814,1223,-30
75288628538,75288628544,6,2301,1237,-30
75289167889,75289167894,5,2073,1388,-30
75289456125,75289456129,4,2102,1484,-30
75291552456,75291552461,5,2041,1435,-30
75295878602,75295878606,4,2105,1218,-30
75296014719,75296014705,-14,3333,968,-30
75296054027,75296054033,6,2821,1351,-30
75297606405,75297606399,-6,1297,4700,-30
75298590254,75298590260,6,2279,1147,-30
75299848334,75299848330,-4,1655,4659,-30
75302516131,75302516134,3,1553,1189,-30
75304302884,75304302888,4,2338,1250,-30
75304545106,75304545110,4,1890,1356,-30
75304968650,75304968655,5,2690,1448,-30
75305839549,75305839553,4,2186,1904,-30
75305991805,75305991786,-19,1734,1090,-30
75306541306,75306541306,0,754,2198,-30
75307595517,75307595522,5,2742,1900,-30
75312252279,75312252287,8,2051,1111,-30
75313931107,75313931113,6,2110,1236,-30
75314094858,75314094867,9,2166,998,-30
75314933664,75314933661,-3,966,1690,-30
75316398553,75316398558,5,3103,1323,-30
75317595747,75317595752,5,1453,1196,-30
75321440937,75321440942,5,2308,1202,-30
75323994475,75323994479,4,1702,1060,-30
75324315230,75324315234,4,374,241,-30
75324803658,75324803661,3,1547,1574,-30
75324946498,75324946499,1,1010,1531,-30
75325230390,75325230390,0,1683,2109,-30
75332128734,75332128741,7,3109,1658,-30
75335557696,75335557702,6,2068,1461,-30
75337234845,75337234851,6,2939,1641,-30
75339368597,75339368603,6,2096,1250,-30
75345845569,75345845575,6,2007,938,-30
75347224090,75347224093,3,2215,1394,-30
75352565967,75352565972,5,2610,1549,-30
75355621702,75355621706,4,2152,1053,-30
75355662251,75355662257,6,2574,1283,-30
75362561745,75362561749,4,1744,981,-30
75362632686,75362632665,-21,524,137,-30
75363052836,75363052832,-4,32942,13172,-30
75370014528,75370014533,5,2566,1121,-30
75370323190,75370323194,4,2466,1870,-30
75374091273,75374091278,5,2397,1411,-30
75375462933,75375462938,5,2951,1161,-30
75375754817,75375754821,4,1624,1214,-30
75377095038,75377095041,3,2379,1705,-30
75377887700,75377887704,4,2719,1460,-30
75380344139,75380344142,3,2237,1136,-30
75386468530,75386468536,6,2691,1949,-30
75387229662,75387229668,6,2303,1143,-30
75387969236,75387969240,4,2155,1688,-30
75390397245,75390397249,4,2394,1472,-30
75394854973,75394854978,5,2038,1481,-30
75395862453,75395862459,6,3567,2229,-30
75397201889,75397201883,-6,1680,4791,-30
75403961098,75403961098,0,943,1473,-30
75406706866,75406706871,5,1488,982,-30
75416929768,75416929774,6,3045,1446,-30
75420027527,75420027534,7,1655,1106,-30
75421626486,75421626480,-6,507,1041,-30
75424727893,75424727899,6,2041,1342,-30
75425172190,75425172195,5,701,697,-30
75426509134,75426509139,5,3083,1577,-30
75427778749,75427778754,5,2532,1142,-30
75429027921,75429027928,7,3085,1363,-30
75430103445,75430103450,5,2226,1435,-30
75430710697,75430710703,6,2495,1217,-30
75431299559,75431299540,-19,482,244,-30
75432578582,75432578588,6,2846,1202,-30
75441537797,75441537802,5,2430,1773,-30
75444583081,75444583086,5,2702,1107,-30
75445178603,75445178609,6,1867,1071,-30
75447923469,75447923473,4,1727,1162,-30
75450795801,75450795807,6,3663,1623,-30
75458993861,75458993867,6,1621,1675,-30
75462763019,75462763022,3,2162,1721,-30
75462996567,75462996571,4,1757,1183,-30
75466817526,75466817530,4,1305,962,-30
75467168033,75467168039,6,2926,1600,-30
75468194774,75468194779,5,1852,740,-30
75468473213,75468473219,6,2455,1588,-30
75469189913,75469189920,7,2130,1196,-30
75469512341,75469512343,2,1755,1318,-30
75470867062,75470867068,6,2387,1027,-30
75474365309,75474365315,6,3047,1362,-30
75476376583,75476376563,-20,23388,30176,-30
75478553957,75478553965,8,1751,1043,-30
75480708623,75480708627,4,2070,1109,-30
75480845757,75480845738,-19,2035,998,-30
75483147554,75483147555,1,2087,2212,-30
75483176114,75483176120,6,1167,1196,-30
75483640474,75483640479,5,2589,1546,-30
75487177223,75487177226,3,1866,1172,-30
75488728171,75488728175,4,2062,1324,-30
75494367742,75494367746,4,2607,1214,-30
75494930165,75494930158,-7,2407,9660,-30
75496739255,75496739260,5,1968,1448,-30
75497036914,75497036917,3,1546,1503,-30
75499088402,75499088407,5,1748,1084,-30
75499429718,75499429722,4,2629,1505,-30
75505163423,75505163427,4,2258,1360,-30
75509785519,75509785523,4,1727,884,-30
75513352933,75513352937,4,1807,1295,-30
75513716381,75513716387,6,1255,690,-30
75515395258,75515395263,5,1500,1028,-30
75519935808,75519935814,6,1159,1165,-30
75523235925,75523235929,4,2259,1375,-30
75527471503,75527471508,5,2697,1545,-30
75528431928,75528431931,3,1781,877,-30
75529185129,75529185131,2,1327,836,-30
75535251496,75535251502,6,2603,1801,-30
75538246730,75538246732,2,944,1368,-30
75549288034,75549288035,1,2385,2102,-30
75557600046,75557600051,5,2210,1627,-30
75558046310,75558046314,4,1796,1346,-30
75560919918,75560919923,5,2721,1278,-30
75561561193,75561561180,-13,1683,1092,-30
75563600787,75563600791,4,2085,736,-30
75565315553,75565315553,0,4608,16461,-30
75565949578,75565949585,7,1988,1162,-30
75566441033,75566441031,-2,2329,3557,-30
75568901318,75568901323,5,2065,1300,-30
75569602318,75569602307,-11,955,910,-30
75572556085,75572556090,5,2384,1174,-30
75572798987,75572798991,4,3437,2349,-30
75574086167,75574086171,4,3526,1632,-30
75580715910,75580715914,4,2500,1232,-30
75584521958,75584521962,4,1461,938,-30
75584904292,75584904296,4,1907,1385,-30
75585706466,75585706472,6,2748,1820,-30
75586204593,75586204598,5,2357,1249,-30
75586735840,75586735843,3,4091,1795,-30
75589059526,75589059533,7,2125,1094,-30
75589157907,75589157912,5,1548,1314,-30
75590458558,75590458563,5,2395,1706,-30
75593257514,75593257521,7,2519,1603,-30
75593593352,75593593357,5,2210,1063,-30
75593659854,75593659859,5,711,121,-30
75597207309,75597207315,6,3438,1463,-30
75601596347,75601596351,4,1974,1322,-30
75603774216,75603774212,-4,29795,17100,-30
75605221477,75605221477,0,9315,11345,-30
75605962861,75605962865,4,2011,1323,-30
75606917548,75606917553,5,2276,1192,-30
75610434100,75610434103,3,2316,1474,-30
75610781789,75610781793,4,2856,1675,-30
75612264778,75612264773,-5,2003,6414,-30
75616687645,75616687650,5,2865,1038,-30
75617285934,75617285940,6,1362,1110,-30
75619496766,75619496770,4,2075,1166,-30
75620197943,75620197928,-15,1597,578,-30
75621656400,75621656403,3,2158,909,-30
75623772147,75623772153,6,2679,1408,-30
75626520826,75626520831,5,2580,1082,-30
75627561184,75627561188,4,2406,1806,-30
75631710489,75631710493,4,2399,1096,-30
75632778422,75632778428,6,2506,1602,-30
75635207178,75635207183,5,1933,1101,-30
75636305794,75636305798,4,2313,1593,-30
75638078320,75638078323,3,2511,1454,-30
75642845670,75642845674,4,2134,1140,-30
75647151870,75647151876,6,1882,1165,-30
75647743802,75647743786,-16,1862,964,-30
75648110969,75648110970,1,1608,1396,-30
75650083269,75650083274,5,2151,846,-30
75650327322,75650327329,7,3665,1871,-30
75651382486,75651382491,5,2783,1087,-30
75656849854,75656849861,7,2231,1666,-30
75658075888,75658075886,-2,1517,2894,-30
75661238893,75661238894,1,2490,1330,-30
75663295597,75663295602,5,1731,1173,-30
75665589297,75665589303,6,2114,919,-30
75666110475,75666110480,5,2000,1688,-30
75667351420,75667351425,5,2473,1732,-30
75671153265,75671153269,4,2081,1463,-30
75674139981,75674139987,6,1897,868,-30
75678920609,75678920615,6,1797,1100,-30
75679305433,75679305438,5,1927,1331,-30
75684454462,75684454448,-14,182,281,-30
75685712865,75685712871,6,2205,1006,-30
75687747232,75687747237,5,2306,1517,-30
75687941756,75687941761,5,1940,1263,-30
75690661772,75690661776,4,2290,1550,-30
75692113398,75692113404,6,1890,1263,-30
75699733434,75699733429,-5,19433,69827,-30
75700450208,75700450214,6,2737,1982,-30
75701441414,75701441421,7,1896,1332,-30
75703203802,75703203807,5,2248,1388,-30
75711733594,75711733599,5,3698,1987,-30
75713478936,75713478941,5,1681,1028,-30
75714705359,75714705364,5,1541,1184,-30
75718359378,75718359383,5,1384,660,-30
75719721528,75719721531,3,1597,972,-30
75721678737,75721678741,4,1160,769,-30
75725575285,75725575291,6,1607,879,-30
75725626051,75725626048,-3,653,291,-30
75726761614,75726761620,6,1843,1452,-30
75727356489,75727356494,5,2366,1469,-30
75728447672,75728447678,6,2224,1370,-30
75732498312,75732498314,2,2145,1465,-30
75733927259,75733927263,4,3047,2137,-30
75738700785,75738700790,5,1954,1102,-30
75741347661,75741347666,5,2581,1722,-30
75742797324,75742797328,4,1998,1282,-30
75742955570,75742955574,4,1602,1374,-30
75743953609,75743953613,4,2347,1042,-30
75745825020,75745825027,7,1934,1196,-30
75746043821,75746043827,6,24758,23158,-30
75748387345,75748387347,2,1557,993,-30
75749068024,75749068028,4,2035,1221,-30
75750292109,75750292118,9,3021,2136,-30
75752465015,75752465018,3,1897,1177,-30
75761679513,75761679519,6,2217,1170,-30
75762540456,75762540463,7,2689,1028,-30
75763195233,75763195251,18,1117,282,-30
75764633803,75764633806,3,2356,1338,-30
75765025382,75765025386,4,2159,1541,-30
75768565897,75768565902,5,2928,1258,-30
75771850555,75771850562,7,2827,1264,-30
75772484707,75772484710,3,2339,1057,-30
75773083009,75773083013,4,2309,1951,-30
75773392638,75773392642,4,2527,2149,-30
75774650144,75774650150,6,2393,1887,-30
75778851786,75778851790,4,2206,1204,-30
75779041353,75779041357,4,3146,1563,-30
75781124601,75781124606,5,1604,818,-30
75781819926,75781819907,-19,2056,1157,-30
75784410634,75784410639,5,1727,1083,-30
75786793822,75786793827,5,1529,1027,-30
75786955627,75786955639,12,28778,3605,-30
75787072777,75787072769,-8,1996,1268,-30
75796229910,75796229915,5,1775,1491,-30
75800088019,75800088025,6,2558,1423,-30
75800943942,75800943947,5,2870,1412,-30
75801309378,75801309392,14,2473,1212,-30
75801413498,75801413481,-17,1726,1229,-30
75801493191,75801493195,4,1612,1373,-30
75802006846,75802006848,2,1692,1306,-30
75802979273,75802979280,7,2312,1353,-30
75806257534,75806257541,7,2088,1005,-30
75808105485,75808105488,3,2487,1515,-30
75808558613,75808558615,2,1550,1019,-30
75815657506,75815657510,4,2642,1779,-30
75815876604,75815876610,6,2412,1092,-30
75816197444,75816197449,5,2616,1272,-30
75819638069,75819638073,4,2279,1909,-30
75820789694,75820789697,3,3093,2229,-30
75823537517,75823537524,7,1367,824,-30
75823815355,75823815348,-7,2082,9879,-30
75824736103,75824736106,3,1418,1060,-30
75825065919,75825065925,6,2218,1412,-30
75827099546,75827099550,4,1677,1249,-30
75828753697,75828753701,4,3032,1594,-30
75829114812,75829114817,5,2734,1171,-30
75832425858,75832425858,0,706,1645,-30
75833591240,75833591245,5,3096,1873,-30
75834974679,75834974686,7,1625,1378,-30
75839193429,75839193433,4,2052,1310,-30
75843069974,75843069978,4,1960,1105,-30
75843372893,75843372898,5,2253,1644,-30
75843498429,75843498435,6,1449,1074,-30
75843711338,75843711343,5,2532,1598,-30
75843934823,75843934823,0,1407,1553,-30
75847894470,75847894474,4,1680,1446,-30
75848632682,75848632700,18,1284,6924,-30
75853164078,75853164077,-1,893,397,-30
75861289849,75861289830,-19,1700,1030,-30
75862136286,75862136291,5,2058,954,-30
75863173093,75863173098,5,1863,1086,-30
75864307964,75864307969,5,2832,1346,-30
75866862586,75866862593,7,2900,1517,-30
75867855489,75867855495,6,3109,1581,-30
75868336987,75868336992,5,2410,1686,-30
75868837158,75868837161,3,2117,1178,-30
75874399869,75874399874,5,2439,908,-30
75875871227,75875871228,1,1990,1446,-30
75877293530,75877293535,5,2197,1098,-30
75879170906,75879170912,6,2711,925,-30
75881084990,75881084995,5,2595,911,-30
75881428365,75881428370,5,2230,1108,-30
75883612370,75883612375,5,2466,1835,-30
75884088073,75884088079,6,3148,887,-30
75884322035,75884322035,0,2048,1799,-30
75890071049,75890071054,5,2886,1505,-30
75893423602,75893423607,5,1828,886,-30
75896031901,75896031906,5,2596,1094,-30
75911989614,75911989619,5,1847,1177,-30
75913367850,75913367853,3,2033,1133,-30
75919497532,75919497539,7,2775,1247,-30
75921962838,75921962845,7,3276,1561,-30
75922284722,75922284726,4,2729,1617,-30
75922899177,75922899182,5,2478,2027,-30
75925171149,75925171154,5,2662,1664,-30
75927066589,75927066593,4,1924,1368,-30
75928898350,75928898345,-5,1081,2430,-30
75932374703,75932374707,4,2548,1509,-30
75933321666,75933321671,5,2297,1113,-30
75934289161,75934289176,15,28,2243,-30
75935182988,75935182991,3,1896,1419,-30
75936479828,75936479836,8,9388,2375,-30
75936968513,75936968519,6,2210,1125,-30
75937292152,75937292155,3,2011,1971,-30
75938078723,75938078729,6,2123,1379,-30
75940823470,75940823477,7,3199,1638,-30
75945436737,75945436742,5,2106,1292,-30
75946588407,75946588414,7,2096,1123,-30
75947806271,75947806277,6,1811,1092,-30
75948408454,75948408460,6,2124,1516,-30
75950501737,75950501742,5,2210,1148,-30
75954461226,75954461231,5,1527,1133,-30
75955949826,75955949831,5,1939,987,-30
75956432421,75956432427,6,3255,1764,-30
75959833318,75959833321,3,2017,1265,-30
75960358885,75960358896,11,1627,1077,-30
75960768949,75960768955,6,2521,1160,-30
75963377301,75963377299,-2,1661,3074,-30
75963990375,75963990378,3,1951,1067,-30
75965854665,75965854670,5,2416,1136,-30
75965885662,75965885669,7,1445,907,-30
75967425499,75967425505,6,2367,1549,-30
75969983488,75969983495,7,2327,1427,-30
75970042900,75970042909,9,2001,1226,-30
75972635250,75972635254,4,2388,1356,-30
75974212481,75974212486,5,3944,1447,-30
75974999378,75974999383,5,2779,1446,-30
75975190154,75975190160,6,1996,1279,-30
75976594446,75976594451,5,2546,1217,-30
75977107039,75977107042,3,1976,1525,-30
75978327613,75978327617,4,2464,1676,-30
75981050557,75981050562,5,2056,1206,-30
75984776945,75984776951,6,2057,1022,-30
75984808274,75984808279,5,1239,1089,-30
75984989059,75984989068,9,729,272,-30
75988586930,75988586935,5,1750,1174,-30
75989704393,75989704397,4,3239,1523,-30
75990179294,75990179295,1,2678,2383,-30
75993276131,75993276137,6,2687,1425,-30
75993944339,75993944344,5,1457,1029,-30
75994188694,75994188697,3,2002,1308,-30
75996600878,75996600881,3,1462,984,-30
75996730323,75996730330,7,1118,606,-30
76002958813,76002958814,1,955,1618,-30
76003755956,76003755961,5,2196,1742,-30
76007380122,76007380128,6,2895,1418,-30
76009452259,76009452263,4,2760,1334,-30
76010282758,76010282754,-4,1262,3213,-30
76010976493,76010976497,4,1837,1248,-30
76012011460,76012011465,5,2806,1948,-30
76013104174,76013104177,3,1970,1520,-30
76013980739,76013980729,-10,732,346,-30
76014249784,76014249783,-1,18946,8291,-30
76015962197,76015962203,6,1663,807,-30
76018540946,76018540954,8,3975,1009,-30
76018862596,76018862605,9,712,394,-30
76020262725,76020262727,2,2011,1663,-30
76029684397,76029684402,5,3106,1838,-30
76030677066,76030677068,2,2594,1472,-30
76035317745,76035317751,6,1658,1236,-30
76036987606,76036987610,4,2041,1547,-30
76037258653,76037258657,4,1538,1305,-30
76042796917,76042796919,2,1907,695,-30
76047797351,76047797355,4,1275,832,-30
76052057429,76052057433,4,2297,1142,-30
76053882626,76053882633,7,1876,1403,-30
76055007834,76055007839,5,2316,1285,-30
76057073855,76057073861,6,2855,1268,-30
76059805681,76059805686,5,2545,1307,-30
76061305986,76061305989,3,2900,1773,-30
76063249431,76063249437,6,2077,1676,-30
76065047690,76065047695,5,2994,1866,-30
76067178809,76067178814,5,2675,1992,-30
76067659414,76067659421,7,1993,1424,-30
76071093420,76071093426,6,1845,1088,-30
76071401961,76071401946,-15,1073,523,-30
76072725214,76072725219,5,2538,1097,-30
76072768395,76072768400,5,1435,1173,-30
76082706651,76082706657,6,1874,1452,-30
76082861882,76082861865,-17,2534,1269,-30
76088872343,76088872338,-5,5261,15805,-30
76092749550,76092749549,-1,1408,1858,-30
76097496597,76097496603,6,2027,1015,-30
76099497103,76099497109,6,1416,799,-30
76103373238,76103373243,5,2669,1045,-30
76106211759,76106211765,6,1332,783,-30
76107297553,76107297550,-3,1514,1515,-30
76113327070,76113327059,-11,1071,8683,-30
76113886939,76113886945,6,2006,1380,-30
76118100423,76118100428,5,2227,1673,-30
76118876615,76118876622,7,2056,985,-30
76120335534,76120335535,1,1339,1627,-30
76120972374,76120972378,4,2567,1434,-30
76121285918,76121285923,5,1551,1029,-30
76122166279,76122166283,4,3034,1374,-30
76122214306,76122214310,4,2193,1301,-30
76122964478,76122964482,4,2349,997,-30
76123667545,76123667564,19,3066,1471,-30
76124827587,76124827593,6,2479,1686,-30
76125111359,76125111362,3,2637,1269,-30
76131992178,76131992169,-9,823,1389,-30
76133488091,76133488098,7,2179,936,-30
76134054498,76134054503,5,1796,1093,-30
76135008134,76135008121,-13,234,2076,-30
76135200425,76135200430,5,1758,1553,-30
76136560334,76136560337,3,1831,703,-30
76138272158,76138272159,1,1112,1185,-30
76139174513,76139174518,5,2416,983,-30
76140006270,76140006278,8,2680,1224,-30
76143853400,76143853385,-15,1659,1016,-30
76144690903,76144690907,4,2120,960,-30
76145425888,76145425894,6,1218,877,-30
76153932906,76153932901,-5,2429,7036,-30
76155116349,76155116353,4,2664,1883,-30
76156918927,76156918925,-2,1264,2701,-30
76158459701,76158459706,5,2220,1062,-30
76163664519,76163664518,-1,1832,1156,-30
76166353633,76166353636,3,2677,1765,-30
76172493186,76172493190,4,1643,1340,-30
76177129930,76177129935,5,1994,971,-30
76180745105,76180745109,4,1504,1045,-30
76188196866,76188196870,4,994,586,-30
76188427647,76188427628,-19,1296,539,-30
76189556294,76189556303,9,2123,1034,-30
76189810123,76189810129,6,2801,1843,-30
76196297625,76196297630,5,1863,1255,-30
76204626780,76204626785,5,2346,1368,-30
76204904474,76204904477,3,1796,1081,-30
76206354677,76206354683,6,2357,1602,-30
76209029728,76209029731,3,1458,801,-30
76209055119,76209055098,-21,1701,927,-30
76210940699,76210940705,6,2587,1634,-30
76211314738,76211314734,-4,24281,12392,-30
76212239089,76212239094,5,1576,1444,-30
76212554343,76212554328,-15,1663,668,-30
76215276080,76215276085,5,2640,1460,-30
76215673970,76215673975,5,2470,1666,-30
76216874210,76216874213,3,1418,1620,-30
76217473310,76217473314,4,2146,1874,-30
76219575401,76219575409,8,4322,1320,-30
76221962034,76221962040,6,3215,1823,-30
76222042572,76222042577,5,1824,1444,-30
76223893574,76223893578,4,2210,1328,-30
76228305857,76228305863,6,2938,1226,-30
76228817976,76228817980,4,2908,1335,-30
76229809846,76229809850,4,2132,1472,-30
76231364918,76231364923,5,1636,1253,-30
76231549618,76231549622,4,2327,1284,-30
76235881893,76235881898,5,3065,1090,-30
76240394032,76240394037,5,2507,1619,-30
76248208720,76248208725,5,2515,1078,-30
76248280753,76248280758,5,1384,1451,-30
76248926679,76248926666,-13,598,650,-30
76250770993,76250770998,5,5275,3298,-30
76261680209,76261680213,4,1430,1260,-30
76262610849,76262610854,5,2008,1353,-30
76263501044,76263501049,5,2250,1253,-30
76265717527,76265717530,3,2438,1585,-30
76266470491,76266470495,4,2224,929,-30
76269879506,76269879512,6,2922,1699,-30
76271142082,76271142083,1,1714,1395,-30
76277850525,76277850530,5,1635,1222,-30
76280926462,76280926467,5,2668,1502,-30
76282562642,76282562646,4,1589,1316,-30
76285295123,76285295128,5,2861,1259,-30
76285874307,76285874312,5,2157,1589,-30
76285933091,76285933097,6,2610,1699,-30
76286027054,76286027060,6,1668,1046,-30
76287510374,76287510377,3,1619,1435,-30
76287736945,76287736950,5,2292,1001,-30
76288711352,76288711354,2,2995,2875,-30
76290062145,76290062150,5,3884,1684,-30
76290590874,76290590880,6,3010,1824,-30
76291831889,76291831893,4,2952,1573,-30
76292887710,76292887718,8,2511,1162,-30
76294206745,76294206750,5,2552,1428,-30
76295171346,76295171350,4,1700,1128,-30
76298802613,76298802617,4,2569,952,-30
76302856526,76302856530,4,1537,1197,-30
76304896402,76304896406,4,2472,906,-30
76311763104,76311763110,6,2343,1534,-30
76312972723,76312972729,6,1942,1139,-30
76316649137,76316649143,6,1648,980,-30
76320214095,76320214101,6,2481,1559,-30
76320834357,76320834369,12,669,16044,-30
76321375618,76321375626,8,16198,23175,-30
76324695240,76324695242,2,1908,1284,-30
76327514261,76327514265,4,1977,1007,-30
76331410672,76331410677,5,3355,1683,-30
76334432865,76334432869,4,2364,1508,-30
76334501352,76334501354,2,1735,1130,-30
76335544485,76335544492,7,2387,1085,-30
76335664529,76335664514,-15,1282,342,-30
76335827351,76335827358,7,2253,1032,-30
76340565201,76340565203,2,1363,1147,-30
76341806520,76341806526,6,2521,1270,-30
76343097392,76343097395,3,1725,1604,-30
76343172534,76343172540,6,2217,1545,-30
76343460351,76343460356,5,2761,1601,-30
76346205097,76346205099,2,702,455,-30
76348178660,76348178666,6,1996,1443,-30
76348883264,76348883268,4,2636,1616,-30
76350352452,76350352457,5,2432,1202,-30
76352469202,76352469207,5,2884,1276,-30
76354561230,76354561235,5,3310,1752,-30
76355766601,76355766606,5,2031,1233,-30
76358514917,76358514921,4,3271,1444,-30
76359200655,76359200660,5,2690,1127,-30
76359546078,76359546081,3,1785,1052,-30
76363711393,76363711399,6,2353,1377,-30
76364679022,76364679026,4,2425,1086,-30
76366109717,76366109722,5,2987,1421,-30
76366282758,76366282739,-19,939,210,-30
76367826599,76367826603,4,2795,1144,-30
76369568338,76369568344,6,2100,975,-30
76370401599,76370401603,4,712,193,-30
76370794235,76370794240,5,2712,1632,-30
76371425057,76371425062,5,1540,1262,-30
76375691801,76375691807,6,1906,1287,-30
76375802406,76375802418,12,1701,1050,-30
76376228200,76376228206,6,1996,1153,-30
76377823376,76377823382,6,2242,1281,-30
76379086657,76379086661,4,1928,1271,-30
76382945650,76382945656,6,2215,1144,-30
76384912191,76384912197,6,2171,1737,-30
76387140506,76387140511,5,2516,1004,-30
76388237583,76388237588,5,1955,1459,-30
76389046394,76389046398,4,1697,647,-30
76390259607,76390259614,7,2994,1786,-30
76391097182,76391097187,5,1977,1070,-30
76391269523,76391269526,3,1565,1189,-30
76392441550,76392441554,4,2046,1238,-30
76394845609,76394845610,1,2053,1386,-30
76395070529,76395070514,-15,1542,487,-30
76398282235,76398282239,4,1853,1376,-30
76399589657,76399589662,5,2502,1594,-30
76401122891,76401122896,5,2348,721,-30
76402006094,76402006099,5,2975,1789,-30
76403564312,76403564317,5,2606,1544,-30
76404063143,76404063146,3,2630,1816,-30
76405002653,76405002657,4,2280,1381,-30
76408951406,76408951411,5,1771,1381,-30
76409050362,76409050369,7,2702,1474,-30
76416082994,76416083000,6,2229,943,-30
76416141457,76416141461,4,2256,721,-30
76417142949,76417142954,5,1699,1418,-30
76417260786,76417260770,-16,1660,889,-30
76420242343,76420242321,-22,1110,360,-30
76422534869,76422534874,5,2286,1525,-30
76426627580,76426627583,3,1297,916,-30
76427002868,76427002873,5,2961,1501,-30
76432288271,76432288273,2,3629,2911,-30
76436417972,76436417977,5,3322,1819,-30
76437002907,76437002910,3,2777,1655,-30
76437698266,76437698272,6,2257,1316,-30
76454319735,76454319741,6,3394,1657,-30
76456656199,76456656202,3,2322,1476,-30
76456813569,76456813574,5,2120,1679,-30
76457382810,76457382816,6,2378,1505,-30
76458020067,76458020071,4,184,922,-30
76460972186,76460972191,5,3822,1610,-30
76463229521,76463229526,5,2386,1189,-30
76464527948,76464527953,5,2223,1612,-30
76465517240,76465517245,5,3722,1621,-30
76468506978,76468506982,4,2650,1682,-30
76470406153,76470406158,5,1924,1347,-30
76474119110,76474119114,4,1780,887,-30
76477859690,76477859686,-4,991,2979,-30
76478789575,76478789582,7,994,516,-30
76479475945,76479475946,1,1564,1415,-30
76479982342,76479982343,1,2142,1221,-30
76482214151,76482214155,4,1226,940,-30
76483012831,76483012826,-5,792,436,-30
76484036727,76484036730,3,1584,1242,-30
76484113796,76484113801,5,2168,1200,-30
76486676150,76486676155,5,3101,1105,-30
76489724907,76489724884,-23,2260,657,-30
76491148794,76491148792,-2,1220,3172,-30
76495626496,76495626500,4,2573,1764,-30
76498279466,76498279470,4,2532,1401,-30
76500561824,76500561835,11,11203,32538,-30
76500905736,76500905739,3,1968,1254,-30
76501009541,76501009543,2,1979,1727,-30
76501093957,76501093963,6,2931,1492,-30
76502289766,76502289771,5,2169,1392,-30
76502607654,76502607661,7,2113,909,-30
76503473453,76503473457,4,2050,1663,-30
76504786944,76504786949,5,3522,1244,-30
76504973805,76504973810,5,2277,927,-30
76505346147,76505346151,4,2605,1327,-30
76506856618,76506856625,7,2181,1125,-30
76507454066,76507454071,5,2316,1080,-30
76511171014,76511171018,4,1466,1274,-30
76512336999,76512337002,3,1522,1014,-30
76513217031,76513217027,-4,1427,3544,-30
76513389061,76513389068,7,2279,1499,-30
76517979952,76517979957,5,2155,1378,-30
76524991554,76524991558,4,2424,1818,-30
76528121759,76528121767,8,2185,1171,-30
76531611336,76531611341,5,2766,2001,-30
76532088474,76532088477,3,2080,1218,-30
76538019438,76538019447,9,2631,1234,-30
76538187472,76538187466,-6,639,2269,-30
76540627115,76540627121,6,2684,1742,-30
76542863333,76542863337,4,2377,1623,-30
76543449615,76543449619,4,1523,1121,-30
76545271618,76545271622,4,1039,1171,-30
76547265393,76547265387,-6,987,3105,-30
76548106323,76548106318,-5,1103,2199,-30
76550619581,76550619587,6,3189,1481,-30
76550814403,76550814407,4,1191,802,-30
76551826830,76551826836,6,2107,1343,-30
76552954330,76552954334,4,2263,1478,-30
76553373877,76553373883,6,1612,1026,-30
76555622103,76555622107,4,1496,1000,-30
76556754987,76556754993,6,2632,1222,-30
76557558905,76557558923,18,1532,199,-30
76558286046,76558286051,5,2774,1396,-30
76559256810,76559256826,16,2023,1418,-30
76559354739,76559354721,-18,1644,936,-30
76560506234,76560506242,8,4390,1556,-30
76561882071,76561882075,4,1821,950,-30
76562123142,76562123155,13,2458,1423,-30
76562153338,76562153323,-15,852,596,-30
76563847775,76563847780,5,1947,1221,-30
76564833173,76564833175,2,1935,812,-30
76567950080,76567950085,5,2045,1457,-30
76570624858,76570624861,3,2004,1180,-30
76570785349,76570785354,5,2501,1313,-30
76570958878,76570958899,21,2623,1817,-30
76571457665,76571457659,-6,1015,3087,-30
76571639772,76571639777,5,2742,2048,-30
76578206272,76578206275,3,1402,870,-30
76579366936,76579366942,6,1999,1156,-30
76584754569,76584754569,0,2277,1579,-30
76592082599,76592082605,6,2725,1828,-30
76592189270,76592189271,1,1785,1545,-30
76593664041,76593664038,-3,850,823,-30
76603859785,76603859791,6,2408,1522,-30
76606181695,76606181698,3,2436,1548,-30
76610593670,76610593675,5,3443,1525,-30
76611143705,76611143711,6,2292,1266,-30
76617494503,76617494502,-1,2491,4015,-30
76623129434,76623129438,4,3103,1239,-30
76626736468,76626736473,5,1727,1249,-30
76631778229,76631778233,4,1724,1119,-30
76632490326,76632490331,5,1745,1431,-30
76634032726,76634032738,12,1541,1069,-30
76634976524,76634976528,4,2055,1296,-30
76635571057,76635571061,4,2374,1436,-30
76638380643,76638380649,6,2061,1429,-30
76639147106,76639147110,4,2189,1053,-30
76644437487,76644437481,-6,1092,4249,-30
76644701659,76644701665,6,2539,1268,-30
76646002253,76646002257,4,1272,1059,-30
76649924049,76649924053,4,1799,1105,-30
76650817776,76650817777,1,1153,1341,-30
76654071536,76654071543,7,2622,1559,-30
76654936116,76654936110,-6,140,3691,-30
76657806202,76657806211,9,24513,52056,-30
76660981738,76660981743,5,2186,1347,-30
76664742169,76664742174,5,2653,1074,-30
76666906901,76666906907,6,2714,1367,-30
76668700810,76668700815,5,1609,993,-30
76670292744,76670292750,6,2354,1538,-30
76670542286,76670542290,4,2100,1871,-30
76670918182,76670918187,5,2042,1131,-30
76673808726,76673808731,5,2456,1383,-30
76675674213,76675674217,4,3169,2033,-30
76676517943,76676517946,3,2335,1560,-30
76679569690,76679569694,4,2045,1299,-30
76681277879,76681277882,3,1930,1159,-30
76682619778,76682619774,-4,1048,2594,-30
76684550458,76684550469,11,14538,31906,-30
76684842469,76684842474,5,2378,1484,-30
76686484223,76686484227,4,1633,815,-30
76686757877,76686757881,4,2282,1268,-30
76689846235,76689846244,9,2592,1426,-30
76694677126,76694677132,6,2485,960,-30
76699900269,76699900275,6,2448,1472,-30
76701992070,76701992075,5,1830,1026,-30
76702169945,76702169949,4,1328,1289,-30
76706004840,76706004845,5,2502,1241,-30
76707221943,76707221955,12,1653,1491,-30
76707453987,76707453994,7,2139,1015,-30
76713065416,76713065419,3,1780,1229,-30
76715399245,76715399251,6,2497,1379,-30
76716261745,76716261750,5,2249,1433,-30
76717663793,76717663798,5,1526,1140,-30
76722171273,76722171277,4,1731,1314,-30
76724719303,76724719307,4,1896,1444,-30
76729043397,76729043402,5,2590,1223,-30
76730848931,76730848935,4,2445,1562,-30
76733719217,76733719210,-7,1916,7079,-30
76734200318,76734200313,-5,754,2122,-30
76736683536,76736683534,-2,1670,2482,-30
76738728102,76738728107,5,1053,1118,-30
76744081406,76744081414,8,2626,1136,-30
76744254714,76744254719,5,2544,1349,-30
76744948577,76744948581,4,1652,1078,-30
76745081123,76745081131,8,1625,1044,-30
76745940535,76745940539,4,2028,1215,-30
76746433018,76746433023,5,2507,1056,-30
76749763917,76749763899,-18,29117,27285,-30
76752800986,76752800989,3,1694,1728,-30
76760217793,76760217797,4,2243,1080,-30
76763432877,76763432883,6,2451,1207,-30
76765183514,76765183519,5,894,1050,-30
76767600414,76767600420,6,3113,1537,-30
76770575294,76770575298,4,2338,1185,-30
76770981270,76770981275,5,1876,989,-30
76775313078,76775313082,4,2403,1263,-30
76775948062,76775948066,4,2525,1521,-30
76777783595,76777783590,-5,1498,4590,-30
76784065051,76784065055,4,2574,1466,-30
76784358810,76784358815,5,2995,2037,-30
76787065366,76787065374,8,2997,1855,-30
76787803654,76787803659,5,2451,1245,-30
76791143810,76791143815,5,2284,1195,-30
76795792397,76795792403,6,2089,865,-30
76799195075,76799195080,5,1947,1696,-30
76804286377,76804286381,4,1896,1356,-30
76806917134,76806917138,4,1684,1218,-30
76808066656,76808066661,5,2423,1366,-30
76808452006,76808452009,3,2148,1373,-30
76808893542,76808893547,5,3574,1676,-30
76811189952,76811189959,7,1741,1204,-30
76817525277,76817525282,5,2705,1092,-30
76818634706,76818634709,3,1098,1261,-30
76822572733,76822572739,6,2401,1330,-30
76825640009,76825640015,6,1595,1396,-30
76826240047,76826240051,4,1708,1238,-30
76826322096,76826322102,6,2384,1358,-30
76826448394,76826448398,4,1668,1296,-30
76827838273,76827838281,8,2495,1651,-30
76828364996,76828364999,3,1963,955,-30
76831457546,76831457540,-6,1612,7341,-30
76833918878,76833918883,5,2114,1441,-30
76834382336,76834382341,5,1344,1086,-30
76835260665,76835260669,4,2103,1490,-30
76836382185,76836382189,4,1255,672,-30
76837381165,76837381170,5,1549,1151,-30
76838065220,76838065242,22,1513,1175,-30
76844820020,76844820026,6,3433,1690,-30
76845818271,76845818275,4,1760,1170,-30
76846788844,76846788848,4,2582,1569,-30
76846845822,76846845804,-18,2116,786,-30
76849338461,76849338466,5,2109,1247,-30
76849453374,76849453378,4,2789,1462,-30
76856525302,76856525306,4,2134,1162,-30
76856944259,76856944266,7,3601,1688,-30
76860153222,76860153227,5,2067,744,-30
76861336141,76861336147,6,3217,1296,-30
76862241034,76862241028,-6,1001,2975,-30
76862364275,76862364278,3,3588,3362,-30
76866580251,76866580256,5,2385,1189,-30
76868854563,76868854570,7,2215,1332,-30
76869681346,76869681353,7,3166,1584,-30
76874812458,76874812466,8,2433,1128,-30
76878203330,76878203337,7,2058,1737,-30
76879484809,76879484814,5,2955,1553,-30
76881931750,76881931755,5,2319,1153,-30
76881960882,76881960864,-18,1223,712,-30
76882461462,76882461469,7,1494,811,-30
76882798618,76882798622,4,1999,1320,-30
76882978509,76882978514,5,2189,1288,-30
76883445643,76883445624,-19,1024,458,-30
76887905027,76887905031,4,1666,1299,-30
76889154660,76889154651,-9,16623,40051,-30
76890921154,76890921160,6,1612,1056,-30
76891195908,76891195913,5,1207,903,-30
76891414596,76891414578,-18,2400,1339,-30
76893943742,76893943747,5,2315,1205,-30
76894169228,76894169233,5,2229,1706,-30
76900211105,76900211111,6,3354,1384,-30
76901393270,76901393274,4,2010,1433,-30
76902432630,76902432637,7,3339,1294,-30
76903469185,76903469190,5,2642,1294,-30
76903585919,76903585900,-19,1748,1253,-30
76906791038,76906791042,4,1661,1741,-30
76907470875,76907470879,4,2592,1830,-30
76908600583,76908600589,6,3868,1785,-30
76908773079,76908773086,7,1447,1167,-30
76911659882,76911659889,7,6221,1936,-30
76913169028,76913169033,5,1785,1272,-30
76913686934,76913686942,8,2397,851,-30
76915884387,76915884394,7,2379,1235,-30
76916167361,76916167363,2,1404,1140,-30
76917074969,76917074974,5,2247,1401,-30
76919677386,76919677391,5,2481,1663,-30
76919760145,76919760150,5,1979,1869,-30
76920667434,76920667412,-22,2408,1371,-30
76922344578,76922344580,2,1649,1218,-30
76922853004,76922853010,6,925,543,-30
76924514790,76924514795,5,1834,1209,-30
76926243904,76926243899,-5,1447,4365,-30
76927155907,76927155907,0,1413,1498,-30
76927237434,76927237439,5,2840,1613,-30
76929206820,76929206826,6,1377,1252,-30
76930112264,76930112270,6,2979,1137,-30
76931171400,76931171402,2,2628,1669,-30
76933682903,76933682911,8,1948,1293,-30
76935402730,76935402725,-5,2352,6446,-30
76938429501,76938429505,4,2008,1278,-30
76942000492,76942000498,6,3524,1264,-30
76942796350,76942796355,5,2324,1031,-30
76950502226,76950502231,5,3276,1519,-30
76959620733,76959620739,6,2716,1024,-30
76964515229,76964515232,3,1887,1537,-30
76966720421,76966720427,6,1798,1054,-30
76966746293,76966746274,-19,1253,360,-30
76967090630,76967090636,6,2476,1301,-30
76968758236,76968758242,6,2483,1557,-30
76970552677,76970552682,5,2595,1505,-30
76971960822,76971960826,4,2686,1432,-30
76972853374,76972853379,5,1950,1045,-30
76973008872,76973008875,3,1247,1503,-30
76974393470,76974393475,5,2437,938,-30
76974758988,76974758993,5,44356,3155,-30
76977270750,76977270746,-4,23636,13690,-30
76977461867,76977461871,4,1521,1344,-30
76978900902,76978900910,8,3331,1241,-30
76980873727,76980873714,-13,1731,2996,-30
76981080604,76981080611,7,1800,1215,-30
76986144466,76986144470,4,2378,1293,-30
76987480026,76987480027,1,1579,2045,-30
76987626275,76987626280,5,1680,1449,-30
76991613494,76991613492,-2,2895,4425,-30
76996242193,76996242199,6,1466,810,-30
76998870793,76998870797,4,1661,1500,-30
76999829494,76999829500,6,2681,1283,-30
77011925491,77011925497,6,1946,1391,-30
77012171182,77012171187,5,1524,1403,-30
77012991087,77012991092,5,1965,1144,-30
77013977474,77013977478,4,2045,1098,-30
77014368705,77014368711,6,2365,1322,-30
77017705837,77017705842,5,2358,1109,-30
77018897951,77018897954,3,4428,3045,-30
77019232253,77019232259,6,2733,1287,-30
77020644736,77020644739,3,1905,1083,-30
77022970141,77022970146,5,1509,1246,-30
77023981342,77023981348,6,2651,1623,-30
77027900085,77027900090,5,1593,1553,-30
77034260378,77034260383,5,2643,1224,-30
77036694021,77036694023,2,2222,1632,-30
77038673468,77038673473,5,2093,1145,-30
77045208438,77045208443,5,1895,972,-30
77045778514,77045778518,4,1859,1616,-30
77052234494,77052234498,4,1280,950,-30
77053015826,77053015831,5,2424,1675,-30
77053279741,77053279747,6,2015,1188,-30
77054206782,77054206786,4,2336,1211,-30
77057322114,77057322120,6,2129,1377,-30
77057612789,77057612794,5,1720,1242,-30
77057812730,77057812735,5,2069,1223,-30
77064509384,77064509387,3,5001,18098,-30
77068386194,77068386199,5,1884,1112,-30
77069105438,77069105448,10,1978,1339,-30
77069204093,77069204112,19,2689,1306,-30
77070422323,77070422322,-1,1049,1012,-30
77070494970,77070494974,4,1232,991,-30
77071731569,77071731576,7,2845,1196,-30
77073448802,77073448785,-17,2177,1189,-30
77075119730,77075119736,6,2551,1345,-30
77075161809,77075161812,3,1342,1701,-30
77076233209,77076233215,6,2946,1168,-30
77078990679,77078990683,4,1617,1164,-30
77079970549,77079970554,5,2190,1111,-30
77080058078,77080058085,7,2297,1238,-30
77084172570,77084172575,5,2800,2171,-30
77085962506,77085962510,4,1051,812,-30
77086912546,77086912549,3,2153,1532,-30
77094506628,77094506632,4,2500,1751,-30
77096187391,77096187395,4,1319,911,-30
77099100682,77099100679,-3,1583,2867,-30
77099848809,77099848813,4,1722,1929,-30
77102686712,77102686714,2,1204,1109,-30
77109118033,77109118038,5,2203,1385,-30
77109343425,77109343430,5,3429,1395,-30
77110371402,77110371406,4,2220,1254,-30
77114421606,77114421611,5,1555,973,-30
77119636845,77119636850,5,1416,802,-30
77121449246,77121449251,5,1862,994,-30
77122310660,77122310666,6,2133,1428,-30
77123105695,77123105688,-7,1263,1852,-30
77125592740,77125592746,6,2798,986,-30
77132181763,77132181767,4,2784,1408,-30
77132777308,77132777314,6,1696,889,-30
77133009390,77133009395,5,3693,1533,-30
77134690363,77134690370,7,2884,1035,-30
77141179644,77141179650,6,2695,1327,-30
77144719919,77144719926,7,2646,980,-30
77145915515,77145915519,4,1169,1163,-30
77148067477,77148067479,2,989,734,-30
77148894327,77148894331,4,1562,997,-30
77153544057,77153544062,5,2367,1729,-30
77155057687,77155057692,5,2028,1383,-30
77158256809,77158256815,6,1905,1107,-30
77158525866,77158525870,4,2051,1513,-30
77160190779,77160190785,6,2796,1191,-30
77161717441,77161717447,6,1517,1151,-30
77162287851,77162287854,3,1079,1069,-30
77169127865,77169127870,5,1551,1260,-30
77172025446,77172025450,4,1817,1373,-30
77172846163,77172846169,6,2380,1342,-30
77173890118,77173890124,6,2287,1358,-30
77174023860,77174023872,12,3000,1269,-30
77175970426,77175970431,5,4763,1869,-30
77188066188,77188066203,15,14912,52785,-30
77190415833,77190415838,5,2294,1095,-30
77191464751,77191464758,7,1373,1382,-30
77193011865,77193011871,6,2477,1220,-30
77194305593,77194305598,5,1359,851,-30
77196895038,77196895042,4,1983,1007,-30
77201352477,77201352482,5,2030,1258,-30
77201803220,77201803224,4,678,262,-30
77212591538,77212591541,3,2157,1424,-30
77213804841,77213804847,6,3239,1337,-30
77218735722,77218735726,4,1851,1217,-30
77218767714,77218767718,4,1693,1215,-30
77220354802,77220354796,-6,1339,5477,-30
77220940789,77220940796,7,2356,1234,-30
77224419247,77224419255,8,2700,828,-30
77225475445,77225475451,6,2554,1652,-30
77226736250,77226736254,4,2122,1331,-30
77227256801,77227256786,-15,1550,1197,-30
77229979046,77229979055,9,1145,912,-30
77231444866,77231444871,5,1681,1179,-30
77232882825,77232882830,5,2554,1665,-30
77237528021,77237528025,4,2282,1331,-30
77238551333,77238551338,5,1576,987,-30
77239204781,77239204786,5,2262,1580,-30
77239594032,77239594037,5,1864,1152,-30
77240634394,77240634399,5,2664,1034,-30
77240870281,77240870291,10,2075,961,-30
77241323196,77241323199,3,1881,1181,-30
77242186358,77242186360,2,1342,907,-30
77245264390,77245264394,4,1855,1247,-30
77247933070,77247933076,6,2023,1432,-30
77248177847,77248177852,5,3190,1786,-30
77250537905,77250537910,5,2295,1018,-30
77250967597,77250967601,4,2627,1395,-30
77255316450,77255316455,5,2193,1183,-30
77258368145,77258368145,0,3083,3334,-30
77259936987,77259936991,4,3451,1571,-30
77261600869,77261600873,4,2025,1087,-30
77264974059,77264974065,6,2934,2349,-30
77265783766,77265783765,-1,1259,1975,-30
77267065741,77267065746,5,2632,1166,-30
77271940298,77271940280,-18,1107,561,-30
77274285219,77274285222,3,2302,1220,-30
77276491575,77276491579,4,2462,1120,-30
77276569212,77276569219,7,939,167,-30
77277378194,77277378198,4,2638,1548,-30
77281903035,77281903041,6,2089,1351,-30
77282461486,77282461496,10,2291,1418,-30
77282792302,77282792301,-1,1574,2096,-30
77283450197,77283450202,5,2636,1572,-30
77284755105,77284755110,5,1647,1430,-30
77286267531,77286267533,2,1816,1923,-30
77287371518,77287371522,4,1811,1189,-30
77291230350,77291230354,4,2917,1111,-30
77291789195,77291789199,4,2354,1630,-30
77292279072,77292279078,6,2174,1100,-30
77292921229,77292921234,5,2377,1107,-30
77293197438,77293197448,10,1422,899,-30
77293650454,77293650458,4,2060,1223,-30
77294650341,77294650346,5,2276,1068,-30
77297958565,77297958569,4,3423,1445,-30
77303419377,77303419382,5,960,463,-30
77303962659,77303962655,-4,1598,4555,-30
77308228279,77308228283,4,2425,1134,-30
77308912209,77308912214,5,1505,1180,-30
77309804370,77309804375,5,1788,29454,-30
77311140187,77311140193,6,2314,1491,-30
77319449194,77319449199,5,1451,796,-30
77321931415,77321931421,6,2607,1459,-30
77322273262,77322273267,5,1922,1266,-30
77328828789,77328828781,-8,2001,992,-30
77330723494,77330723489,-5,1077,3305,-30
77331135243,77331135246,3,2513,1660,-30
77331861326,77331861325,-1,1092,1618,-30
77338094733,77338094737,4,1817,1055,-30
77339002477,77339002481,4,2104,1192,-30
77340840479,77340840484,5,2458,1495,-30
77342289791,77342289790,-1,1946,1421,-30
77342332962,77342332967,5,2623,1119,-30
77351224563,77351224566,3,1937,1375,-30
77353162055,77353162060,5,2408,1161,-30
77355560210,77355560210,0,2487,2216,-30
77355828170,77355828174,4,1309,1411,-30
77356967361,77356967362,1,1381,1841,-30
77357454937,77357454942,5,1517,843,-30
77358542174,77358542181,7,1796,950,-30
77359603253,77359603256,3,2620,2020,-30
77360963169,77360963174,5,2989,1175,-30
77364198417,77364198422,5,1199,900,-30
77366754255,77366754259,4,2071,1091,-30
77367244105,77367244110,5,2659,1423,-30
77381117196,77381117204,8,2027,1055,-30
77382614159,77382614165,6,1316,1437,-30
77383126638,77383126641,3,1523,830,-30
77384764925,77384764931,6,2977,1999,-30
77385543622,77385543628,6,3009,1340,-30
77389436025,77389436029,4,1691,1031,-30
77393199114,77393199117,3,2005,1540,-30
77395261712,77395261717,5,1613,1472,-30
77397936826,77397936830,4,2741,1706,-30
77400604873,77400604875,2,2887,1712,-30
77403375238,77403375244,6,2322,1198,-30
77406967914,77406967919,5,2056,1097,-30
77408608569,77408608574,5,2168,1296,-30
77408775311,77408775315,4,2155,1051,-30
77410802606,77410802612,6,2987,1164,-30
77413392686,77413392690,4,1494,1076,-30
77417769094,77417769098,4,1149,1188,-30
77422811851,77422811855,4,2211,1107,-30
77424993793,77424993798,5,2376,1925,-30
77427068230,77427068237,7,2466,1253,-30
77428001661,77428001665,4,2750,1445,-30
77432206510,77432206515,5,2849,1736,-30
77436912290,77436912294,4,1568,767,-30
77437148150,77437148155,5,2251,1176,-30
77438172989,77438172995,6,1909,1089,-30
77442221449,77442221454,5,2344,1423,-30
77446114508,77446114511,3,2058,1533,-30
77447677304,77447677310,6,5814,1788,-30
77448363833,77448363836,3,2261,1737,-30
77451629641,77451629645,4,1730,829,-30
77452692675,77452692674,-1,983,1399,-30
77454215185,77454215189,4,2183,1641,-30
77462948715,77462948718,3,2055,894,-30
77465473526,77465473531,5,2401,1145,-30
77472286767,77472286775,8,13782,28092,-30
77475072322,77475072327,5,1112,900,-30
77475596870,77475596874,4,1360,1215,-30
77477943168,77477943171,3,2627,1788,-30
77480487902,77480487906,4,2427,1206,-30
77481346914,77481346919,5,2120,781,-30
77486336410,77486336417,7,2926,2031,-30
77486386299,77486386305,6,2076,1265,-30
77490344295,77490344299,4,2344,1175,-30
77493893427,77493893425,-2,52918,20114,-30
77494760487,77494760494,7,1522,1293,-30
77494973182,77494973178,-4,4080,11230,-30
77499320889,77499320894,5,1626,1290,-30
77503325519,77503325526,7,2968,983,-30
77510194386,77510194389,3,2511,1798,-30
77514069030,77514069034,4,2181,1102,-30
77516899738,77516899742,4,2909,1779,-30
77517346415,77517346419,4,1756,1358,-30
77518609082,77518609086,4,2776,1510,-30
77521246005,77521246010,5,2130,1190,-30
77522813290,77522813293,3,2085,1210,-30
77525050429,77525050433,4,2526,1709,-30
77527341157,77527341162,5,2257,1276,-30
77528872192,77528872197,5,2279,1795,-30
77536583895,77536583902,7,2833,1047,-30
77539061734,77539061739,5,2005,1539,-30
77540952282,77540952286,4,2428,1885,-30
77542265742,77542265749,7,1392,1082,-30
77544505204,77544505209,5,1966,1399,-30
77546427429,77546427427,-2,184,943,-30
77547505452,77547505458,6,2486,1255,-30
77549257207,77549257212,5,1386,1310,-30
77554094409,77554094413,4,3064,2138,-30
77554696855,77554696834,-21,3648,1778,-30
77554956192,77554956197,5,2391,1393,-30
77558088327,77558088330,3,2426,1162,-30
77559980878,77559980882,4,1318,1130,-30
77563515386,77563515391,5,2727,1636,-30
77563964430,77563964435,5,1725,835,-30
77567385621,77567385626,5,2235,1105,-30
77569344867,77569344867,0,2125,1659,-30
77571953753,77571953737,-16,1674,936,-30
77577451779,77577451785,6,1930,1234,-30
77578284211,77578284215,4,2106,1091,-30
77584018822,77584018826,4,2467,1116,-30
77584417487,77584417492,5,2151,1071,-30
77586122884,77586122888,4,1959,1544,-30
77595033423,77595033429,6,2648,1583,-30
77595886434,77595886442,8,1442,938,-30
77599686612,77599686618,6,3906,1975,-30
77606413593,77606413587,-6,1533,3939,-30
77614670063,77614670061,-2,1163,1506,-30
77617429606,77617429611,5,2677,1088,-30
77619307970,77619307974,4,3679,2193,-30
77619843082,77619843087,5,1670,806,-30
77623002098,77623002105,7,3239,1893,-30
77626379095,77626379102,7,2292,1396,-30
77631185829,77631185834,5,1552,862,-30
77631559809,77631559815,6,1452,929,-30
77636997703,77636997707,4,1735,1041,-30
77637065905,77637065890,-15,1041,616,-30
77638066805,77638066810,5,2512,1387,-30
77640376190,77640376195,5,2642,1583,-30
77641729526,77641729529,3,2337,1214,-30
77647207793,77647207798,5,1649,1406,-30
77648660746,77648660751,5,2357,1373,-30
77649250471,77649250477,6,1320,921,-30
77650685137,77650685140,3,1472,1837,-30
77651180877,77651180882,5,2385,1128,-30
77655719615,77655719621,6,1793,1464,-30
77656072315,77656072310,-5,955,3602,-30
77657360676,77657360678,2,2128,1108,-30
77658569821,77658569821,0,1366,1038,-30
77663380149,77663380153,4,2122,1289,-30
77666811895,77666811899,4,1235,793,-30
77667865481,77667865483,2,1374,1013,-30
77668008797,77668008802,5,2003,791,-30
77668193868,77668193865,-3,780,50,-30
77674592367,77674592365,-2,661,2309,-30
77675318633,77675318638,5,3959,1327,-30
77675384001,77675383987,-14,1108,1048,-30
77682378349,77682378352,3,2132,1122,-30
77683251215,77683251221,6,1966,1490,-30
77684068331,77684068326,-5,1035,4035,-30
77686089634,77686089639,5,2285,1483,-30
77687074299,77687074303,4,2675,1809,-30
77687849593,77687849597,4,1291,1075,-30
77689838249,77689838235,-14,2828,1530,-30
77691067402,77691067411,9,1248,899,-30
77692267267,77692267271,4,1729,1419,-30
77693052218,77693052222,4,1873,2100,-30
77695098058,77695098063,5,1595,1278,-30
77695770363,77695770369,6,2774,1242,-30
77695848742,77695848742,0,1377,1744,-30
77705386418,77705386424,6,2435,1070,-30
77706410994,77706411000,6,2154,1235,-30
77707860136,77707860141,5,2058,1172,-30
77711105845,77711105851,6,1886,1035,-30
77712251605,77712251610,5,1975,1632,-30
77714107179,77714107186,7,2622,1539,-30
77714439322,77714439326,4,1407,1265,-30
77714950025,77714950029,4,2019,1302,-30
77718706577,77718706581,4,1772,571,-30
77718800118,77718800122,4,2007,1342,-30
77726153414,77726153418,4,2440,1409,-30
77730886742,77730886746,4,2077,996,-30
77734119060,77734119063,3,1589,1510,-30
77735106682,77735106687,5,2912,1545,-30
77737704069,77737704074,5,2292,1093,-30
77740107026,77740107030,4,1787,1069,-30
77740488346,77740488347,1,2210,1693,-30
77740855803,77740855808,5,1348,294,-30
77741498539,77741498547,8,3064,820,-30
77745809110,77745809115,5,2131,1170,-30
77749641581,77749641586,5,1929,1130,-30
77750587804,77750587810,6,1749,1247,-30
77751996789,77751996794,5,2922,1515,-30
77753125433,77753125437,4,1965,1241,-30
77756359106,77756359110,4,2355,1343,-30
77761601662,77761601669,7,806,710,-30
77763428786,77763428791,5,1917,1277,-30
77764587865,77764587869,4,2853,1919,-30
77764790541,77764790547,6,2037,1364,-30
77770680622,77770680626,4,1451,1188,-30
77780277846,77780277852,6,1895,948,-30
77781542438,77781542445,7,1797,1019,-30
77782670629,77782670634,5,1976,1276,-30
77783230155,77783230160,5,2202,1135,-30
77785523915,77785523921,6,2019,1094,-30
77786099579,77786099561,-18,1267,641,-30
77789715242,77789715249,7,2343,1251,-30
77795702605,77795702611,6,2691,1405,-30
77797531190,77797531195,5,2515,1015,-30
77798001075,77798001079,4,2794,1457,-30
77799119905,77799119909,4,2445,1177,-30
77799779920,77799779926,6,2424,1175,-30
77799834233,77799834237,4,2344,1852,-30
77803591571,77803591577,6,2108,1511,-30
77805379846,77805379852,6,1484,1039,-30
77808818477,77808818482,5,1667,743,-30
77810443523,77810443529,6,2497,1223,-30
77813373649,77813373653,4,2163,1332,-30
77814102537,77814102543,6,1463,1104,-30
77816379061,77816379064,3,1509,1204,-30
77816863589,77816863591,2,999,1033,-30
77817364082,77817364087,5,1936,1104,-30
77819896352,77819896338,-14,1845,1463,-30
77820243970,77820243977,7,2430,1238,-30
77821436833,77821436837,4,2126,1343,-30
77824439367,77824439373,6,2447,1535,-30
77825532551,77825532557,6,1984,1339,-30
77825878949,77825878955,6,2892,1414,-30
77826132469,77826132473,4,2323,778,-30
77828569320,77828569325,5,2545,1285,-30
77829740813,77829740818,5,2860,2095,-30
77836188858,77836188863,5,4202,1967,-30
77838557142,77838557147,5,1843,1579,-30
77840498955,77840498960,5,3045,1437,-30
77841632006,77841632011,5,2316,1518,-30
77841961508,77841961526,18,233,1163,-30
77846213050,77846213051,1,1962,2022,-30
77846888465,77846888468,3,2273,1876,-30
77847155322,77847155327,5,2659,1286,-30
77848714699,77848714705,6,2384,1352,-30
77848932975,77848932978,3,1926,1322,-30
77852880778,77852880775,-3,1123,2684,-30
77853706716,77853706719,3,1836,1276,-30
77856762634,77856762640,6,2889,1367,-30
77859964812,77859964817,5,1974,909,-30
77866964319,77866964323,4,2014,1458,-30
77873552061,77873552065,4,1220,1149,-30
77879491454,77879491462,8,1178,781,-30
77881108695,77881108700,5,2500,1594,-30
77883181534,77883181541,7,2670,1767,-30
77883274577,77883274582,5,1994,1239,-30
77884852232,77884852239,7,2526,1403,-30
77888740689,77888740693,4,2466,1471,-30
77889381321,77889381326,5,2969,1410,-30
77891215801,77891215806,5,2017,1438,-30
77894551940,77894551947,7,2708,1299,-30
77894895791,77894895796,5,1941,1464,-30
77900837702,77900837706,4,1745,1231,-30
77902014941,77902014946,5,2096,1400,-30
77902741326,77902741331,5,2628,996,-30
77903735773,77903735777,4,2816,1181,-30
77908089911,77908089915,4,1817,914,-30
77908819989,77908819968,-21,1986,960,-30
77909172253,77909172258,5,2456,1281,-30
77912743626,77912743633,7,1688,913,-30
77916278955,77916278961,6,1500,1060,-30
77918013213,77918013217,4,2525,1360,-30
77919701126,77919701130,4,2561,1851,-30
77921373763,77921373764,1,1133,1267,-30
77921429247,77921429228,-19,1812,1125,-30
77922631081,77922631081,0,1375,2090,-30
77922989605,77922989609,4,2150,1428,-30
77925455628,77925455631,3,1696,1553,-30
77927880017,77927880023,6,2436,1468,-30
77930964338,77930964342,4,3091,1714,-30
77932204881,77932204886,5,2226,1236,-30
77936111158,77936111163,5,2640,1620,-30
77936216359,77936216363,4,1615,860,-30
77936330801,77936330817,16,2017,1097,-30
77938247541,77938247537,-4,2450,5314,-30
77938918259,77938918262,3,1616,1198,-30
77940569897,77940569902,5,2362,1423,-30
77941736986,77941736991,5,1078,704,-30
77947883824,77947883809,-15,220,11513,-30
77950083329,77950083333,4,1867,1509,-30
77954189617,77954189621,4,1909,1263,-30
77954932973,77954932978,5,2627,1279,-30
77960973694,77960973696,2,1114,1110,-30
77962646679,77962646686,7,2198,1525,-30
77962960181,77962960194,13,1712,1326,-30
77964528606,77964528611,5,2456,1111,-30
77964761673,77964761679,6,1632,749,-30
77967649297,77967649304,7,3252,1779,-30
77968075742,77968075748,6,3276,1067,-30
77968207633,77968207638,5,3258,1787,-30
77971973146,77971973154,8,2297,1501,-30
77976405995,77976405999,4,1753,603,-30
77978640623,77978640627,4,1586,917,-30
77978848331,77978848337,6,2427,1110,-30
77981628521,77981628526,5,1870,1218,-30
77985012114,77985012119,5,1894,873,-30
77987602955,77987602961,6,2848,1592,-30
77988543075,77988543078,3,2083,1217,-30
77990656625,77990656630,5,3608,1435,-30
77991039660,77991039666,6,2626,993,-30
77991601262,77991601260,-2,22060,19374,-30
77992270106,77992270110,4,2158,1570,-30
77998309083,77998309086,3,1482,927,-30
78003231175,78003231179,4,1554,870,-30
78008087454,78008087461,7,1756,925,-30
78008743885,78008743889,4,1395,896,-30
78016409465,78016409471,6,2121,1564,-30
78018592853,78018592856,3,1225,1195,-30
78019959815,78019959819,4,1151,866,-30
78020843779,78020843784,5,2744,1390,-30
78021791813,78021791818,5,1538,1569,-30
78023864641,78023864646,5,1700,1084,-30
78024136333,78024136338,5,2223,1553,-30
78026537138,78026537142,4,1630,917,-30
78028157969,78028157974,5,1384,896,-30
78029056058,78029056059,1,1529,959,-30
78033504261,78033504266,5,2837,1792,-30
78036212413,78036212418,5,2682,1375,-30
78038069004,78038069007,3,1673,1021,-30
78039616942,78039616947,5,2169,1295,-30
78045890355,78045890358,3,1790,1595,-30
78046472828,78046472831,3,2724,1149,-30
78047188845,78047188850,5,2360,1251,-30
78047813985,78047813990,5,2669,984,-30
78048323275,78048323290,15,678,307,-30
78048941559,78048941564,5,2118,1575,-30
78049862877,78049862887,10,7832,34425,-30
78050611644,78050611648,4,2131,1251,-30
78050722091,78050722074,-17,1910,907,-30
78051189489,78051189494,5,2015,1401,-30
78052347024,78052347021,-3,23629,14579,-30
78052927386,78052927388,2,1829,1130,-30
78053616333,78053616338,5,2538,1360,-30
78053820575,78053820555,-20,2529,1539,-30
78056316481,78056316485,4,1564,1041,-30
78056993027,78056993033,6,2125,1118,-30
78058739374,78058739380,6,2150,1154,-30
78061533798,78061533802,4,2123,1014,-30
78062235911,78062235918,7,4456,2157,-30
78063018173,78063018178,5,2377,1342,-30
78064330590,78064330593,3,1169,424,-30
78066243731,78066243737,6,2459,1357,-30
78067692436,78067692441,5,2143,926,-30
78069536418,78069536421,3,2423,1050,-30
78070024602,78070024608,6,1904,1199,-30
78075832797,78075832790,-7,1681,827,-30
78077210030,78077210034,4,2337,1518,-30
78079567323,78079567329,6,2580,1218,-30
78082070762,78082070756,-6,976,5013,-30
78082715719,78082715725,6,2143,1300,-30
78084403294,78084403299,5,2150,1627,-30
78085878978,78085878982,4,1546,1057,-30
78086255895,78086255899,4,2298,1686,-30
78086557572,78086557579,7,2550,1334,-30
78088415083,78088415082,-1,2085,2597,-30
78088529994,78088529999,5,2735,1186,-30
78089090432,78089090434,2,1285,748,-30
78091361196,78091361199,3,1315,1694,-30
78099147289,78099147293,4,2984,1758,-30
78100653257,78100653259,2,2270,1256,-30
78102951237,78102951244,7,2562,1158,-30
78103162691,78103162707,16,2706,1474,-30
78109801489,78109801494,5,3800,1614,-30
78112705390,78112705385,-5,1028,4337,-30
78114533930,78114533935,5,3147,1637,-30
78117926294,78117926300,6,2778,1124,-30
78119210693,78119210696,3,2813,1602,-30
78123374895,78123374901,6,2800,1609,-30
78123808423,78123808424,1,8500,8486,-30
78131180967,78131180970,3,1957,1595,-30
78132720489,78132720495,6,1964,1209,-30
78132963537,78132963542,5,3084,1888,-30
78134362915,78134362918,3,2424,1732,-30
78135454844,78135454846,2,914,1628,-30
78141452931,78141452935,4,2574,1708,-30
78144331084,78144331089,5,1602,905,-30
78144878978,78144878974,-4,637,1603,-30
78145122505,78145122526,21,243,885,-30
78146203617,78146203603,-14,838,377,-30
78147750801,78147750804,3,2165,1607,-30
78148109326,78148109330,4,1721,1075,-30
78149037065,78149037069,4,1742,1102,-30
78152424586,78152424590,4,2673,1540,-30
78153173726,78153173730,4,1783,1516,-30
78154090244,78154090242,-2,1298,2456,-30
78155577574,78155577579,5,2989,1444,-30
78156686759,78156686738,-21,2173,1045,-30
78161245970,78161245976,6,2207,1656,-30
78161455566,78161455570,4,2607,1284,-30
78163159262,78163159266,4,1678,1380,-30
78168606510,78168606520,10,15019,31608,-30
78168749322,78168749325,3,1711,1548,-30
78168819611,78168819616,5,736,153,-30
78171493497,78171493502,5,2050,1233,-30
78174080524,78174080526,2,2079,1488,-30
78174487791,78174487779,-12,3757,1284,-30
78175051338,78175051339,1,794,1011,-30
78175483209,78175483202,-7,1587,6618,-30
78176772447,78176772454,7,2981,1069,-30
78180476700,78180476719,19,1222,911,-30
78183246537,78183246543,6,1936,809,-30
78187066739,78187066742,3,2184,1058,-30
78188349407,78188349407,0,1088,1652,-30
78190919185,78190919193,8,1144,751,-30
78192883072,78192883069,-3,2348,5289,-30
78193141371,78193141375,4,3065,1827,-30
78194220018,78194220023,5,1377,1111,-30
78194891945,78194891952,7,2431,1187,-30
78197853876,78197853878,2,1461,1200,-30
78198798870,78198798874,4,1925,1737,-30
78202881998,78202882002,4,2108,1656,-30
78203061617,78203061621,4,2270,1607,-30
78203204040,78203204046,6,1342,1747,-30
78208026603,78208026584,-19,573,210,-30
78209784494,78209784498,4,2749,1319,-30
78214147945,78214147951,6,1990,1087,-30
78214180229,78214180235,6,1733,955,-30
78220498309,78220498315,6,2645,1224,-30
78221488693,78221488698,5,2606,930,-30
78225330053,78225330057,4,2110,858,-30
78226697187,78226697192,5,2287,1459,-30
78227564557,78227564562,5,3443,2031,-30
78237181564,78237181569,5,2041,1266,-30
78244895426,78244895405,-21,2972,1937,-30
78248091874,78248091878,4,2134,1204,-30
78250175065,78250175070,5,1961,1505,-30
78253315721,78253315724,3,1668,1232,-30
78256243003,78256243006,3,1421,805,-30
78257790441,78257790446,5,1096,1020,-30
78260331738,78260331744,6,2377,1190,-30
78262142886,78262142889,3,1813,1322,-30
78267961013,78267961019,6,1120,632,-30
78268749609,78268749614,5,1813,1428,-30
78271745547,78271745552,5,2709,1258,-30
78273964701,78273964707,6,1836,1236,-30
78274730089,78274730094,5,2473,1144,-30
78274839136,78274839142,6,2295,1367,-30
78274943789,78274943793,4,2632,1696,-30
78275948082,78275948087,5,2649,1370,-30
78276577642,78276577647,5,2899,1682,-30
78277829779,78277829783,4,1795,970,-30
78278220802,78278220808,6,2113,1543,-30
78278364966,78278364971,5,2195,871,-30
78282335080,78282335086,6,2593,1533,-30
78286122659,78286122664,5,1437,1378,-30
78286573331,78286573313,-18,2268,873,-30
78289892558,78289892563,5,1853,1471,-30
78291411274,78291411279,5,2122,1470,-30
78293602387,78293602391,4,1480,1169,-30
78301257181,78301257186,5,832,960,-30
78306404334,78306404337,3,2833,2232,-30
78306927365,78306927371,6,2770,1069,-30
78308245111,78308245104,-7,1130,4571,-30
78308925250,78308925255,5,1451,1115,-30
78309631150,78309631155,5,1929,1113,-30
78309714704,78309714709,5,2829,1228,-30
78311255280,78311255281,1,1680,2368,-30
78314037579,78314037582,3,2061,1324,-30
78315465203,78315465208,5,2371,1633,-30
78327030588,78327030590,2,1895,1630,-30
78329210131,78329210135,4,2187,1410,-30
78329902401,78329902407,6,1387,1021,-30
78331255001,78331255005,4,2222,1520,-30
78338765922,78338765926,4,2280,1492,-30
78339065577,78339065582,5,2883,1044,-30
78343468159,78343468167,8,1274,719,-30
78346689025,78346689028,3,2057,1273,-30
78347297762,78347297767,5,1396,920,-30
78347906147,78347906150,3,1756,1086,-30
78349416475,78349416477,2,1493,1877,-30
78350566182,78350566189,7,2707,1171,-30
78358912797,78358912803,6,5397,2237,-30
78361059814,78361059819,5,2202,893,-30
78361488134,78361488138,4,1859,1037,-30
78364989710,78364989714,4,2198,1023,-30
78366331460,78366331463,3,1946,803,-30
78366755142,78366755147,5,3369,1743,-30
78367175621,78367175602,-19,1975,1419,-30
78372325204,78372325209,5,4695,3032,-30
78377030480,78377030485,5,3276,1709,-30
78378160071,78378160075,4,1243,946,-30
78378455220,78378455225,5,1966,1432,-30
78379670323,78379670329,6,3281,1940,-30
78381381872,78381381879,7,2119,1475,-30
78381436383,78381436396,13,13981,26383,-30
78383878253,78383878258,5,2528,1124,-30
78384671810,78384671813,3,1913,1107,-30
78392206466,78392206470,4,2788,1177,-30
78392715240,78392715245,5,1985,981,-30
78395656107,78395656114,7,2914,1367,-30
78399649673,78399649671,-2,1492,4110,-30
78403139605,78403139611,6,2649,1685,-30
78405347817,78405347817,0,744,1224,-30
78407408699,78407408705,6,3224,1583,-30
78410346829,78410346834,5,2535,1464,-30
78413083889,78413083893,4,2237,1123,-30
78417693937,78417693942,5,1607,622,-30
78421673124,78421673129,5,2547,1654,-30
78421708261,78421708265,4,2415,2079,-30
78424732464,78424732469,5,1536,1002,-30
78426138997,78426139001,4,1520,910,-30
78426189974,78426189956,-18,1640,628,-30
78426427422,78426427426,4,1334,1029,-30
78429735231,78429735237,6,1435,1339,-30
78430899346,78430899350,4,2340,1308,-30
78436467507,78436467513,6,2566,1152,-30
78444803758,78444803763,5,1726,807,-30
78444952844,78444952824,-20,2252,1156,-30
78446582782,78446582786,4,2199,1460,-30
78447595699,78447595705,6,3024,1543,-30
78447717173,78447717178,5,2449,1537,-30
78451728217,78451728223,6,2227,1201,-30
78452766627,78452766632,5,2113,1449,-30
78455395300,78455395305,5,2127,1330,-30
78457775162,78457775162,0,2677,4462,-30
78458745774,78458745779,5,2704,1728,-30
78462473914,78462473917,3,1728,1443,-30
78466928708,78466928712,4,2535,1170,-30
78467656090,78467656085,-5,1187,4413,-30
78468501017,78468501019,2,1634,1057,-30
78468730927,78468730914,-13,962,568,-30
78468897876,78468897882,6,1350,1082,-30
78470334257,78470334262,5,2222,1981,-30
78472060284,78472060284,0,25097,9063,-30
78474424258,78474424252,-6,923,3914,-30
78474823175,78474823182,7,2326,1149,-30
78475721375,78475721376,1,2122,2490,-30
78476224990,78476224997,7,4264,1868,-30
78476680176,78476680163,-13,3797,457,-30
78477529270,78477529278,8,4182,1435,-30
78481258487,78481258493,6,2486,1408,-30
78483981214,78483981218,4,2621,1372,-30
78485498783,78485498787,4,2036,1520,-30
78486091861,78486091869,8,3275,1206,-30
78490946712,78490946715,3,1834,1321,-30
78497066449,78497066455,6,2340,1255,-30
78506085598,78506085604,6,1365,1260,-30
78508123648,78508123651,3,2462,1777,-30
78516176402,78516176409,7,2232,1108,-30
78516587168,78516587170,2,2078,1752,-30
78517121247,78517121242,-5,2041,7390,-30
78520013522,78520013527,5,2517,1438,-30
78522503898,78522503903,5,1470,1101,-30
78523321710,78523321714,4,2731,1557,-30
78523594271,78523594276,5,1908,1400,-30
78524389149,78524389154,5,2079,1398,-30
78525446389,78525446394,5,2105,991,-30
78527580462,78527580466,4,2455,1846,-30
78529649607,78529649615,8,1379,997,-30
78529764383,78529764386,3,2270,2031,-30
78530472606,78530472609,3,1280,871,-30
78531317133,78531317144,11,2170,1105,-30
78533389516,78533389515,-1,987,1550,-30
78533689166,78533689171,5,2704,1241,-30
78537923099,78537923104,5,2774,1625,-30
78538698893,78538698898,5,1100,634,-30
78542977221,78542977229,8,2168,1043,-30
78543859924,78543859923,-1,1092,237,-30
78545580134,78545580139,5,1596,1159,-30
78548141611,78548141616,5,2673,1028,-30
78549788629,78549788634,5,2215,1522,-30
78556588352,78556588355,3,2773,2322,-30
78556792604,78556792611,7,3479,1474,-30
78557172022,78557172027,5,2378,1374,-30
78561230100,78561230107,7,3530,1077,-30
78563594130,78563594134,4,1737,1179,-30
78563832032,78563832038,6,4776,2123,-30
78564467692,78564467697,5,3111,2130,-30
78568014885,78568014891,6,2014,1322,-30
78573901345,78573901342,-3,1332,2716,-30
78588643940,78588643946,6,2975,1153,-30
78591865022,78591865027,5,2480,1443,-30
78592132862,78592132866,4,2284,1286,-30
78593019373,78593019378,5,2109,1554,-30
78593527066,78593527073,7,2359,868,-30
78595937386,78595937374,-12,1131,529,-30
78596887732,78596887735,3,3727,3327,-30
78598852982,78598852987,5,3315,2189,-30
78601183966,78601183974,8,2073,1036,-30
78607445783,78607445785,2,1609,1330,-30
78607767898,78607767902,4,1021,992,-30
78610832041,78610832045,4,2019,1343,-30
78611939385,78611939390,5,2277,1270,-30
78621732827,78621732832,5,1544,1288,-30
78625485262,78625485269,7,2866,1494,-30
78625966517,78625966521,4,1587,1120,-30
78626581749,78626581761,12,3608,1313,-30
78626807093,78626807099,6,2682,1481,-30
78627177730,78627177734,4,1828,828,-30
78631913082,78631913087,5,2509,1913,-30
78636275081,78636275082,1,2968,3379,-30
78636445599,78636445605,6,2748,1815,-30
78636619918,78636619922,4,2048,1505,-30
78639475523,78639475528,5,2435,1101,-30
78640492163,78640492166,3,2327,1359,-30
78642338871,78642338877,6,3292,1097,-30
78643595346,78643595350,4,2417,1595,-30
78645254403,78645254401,-2,1474,901,-30
78645811029,78645811034,5,2783,1407,-30
78654218693,78654218697,4,2164,1496,-30
78655110414,78655110419,5,2964,1636,-30
78655547645,78655547627,-18,223,256,-30
78657553985,78657553989,4,2022,1433,-30
78659330098,78659330101,3,2543,2015,-30
78662746807,78662746810,3,1523,957,-30
78663753268,78663753273,5,2858,1270,-30
78667468455,78667468462,7,1772,1311,-30
78669438186,78669438190,4,2629,1629,-30
78673143315,78673143319,4,2304,971,-30
78674859664,78674859669,5,2913,1625,-30
78674913109,78674913115,6,2012,1389,-30
78675856601,78675856607,6,2383,1206,-30
78678659186,78678659190,4,2066,1028,-30
78679917224,78679917231,7,6857,2138,-30
78684892000,78684892005,5,2610,935,-30
78685518974,78685518955,-19,2465,1309,-30
78687823750,78687823755,5,2257,1248,-30
78689453434,78689453439,5,2111,1025,-30
78691880634,78691880639,5,1683,1067,-30
78700495558,78700495563,5,1841,1162,-30
78702579582,78702579585,3,1538,1412,-30
78712133498,78712133504,6,2819,1294,-30
78714062709,78714062714,5,1003,848,-30
78714878621,78714878626,5,1840,1264,-30
78715376335,78715376322,-13,1689,791,-30
78718846190,78718846196,6,2993,1268,-30
78718981166,78718981166,0,1904,2927,-30
78723448851,78723448855,4,3325,1147,-30
78728111193,78728111199,6,1862,1283,-30
78731796661,78731796666,5,1642,1040,-30
78732340338,78732340344,6,1795,969,-30
78733092773,78733092777,4,2306,1392,-30
78739491743,78739491746,3,1980,1941,-30
78739909385,78739909391,6,1726,1233,-30
78740349526,78740349523,-3,1264,1383,-30
78746452861,78746452864,3,2934,1127,-30
78747531573,78747531577,4,2268,1716,-30
78747944785,78747944789,4,2611,1273,-30
78748355773,78748355778,5,1974,1397,-30
78750233677,78750233683,6,2566,1049,-30
78753192595,78753192603,8,2125,1218,-30
78755707103,78755707107,4,2255,1030,-30
78759399725,78759399730,5,2236,989,-30
78761402740,78761402743,3,2149,1254,-30
78764460201,78764460202,1,1779,2179,-30
78768718185,78768718189,4,2280,2014,-30
78769301998,78769302003,5,1342,378,-30
78769951454,78769951466,12,887,237,-30
78770356576,78770356582,6,2628,1894,-30
78771979309,78771979310,1,1197,1283,-30
78778312550,78778312557,7,2186,1408,-30
78783676609,78783676614,5,1902,1287,-30
78783728825,78783728808,-17,1382,471,-30
78784148960,78784148965,5,3363,1610,-30
78784182547,78784182551,4,1935,1332,-30
78786720231,78786720239,8,2403,1053,-30
78787947202,78787947209,7,2528,1570,-30
78789605144,78789605149,5,2117,1660,-30
78792983335,78792983341,6,3106,1104,-30
78793886174,78793886194,20,1797,1094,-30
78796507181,78796507186,5,1708,962,-30
78804880938,78804880941,3,2303,1220,-30
78808763885,78808763865,-20,1817,1053,-30
78811152829,78811152833,4,2310,1552,-30
78811647491,78811647494,3,2917,1576,-30
78811805842,78811805847,5,1802,1235,-30
78816293386,78816293391,5,2518,1352,-30
78819687633,78819687637,4,2417,1846,-30
78825266680,78825266686,6,2724,1314,-30
78827440917,78827440921,4,2624,1288,-30
78832981586,78832981594,8,2853,1475,-30
78834018135,78834018139,4,1952,1216,-30
78834518614,78834518617,3,1615,1371,-30
78835919823,78835919818,-5,2401,4384,-30
78837057108,78837057114,6,2209,993,-30
78837796266,78837796270,4,2510,1608,-30
78838919889,78838919895,6,2161,1096,-30
78839384917,78839384921,4,1334,1165,-30
78843627494,78843627497,3,1850,1075,-30
78848543728,78848543733,5,1624,843,-30
78850987762,78850987766,4,2898,1743,-30
78851131562,78851131568,6,1461,813,-30
78851396722,78851396727,5,1805,889,-30
78851533346,78851533352,6,1970,1312,-30
78854740422,78854740428,6,3209,1628,-30
78856651445,78856651449,4,2009,1259,-30
78859752201,78859752207,6,2001,1247,-30
78859873342,78859873332,-10,1006,71,-30
78861835586,78861835591,5,1987,1169,-30
78870057401,78870057405,4,2547,1293,-30
78871874326,78871874330,4,2618,1540,-30
78872684610,78872684614,4,1755,1387,-30
78872819413,78872819417,4,1829,1207,-30
78875594547,78875594552,5,1172,552,-30
78877126190,78877126194,4,2188,1084,-30
78878305689,78878305694,5,2388,1458,-30
78879540054,78879540032,-22,2443,944,-30
78880679887,78880679891,4,2146,1338,-30
78886877417,78886877422,5,1982,922,-30
78890001647,78890001653,6,2153,1227,-30
78890066580,78890066586,6,2211,1610,-30
78896695221,78896695223,2,2402,1212,-30
78900299647,78900299651,4,1741,922,-30
78901030310,78901030328,18,1919,990,-30
78901836966,78901836971,5,2549,873,-30
78902807101,78902807106,5,3018,1437,-30
78906465990,78906465994,4,1865,1191,-30
78907233261,78907233267,6,1243,728,-30
78912510390,78912510390,0,924,1773,-30
78915523966,78915523972,6,1746,1226,-30
78916966130,78916966127,-3,1374,507,-30
78919571490,78919571495,5,1516,826,-30
78923526483,78923526488,5,2748,1685,-30
78924454262,78924454266,4,2404,2001,-30
78925538582,78925538585,3,846,795,-30
78925703922,78925703926,4,2237,921,-30
78926812769,78926812771,2,1311,998,-30
78932025450,78932025456,6,1435,635,-30
78935597706,78935597711,5,1542,1274,-30
78943459086,78943459092,6,2153,1152,-30
78943996872,78943996856,-16,2207,1361,-30
78945219947,78945219952,5,1957,1279,-30
78949685034,78949685043,9,4003,1134,-30
78952639009,78952639014,5,2075,1405,-30
78954355599,78954355594,-5,1202,3583,-30
78956892808,78956892815,7,2432,1205,-30
78958323203,78958323209,6,2466,1728,-30
78960006212,78960006217,5,2568,1682,-30
78965249551,78965249557,6,2032,1344,-30
78966799670,78966799676,6,3066,1331,-30
78966922057,78966922062,5,2217,1017,-30
78967008422,78967008435,13,2657,1378,-30
78967762554,78967762559,5,3355,2368,-30
78968451750,78968451756,6,2263,1500,-30
78969462977,78969462982,5,1743,1207,-30
78970282271,78970282276,5,2545,1399,-30
78973808534,78973808539,5,2163,1261,-30
78981331758,78981331759,1,1267,2079,-30
78981693409,78981693407,-2,1761,2499,-30
78988029733,78988029727,-6,1651,6634,-30
78988730786,78988730790,4,2401,1107,-30
78989128749,78989128753,4,1797,1409,-30
78990398638,78990398643,5,2510,1806,-30
78993007749,78993007754,5,2104,1214,-30
78994469713,78994469718,5,2633,1708,-30
78997002702,78997002707,5,15327,8376,-30
78998055973,78998055979,6,2406,1252,-30
79005685306,79005685310,4,2247,1556,-30
79011768716,79011768713,-3,1929,4207,-30
79014740412,79014740406,-6,23716,13320,-30
79017578760,79017578766,6,3495,1745,-30
79017924503,79017924509,6,3377,2027,-30
79018558868,79018558874,6,2226,1273,-30
79020397117,79020397121,4,1821,1676,-30
79024004674,79024004673,-1,1119,1925,-30
79024205923,79024205927,4,1599,658,-30
79025705567,79025705572,5,2154,1431,-30
79027134362,79027134369,7,2209,1270,-30
79027970600,79027970605,5,2423,1110,-30
79030418311,79030418292,-19,1567,1200,-30
79034777555,79034777554,-1,30590,17943,-30
79035475016,79035475020,4,2035,1580,-30
79035736797,79035736787,-10,1071,389,-30
79036680451,79036680458,7,2539,1482,-30
79038131493,79038131494,1,2367,1889,-30
79040136968,79040136961,-7,2310,7414,-30
79041517536,79041517541,5,2178,2095,-30
79044689380,79044689385,5,2418,1419,-30
79047731828,79047731833,5,2780,1481,-30
79048367933,79048367939,6,1384,843,-30
79053675014,79053675017,3,2349,1603,-30
79055851389,79055851393,4,2462,1337,-30
79062308122,79062308127,5,2638,1267,-30
79063018294,79063018298,4,2672,1531,-30
79067376469,79067376473,4,1586,1241,-30
79068596269,79068596275,6,2373,1618,-30
79074082677,79074082682,5,2445,974,-30
79074587827,79074587824,-3,1799,2643,-30
79075035186,79075035191,5,1201,964,-30
79076078632,79076078635,3,1831,1113,-30
79076909190,79076909194,4,3082,1628,-30
79078762890,79078762897,7,1847,1272,-30
79079148451,79079148455,4,1558,1161,-30
79079674921,79079674927,6,2209,1281,-30
79080295948,79080295949,1,1222,1172,-30
79081481496,79081481500,4,1963,1551,-30
79082831269,79082831274,5,2360,1496,-30
79082898738,79082898746,8,1980,1183,-30
79084868610,79084868614,4,2172,972,-30
79085192703,79085192701,-2,1293,2384,-30
79087266662,79087266668,6,2270,830,-30
79092141761,79092141767,6,3062,1630,-30
79094124845,79094124842,-3,2554,5921,-30
79101503581,79101503586,5,2721,1668,-30
79101540325,79101540331,6,3059,1457,-30
79102363425,79102363429,4,2490,1490,-30
79102697861,79102697867,6,2133,1274,-30
79103815713,79103815715,2,1294,1171,-30
79106662882,79106662886,4,1775,990,-30
79108558273,79108558279,6,2455,1509,-30
79110335131,79110335138,7,1646,957,-30
79112524732,79112524730,-2,1532,2746,-30
79113454427,79113454433,6,2717,1816,-30
79114558637,79114558642,5,1542,845,-30
79116223590,79116223595,5,1047,898,-30
79117963330,79117963330,0,1204,1473,-30
79119309966,79119309974,8,4442,1182,-30
79119348142,79119348146,4,2558,1232,-30
79119589299,79119589302,3,1897,1332,-30
79120760937,79120760954,17,695,335,-30
79122019264,79122019258,-6,1267,4906,-30
79122619305,79122619307,2,1848,1154,-30
79125839237,79125839233,-4,2338,4502,-30
79131129844,79131129850,6,2026,1467,-30
79136880241,79136880246,5,2124,1006,-30
79141139977,79141139981,4,1903,937,-30
79152971658,79152971665,7,4030,1677,-30
79153891213,79153891213,0,918,232,-30
79156525873,79156525877,4,1774,1274,-30
79157945737,79157945734,-3,807,2432,-30
79160184102,79160184106,4,2784,1800,-30
79161355286,79161355291,5,1792,848,-30
79167638545,79167638550,5,1321,767,-30
79168689921,79168689927,6,1665,868,-30
79169002871,79169002874,3,1723,1383,-30
79171057843,79171057848,5,1555,1050,-30
79175923711,79175923714,3,2030,1124,-30
79176364442,79176364425,-17,2150,1003,-30
79179263899,79179263904,5,2886,1686,-30
79181447431,79181447430,-1,1096,1527,-30
79182667253,79182667258,5,3312,1521,-30
79185077661,79185077666,5,1753,1055,-30
79185538332,79185538345,13,2422,852,-30
79187057662,79187057667,5,3162,941,-30
79187680329,79187680335,6,2332,1132,-30
79190347441,79190347439,-2,1719,2925,-30
79190547887,79190547895,8,4694,1097,-30
79191127171,79191127176,5,965,330,-30
79195463664,79195463669,5,2422,1696,-30
79195824541,79195824546,5,2668,1535,-30
79198226236,79198226241,5,1928,1542,-30
79200016462,79200016465,3,1733,1598,-30
79203585626,79203585631,5,1963,1335,-30
79206170826,79206170831,5,1550,851,-30
79214221265,79214221251,-14,1789,1049,-30
79217612109,79217612113,4,2428,1443,-30
79218279744,79218279748,4,3294,1430,-30
79218869165,79218869170,5,1951,1016,-30
79220024508,79220024512,4,2800,1310,-30
79226060817,79226060822,5,1334,749,-30
79226484156,79226484160,4,1787,1161,-30
79229505842,79229505846,4,2350,1598,-30
79232064061,79232064066,5,2061,1347,-30
79232283413,79232283418,5,3000,1468,-30
79235544419,79235544427,8,2465,1057,-30
79235582545,79235582562,17,2708,1308,-30
79235713161,79235713164,3,1311,1148,-30
79236084058,79236084062,4,9582,24322,-30
79239642433,79239642437,4,2113,1770,-30
79241244934,79241244938,4,2073,1415,-30
79241663636,79241663642,6,2489,1547,-30
79243273118,79243273122,4,2384,1733,-30
79245653440,79245653442,2,1828,1094,-30
79249444457,79249444462,5,1833,1530,-30
79253651962,79253651965,3,1663,1084,-30
79254291930,79254291936,6,2196,1264,-30
79255410949,79255410952,3,1764,1842,-30
79255611975,79255611952,-23,625,284,-30
79257813183,79257813187,4,1121,877,-30
79257843149,79257843160,11,898,276,-30
79258963733,79258963734,1,3438,3595,-30
79261274601,79261274606,5,2459,1406,-30
79267060274,79267060279,5,1592,1045,-30
79267750648,79267750653,5,3963,1793,-30
79269274815,79269274819,4,1598,1249,-30
79273164106,79273164111,5,2017,1682,-30
79274265989,79274265995,6,3956,1295,-30
79274324429,79274324433,4,2582,1626,-30
79278601798,79278601804,6,1967,1114,-30
79279935267,79279935265,-2,1932,4512,-30
79288576745,79288576749,4,2543,1059,-30
79292242838,79292242831,-7,732,4208,-30
79294035028,79294035031,3,1927,1239,-30
79294528714,79294528719,5,2461,915,-30
79294842238,79294842228,-10,609,489,-30
79298073092,79298073098,6,1506,627,-30
79299031801,79299031803,2,2577,2329,-30
79299410650,79299410656,6,3171,1459,-30
79300325216,79300325218,2,1871,1561,-30
79300522530,79300522535,5,2889,1737,-30
79301010903,79301010907,4,2236,1633,-30
79302232274,79302232278,4,3298,1556,-30
79304095592,79304095595,3,1769,1193,-30
79306363964,79306363970,6,1745,1378,-30
79307990430,79307990430,0,2111,16837,-30
79310365734,79310365739,5,2282,966,-30
79315287390,79315287394,4,910,1072,-30
79315832234,79315832238,4,2382,1551,-30
79317304363,79317304368,5,1848,1209,-30
79322607339,79322607348,9,4087,1578,-30
79327480476,79327480469,-7,1195,5303,-30
79328925565,79328925570,5,2407,1237,-30
79331250811,79331250809,-2,1213,3197,-30
79332012966,79332012978,12,2287,1223,-30
79338235870,79338235877,7,2065,1372,-30
79338722947,79338722932,-15,22054,14904,-30
79340909534,79340909529,-5,703,1808,-30
79340978921,79340978927,6,2104,771,-30
79344497655,79344497661,6,2131,912,-30
79348296645,79348296651,6,1499,1175,-30
79348985826,79348985810,-16,2150,1368,-30
79351447086,79351447091,5,1809,1024,-30
79354651163,79354651158,-5,1069,3495,-30
79357102854,79357102858,4,2401,1503,-30
79358142075,79358142070,-5,1238,3812,-30
79358436120,79358436126,6,2042,1331,-30
79362195242,79362195247,5,3353,1311,-30
79365907647,79365907650,3,1362,1129,-30
79366026618,79366026620,2,1457,1656,-30
79366076177,79366076193,16,2136,4841,-30
79366353762,79366353767,5,2285,1043,-30
79368341124,79368341129,5,2379,1407,-30
79369639976,79369639982,6,2147,1551,-30
79372182898,79372182904,6,2245,1241,-30
79372257195,79372257203,8,3814,1488,-30
79379513822,79379513827,5,2068,750,-30
79385281374,79385281378,4,3341,1883,-30
79386679665,79386679669,4,3610,1629,-30
79389381600,79389381604,4,1500,1429,-30
79402236805,79402236811,6,1653,747,-30
79405631760,79405631765,5,3598,1344,-30
79408870257,79408870263,6,3098,976,-30
79412298263,79412298270,7,2151,1419,-30
79413755026,79413755032,6,1744,1185,-30
79414662081,79414662085,4,1750,1175,-30
79415307268,79415307274,6,3969,1705,-30
79416246482,79416246490,8,3389,1341,-30
79416596715,79416596723,8,2232,982,-30
79417020950,79417020955,5,2899,1536,-30
79418115766,79418115771,5,3150,1474,-30
79420749427,79420749422,-5,903,2323,-30
79421117054,79421117058,4,1918,842,-30
79422851546,79422851560,14,1604,1066,-30
79423673643,79423673650,7,6262,2529,-30
79433935128,79433935131,3,1767,1342,-30
79435130820,79435130826,6,1592,1356,-30
79436359805,79436359811,6,2972,1398,-30
79436676942,79436676924,-18,1012,407,-30
79437949846,79437949851,5,2669,1578,-30
79438390833,79438390837,4,1561,1611,-30
79448595402,79448595406,4,1101,992,-30
79451870974,79451870979,5,2145,1249,-30
79454989882,79454989886,4,1784,1216,-30
79455224478,79455224483,5,1313,1024,-30
79458040767,79458040773,6,2734,1278,-30
79460634747,79460634752,5,2970,1686,-30
79461397258,79461397265,7,1747,1226,-30
79463504719,79463504727,8,2660,1543,-30
79466004502,79466004507,5,1718,1432,-30
79467885782,79467885786,4,2089,988,-30
79467978876,79467978880,4,2519,1464,-30
79473339631,79473339635,4,1577,957,-30
79474427327,79474427331,4,2524,1007,-30
79477104785,79477104791,6,2645,1278,-30
79479867048,79479867054,6,2977,891,-30
79483931564,79483931577,13,10731,45437,-30
79484381101,79484381104,3,2323,1381,-30
79486180899,79486180902,3,2121,1513,-30
79487567676,79487567682,6,2152,1291,-30
79488833045,79488833048,3,1115,1359,-30
79488882580,79488882585,5,1903,1437,-30
79490722414,79490722417,3,1203,945,-30
79490778009,79490778025,16,3429,1558,-30
79491089130,79491089135,5,2066,1394,-30
79492365463,79492365465,2,1328,1235,-30
79493048093,79493048099,6,2232,828,-30
79493190587,79493190591,4,3073,1622,-30
79495308602,79495308607,5,2085,863,-30
79495722914,79495722919,5,1988,1018,-30
79497003988,79497003992,4,2278,1752,-30
79497330893,79497330892,-1,51889,35688,-30
79500177346,79500177350,4,1840,1445,-30
79503710790,79503710795,5,1611,987,-30
79505751857,79505751838,-19,2063,1182,-30
79510700040,79510700045,5,1816,1088,-30
79511758329,79511758334,5,1738,1206,-30
79512851202,79512851208,6,3217,1836,-30
79515013513,79515013517,4,1577,1092,-30
79517344553,79517344559,6,2173,1406,-30
79520027836,79520027832,-4,3006,6320,-30
79522410727,79522410730,3,1805,1126,-30
79522593497,79522593502,5,2011,1350,-30
79524726592,79524726596,4,3205,1731,-30
79534832653,79534832657,4,1988,1127,-30
79535426647,79535426636,-11,832,259,-30
79537370533,79537370538,5,2416,1221,-30
79538659942,79538659946,4,2450,1550,-30
79539433614,79539433618,4,2273,1288,-30
79540292230,79540292233,3,2716,1454,-30
79541900106,79541900112,6,1711,1455,-30
79547218080,79547218083,3,2612,1335,-30
79551399478,79551399484,6,1484,1009,-30
79551643717,79551643729,12,2185,1321,-30
79554122630,79554122633,3,2314,1381,-30
79556096055,79556096060,5,3625,2670,-30
79557669546,79557669552,6,2221,1163,-30
79558182165,79558182168,3,1392,1146,-30
79563771176,79563771182,6,7575,3728,-30
79564684129,79564684133,4,2165,1714,-30
79564880886,79564880890,4,2220,1159,-30
79566720089,79566720096,7,3687,1577,-30
79568900591,79568900590,-1,1410,2006,-30
79569649344,79569649350,6,2630,1657,-30
79572723656,79572723662,6,2449,1304,-30
79576125044,79576125049,5,2903,1431,-30
79577324555,79577324562,7,2559,1273,-30
79578103362,79578103367,5,1871,1216,-30
79581990613,79581990618,5,3126,1398,-30
79583697347,79583697352,5,2002,1181,-30
79592578797,79592578801,4,1839,1002,-30
79592639562,79592639566,4,3306,1606,-30
79592859024,79592859029,5,2411,1230,-30
79593735395,79593735399,4,1655,1246,-30
79597388225,79597388230,5,2063,1255,-30
79598012533,79598012538,5,2765,1274,-30
79598039915,79598039919,4,2173,1800,-30
79600055293,79600055298,5,1887,1405,-30
79601165307,79601165310,3,2052,1234,-30
79602391369,79602391374,5,2880,1663,-30
79605123378,79605123377,-1,1161,1356,-30
79605454621,79605454626,5,2233,1308,-30
79605548576,79605548577,1,1660,1750,-30
79608241005,79608241009,4,2305,1569,-30
79610585606,79610585622,16,2397,1360,-30
79613224958,79613224966,8,3359,1200,-30
79613653634,79613653640,6,2763,1907,-30
79616186194,79616186200,6,1340,1015,-30
79618160139,79618160143,4,1182,1516,-30
79621844790,79621844794,4,2651,1160,-30
79622476994,79622476998,4,1846,1573,-30
79623100326,79623100331,5,3081,1319,-30
79628651613,79628651615,2,891,962,-30
79633647306,79633647311,5,2108,1272,-30
79635850046,79635850050,4,2020,940,-30
79636656038,79636656041,3,1832,1272,-30
79639322331,79639322335,4,2189,1460,-30
79642603648,79642603652,4,2045,1077,-30
79644672702,79644672706,4,5644,2287,-30
79650981255,79650981259,4,1962,1209,-30
79661501446,79661501451,5,1536,1125,-30
79662085918,79662085923,5,2947,1649,-30
79662247468,79662247473,5,1533,984,-30
79664014143,79664014148,5,1923,1377,-30
79670082979,79670082986,7,2186,1071,-30
79672560603,79672560608,5,2757,1591,-30
79674430449,79674430454,5,1834,1239,-30
79677198401,79677198406,5,1773,915,-30
79679026402,79679026406,4,1755,819,-30
79680059247,79680059246,-1,1800,1807,-30
79680529583,79680529594,11,6,1405,-30
79680680595,79680680601,6,2810,1431,-30
79687474160,79687474165,5,3080,1679,-30
79696867655,79696867660,5,2017,1254,-30
79698174926,79698174930,4,2703,1578,-30
79698738367,79698738358,-9,1381,5347,-30
79700631187,79700631194,7,3371,1057,-30
79702050495,79702050500,5,967,1104,-30
79702768986,79702768974,-12,737,2454,-30
79705389709,79705389714,5,2223,1826,-30
79706591210,79706591213,3,1676,1212,-30
79708177442,79708177447,5,2579,1094,-30
79709450298,79709450303,5,2527,1199,-30
79713162515,79713162521,6,2580,1071,-30
79715167930,79715167936,6,2762,1688,-30
79719346658,79719346662,4,1739,1041,-30
79719431088,79719431092,4,1568,1359,-30
79728274246,79728274249,3,2016,1727,-30
79729582757,79729582740,-17,2005,1032,-30
79731508513,79731508519,6,2516,1402,-30
79734259670,79734259675,5,1827,909,-30
79735584322,79735584326,4,2211,1666,-30
79735758953,79735758960,7,3624,1055,-30
79740754349,79740754355,6,2155,1275,-30
79742969406,79742969407,1,1689,1373,-30
79743758805,79743758786,-19,2980,962,-30
79749359970,79749359975,5,1715,1059,-30
79755207653,79755207658,5,2617,1801,-30
79760114641,79760114645,4,2633,1190,-30
79764559746,79764559752,6,1211,971,-30
79764815267,79764815272,5,2444,2158,-30
79765023606,79765023608,2,2561,881,-30
79766145602,79766145608,6,3086,1650,-30
79767534671,79767534675,4,1579,910,-30
79769282503,79769282508,5,2784,1411,-30
79772789047,79772789050,3,2701,2078,-30
79773480817,79773480822,5,2436,1474,-30
79777792438,79777792443,5,2340,1214,-30
79778483550,79778483554,4,2406,1512,-30
79779276171,79779276170,-1,1160,1360,-30
79782117866,79782117868,2,1808,1599,-30
79788760415,79788760419,4,1069,805,-30
79790887299,79790887303,4,2189,1129,-30
79791968370,79791968376,6,3057,1241,-30
79796133641,79796133643,2,4100,3749,-30
79798381790,79798381795,5,1767,1281,-30
79798696051,79798696054,3,1849,1222,-30
79800764481,79800764486,5,2041,1443,-30
79800977964,79800977968,4,2506,1552,-30
79804893875,79804893879,4,1735,1748,-30
79806304726,79806304730,4,2222,1409,-30
79807220918,79807220921,3,2108,1073,-30
79808685258,79808685264,6,2224,1124,-30
79809544510,79809544513,3,2128,1455,-30
79816609097,79816609102,5,2448,1213,-30
79818935362,79818935367,5,2676,1191,-30
79821065538,79821065545,7,2262,1348,-30
79822064653,79822064658,5,1346,972,-30
79823257242,79823257243,1,1630,1203,-30
79823482201,79823482205,4,1724,1470,-30
79824384406,79824384406,0,1586,2319,-30
79825788149,79825788154,5,2279,876,-30
79831701319,79831701326,7,3221,1269,-30
79833877345,79833877331,-14,2042,984,-30
79834987435,79834987440,5,1544,1025,-30
79836163563,79836163569,6,1371,1250,-30
79836473041,79836473050,9,1854,993,-30
79836687837,79836687842,5,2918,955,-30
79839546259,79839546262,3,1274,979,-30
79843694722,79843694727,5,2496,1796,-30
79844045278,79844045281,3,1215,1104,-30
79845507054,79845507058,4,1612,1106,-30
79845869473,79845869480,7,1834,1575,-30
79850025901,79850025897,-4,1903,5748,-30
79850120833,79850120838,5,2299,1420,-30
79853800816,79853800819,3,14992,16775,-30
79855640598,79855640602,4,1813,874,-30
79857741982,79857741985,3,4107,2243,-30
79859068861,79859068866,5,3121,1841,-30
79862506015,79862506021,6,2185,947,-30
79864075014,79864075019,5,3418,1127,-30
79866961628,79866961634,6,2932,1542,-30
79867125239,79867125243,4,1736,1448,-30
79868949967,79868949973,6,1448,1441,-30
79872309765,79872309770,5,1216,913,-30
79875481949,79875481944,-5,22919,17309,-30
79876145603,79876145598,-5,1743,5470,-30
79881901706,79881901711,5,1799,836,-30
79882503681,79882503697,16,2596,1235,-30
79882620030,79882620037,7,8127,34997,-30
79884479717,79884479722,5,2095,1265,-30
79893770373,79893770380,7,3421,1297,-30
79894545729,79894545735,6,1973,1510,-30
79896463113,79896463116,3,2634,1289,-30
79896680157,79896680162,5,2682,1440,-30
79897609397,79897609396,-1,5742,6785,-30
79900417106,79900417110,4,1051,887,-30
79901815842,79901815846,4,1872,1388,-30
79907514117,79907514122,5,1925,1094,-30
79914368476,79914368481,5,2138,1291,-30
79915001071,79915001049,-22,1149,894,-30
79918021901,79918021906,5,1967,1196,-30
79923356794,79923356799,5,2354,972,-30
79925717471,79925717466,-5,978,2155,-30
79925809474,79925809478,4,1702,1426,-30
79928006478,79928006482,4,2256,1035,-30
79930515872,79930515878,6,2521,1079,-30
79931857398,79931857404,6,2543,1452,-30
79933348316,79933348321,5,2061,1348,-30
79939879863,79939879867,4,1604,1012,-30
79941098843,79941098837,-6,644,5377,-30
79941576859,79941576864,5,3589,1180,-30
79945256583,79945256589,6,2359,1380,-30
79947630924,79947630928,4,1671,1142,-30
79948322361,79948322346,-15,1301,683,-30
79949624474,79949624478,4,2401,1117,-30
79951089205,79951089211,6,2281,1368,-30
79951347606,79951347614,8,2367,1126,-30
79951399947,79951399949,2,3262,3523,-30
79951460367,79951460373,6,2116,1708,-30
79954747549,79954747553,4,2029,1074,-30
79955983388,79955983390,2,1978,979,-30
79957150077,79957150079,2,1070,606,-30
79957791525,79957791531,6,1830,1082,-30
79962044559,79962044560,1,975,1258,-30
79962229818,79962229823,5,2204,1262,-30
79962435641,79962435646,5,1875,1386,-30
79963623742,79963623746,4,2358,1041,-30
79965005911,79965005915,4,1540,1445,-30
79975694779,79975694784,5,2863,1461,-30
79978086640,79978086646,6,1317,814,-30
79978510153,79978510160,7,2468,1169,-30
79980753425,79980753429,4,2338,1151,-30
79984852041,79984852048,7,1723,1375,-30
79991576387,79991576393,6,1837,1416,-30
79992546675,79992546679,4,2210,994,-30
79993959421,79993959426,5,3023,1976,-30
80003358061,80003358069,8,7890,2678,-30
80003729228,80003729233,5,2464,1252,-30
80003983242,80003983228,-14,1060,817,-30
80009392573,80009392578,5,1378,813,-30
80011336328,80011336333,5,2428,1630,-30
80011644624,80011644610,-14,1805,767,-30
80013416682,80013416687,5,1882,1224,-30
80015930752,80015930758,6,2932,1492,-30
80017279501,80017279505,4,1249,1062,-30
80021149213,80021149214,1,1275,2198,-30
80022530605,80022530610,5,2415,900,-30
80024541142,80024541138,-4,1297,3403,-30
80025431066,80025431048,-18,1757,1436,-30
80025556343,80025556320,-23,933,1103,-30
80025582529,80025582534,5,2108,1504,-30
80026927295,80026927287,-8,937,473,-30
80029519699,80029519706,7,1721,1613,-30
80030373427,80030373430,3,2074,1463,-30
80031879431,80031879435,4,1840,1239,-30
80036325769,80036325775,6,4754,1460,-30
80036957405,80036957411,6,2350,1536,-30
80037025426,80037025430,4,2189,1258,-30
80037409239,80037409243,4,2093,1597,-30
80039675598,80039675602,4,1886,1428,-30
80040449393,80040449397,4,2377,1652,-30
80045968491,80045968496,5,1472,1137,-30
80049451498,80049451503,5,1972,1205,-30
80050167351,80050167355,4,2082,1364,-30
80051257676,80051257681,5,1734,1394,-30
80057034148,80057034151,3,2487,1461,-30
80057072822,80057072826,4,2761,1462,-30
80061052890,80061052895,5,2362,1077,-30
80063496426,80063496432,6,3264,1753,-30
80064918621,80064918624,3,2527,1312,-30
80065107817,80065107822,5,2725,1191,-30
80065435832,80065435838,6,3703,1496,-30
80073932849,80073932853,4,3101,1469,-30
80076436419,80076436425,6,2512,1001,-30
80078732834,80078732818,-16,2091,990,-30
80080653282,80080653286,4,2513,1086,-30
80082093999,80082094003,4,1830,1621,-30
80091341766,80091341775,9,657,239,-30
80095114879,80095114883,4,2005,1395,-30
80098456098,80098456102,4,1456,1278,-30
80099322868,80099322873,5,3036,1134,-30
80099610369,80099610375,6,2579,1385,-30
80102625470,80102625475,5,2803,1403,-30
80104437375,80104437371,-4,1436,3011,-30
80105459697,80105459702,5,2479,1167,-30
80106642846,80106642853,7,2356,1291,-30
80108824386,80108824391,5,1723,1256,-30
80109181390,80109181395,5,2353,1266,-30
80113519188,80113519192,4,2429,1754,-30
80115274893,80115274894,1,1229,975,-30
80119940150,80119940153,3,2445,1068,-30
80122877867,80122877873,6,2490,792,-30
80123171306,80123171313,7,3974,1232,-30
80125772404,80125772410,6,2663,1403,-30
80132407479,80132407482,3,1754,1672,-30
80132534582,80132534584,2,1495,1920,-30
80135633998,80135634003,5,2384,939,-30
80141593087,80141593090,3,1616,934,-30
80142591551,80142591555,4,2587,901,-30
80142813598,80142813579,-19,671,250,-30
80143807163,80143807168,5,1857,1189,-30
80145792747,80145792751,4,1232,704,-30
80148332061,80148332063,2,1687,996,-30
80153148962,80153148969,7,1853,944,-30
80155761284,80155761287,3,1966,1514,-30
80156064285,80156064290,5,2163,1114,-30
80166581676,80166581676,0,1414,1984,-30
80167926699,80167926697,-2,826,2790,-30
80173272634,80173272640,6,2793,1035,-30
80176317639,80176317645,6,2238,1256,-30
80180213308,80180213313,5,2505,1318,-30
80180921853,80180921853,0,2720,4576,-30
80185834767,80185834773,6,2423,1588,-30
80188835840,80188835848,8,2716,1418,-30
80190032331,80190032338,7,1951,1324,-30
80192951482,80192951482,0,1355,1589,-30
80195660607,80195660610,3,2420,1015,-30
80196545174,80196545177,3,927,167,-30
80197928906,80197928913,7,1733,1728,-30
80201130151,80201130157,6,1913,1271,-30
80202723607,80202723601,-6,2030,6829,-30
80209320821,80209320826,5,2093,1123,-30
80209357662,80209357668,6,2242,1547,-30
80212060305,80212060310,5,1610,816,-30
80212548713,80212548719,6,2007,992,-30
80213780069,80213780072,3,1416,1500,-30
80215561555,80215561558,3,1582,1007,-30
80219177245,80219177250,5,3107,1154,-30
80222914403,80222914407,4,1785,1217,-30
80226747474,80226747476,2,2487,1385,-30
80228549661,80228549669,8,2628,1372,-30
80230138958,80230138963,5,2206,1010,-30
80234469333,80234469317,-16,2384,1435,-30
80235179200,80235179207,7,2509,1353,-30
80236061030,80236061035,5,2618,1283,-30
80236980299,80236980304,5,1849,1124,-30
80240342225,80240342229,4,2298,1669,-30
80243447689,80243447697,8,2349,1118,-30
80243954427,80243954424,-3,1438,1964,-30
80246191217,80246191221,4,3260,1952,-30
80247513601,80247513607,6,3386,1277,-30
80249422201,80249422206,5,1844,1487,-30
80249497794,80249497776,-18,1518,1037,-30
80251065882,80251065885,3,1766,1412,-30
80254504991,80254504997,6,2112,1601,-30
80254945204,80254945207,3,2633,1751,-30
80255276053,80255276058,5,2583,1140,-30
80256897616,80256897622,6,2770,848,-30
80257213978,80257213961,-17,2184,1576,-30
80259107219,80259107222,3,2608,1692,-30
80262203636,80262203641,5,2284,1481,-30
80262983802,80262983814,12,12650,47346,-30
80263719061,80263719066,5,2404,1474,-30
80266145725,80266145729,4,1889,1297,-30
80270244228,80270244234,6,5741,815,-30
80272900031,80272900035,4,2624,1828,-30
80276621033,80276621036,3,1857,926,-30
80277362138,80277362130,-8,1072,205,-30
80278522862,80278522867,5,1989,968,-30
80278632654,80278632659,5,2527,1368,-30
80279206171,80279206175,4,2713,1093,-30
80281498130,80281498135,5,1326,1007,-30
80287953696,80287953701,5,2108,1083,-30
80290430609,80290430614,5,1495,834,-30
80292365257,80292365264,7,2425,1542,-30
80292958588,80292958595,7,1632,880,-30
80293262646,80293262651,5,2829,1778,-30
80296142357,80296142360,3,1894,1440,-30
80297130488,80297130493,5,1725,1525,-30
80297928705,80297928710,5,3159,1422,-30
80302620405,80302620410,5,2571,1279,-30
80303852557,80303852563,6,1646,1057,-30
80306886567,80306886571,4,2081,1642,-30
80312553957,80312553960,3,2728,1681,-30
80312659798,80312659804,6,1953,1036,-30
80315378252,80315378258,6,3495,1524,-30
80315434651,80315434634,-17,2538,1528,-30
80315775209,80315775214,5,1955,1055,-30
80319788182,80319788186,4,3076,2227,-30
80320773961,80320773963,2,1789,1502,-30
80326464773,80326464776,3,1781,1241,-30
80328170394,80328170397,3,2448,1742,-30
80332744591,80332744595,4,1124,986,-30
80333544720,80333544723,3,1869,1855,-30
80334309426,80334309431,5,1833,1212,-30
80334646980,80334646986,6,2094,1265,-30
80336326506,80336326510,4,1761,1166,-30
80342253918,80342253923,5,1676,981,-30
80342934413,80342934393,-20,1142,353,-30
80343621722,80343621727,5,2259,1317,-30
80346606877,80346606881,4,1156,1148,-30
80347877097,80347877102,5,1535,1434,-30
80349822953,80349822957,4,3328,1651,-30
80356104666,80356104671,5,2321,1790,-30
80358055898,80358055902,4,2870,1256,-30
80358176434,80358176439,5,2971,1313,-30
80361822946,80361822950,4,2752,1424,-30
80361859526,80361859525,-1,1058,1274,-30
80363358675,80363358684,9,2447,1484,-30
80363520472,80363520476,4,1288,1326,-30
80364449382,80364449386,4,2768,1438,-30
80364884155,80364884162,7,2830,1284,-30
80365237176,80365237171,-5,23699,74526,-30
80372680077,80372680072,-5,1145,5051,-30
80372996462,80372996459,-3,2742,5389,-30
80375033693,80375033698,5,1432,664,-30
80375204347,80375204344,-3,22187,10751,-30
80379140353,80379140358,5,1938,1512,-30
80380294257,80380294263,6,1641,830,-30
80380649602,80380649606,4,2343,1148,-30
80384922697,80384922701,4,3026,1466,-30
80389106410,80389106414,4,2554,1825,-30
80395316402,80395316407,5,3124,2070,-30
80398002230,80398002235,5,2328,1109,-30
80400460534,80400460538,4,1571,1785,-30
80401802166,80401802170,4,2584,1682,-30
80404232879,80404232883,4,1415,1028,-30
80404552945,80404552950,5,1376,1230,-30
80408839237,80408839242,5,3276,1683,-30
80410342516,80410342520,4,2505,1692,-30
80410934947,80410934953,6,2214,1578,-30
80412300743,80412300743,0,1558,1907,-30
80412580962,80412580967,5,2047,930,-30
80414613346,80414613353,7,2383,1405,-30
80414885610,80414885609,-1,17189,24964,-30
80417441646,80417441651,5,2282,1178,-30
80417517384,80417517391,7,2923,1093,-30
80420502268,80420502272,4,1564,835,-30
80421465419,80421465424,5,2293,1087,-30
80421922527,80421922533,6,2701,1387,-30
80423323245,80423323251,6,2099,1028,-30
80423544159,80423544168,9,1052,1209,-30
80424018233,80424018250,17,26,1201,-30
80425844181,80425844185,4,2239,1572,-30
80429158979,80429158982,3,2141,1638,-30
80435959934,80435959939,5,949,733,-30
80438550546,80438550543,-3,1379,2987,-30
80440430965,80440430970,5,1608,1190,-30
80442479982,80442479986,4,1759,899,-30
80444317429,80444317434,5,2321,1320,-30
80444879063,80444879068,5,2447,1088,-30
80446374869,80446374875,6,2591,1319,-30
80448903207,80448903205,-2,1179,1812,-30
80449879541,80449879545,4,1923,1391,-30
80449932218,80449932235,17,13857,48449,-30
80450057493,80450057497,4,874,109,-30
80457452968,80457452968,0,61649,51371,-30
80459638060,80459638065,5,2733,1350,-30
80459859901,80459859905,4,2664,1162,-30
80460478943,80460478939,-4,624,62,-30
80461621469,80461621474,5,2125,1290,-30
80463402870,80463402875,5,2744,1430,-30
80463812142,80463812145,3,1909,982,-30
80472492675,80472492679,4,2198,1220,-30
80472762986,80472762991,5,2222,1342,-30
80472868322,80472868327,5,2299,1473,-30
80475589703,80475589696,-7,1305,972,-30
80481619029,80481619034,5,1533,815,-30
80485081758,80485081762,4,1991,1386,-30
80485570034,80485570042,8,2490,1132,-30
80487522529,80487522535,6,2396,1011,-30
80488268719,80488268726,7,1370,928,-30
80489001971,80489001978,7,2229,1172,-30
80489558722,80489558726,4,1729,1403,-30
80494425557,80494425561,4,2464,1150,-30
80498362674,80498362677,3,9292,7876,-30
80498619530,80498619534,4,3532,1396,-30
80500141054,80500141055,1,816,740,-30
80504335178,80504335183,5,1734,1120,-30
80506213946,80506213951,5,3133,2195,-30
80507205244,80507205250,6,3072,1328,-30
80507374490,80507374476,-14,2299,1308,-30
80510311054,80510311059,5,2267,1850,-30
80512279406,80512279411,5,2586,1485,-30
80516952826,80516952827,1,1478,1729,-30
80523516672,80523516677,5,1683,1355,-30
80529044282,80529044282,0,1592,1506,-30
80529643041,80529643046,5,1937,1601,-30
80533579934,80533579941,7,2193,1275,-30
80534713664,80534713670,6,2220,1356,-30
80535082510,80535082513,3,1448,1026,-30
80539625941,80539625927,-14,1247,742,-30
80540612977,80540612981,4,3017,1504,-30
80541675483,80541675487,4,1968,1328,-30
80542502202,80542502207,5,2761,1275,-30
80542578148,80542578163,15,2454,1235,-30
80544123894,80544123899,5,1894,1264,-30
80544567779,80544567781,2,2420,1706,-30
80545960270,80545960276,6,3352,1913,-30
80552129243,80552129249,6,2106,918,-30
80552425833,80552425838,5,2267,944,-30
80554922194,80554922215,21,1548,2235,-30
80559763347,80559763330,-17,1788,854,-30
80560800722,80560800726,4,2102,1229,-30
80561743650,80561743653,3,1950,1164,-30
80563110470,80563110477,7,1885,1234,-30
80567965703,80567965699,-4,881,436,-30
80571210129,80571210133,4,1816,1372,-30
80574498300,80574498305,5,1867,1164,-30
80577753211,80577753217,6,2823,1770,-30
80578797561,80578797566,5,2540,1440,-30
80579997041,80579997051,10,37654,11445,-30
80581289035,80581289040,5,2285,1808,-30
80586605531,80586605533,2,2185,1420,-30
80586910717,80586910722,5,2593,1836,-30
80587012020,80587012018,-2,1200,1817,-30
80591967152,80591967157,5,2900,1285,-30
80595510499,80595510503,4,2029,1217,-30
80595602936,80595602939,3,2168,927,-30
80595694541,80595694545,4,2707,1214,-30
80596965589,80596965591,2,1469,1277,-30
80600267122,80600267126,4,2031,1544,-30
80602903316,80602903320,4,2338,1180,-30
80603418215,80603418222,7,2988,1491,-30
80603534113,80603534118,5,2085,1468,-30
80603848066,80603848070,4,1322,603,-30
80609780014,80609780019,5,1583,1303,-30
80611510386,80611510390,4,1822,873,-30
80612184130,80612184133,3,1974,1558,-30
80613899765,80613899770,5,1986,1308,-30
80615305126,80615305133,7,3314,1328,-30
80617167107,80617167115,8,1995,1102,-30
80621277113,80621277110,-3,1326,2842,-30
80621671004,80621671008,4,2147,1785,-30
80625148189,80625148194,5,2082,1224,-30
80628816931,80628816935,4,2243,1532,-30
80630878764,80630878769,5,2515,1384,-30
80631555693,80631555691,-2,960,247,-30
80634992048,80634992054,6,2262,784,-30
80636567685,80636567688,3,1729,1591,-30
80636944728,80636944711,-17,762,181,-30
80641460077,80641460082,5,2245,1066,-30
80641780154,80641780159,5,2921,1740,-30
80643668103,80643668107,4,2471,947,-30
80644054449,80644054454,5,1348,1073,-30
80644466950,80644466954,4,1907,1667,-30
80645096078,80645096085,7,1908,951,-30
80645270557,80645270538,-19,3024,1364,-30
80650928072,80650928057,-15,2819,1057,-30
80657710541,80657710546,5,2350,1068,-30
80658212077,80658212081,4,2014,1253,-30
80658945701,80658945707,6,2376,1066,-30
80659427953,80659427958,5,2286,1622,-30
80663967474,80663967480,6,1557,1171,-30
80665741093,80665741098,5,2508,1327,-30
80668527503,80668527510,7,2139,1091,-30
80668555626,80668555609,-17,2002,936,-30
80669634850,80669634833,-17,1975,946,-30
80669909893,80669909898,5,2446,1466,-30
80673167034,80673167037,3,2693,1901,-30
80673848906,80673848911,5,2740,1336,-30
80675897626,80675897633,7,3070,1562,-30
80676928591,80676928597,6,2503,1618,-30
80678072858,80678072844,-14,880,319,-30
80678294080,80678294077,-3,3273,7947,-30
80680219190,80680219195,5,2056,1171,-30
80683117327,80683117331,4,1973,1187,-30
80683293279,80683293285,6,2567,1721,-30
80686193617,80686193622,5,2739,1077,-30
80687867957,80687867963,6,3003,1738,-30
80691885510,80691885515,5,2541,1618,-30
80695404907,80695404886,-21,1236,785,-30
80695594446,80695594450,4,2874,1726,-30
80699356541,80699356546,5,1499,1685,-30
80699439801,80699439801,0,1890,2703,-30
80700947002,80700947003,1,1274,969,-30
80701246018,80701246023,5,2023,1340,-30
80701761865,80701761870,5,2313,1132,-30
80705921033,80705921037,4,1909,1374,-30
80708539549,80708539545,-4,651,2913,-30
80710123970,80710123974,4,1629,890,-30
80713038726,80713038731,5,1446,1266,-30
80714191545,80714191550,5,2581,1274,-30
80718395329,80718395313,-16,268,1026,-30
80719924430,80719924435,5,2412,1948,-30
80723351895,80723351899,4,1803,1337,-30
80725092191,80725092195,4,2076,1096,-30
80725151486,80725151491,5,2471,1098,-30
80725263413,80725263417,4,2297,1169,-30
80726154130,80726154135,5,1580,1090,-30
80730521701,80730521705,4,2732,1539,-30
80730933418,80730933426,8,1111,940,-30
80731251361,80731251365,4,1807,1328,-30
80732286566,80732286570,4,1901,1234,-30
80732384254,80732384263,9,1278,1809,-30
80737971706,80737971710,4,2174,1494,-30
80741247067,80741247073,6,2440,1135,-30
80750797724,80750797726,2,1957,1609,-30
80754476693,80754476678,-15,876,320,-30
80755763949,80755763954,5,3358,1682,-30
80757376395,80757376398,3,2471,1244,-30
80757788510,80757788514,4,3331,1683,-30
80758194230,80758194227,-3,854,1580,-30
80760411930,80760411935,5,2149,1209,-30
80761493930,80761493933,3,1907,1210,-30
80769828862,80769828863,1,9142,9424,-30
80772944194,80772944197,3,1759,799,-30
80774045371,80774045375,4,1747,937,-30
80776413461,80776413465,4,2192,1208,-30
80777090252,80777090255,3,1519,872,-30
80781077632,80781077636,4,3469,2260,-30
80785506407,80785506411,4,2083,953,-30
80787717067,80787717075,8,3026,1597,-30
80787758445,80787758426,-19,2192,1160,-30
80789018378,80789018381,3,3220,1920,-30
80795602066,80795602070,4,2471,1202,-30
80796181554,80796181561,7,2674,1508,-30
80798399429,80798399434,5,2659,1843,-30
80799184805,80799184784,-21,2368,1128,-30
80799615044,80799615049,5,2348,1338,-30
80799728838,80799728842,4,2077,1309,-30
80799964237,80799964223,-14,30318,18874,-30
80801491162,80801491167,5,1587,1374,-30
80802297073,80802297078,5,2567,1956,-30
80806338897,80806338902,5,2621,1755,-30
80806747502,80806747506,4,1746,1161,-30
80807935816,80807935822,6,2560,1368,-30
80808012687,80808012690,3,2508,1221,-30
80810722821,80810722826,5,2747,1108,-30
80811697541,80811697545,4,1828,1078,-30
80812360882,80812360887,5,3349,1396,-30
80813463765,80813463770,5,2795,1274,-30
80813966758,80813966764,6,2428,2107,-30
80814033995,80814034001,6,2246,1465,-30
80815546902,80815546906,4,2533,1250,-30
80816712413,80816712418,5,2505,1348,-30
80818514246,80818514253,7,2716,1652,-30
80821488450,80821488454,4,2338,1903,-30
80826028841,80826028848,7,3396,1199,-30
80826132166,80826132166,0,26833,30134,-30
80828118542,80828118546,4,2496,1433,-30
80828541077,80828541082,5,2725,1026,-30
80829286374,80829286354,-20,1218,351,-30
80830397016,80830397023,7,2413,1234,-30
80830617640,80830617645,5,2248,1301,-30
80835972712,80835972715,3,2416,1694,-30
80839687097,80839687102,5,3275,1912,-30
80843101672,80843101677,5,2636,1400,-30
80843739054,80843739047,-7,1264,3678,-30
80844172025,80844172006,-19,1178,407,-30
80845945335,80845945341,6,2355,962,-30
80848206456,80848206460,4,2744,1320,-30
80848656439,80848656445,6,3613,1908,-30
80848991903,80848991910,7,2647,1229,-30
80850362899,80850362903,4,2358,1413,-30
80853587267,80853587273,6,1801,1426,-30
80860006305,80860006311,6,2180,1473,-30
80862196566,80862196573,7,3007,1523,-30
80863222006,80863222007,1,2641,2989,-30
80864480780,80864480778,-2,1548,2995,-30
80866775681,80866775686,5,1863,1010,-30
80870344747,80870344743,-4,1103,1937,-30
80875119804,80875119809,5,2413,2061,-30
80876734537,80876734541,4,2467,1109,-30
80877700774,80877700778,4,2073,1424,-30
80880564605,80880564610,5,2049,1431,-30
80883278539,80883278545,6,4589,2965,-30
80887131596,80887131601,5,1563,1009,-30
80888056827,80888056830,3,3213,3500,-30
80889315708,80889315711,3,2641,1737,-30
80894116401,80894116407,6,2767,1366,-30
80895744960,80895744968,8,2013,1043,-30
80896806991,80896806997,6,2584,1283,-30
80899417189,80899417195,6,2791,1337,-30
80904142022,80904142028,6,2228,1353,-30
80911119577,80911119581,4,2971,1594,-30
80915857315,80915857323,8,3052,1740,-30
80921041829,80921041833,4,1416,792,-30
80928256323,80928256329,6,1042,963,-30
80929411034,80929411039,5,2577,1441,-30
80930944394,80930944399,5,2576,1275,-30
80932846017,80932846024,7,2258,1613,-30
80935076627,80935076634,7,2294,1730,-30
80936232265,80936232269,4,2382,1669,-30
80940500693,80940500698,5,1957,1079,-30
80940556573,80940556580,7,2046,1236,-30
80945253610,80945253616,6,1303,654,-30
80947182958,80947182961,3,1810,768,-30
80947270454,80947270459,5,967,805,-30
80949542510,80949542514,4,1800,1391,-30
80952081356,80952081361,5,2568,866,-30
80952803744,80952803750,6,1994,1480,-30
80953108385,80953108390,5,2237,1549,-30
80955382175,80955382179,4,2717,1323,-30
80957145513,80957145519,6,3333,1089,-30
80957182578,80957182581,3,2577,1333,-30
80961696589,80961696597,8,2405,1167,-30
80962164103,80962164105,2,1297,1352,-30
80964918199,80964918206,7,2926,899,-30
80964974835,80964974819,-16,2006,879,-30
80966124913,80966124918,5,2280,1470,-30
80966885182,80966885185,3,1793,1756,-30
80971036090,80971036089,-1,829,1815,-30
80974566258,80974566266,8,3057,1434,-30
80977930283,80977930289,6,2518,1098,-30
80978985778,80978985782,4,2155,1270,-30
80979946093,80979946098,5,1469,1147,-30
80982306090,80982306095,5,2021,1215,-30
80982977545,80982977542,-3,1396,1838,-30
80988315458,80988315463,5,2292,1678,-30
80988563527,80988563532,5,2127,1602,-30
80989547552,80989547555,3,2081,1337,-30
80989904866,80989904870,4,1958,998,-30
80990449263,80990449259,-4,790,290,-30
80993811927,80993811931,4,1872,1134,-30
80994937308,80994937313,5,2108,1590,-30
80995970560,80995970565,5,2553,1271,-30
80996057473,80996057477,4,2084,1453,-30
80996885361,80996885366,5,1776,1576,-30
81005490629,81005490635,6,1722,1405,-30
81005996892,81005996895,3,2989,2312,-30
81006290322,81006290327,5,2476,1052,-30
81009246182,81009246186,4,3459,1986,-30
81009327786,81009327791,5,2520,1255,-30
81011378294,81011378298,4,2724,1315,-30
81016842515,81016842519,4,1615,1431,-30
81017609206,81017609211,5,2899,1695,-30
81025206605,81025206599,-6,1573,5410,-30
81026745306,81026745314,8,2351,910,-30
81028744013,81028744020,7,2068,1301,-30
81029048164,81029048166,2,3429,2766,-30
81029225714,81029225718,4,2389,1689,-30
81031507056,81031507060,4,9679,6035,-30
81033160985,81033160990,5,2394,1185,-30
81033912685,81033912690,5,2127,867,-30
81034739566,81034739570,4,965,1230,-30
81036778685,81036778691,6,2820,1416,-30
81038306247,81038306246,-1,1236,1773,-30
81038692315,81038692316,1,4202,4737,-30
81043111543,81043111546,3,2094,1195,-30
81043190454,81043190460,6,2792,1408,-30
81047277075,81047277079,4,1978,958,-30
81048556331,81048556338,7,2053,1169,-30
81048809702,81048809708,6,1926,1290,-30
81049423337,81049423341,4,2011,1661,-30
81050615818,81050615823,5,2130,1162,-30
81053971430,81053971434,4,1848,1306,-30
81055942181,81055942182,1,3458,2683,-30
81056591985,81056591991,6,2608,1089,-30
81058470710,81058470714,4,3642,1581,-30
81058638123,81058638128,5,2821,1211,-30
81062548336,81062548339,3,1999,1010,-30
81064933592,81064933599,7,3005,1323,-30
81068846556,81068846562,6,2534,1476,-30
81070656380,81070656381,1,7110,9340,-30
81071330561,81071330566,5,2503,1118,-30
81073480573,81073480579,6,2634,1710,-30
81075046053,81075046058,5,2864,1224,-30
81076191610,81076191615,5,1478,808,-30
81077978366,81077978371,5,1666,1332,-30
81080532418,81080532414,-4,1647,4015,-30
81082950262,81082950268,6,2533,1445,-30
81082979757,81082979761,4,2598,1544,-30
81098121215,81098121221,6,2310,1199,-30
81100077742,81100077745,3,2047,1421,-30
81100418826,81100418830,4,1514,1019,-30
81101066886,81101066892,6,1715,1349,-30
81104046489,81104046486,-3,1685,3753,-30
81105757551,81105757553,2,1330,1217,-30
81106789239,81106789242,3,2174,2071,-30
81110991894,81110991894,0,1572,1593,-30
81113241413,81113241419,6,2995,1239,-30
81115381756,81115381763,7,2224,934,-30
81115474142,81115474139,-3,514,3528,-30
81120240976,81120240980,4,1470,1487,-30
81121119937,81121119938,1,1391,1622,-30
81125254842,81125254848,6,2314,1294,-30
81125315894,81125315899,5,1828,1108,-30
81126905545,81126905550,5,1949,1417,-30
81129998615,81129998613,-2,2268,5578,-30
81133590806,81133590810,4,1812,1392,-30
81137429402,81137429407,5,2107,970,-30
81139623883,81139623887,4,1351,672,-30
81145331515,81145331521,6,2055,990,-30
81145961002,81145961007,5,2397,1384,-30
81157826432,81157826435,3,1241,824,-30
81157881018,81157881022,4,2167,1617,-30
81158294849,81158294850,1,1723,1806,-30
81161597313,81161597317,4,3432,1786,-30
81161829330,81161829338,8,1531,1165,-30
81163328950,81163328954,4,1446,975,-30
81165382918,81165382924,6,1958,1374,-30
81169859690,81169859697,7,1673,1053,-30
81170214373,81170214394,21,1930,1042,-30
81171049253,81171049236,-17,2501,1203,-30
81173423147,81173423151,4,1705,1131,-30
81174827039,81174827043,4,1155,886,-30
81176096747,81176096748,1,1807,1606,-30
81180948464,81180948470,6,2702,1333,-30
81186414581,81186414586,5,3195,1332,-30
81188328745,81188328751,6,1762,916,-30
81189395151,81189395154,3,2286,1013,-30
81190252146,81190252151,5,2272,1121,-30
81194202178,81194202182,4,1335,1413,-30
81199597841,81199597846,5,2304,1463,-30
81205461401,81205461405,4,1769,1200,-30
81206927695,81206927699,4,2754,1082,-30
81207321323,81207321323,0,895,234,-30
81207837140,81207837154,14,2430,1046,-30
81208456342,81208456321,-21,1334,1642,-30
81208884784,81208884790,6,2484,1409,-30
81210282469,81210282474,5,2675,1186,-30
81215783806,81215783811,5,2296,1221,-30
81216675712,81216675711,-1,2570,3144,-30
81219328013,81219328018,5,1713,1051,-30
81220229195,81220229202,7,2131,900,-30
81224526777,81224526783,6,2803,1324,-30
81226534901,81226534905,4,2774,1404,-30
81230982352,81230982368,16,236,1272,-30
81231207004,81231206984,-20,2112,1117,-30
81231600852,81231600856,4,1984,1558,-30
81236992579,81236992583,4,1711,1279,-30
81239978430,81239978434,4,2396,1448,-30
81240143987,81240143993,6,2793,1552,-30
81241042000,81241042006,6,2468,1497,-30
81241598023,81241598030,7,3194,1384,-30
81244872749,81244872753,4,2325,1363,-30
81245117224,81245117240,16,1622,1128,-30
81246161026,81246161033,7,2642,1187,-30
81247862027,81247862033,6,1950,1194,-30
81248472746,81248472751,5,2543,1272,-30
81249196122,81249196127,5,2617,1249,-30
81249295511,81249295517,6,2023,1336,-30
81255726179,81255726183,4,2942,1080,-30
81256647609,81256647610,1,12151,11671,-30
81261938663,81261938665,2,1187,1617,-30
81263919165,81263919169,4,2416,1703,-30
81264494616,81264494621,5,1870,1005,-30
81265938289,81265938294,5,1510,1175,-30
81266887074,81266887077,3,1502,1071,-30
81267112363,81267112369,6,1404,813,-30
81269568251,81269568254,3,1358,1094,-30
81269672598,81269672603,5,1542,1079,-30
81270118865,81270118869,4,2066,1323,-30
81271489647,81271489650,3,2815,1319,-30
81274605935,81274605939,4,2037,1433,-30
81277762335,81277762340,5,2764,1460,-30
81279495285,81279495290,5,1771,1107,-30
81283050714,81283050719,5,2082,1326,-30
81283657660,81283657664,4,2069,1303,-30
81286969750,81286969754,4,2727,1977,-30
81289050728,81289050731,3,2185,981,-30
81296136422,81296136422,0,1294,2000,-30
81297433334,81297433338,4,1826,1134,-30
81304061069,81304061072,3,1812,1240,-30
81304318199,81304318187,-12,873,53,-30
81306549035,81306549040,5,3065,1677,-30
81307340170,81307340175,5,2636,1103,-30
81307724567,81307724571,4,2129,1290,-30
81308482579,81308482586,7,4010,842,-30
81313011879,81313011883,4,2191,1432,-30
81316572159,81316572163,4,2460,1311,-30
81328654809,81328654814,5,2157,955,-30
81334726882,81334726889,7,2289,1120,-30
81334921191,81334921169,-22,527,494,-30
81337938770,81337938777,7,1155,956,-30
81339291238,81339291241,3,1131,1302,-30
81339317425,81339317433,8,2448,947,-30
81340067749,81340067754,5,1848,1085,-30
81341813323,81341813329,6,2318,1185,-30
81345591679,81345591685,6,2093,1239,-30
81356837526,81356837529,3,1104,1049,-30
81357319803,81357319798,-5,1347,4392,-30
81360533286,81360533289,3,2040,1040,-30
81362759095,81362759100,5,1998,1570,-30
81364330957,81364330963,6,2651,1303,-30
81364829047,81364829051,4,2020,1744,-30
81366551306,81366551309,3,2220,1104,-30
81366692161,81366692154,-7,1164,4207,-30
81369477099,81369477111,12,12581,38257,-30
81372624910,81372624914,4,2389,1399,-30
81374282099,81374282104,5,1970,1101,-30
81378812105,81378812091,-14,1807,747,-30
81379247484,81379247488,4,2287,1803,-30
81380212941,81380212947,6,2073,989,-30
81383084865,81383084870,5,1825,1362,-30
81384879502,81384879506,4,2432,1305,-30
81385745284,81385745288,4,1908,1329,-30
81387224796,81387224789,-7,2227,7046,-30
81387737724,81387737727,3,2028,1088,-30
81391353075,81391353072,-3,1305,4295,-30
81391618632,81391618635,3,2380,1825,-30
81392982486,81392982491,5,1651,722,-30
81394354554,81394354558,4,3048,1427,-30
81397896370,81397896374,4,2163,1374,-30
81399334911,81399334919,8,1525,1455,-30
81399625697,81399625702,5,2107,1612,-30
81400363674,81400363680,6,2996,1787,-30
81400749718,81400749721,3,721,337,-30
81401612061,81401612066,5,2060,1149,-30
81411455575,81411455590,15,850,1945,-30
81412808821,81412808827,6,2619,1577,-30
81418098864,81418098847,-17,2160,877,-30
81423983943,81423983944,1,1986,1745,-30
81424340628,81424340631,3,1799,998,-30
81431910212,81431910218,6,2540,1115,-30
81434945494,81434945502,8,2565,974,-30
81442119652,81442119657,5,1053,903,-30
81444115499,81444115502,3,557,503,-30
81445407190,81445407201,11,2508,1699,-30
81446253220,81446253225,5,2747,1819,-30
81447524675,81447524674,-1,2183,1708,-30
81448425629,81448425633,4,1885,1583,-30
81462931749,81462931754,5,1811,996,-30
81463252806,81463252810,4,2489,1872,-30
81466270574,81466270579,5,1736,1270,-30
81467081090,81467081097,7,2112,1325,-30
81467832173,81467832177,4,1771,1337,-30
81468664983,81468664988,5,1425,833,-30
81475522186,81475522190,4,2224,1224,-30
81476053814,81476053817,3,2400,2118,-30
81476515442,81476515446,4,2492,1793,-30
81482123607,81482123611,4,1575,783,-30
81482494112,81482494118,6,2683,1090,-30
81482581996,81482582003,7,1671,950,-30
81487548654,81487548659,5,2940,1325,-30
81494364824,81494364827,3,1221,826,-30
81495006428,81495006431,3,2514,1135,-30
81495063830,81495063834,4,2013,1683,-30
81497338358,81497338363,5,3144,2089,-30
81499874390,81499874394,4,1176,903,-30
81500957889,81500957893,4,2700,1272,-30
81507549497,81507549505,8,2129,1134,-30
81510520771,81510520777,6,1580,1351,-30
81517731163,81517731169,6,2442,972,-30
81518367050,81518367054,4,2315,1294,-30
81518878926,81518878931,5,2290,1397,-30
81519894566,81519894572,6,2734,1427,-30
81521200764,81521200741,-23,1154,595,-30
81526354498,81526354494,-4,1851,4901,-30
81527054118,81527054122,4,2460,1178,-30
81528087334,81528087339,5,2688,1493,-30
81530194653,81530194659,6,1945,1088,-30
81531506703,81531506706,3,2053,2213,-30
81537870671,81537870675,4,2046,1373,-30
81538509281,81538509286,5,2042,1675,-30
81538549558,81538549563,5,3502,1868,-30
81541514789,81541514796,7,2003,1212,-30
81542828314,81542828320,6,1434,940,-30
81548209946,81548209950,4,2320,1420,-30
81551842080,81551842086,6,2857,1310,-30
81552986201,81552986207,6,2447,1353,-30
81559162125,81559162130,5,2629,1263,-30
81560332160,81560332158,-2,23557,15492,-30
81560657319,81560657324,5,2131,1424,-30
81562089109,81562089113,4,1330,1079,-30
81563691529,81563691537,8,1815,984,-30
81565379930,81565379935,5,2383,1747,-30
81567878552,81567878557,5,2219,1165,-30
81571472913,81571472914,1,1545,1070,-30
81576297340,81576297345,5,2443,1422,-30
81578564546,81578564542,-4,1238,2999,-30
81580381938,81580381946,8,3265,1572,-30
81582150607,81582150611,4,2447,1108,-30
81582184508,81582184520,12,2284,1322,-30
81583050191,81583050197,6,3324,1789,-30
81584120270,81584120277,7,2504,1693,-30
81588612304,81588612311,7,3305,1185,-30
81590499447,81590499450,3,2060,1285,-30
81592989421,81592989425,4,2577,1885,-30
81594882007,81594882011,4,1800,1154,-30
81595454180,81595454185,5,2800,1868,-30
81596485891,81596485872,-19,1767,1254,-30
81596972439,81596972440,1,1435,1693,-30
81600066136,81600066142,6,3423,1837,-30
81600293834,81600293837,3,1650,1082,-30
81604221129,81604221134,5,2035,881,-30
81608788317,81608788310,-7,1083,2411,-30
81610868466,81610868473,7,2214,1225,-30
81613272345,81613272350,5,2175,1336,-30
81613809393,81613809396,3,1997,1439,-30
81614589577,81614589570,-7,816,4047,-30
81615065796,81615065797,1,1102,732,-30
81615522478,81615522489,11,753,165,-30
81617700534,81617700541,7,2598,1238,-30
81617764806,81617764784,-22,1879,718,-30
81620906676,81620906683,7,2808,1250,-30
81621413033,81621413039,6,2031,1056,-30
81621995740,81621995745,5,1951,1654,-30
81622128262,81622128268,6,1946,1427,-30
81625638617,81625638623,6,1554,1125,-30
81625723689,81625723694,5,1581,1031,-30
81627110038,81627110042,4,2162,1418,-30
81627255361,81627255366,5,2155,1050,-30
81632507615,81632507613,-2,942,1673,-30
81633185251,81633185256,5,2134,1536,-30
81633792500,81633792506,6,2875,1034,-30
81635910014,81635910018,4,1716,985,-30
81637657375,81637657379,4,1518,1343,-30
81642228265,81642228269,4,2038,1119,-30
81644046029,81644046034,5,1140,995,-30
81644256511,81644256489,-22,765,320,-30
81644511907,81644511913,6,2100,1523,-30
81644796118,81644796099,-19,1414,1103,-30
81646691526,81646691530,4,2343,1506,-30
81647854945,81647854946,1,1480,1250,-30
81648653221,81648653226,5,1265,705,-30
81649373453,81649373456,3,2477,1747,-30
81649418291,81649418297,6,1458,967,-30
81654038530,81654038535,5,1843,969,-30
81659569662,81659569668,6,2852,1622,-30
81660497668,81660497673,5,1305,810,-30
81662086126,81662086133,7,2375,2136,-30
81665302257,81665302262,5,2075,1172,-30
81665558900,81665558905,5,2365,1117,-30
81665664605,81665664626,21,1395,1041,-30
81665981705,81665981688,-17,448,56,-30
81666752605,81666752611,6,2154,1501,-30
81668327812,81668327816,4,2690,1523,-30
81676765996,81676766003,7,1915,1083,-30
81679368966,81679368970,4,2473,1242,-30
81679780418,81679780421,3,2209,1547,-30
81682851319,81682851324,5,2456,1702,-30
81685449702,81685449708,6,2680,1603,-30
81692911318,81692911322,4,2268,1443,-30
81694657549,81694657555,6,2456,1178,-30
81696270083,81696270087,4,1763,1713,-30
81696871979,81696871985,6,2577,1602,-30
81699165629,81699165633,4,2687,1516,-30
81699721386,81699721390,4,2473,1338,-30
81700250194,81700250198,4,2808,1950,-30
81707314772,81707314778,6,2379,1169,-30
81708476065,81708476069,4,1677,1047,-30
81709272606,81709272610,4,1246,1056,-30
81710336166,81710336170,4,1650,1066,-30
81711164834,81711164839,5,1691,1099,-30
81712927039,81712927043,4,2500,1726,-30
81715780014,81715780019,5,1870,1248,-30
81716091889,81716091893,4,1631,985,-30
81719990809,81719990814,5,2872,1979,-30
81720621074,81720621076,2,1346,969,-30
81723367339,81723367343,4,2040,1338,-30
81723934213,81723934218,5,2424,1056,-30
81726232602,81726232606,4,2304,1122,-30
81728108019,81728108002,-17,3065,1405,-30
81730790679,81730790681,2,1824,1016,-30
81731735747,81731735750,3,2601,1552,-30
81739588571,81739588576,5,2642,2316,-30
81745268023,81745268027,4,1482,1219,-30
81745913002,81745913007,5,2481,1237,-30
81746692637,81746692641,4,1951,1536,-30
81749426117,81749426116,-1,1351,1825,-30
81750085863,81750085866,3,2575,1542,-30
81753118335,81753118340,5,2096,1154,-30
81753684242,81753684246,4,1970,1027,-30
81756868945,81756868950,5,2092,1287,-30
81759706923,81759706927,4,2302,1640,-30
81762343461,81762343443,-18,2955,1315,-30
81765456394,81765456401,7,2102,1971,-30
81767824162,81767824166,4,2706,1533,-30
81771310517,81771310521,4,1480,1210,-30
81772517731,81772517736,5,2458,1386,-30
81782527629,81782527633,4,2606,1424,-30
81783567407,81783567413,6,1085,847,-30
81784716206,81784716210,4,1730,1142,-30
81784901290,81784901294,4,2236,1951,-30
81786545518,81786545523,5,2640,1164,-30
81786581209,81786581215,6,1466,1388,-30
81787161757,81787161763,6,2437,1245,-30
81790008399,81790008405,6,2998,1833,-30
81792085855,81792085863,8,1083,782,-30
81793335909,81793335913,4,2203,1283,-30
81795808209,81795808213,4,2789,1816,-30
81797796186,81797796190,4,3034,1382,-30
81801199197,81801199202,5,2014,1321,-30
81802577044,81802577047,3,1796,946,-30
81808028470,81808028470,0,1275,2092,-30
81808667215,81808667220,5,2043,1205,-30
81812450610,81812450615,5,2245,1481,-30
81812697271,81812697278,7,2238,992,-30
81814198578,81814198583,5,1816,1114,-30
81818032695,81818032701,6,1128,1028,-30
81825749015,81825749020,5,1663,1055,-30
81827936256,81827936261,5,2963,1389,-30
81830139750,81830139757,7,2135,1376,-30
81834206034,81834206040,6,2385,1285,-30
81835617490,81835617494,4,2331,1466,-30
81838472617,81838472621,4,2598,2002,-30
81838972909,81838972915,6,1615,1337,-30
81840347125,81840347129,4,1938,954,-30
81842662079,81842662086,7,3366,1174,-30
81842767135,81842767138,3,1815,1430,-30
81844617427,81844617434,7,2651,1014,-30
81846203601,81846203606,5,2589,1988,-30
81848417565,81848417571,6,2562,999,-30
81848739754,81848739758,4,2447,1993,-30
81850987863,81850987869,6,2853,1660,-30
81851035331,81851035334,3,1668,1138,-30
81851870994,81851870998,4,1837,1361,-30
81857433146,81857433150,4,2340,1359,-30
81860559809,81860559813,4,2288,1228,-30
81869421318,81869421322,4,2371,2252,-30
81869644878,81869644882,4,2493,838,-30
81870555966,81870555971,5,1547,951,-30
81873841020,81873841025,5,2075,1104,-30
81875378414,81875378418,4,1973,1052,-30
81879022546,81879022550,4,2357,993,-30
81882985197,81882985200,3,2134,1041,-30
81883702909,81883702915,6,2240,1426,-30
81884845159,81884845166,7,1358,867,-30
81885911156,81885911161,5,2769,1484,-30
81887004981,81887004983,2,1684,1254,-30
81887368334,81887368312,-22,2889,1272,-30
81889840522,81889840517,-5,1073,3912,-30
81892541588,81892541594,6,2777,1268,-30
81895651395,81895651399,4,2526,1230,-30
81896565190,81896565173,-17,1415,898,-30
81897432818,81897432822,4,1983,1167,-30
81899754053,81899754058,5,2883,1135,-30
81900332173,81900332178,5,2049,1542,-30
81901187942,81901187947,5,1571,1292,-30
81910824704,81910824703,-1,1129,2002,-30
81914764733,81914764738,5,2344,1318,-30
81917731397,81917731404,7,2253,1302,-30
81920428120,81920428127,7,3728,1473,-30
81920684742,81920684752,10,1783,1203,-30
81921209026,81921209031,5,1898,1419,-30
81921338159,81921338165,6,2199,925,-30
81923356601,81923356606,5,1851,1181,-30
81923661577,81923661583,6,1558,709,-30
81925170930,81925170935,5,2691,1905,-30
81928194882,81928194886,4,3541,1737,-30
81929635141,81929635145,4,2087,1237,-30
81931041755,81931041761,6,3248,1571,-30
81932944562,81932944566,4,1963,1287,-30
81933724058,81933724061,3,1455,1159,-30
81934207004,81934207009,5,2295,1340,-30
81935346206,81935346212,6,3357,1725,-30
81940508612,81940508619,7,2162,1396,-30
81944454714,81944454717,3,1621,1273,-30
81944750785,81944750788,3,1272,1105,-30
81945575225,81945575230,5,2729,1375,-30
81948951362,81948951367,5,2484,1258,-30
81950263910,81950263915,5,2143,1158,-30
81951507847,81951507850,3,1288,1386,-30
81951977681,81951977686,5,1797,576,-30
81952087578,81952087582,4,5000,2899,-30
81956324074,81956324092,18,453,3549,-30
81956848291,81956848294,3,2219,1356,-30
81959356821,81959356825,4,2267,1598,-30
81961113088,81961113070,-18,1521,298,-30
81964343200,81964343206,6,1899,836,-30
81964935084,81964935067,-17,1177,280,-30
81965027976,81965027981,5,1728,1111,-30
81965415267,81965415272,5,2784,1531,-30
81966879857,81966879862,5,2629,1561,-30
81982703608,81982703604,-4,35202,11905,-30
81985048574,81985048581,7,1539,860,-30
81985371934,81985371939,5,2629,1534,-30
81986977791,81986977786,-5,857,3302,-30
81988980401,81988980406,5,2852,1177,-30
81989933630,81989933635,5,1958,764,-30
81997762434,81997762438,4,1960,978,-30
81997984272,81997984276,4,3016,1551,-30
82000115678,82000115686,8,2043,1327,-30
82001995326,82001995332,6,3586,1227,-30
82003299264,82003299269,5,2386,1043,-30
82018604826,82018604830,4,2228,928,-30
82019509637,82019509642,5,1804,991,-30
82027053366,82027053370,4,2000,787,-30
82032412739,82032412743,4,1527,1142,-30
82032512321,82032512322,1,1223,1322,-30
82036470100,82036470106,6,2649,1113,-30
82042633550,82042633555,5,2227,1358,-30
82045528017,82045528022,5,2676,1626,-30
82045640183,82045640187,4,2761,1524,-30
82046357339,82046357322,-17,1983,1855,-30
82051527013,82051527018,5,2482,1196,-30
82053136200,82053136202,2,2337,1124,-30
82055266283,82055266283,0,415,112,-30
82060441069,82060441074,5,3007,1586,-30
82061345333,82061345334,1,2117,1578,-30
82064902264,82064902267,3,2320,1625,-30
82064936461,82064936467,6,2403,1128,-30
82067921641,82067921646,5,3105,2127,-30
82082821702,82082821704,2,1606,1905,-30
82084358878,82084358883,5,1436,821,-30
82085524497,82085524500,3,2131,1745,-30
82089058673,82089058674,1,1922,1534,-30
82090585582,82090585586,4,1564,1538,-30
82092306588,82092306594,6,2122,838,-30
82092335863,82092335849,-14,1854,1137,-30
82092390258,82092390262,4,1976,1072,-30
82097199116,82097199122,6,1802,944,-30
82099960501,82099960504,3,918,1147,-30
82104124338,82104124341,3,1785,1697,-30
82106531123,82106531128,5,1778,1228,-30
82107658713,82107658718,5,1296,1069,-30
82113297515,82113297520,5,2969,1847,-30
82113766329,82113766325,-4,1259,4017,-30
82119044474,82119044478,4,2037,1980,-30
82121743117,82121743123,6,2072,1054,-30
82124235426,82124235440,14,1751,515,-30
82128625934,82128625938,4,2677,1477,-30
82135040527,82135040530,3,1367,994,-30
82136570127,82136570132,5,1891,1058,-30
82142922288,82142922286,-2,1213,1382,-30
82143043490,82143043495,5,1684,1227,-30
82145611473,82145611478,5,2055,784,-30
82146262586,82146262591,5,2466,1620,-30
82146586723,82146586726,3,2162,1485,-30
82149579855,82149579862,7,2408,1452,-30
82152204237,82152204242,5,1853,1426,-30
82156932890,82156932895,5,2296,1139,-30
82158443068,82158443064,-4,1769,3626,-30
82159216893,82159216899,6,1341,1121,-30
82161148797,82161148803,6,2600,1375,-30
82162574217,82162574220,3,7868,19540,-30
82166232402,82166232410,8,2848,1181,-30
82167208245,82167208250,5,1683,1357,-30
82170952913,82170952917,4,1842,1471,-30
82171445952,82171445950,-2,24048,66313,-30
82173023638,82173023642,4,2598,959,-30
82174518321,82174518322,1,1378,1084,-30
82175144834,82175144834,0,1032,1181,-30
82176926029,82176926033,4,2228,1497,-30
82176953478,82176953468,-10,3544,1477,-30
82177313905,82177313910,5,1882,822,-30
82188342399,82188342405,6,668,446,-30
82192162905,82192162909,4,2292,1497,-30
82194132025,82194132029,4,2415,1442,-30
82196308289,82196308292,3,1806,1099,-30
82197167423,82197167429,6,2373,999,-30
82203833586,82203833590,4,2709,1219,-30
82204482733,82204482738,5,2676,1223,-30
82205736298,82205736304,6,2546,1183,-30
82206829462,82206829466,4,1925,1265,-30
82211076915,82211076920,5,1902,1813,-30
82213172538,82213172542,4,2252,1485,-30
82216913879,82216913887,8,3053,1243,-30
82220304306,82220304313,7,1050,895,-30
82221346159,82221346164,5,1998,1314,-30
82224111867,82224111873,6,2442,1432,-30
82225166177,82225166182,5,2301,1657,-30
82226358113,82226358119,6,2392,1639,-30
82226538294,82226538299,5,2741,1312,-30
82232183234,82232183239,5,2769,1368,-30
82245264692,82245264694,2,1468,1735,-30
82245859422,82245859427,5,2274,1199,-30
82246261629,82246261635,6,3024,1047,-30
82251664822,82251664827,5,1825,1540,-30
82251726071,82251726077,6,3048,1617,-30
82256285662,82256285667,5,1736,891,-30
82257930859,82257930842,-17,2485,1609,-30
82260650789,82260650791,2,1450,1222,-30
82261984539,82261984545,6,2154,997,-30
82262807470,82262807474,4,1542,764,-30
82270277068,82270277073,5,2093,963,-30
82275332405,82275332410,5,2035,1060,-30
82276719290,82276719295,5,2246,1682,-30
82278362915,82278362922,7,2815,1094,-30
82279239457,82279239462,5,2422,1386,-30
82280307505,82280307510,5,2669,1896,-30
82284270597,82284270601,4,1507,1585,-30
82288852600,82288852603,3,1810,1367,-30
82290247791,82290247797,6,1497,934,-30
82292082169,82292082170,1,1541,1098,-30
82293564233,82293564238,5,2296,1294,-30
82294231158,82294231163,5,1943,903,-30
82294363632,82294363634,2,38969,25264,-30
82294513178,82294513182,4,5723,2995,-30
82296379793,82296379804,11,37,7371,-30
82296859238,82296859243,5,1712,935,-30
82307960013,82307959999,-14,1779,1451,-30
82310588430,82310588437,7,3057,1605,-30
82311284994,82311284987,-7,647,428,-30
82316061318,82316061333,15,438,1999,-30
82317753010,82317753017,7,2071,838,-30
82319093450,82319093457,7,2805,1498,-30
82320155456,82320155462,6,2421,1362,-30
82323871305,82323871311,6,1975,1366,-30
82325853449,82325853456,7,1918,1466,-30
82327813938,82327813943,5,3342,1616,-30
82328083019,82328083003,-16,747,1205,-30
82332781513,82332781518,5,1305,1041,-30
82332948446,82332948432,-14,696,415,-30
82337724725,82337724730,5,2401,1768,-30
82339058310,82339058313,3,1492,1668,-30
82346542114,82346542119,5,1985,1106,-30
82347089133,82347089147,14,2219,1438,-30
82349216671,82349216676,5,1549,820,-30
82355978889,82355978895,6,1427,851,-30
82358265648,82358265645,-3,2110,4450,-30
82359123065,82359123071,6,1920,866,-30
82359521717,82359521729,12,2674,1578,-30
82360853408,82360853414,6,1878,1193,-30
82363250636,82363250640,4,2283,1266,-30
82368652740,82368652746,6,2256,1130,-30
82368759999,82368760004,5,1288,1440,-30
82369244522,82369244529,7,1965,913,-30
82371526567,82371526574,7,2415,1594,-30
82375414353,82375414355,2,1392,879,-30
82375800895,82375800898,3,1325,1254,-30
82377413883,82377413883,0,1047,1227,-30
82379651670,82379651675,5,2558,875,-30
82380836117,82380836123,6,2114,1267,-30
82382703609,82382703614,5,2113,774,-30
82383208125,82383208130,5,2076,1237,-30
82383559073,82383559078,5,2067,1291,-30
82384457426,82384457431,5,2330,1038,-30
82386869698,82386869703,5,2228,1599,-30
82389885511,82389885515,4,3319,1792,-30
82390006456,82390006459,3,2152,1663,-30
82392101215,82392101222,7,3245,1648,-30
82392133996,82392134000,4,2477,1038,-30
82393641406,82393641405,-1,828,1872,-30
82394707567,82394707574,7,1900,1315,-30
82401704388,82401704395,7,2424,1290,-30
82401763805,82401763808,3,1687,661,-30
82407543004,82407543007,3,2241,1386,-30
82407848648,82407848653,5,2146,1445,-30
82409448370,82409448370,0,1697,1542,-30
82413712705,82413712710,5,2782,1909,-30
82415807539,82415807543,4,1234,944,-30
82418253906,82418253910,4,1507,1195,-30
82418885160,82418885165,5,2250,1328,-30
82419104949,82419104931,-18,2165,231,-30
82420712286,82420712293,7,2090,1693,-30
82421981809,82421981814,5,2084,1225,-30
82422687881,82422687865,-16,25,2358,-30
82424164277,82424164283,6,1713,1052,-30
82426349267,82426349273,6,2291,1336,-30
82426770639,82426770644,5,25008,61214,-30
82429864898,82429864902,4,1831,1178,-30
82431976665,82431976670,5,2177,1194,-30
82432475837,82432475833,-4,1732,5780,-30
82435816290,82435816294,4,3154,1674,-30
82436998998,82436999003,5,2140,1383,-30
82437061575,82437061581,6,2311,1661,-30
82439158786,82439158778,-8,44450,10478,-30
82441741967,82441741971,4,1913,1215,-30
82443888426,82443888435,9,2594,987,-30
82449774893,82449774900,7,2861,1161,-30
82452698981,82452699001,20,550,2578,-30
82452975355,82452975360,5,1877,1494,-30
82454660076,82454660082,6,2313,1320,-30
82456818449,82456818454,5,2183,1443,-30
82457811660,82457811667,7,2289,965,-30
82463055946,82463055950,4,2284,1257,-30
82464682909,82464682915,6,1637,1127,-30
82467545519,82467545522,3,2450,1888,-30
82474297622,82474297622,0,2750,3661,-30
82477707505,82477707510,5,2636,1664,-30
82477911846,82477911846,0,2125,1721,-30
82480749346,82480749352,6,1978,1082,-30
82482896663,82482896670,7,1684,1006,-30
82483209892,82483209898,6,2837,1539,-30
82489827388,82489827392,4,2128,1128,-30
82490833214,82490833218,4,2335,1635,-30
82491888367,82491888374,7,4346,1838,-30
82504922390,82504922397,7,2632,1445,-30
82507113004,82507113010,6,3610,1913,-30
82510432197,82510432201,4,1980,1387,-30
82511245026,82511245031,5,2687,1042,-30
82512382161,82512382165,4,2463,1506,-30
82512659065,82512659072,7,1636,1471,-30
82516928874,82516928879,5,3481,1722,-30
82520106699,82520106702,3,2069,993,-30
82520285794,82520285797,3,2042,1194,-30
82525466356,82525466362,6,2525,1011,-30
82525675264,82525675270,6,6693,2201,-30
82528920623,82528920628,5,2399,1484,-30
82530148674,82530148659,-15,2040,1318,-30
82531030854,82531030857,3,1369,1184,-30
82538800113,82538800118,5,2422,1209,-30
82540482007,82540482010,3,1235,1302,-30
82542497069,82542497075,6,2401,1279,-30
82549458394,82549458398,4,2199,1274,-30
82551884514,82551884520,6,2889,1432,-30
82552167669,82552167652,-17,2217,874,-30
82559918995,82559918992,-3,7362,14151,-30
82561123770,82561123777,7,2026,964,-30
82561490870,82561490875,5,1863,971,-30
82563303605,82563303609,4,1840,1026,-30
82563740838,82563740817,-21,1147,673,-30
82564017000,82564016993,-7,285,1471,-30
82565596478,82565596483,5,2108,1198,-30
82565855053,82565855035,-18,2148,964,-30
82567417950,82567417957,7,46292,19083,-30
82574351070,82574351063,-7,2635,8339,-30
82574384788,82574384794,6,2701,1318,-30
82579494466,82579494458,-8,606,1646,-30
82582207341,82582207345,4,1506,1100,-30
82583200456,82583200476,20,2164,1246,-30
82584050529,82584050534,5,2219,1301,-30
82584416413,82584416418,5,1635,1633,-30
82585498997,82585499003,6,2370,1346,-30
82585723690,82585723697,7,2703,1627,-30
82595974366,82595974370,4,2197,1200,-30
82599215965,82599215970,5,2499,1324,-30
82599280895,82599280901,6,2677,1662,-30
82600863027,82600863031,4,2262,1561,-30
82601046466,82601046471,5,2873,1146,-30
82608366134,82608366138,4,2303,1268,-30
82613354928,82613354931,3,1403,661,-30
82613535495,82613535481,-14,1029,322,-30
82613813969,82613813968,-1,1495,2712,-30
82624997625,82624997631,6,2237,1314,-30
82628273163,82628273167,4,2431,1335,-30
82629701618,82629701623,5,2522,1313,-30
82631286420,82631286422,2,1082,875,-30
82636460758,82636460763,5,1876,1434,-30
82636681452,82636681455,3,1639,909,-30
82639005406,82639005402,-4,1049,2633,-30
82644399054,82644399059,5,3344,1863,-30
82646620825,82646620830,5,2043,1106,-30
82653009410,82653009413,3,1642,1172,-30
82653559941,82653559947,6,1685,640,-30
82653986141,82653986145,4,2228,723,-30
82660549508,82660549512,4,2675,1392,-30
82660639741,82660639729,-12,1066,320,-30
82663045681,82663045678,-3,799,3273,-30
82665461953,82665461958,5,3011,1316,-30
82669129643,82669129647,4,2445,1123,-30
82670030802,82670030808,6,1842,1251,-30
82671447122,82671447127,5,2103,1140,-30
82675750781,82675750774,-7,1319,5266,-30
82679880014,82679880018,4,2468,1159,-30
82680228585,82680228589,4,3060,1610,-30
82680258535,82680258512,-23,1586,911,-30
82681843237,82681843242,5,2631,1266,-30
82683314067,82683314071,4,1837,784,-30
82683807425,82683807428,3,2000,1160,-30
82685981037,82685981042,5,2369,1706,-30
82690312452,82690312458,6,2659,1486,-30
82690598409,82690598417,8,3760,1378,-30
82691606069,82691606073,4,2878,2072,-30
82695006089,82695006094,5,1336,603,-30
82699277259,82699277265,6,2304,1400,-30
82699469757,82699469758,1,1632,1786,-30
82700447906,82700447911,5,2876,1741,-30
82703258125,82703258129,4,3005,1065,-30
82703764565,82703764568,3,887,705,-30
82704134238,82704134242,4,2426,1262,-30
82705465047,82705465051,4,1984,1027,-30
82710556337,82710556343,6,2439,1575,-30
82711012802,82711012810,8,2866,1377,-30
82715076186,82715076186,0,1093,1705,-30
82715284210,82715284215,5,1813,902,-30
82716081421,82716081417,-4,598,2429,-30
82716655765,82716655768,3,2562,1631,-30
82721319666,82721319671,5,2337,1193,-30
82723512243,82723512247,4,1510,1283,-30
82727910473,82727910478,5,2050,1288,-30
82729544885,82729544889,4,2291,1572,-30
82731501106,82731501111,5,1832,1133,-30
82731529912,82731529929,17,1739,1386,-30
82733780907,82733780910,3,1719,1657,-30
82743538938,82743538942,4,2601,1386,-30
82745726794,82745726798,4,1626,1314,-30
82748237740,82748237721,-19,2522,1419,-30
82751862295,82751862301,6,1963,1454,-30
82754162246,82754162251,5,2300,1120,-30
82756898139,82756898141,2,1905,1676,-30
82767586479,82767586485,6,2763,1567,-30
82769721378,82769721382,4,867,754,-30
82770467846,82770467851,5,2691,1161,-30
82771862149,82771862159,10,8817,30671,-30
82772449454,82772449458,4,2497,2098,-30
82773159791,82773159769,-22,1339,1129,-30
82774554358,82774554362,4,2838,1480,-30
82775709752,82775709759,7,3946,1526,-30
82776591169,82776591174,5,2011,778,-30
82781998902,82781998907,5,1774,1247,-30
82782523269,82782523274,5,2118,1204,-30
82782567119,82782567122,3,1106,199,-30
82782917482,82782917496,14,1151,219,-30
82784519764,82784519763,-1,1450,3163,-30
82784703737,82784703741,4,1124,576,-30
82785676439,82785676443,4,2562,927,-30
82785768006,82785768003,-3,1212,310,-30
82790143374,82790143379,5,3036,1004,-30
82794976512,82794976515,3,1948,1162,-30
82796247484,82796247486,2,2250,1419,-30
82797745574,82797745578,4,3649,2177,-30
82800370507,82800370511,4,3137,2093,-30
82803584050,82803584057,7,2262,1291,-30
82803711175,82803711178,3,3121,1348,-30
82805854295,82805854298,3,1993,1754,-30
82808339351,82808339354,3,2284,1247,-30
82809084114,82809084119,5,2096,1045,-30
82814281700,82814281707,7,2233,1459,-30
82817011107,82817011111,4,2643,1595,-30
82817513905,82817513912,7,2441,1103,-30
82819413464,82819413472,8,1796,1290,-30
82823637202,82823637222,20,2149,1530,-30
82825531211,82825531218,7,2095,941,-30
82833116961,82833116955,-6,1203,3454,-30
82835447879,82835447885,6,3042,1669,-30
82836444854,82836444859,5,1737,935,-30
82842600817,82842600823,6,2432,1148,-30
82843872851,82843872846,-5,1254,2810,-30
82846797838,82846797843,5,2694,1116,-30
82847711014,82847711019,5,1827,1321,-30
82849014649,82849014656,7,2509,1469,-30
82851508949,82851508955,6,1735,860,-30
82856245475,82856245483,8,2531,1081,-30
82859991596,82859991599,3,987,687,-30
82860783861,82860783867,6,2176,1284,-30
82862771145,82862771150,5,3108,1190,-30
82863166185,82863166186,1,1351,2389,-30
82863739951,82863739957,6,1753,1309,-30
82864951132,82864951134,2,1487,1621,-30
82870292314,82870292322,8,2379,1211,-30
82872816204,82872816207,3,2009,1512,-30
82876470803,82876470808,5,3290,1474,-30
82882082555,82882082557,2,1166,2555,-30
82886362461,82886362465,4,2068,1443,-30
82886800481,82886800486,5,2644,987,-30
82888381177,82888381181,4,3040,1907,-30
82895637238,82895637241,3,1532,799,-30
82895977391,82895977397,6,2482,1591,-30
82897548448,82897548452,4,2460,1149,-30
82900242560,82900242562,2,1755,1140,-30
82900689178,82900689170,-8,1154,10914,-30
82901427602,82901427613,11,103,1356,-30
82901775843,82901775838,-5,1035,3364,-30
82904372754,82904372762,8,2095,1019,-30
82911517577,82911517582,5,1655,782,-30
82912420862,82912420867,5,2880,1702,-30
82916264077,82916264058,-19,2807,1339,-30
82917453479,82917453491,12,2849,1124,-30
82927113879,82927113885,6,2914,1416,-30
82928498401,82928498406,5,2312,1263,-30
82928976221,82928976224,3,2881,1439,-30
82929492942,82929492921,-21,942,311,-30
82933108078,82933108081,3,1739,1034,-30
82934523361,82934523366,5,1058,932,-30
82938498773,82938498775,2,1947,1448,-30
82939365630,82939365634,4,2622,1627,-30
82939448078,82939448085,7,7528,2180,-30
82943470695,82943470693,-2,1630,4014,-30
82943903613,82943903618,5,2116,968,-30
82944274305,82944274310,5,2162,984,-30
82945526742,82945526751,9,1474,891,-30
82946747724,82946747729,5,2244,1161,-30
82947644746,82947644754,8,2052,986,-30
82947937851,82947937857,6,1818,977,-30
82950482041,82950482045,4,3200,1928,-30
82950697225,82950697229,4,3323,2074,-30
82954654177,82954654170,-7,1161,4654,-30
82958232550,82958232556,6,3020,1467,-30
82960704019,82960704022,3,1659,1255,-30
82962583085,82962583091,6,1591,1178,-30
82963221046,82963221050,4,1613,1006,-30
82963470131,82963470137,6,2348,1176,-30
82964412058,82964412062,4,2571,1153,-30
82967700515,82967700522,7,2064,1454,-30
82972682889,82972682898,9,12127,42144,-30
82974994923,82974994930,7,1519,825,-30
82975581027,82975581032,5,1925,1231,-30
82978558478,82978558485,7,3477,1396,-30
82981708325,82981708327,2,1329,916,-30
82982700087,82982700076,-11,562,496,-30
82983022488,82983022493,5,3002,1166,-30
82987484938,82987484944,6,2619,1527,-30
82992280305,82992280301,-4,1017,2957,-30
82997674757,82997674762,5,2770,1168,-30
82997811796,82997811795,-1,1748,1846,-30
82998222488,82998222492,4,2415,1577,-30
82998596720,82998596727,7,2867,1644,-30
83004725923,83004725929,6,1107,669,-30
83006374119,83006374122,3,2303,1283,-30
83007150987,83007150993,6,3286,1987,-30
83007992486,83007992491,5,1660,937,-30
83013642533,83013642538,5,2688,1515,-30
83016271088,83016271091,3,2372,1614,-30
83029095975,83029095979,4,1406,1632,-30
83030869418,83030869401,-17,3090,1645,-30
83033462513,83033462516,3,1384,1261,-30
83035479691,83035479697,6,2626,1186,-30
83036400494,83036400499,5,2810,1813,-30
83037071673,83037071677,4,1775,1305,-30
83037350110,83037350114,4,1639,1090,-30
83041775816,83041775817,1,2090,2479,-30
83054108825,83054108831,6,2377,1512,-30
83058295614,83058295621,7,3213,1448,-30
83059307380,83059307386,6,2415,1677,-30
83059862978,83059862984,6,1542,1403,-30
83062366402,83062366406,4,2344,1474,-30
83066144009,83066144014,5,4448,2167,-30
83072592378,83072592385,7,1473,851,-30
83075420741,83075420736,-5,1078,3540,-30
83078494073,83078494078,5,3131,1219,-30
83079668093,83079668096,3,24740,45502,-30
83079875390,83079875395,5,1433,678,-30
83080693707,83080693713,6,6078,2599,-30
83081066130,83081066135,5,3072,1471,-30
83081344121,83081344126,5,2844,1106,-30
83081593048,83081593054,6,2137,1324,-30
83082206215,83082206219,4,1502,941,-30
83083257810,83083257815,5,2495,1129,-30
83083388412,83083388396,-16,771,708,-30
83084258001,83084258006,5,1638,1268,-30
83085470848,83085470853,5,2647,1271,-30
83090265521,83090265525,4,2179,1520,-30
83096234297,83096234302,5,2004,1109,-30
83099916648,83099916653,5,1390,1438,-30
83103165727,83103165732,5,2093,1433,-30
83103832196,83103832186,-10,750,266,-30
83108998456,83108998463,7,1813,934,-30
83110542355,83110542359,4,1904,1138,-30
83113544181,83113544186,5,2458,1428,-30
83115441268,83115441268,0,1720,2254,-30
83131693513,83131693514,1,1772,1284,-30
83135188189,83135188194,5,2323,1388,-30
83135265094,83135265115,21,2780,1788,-30
83142167296,83142167301,5,4139,1489,-30
83143800771,83143800774,3,2599,1530,-30
83150480029,83150480035,6,1607,784,-30
83151589820,83151589828,8,1872,688,-30
83152206180,83152206185,5,2614,1118,-30
83153506485,83153506491,6,3734,1956,-30
83153797188,83153797185,-3,1225,2552,-30
83162108470,83162108475,5,2499,1597,-30
83163167320,83163167323,3,1707,1222,-30
83163599194,83163599197,3,2397,1163,-30
83163906338,83163906343,5,2008,1417,-30
83168098297,83168098302,5,2458,1013,-30
83169786814,83169786819,5,2474,1754,-30
83173702750,83173702755,5,3062,1016,-30
83178877350,83178877357,7,2369,1644,-30
83179620418,83179620421,3,2202,1055,-30
83185718389,83185718395,6,2614,1420,-30
83187706867,83187706871,4,1179,1646,-30
83198540071,83198540069,-2,933,381,-30
83198728626,83198728635,9,13618,2107,-30
83199010121,83199010126,5,3719,1264,-30
83199442513,83199442528,15,2661,1295,-30
83200932829,83200932835,6,2498,1324,-30
83201240571,83201240585,14,1672,1101,-30
83203362415,83203362421,6,2334,1378,-30
83204347527,83204347529,2,1345,1026,-30
83205482287,83205482291,4,2202,1332,-30
83207339501,83207339506,5,833,672,-30
83208881125,83208881130,5,2360,1114,-30
83209248440,83209248446,6,1210,787,-30
83212513064,83212513068,4,2552,1369,-30
83213000814,83213000817,3,2228,1011,-30
83213632369,83213632373,4,2471,825,-30
83216395062,83216395066,4,1666,1198,-30
83217038270,83217038291,21,777,292,-30
83218286401,83218286402,1,1316,1156,-30
83219102546,83219102553,7,1636,1087,-30
83219995732,83219995714,-18,1645,1170,-30
83222022639,83222022644,5,2033,1204,-30
83222433784,83222433789,5,2151,1077,-30
83224274110,83224274116,6,2462,921,-30
83226934518,83226934522,4,1600,837,-30
83228478762,83228478766,4,1460,988,-30
83229066531,83229066547,16,2516,1365,-30
83229998789,83229998794,5,1367,1059,-30
83233346751,83233346751,0,865,897,-30
83234342594,83234342580,-14,1226,1223,-30
83235491494,83235491501,7,2237,988,-30
83239582075,83239582080,5,1923,1386,-30
83241952974,83241952979,5,3044,1658,-30
83242317461,83242317466,5,2423,1359,-30
83245660337,83245660342,5,2272,976,-30
83245726846,83245726851,5,2400,1517,-30
83246645924,83246645924,0,1891,1434,-30
83249199058,83249199063,5,3302,1727,-30
83252752723,83252752730,7,1879,1112,-30
83254992967,83254992971,4,1995,1051,-30
83256196378,83256196385,7,1984,1549,-30
83265159285,83265159289,4,2136,1535,-30
83266229805,83266229810,5,2146,1611,-30
83267117678,83267117690,12,201,121,-30
83267608942,83267608946,4,3322,2036,-30
83273597186,83273597193,7,2983,1582,-30
83274028686,83274028690,4,2296,1562,-30
83275150405,83275150410,5,3534,1550,-30
83276842831,83276842837,6,3722,2012,-30
83281458278,83281458283,5,2446,1605,-30
83284604812,83284604817,5,2457,1312,-30
83285776786,83285776781,-5,1168,4489,-30
83286403108,83286403113,5,2827,1360,-30
83287129787,83287129793,6,1593,1024,-30
83289131605,83289131610,5,1984,1516,-30
83299692799,83299692798,-1,1540,2273,-30
83300499615,83300499621,6,1649,939,-30
83301132274,83301132280,6,1702,1640,-30
83305534492,83305534497,5,2414,1007,-30
83308314374,83308314370,-4,1871,4316,-30
83310523507,83310523513,6,1820,1450,-30
83312360633,83312360638,5,2337,1128,-30
83316168938,83316168943,5,2596,1289,-30
83317703252,83317703257,5,3243,1234,-30
83320316418,83320316422,4,1998,1261,-30
83322101869,83322101874,5,1877,894,-30
83322964431,83322964435,4,2335,1252,-30
83324533084,83324533089,5,2467,1352,-30
83329130006,83329130010,4,1611,1222,-30
83329980861,83329980867,6,2815,1313,-30
83332016577,83332016575,-2,1520,2750,-30
83336190182,83336190186,4,2331,983,-30
83336377375,83336377377,2,2776,2479,-30
83337597886,83337597882,-4,1021,3318,-30
83340335730,83340335734,4,1636,937,-30
83340588771,83340588766,-5,3060,11142,-30
83342264566,83342264570,4,2526,1623,-30
83344528078,83344528083,5,2944,1724,-30
83345148329,83345148334,5,3053,1892,-30
83353070593,83353070599,6,2341,1598,-30
83353178941,83353178945,4,2099,1368,-30
83364746918,83364746921,3,1327,1274,-30
83365097978,83365097983,5,2193,1026,-30
83366435605,83366435610,5,3138,1946,-30
83366877951,83366877952,1,1219,1613,-30
83367626646,83367626649,3,1513,1524,-30
83368441293,83368441298,5,2346,1421,-30
83369062823,83369062827,4,1683,788,-30
83370476790,83370476798,8,1879,1135,-30
83373091579,83373091579,0,1958,1324,-30
83373811146,83373811151,5,2143,1459,-30
83378414730,83378414734,4,1719,1375,-30
83380012978,83380012981,3,1780,1341,-30
83385711081,83385711086,5,2085,1208,-30
83387053603,83387053609,6,1840,900,-30
83387295732,83387295727,-5,373,1000,-30
83388059606,83388059612,6,2741,1680,-30
83390736895,83390736902,7,2918,1548,-30
83396378639,83396378634,-5,865,1679,-30
83398891457,83398891461,4,2674,1913,-30
83400882134,83400882136,2,1628,1509,-30
83403915374,83403915379,5,2593,1375,-30
83410338078,83410338085,7,2376,1083,-30
83412226505,83412226510,5,6107,2717,-30
83415183044,83415183050,6,2306,1537,-30
83416435850,83416435856,6,3131,1755,-30
83419406837,83419406843,6,2770,1480,-30
83421963429,83421963435,6,1327,1101,-30
83422852424,83422852427,3,1586,972,-30
83423169431,83423169434,3,1491,1096,-30
83434467038,83434467038,0,1658,2312,-30
83439683433,83439683440,7,4813,2224,-30
83439886454,83439886461,7,1896,1196,-30
83440244575,83440244564,-11,682,234,-30
83445247550,83445247555,5,2229,1063,-30
83446147163,83446147167,4,1571,1342,-30
83447615321,83447615325,4,2495,1703,-30
83449377653,83449377656,3,1413,818,-30
83449720846,83449720835,-11,624,176,-30
83452881580,83452881573,-7,1690,8433,-30
83454382397,83454382401,4,2836,1050,-30
83454733474,83454733479,5,1706,1018,-30
83458405444,83458405446,2,1336,1445,-30
83458586370,83458586374,4,2323,1367,-30
83458709416,83458709421,5,1996,1368,-30
83466307848,83466307855,7,2844,1234,-30
83469541573,83469541578,5,805,569,-30
83474724773,83474724778,5,2922,1198,-30
83479204721,83479204728,7,3066,1001,-30
83480631178,83480631180,2,2038,1469,-30
83481078069,83481078076,7,6424,2403,-30
83490161146,83490161150,4,2258,1218,-30
83492435882,83492435886,4,1699,1392,-30
83492650391,83492650368,-23,1502,1469,-30
83493482498,83493482502,4,2251,1463,-30
83494519677,83494519682,5,2764,1200,-30
83495173666,83495173673,7,4035,1739,-30
83495336616,83495336621,5,1746,1323,-30
83497792602,83497792606,4,2007,1020,-30
83499398779,83499398784,5,2472,1500,-30
83501541516,83501541503,-13,2916,1286,-30
83507333710,83507333715,5,2999,1193,-30
83507607346,83507607350,4,2949,1588,-30
83510693846,83510693851,5,1828,1186,-30
83513307906,83513307910,4,1501,1372,-30
83516675997,83516676003,6,1631,951,-30
83516717301,83516717308,7,2022,1791,-30
83521163594,83521163600,6,3489,1660,-30
83524663818,83524663823,5,2283,1445,-30
83524864562,83524864567,5,2176,1307,-30
83526066734,83526066740,6,1690,828,-30
83527041524,83527041526,2,882,1064,-30
83530391169,83530391173,4,2103,1558,-30
83530771013,83530771017,4,1350,1342,-30
83532043616,83532043622,6,3167,1007,-30
83532482347,83532482353,6,2462,970,-30
83534224594,83534224599,5,2567,1295,-30
83535034891,83535034895,4,2591,1360,-30
83538723047,83538723052,5,2385,1419,-30
83539797970,83539797975,5,1370,858,-30
83541711095,83541711098,3,2303,1205,-30
83542583079,83542583086,7,1541,1326,-30
83542701322,83542701331,9,1175,728,-30
83544317145,83544317139,-6,2133,7278,-30
83545616399,83545616401,2,1048,1054,-30
83546811295,83546811313,18,2050,1109,-30
83547319710,83547319714,4,2080,1190,-30
83550501374,83550501380,6,3040,1528,-30
83550852487,83550852491,4,2110,1210,-30
83551635086,83551635087,1,15198,2784,-30
83553749210,83553749214,4,2169,820,-30
83556273960,83556273965,5,1529,1127,-30
83556315188,83556315168,-20,3272,1435,-30
83556710626,83556710630,4,1999,1484,-30
83556928199,83556928203,4,2046,1759,-30
83560169566,83560169570,4,2399,1181,-30
83561641438,83561641443,5,2495,1597,-30
83562031517,83562031522,5,2474,1847,-30
83566080717,83566080722,5,1688,729,-30
83568602369,83568602373,4,2155,1893,-30
83569187160,83569187167,7,1851,1485,-30
83569696067,83569696073,6,2473,1329,-30
83570463286,83570463291,5,2898,1610,-30
83570497582,83570497587,5,2133,1756,-30
83572777374,83572777380,6,1408,837,-30
83574581869,83574581873,4,2064,1225,-30
83575103987,83575103994,7,1989,1660,-30
83576080220,83576080227,7,2571,1188,-30
83576276307,83576276310,3,2346,1498,-30
83576837344,83576837348,4,1657,970,-30
83578805071,83578805075,4,2257,1534,-30
83580346554,83580346558,4,2619,1516,-30
83583312034,83583312038,4,2910,1391,-30
83589424243,83589424249,6,2686,1307,-30
83592014256,83592014257,1,1197,1554,-30
83595414151,83595414157,6,2765,1510,-30
83597447539,83597447542,3,1714,1194,-30
83598740159,83598740164,5,3057,1879,-30
83598830020,83598830025,5,2360,1332,-30
83599015133,83599015138,5,1178,558,-30
83599735654,83599735641,-13,1188,1044,-30
83601091993,83601091998,5,1720,1502,-30
83601871433,83601871438,5,2536,1483,-30
83606580607,83606580611,4,2575,1721,-30
83608545915,83608545921,6,2507,1611,-30
83609866841,83609866846,5,2359,1276,-30
83611290864,83611290869,5,1466,1250,-30
83612316645,83612316650,5,1511,1604,-30
83613077719,83613077725,6,2246,1833,-30
83614276002,83614276007,5,1204,774,-30
83614709175,83614709179,4,2096,1174,-30
83615208082,83615208086,4,2497,1058,-30
83616253851,83616253856,5,1742,1087,-30
83617140815,83617140820,5,2127,1707,-30
83618670112,83618670117,5,2541,1639,-30
83626143575,83626143580,5,2132,1089,-30
83629447718,83629447725,7,2239,978,-30
83630822182,83630822187,5,2457,1086,-30
83632810235,83632810241,6,3054,1057,-30
83633628406,83633628409,3,2303,1834,-30
83638182346,83638182350,4,1231,1009,-30
83640389521,83640389524,3,1918,1125,-30
83642790645,83642790650,5,2991,1492,-30
83642985479,83642985457,-22,963,407,-30
83645524908,83645524912,4,1904,985,-30
83646283235,83646283239,4,2091,1152,-30
83646530505,83646530506,1,700,319,-30
83649181055,83649181060,5,1898,992,-30
83649881289,83649881298,9,1760,1196,-30
83651093430,83651093435,5,1627,1552,-30
83651132592,83651132598,6,2935,1309,-30
83651670750,83651670755,5,1497,843,-30
83654610837,83654610834,-3,1101,1927,-30
83656132802,83656132806,4,2264,1451,-30
83656459869,83656459851,-18,1148,533,-30
83659744110,83659744115,5,1676,1434,-30
83661369134,83661369139,5,2594,1066,-30
83662611717,83662611722,5,2236,1457,-30
83664454563,83664454568,5,1992,1049,-30
83667181090,83667181095,5,2073,1348,-30
83668447679,83668447682,3,2110,1155,-30
83668679873,83668679873,0,5734,19845,-30
83670103310,83670103315,5,1875,859,-30
83671382755,83671382760,5,2060,1091,-30
83673900999,83673901005,6,1789,833,-30
83679340644,83679340650,6,2758,1169,-30
83682380948,83682380954,6,1433,929,-30
83683450134,83683450139,5,1500,1015,-30
83687872702,83687872709,7,3327,1279,-30
83688739842,83688739843,1,1805,1740,-30
83692578844,83692578847,3,2116,1186,-30
83693480844,83693480851,7,9700,27313,-30
83696258717,83696258724,7,2836,1805,-30
83700149158,83700149163,5,2804,1394,-30
83700781279,83700781282,3,1608,1275,-30
83703349321,83703349326,5,2337,1190,-30
83705509727,83705509734,7,2760,1969,-30
83710899091,83710899097,6,1546,621,-30
83711066885,83711066885,0,1424,3150,-30
83711589298,83711589301,3,2057,1638,-30
83712001922,83712001927,5,2125,1560,-30
83714037807,83714037811,4,1888,900,-30
83717559217,83717559224,7,2393,1112,-30
83717927623,83717927603,-20,1359,503,-30
83720032098,83720032101,3,2122,1383,-30
83722774902,83722774906,4,2403,1260,-30
83723263642,83723263649,7,2052,981,-30
83723713443,83723713446,3,1205,821,-30
83728531438,83728531441,3,1578,1009,-30
83730784682,83730784688,6,2402,927,-30
83731127611,83731127627,16,1375,1312,-30
83731235157,83731235170,13,2000,1149,-30
83731684341,83731684345,4,1838,1240,-30
83733237865,83733237870,5,2754,1270,-30
83733806014,83733806019,5,1444,1357,-30
83734183166,83734183170,4,2515,1275,-30
83735609954,83735609960,6,1369,955,-30
83738059978,83738059981,3,1923,1268,-30
83738441381,83738441386,5,2454,1230,-30
83740399434,83740399439,5,2674,1648,-30
83742140060,83742140066,6,2790,1051,-30
83742541061,83742541066,5,4327,1924,-30
83744390243,83744390250,7,3280,1625,-30
83744865227,83744865229,2,1675,1700,-30
83745555574,83745555593,19,218,2242,-30
83753007910,83753007913,3,2006,1205,-30
83759329906,83759329909,3,2062,1572,-30
83761234962,83761234966,4,1803,865,-30
83761448558,83761448537,-21,1682,687,-30
83763281971,83763281974,3,839,1106,-30
83765528585,83765528590,5,2184,1145,-30
83767218145,83767218149,4,1986,1502,-30
83767530810,83767530794,-16,2725,778,-30
83770186811,83770186817,6,2156,1274,-30
83771023804,83771023823,19,1391,1217,-30
83774574909,83774574915,6,2260,1245,-30
83775998586,83775998587,1,1687,1236,-30
83777291407,83777291407,0,1688,1694,-30
83778348615,83778348621,6,2791,1426,-30
83781388174,83781388179,5,1545,943,-30
83784083144,83784083149,5,2478,1392,-30
83784216729,83784216722,-7,2517,8188,-30
83787064269,83787064276,7,1763,1113,-30
83787541545,83787541550,5,1430,674,-30
83788231062,83788231042,-20,1584,943,-30
83788455957,83788455963,6,2904,1393,-30
83790235894,83790235899,5,2242,1209,-30
83790958278,83790958283,5,1965,1058,-30
83795127102,83795127107,5,1900,970,-30
83795477471,83795477481,10,627,265,-30
83798828410,83798828422,12,18202,21724,-30
83799892378,83799892381,3,1859,1385,-30
83800094542,83800094545,3,1471,1614,-30
83801128770,83801128775,5,1927,1192,-30
83801610318,83801610325,7,2131,1458,-30
83803548862,83803548869,7,1940,1264,-30
83803995874,83803995868,-6,384,304,-30
83808264386,83808264391,5,1198,1217,-30
83809747117,83809747122,5,1842,1258,-30
83810859474,83810859479,5,1506,1267,-30
83812524249,83812524253,4,2175,1473,-30
83813573955,83813573960,5,2548,1252,-30
83817105106,83817105111,5,2428,1452,-30
83817714116,83817714121,5,1441,985,-30
83818968129,83818968134,5,2433,920,-30
83820449594,83820449598,4,2202,1234,-30
83829552601,83829552606,5,2433,1698,-30
83830179766,83830179773,7,1998,1440,-30
83830311085,83830311089,4,1695,1204,-30
83834712956,83834712961,5,1894,1037,-30
83838727068,83838727074,6,1971,1135,-30
83841800779,83841800784,5,1959,1216,-30
83842816996,83842817016,20,1793,1420,-30
83842908694,83842908673,-21,997,346,-30
83847843158,83847843162,4,855,143,-30
83850921131,83850921134,3,1700,955,-30
83853624341,83853624343,2,1233,1375,-30
83854249809,83854249814,5,2511,1365,-30
83854282342,83854282347,5,3015,1075,-30
83854662031,83854662049,18,1427,51,-30
83856550661,83856550662,1,1033,1360,-30
83856750689,83856750692,3,2017,1063,-30
83859413485,83859413490,5,1699,964,-30
83863275226,83863275231,5,3166,1698,-30
83863950416,83863950422,6,2331,814,-30
83865407674,83865407678,4,1922,1143,-30
83865466442,83865466448,6,2714,1146,-30
83872427638,83872427634,-4,801,1705,-30
83873534530,83873534535,5,2442,1158,-30
83875840165,83875840168,3,2098,1444,-30
83877807901,83877807905,4,3476,2455,-30
83880298904,83880298903,-1,2978,3874,-30
83881992333,83881992336,3,2306,1622,-30
83882313657,83882313663,6,1800,1295,-30
83883374485,83883374490,5,1920,1123,-30
83887761846,83887761851,5,1548,833,-30
83889962839,83889962847,8,3140,1288,-30
83891597487,83891597493,6,2401,1578,-30
83896059459,83896059463,4,2458,1498,-30
83896095689,83896095694,5,1641,1085,-30
83897288481,83897288487,6,4271,1607,-30
83900411410,83900411417,7,2931,1846,-30
83902298230,83902298237,7,2896,1529,-30
83904403441,83904403446,5,1555,983,-30
83904451966,83904451947,-19,6598,2989,-30
83905018046,83905018046,0,1531,1570,-30
83907787215,83907787221,6,2051,1742,-30
83908452374,83908452379,5,1516,1348,-30
83910985295,83910985299,4,2267,1291,-30
83914327493,83914327499,6,2124,1271,-30
83916554526,83916554531,5,2142,1229,-30
83917123217,83917123221,4,2260,1209,-30
83918471709,83918471711,2,973,1062,-30
83921253991,83921253997,6,1400,857,-30
83921727799,83921727778,-21,857,59,-30
83925222663,83925222667,4,1816,1074,-30
83929314947,83929314952,5,2547,1609,-30
83931560344,83931560349,5,2037,1205,-30
83932302736,83932302751,15,12837,45706,-30
83935923354,83935923355,1,2905,2674,-30
83941703674,83941703666,-8,1637,1115,-30
83946074233,83946074239,6,2504,1123,-30
83948479158,83948479163,5,2942,1487,-30
83950915854,83950915860,6,2485,1077,-30
83953802886,83953802891,5,3401,1713,-30
83968383302,83968383307,5,2144,1098,-30
83969528816,83969528824,8,7236,3301,-30
83969664525,83969664530,5,2271,1457,-30
83969948618,83969948623,5,2101,1349,-30
83975817046,83975817058,12,2861,1233,-30
83977159153,83977159145,-8,938,7883,-30
83980641645,83980641652,7,2886,1292,-30
83985807299,83985807303,4,1297,1261,-30
83986366629,83986366633,4,2133,931,-30
83988111134,83988111138,4,1964,1340,-30
83988980434,83988980440,6,3457,1481,-30
83991809146,83991809150,4,2122,972,-30
83992843192,83992843197,5,2912,1456,-30
83997243614,83997243619,5,928,692,-30
83997604782,83997604786,4,1824,1191,-30
84002522834,84002522840,6,2132,1244,-30
84006133448,84006133450,2,1899,1941,-30
84007443595,84007443597,2,2357,1304,-30
84010201325,84010201333,8,3061,1153,-30
84010254542,84010254547,5,2916,1175,-30
84010546483,84010546487,4,1184,864,-30
84010769436,84010769417,-19,2074,1439,-30
84012483438,84012483435,-3,1197,3347,-30
84012865263,84012865265,2,1452,1757,-30
84015027474,84015027478,4,2608,1652,-30
84016948325,84016948329,4,1938,1556,-30
84019838307,84019838311,4,932,1316,-30
84028128679,84028128686,7,2095,1315,-30
84028719338,84028719347,9,1458,1550,-30
84032606044,84032606049,5,2287,1218,-30
84033867003,84033867008,5,2042,1604,-30
84034570170,84034570175,5,1363,503,-30
84037134049,84037134055,6,2181,1269,-30
84039695836,84039695843,7,2652,1463,-30
84039961626,84039961643,17,2154,1283,-30
84040071231,84040071237,6,2775,1122,-30
84044809480,84044809498,18,664,4847,-30
84047138530,84047138535,5,1810,1532,-30
84047823639,84047823645,6,3089,1887,-30
84050944902,84050944906,4,2123,1766,-30
84053025888,84053025893,5,2421,1378,-30
84054483611,84054483615,4,2340,1028,-30
84057665244,84057665247,3,2282,1473,-30
84059036881,84059036887,6,2047,1538,-30
84059294506,84059294512,6,2310,1086,-30
84061283480,84061283470,-10,1179,990,-30
84067030162,84067030162,0,2134,1208,-30
84068980970,84068980973,3,2331,1283,-30
84069243751,84069243757,6,1811,1112,-30
84075886865,84075886872,7,2061,1246,-30
84078767622,84078767623,1,1961,1182,-30
84081552862,84081552869,7,6435,1928,-30
84082321970,84082321974,4,2743,1191,-30
84084123400,84084123406,6,2024,1390,-30
84086172816,84086172821,5,1566,731,-30
84088603542,84088603550,8,2142,1323,-30
84089617662,84089617665,3,2805,3197,-30
84090640756,84090640762,6,2202,1257,-30
84094712194,84094712199,5,1702,1282,-30
84098780755,84098780751,-4,1153,2673,-30
84103400786,84103400790,4,2592,1312,-30
84103971361,84103971366,5,2954,1380,-30
84108728625,84108728624,-1,1328,1717,-30
84112529483,84112529488,5,2068,1185,-30
84115898198,84115898201,3,3321,2824,-30
84117369494,84117369499,5,1870,1289,-30
84121053854,84121053858,4,2158,830,-30
84121550973,84121550978,5,1958,1471,-30
84127167573,84127167578,5,2486,1445,-30
84127456015,84127456021,6,3075,1264,-30
84127972654,84127972661,7,1356,848,-30
84131013623,84131013627,4,2428,1378,-30
84134515208,84134515212,4,1686,1075,-30
84135656243,84135656251,8,1150,1034,-30
84135731903,84135731907,4,2168,1364,-30
84136159646,84136159652,6,2399,1522,-30
84139216314,84139216319,5,1026,1091,-30
84141760601,84141760607,6,2441,1276,-30
84142796834,84142796838,4,2106,1438,-30
84148401714,84148401719,5,2137,1146,-30
84149543698,84149543702,4,1703,1086,-30
84150092983,84150092986,3,3050,1272,-30
84150689458,84150689459,1,1019,1526,-30
84151120794,84151120798,4,2579,1672,-30
84151918303,84151918307,4,2881,1502,-30
84154195010,84154195003,-7,1041,3466,-30
84155133590,84155133595,5,2469,1007,-30
84160020182,84160020186,4,2911,2169,-30
84161586257,84161586270,13,336,3305,-30
84163509762,84163509766,4,1849,1466,-30
84165741929,84165741934,5,1917,1285,-30
84166347793,84166347798,5,2063,1538,-30
84171894407,84171894411,4,1968,1425,-30
84175468880,84175468884,4,2371,1674,-30
84179654957,84179654963,6,3092,1480,-30
84183948877,84183948883,6,2297,1211,-30
84186233990,84186233994,4,1774,1304,-30
84186568636,84186568641,5,2816,1207,-30
84187305683,84187305687,4,2328,1146,-30
84191243214,84191243218,4,2560,1506,-30
84192346866,84192346873,7,2322,1259,-30
84196627372,84196627377,5,2215,1329,-30
84197250054,84197250059,5,1454,1067,-30
84197417513,84197417506,-7,933,298,-30
84202901600,84202901606,6,2228,1063,-30
84204581679,84204581683,4,1762,972,-30
84206191229,84206191234,5,3187,1569,-30
84207688945,84207688950,5,2164,1389,-30
84208038131,84208038136,5,2149,1371,-30
84208964529,84208964527,-2,2505,4519,-30
84214063051,84214063067,16,24967,47293,-30
84218517657,84218517661,4,2158,1229,-30
84223712845,84223712849,4,2336,894,-30
84224991020,84224991026,6,2768,1146,-30
84225805022,84225805025,3,1479,1229,-30
84228196451,84228196454,3,1991,1131,-30
84228676374,84228676378,4,2126,1283,-30
84232169247,84232169252,5,2657,1627,-30
84233366706,84233366711,5,1615,996,-30
84234239278,84234239284,6,1948,1751,-30
84237231732,84237231737,5,2610,1874,-30
84238532939,84238532945,6,2611,1499,-30
84243609381,84243609387,6,2387,919,-30
84250406897,84250406901,4,2723,1873,-30
84250749990,84250749994,4,1206,808,-30
84252698530,84252698530,0,926,1240,-30
84253816849,84253816854,5,1957,989,-30
84256069105,84256069110,5,2831,1137,-30
84256349673,84256349678,5,2159,1568,-30
84258218542,84258218546,4,1491,1258,-30
84258269270,84258269274,4,1919,1186,-30
84258986982,84258986992,10,2317,1520,-30
84259743332,84259743338,6,2031,1608,-30
84260738362,84260738366,4,1472,924,-30
84261790993,84261790999,6,2414,1640,-30
84264005900,84264005904,4,1858,1620,-30
84264929754,84264929758,4,2154,1219,-30
84265406612,84265406618,6,2023,1334,-30
84271442166,84271442170,4,2491,1626,-30
84277360341,84277360343,2,1772,1083,-30
84277392295,84277392295,0,1380,1290,-30
84277465455,84277465458,3,1922,1317,-30
84279381573,84279381578,5,2611,1758,-30
84281060426,84281060422,-4,1191,4020,-30
84281223558,84281223562,4,1551,1074,-30
84281849532,84281849539,7,2093,1167,-30
84282392107,84282392115,8,1791,838,-30
84282824145,84282824140,-5,509,264,-30
84283929110,84283929114,4,1992,1162,-30
84288050103,84288050107,4,2343,1582,-30
84292725021,84292725027,6,1908,756,-30
84297334563,84297334582,19,2852,1688,-30
84298894490,84298894494,4,2570,1023,-30
84304389636,84304389640,4,2987,1707,-30
84304636479,84304636482,3,1869,1214,-30
84304687403,84304687385,-18,673,286,-30
84307652289,84307652294,5,1948,1121,-30
84308544809,84308544814,5,3241,1623,-30
84309316070,84309316074,4,2115,1553,-30
84309885647,84309885652,5,1639,1034,-30
84312895361,84312895367,6,1132,805,-30
84313770540,84313770545,5,1875,1180,-30
84316929271,84316929271,0,1310,2764,-30
84318073201,84318073205,4,1923,1388,-30
84319809226,84319809222,-4,1028,3233,-30
84320052310,84320052316,6,1427,1109,-30
84320241809,84320241796,-13,830,73,-30
84320968197,84320968202,5,3114,1407,-30
84323083407,84323083414,7,2138,1015,-30
84323873788,84323873790,2,1929,1138,-30
84329174757,84329174762,5,2215,1402,-30
84331625513,84331625518,5,2097,1055,-30
84333378242,84333378246,4,2766,1700,-30
84335386402,84335386407,5,1292,1052,-30
84339353702,84339353706,4,1914,1552,-30
84341412742,84341412749,7,4154,1816,-30
84341624671,84341624674,3,1324,973,-30
84343772646,84343772650,4,2447,1243,-30
84346465616,84346465620,4,2728,1721,-30
84346515586,84346515594,8,2923,1255,-30
84347758501,84347758505,4,3029,1750,-30
84352189085,84352189090,5,2233,1333,-30
84352467147,84352467155,8,6820,2586,-30
84353331894,84353331899,5,2610,1020,-30
84362431558,84362431563,5,1022,851,-30
84362673741,84362673746,5,2164,1707,-30
84363742992,84363742995,3,2157,974,-30
84364419722,84364419728,6,2190,1390,-30
84368915717,84368915722,5,3810,2083,-30
84369848109,84369848114,5,2132,1303,-30
84372667053,84372667058,5,2420,1482,-30
84376878686,84376878690,4,2250,1531,-30
84377165993,84377165997,4,2274,1326,-30
84380137392,84380137375,-17,1430,5004,-30
84380798663,84380798666,3,1470,1145,-30
84380944451,84380944466,15,788,32,-30
84385462602,84385462602,0,2084,4051,-30
84393692474,84393692479,5,1913,1204,-30
84400764684,84400764688,4,2185,1685,-30
84401278631,84401278637,6,2326,1011,-30
84402104211,84402104218,7,3303,1803,-30
84404893351,84404893357,6,2308,970,-30
84407958220,84407958225,5,1777,1616,-30
84410060667,84410060648,-19,1803,911,-30
84411808280,84411808279,-1,931,1797,-30
84415373254,84415373258,4,2245,1175,-30
84418675743,84418675748,5,2220,1070,-30
84421831731,84421831737,6,1475,614,-30
84424307395,84424307399,4,2597,1176,-30
84426125938,84426125944,6,1592,1452,-30
84428511261,84428511266,5,1530,1250,-30
84429998673,84429998675,2,3040,1479,-30
84436123225,84436123229,4,1977,1760,-30
84438448981,84438448983,2,864,623,-30
84438970861,84438970863,2,1756,1053,-30
84441443950,84441443957,7,1882,1058,-30
84442915525,84442915530,5,2494,1556,-30
84444906505,84444906510,5,4017,1997,-30
84445975849,84445975854,5,1948,1173,-30
84447936074,84447936077,3,2262,1379,-30
84448379823,84448379809,-14,1495,658,-30
84448807396,84448807401,5,2763,1520,-30
84455393900,84455393903,3,2701,1227,-30
84457059875,84457059872,-3,1326,2120,-30
84458539950,84458539953,3,1984,1570,-30
84462098174,84462098173,-1,1166,2717,-30
84463904180,84463904184,4,2160,1124,-30
84464205805,84464205810,5,3039,1539,-30
84464613085,84464613091,6,2473,1634,-30
84475751142,84475751147,5,2168,1594,-30
84475899986,84475899971,-15,1129,635,-30
84476316436,84476316438,2,1371,1754,-30
84477218165,84477218168,3,1415,1745,-30
84478847593,84478847599,6,2410,1010,-30
84479660705,84479660710,5,2829,1378,-30
84484027495,84484027501,6,2419,1534,-30
84484870458,84484870461,3,2027,1502,-30
84490705612,84490705617,5,3013,1913,-30
84496237785,84496237785,0,1013,1779,-30
84497546877,84497546878,1,1778,1649,-30
84497922093,84497922099,6,2280,1325,-30
84500803401,84500803405,4,2918,1454,-30
84503813578,84503813582,4,2157,1424,-30
84506680410,84506680414,4,1809,920,-30
84511580410,84511580415,5,3065,1162,-30
84513477685,84513477690,5,3072,1523,-30
84518308313,84518308322,9,761,252,-30
84518589824,84518589814,-10,2571,1322,-30
84523918404,84523918411,7,1889,1382,-30
84527453706,84527453707,1,1674,2014,-30
84529449242,84529449247,5,992,512,-30
84531662570,84531662575,5,3292,1533,-30
84533762571,84533762575,4,1666,413,-30
84537999853,84537999858,5,3441,1170,-30
84538125395,84538125403,8,1371,735,-30
84539101038,84539101043,5,2448,2002,-30
84539896485,84539896491,6,3987,1693,-30
84541864559,84541864565,6,2540,1275,-30
84542420006,84542420012,6,3067,1125,-30
84544235213,84544235218,5,2083,1550,-30
84544924906,84544924909,3,1543,1200,-30
84545650907,84545650911,4,2069,1296,-30
84547379718,84547379722,4,1788,1593,-30
84548969979,84548969977,-2,1067,2849,-30
84552217854,84552217861,7,2948,1495,-30
84552802461,84552802460,-1,812,1412,-30
84555426001,84555426006,5,2234,1647,-30
84555597258,84555597240,-18,1771,1011,-30
84557132459,84557132465,6,2482,1508,-30
84569042606,84569042610,4,1251,916,-30
84570173302,84570173308,6,2501,1253,-30
84573138704,84573138709,5,1835,1313,-30
84576006214,84576006221,7,2303,1222,-30
84579790010,84579790014,4,2266,1922,-30
84582851314,84582851319,5,1690,1068,-30
84585568229,84585568235,6,2157,1419,-30
84587568113,84587568119,6,1921,1426,-30
84589006521,84589006527,6,3273,1744,-30
84594515134,84594515138,4,1879,1571,-30
84594931642,84594931646,4,1461,1436,-30
84595675406,84595675407,1,1100,291,-30
84596544194,84596544177,-17,766,287,-30
84597089990,84597089994,4,1571,1303,-30
84598374226,84598374212,-14,613,86,-30
84599226641,84599226646,5,2184,1076,-30
84600523251,84600523252,1,1226,1399,-30
84602298178,84602298183,5,3324,1848,-30
84603245691,84603245694,3,1275,1383,-30
84606553049,84606553054,5,2359,1255,-30
84609114619,84609114622,3,2701,1431,-30
84617869469,84617869473,4,2177,1227,-30
84619719937,84619719943,6,3396,1855,-30
84622245475,84622245478,3,2376,1286,-30
84622883148,84622883129,-19,1061,483,-30
84623119430,84623119432,2,2720,1407,-30
84624538678,84624538682,4,2280,1494,-30
84627014214,84627014217,3,33806,30477,-30
84627312009,84627312014,5,3796,1812,-30
84631599170,84631599175,5,2583,1220,-30
84632528190,84632528196,6,1922,1207,-30
84634033942,84634033947,5,2014,1596,-30
84635720509,84635720513,4,3043,1384,-30
84639245971,84639245975,4,1687,1053,-30
84640333607,84640333595,-12,37026,16000,-30
84642717146,84642717152,6,3051,1413,-30
84649993024,84649993020,-4,1628,3996,-30
84650873496,84650873501,5,1952,2022,-30
84651100185,84651100190,5,2431,1151,-30
84651594652,84651594659,7,2725,1335,-30
84653119612,84653119609,-3,695,1818,-30
84653652215,84653652221,6,2113,1427,-30
84653932417,84653932423,6,2088,1544,-30
84659217414,84659217419,5,2183,1592,-30
84660326125,84660326131,6,1752,1399,-30
84662159819,84662159824,5,2779,1199,-30
84666200254,84666200260,6,1972,1031,-30
84666796342,84666796348,6,2622,1263,-30
84669974784,84669974792,8,3332,1505,-30
84670868588,84670868591,3,1912,1221,-30
84675777669,84675777674,5,2058,1291,-30
84676195069,84676195066,-3,1525,2583,-30
84679322238,84679322242,4,2123,1221,-30
84680693328,84680693333,5,2050,1377,-30
84682916326,84682916332,6,2947,1558,-30
84683818577,84683818582,5,2786,1560,-30
84686325622,84686325627,5,2625,1140,-30
84686478169,84686478177,8,2543,1147,-30
84687024701,84687024709,8,2285,1015,-30
84687668623,84687668624,1,1648,1726,-30
84688706546,84688706539,-7,816,4185,-30
84689640689,84689640695,6,2486,1230,-30
84694688881,84694688886,5,2995,1066,-30
84696228414,84696228419,5,2248,1229,-30
84698287454,84698287460,6,1906,876,-30
84699009087,84699009067,-20,2067,1161,-30
84703198463,84703198469,6,2681,1920,-30
84703856886,84703856891,5,8926,5214,-30
84706809730,84706809735,5,2117,1216,-30
84707740218,84707740225,7,3308,1575,-30
84710226904,84710226909,5,1695,1150,-30
84712980545,84712980551,6,2387,1100,-30
84713431125,84713431146,21,1802,760,-30
84715767474,84715767478,4,2383,1061,-30
84720538986,84720538990,4,2043,950,-30
84721162476,84721162481,5,1685,854,-30
84721443674,84721443678,4,2044,1211,-30
84722993457,84722993459,2,1381,1414,-30
84724204211,84724204216,5,1967,1169,-30
84726641246,84726641242,-4,890,1335,-30
84730834747,84730834755,8,2267,902,-30
84734676559,84734676562,3,1704,1569,-30
84734744380,84734744360,-20,2388,1323,-30
84739400496,84739400502,6,2328,1066,-30
84741852679,84741852681,2,1324,1088,-30
84742435890,84742435897,7,1346,1131,-30
84744387557,84744387562,5,2251,1259,-30
84747579026,84747579025,-1,1672,2092,-30
84748762268,84748762273,5,3553,1764,-30
84750828166,84750828170,4,1257,1359,-30
84751147649,84751147655,6,1666,1068,-30
84753029498,84753029513,15,2916,1251,-30
84753773353,84753773358,5,2576,1263,-30
84754428998,84754429008,10,2694,1267,-30
84755045701,84755045706,5,1841,1083,-30
84758981419,84758981414,-5,979,3667,-30
84768003312,84768003316,4,2243,1440,-30
84770565243,84770565249,6,2207,1267,-30
84775846266,84775846270,4,1971,852,-30
84783492498,84783492503,5,2385,1472,-30
84786121862,84786121867,5,1736,1153,-30
84786501398,84786501409,11,6648,43849,-30
84787256954,84787256958,4,1946,1085,-30
84789755376,84789755380,4,1615,1682,-30
84793968806,84793968810,4,1893,1215,-30
84800119781,84800119786,5,1793,730,-30
84805481328,84805481334,6,2672,1546,-30
84808436610,84808436617,7,2944,1166,-30
84808839811,84808839796,-15,1555,981,-30
84814017904,84814017911,7,2624,1242,-30
84815107647,84815107650,3,2231,1549,-30
84817921293,84817921281,-12,1259,769,-30
84820120839,84820120836,-3,1543,3774,-30
84820844805,84820844808,3,2776,1926,-30
84821892691,84821892697,6,4676,1686,-30
84827125125,84827125130,5,1969,1121,-30
84827502306,84827502311,5,3190,1394,-30
84832119510,84832119515,5,2411,857,-30
84835935864,84835935871,7,1789,928,-30
84839062861,84839062866,5,1809,1128,-30
84840382815,84840382821,6,4012,1905,-30
84841007516,84841007522,6,1849,1404,-30
84841470169,84841470171,2,529,224,-30
84849473425,84849473423,-2,2525,4592,-30
84850489033,84850489037,4,2011,1381,-30
84856145437,84856145442,5,1657,1162,-30
84856849271,84856849277,6,2739,1253,-30
84857245053,84857245059,6,1721,1084,-30
84857754742,84857754748,6,1885,1310,-30
84864014810,84864014813,3,1758,1468,-30
84864076244,84864076228,-16,3181,1377,-30
84870120533,84870120539,6,3576,2285,-30
84870806574,84870806578,4,2695,1613,-30
84872668385,84872668390,5,1444,1239,-30
84877380286,84877380290,4,2857,1183,-30
84880618279,84880618283,4,1134,1294,-30
84880751202,84880751217,15,1423,1134,-30
84881762195,84881762199,4,821,754,-30
84882352692,84882352695,3,2137,1141,-30
84884665384,84884665387,3,1349,622,-30
84885656658,84885656665,7,2456,1417,-30
84886099185,84886099191,6,3345,1324,-30
84886390182,84886390187,5,2621,1514,-30
84886886171,84886886175,4,2238,1590,-30
84890095927,84890095933,6,3203,1705,-30
84890250793,84890250799,6,2213,1394,-30
84890587025,84890587031,6,1974,960,-30
84891767900,84891767906,6,2260,1300,-30
84893108968,84893108973,5,2769,1367,-30
84895069226,84895069232,6,2963,1871,-30
84895402364,84895402370,6,2324,1600,-30
84897375683,84897375686,3,1810,1186,-30
84900568367,84900568371,4,2802,1696,-30
84901373329,84901373335,6,2058,1182,-30
84903454085,84903454090,5,2398,1188,-30
84904205646,84904205652,6,1690,1277,-30
84904422812,84904422827,15,1757,1142,-30
84905107924,84905107907,-17,5642,759,-30
84907903064,84907903068,4,1273,1614,-30
84909536910,84909536917,7,2179,1134,-30
84912607442,84912607447,5,2800,1435,-30
84916112522,84916112527,5,2684,1033,-30
84920163292,84920163296,4,10693,24688,-30
84921117765,84921117766,1,1372,1479,-30
84921187928,84921187932,4,2859,1596,-30
84921803506,84921803510,4,2736,2324,-30
84924867098,84924867102,4,2506,1758,-30
84925035867,84925035870,3,1047,850,-30
84925769096,84925769104,8,2523,1502,-30
84926793371,84926793375,4,2503,1405,-30
84932137239,84932137242,3,2401,1914,-30
84932251227,84932251233,6,2992,1309,-30
84932437385,84932437391,6,1947,796,-30
84933371704,84933371710,6,2860,1957,-30
84934696953,84934696958,5,2785,1991,-30
84935637973,84935637978,5,2441,1346,-30
84936599794,84936599798,4,2516,1259,-30
84937105154,84937105158,4,1670,1210,-30
84938173293,84938173298,5,2278,1929,-30
84940961297,84940961302,5,2379,1391,-30
84942295903,84942295911,8,3682,1264,-30
84943767855,84943767859,4,1867,1624,-30
84946706313,84946706317,4,1604,1023,-30
84949075064,84949075069,5,1543,1265,-30
84951262503,84951262506,3,1478,1423,-30
84951815552,84951815556,4,2391,1571,-30
84955656291,84955656289,-2,1068,1529,-30
84965047498,84965047503,5,1876,1475,-30
84968930689,84968930694,5,1974,1091,-30
84969321077,84969321097,20,2490,1000,-30
84969812023,84969812028,5,2352,1303,-30
84970997317,84970997326,9,3301,1209,-30
84971444102,84971444083,-19,2382,1019,-30
84973057010,84973057015,5,2692,1068,-30
84976493030,84976493034,4,1671,686,-30
84978936797,84978936803,6,1379,1398,-30
84981994304,84981994301,-3,1343,4800,-30
84982713249,84982713254,5,1962,1331,-30
84984334073,84984334088,15,1191,2,-30
84985830434,84985830429,-5,835,2010,-30
84992907770,84992907774,4,2351,1499,-30
84993616021,84993616024,3,2126,1517,-30
84996183242,84996183248,6,2076,1186,-30
84997591975,84997591980,5,2151,1230,-30
84997657614,84997657618,4,552,154,-30
85001436572,85001436577,5,2483,1168,-30
85002088847,85002088851,4,1428,743,-30
85006445298,85006445304,6,1989,1354,-30
85009921893,85009921898,5,1739,1340,-30
85011253574,85011253582,8,2132,1116,-30
85011622193,85011622199,6,2604,1726,-30
85011697922,85011697927,5,2555,1479,-30
85012466034,85012466039,5,2492,1301,-30
85018332129,85018332134,5,2120,1032,-30
85019670442,85019670439,-3,971,3198,-30
85021885483,85021885497,14,2816,7709,-30
85024004139,85024004145,6,2288,1189,-30
85025171803,85025171808,5,2900,1635,-30
85028635426,85028635430,4,2594,1385,-30
85029117599,85029117611,12,1247,1195,-30
85032961123,85032961127,4,2945,1631,-30
85040016249,85040016253,4,1534,1513,-30
85042966062,85042966067,5,2481,1350,-30
85044040922,85044040927,5,2491,1466,-30
85044658177,85044658184,7,22986,56754,-30
85047039685,85047039688,3,2287,1586,-30
85048844236,85048844242,6,2083,958,-30
85048980842,85048980847,5,2141,1991,-30
85050563851,85050563857,6,2171,1091,-30
85051996950,85051996955,5,2840,1141,-30
85054561283,85054561286,3,1266,938,-30
85054890642,85054890647,5,2484,1323,-30
85056544907,85056544915,8,1692,1053,-30
85061789877,85061789871,-6,1151,2704,-30
85063484742,85063484747,5,2235,1256,-30
85065585794,85065585799,5,1784,994,-30
85066862022,85066862027,5,2852,1171,-30
85067613623,85067613609,-14,79,569,-30
85070221175,85070221180,5,2758,1290,-30
85071722422,85071722430,8,3392,1509,-30
85072931213,85072931218,5,2060,1064,-30
85074944052,85074944066,14,16465,45972,-30
85075754532,85075754538,6,2548,1736,-30
85076481913,85076481918,5,2065,1319,-30
85077519423,85077519425,2,1325,1603,-30
85084780559,85084780565,6,2438,1787,-30
85085953747,85085953752,5,2447,1334,-30
85086670625,85086670609,-16,2045,1284,-30
85087388213,85087388219,6,1905,1566,-30
85087644592,85087644599,7,2756,1182,-30
85092159337,85092159342,5,2460,1207,-30
85093447856,85093447861,5,2200,1300,-30
85093574811,85093574795,-16,3166,1649,-30
85093755434,85093755439,5,1631,1219,-30
85095771279,85095771285,6,2554,1035,-30
85096170194,85096170199,5,3594,1578,-30
85096487054,85096487060,6,2040,943,-30
85097421726,85097421731,5,2057,1337,-30
85098562171,85098562177,6,2159,999,-30
85099178174,85099178178,4,1793,1236,-30
85100823686,85100823694,8,1557,1149,-30
85101240181,85101240178,-3,1344,3490,-30
85104602692,85104602694,2,2210,1051,-30
85105218334,85105218312,-22,1226,845,-30
85110613833,85110613830,-3,1275,2664,-30
85112885526,85112885532,6,2665,1779,-30
85114496558,85114496563,5,2485,1209,-30
85116310341,85116310347,6,2919,1069,-30
85117234850,85117234854,4,821,1125,-30
85121841763,85121841768,5,2134,1488,-30
85122037063,85122037067,4,2041,1134,-30
85122214826,85122214835,9,2160,1373,-30
85122284539,85122284554,15,2506,1384,-30
85122530209,85122530196,-13,3381,1175,-30
85127312170,85127312174,4,1907,1202,-30
85129258990,85129258991,1,2945,2919,-30
85136712037,85136712042,5,2114,1165,-30
85140447735,85140447712,-23,2319,1128,-30
85140798843,85140798844,1,1251,1490,-30
85142654014,85142654018,4,2355,1276,-30
85142940003,85142940006,3,1256,945,-30
85147144597,85147144593,-4,187,1383,-30
85147991019,85147991024,5,1734,1094,-30
85148066414,85148066409,-5,1712,4862,-30
85148224386,85148224391,5,1769,1254,-30
85148943073,85148943077,4,2672,1479,-30
85149300585,85149300590,5,1966,1250,-30
85150731035,85150731040,5,2985,2088,-30
85152262478,85152262482,4,2508,1895,-30
85152780002,85152780007,5,2248,1080,-30
85153019218,85153019221,3,3133,1497,-30
85153125425,85153125429,4,1673,1251,-30
85153939001,85153939004,3,2534,1474,-30
85155979925,85155979929,4,2276,1311,-30
85160814654,85160814659,5,1896,1193,-30
85165464717,85165464722,5,2852,1769,-30
85170666209,85170666214,5,2166,1314,-30
85171246339,85171246343,4,1263,1027,-30
85171912994,85171912999,5,2824,1430,-30
85177870847,85177870854,7,5075,1169,-30
85179875644,85179875643,-1,1134,1472,-30
85180805010,85180805016,6,2441,1452,-30
85190639926,85190639931,5,1669,1001,-30
85190973904,85190973906,2,1903,1325,-30
85193136086,85193136090,4,2159,1304,-30
85193482592,85193482597,5,2437,1257,-30
85202231816,85202231817,1,1644,1690,-30
85203097660,85203097666,6,2130,1787,-30
85203215070,85203215051,-19,2229,1341,-30
85208802641,85208802648,7,3096,1316,-30
85209236096,85209236114,18,2751,1370,-30
85209823390,85209823369,-21,2534,1168,-30
85217015774,85217015781,7,1515,1308,-30
85219067416,85219067421,5,2949,1657,-30
85219134693,85219134698,5,2043,1176,-30
85221529986,85221529994,8,1045,347,-30
85222908195,85222908201,6,2000,1594,-30
85223603173,85223603178,5,1643,1785,-30
85223932570,85223932575,5,2058,1040,-30
85225938319,85225938324,5,3003,1776,-30
85231862778,85231862783,5,2386,1102,-30
85232360703,85232360691,-12,1075,540,-30
85236573573,85236573578,5,1604,1306,-30
85241923957,85241923958,1,1289,1814,-30
85245757682,85245757687,5,1776,1151,-30
85248870149,85248870152,3,2302,1704,-30
85250883020,85250883025,5,2834,1208,-30
85258241734,85258241739,5,2969,1176,-30
85260000399,85260000397,-2,1128,1495,-30
85265353557,85265353561,4,2731,1423,-30
85271215616,85271215622,6,2784,1580,-30
85279440551,85279440554,3,3186,1516,-30
85282539351,85282539355,4,2936,1168,-30
85290049294,85290049299,5,1628,1245,-30
85290859473,85290859479,6,3396,1247,-30
85293185129,85293185125,-4,1858,6500,-30
85293848627,85293848630,3,1794,1131,-30
85294016026,85294016031,5,2766,1292,-30
85295449695,85295449699,4,2139,1240,-30
85299367733,85299367737,4,2887,1904,-30
85301625385,85301625393,8,4480,1589,-30
85302537143,85302537150,7,2132,957,-30
85304947860,85304947867,7,1064,724,-30
85306554353,85306554358,5,1783,1219,-30
85306769869,85306769850,-19,908,290,-30
85309390729,85309390726,-3,22186,14926,-30
85313728946,85313728951,5,2343,1178,-30
85314385573,85314385578,5,2011,1045,-30
85321979323,85321979328,5,2839,1134,-30
85323293925,85323293929,4,1072,982,-30
85332095225,85332095231,6,3277,1342,-30
85335702633,85335702638,5,2302,1549,-30
85337717870,85337717875,5,2768,890,-30
85338485593,85338485595,2,1521,1126,-30
85341111824,85341111827,3,1630,738,-30
85341167992,85341168010,18,2434,1547,-30
85351131638,85351131646,8,10,908,-30
85355754960,85355754966,6,2608,960,-30
85356265485,85356265490,5,1355,1201,-30
85356826055,85356826061,6,2424,1415,-30
85357686401,85357686406,5,1678,985,-30
85357920500,85357920506,6,2916,1358,-30
85358407997,85358408019,22,3796,1341,-30
85358608931,85358608921,-10,979,388,-30
85374172230,85374172235,5,9985,6623,-30
85378556637,85378556640,3,2195,1718,-30
85379229393,85379229398,5,2684,1254,-30
85380382478,85380382479,1,40721,45834,-30
85381097094,85381097097,3,1382,1202,-30
85382522553,85382522559,6,2593,1698,-30
85383404151,85383404155,4,2857,1737,-30
85384517266,85384517271,5,1930,1505,-30
85386446389,85386446389,0,2137,1442,-30
85386868306,85386868310,4,2021,1232,-30
85388050533,85388050538,5,2301,1235,-30
85392476645,85392476650,5,2266,1321,-30
85396225726,85396225732,6,1124,649,-30
85399463966,85399463971,5,2675,1490,-30
85401668916,85401668921,5,2567,1950,-30
85403189476,85403189478,2,1908,1256,-30
85404212945,85404212941,-4,1580,4229,-30
85405777458,85405777468,10,2537,1567,-30
85408861690,85408861694,4,2143,1490,-30
85412862363,85412862369,6,2668,1476,-30
85414150348,85414150355,7,2447,1054,-30
85422476911,85422476915,4,3050,1300,-30
85423648585,85423648591,6,2857,1228,-30
85429316574,85429316578,4,3432,2167,-30
85430262666,85430262666,0,1478,2132,-30
85432831441,85432831446,5,2541,1327,-30
85434550804,85434550809,5,2375,962,-30
85435697932,85435697934,2,1854,1353,-30
85436276313,85436276310,-3,1621,3367,-30
85438855768,85438855774,6,3906,1359,-30
85440741854,85440741861,7,2770,1814,-30
85444874094,85444874101,7,4710,1955,-30
85447950449,85447950456,7,1294,1234,-30
85450191026,85450191034,8,2770,1255,-30
85451034623,85451034626,3,1506,1490,-30
85455022590,85455022594,4,2114,1463,-30
85455663571,85455663577,6,2596,1800,-30
85456778702,85456778707,5,2235,1184,-30
85459128098,85459128103,5,1958,1644,-30
85462589232,85462589229,-3,1798,5883,-30
85463600670,85463600674,4,1805,1278,-30
85468147954,85468147957,3,1840,1168,-30
85468625245,85468625251,6,1732,1161,-30
85469246917,85469246923,6,1735,710,-30
85469738194,85469738197,3,2747,1508,-30
85470514053,85470514057,4,2233,1251,-30
85473384184,85473384190,6,2416,1051,-30
85475471959,85475471957,-2,1074,1960,-30
85479386534,85479386537,3,1239,1177,-30
85481348570,85481348574,4,2436,1536,-30
85483930858,85483930862,4,1905,1144,-30
85488845054,85488845059,5,2237,1379,-30
85489732771,85489732775,4,1016,738,-30
85493970383,85493970389,6,2267,1216,-30
85498599605,85498599609,4,1622,605,-30
85500082477,85500082482,5,2795,1452,-30
85500198686,85500198686,0,1462,1435,-30
85500542398,85500542402,4,2744,1375,-30
85502598187,85502598190,3,2227,1128,-30
85506015067,85506015071,4,2391,1558,-30
85506716010,85506716015,5,1920,1015,-30
85510444268,85510444284,16,1137,3471,-30
85514777414,85514777418,4,1920,1383,-30
85514843855,85514843875,20,1968,925,-30
85517337994,85517338007,13,1729,815,-30
85518855465,85518855470,5,2154,1576,-30
85519445882,85519445886,4,2596,2059,-30
85519780338,85519780341,3,1896,1137,-30
85525671872,85525671875,3,1833,1289,-30
85526801215,85526801222,7,3272,1465,-30
85531419950,85531419944,-6,1775,6787,-30
85533376372,85533376369,-3,4849,10694,-30
85535138649,85535138654,5,2341,1062,-30
85535694401,85535694396,-5,37499,14830,-30
85536397473,85536397479,6,2261,1613,-30
85537021514,85537021513,-1,1156,1322,-30
85538481402,85538481406,4,1777,1032,-30
85542410678,85542410682,4,2277,1224,-30
85545346383,85545346387,4,1926,1118,-30
85549091238,85549091243,5,2548,1171,-30
85551374445,85551374450,5,1527,1079,-30
85553662131,85553662136,5,2189,1548,-30
85554901988,85554901993,5,1602,1284,-30
85556053901,85556053906,5,1634,1315,-30
85556941834,85556941838,4,2009,935,-30
85566497038,85566497036,-2,939,1974,-30
85567684542,85567684546,4,1898,1289,-30
85569162523,85569162527,4,1759,1342,-30
85570798634,85570798640,6,3696,1583,-30
85572908011,85572908010,-1,1662,2653,-30
85574393225,85574393231,6,3142,1102,-30
85575714262,85575714266,4,1707,994,-30
85581969481,85581969486,5,1818,887,-30
85584266501,85584266506,5,3463,1936,-30
85584793024,85584793022,-2,993,2428,-30
85585436295,85585436294,-1,1457,1917,-30
85586787870,85586787876,6,1970,1304,-30
85587867845,85587867849,4,2280,1554,-30
85595131437,85595131443,6,1902,1381,-30
85597157317,85597157322,5,1885,1214,-30
85597989555,85597989562,7,2861,1660,-30
85600681934,85600681933,-1,907,1257,-30
85601642662,85601642666,4,2021,1628,-30
85601855886,85601855906,20,2544,1319,-30
85609617034,85609617041,7,2451,1567,-30
85609826024,85609826030,6,1600,1239,-30
85615089826,85615089831,5,2787,1246,-30
85615262956,85615262938,-18,1955,1129,-30
85619429809,85619429811,2,1748,1299,-30
85619616833,85619616842,9,2761,1269,-30
85626263610,85626263615,5,2184,1257,-30
85626554722,85626554726,4,2540,1076,-30
85627555006,85627555013,7,2285,1319,-30
85628532502,85628532499,-3,3121,6057,-30
85628989384,85628989386,2,13270,49774,-30
85630542284,85630542286,2,1091,532,-30
85633768084,85633768089,5,2125,1366,-30
85635919132,85635919133,1,1230,1875,-30
85637394503,85637394507,4,1705,1171,-30
85641392489,85641392477,-12,1248,755,-30
85643733690,85643733694,4,2109,1208,-30
85644278122,85644278128,6,2440,1642,-30
85649834974,85649834978,4,1446,856,-30
85649935742,85649935752,10,1815,1214,-30
85650516911,85650516918,7,1987,1238,-30
85657967053,85657967061,8,608,298,-30
85660364688,85660364691,3,2004,876,-30
85661823732,85661823735,3,1787,1151,-30
85662292713,85662292719,6,2742,1669,-30
85662444375,85662444380,5,1249,988,-30
85662764818,85662764823,5,1873,1131,-30
85663401826,85663401831,5,3271,1138,-30
85665893938,85665893943,5,3215,1407,-30
85666276575,85666276578,3,1774,1114,-30
85668979061,85668979066,5,2544,1628,-30
85671870917,85671870922,5,2230,918,-30
85672201862,85672201865,3,2195,1701,-30
85674244625,85674244630,5,2392,1207,-30
85674622598,85674622603,5,1927,1010,-30
85676941749,85676941752,3,2109,1249,-30
85677274041,85677274042,1,1123,934,-30
85678333437,85678333442,5,1483,1692,-30
85679057586,85679057591,5,2434,694,-30
85688395249,85688395254,5,2023,1708,-30
85689968721,85689968726,5,2509,1153,-30
85690061089,85690061096,7,1403,1120,-30
85690499329,85690499327,-2,939,1064,-30
85692000511,85692000515,4,2000,1251,-30
85694685646,85694685651,5,3063,1182,-30
85695326470,85695326475,5,1271,841,-30
85700518149,85700518153,4,1752,1019,-30
85702013156,85702013163,7,2331,1521,-30
85705261229,85705261235,6,3237,1368,-30
85707118134,85707118139,5,1859,1194,-30
85708939962,85708939967,5,3266,1295,-30
85709064550,85709064554,4,1418,830,-30
85713065060,85713065065,5,2271,966,-30
85716272792,85716272790,-2,2109,5148,-30
85716355428,85716355432,4,1917,1649,-30
85719670217,85719670222,5,2139,1687,-30
85719845157,85719845161,4,2059,926,-30
85719939823,85719939841,18,590,286,-30
85722338326,85722338333,7,14072,25516,-30
85724048851,85724048855,4,2369,1924,-30
85728768238,85728768243,5,1693,849,-30
85729298522,85729298529,7,2660,1544,-30
85732929330,85732929334,4,2018,1212,-30
85734660530,85734660536,6,2629,1457,-30
85737571673,85737571681,8,3454,1060,-30
85738385945,85738385949,4,1611,1191,-30
85738585933,85738585937,4,2531,1223,-30
85740777817,85740777821,4,1752,990,-30
85741833604,85741833611,7,1612,675,-30
85745042606,85745042610,4,5329,3202,-30
85748601046,85748601051,5,8942,25704,-30
85750351834,85750351838,4,2507,1305,-30
85751511348,85751511353,5,2779,1518,-30
85752687789,85752687798,9,1523,1085,-30
85753764123,85753764128,5,2388,916,-30
85757479446,85757479453,7,1401,818,-30
85758339407,85758339413,6,2011,1397,-30
85760088261,85760088266,5,1926,1087,-30
85760334013,85760334017,4,2660,1381,-30
85760532447,85760532425,-22,1715,1348,-30
85760696850,85760696854,4,2324,1074,-30
85763045792,85763045797,5,3602,1521,-30
85764917934,85764917943,9,2327,912,-30
85765514866,85765514870,4,2151,1478,-30
85766529397,85766529402,5,2376,1373,-30
85767329292,85767329298,6,2201,1475,-30
85768401905,85768401910,5,2164,1354,-30
85772983998,85772984002,4,2208,1329,-30
85774237926,85774237930,4,2743,1560,-30
85774483589,85774483591,2,1475,997,-30
85774902578,85774902582,4,1617,973,-30
85778232429,85778232434,5,1822,1074,-30
85778377933,85778377947,14,1524,994,-30
85779034048,85779034051,3,1382,1565,-30
85779479383,85779479389,6,516,351,-30
85782261875,85782261879,4,1316,796,-30
85785302434,85785302440,6,3827,1646,-30
85786235223,85786235227,4,2713,1373,-30
85787260930,85787260935,5,1093,894,-30
85787995610,85787995614,4,1770,1484,-30
85788754116,85788754123,7,2621,1380,-30
85790959752,85790959757,5,2159,824,-30
85792124028,85792124035,7,2096,1058,-30
85793440902,85793440905,3,1775,829,-30
85805610935,85805610941,6,2629,1105,-30
85807631561,85807631565,4,2344,1246,-30
85809359027,85809359034,7,2187,1233,-30
85815634648,85815634653,5,1722,1334,-30
85816022779,85816022784,5,2503,1629,-30
85822017013,85822017018,5,2115,998,-30
85823719101,85823719105,4,1636,851,-30
85825670630,85825670635,5,2529,1339,-30
85825987559,85825987563,4,1674,1225,-30
85828533075,85828533079,4,2078,1530,-30
85831437855,85831437862,7,2508,1478,-30
85833052203,85833052207,4,1711,1114,-30
85836004688,85836004694,6,3109,1591,-30
85838252613,85838252618,5,2557,1413,-30
85839593190,85839593195,5,2531,1528,-30
85841286089,85841286095,6,2158,1155,-30
85843792310,85843792315,5,2250,1329,-30
85844836381,85844836387,6,2190,1696,-30
85845385876,85845385878,2,2214,1389,-30
85847785963,85847785967,4,2071,1244,-30
85847894964,85847894947,-17,2056,1022,-30
85850039986,85850039989,3,1783,1484,-30
85853803846,85853803853,7,2329,969,-30
85856451308,85856451311,3,899,721,-30
85856860202,85856860209,7,1639,1118,-30
85857164710,85857164717,7,2573,1591,-30
85858901273,85858901279,6,2406,1285,-30
85861374831,85861374835,4,2100,1133,-30
85862076525,85862076530,5,1601,785,-30
85862457787,85862457768,-19,2744,1945,-30
85863486515,85863486513,-2,2042,3806,-30
85865409957,85865409962,5,2444,1575,-30
85866470909,85866470915,6,2147,1137,-30
85867360314,85867360320,6,2428,1088,-30
85867852826,85867852818,-8,1331,6558,-30
85869514362,85869514366,4,2197,1355,-30
85872189804,85872189807,3,2318,1174,-30
85873279637,85873279643,6,3013,1407,-30
85874232974,85874232982,8,2681,1282,-30
85877794906,85877794909,3,2228,1437,-30
85881124870,85881124874,4,1488,1286,-30
85881368563,85881368545,-18,1230,472,-30
85883243981,85883243986,5,1530,934,-30
85886410002,85886409982,-20,3017,1813,-30
85887769787,85887769792,5,1557,894,-30
85896958971,85896958975,4,2478,1580,-30
85899227050,85899227054,4,1830,1982,-30
85906499691,85906499695,4,1299,894,-30
85906794635,85906794626,-9,1023,495,-30
85916283530,85916283533,3,2003,1810,-30
85918151412,85918151418,6,2336,1480,-30
85918214628,85918214608,-20,2846,1773,-30
85918920877,85918920882,5,1737,596,-30
85919585354,85919585358,4,2441,994,-30
85921818282,85921818289,7,2692,1870,-30
85923187070,85923187073,3,2085,1437,-30
85928889882,85928889887,5,1969,1063,-30
85929477318,85929477324,6,2365,1156,-30
85941871434,85941871438,4,2328,1183,-30
85943049847,85943049851,4,903,466,-30
85944227479,85944227473,-6,1014,3304,-30
85946974054,85946974059,5,1530,745,-30
85949078145,85949078151,6,1993,1027,-30
85951281983,85951281989,6,2816,1262,-30
85951814123,85951814118,-5,1437,3802,-30
85952227888,85952227895,7,2318,1625,-30
85956630143,85956630146,3,1743,949,-30
85957021322,85957021322,0,1382,1703,-30
85958266929,85958266936,7,8786,2497,-30
85959132534,85959132534,0,1783,965,-30
85961088179,85961088184,5,2500,1268,-30
85962116686,85962116691,5,1945,1252,-30
85962203009,85962203013,4,2000,1268,-30
85965135084,85965135090,6,1629,886,-30
85965453555,85965453561,6,2696,1426,-30
85970265878,85970265884,6,2544,1057,-30
85971710405,85971710411,6,2218,1397,-30
85973517527,85973517531,4,1528,854,-30
85975903278,85975903283,5,2665,1637,-30
85979094633,85979094638,5,2071,1447,-30
85983701810,85983701817,7,2064,1245,-30
85984320386,85984320390,4,2943,1356,-30
85984629229,85984629237,8,2191,1019,-30
85984950131,85984950138,7,2423,1543,-30
85986700915,85986700919,4,1774,1399,-30
85993196043,85993196047,4,2124,1237,-30
85995830702,85995830700,-2,2079,2810,-30
85997899366,85997899367,1,771,1743,-30
86004721862,86004721876,14,17,2020,-30
86010431751,86010431758,7,2441,835,-30
86011129800,86011129807,7,3107,1518,-30
86012606308,86012606313,5,2807,1379,-30
86012698562,86012698566,4,2540,1583,-30
86016752354,86016752359,5,2213,1495,-30
86021033887,86021033893,6,1707,1283,-30
86023817271,86023817272,1,1509,1457,-30
86024936592,86024936597,5,2195,1458,-30
86025058301,86025058305,4,2270,1425,-30
86026000284,86026000291,7,2355,966,-30
86027176490,86027176495,5,2922,1651,-30
86027850137,86027850141,4,1321,753,-30
86028759658,86028759664,6,2522,1467,-30
86029595771,86029595778,7,2584,1410,-30
86035895771,86035895777,6,1748,1541,-30
86042958604,86042958609,5,2418,1251,-30
86044933753,86044933759,6,1343,1202,-30
86048891228,86048891231,3,1296,1261,-30
86049105851,86049105852,1,1531,2236,-30
86049441002,86049441007,5,2159,964,-30
86051536831,86051536851,20,2690,1343,-30
86056887833,86056887839,6,2282,1607,-30
86060781294,86060781298,4,2430,1615,-30
86064080070,86064080075,5,2205,1510,-30
86064644917,86064644921,4,2670,1233,-30
86066146402,86066146384,-18,1577,630,-30
86067374354,86067374361,7,2872,1363,-30
86073212370,86073212374,4,1993,1309,-30
86075979446,86075979450,4,2215,1228,-30
86085483284,86085483298,14,14459,42567,-30
86086145462,86086145462,0,3418,3572,-30
86086176309,86086176315,6,4672,2425,-30
86087876137,86087876142,5,1636,945,-30
86087913934,86087913940,6,2316,1676,-30
86092607257,86092607263,6,2442,1219,-30
86092838701,86092838706,5,2039,1395,-30
86093789772,86093789778,6,2784,1676,-30
86098661851,86098661855,4,2251,1499,-30
86099820394,86099820390,-4,751,2623,-30
86099950443,86099950448,5,2308,1389,-30
86100405008,86100405013,5,1574,1386,-30
86112473386,86112473393,7,2989,1448,-30
86116686261,86116686267,6,2406,1621,-30
86119335006,86119335011,5,2294,1563,-30
86121068361,86121068366,5,2422,1651,-30
86121964913,86121964917,4,1611,1421,-30
86126074033,86126074039,6,3570,1734,-30
86128031398,86128031402,4,2262,1239,-30
86132270275,86132270280,5,1752,1426,-30
86135389238,86135389242,4,3649,1724,-30
86137758230,86137758234,4,3239,1966,-30
86139484175,86139484182,7,3510,1515,-30
86139607422,86139607427,5,1553,1100,-30
86140342054,86140342058,4,2210,1030,-30
86142264894,86142264898,4,3673,1521,-30
86144994170,86144994169,-1,1655,1543,-30
86147091134,86147091139,5,2036,1383,-30
86152318543,86152318538,-5,1051,2779,-30
86152568365,86152568370,5,2092,1457,-30
86153370994,86153370998,4,2321,1216,-30
86157931071,86157931074,3,915,875,-30
86158673176,86158673181,5,2880,1847,-30
86161127730,86161127736,6,2007,1532,-30
86161568834,86161568837,3,1486,1491,-30
86162043976,86162043962,-14,2298,1155,-30
86171401113,86171401117,4,1423,1134,-30
86171840910,86171840915,5,2055,1433,-30
86173732908,86173732914,6,2682,1311,-30
86177101095,86177101102,7,1454,1042,-30
86177905480,86177905486,6,2096,1074,-30
86178839019,86178839018,-1,1430,1880,-30
86181006038,86181006042,4,1898,1309,-30
86184105758,86184105762,4,3245,819,-30
86186016133,86186016137,4,1993,838,-30
86187771408,86187771414,6,1930,1048,-30
86189927837,86189927843,6,2489,897,-30
86190045748,86190045753,5,1848,1648,-30
86192765932,86192765913,-19,104,3869,-30
86193475281,86193475288,7,4360,1384,-30
86193617027,86193617012,-15,2337,1535,-30
86194308726,86194308730,4,2791,1315,-30
86198544948,86198544953,5,2761,1141,-30
86198657221,86198657227,6,1739,1024,-30
86205185660,86205185663,3,2570,1491,-30
86205268291,86205268295,4,1645,1168,-30
86207609050,86207609054,4,1363,1134,-30
86209561389,86209561391,2,1969,1384,-30
86212142588,86212142593,5,2438,1266,-30
86214847082,86214847087,5,2439,1616,-30
86216802125,86216802131,6,1385,1111,-30
86221263407,86221263411,4,1872,1501,-30
86222097881,86222097886,5,1908,1201,-30
86222579584,86222579589,5,1454,1344,-30
86225568121,86225568125,4,1424,1011,-30
86226498017,86226498021,4,2139,1209,-30
86227659243,86227659249,6,2325,1553,-30
86234912580,86234912583,3,2218,1250,-30
86238637757,86238637762,5,1679,1264,-30
86239705645,86239705650,5,1665,752,-30
86239991356,86239991361,5,2669,1372,-30
86241386450,86241386457,7,2229,1223,-30
86245496335,86245496338,3,1824,1285,-30
86248309006,86248309010,4,1205,970,-30
86250499223,86250499229,6,2357,1182,-30
86262565161,86262565165,4,2291,1347,-30
86273104353,86273104356,3,2103,1551,-30
86275854502,86275854506,4,1923,897,-30
86276138742,86276138742,0,3096,4232,-30
86276394874,86276394879,5,1887,837,-30
86279085025,86279085028,3,3123,1838,-30
86279939642,86279939645,3,5289,3804,-30
86285221669,86285221661,-8,3261,7502,-30
86286342665,86286342669,4,1703,1122,-30
86287094777,86287094782,5,1728,803,-30
86289221131,86289221135,4,2210,1378,-30
86293877603,86293877607,4,1268,524,-30
86294497180,86294497162,-18,1307,799,-30
86297517847,86297517851,4,1901,1193,-30
86298167657,86298167662,5,2261,1020,-30
86300430503,86300430509,6,2023,1220,-30
86306536300,86306536306,6,1955,1047,-30
86307721566,86307721570,4,1588,1084,-30
86308448477,86308448494,17,14291,53265,-30
86312082114,86312082118,4,2644,1240,-30
86312492873,86312492871,-2,2358,4404,-30
86315311061,86315311066,5,2213,1503,-30
86317452881,86317452882,1,1429,1158,-30
86319148903,86319148910,7,2629,1280,-30
86319185809,86319185811,2,2389,1325,-30
86319840653,86319840652,-1,1007,1681,-30
86319937297,86319937302,5,1982,1277,-30
86323800726,86323800733,7,2190,1093,-30
86324407478,86324407483,5,2432,1386,-30
86327030670,86327030675,5,2766,1559,-30
86329962422,86329962426,4,1926,1665,-30
86330742862,86330742867,5,2349,1274,-30
86333091397,86333091402,5,3079,1451,-30
86335482565,86335482569,4,1683,1121,-30
86337061851,86337061857,6,1835,1564,-30
86338237874,86338237879,5,2139,1464,-30
86338947774,86338947779,5,1871,1032,-30
86344650132,86344650134,2,1918,1737,-30
86345451542,86345451542,0,1163,1372,-30
86348096440,86348096447,7,2239,1494,-30
86350595669,86350595674,5,2950,1416,-30
86354747549,86354747552,3,3011,1656,-30
86354962301,86354962306,5,2399,1112,-30
86356347354,86356347359,5,2382,1209,-30
86356600917,86356600921,4,1948,1035,-30
86356831290,86356831294,4,1591,1115,-30
86357152932,86357152913,-19,2437,1446,-30
86357346581,86357346586,5,2035,784,-30
86357375986,86357375992,6,3039,1750,-30
86360364957,86360364961,4,1843,1107,-30
86360561197,86360561200,3,2330,2334,-30
86367187464,86367187468,4,1953,1407,-30
86369587505,86369587511,6,2188,1329,-30
86370364539,86370364545,6,2726,1343,-30
86371697127,86371697131,4,1928,1492,-30
86380856434,86380856438,4,2037,1037,-30
86382034178,86382034184,6,2661,1145,-30
86382717433,86382717434,1,2206,1417,-30
86384628334,86384628339,5,1629,1478,-30
86385350905,86385350909,4,1716,1689,-30
86385474226,86385474242,16,1840,1132,-30
86388345514,86388345521,7,2232,1297,-30
86404898762,86404898766,4,1907,815,-30
86408522157,86408522159,2,2272,1401,-30
86415120389,86415120395,6,1749,896,-30
86426018544,86426018549,5,3210,1439,-30
86428875841,86428875845,4,1463,960,-30
86430427838,86430427843,5,2206,1485,-30
86430905040,86430905042,2,1535,1031,-30
86431419273,86431419277,4,2423,1457,-30
86432174163,86432174170,7,1965,789,-30
86434048852,86434048857,5,2193,1304,-30
86436275520,86436275526,6,2787,1475,-30
86439165278,86439165282,4,1884,1502,-30
86444625600,86444625600,0,892,2252,-30
86444762903,86444762904,1,679,407,-30
86446256611,86446256615,4,2372,1439,-30
86449199676,86449199681,5,2653,1265,-30
86449858514,86449858521,7,2863,1221,-30
86451318485,86451318464,-21,1265,743,-30
86457834867,86457834872,5,1259,1217,-30
86460691266,86460691273,7,2155,1411,-30
86464388158,86464388166,8,1470,1128,-30
86466837150,86466837154,4,2698,1307,-30
86470304312,86470304316,4,1603,906,-30
86470476195,86470476180,-15,861,206,-30
86473529695,86473529690,-5,1406,4344,-30
86474208422,86474208427,5,2728,1697,-30
86474330391,86474330397,6,2890,1229,-30
86479007233,86479007238,5,2342,958,-30
86479703086,86479703091,5,2432,1150,-30
86486196392,86486196394,2,1278,1252,-30
86490276551,86490276553,2,1977,1709,-30
86492935657,86492935662,5,2256,1703,-30
86494503594,86494503591,-3,2039,4718,-30
86494772190,86494772199,9,3466,1138,-30
86499189870,86499189875,5,1422,1075,-30
86506005832,86506005837,5,2262,1094,-30
86506084251,86506084258,7,2773,1285,-30
86506296464,86506296467,3,1462,1292,-30
86507764329,86507764333,4,2693,1581,-30
86508282913,86508282917,4,1718,1054,-30
86510254254,86510254258,4,2218,1122,-30
86513199893,86513199898,5,1904,1069,-30
86515498317,86515498321,4,2121,1328,-30
86522941710,86522941714,4,2390,1691,-30
86525365121,86525365126,5,1543,1159,-30
86526375258,86526375263,5,2239,1417,-30
86526532301,86526532304,3,2005,1240,-30
86528161635,86528161641,6,13726,7009,-30
86538549190,86538549198,8,13133,20168,-30
86544045947,86544045954,7,2410,1323,-30
86544894058,86544894062,4,2726,1370,-30
86549934945,86549934949,4,3163,1599,-30
86551086591,86551086596,5,1985,1692,-30
86552285222,86552285227,5,1047,669,-30
86552495869,86552495874,5,1734,1086,-30
86560733637,86560733643,6,2570,1156,-30
86561496726,86561496729,3,1756,1209,-30
86562866508,86562866514,6,3093,1278,-30
86565529874,86565529877,3,2302,1770,-30
86567102153,86567102149,-4,1278,5630,-30
86568331793,86568331798,5,1950,953,-30
86568511728,86568511732,4,2579,1639,-30
86574612655,86574612657,2,2433,2887,-30
86578732176,86578732181,5,1720,851,-30
86579525070,86579525064,-6,1395,266,-30
86586081180,86586081182,2,1077,1387,-30
86586463870,86586463875,5,2127,1214,-30
86587586394,86587586379,-15,983,628,-30
86587733435,86587733438,3,1691,1362,-30
86593267054,86593267058,4,2646,1780,-30
86594972167,86594972159,-8,1055,3361,-30
86596246758,86596246763,5,2980,1641,-30
86598542651,86598542657,6,2411,972,-30
86600093481,86600093486,5,2251,1299,-30
86602360578,86602360584,6,2525,1593,-30
86602688889,86602688884,-5,588,293,-30
86603948723,86603948725,2,33212,33255,-30
86606520849,86606520854,5,2845,1559,-30
86606960214,86606960218,4,2858,1408,-30
86607247167,86607247185,18,1557,1023,-30
86610887393,86610887399,6,1824,1154,-30
86611153421,86611153427,6,1225,1312,-30
86618384926,86618384931,5,2707,1903,-30
86619313910,86619313918,8,3164,1261,-30
86621384730,86621384734,4,1316,1103,-30
86622688492,86622688490,-2,3029,5222,-30
86622894017,86622894023,6,1491,722,-30
86624183826,86624183830,4,2871,994,-30
86624277709,86624277692,-17,1825,961,-30
86629496729,86629496734,5,1322,1072,-30
86629667852,86629667875,23,2564,1233,-30
86629903837,86629903839,2,2920,2055,-30
86636215955,86636215959,4,2184,1497,-30
86636556256,86636556262,6,2232,1211,-30
86636928876,86636928880,4,1972,1292,-30
86645161261,86645161265,4,2868,1723,-30
86646073088,86646073098,10,2749,1325,-30
86647101147,86647101153,6,2097,1184,-30
86648146094,86648146100,6,1347,758,-30
86654171143,86654171147,4,1594,1566,-30
86655731342,86655731349,7,7958,1001,-30
86656068218,86656068234,16,623,1037,-30
86659102078,86659102083,5,1880,1098,-30
86661511703,86661511707,4,1805,1262,-30
86662843685,86662843690,5,1908,1280,-30
86667186434,86667186438,4,1741,1411,-30
86668418134,86668418130,-4,1153,2368,-30
86669737037,86669737043,6,3059,1209,-30
86669769679,86669769659,-20,2334,1685,-30
86670810870,86670810874,4,1938,1179,-30
86671490115,86671490120,5,2364,1590,-30
86672107075,86672107070,-5,2411,5604,-30
86672916028,86672916034,6,3225,1529,-30
86674827734,86674827741,7,2667,1791,-30
86674889926,86674889921,-5,738,3343,-30
86675365881,86675365884,3,2150,1215,-30
86676238557,86676238562,5,2061,1576,-30
86679665179,86679665184,5,1707,1059,-30
86680174566,86680174568,2,2305,1140,-30
86684549527,86684549533,6,2203,1475,-30
86687064048,86687064051,3,2441,1844,-30
86688099035,86688099039,4,2997,1493,-30
86690614281,86690614288,7,3483,1551,-30
86691691851,86691691854,3,3460,1871,-30
86696608194,86696608200,6,2464,1557,-30
86699413557,86699413562,5,3038,1514,-30
86699912209,86699912213,4,2083,1236,-30
86701950856,86701950861,5,2879,1292,-30
86702560266,86702560271,5,2827,1243,-30
86707285246,86707285250,4,2081,1305,-30
86708609242,86708609249,7,2920,1624,-30
86712169038,86712169043,5,2585,1485,-30
86716895841,86716895845,4,1494,747,-30
86718661070,86718661086,16,1600,1130,-30
86719509745,86719509750,5,2164,1428,-30
86720398764,86720398770,6,2038,1286,-30
86720933413,86720933410,-3,1275,1929,-30
86723324922,86723324927,5,2120,1102,-30
86725064089,86725064073,-16,2491,1795,-30
86728233262,86728233266,4,1887,1393,-30
86729211806,86729211810,4,1724,1560,-30
86731704983,86731704987,4,1708,903,-30
86734022943,86734022947,4,2059,1371,-30
86735161073,86735161079,6,2194,1281,-30
86738154656,86738154662,6,2181,1282,-30
86738534017,86738534024,7,2080,1280,-30
86742424197,86742424202,5,2756,1174,-30
86743173317,86743173320,3,1572,1370,-30
86748574681,86748574685,4,2286,1515,-30
86749336214,86749336217,3,1771,1344,-30
86750117617,86750117623,6,4130,1304,-30
86750813113,86750813107,-6,1981,6614,-30
86751617852,86751617856,4,1531,1660,-30
86751741577,86751741569,-8,1271,638,-30
86752346383,86752346388,5,1694,1370,-30
86753343574,86753343579,5,2158,1041,-30
86757633429,86757633433,4,2006,1326,-30
86761340274,86761340279,5,1520,1088,-30
86766979515,86766979519,4,1509,1844,-30
86771439402,86771439408,6,2997,1371,-30
86775140766,86775140774,8,2124,1014,-30
86777122006,86777122011,5,2442,1545,-30
86778644477,86778644482,5,2289,1479,-30
86786432479,86786432485,6,2028,1128,-30
86787535650,86787535655,5,1350,988,-30
86787689727,86787689706,-21,1495,618,-30
86789349774,86789349778,4,1787,1033,-30
86792271377,86792271382,5,2291,1667,-30
86797050533,86797050528,-5,1286,4713,-30
86799691201,86799691206,5,3477,1268,-30
86801080434,86801080440,6,1825,1178,-30
86801310385,86801310391,6,3439,1037,-30
86803508923,86803508921,-2,873,2492,-30
86803715743,86803715749,6,1966,1203,-30
86804891474,86804891481,7,3162,1679,-30
86809185137,86809185141,4,2511,1510,-30
86810739757,86810739760,3,1893,1135,-30
86811909206,86811909211,5,2213,893,-30
86813169425,86813169430,5,2144,1494,-30
86816568206,86816568209,3,2299,1672,-30
86826232834,86826232837,3,1516,764,-30
86826584565,86826584556,-9,820,414,-30
86833010592,86833010597,5,2777,1695,-30
86836807181,86836807184,3,1323,23784,-30
86837834167,86837834173,6,2696,1823,-30
86837864267,86837864273,6,1972,1204,-30
86838640478,86838640484,6,1642,1255,-30
86840289469,86840289475,6,2455,1723,-30
86846257455,86846257450,-5,961,3698,-30
86846413317,86846413324,7,2814,1361,-30
86851679945,86851679949,4,2030,1121,-30
86853271342,86853271351,9,1760,691,-30
86854312315,86854312321,6,1624,1574,-30
86854549866,86854549872,6,2860,1436,-30
86854759434,86854759438,4,2407,1401,-30
86856016486,86856016490,4,1860,694,-30
86859525358,86859525362,4,1823,1126,-30
86860207970,86860207973,3,2555,2079,-30
86860775813,86860775817,4,1432,1283,-30
86861395106,86861395088,-18,3130,1378,-30
86862351261,86862351265,4,1838,1224,-30
86862970746,86862970751,5,2558,1731,-30
86867836942,86867836946,4,3333,1472,-30
86868356894,86868356899,5,2203,1198,-30
86868468922,86868468925,3,2050,1158,-30
86868910825,86868910829,4,2377,1491,-30
86871606174,86871606179,5,2460,1213,-30
86871815046,86871815051,5,2111,1622,-30
86874611621,86874611627,6,2155,1138,-30
86876717913,86876717907,-6,2209,6096,-30
86879844405,86879844409,4,2334,1573,-30
86879939379,86879939383,4,1339,1160,-30
86881153565,86881153569,4,1804,1102,-30
86882064786,86882064791,5,2236,1076,-30
86884070216,86884070221,5,2623,985,-30
86889784238,86889784240,2,2284,2611,-30
86898662801,86898662809,8,2531,1801,-30
86899497656,86899497659,3,1621,1266,-30
86900328725,86900328706,-19,2493,1042,-30
86903901373,86903901380,7,2864,1066,-30
86906556337,86906556343,6,2354,896,-30
86915693605,86915693610,5,1945,1340,-30
86916260382,86916260386,4,2439,1361,-30
86918607790,86918607794,4,1396,1080,-30
86919960050,86919960054,4,2507,1326,-30
86920295096,86920295101,5,2667,1383,-30
86921773503,86921773506,3,1664,968,-30
86924318397,86924318401,4,1387,784,-30
86925752245,86925752249,4,1818,1069,-30
86928705251,86928705260,9,2558,908,-30
86930006902,86930006906,4,2197,1219,-30
86933148909,86933148918,9,23856,47425,-30
86936211649,86936211654,5,3054,1395,-30
86937253431,86937253438,7,4041,1371,-30
86937613067,86937613074,7,2138,983,-30
86939412031,86939412034,3,2893,1605,-30
86940019670,86940019674,4,2509,1088,-30
86940149856,86940149861,5,2015,1112,-30
86942038056,86942038061,5,2347,1191,-30
86947629788,86947629794,6,2427,1350,-30
86951486901,86951486906,5,2324,1084,-30
86955439746,86955439750,4,1618,980,-30
86955623051,86955623036,-15,1318,847,-30
86960919558,86960919560,2,1250,1454,-30
86961097945,86961097949,4,2367,1440,-30
86961142261,86961142265,4,2316,1416,-30
86963926034,86963926042,8,1534,1125,-30
86965458253,86965458260,7,2685,1488,-30
86966894830,86966894834,4,1244,992,-30
86967209817,86967209824,7,2080,1105,-30
86968619471,86968619477,6,2921,1345,-30
86969146731,86969146737,6,2028,1124,-30
86970368125,86970368131,6,4013,1196,-30
86977592203,86977592208,5,970,668,-30
86981221101,86981221106,5,872,671,-30
86981606238,86981606244,6,1715,1229,-30
86983082860,86983082867,7,2880,712,-30
86983974490,86983974495,5,1276,744,-30
86984446673,86984446669,-4,1403,4742,-30
86985687596,86985687599,3,2055,999,-30
86985714444,86985714462,18,15656,25921,-30
86986684362,86986684368,6,2023,765,-30
86988069916,86988069922,6,1891,776,-30
86992933844,86992933849,5,2049,1100,-30
87002607926,87002607930,4,3311,1515,-30
87003378201,87003378205,4,1295,978,-30
87004255136,87004255142,6,2974,1705,-30
87006820705,87006820706,1,1015,1954,-30
87007115115,87007115094,-21,1122,2661,-30
87009747450,87009747446,-4,1624,3052,-30
87011741467,87011741471,4,1853,1227,-30
87017243029,87017243033,4,1958,1018,-30
87017595788,87017595792,4,1408,1387,-30
87023191072,87023191078,6,2404,951,-30
87024632675,87024632678,3,1940,1382,-30
87026092126,87026092130,4,1831,975,-30
87028987110,87028987114,4,2161,935,-30
87030215081,87030215086,5,2377,1245,-30
87032443476,87032443481,5,1972,879,-30
87035200670,87035200674,4,1454,1504,-30
87041169536,87041169543,7,1979,1035,-30
87041665949,87041665929,-20,1955,1692,-30
87041826291,87041826297,6,1549,1215,-30
87042358910,87042358914,4,3027,1535,-30
87044983718,87044983722,4,1362,946,-30
87047250854,87047250860,6,1388,1319,-30
87048586558,87048586563,5,2702,1751,-30
87049806646,87049806652,6,2739,1506,-30
87052404186,87052404193,7,2403,1066,-30
87052581341,87052581339,-2,765,145,-30
87052787350,87052787329,-21,2266,1245,-30
87055146092,87055146102,10,323,862,-30
87055439902,87055439899,-3,1580,3510,-30
87055831886,87055831893,7,1775,1085,-30
87057316516,87057316526,10,1872,4711,-30
87057530641,87057530644,3,1955,1622,-30
87057567719,87057567726,7,2871,1248,-30
87058565489,87058565491,2,1828,1411,-30
87058976365,87058976370,5,3521,1604,-30
87059232741,87059232745,4,2123,1286,-30
87059345082,87059345090,8,1997,1230,-30
87059432996,87059433001,5,2686,1190,-30
87061394941,87061394946,5,2786,1212,-30
87064785229,87064785235,6,2341,1288,-30
87070333754,87070333760,6,1561,798,-30
87074698659,87074698665,6,2569,1162,-30
87076616018,87076616002,-16,1706,1178,-30
87077929706,87077929711,5,2966,1011,-30
87079575859,87079575856,-3,2047,5490,-30
87082892866,87082892873,7,7072,1101,-30
87083301306,87083301309,3,1564,1037,-30
87086061013,87086061019,6,2665,1221,-30
87090691236,87090691240,4,1898,1151,-30
87094494381,87094494387,6,2427,1383,-30
87106316489,87106316494,5,1892,1167,-30
87107194241,87107194246,5,3423,1889,-30
87109236079,87109236083,4,2286,1140,-30
87109991094,87109991098,4,2684,1448,-30
87112055840,87112055838,-2,778,1846,-30
87112730891,87112730894,3,1749,1062,-30
87113484085,87113484090,5,954,1279,-30
87124679627,87124679631,4,1840,1142,-30
87125200747,87125200751,4,2221,1168,-30
87125749394,87125749397,3,2562,1516,-30
87126986973,87126986978,5,2835,1572,-30
87130816206,87130816211,5,1873,1421,-30
87133091273,87133091270,-3,1520,3900,-30
87138750435,87138750440,5,689,721,-30
87142061198,87142061202,4,2252,1129,-30
87142768841,87142768843,2,1498,1553,-30
87144092887,87144092890,3,1651,1144,-30
87145934970,87145934986,16,34,1707,-30
87147573667,87147573670,3,1561,1642,-30
87148485711,87148485718,7,2027,1010,-30
87150485959,87150485962,3,2262,1723,-30
87151665469,87151665474,5,928,966,-30
87168212642,87168212649,7,1800,1530,-30
87171075616,87171075622,6,1999,1412,-30
87171561791,87171561798,7,2468,1454,-30
87171636901,87171636903,2,1912,1440,-30
87171933330,87171933334,4,1886,1434,-30
87174126385,87174126379,-6,1167,5072,-30
87175859122,87175859126,4,2330,1355,-30
87177210838,87177210843,5,2150,1411,-30
87181217974,87181217978,4,1742,1219,-30
87183373643,87183373647,4,2094,1242,-30
87188609990,87188609996,6,3348,1632,-30
87190051925,87190051930,5,3110,1598,-30
87192448895,87192448904,9,2626,708,-30
87194210439,87194210442,3,1051,1364,-30
87194576406,87194576411,5,2156,1372,-30
87195602046,87195602054,8,3942,1277,-30
87196043254,87196043258,4,2172,1218,-30
87197960747,87197960751,4,2381,1650,-30
87198442050,87198442054,4,2587,1012,-30
87199307590,87199307594,4,2293,1522,-30
87201092942,87201092947,5,2812,1323,-30
87204662023,87204662029,6,2002,1136,-30
87205805882,87205805887,5,2434,1268,-30
87208132294,87208132298,4,1932,1109,-30
87209371273,87209371278,5,4535,2740,-30
87210354737,87210354742,5,2794,1247,-30
87212602497,87212602503,6,1698,663,-30
87218669004,87218669009,5,2081,1070,-30
87221390886,87221390893,7,2185,1564,-30
87222836415,87222836420,5,2668,1983,-30
87224849433,87224849438,5,2445,1482,-30
87226814962,87226814968,6,2330,1782,-30
87229204234,87229204239,5,1590,1312,-30
87230558805,87230558811,6,2552,1438,-30
87231802876,87231802881,5,2629,1044,-30
87235658481,87235658487,6,1273,987,-30
87236253258,87236253272,14,2424,1292,-30
87236412975,87236412994,19,811,83,-30
87238650539,87238650544,5,1246,583,-30
87239345180,87239345185,5,1896,1236,-30
87239550650,87239550651,1,656,64,-30
87243083295,87243083298,3,1498,963,-30
87244374513,87244374517,4,973,903,-30
87248479500,87248479504,4,2171,1341,-30
87253871221,87253871225,4,2606,2006,-30
87254112541,87254112546,5,1421,1465,-30
87256882998,87256883002,4,1820,1391,-30
87264585790,87264585794,4,1622,777,-30
87265928782,87265928788,6,1578,1689,-30
87266929569,87266929573,4,2299,1359,-30
87266955523,87266955529,6,2865,1401,-30
87267018834,87267018818,-16,1967,1638,-30
87271468102,87271468107,5,2448,979,-30
87273897837,87273897839,2,2733,1535,-30
87276041632,87276041635,3,1846,1139,-30
87286155666,87286155673,7,2097,1431,-30
87286562979,87286562982,3,2432,1311,-30
87287067009,87287067014,5,1918,1106,-30
87289938589,87289938586,-3,956,1811,-30
87293333986,87293333989,3,821,508,-30
87293454165,87293454168,3,2846,1181,-30
87293912038,87293912016,-22,1481,1251,-30
87294067033,87294067038,5,1566,1233,-30
87294467812,87294467815,3,1958,1062,-30
87295878537,87295878543,6,2629,1479,-30
87300916934,87300916938,4,2152,1448,-30
87306624244,87306624248,4,2055,1590,-30
87309723297,87309723303,6,1052,1039,-30
87311304638,87311304643,5,2689,2003,-30
87312341814,87312341817,3,1974,761,-30
87313837604,87313837609,5,207,1663,-30
87318249617,87318249621,4,1497,1419,-30
87319827015,87319827021,6,6044,2498,-30
87323694255,87323694262,7,2614,872,-30
87325062265,87325062269,4,2080,1838,-30
87325520283,87325520287,4,3042,1711,-30
87325632548,87325632554,6,1211,1218,-30
87330314766,87330314771,5,2618,1335,-30
87338816038,87338816044,6,2348,1668,-30
87345936206,87345936210,4,1206,1432,-30
87346147899,87346147900,1,1224,2222,-30
87347259331,87347259338,7,2464,1224,-30
87347938283,87347938289,6,2163,1628,-30
87348297714,87348297721,7,2618,999,-30
87349969829,87349969834,5,2635,1426,-30
87351350390,87351350395,5,969,1084,-30
87354043010,87354043014,4,2462,1217,-30
87354564699,87354564705,6,1483,771,-30
87357376929,87357376936,7,3563,2053,-30
87360497389,87360497393,4,2114,1656,-30
87363770582,87363770586,4,870,950,-30
87366587757,87366587763,6,855,764,-30
87366645342,87366645345,3,1729,1555,-30
87367032237,87367032249,12,1899,1308,-30
87367762981,87367762983,2,1640,1611,-30
87368949650,87368949654,4,2445,1407,-30
87369601910,87369601917,7,1739,1228,-30
87370569306,87370569293,-13,225,913,-30
87373945359,87373945363,4,2251,1729,-30
87377485451,87377485453,2,1374,1935,-30
87381458147,87381458153,6,1914,819,-30
87383148450,87383148455,5,1543,1142,-30
87385643722,87385643728,6,2734,1304,-30
87389568789,87389568795,6,1939,1003,-30
87390959245,87390959237,-8,1172,15333,-30
87392006121,87392006128,7,1959,1184,-30
87392538410,87392538406,-4,1131,2341,-30
87394846025,87394846031,6,1370,960,-30
87395353029,87395353035,6,2981,1176,-30
87398544470,87398544476,6,2174,1450,-30
87399659263,87399659268,5,2958,1338,-30
87401370343,87401370350,7,2927,865,-30
87401767859,87401767864,5,1912,1222,-30
87402203334,87402203345,11,1670,972,-30
87403987762,87403987767,5,2813,1263,-30
87404024744,87404024751,7,2284,1675,-30
87404672089,87404672096,7,2022,915,-30
87406394702,87406394706,4,2033,1073,-30
87406973337,87406973343,6,2639,1619,-30
87408326874,87408326878,4,2445,1373,-30
87414458074,87414458079,5,1963,1253,-30
87415992370,87415992366,-4,2151,6187,-30
87423672319,87423672326,7,2635,1520,-30
87424673710,87424673715,5,3051,1703,-30
87427674469,87427674473,4,2333,1502,-30
87429845335,87429845341,6,2158,1552,-30
87431324806,87431324810,4,6382,3067,-30
87431932952,87431932956,4,2283,1696,-30
87437250140,87437250145,5,2604,1318,-30
87441519857,87441519861,4,2001,1373,-30
87448679414,87448679418,4,2075,1303,-30
87450653990,87450653997,7,4715,969,-30
87452535289,87452535295,6,1949,1256,-30
87453679627,87453679615,-12,146,689,-30
87454716314,87454716319,5,1750,1198,-30
87455699704,87455699703,-1,1203,1757,-30
87459357985,87459357988,3,2100,1203,-30
87459393320,87459393323,3,2435,1645,-30
87462920328,87462920334,6,2445,1560,-30
87464258603,87464258610,7,2411,921,-30
87465837845,87465837851,6,2749,1208,-30
87466914562,87466914568,6,3436,2058,-30
87469004613,87469004618,5,1965,1084,-30
87469314559,87469314562,3,1508,750,-30
87471541422,87471541426,4,2527,1469,-30
87472822123,87472822130,7,2634,1268,-30
87474169811,87474169812,1,19279,24087,-30
87475613962,87475613966,4,2498,1603,-30
87475653410,87475653416,6,2264,1295,-30
87479181509,87479181515,6,2992,1173,-30
87480226845,87480226852,7,3248,921,-30
87482303711,87482303716,5,2184,1145,-30
87485411710,87485411715,5,1612,854,-30
87485487821,87485487828,7,3076,1509,-30
87485738406,87485738410,4,1725,1128,-30
87489012438,87489012443,5,2310,1721,-30
87490342148,87490342153,5,1821,1284,-30
87490966277,87490966281,4,2778,1439,-30
87493768433,87493768434,1,2459,1719,-30
87493982548,87493982551,3,1966,1602,-30
87495978601,87495978606,5,1572,1340,-30
87496285482,87496285489,7,2438,1398,-30
87498051510,87498051514,4,1702,1265,-30
87501436403,87501436403,0,1666,1177,-30
87505745174,87505745179,5,2429,1494,-30
87506047517,87506047522,5,2408,1473,-30
87511300811,87511300817,6,2717,1278,-30
87511616454,87511616458,4,1946,1198,-30
87513777371,87513777377,6,1559,1138,-30
87516809013,87516809018,5,2896,1539,-30
87518753543,87518753549,6,2589,1289,-30
87520402377,87520402381,4,2627,1922,-30
87520845978,87520845982,4,1976,1250,-30
87526064475,87526064482,7,2152,962,-30
87526971214,87526971219,5,2519,1307,-30
87529979664,87529979669,5,2185,1418,-30
87531022899,87531022902,3,1761,1714,-30
87531255226,87531255232,6,1785,1488,-30
87539320125,87539320129,4,2311,1063,-30
87539517413,87539517433,20,1186,942,-30
87541027529,87541027535,6,4374,2325,-30
87542351666,87542351670,4,2119,843,-30
87546992485,87546992491,6,2979,1534,-30
87549791730,87549791730,0,1414,1410,-30
87553911602,87553911609,7,3144,1264,-30
87554582846,87554582853,7,1743,1639,-30
87556161222,87556161226,4,1269,896,-30
87556993582,87556993587,5,2922,1356,-30
87558825561,87558825565,4,2405,1630,-30
87561138474,87561138478,4,2398,1148,-30
87561171548,87561171569,21,1316,936,-30
87564901313,87564901319,6,2155,1153,-30
87567359474,87567359477,3,1740,1196,-30
87569803098,87569803103,5,2180,1172,-30
87571815155,87571815161,6,3174,1185,-30
87573390903,87573390908,5,2658,1390,-30
87574815049,87574815054,5,2002,1509,-30
87577539902,87577539907,5,2567,1528,-30
87578540722,87578540714,-8,761,3690,-30
87581744763,87581744767,4,1994,1518,-30
87587326612,87587326617,5,2160,2163,-30
87587432473,87587432478,5,1944,944,-30
87589783111,87589783116,5,2162,1175,-30
87590536278,87590536283,5,2182,1434,-30
87596778470,87596778475,5,1632,1152,-30
87599138731,87599138733,2,1843,1696,-30
87602974565,87602974567,2,2284,1689,-30
87604902554,87604902560,6,2862,1252,-30
87604932103,87604932107,4,678,323,-30
87605837770,87605837773,3,2442,1444,-30
87606839398,87606839404,6,2694,1264,-30
87607488590,87607488595,5,3018,1343,-30
87607615953,87607615959,6,2023,1053,-30
87609078670,87609078675,5,2365,1535,-30
87610090715,87610090721,6,1993,1088,-30
87610185374,87610185354,-20,1406,825,-30
87615058795,87615058793,-2,1920,4362,-30
87615388202,87615388206,4,860,793,-30
87615597685,87615597698,13,2908,1656,-30
87616332200,87616332205,5,1856,1080,-30
87616492502,87616492498,-4,1030,282,-30
87618971210,87618971214,4,2922,2270,-30
87619448750,87619448754,4,2770,977,-30
87621335986,87621335990,4,2576,1445,-30
87622703228,87622703230,2,1529,1062,-30
87625061836,87625061841,5,2248,1339,-30
87625281086,87625281083,-3,755,97,-30
87625430422,87625430428,6,2111,1610,-30
87626569581,87626569586,5,3155,1328,-30
87627088482,87627088486,4,4004,2542,-30
87630904714,87630904718,4,1823,1212,-30
87632014684,87632014687,3,2654,1827,-30
87632383152,87632383137,-15,28,1706,-30
87639530230,87639530234,4,2698,1442,-30
87642624538,87642624542,4,2079,912,-30
87642781990,87642781995,5,2297,967,-30
87643311115,87643311119,4,1919,1304,-30
87646232513,87646232518,5,3417,1631,-30
87648070143,87648070147,4,1937,1044,-30
87654188138,87654188143,5,1851,1837,-30
87655597042,87655597046,4,2022,837,-30
87664072353,87664072358,5,2588,1594,-30
87665949080,87665949082,2,1942,1382,-30
87667049147,87667049151,4,2502,1337,-30
87669380853,87669380857,4,3443,1516,-30
87670402834,87670402839,5,1860,1056,-30
87670817897,87670817912,15,2134,1136,-30
87673924074,87673924077,3,2226,1243,-30
87674797538,87674797543,5,2783,1753,-30
87676265654,87676265660,6,2097,1519,-30
87676779558,87676779562,4,1350,861,-30
87678067427,87678067422,-5,1200,2768,-30
87680066577,87680066582,5,2436,1031,-30
87680904327,87680904325,-2,2363,4827,-30
87682706528,87682706531,3,2174,1660,-30
87683130803,87683130802,-1,44992,21291,-30
87683356015,87683356019,4,1687,798,-30
87684087707,87684087711,4,3004,1787,-30
87684307042,87684307046,4,2166,1734,-30
87685402338,87685402343,5,2910,1586,-30
87690153362,87690153366,4,2168,980,-30
87691187461,87691187451,-10,699,320,-30
87694928818,87694928823,5,1531,943,-30
87702571366,87702571371,5,2217,908,-30
87705134802,87705134807,5,2881,1330,-30
87706408651,87706408655,4,2041,1367,-30
87708019531,87708019537,6,2272,1486,-30
87708583592,87708583596,4,2177,1441,-30
87709046550,87709046555,5,2701,684,-30
87709770746,87709770751,5,1410,813,-30
87710737561,87710737566,5,1847,929,-30
87711938863,87711938867,4,1894,1194,-30
87717579346,87717579348,2,2177,1566,-30
87717733555,87717733558,3,2286,1772,-30
87720484412,87720484415,3,1830,1138,-30
87721109367,87721109370,3,1128,1227,-30
87725522925,87725522929,4,1789,1069,-30
87731976155,87731976160,5,3840,1656,-30
87732859739,87732859743,4,2849,1641,-30
87733043868,87733043874,6,2921,1610,-30
87733847841,87733847848,7,2430,1028,-30
87736816366,87736816369,3,2253,1317,-30
87737703065,87737703070,5,1789,1158,-30
87738684134,87738684138,4,1649,1107,-30
87741994558,87741994563,5,2239,1123,-30
87742358813,87742358818,5,2193,1286,-30
87744138167,87744138171,4,1275,799,-30
87744744285,87744744290,5,2137,1440,-30
87745139979,87745139983,4,2036,1320,-30
87746732758,87746732763,5,2666,1287,-30
87750304277,87750304281,4,2150,1208,-30
87758630906,87758630913,7,2835,1291,-30
87759021946,87759021951,5,2134,1748,-30
87759547720,87759547724,4,2335,1311,-30
87764050474,87764050481,7,3171,1994,-30
87770881881,87770881886,5,3114,1458,-30
87773680551,87773680554,3,2187,1524,-30
87776999886,87776999892,6,2929,1438,-30
87777098666,87777098652,-14,2322,1106,-30
87778073893,87778073897,4,1554,1006,-30
87779103870,87779103875,5,2156,939,-30
87782286022,87782286026,4,2604,1278,-30
87784579467,87784579471,4,1499,859,-30
87787065654,87787065662,8,3420,1213,-30
87791728052,87791728058,6,2491,1617,-30
87793684051,87793684055,4,2278,1526,-30
87801323294,87801323298,4,2273,1384,-30
87802369941,87802369946,5,3418,1087,-30
87803259974,87803259978,4,1298,916,-30
87813950033,87813950032,-1,1581,1360,-30
87815512829,87815512837,8,2901,1260,-30
87817787364,87817787370,6,2763,1253,-30
87818657330,87818657329,-1,1018,1276,-30
87819344103,87819344106,3,2322,1959,-30
87822257850,87822257856,6,2573,1585,-30
87826997806,87826997810,4,1423,961,-30
87829067949,87829067952,3,1945,890,-30
87829972121,87829972126,5,2222,1268,-30
87830300793,87830300798,5,2257,1016,-30
87833066725,87833066730,5,2329,1326,-30
87834600397,87834600403,6,4669,2616,-30
87838018197,87838018204,7,1702,811,-30
87839439097,87839439103,6,2684,1199,-30
87841199831,87841199837,6,2632,1223,-30
87842421514,87842421513,-1,1474,1702,-30
87842577603,87842577588,-15,783,444,-30
87842926954,87842926958,4,2509,2262,-30
87844397326,87844397330,4,2138,1283,-30
87845843934,87845843939,5,2004,1348,-30
87846514289,87846514294,5,1224,670,-30
87847132897,87847132904,7,2298,1376,-30
87847475708,87847475713,5,1334,1023,-30
87847548815,87847548792,-23,1194,182,-30
87847668696,87847668702,6,2821,1099,-30
87849982317,87849982322,5,2264,1269,-30
87851676782,87851676788,6,3154,1682,-30
87858471851,87858471857,6,2128,1118,-30
87859529862,87859529867,5,1410,652,-30
87860406480,87860406487,7,2161,1256,-30
87860455242,87860455226,-16,1888,1034,-30
87860573204,87860573201,-3,7829,634,-30
87864674722,87864674729,7,2471,1314,-30
87865037158,87865037161,3,1334,824,-30
87866358417,87866358423,6,2319,1419,-30
87869534975,87869534979,4,4463,2677,-30
87873065110,87873065115,5,1565,1131,-30
87874231977,87874231981,4,2204,1336,-30
87874503169,87874503172,3,1348,1008,-30
87875425182,87875425188,6,1747,1117,-30
87875947798,87875947806,8,2040,1512,-30
87876611534,87876611541,7,2685,1383,-30
87878616350,87878616354,4,1782,1536,-30
87881234962,87881234967,5,1806,1567,-30
87881284836,87881284842,6,2543,1377,-30
87881941532,87881941534,2,3034,2494,-30
87884069609,87884069614,5,2668,1524,-30
87887793132,87887793135,3,2046,1655,-30
87888435625,87888435629,4,2172,1312,-30
87891012637,87891012642,5,2832,1200,-30
87893195594,87893195601,7,3690,1233,-30
87894189425,87894189430,5,2039,1309,-30
87895361248,87895361254,6,1386,934,-30
87896357499,87896357500,1,1468,2360,-30
87900031337,87900031343,6,2578,1294,-30
87901562886,87901562891,5,4077,2377,-30
87902497139,87902497143,4,1141,1171,-30
87905562306,87905562312,6,2576,1381,-30
87909256516,87909256523,7,1974,987,-30
87914289090,87914289094,4,1910,1285,-30
87915598265,87915598269,4,1919,1394,-30
87916358065,87916358070,5,2742,1272,-30
87916450645,87916450649,4,2079,1398,-30
87919854890,87919854894,4,2159,1219,-30
87925558710,87925558718,8,3343,1196,-30
87926580258,87926580266,8,1590,1125,-30
87926970475,87926970460,-15,1541,607,-30
87928022266,87928022270,4,1829,720,-30
87931120803,87931120811,8,2631,1209,-30
87931321782,87931321761,-21,461,218,-30
87938005507,87938005503,-4,1118,2570,-30
87943242202,87943242209,7,2399,2091,-30
87943943145,87943943149,4,2605,936,-30
87946459863,87946459876,13,2263,1256,-30
87946540603,87946540584,-19,2177,887,-30
87948199233,87948199238,5,2180,1353,-30
87949030817,87949030821,4,2588,1024,-30
87950902919,87950902926,7,2548,1334,-30
87950972521,87950972526,5,1906,1227,-30
87951099142,87951099140,-2,1202,1682,-30
87955249878,87955249881,3,1814,1291,-30
87955793802,87955793798,-4,1293,2174,-30
87956841583,87956841586,3,2693,1837,-30
87958368765,87958368770,5,2378,1226,-30
87966888127,87966888130,3,3046,1287,-30
87968760286,87968760294,8,2840,1312,-30
87968813370,87968813375,5,1997,1295,-30
87969533385,87969533390,5,2167,895,-30
87970092572,87970092577,5,2608,1512,-30
87972042602,87972042606,4,2447,1254,-30
87976747369,87976747363,-6,196,2571,-30
87977825878,87977825883,5,1872,978,-30
87979451182,87979451186,4,2750,1308,-30
87979694449,87979694453,4,2319,1259,-30
87983518942,87983518947,5,3263,1272,-30
87984749706,87984749710,4,2889,1838,-30
87990357632,87990357635,3,1839,1861,-30
87992637241,87992637246,5,2171,1435,-30
87993234611,87993234626,15,1873,1319,-30
88002136588,88002136593,5,2259,868,-30
88004281777,88004281773,-4,3204,8018,-30
88006358729,88006358733,4,1226,953,-30
88010624930,88010624935,5,1641,1021,-30
88012992098,88012992105,7,1189,917,-30
88015485622,88015485622,0,1841,2321,-30
88017909221,88017909228,7,2458,1512,-30
88018331974,88018331978,4,3245,1926,-30
88018832719,88018832717,-2,1350,2347,-30
88027640842,88027640846,4,1934,1246,-30
88032733330,88032733333,3,2005,883,-30
88039097466,88039097465,-1,1629,1708,-30
88039134663,88039134641,-22,2302,1258,-30
88041101656,88041101662,6,2732,1511,-30
88041490946,88041490952,6,2546,1269,-30
88043941721,88043941726,5,2036,1024,-30
88044661292,88044661297,5,2813,1689,-30
88046847390,88046847393,3,1585,1303,-30
88051517931,88051517939,8,2772,1079,-30
88051742629,88051742650,21,740,277,-30
88056006717,88056006720,3,2513,1907,-30
88059935558,88059935563,5,1984,1124,-30
88060759126,88060759132,6,2401,1338,-30
88061508499,88061508480,-19,2072,1422,-30
88061776566,88061776570,4,3607,1673,-30
88062468259,88062468263,4,2523,1569,-30
88062715028,88062715034,6,1990,1288,-30
88063195126,88063195130,4,1826,1171,-30
88064006101,88064006104,3,2503,1384,-30
88064425738,88064425742,4,2133,1577,-30
88065851519,88065851507,-12,268,1020,-30
88066032805,88066032810,5,2242,1224,-30
88067627217,88067627219,2,1109,1077,-30
88068079606,88068079609,3,1566,1104,-30
88068323174,88068323181,7,2782,1705,-30
88068950546,88068950551,5,2272,1204,-30
88069161785,88069161785,0,1504,1534,-30
88070679159,88070679163,4,1761,949,-30
88076506448,88076506466,18,515,1569,-30
88087761233,88087761238,5,2964,1624,-30
88088289503,88088289508,5,2521,1474,-30
88092431682,88092431689,7,1481,1371,-30
88094570533,88094570538,5,3653,1171,-30
88098582353,88098582358,5,2579,1502,-30
88102920896,88102920900,4,2438,1536,-30
88105420346,88105420351,5,2116,1027,-30
88106511063,88106511068,5,2455,1109,-30
88109855192,88109855174,-18,2565,1274,-30
88110036837,88110036850,13,2072,1404,-30
88110330136,88110330153,17,2027,972,-30
88116910849,88116910851,2,2127,1086,-30
88119214738,88119214741,3,2273,1674,-30
88120667827,88120667831,4,3304,1656,-30
88125013525,88125013530,5,2576,1622,-30
88127156942,88127156947,5,2013,991,-30
88128210694,88128210699,5,2580,1405,-30
88132552794,88132552801,7,3103,1131,-30
88134885245,88134885252,7,1789,1074,-30
88135180699,88135180682,-17,976,839,-30
88142070858,88142070862,4,2099,1630,-30
88142484390,88142484382,-8,1553,5961,-30
88147476830,88147476835,5,3838,2875,-30
88148402526,88148402525,-1,1176,2577,-30
88148878751,88148878755,4,1458,1341,-30
88150783752,88150783759,7,7336,1232,-30
88152051888,88152051893,5,2482,1108,-30
88153177669,88153177674,5,1708,1166,-30
88156521735,88156521741,6,3051,1564,-30
88157427118,88157427122,4,2465,1611,-30
88160181252,88160181257,5,1512,881,-30
88162602818,88162602823,5,3072,1253,-30
88165464638,88165464642,4,1601,1678,-30
88168381486,88168381490,4,3622,1572,-30
88174405582,88174405589,7,7590,827,-30
88174508681,88174508665,-16,1231,864,-30
88175492325,88175492329,4,2868,1216,-30
88176548813,88176548817,4,1310,875,-30
88177242739,88177242732,-7,529,4832,-30
88177872062,88177872066,4,1143,1200,-30
88179411142,88179411147,5,2200,1418,-30
88180293074,88180293079,5,2186,1314,-30
88181480735,88181480737,2,2192,2282,-30
88183288202,88183288206,4,1832,1147,-30
88185663964,88185663967,3,2722,1652,-30
88186058274,88186058281,7,1597,1218,-30
88186243457,88186243441,-16,1554,965,-30
88189743670,88189743674,4,1618,1013,-30
88191959618,88191959615,-3,881,1095,-30
88193050063,88193050066,3,2241,1071,-30
88195251853,88195251860,7,1817,1750,-30
88198511942,88198511950,8,2863,1185,-30
88199535042,88199535045,3,2108,1240,-30
88199967778,88199967783,5,2166,1346,-30
88200718426,88200718430,4,1223,670,-30
88201594974,88201594973,-1,1318,2494,-30
88204044084,88204044088,4,2670,1346,-30
88212211243,88212211250,7,3054,1489,-30
88214047738,88214047744,6,2812,1027,-30
88214827451,88214827441,-10,1426,2075,-30
88216076990,88216076994,4,2955,1233,-30
88221627110,88221627116,6,2332,1385,-30
88224435999,88224436003,4,2414,1220,-30
88225036851,88225036858,7,2803,1000,-30
88230143832,88230143836,4,2282,1482,-30
88231461188,88231461191,3,1995,1328,-30
88238844945,88238844950,5,2174,1089,-30
88246359392,88246359402,10,19000,20926,-30
88246834028,88246834033,5,2048,1868,-30
88247351748,88247351753,5,2147,874,-30
88250029098,88250029104,6,3096,1380,-30
88251927734,88251927742,8,1448,1036,-30
88258729865,88258729870,5,1361,1037,-30
88260213945,88260213952,7,670,71,-30
88262400467,88262400471,4,1503,1066,-30
88262892031,88262892035,4,1729,1120,-30
88264274958,88264274963,5,1620,833,-30
88268051825,88268051829,4,2152,1727,-30
88270081579,88270081581,2,1509,1994,-30
88270268141,88270268146,5,2247,1401,-30
88271435413,88271435434,21,538,158,-30
88272516130,88272516134,4,2020,1370,-30
88274468619,88274468625,6,1958,1066,-30
88276351534,88276351537,3,2551,1181,-30
88280787210,88280787215,5,2524,1400,-30
88280865941,88280865953,12,1446,820,-30
88283431348,88283431353,5,2531,1080,-30
88283566671,88283566691,20,589,195,-30
88284268947,88284268953,6,2894,1437,-30
88284916150,88284916159,9,2188,1202,-30
88285913113,88285913121,8,2037,781,-30
88288099093,88288099098,5,2472,1261,-30
88289564597,88289564602,5,2873,1710,-30
88290124789,88290124792,3,2167,1921,-30
88290581298,88290581303,5,1411,1086,-30
88295668187,88295668191,4,2143,1341,-30
88297425034,88297425034,0,16143,17217,-30
88297510621,88297510626,5,1699,903,-30
88297841237,88297841242,5,1868,1469,-30
88300578343,88300578342,-1,765,1770,-30
88303784872,88303784873,1,1396,1165,-30
88304021825,88304021829,4,2114,1199,-30
88305325414,88305325421,7,2975,1104,-30
88308867769,88308867774,5,2580,1097,-30
88309276220,88309276224,4,1176,1093,-30
88310498522,88310498526,4,2224,1343,-30
88310939661,88310939663,2,2099,1530,-30
88313041591,88313041589,-2,906,2053,-30
88318077122,88318077127,5,1599,779,-30
88321628898,88321628902,4,2363,832,-30
88323699777,88323699779,2,1140,1244,-30
88324618711,88324618715,4,1876,1640,-30
88324989731,88324989738,7,1948,1214,-30
88329309701,88329309706,5,2159,1407,-30
88329542095,88329542099,4,1194,1386,-30
88334282602,88334282607,5,2247,1378,-30
88339336221,88339336225,4,2489,1636,-30
88345293589,88345293593,4,2213,1124,-30
88347929791,88347929797,6,2535,1504,-30
88348265445,88348265450,5,1757,1474,-30
88350782501,88350782508,7,2129,1417,-30
88358508351,88358508354,3,2986,1450,-30
88363123520,88363123524,4,2037,1189,-30
88366570380,88366570385,5,2259,1401,-30
88367021768,88367021773,5,2078,1321,-30
88367296182,88367296164,-18,739,415,-30
88372863961,88372863967,6,1723,745,-30
88375306249,88375306254,5,1999,1180,-30
88375586010,88375586019,9,728,890,-30
88375642250,88375642254,4,2004,1192,-30
88378272590,88378272598,8,1738,1132,-30
88378463818,88378463804,-14,878,337,-30
88382152366,88382152375,9,3104,1179,-30
88382836067,88382836073,6,3380,1921,-30
88384357633,88384357638,5,2359,1121,-30
88384874685,88384874690,5,2257,1075,-30
88386535713,88386535718,5,1734,1013,-30
88388000690,88388000694,4,2326,989,-30
88389973607,88389973610,3,2770,1773,-30
88393203549,88393203552,3,2399,1537,-30
88394469987,88394469994,7,2772,1090,-30
88400898399,88400898405,6,2551,1039,-30
88401203932,88401203937,5,2173,998,-30
88402866393,88402866397,4,2225,1113,-30
88403491969,88403491952,-17,637,257,-30
88403881250,88403881254,4,2434,813,-30
88405614032,88405614036,4,2145,1300,-30
88405815818,88405815803,-15,1548,585,-30
88415982266,88415982259,-7,1905,8968,-30
88419509415,88419509420,5,1588,1236,-30
88419559111,88419559123,12,771,162,-30
88420345377,88420345382,5,1294,1486,-30
88420538285,88420538266,-19,666,550,-30
88420961438,88420961443,5,1669,985,-30
88421451596,88421451599,3,1681,781,-30
88428473977,88428473985,8,2759,1156,-30
88429078814,88429078818,4,2098,975,-30
88429890241,88429890246,5,2269,1405,-30
88430696441,88430696437,-4,1995,4579,-30
88433123065,88433123070,5,1459,1309,-30
88439220306,88439220311,5,3477,1459,-30
88441906954,88441906959,5,3174,1137,-30
88442552070,88442552074,4,1790,1269,-30
88443708428,88443708416,-12,1185,292,-30
88444141091,88444141097,6,2063,1882,-30
88447023467,88447023474,7,3650,1570,-30
88449803124,88449803130,6,3394,1656,-30
88451043502,88451043510,8,1788,912,-30
88451349151,88451349159,8,1797,1152,-30
88453004130,88453004138,8,2109,1290,-30
88454670295,88454670298,3,1445,1164,-30
88457517853,88457517841,-12,1466,4688,-30
88460386299,88460386305,6,3701,1339,-30
88461714463,88461714469,6,1656,1096,-30
88462292269,88462292267,-2,1143,432,-30
88465797701,88465797706,5,2331,1315,-30
88466523242,88466523249,7,3195,1905,-30
88468326917,88468326921,4,2281,1501,-30
88470805009,88470805013,4,2303,806,-30
88472633438,88472633443,5,2164,1257,-30
88481728409,88481728414,5,1712,1450,-30
88482977159,88482977163,4,1562,1184,-30
88486927289,88486927291,2,1340,1430,-30
88492115988,88492115993,5,2634,1678,-30
88495506269,88495506263,-6,1401,2691,-30
88496831620,88496831623,3,1905,1358,-30
88501902076,88501902081,5,2096,999,-30
88504085666,88504085665,-1,2334,3074,-30
88506401666,88506401671,5,30132,20960,-30
88506640913,88506640920,7,2278,1425,-30
88508829858,88508829863,5,1316,1148,-30
88509451322,88509451331,9,2138,1496,-30
88512086471,88512086475,4,2367,1093,-30
88512245217,88512245232,15,2718,1632,-30
88512576653,88512576658,5,3093,2027,-30
88515379156,88515379161,5,2213,1549,-30
88517811903,88517811910,7,2129,868,-30
88523333256,88523333259,3,1967,1036,-30
88524715638,88524715633,-5,1894,5765,-30
88529651293,88529651297,4,2793,1394,-30
88529728883,88529728889,6,2553,1400,-30
88530953789,88530953791,2,2232,1666,-30
88531572313,88531572317,4,1545,1541,-30
88532646369,88532646374,5,2911,1904,-30
88535212633,88535212637,4,2272,2054,-30
88542140252,88542140257,5,2095,1416,-30
88543813354,88543813360,6,2761,611,-30
88545855012,88545855018,6,2887,1989,-30
88547020418,88547020423,5,2018,1302,-30
88548107586,88548107591,5,2196,1460,-30
88548428210,88548428216,6,1479,1206,-30
88551021136,88551021139,3,2207,1602,-30
88551695834,88551695841,7,1778,1346,-30
88555260261,88555260267,6,2519,1389,-30
88556723854,88556723858,4,2318,1230,-30
88557382881,88557382883,2,1863,989,-30
88558478994,88558478998,4,2019,862,-30
88559456090,88559456093,3,2707,1317,-30
88562128190,88562128195,5,2285,1387,-30
88565616246,88565616252,6,2402,1396,-30
88571577173,88571577178,5,2322,956,-30
88578847703,88578847707,4,2752,1482,-30
88580268497,88580268503,6,2242,1239,-30
88581702638,88581702632,-6,785,3758,-30
88584769934,88584769936,2,8476,20174,-30
88585192050,88585192054,4,1469,1041,-30
88588715619,88588715613,-6,1152,3934,-30
88589916210,88589916215,5,1815,1252,-30
88590695169,88590695174,5,2353,1577,-30
88591880287,88591880294,7,2412,1355,-30
88595182034,88595182038,4,1317,1312,-30
88595798115,88595798118,3,2050,1590,-30
88600444665,88600444667,2,2008,1087,-30
88601770834,88601770838,4,3159,1814,-30
88605322780,88605322785,5,1798,1193,-30
88607423642,88607423647,5,2879,1176,-30
88612107114,88612107117,3,1941,1794,-30
88614498058,88614498063,5,2659,1107,-30
88615564293,88615564299,6,2837,1029,-30
88616592727,88616592733,6,2571,1236,-30
88620370442,88620370437,-5,21175,16154,-30
88621850330,88621850334,4,1548,1194,-30
88625659737,88625659739,2,1693,1190,-30
88626844585,88626844590,5,2809,1141,-30
88628132167,88628132171,4,2554,1898,-30
88630584397,88630584403,6,2283,1372,-30
88631365075,88631365079,4,2889,1766,-30
88634673997,88634674002,5,2062,1118,-30
88635746252,88635746254,2,1959,1125,-30
88644641030,88644641035,5,1968,1242,-30
88645858276,88645858282,6,2434,1029,-30
88645949658,88645949648,-10,1085,241,-30
88658245033,88658245038,5,1572,828,-30
88658305881,88658305886,5,2286,1273,-30
88660179934,88660179939,5,2186,1136,-30
88662081081,88662081083,2,2251,1093,-30
88663450955,88663450958,3,2392,1162,-30
88671866570,88671866575,5,3308,1430,-30
88673680017,88673680022,5,2549,1455,-30
88677170686,88677170691,5,1524,1090,-30
88684503466,88684503470,4,2449,1488,-30
88688738229,88688738224,-5,748,204,-30
88689940577,88689940583,6,2164,1328,-30
88693069070,88693069077,7,3001,1688,-30
88693328094,88693328098,4,2678,1760,-30
88694358332,88694358336,4,1883,1404,-30
88695119465,88695119452,-13,3194,1214,-30
88696992072,88696992077,5,1680,1276,-30
88697375176,88697375185,9,1680,1273,-30
88698165821,88698165817,-4,1854,5773,-30
88702299995,88702300000,5,2280,1695,-30
88705187360,88705187363,3,1600,1360,-30
88706635820,88706635825,5,2846,1798,-30
88712360212,88712360216,4,3211,1620,-30
88715514405,88715514410,5,2266,1321,-30
88715712381,88715712385,4,2098,1047,-30
88717871078,88717871081,3,1812,1498,-30
88717971551,88717971558,7,1230,702,-30
88719117347,88719117351,4,1925,1232,-30
88724705747,88724705753,6,1951,964,-30
88725174422,88725174404,-18,5175,1687,-30
88725972032,88725972037,5,2428,996,-30
88727191717,88727191721,4,2729,1032,-30
88729701483,88729701486,3,1034,873,-30
88730558232,88730558237,5,1902,1319,-30
88732523653,88732523657,4,1837,848,-30
88734968767,88734968771,4,1157,1109,-30
88738621770,88738621775,5,1661,1084,-30
88738747257,88738747267,10,1574,954,-30
88738833470,88738833450,-20,575,97,-30
88741255105,88741255112,7,1794,1251,-30
88743120638,88743120643,5,2306,1401,-30
88745540674,88745540677,3,2889,1735,-30
88746393021,88746393027,6,2358,1127,-30
88746429894,88746429915,21,2347,1253,-30
88750814051,88750814055,4,2244,1270,-30
88752285377,88752285381,4,1498,841,-30
88753278214,88753278218,4,1886,1027,-30
88756719557,88756719562,5,1509,1116,-30
88757262238,88757262246,8,2313,1767,-30
88757772857,88757772863,6,1801,1242,-30
88758877903,88758877906,3,1822,1355,-30
88761461256,88761461260,4,3049,1732,-30
88762276474,88762276479,5,1586,864,-30
88768297593,88768297597,4,1316,1170,-30
88773341792,88773341798,6,2692,1236,-30
88773948697,88773948699,2,1836,1915,-30
88776522702,88776522697,-5,2280,4470,-30
88780679587,88780679595,8,2366,1152,-30
88781035006,88781035013,7,1869,1199,-30
88781512316,88781512296,-20,2289,1571,-30
88782902711,88782902715,4,2236,1441,-30
88783933459,88783933456,-3,26447,22139,-30
88787549993,88787549996,3,1766,1699,-30
88788528923,88788528927,4,3259,1373,-30
88789019306,88789019311,5,2081,1367,-30
88794569706,88794569709,3,1511,1105,-30
88795102135,88795102145,10,423,15,-30
88797954857,88797954859,2,1538,1387,-30
88801473385,88801473390,5,1991,1023,-30
88803191186,88803191194,8,2811,927,-30
88807081119,88807081123,4,2468,1595,-30
88807669065,88807669067,2,3102,2356,-30
88810187185,88810187190,5,1645,1623,-30
88811115592,88811115597,5,1909,1687,-30
88814718801,88814718803,2,1806,1333,-30
88816090894,88816090898,4,1922,1077,-30
88819829857,88819829860,3,1304,1474,-30
88821026446,88821026426,-20,751,343,-30
88822055488,88822055493,5,3386,2037,-30
88824702463,88824702467,4,1204,793,-30
88827036975,88827036980,5,2079,1365,-30
88829851659,88829851664,5,2086,1550,-30
88831181225,88831181226,1,918,1246,-30
88832687925,88832687930,5,2461,1215,-30
88834016385,88834016390,5,1991,1218,-30
88834314154,88834314153,-1,1769,2544,-30
88834483957,88834483963,6,1883,1087,-30
88834895677,88834895682,5,2558,1713,-30
88836499580,88836499585,5,1395,911,-30
88841191064,88841191067,3,1755,1801,-30
88843821902,88843821907,5,1788,1477,-30
88846917190,88846917194,4,2994,1454,-30
88848814069,88848814078,9,3957,1200,-30
88849623859,88849623863,4,2192,1321,-30
88852130052,88852130057,5,2376,959,-30
88853213730,88853213736,6,2285,972,-30
88854248848,88854248851,3,1816,1060,-30
88859630085,88859630090,5,1978,1181,-30
88861802975,88861802981,6,2107,1506,-30
88863943262,88863943267,5,1740,955,-30
88870540674,88870540677,3,2373,1184,-30
88871497091,88871497099,8,2026,943,-30
88873876749,88873876754,5,1669,1418,-30
88875962782,88875962786,4,1705,1793,-30
88877153455,88877153450,-5,1057,3013,-30
88885876196,88885876188,-8,43109,17965,-30
88887614782,88887614788,6,1264,743,-30
88888481769,88888481774,5,2505,1633,-30
88893316539,88893316542,3,2131,1356,-30
88893721980,88893721985,5,2537,1368,-30
88894802616,88894802620,4,2409,1769,-30
88895494926,88895494920,-6,3373,8003,-30
88902081135,88902081140,5,1866,1343,-30
88902646958,88902646938,-20,854,270,-30
88902889981,88902889978,-3,2864,4714,-30
88902965874,88902965878,4,2068,1406,-30
88903727612,88903727618,6,3675,1292,-30
88904197667,88904197672,5,2475,1430,-30
88904385873,88904385875,2,2159,1222,-30
88904892386,88904892392,6,2075,1851,-30
88906166067,88906166069,2,1666,959,-30
88915738531,88915738537,6,2648,1754,-30
88916011374,88916011394,20,755,127,-30
88917161510,88917161503,-7,789,5670,-30
88918816310,88918816313,3,1904,1298,-30
88919496700,88919496705,5,2349,1003,-30
88922258513,88922258519,6,2519,1119,-30
88924755646,88924755653,7,2728,1740,-30
88925365132,88925365134,2,2104,1236,-30
88927736794,88927736799,5,1891,956,-30
88939399420,88939399428,8,10795,35016,-30
88943915153,88943915157,4,2353,1112,-30
88946269089,88946269091,2,1956,1192,-30
88954659008,88954659011,3,2332,956,-30
88955077440,88955077443,3,1691,1048,-30
88963501534,88963501539,5,3295,1369,-30
88967365404,88967365409,5,1833,1576,-30
88968453998,88968454003,5,2649,1651,-30
88969458369,88969458372,3,2131,684,-30
88969638408,88969638413,5,1941,1443,-30
88970114698,88970114702,4,2343,1195,-30
88970198771,88970198771,0,6,596,-30
88971948066,88971948073,7,2112,1105,-30
88972706805,88972706784,-21,2310,1008,-30
88976111986,88976111981,-5,908,3274,-30
88978816170,88978816172,2,2371,1654,-30
88979049460,88979049466,6,2462,1524,-30
88979312990,88979312994,4,1975,1164,-30
88981651451,88981651456,5,3846,1767,-30
88988624353,88988624350,-3,991,1835,-30
88994191723,88994191726,3,2445,932,-30
88995416460,88995416466,6,2669,1426,-30
88995577817,88995577816,-1,3106,4059,-30
88999343705,88999343711,6,2168,903,-30
88999494798,88999494805,7,3048,1590,-30
89005109588,89005109594,6,2378,1351,-30
89005486645,89005486650,5,1578,1370,-30
89005568068,89005568080,12,778,278,-30
89006045172,89006045174,2,1349,1103,-30
89011896590,89011896597,7,2603,886,-30
89019387231,89019387237,6,979,812,-30
89021306181,89021306187,6,1835,1217,-30
89021576270,89021576275,5,2410,1211,-30
89022304474,89022304478,4,2620,2314,-30
89022671912,89022671917,5,3037,1549,-30
89023753416,89023753414,-2,1195,2364,-30
89029126826,89029126832,6,2856,1598,-30
89031549885,89031549891,6,1540,848,-30
89035065554,89035065551,-3,1503,2173,-30
89039805314,89039805329,15,1088,1520,-30
89043406030,89043406034,4,2276,1307,-30
89047939705,89047939722,17,1053,3539,-30
89049823949,89049823954,5,1921,1025,-30
89050667086,89050667098,12,463,214,-30
89051618754,89051618752,-2,1456,3853,-30
89051992127,89051992131,4,1672,888,-30
89053896465,89053896471,6,2714,1513,-30
89055659054,89055659059,5,2536,1281,-30
89058678565,89058678571,6,2136,1382,-30
89060103869,89060103874,5,1618,1198,-30
89060511512,89060511514,2,2667,3179,-30
89062413833,89062413841,8,4731,1617,-30
89063029781,89063029786,5,2152,1115,-30
89066452225,89066452230,5,3001,1133,-30
89068305674,89068305677,3,1335,1675,-30
89070887307,89070887312,5,1475,920,-30
89073314346,89073314352,6,2027,1000,-30
89078450373,89078450373,0,1613,2445,-30
89083944558,89083944562,4,2965,1647,-30
89085597427,89085597413,-14,1246,1136,-30
89086040693,89086040706,13,5876,1407,-30
89089370017,89089370021,4,1946,1297,-30
89095114357,89095114363,6,3205,1226,-30
89095664337,89095664342,5,1615,1280,-30
89096178430,89096178435,5,2646,1058,-30
89099328054,89099328061,7,2520,1566,-30
89099499573,89099499578,5,2248,1149,-30
89099865225,89099865229,4,1780,1102,-30
89102356804,89102356810,6,2866,1680,-30
89104107076,89104107080,4,2361,1479,-30
89105157954,89105157960,6,3154,1919,-30
89107550321,89107550310,-11,1229,292,-30
89109252398,89109252402,4,2297,1331,-30
89110406449,89110406454,5,1685,1214,-30
89114460544,89114460548,4,2457,1207,-30
89114801467,89114801470,3,1933,1458,-30
89117318560,89117318566,6,2538,1496,-30
89118503986,89118503991,5,2478,1576,-30
89121949531,89121949537,6,3131,1530,-30
89122365982,89122365960,-22,744,434,-30
89127766199,89127766204,5,2358,1385,-30
89128071305,89128071310,5,2476,1364,-30
89128637922,89128637926,4,2909,1361,-30
89130537635,89130537641,6,1954,1225,-30
89131033997,89131033988,-9,661,213,-30
89135919985,89135919990,5,2186,1431,-30
89139409334,89139409331,-3,767,1666,-30
89139932927,89139932928,1,1296,1395,-30
89144283585,89144283590,5,2197,1237,-30
89147031379,89147031383,4,2573,1336,-30
89148376931,89148376938,7,3380,1557,-30
89148996042,89148996046,4,1939,1392,-30
89150256445,89150256449,4,1748,1097,-30
89153503706,89153503710,4,3050,1546,-30
89155681113,89155681114,1,1467,1557,-30
89160838501,89160838507,6,3063,1513,-30
89162858965,89162858970,5,1465,896,-30
89163310834,89163310818,-16,2509,917,-30
89163438884,89163438890,6,1909,1141,-30
89165908535,89165908541,6,3398,1970,-30
89166124614,89166124618,4,2414,1454,-30
89166562081,89166562064,-17,941,259,-30
89167451185,89167451191,6,1751,1187,-30
89168033021,89168033020,-1,1409,1726,-30
89168192991,89168192997,6,3545,1408,-30
89169226321,89169226325,4,2636,1255,-30
89169301707,89169301710,3,1567,1299,-30
89176490026,89176490033,7,2823,1746,-30
89176744562,89176744559,-3,1807,2978,-30
89177206046,89177206049,3,1435,1131,-30
89177908302,89177908307,5,2108,1310,-30
89178574618,89178574622,4,2870,1296,-30
89179249807,89179249812,5,2205,1399,-30
89179616716,89179616699,-17,1905,1160,-30
89181380691,89181380696,5,4247,1553,-30
89182230158,89182230163,5,1681,1596,-30
89183598737,89183598743,6,3058,1360,-30
89184324650,89184324656,6,1647,948,-30
89184900323,89184900327,4,1044,458,-30
89187186648,89187186650,2,1214,1123,-30
89187611710,89187611689,-21,3723,1434,-30
89188243613,89188243615,2,1779,1162,-30
89188643198,89188643176,-22,938,572,-30
89189635862,89189635868,6,3383,1953,-30
89195875597,89195875601,4,1281,1290,-30
89197965057,89197965062,5,2281,1368,-30
89199021272,89199021275,3,2193,987,-30
89201457979,89201457982,3,1874,493,-30
89203056251,89203056252,1,2721,3314,-30
89205993814,89205993818,4,2364,1138,-30
89206696339,89206696346,7,2475,1622,-30
89207035135,89207035138,3,1558,1154,-30
89208471025,89208471027,2,1272,1211,-30
89212369809,89212369814,5,3144,1166,-30
89219180882,89219180886,4,2506,1155,-30
89220318213,89220318218,5,2704,1382,-30
89222946206,89222946211,5,2297,1590,-30
89227142465,89227142465,0,1506,1939,-30
89227953422,89227953426,4,2687,2108,-30
89228631642,89228631643,1,1425,2082,-30
89229734011,89229734018,7,2832,1744,-30
89230791162,89230791167,5,2533,1094,-30
89231437599,89231437604,5,2676,1463,-30
89234448961,89234448962,1,1517,1550,-30
89240140530,89240140530,0,6982,8798,-30
89241127223,89241127217,-6,1522,6249,-30
89242249509,89242249516,7,2519,1403,-30
89244230953,89244230955,2,1344,1257,-30
89249680200,89249680204,4,2753,1624,-30
89250149278,89250149275,-3,1468,3186,-30
89250924821,89250924829,8,3686,924,-30
89254264024,89254264030,6,1848,1151,-30
89261321378,89261321381,3,2033,1384,-30
89261730017,89261730022,5,2110,1116,-30
89262683113,89262683109,-4,433,1800,-30
89264723426,89264723429,3,2702,1795,-30
89266055518,89266055523,5,1661,1038,-30
89266136182,89266136187,5,3154,1323,-30
89268062960,89268062962,2,1252,1579,-30
89269632233,89269632239,6,6206,2731,-30
89269788798,89269788803,5,2475,1418,-30
89270071459,89270071464,5,2425,1450,-30
89276632436,89276632440,4,2067,1324,-30
89277675479,89277675478,-1,882,2015,-30
89277973514,89277973515,1,456,896,-30
89279215069,89279215074,5,2497,1278,-30
89280587687,89280587705,18,509,2721,-30
89285605558,89285605562,4,938,726,-30
89288011186,89288011190,4,1874,1549,-30
89288257395,89288257399,4,1839,1186,-30
89292143585,89292143590,5,2488,1704,-30
89292670960,89292670962,2,1548,1874,-30
89292990466,89292990470,4,2031,1048,-30
89293489622,89293489626,4,2287,1331,-30
89294292177,89294292180,3,1637,1454,-30
89295548165,89295548170,5,2249,1726,-30
89297747731,89297747738,7,2711,1401,-30
89300774025,89300774030,5,1937,1550,-30
89311015324,89311015330,6,3629,1333,-30
89314397135,89314397138,3,1068,1362,-30
89317117925,89317117933,8,14512,34292,-30
89317473389,89317473394,5,1870,1116,-30
89319405490,89319405496,6,2236,1581,-30
89320466677,89320466681,4,2348,1776,-30
89321116427,89321116421,-6,946,2695,-30
89321472749,89321472754,5,2569,2010,-30
89325340904,89325340908,4,3625,1636,-30
89327694459,89327694468,9,2231,1455,-30
89328954294,89328954298,4,2721,1427,-30
89329825314,89329825319,5,2218,1168,-30
89331157178,89331157186,8,13763,22652,-30
89333496766,89333496771,5,2696,1979,-30
89335021438,89335021444,6,3333,1888,-30
89336289422,89336289427,5,2472,1282,-30
89339107686,89339107690,4,2567,1536,-30
89341497777,89341497782,5,1425,1383,-30
89347191609,89347191615,6,2424,820,-30
89350202523,89350202529,6,2504,1426,-30
89350729526,89350729531,5,2428,1110,-30
89351560933,89351560937,4,1351,880,-30
89352789258,89352789263,5,1733,862,-30
89353335243,89353335247,4,1984,1435,-30
89355509340,89355509341,1,46281,39271,-30
89355729735,89355729738,3,1618,1229,-30
89355855801,89355855811,10,2431,1173,-30
89357053042,89357053045,3,11,1543,-30
89360960838,89360960843,5,2744,1338,-30
89362191106,89362191091,-15,2871,1512,-30
89364363383,89364363389,6,4118,2096,-30
89367210561,89367210567,6,2569,1105,-30
89368834865,89368834869,4,1713,1320,-30
89369067969,89369067977,8,1683,1028,-30
89371034145,89371034151,6,2672,1335,-30
89380573726,89380573731,5,1849,1172,-30
89384897370,89384897373,3,1045,1189,-30
89385319866,89385319870,4,3031,1498,-30
89389558000,89389558008,8,2854,1343,-30
89389992912,89389992918,6,1909,1291,-30
89392422323,89392422326,3,2066,1474,-30
89395087225,89395087230,5,1707,1559,-30
89399691469,89399691458,-11,1170,3670,-30
89400148192,89400148178,-14,1532,937,-30
89400965523,89400965530,7,11,826,-30
89404363056,89404363061,5,2067,1415,-30
89405232747,89405232753,6,2610,858,-30
89409421309,89409421314,5,1926,1042,-30
89413096912,89413096918,6,2812,1211,-30
89417173553,89417173557,4,2776,962,-30
89419705894,89419705899,5,2349,1337,-30
89426622773,89426622777,4,2398,1633,-30
89427772570,89427772575,5,1596,1135,-30
89429193224,89429193220,-4,2053,3972,-30
89431345815,89431345821,6,2730,1066,-30
89435271222,89435271227,5,2548,1307,-30
89436357445,89436357450,5,2465,1135,-30
89440056696,89440056700,4,2831,1529,-30
89440619640,89440619645,5,3328,1894,-30
89445625498,89445625501,3,1678,1461,-30
89446058187,89446058193,6,3011,1428,-30
89446434021,89446434025,4,1763,1365,-30
89447034668,89447034671,3,1245,557,-30
89454770697,89454770703,6,3079,1541,-30
89456233238,89456233242,4,2427,912,-30
89461259637,89461259640,3,1926,1584,-30
89462150915,89462150928,13,3255,1400,-30
89465583389,89465583403,14,9804,44695,-30
89465747342,89465747347,5,1385,664,-30
89475726400,89475726405,5,2510,1328,-30
89477315715,89477315719,4,2177,1508,-30
89478696357,89478696363,6,2587,1325,-30
89479030721,89479030706,-15,1881,1444,-30
89482035599,89482035606,7,3659,1251,-30
89484956973,89484956981,8,3079,1343,-30
89488883478,89488883483,5,3250,1134,-30
89490399914,89490399911,-3,1127,1017,-30
89491954673,89491954677,4,2422,1484,-30
89492303686,89492303693,7,2852,1487,-30
89492478731,89492478739,8,1076,758,-30
89500117941,89500117960,19,443,2213,-30
89502876462,89502876467,5,2682,946,-30
89505069854,89505069859,5,2889,1290,-30
89507770747,89507770750,3,2231,1702,-30
89509654398,89509654403,5,2281,1320,-30
89510310053,89510310057,4,1214,1253,-30
89511188196,89511188219,23,2050,1370,-30
89511265129,89511265136,7,2653,1348,-30
89522126762,89522126767,5,1317,784,-30
89525604546,89525604549,3,1971,1311,-30
89526779342,89526779346,4,2367,1209,-30
89528610638,89528610642,4,2330,1055,-30
89532943930,89532943935,5,2005,1103,-30
89537338129,89537338132,3,2619,1542,-30
89538082617,89538082622,5,2272,1593,-30
89539832607,89539832611,4,2465,1506,-30
89540661489,89540661495,6,2778,1472,-30
89542042697,89542042703,6,2425,1434,-30
89549237017,89549237024,7,5321,1649,-30
89550589575,89550589578,3,2479,1346,-30
89556252838,89556252846,8,2513,957,-30
89558157462,89558157466,4,2538,1208,-30
89560236041,89560236045,4,2027,1524,-30
89566373439,89566373443,4,1839,1208,-30
89566582138,89566582122,-16,1171,528,-30
89567279671,89567279677,6,1495,1252,-30
89567603582,89567603587,5,1922,1643,-30
89569820561,89569820566,5,2131,1060,-30
89571817865,89571817870,5,2385,1320,-30
89572597310,89572597315,5,1253,993,-30
89576142243,89576142246,3,1603,1105,-30
89576369725,89576369738,13,838,96,-30
89576915617,89576915618,1,1815,1702,-30
89579793608,89579793615,7,3259,1155,-30
89580103372,89580103376,4,2756,1758,-30
89581899241,89581899246,5,1807,1173,-30
89582703777,89582703781,4,1963,1041,-30
89583304501,89583304521,20,727,389,-30
89586164258,89586164254,-4,2279,6955,-30
89587056298,89587056303,5,2439,1124,-30
89590022521,89590022524,3,1448,1336,-30
89592590943,89592590949,6,3439,1415,-30
89593516127,89593516129,2,8798,9224,-30
89596451454,89596451457,3,2248,1696,-30
89598205322,89598205322,0,1636,2626,-30
89598972060,89598972066,6,1880,920,-30
89602502745,89602502751,6,1798,1320,-30
89605028785,89605028790,5,1489,719,-30
89612142611,89612142603,-8,28386,13219,-30
89616451175,89616451181,6,2465,965,-30
89621075758,89621075744,-14,791,130,-30
89623846640,89623846644,4,2361,1677,-30
89625606473,89625606477,4,1947,1345,-30
89626415757,89626415763,6,1928,1223,-30
89630774725,89630774729,4,2696,1353,-30
89631080962,89631080944,-18,690,436,-30
89631162590,89631162597,7,3450,1934,-30
89632703843,89632703846,3,1407,1235,-30
89632867085,89632867090,5,1539,906,-30
89634946461,89634946466,5,2648,1598,-30
89635487543,89635487547,4,2756,2143,-30
89642783649,89642783655,6,3022,1619,-30
89647040762,89647040767,5,1522,1095,-30
89650933886,89650933890,4,1986,1333,-30
89652139083,89652139085,2,1467,1308,-30
89655625475,89655625481,6,2809,2260,-30
89658594001,89658594007,6,2961,1195,-30
89658858002,89658858008,6,1641,1330,-30
89659228502,89659228504,2,1482,1012,-30
89662205868,89662205870,2,1941,1839,-30
89664888186,89664888192,6,2520,2157,-30
89672520180,89672520185,5,1168,1002,-30
89680989455,89680989459,4,2355,1420,-30
89683982776,89683982781,5,1885,1037,-30
89689602343,89689602346,3,1407,1223,-30
89690512546,89690512549,3,2560,1116,-30
89690971477,89690971482,5,2302,1337,-30
89692821644,89692821649,5,1962,1108,-30
89693187941,89693187947,6,1531,1027,-30
89693389364,89693389370,6,2818,1099,-30
89695236020,89695236023,3,1991,1279,-30
89697190842,89697190847,5,1957,1326,-30
89697919082,89697919064,-18,1830,760,-30
89698438478,89698438482,4,2399,1389,-30
89700131910,89700131915,5,2041,1293,-30
89702621142,89702621148,6,2916,1492,-30
89703234230,89703234235,5,2978,1888,-30
89705149300,89705149307,7,3298,1334,-30
89705339348,89705339353,5,5771,2625,-30
89706529875,89706529878,3,182,1519,-30
89707902058,89707902062,4,959,1060,-30
89707949078,89707949086,8,3222,967,-30
89708074187,89708074194,7,2077,1126,-30
89709447050,89709447065,15,1454,1017,-30
89717179517,89717179521,4,2105,1553,-30
89719036760,89719036765,5,2238,1514,-30
89724157842,89724157848,6,2370,1406,-30
89725723786,89725723789,3,2454,1780,-30
89730982230,89730982234,4,1881,952,-30
89733021517,89733021523,6,2742,1373,-30
89738778453,89738778458,5,1283,1246,-30
89738819094,89738819099,5,1559,1220,-30
89740227329,89740227335,6,1843,1213,-30
89741292657,89741292663,6,2370,1298,-30
89742555650,89742555656,6,1630,1309,-30
89746613631,89746613635,4,2351,898,-30
89748824478,89748824483,5,1665,875,-30
89753272017,89753272022,5,3513,1820,-30
89754248403,89754248409,6,2276,1214,-30
89757127010,89757127017,7,2744,1339,-30
89758364582,89758364588,6,2187,1257,-30
89758693271,89758693276,5,1844,1282,-30
89761275156,89761275159,3,1527,1096,-30
89761854189,89761854203,14,2517,1456,-30
89762014033,89762014031,-2,2083,2115,-30
89764294678,89764294677,-1,1233,1753,-30
89765199875,89765199882,7,2507,1551,-30
89769286682,89769286679,-3,1363,3117,-30
89770706145,89770706151,6,2693,1337,-30
89774843049,89774843054,5,1409,1250,-30
89776892309,89776892314,5,2190,1381,-30
89778476009,89778476014,5,2060,865,-30
89778996162,89778996167,5,2723,1248,-30
89781215935,89781215940,5,2231,1494,-30
89782532417,89782532422,5,1926,1348,-30
89783440299,89783440315,16,632,257,-30
89784426088,89784426091,3,1257,1071,-30
89790785425,89790785430,5,2553,1278,-30
89791817602,89791817606,4,2330,1051,-30
89792020091,89792020095,4,1953,1271,-30
89793821738,89793821746,8,2411,1417,-30
89794885581,89794885583,2,2048,1416,-30
89798763472,89798763474,2,1383,1070,-30
89799050991,89799050995,4,1715,1479,-30
89800302698,89800302703,5,2361,1142,-30
89800536598,89800536580,-18,2352,1276,-30
89803572738,89803572741,3,1849,1540,-30
89805552065,89805552069,4,2184,1406,-30
89806056622,89806056605,-17,1823,1164,-30
89806416466,89806416449,-17,682,318,-30
89806918301,89806918304,3,2042,1637,-30
89823635702,89823635707,5,1780,1026,-30
89829163757,89829163762,5,1768,962,-30
89829522766,89829522761,-5,1816,6328,-30
89829758853,89829758858,5,2050,1440,-30
89830103493,89830103498,5,1634,1140,-30
89830952147,89830952153,6,2053,1396,-30
89832693141,89832693146,5,2442,1610,-30
89835589659,89835589665,6,2798,1503,-30
89837742086,89837742083,-3,934,1046,-30
89839005149,89839005132,-17,3128,471,-30
89841081323,89841081330,7,2734,1064,-30
89843437265,89843437261,-4,1603,2782,-30
89845117042,89845117046,4,2393,1379,-30
89845873705,89845873710,5,1889,1202,-30
89847007974,89847007974,0,1623,1667,-30
89847595745,89847595751,6,3054,1334,-30
89850186586,89850186590,4,2899,1289,-30
89851407724,89851407729,5,2334,936,-30
89854041445,89854041451,6,2092,875,-30
89857412814,89857412819,5,2357,1314,-30
89860731693,89860731696,3,1986,1380,-30
89864736046,89864736053,7,3329,1037,-30
89865850769,89865850774,5,2530,1012,-30
89869988770,89869988774,4,2622,1193,-30
89872038433,89872038436,3,1750,887,-30
89875026797,89875026801,4,1551,1197,-30
89875348485,89875348489,4,2002,1103,-30
89878996081,89878996085,4,2015,1335,-30
89881551136,89881551141,5,1896,1418,-30
89883958964,89883958968,4,2055,1400,-30
89885209542,89885209538,-4,1070,3075,-30
89887388537,89887388542,5,2930,1908,-30
89889473343,89889473347,4,2216,1084,-30
89891674445,89891674450,5,2396,1435,-30
89893168004,89893168010,6,2474,1668,-30
89894995894,89894995898,4,1820,1692,-30
89895707494,89895707499,5,2426,1151,-30
89897225946,89897225950,4,2733,1841,-30
89897700182,89897700187,5,1967,1187,-30
89897728558,89897728551,-7,1451,4820,-30
89899069075,89899069082,7,2684,1140,-30
89899133251,89899133236,-15,2026,1430,-30
89899885087,89899885093,6,2450,2189,-30
89900341654,89900341655,1,3299,3040,-30
89903436095,89903436098,3,1834,1408,-30
89908858650,89908858659,9,1771,972,-30
89914726318,89914726323,5,2131,1057,-30
89915695721,89915695727,6,1921,1264,-30
89916322412,89916322415,3,1395,1393,-30
89918420970,89918420975,5,2175,1093,-30
89918711849,89918711856,7,15418,39733,-30
89924549655,89924549658,3,1039,588,-30
89925492093,89925492098,5,2371,1777,-30
89926031971,89926031975,4,2422,1254,-30
89927069804,89927069809,5,2103,1213,-30
89932910638,89932910634,-4,1187,1705,-30
89935719191,89935719195,4,2272,1169,-30
89937405443,89937405442,-1,1521,1769,-30
89939818354,89939818358,4,1366,696,-30
89942811307,89942811315,8,1858,980,-30
89943352664,89943352670,6,2470,854,-30
89944256841,89944256845,4,1820,1379,-30
89949625621,89949625627,6,2344,899,-30
89953213794,89953213791,-3,2050,3621,-30
89956384218,89956384222,4,1707,910,-30
89956425420,89956425425,5,3066,1815,-30
89957539776,89957539782,6,2306,1084,-30
89957676621,89957676627,6,2142,1099,-30
89959049529,89959049533,4,2380,1558,-30
89959623938,89959623942,4,1806,1352,-30
89960706627,89960706635,8,3088,1772,-30
89965802910,89965802915,5,1140,741,-30
89969765754,89969765762,8,1910,720,-30
89970347302,89970347306,4,2113,1006,-30
89970967350,89970967355,5,1261,891,-30
89971503791,89971503796,5,2385,1479,-30
89972815335,89972815341,6,1771,740,-30
89973750758,89973750737,-21,1341,559,-30
89982684346,89982684348,2,1323,948,-30
89984070896,89984070898,2,3692,3529,-30
89985875123,89985875129,6,2272,1179,-30
89989331908,89989331912,4,1918,1208,-30
89993421059,89993421054,-5,948,3299,-30
89994896276,89994896279,3,2349,1405,-30
89996591918,89996591918,0,11394,14263,-30
89998085618,89998085624,6,2691,1296,-30
90001169739,90001169734,-5,988,4044,-30
90005011517,90005011522,5,2617,1415,-30
90009150442,90009150449,7,2066,927,-30
90009745521,90009745522,1,1861,1177,-30
90009907254,90009907261,7,1999,1488,-30
90014922527,90014922531,4,1723,1585,-30
90015760639,90015760643,4,1843,1133,-30
90018781610,90018781615,5,2299,1953,-30
90020372921,90020372926,5,2214,1317,-30
90021166146,90021166148,2,1958,1552,-30
90025677612,90025677615,3,1980,1445,-30
90025858750,90025858754,4,989,537,-30
90027832685,90027832691,6,2555,1473,-30
90028960923,90028960929,6,2346,1456,-30
90030711225,90030711230,5,1884,1135,-30
90032299067,90032299074,7,10026,28032,-30
90032325640,90032325646,6,1702,1054,-30
90033591854,90033591859,5,1912,1299,-30
90036131496,90036131482,-14,1231,732,-30
90038639213,90038639217,4,1833,903,-30
90043748830,90043748835,5,2373,853,-30
90049202986,90049202990,4,2525,1678,-30
90050442557,90050442561,4,2051,1252,-30
90051361945,90051361950,5,2609,1674,-30
90057921174,90057921181,7,2062,1211,-30
90058633793,90058633798,5,2724,1402,-30
90058671860,90058671867,7,2042,1033,-30
90058709489,90058709476,-13,1614,684,-30
90059580654,90059580659,5,2272,1534,-30
90062771586,90062771593,7,3439,2182,-30
90065025057,90065025061,4,2279,1447,-30
90068901832,90068901833,1,1899,2869,-30
90069571678,90069571682,4,2968,1352,-30
90071402121,90071402122,1,1721,1074,-30
90072535072,90072535078,6,2514,1618,-30
90073557229,90073557234,5,2994,1343,-30
90075039920,90075039924,4,2508,1581,-30
90075573353,90075573357,4,2085,1602,-30
90077479319,90077479322,3,1759,1482,-30
90077536864,90077536849,-15,772,174,-30
90079239793,90079239798,5,2437,1914,-30
90084749311,90084749317,6,2266,1605,-30
90086674110,90086674114,4,2744,1343,-30
90087316863,90087316867,4,1720,1082,-30
90087428785,90087428791,6,2541,1355,-30
90089842898,90089842902,4,2088,1257,-30
90094894523,90094894527,4,2141,1181,-30
90096119722,90096119727,5,2178,1000,-30
90099068419,90099068423,4,2181,1392,-30
90099416579,90099416572,-7,1145,3780,-30
90100616828,90100616834,6,2027,1105,-30
90102200115,90102200121,6,1288,894,-30
90102334224,90102334232,8,23902,48768,-30
90102461454,90102461458,4,2836,1194,-30
90102956918,90102956921,3,1843,1746,-30
90103900509,90103900514,5,2068,1153,-30
90105856689,90105856690,1,1726,1384,-30
90107481411,90107481415,4,2614,1382,-30
90110191358,90110191362,4,2852,1829,-30
90111815808,90111815814,6,2114,2027,-30
90112951013,90112951018,5,2220,1601,-30
90115870615,90115870620,5,2473,1362,-30
90117881354,90117881358,4,1004,887,-30
90120438966,90120438971,5,3038,1560,-30
90121673235,90121673241,6,2915,1443,-30
90121850575,90121850582,7,20412,36663,-30
90122796964,90122796969,5,2733,1294,-30
90122912059,90122912063,4,2036,1352,-30
90124386279,90124386286,7,2480,1201,-30
90125130919,90125130926,7,2384,1279,-30
90125260504,90125260509,5,2334,1731,-30
90125408145,90125408147,2,1249,1452,-30
90125446447,90125446425,-22,1182,858,-30
90128236335,90128236333,-2,1702,2465,-30
90129843314,90129843319,5,3429,1270,-30
90134595173,90134595181,8,1792,1658,-30
90135157622,90135157625,3,2643,1679,-30
90135786946,90135786950,4,2024,1262,-30
90138997979,90138997983,4,1479,1262,-30
90139262419,90139262425,6,2782,1417,-30
90140209210,90140209200,-10,670,397,-30
90140726134,90140726138,4,1590,965,-30
90143326491,90143326497,6,2573,1531,-30
90143718621,90143718616,-5,2669,7673,-30
90145453261,90145453266,5,2871,1647,-30
90146064018,90146064022,4,2472,1529,-30
90153719349,90153719354,5,1810,1087,-30
90154585813,90154585818,5,2350,1288,-30
90155607340,90155607345,5,2625,886,-30
90156704691,90156704696,5,2224,1399,-30
90157142959,90157142964,5,1536,1612,-30
90157834041,90157834047,6,1741,1313,-30
90159799629,90159799634,5,2513,1541,-30
90162611979,90162611983,4,1687,1195,-30
90165337813,90165337817,4,1595,976,-30
90170357192,90170357197,5,1110,911,-30
90171307662,90171307665,3,2018,1088,-30
90175372451,90175372455,4,2254,1356,-30
90176183290,90176183295,5,2068,1210,-30
90176988204,90176988210,6,1739,957,-30
90182540767,90182540772,5,1434,1131,-30
90183672703,90183672709,6,2203,1478,-30
90185170199,90185170203,4,1274,991,-30
90189434250,90189434256,6,2291,1109,-30
90189750741,90189750745,4,1741,1160,-30
90191510935,90191510937,2,1950,1901,-30
90192514430,90192514434,4,2453,1319,-30
90193809052,90193809056,4,2586,1120,-30
90203017297,90203017294,-3,434,1636,-30
90204332004,90204332009,5,1732,1248,-30
90205439626,90205439633,7,3955,1542,-30
90209912073,90209912076,3,2753,1609,-30
90210102434,90210102439,5,2238,1029,-30
90213896940,90213896946,6,24122,35122,-30
90221098247,90221098251,4,2363,1192,-30
90225737794,90225737799,5,2506,819,-30
90231251365,90231251369,4,1621,958,-30
90233656088,90233656090,2,1220,1162,-30
90234891317,90234891320,3,2029,1129,-30
90235277805,90235277810,5,2341,1363,-30
90237891987,90237891985,-2,770,2082,-30
90240428183,90240428187,4,1633,1017,-30
90240805837,90240805830,-7,3175,9478,-30
90244105418,90244105425,7,3410,1657,-30
90245318875,90245318881,6,1622,707,-30
90245569199,90245569178,-21,667,349,-30
90247392999,90247393003,4,2077,1774,-30
90248180850,90248180855,5,1746,1320,-30
90252116220,90252116226,6,2043,1351,-30
90253881246,90253881251,5,2759,1593,-30
90255373110,90255373115,5,1399,765,-30
90255904171,90255904176,5,2553,1360,-30
90256682171,90256682176,5,3016,1803,-30
90259844324,90259844331,7,2277,1462,-30
90261057268,90261057262,-6,1667,7742,-30
90266206070,90266206076,6,2734,1189,-30
90273454780,90273454777,-3,1420,2905,-30
90274985038,90274985042,4,2550,1388,-30
90278284275,90278284279,4,2373,1236,-30
90278572025,90278572029,4,2188,1397,-30
90279782777,90279782780,3,2414,1272,-30
90282518471,90282518475,4,2201,1343,-30
90282786202,90282786207,5,2670,856,-30
90283958725,90283958729,4,1217,1003,-30
90288528981,90288528986,5,2398,1382,-30
90288874746,90288874751,5,1849,926,-30
90290604967,90290604970,3,1625,1025,-30
90290917494,90290917474,-20,673,461,-30
90293157648,90293157652,4,2186,1425,-30
90294221690,90294221697,7,2230,1272,-30
90296240249,90296240253,4,1605,1119,-30
90299171715,90299171722,7,2193,979,-30
90302578945,90302578949,4,2044,1368,-30
90305007220,90305007214,-6,597,2891,-30
90305239529,90305239535,6,1824,904,-30
90308077958,90308077972,14,2321,1331,-30
90308916449,90308916452,3,1723,1566,-30
90312829433,90312829412,-21,2245,1406,-30
90312901270,90312901277,7,2854,1539,-30
90313154943,90313154948,5,4007,1839,-30
90317533223,90317533225,2,1555,1285,-30
90321539615,90321539619,4,2271,1736,-30
90322974310,90322974314,4,1902,1556,-30
90323128428,90323128433,5,2253,1485,-30
90328342639,90328342644,5,1962,1321,-30
90329576738,90329576745,7,4667,1620,-30
90331398607,90331398611,4,2384,1499,-30
90331690390,90331690396,6,3374,1933,-30
90332681529,90332681534,5,2086,1317,-30
90337009604,90337009607,3,1775,1180,-30
90337284582,90337284588,6,2086,1391,-30
90337528250,90337528257,7,1244,887,-30
90339724834,90339724840,6,2191,1462,-30
90342166378,90342166383,5,3186,1479,-30
90343964457,90343964463,6,3432,406,-30
90346028806,90346028811,5,2048,1045,-30
90354201202,90354201206,4,2202,1471,-30
90360339042,90360339046,4,1711,904,-30
90361509473,90361509472,-1,789,1471,-30
90364711562,90364711568,6,3193,1618,-30
90365853931,90365853936,5,2062,1254,-30
90366033142,90366033147,5,1382,1115,-30
90371200364,90371200370,6,2749,1056,-30
90371490207,90371490213,6,1790,1188,-30
90375764507,90375764513,6,1802,1669,-30
90379268109,90379268115,6,2535,1429,-30
90381136111,90381136115,4,2545,1732,-30
90382246494,90382246498,4,2187,1255,-30
90384154686,90384154690,4,2350,1520,-30
90385533781,90385533786,5,2262,1308,-30
90388919821,90388919825,4,2094,1207,-30
90394160227,90394160233,6,2593,1668,-30
90394690336,90394690341,5,2525,1362,-30
90395749663,90395749666,3,3170,1508,-30
90400710714,90400710717,3,2003,1625,-30
90402797892,90402797897,5,2108,1188,-30
90402892384,90402892387,3,1952,1350,-30
90409390358,90409390363,5,1633,1478,-30
90411174550,90411174551,1,1585,1172,-30
90414202824,90414202829,5,2350,1477,-30
90415316668,90415316673,5,2330,1179,-30
90416293071,90416293074,3,2852,1271,-30
90420329716,90420329719,3,951,644,-30
90423857327,90423857331,4,2305,935,-30
90424305682,90424305687,5,1987,1180,-30
90424869654,90424869660,6,2217,1163,-30
90429398247,90429398253,6,2364,1841,-30
90431830923,90431830928,5,1625,1444,-30
90432257679,90432257683,4,1820,956,-30
90434175808,90434175814,6,2324,1386,-30
90434934505,90434934510,5,2744,1378,-30
90435708802,90435708802,0,704,1052,-30
90435933978,90435933985,7,2302,1387,-30
90437797765,90437797769,4,1376,928,-30
90439612002,90439611997,-5,1713,5926,-30
90443540258,90443540263,5,5482,3313,-30
90444282944,90444282949,5,2335,1744,-30
90445143830,90445143835,5,3130,1747,-30
90448943345,90448943350,5,2953,1574,-30
90450770523,90450770527,4,3016,1508,-30
90451736383,90451736387,4,2538,1416,-30
90451793421,90451793428,7,2104,812,-30
90453349963,90453349968,5,2387,1170,-30
90455721324,90455721330,6,2692,1327,-30
90460810073,90460810078,5,2201,802,-30
90462236979,90462236975,-4,2336,4675,-30
90464342045,90464342050,5,1749,1248,-30
90464645610,90464645624,14,1539,1104,-30
90465714547,90465714552,5,2249,983,-30
90466905026,90466905030,4,2116,1234,-30
90468549630,90468549635,5,2622,1459,-30
90469679238,90469679243,5,6128,23327,-30
90471058789,90471058791,2,1728,1154,-30
90476156398,90476156402,4,2139,1676,-30
90485553909,90485553913,4,2748,2209,-30
90487092854,90487092861,7,1839,1033,-30
90490539887,90490539891,4,1474,994,-30
90495425381,90495425385,4,2867,1609,-30
90499385063,90499385068,5,2186,1275,-30
90503557561,90503557566,5,3196,1480,-30
90505522686,90505522690,4,1553,923,-30
90508307943,90508307949,6,2512,1067,-30
90513517677,90513517682,5,2320,1102,-30
90514894391,90514894396,5,2859,1019,-30
90516370241,90516370222,-19,1597,1303,-30
90518471106,90518471111,5,1717,1572,-30
90519845334,90519845328,-6,1973,10278,-30
90520273068,90520273073,5,1930,1304,-30
90520461977,90520461974,-3,21182,47512,-30
90521476829,90521476827,-2,2427,4271,-30
90523024353,90523024357,4,2896,1345,-30
90524013441,90524013446,5,1851,1279,-30
90524777053,90524777054,1,1119,1033,-30
90526215478,90526215475,-3,854,1997,-30
90526760807,90526760814,7,2004,1241,-30
90528337200,90528337202,2,23855,103125,-30
90530809163,90530809171,8,1803,1047,-30
90535449889,90535449884,-5,1714,5120,-30
90541262282,90541262286,4,2075,1193,-30
90542549797,90542549801,4,1296,1238,-30
90544259668,90544259674,6,1952,1186,-30
90545237511,90545237517,6,4899,1622,-30
90546194989,90546194991,2,1282,1340,-30
90548128249,90548128254,5,2582,1228,-30
90548225731,90548225712,-19,951,714,-30
90550276633,90550276638,5,2251,1429,-30
90550382178,90550382182,4,1964,1139,-30
90553319902,90553319907,5,1777,1163,-30
90553891272,90553891277,5,2912,1793,-30
90556914958,90556914963,5,1349,949,-30
90557759441,90557759445,4,2891,1230,-30
90559733785,90559733790,5,2559,1185,-30
90559805880,90559805884,4,20526,24309,-30
90560574766,90560574770,4,2407,1534,-30
90561260143,90561260148,5,1795,734,-30
90562099060,90562099065,5,2901,1436,-30
90562155858,90562155862,4,2190,1319,-30
90562413322,90562413304,-18,724,302,-30
90563086826,90563086832,6,1357,856,-30
90563964682,90563964686,4,2571,1643,-30
90564608574,90564608579,5,2342,1315,-30
90565100112,90565100117,5,1996,1209,-30
90569419387,90569419394,7,1734,1007,-30
90571407348,90571407354,6,3080,1328,-30
90571774354,90571774340,-14,3006,1388,-30
90572101515,90572101519,4,1786,1378,-30
90574167268,90574167270,2,1413,1095,-30
90574753635,90574753641,6,1798,1353,-30
90579267941,90579267945,4,1855,1296,-30
90582006618,90582006624,6,7526,3196,-30
90586280852,90586280856,4,2624,1447,-30
90590470834,90590470839,5,1768,1256,-30
90590600293,90590600300,7,1747,1014,-30
90593440568,90593440571,3,1551,972,-30
90596083162,90596083168,6,12570,24582,-30
90597225386,90597225391,5,3266,1642,-30
90598467224,90598467228,4,1044,907,-30
90600927165,90600927171,6,1869,1306,-30
90600955774,90600955752,-22,1797,1972,-30
90601015311,90601015318,7,2708,1000,-30
90602369241,90602369224,-17,2905,1436,-30
90603023548,90603023554,6,2995,1471,-30
90605204965,90605204971,6,2122,1617,-30
90610413849,90610413855,6,2088,1637,-30
90612165394,90612165398,4,2167,1307,-30
90613861846,90613861850,4,2746,1521,-30
90614827726,90614827731,5,2709,1095,-30
90617131330,90617131335,5,1390,1254,-30
90627398279,90627398283,4,1793,1110,-30
90628612864,90628612869,5,1904,1928,-30
90631371958,90631371963,5,1460,1138,-30
90634259294,90634259299,5,2721,1324,-30
90636930495,90636930501,6,2264,1144,-30
90639132607,90639132606,-1,1185,1436,-30
90643665329,90643665334,5,3219,1330,-30
90644049354,90644049360,6,2231,1229,-30
90645541772,90645541777,5,3095,1356,-30
90646496924,90646496925,1,1285,1817,-30
90647185742,90647185747,5,2041,1034,-30
90648742338,90648742343,5,1646,861,-30
90650426243,90650426244,1,1985,1655,-30
90651150227,90651150231,4,1893,1136,-30
90653842778,90653842782,4,1161,1085,-30
90654376570,90654376574,4,2307,988,-30
90655841062,90655841068,6,2499,1382,-30
90657872413,90657872417,4,1856,1352,-30
90658467364,90658467370,6,3753,1102,-30
90663280686,90663280690,4,2474,1565,-30
90663797932,90663797938,6,1925,1529,-30
90664192367,90664192379,12,2267,1087,-30
90664636418,90664636403,-15,2775,1381,-30
90664731666,90664731673,7,2806,1410,-30
90665287058,90665287058,0,1825,1414,-30
90667865861,90667865866,5,2418,1461,-30
90676063532,90676063537,5,2498,1279,-30
90677505344,90677505347,3,1797,1239,-30
90678012638,90678012644,6,2012,1122,-30
90678987084,90678987086,2,2288,2061,-30
90682474686,90682474690,4,1998,1134,-30
90683674102,90683674106,4,1971,1124,-30
90685744095,90685744101,6,1292,1193,-30
90687907886,90687907891,5,1640,1449,-30
90694410096,90694410102,6,2821,1148,-30
90694564306,90694564311,5,3910,1660,-30
90694746702,90694746707,5,3085,1388,-30
90696368438,90696368443,5,1939,1467,-30
90697763542,90697763547,5,2049,1271,-30
90706047006,90706047010,4,3151,1699,-30
90706778902,90706778885,-17,2090,497,-30
90708972679,90708972687,8,1769,1150,-30
90710865670,90710865669,-1,1565,2375,-30
90713151141,90713151147,6,2376,1043,-30
90716254319,90716254322,3,2397,1451,-30
90718261581,90718261586,5,1724,995,-30
90718760565,90718760570,5,2325,1269,-30
90722537681,90722537686,5,2406,1393,-30
90730351736,90730351741,5,2520,1534,-30
90731115444,90731115449,5,1329,825,-30
90734526322,90734526327,5,1000,724,-30
90736904323,90736904326,3,1627,1326,-30
90740864060,90740864065,5,1281,951,-30
90748980341,90748980345,4,2401,1492,-30
90749102117,90749102121,4,2917,1349,-30
90749423094,90749423102,8,3442,1832,-30
90756433889,90756433893,4,2384,1783,-30
90758131960,90758131962,2,1880,1283,-30
90758695075,90758695077,2,1512,1618,-30
90760004597,90760004603,6,3023,1399,-30
90762055374,90762055378,4,3462,1217,-30
90764974050,90764974056,6,2770,1797,-30
90765860566,90765860571,5,2588,1479,-30
90768999938,90768999951,13,13686,50902,-30
90771234061,90771234065,4,2958,1265,-30
90773626320,90773626322,2,20826,7022,-30
90779855961,90779855965,4,2835,1458,-30
90781543522,90781543526,4,2563,1492,-30
90782720805,90782720811,6,2612,1316,-30
90784854482,90784854490,8,4068,1523,-30
90784940820,90784940823,3,1288,830,-30
90786851488,90786851493,5,2547,1421,-30
90787560826,90787560830,4,1524,1452,-30
90788575664,90788575670,6,2165,1312,-30
90789473177,90789473180,3,1742,1193,-30
90790198929,90790198914,-15,2300,1257,-30
90791996745,90791996749,4,1754,694,-30
90793242177,90793242182,5,2036,899,-30
90796375094,90796375099,5,2714,1518,-30
90800261315,90800261294,-21,31764,42856,-30
90802777387,90802777393,6,3054,1538,-30
90805748703,90805748709,6,1640,1356,-30
90807634587,90807634591,4,2536,1383,-30
90807764194,90807764196,2,1543,1851,-30
90811674516,90811674521,5,1174,881,-30
90812103435,90812103439,4,2131,804,-30
90813879264,90813879267,3,1797,1246,-30
90817759697,90817759705,8,3558,1349,-30
90822415153,90822415158,5,2775,1571,-30
90824260599,90824260604,5,2534,1455,-30
90825365393,90825365398,5,2904,794,-30
90827979102,90827979108,6,2418,1370,-30
90829490970,90829490971,1,1288,963,-30
90830256105,90830256110,5,1878,1431,-30
90831225841,90831225845,4,1547,1230,-30
90835654238,90835654222,-16,1398,1601,-30
90837763157,90837763163,6,2461,1330,-30
90838733117,90838733122,5,3883,2150,-30
90840998494,90840998498,4,2655,1485,-30
90843591933,90843591937,4,2232,1462,-30
90843944808,90843944814,6,2174,1181,-30
90844797142,90844797146,4,1670,1097,-30
90848173652,90848173657,5,2611,1423,-30
90850724716,90850724714,-2,1711,2625,-30
90853116014,90853116018,4,2601,1428,-30
90854646782,90854646776,-6,1104,2253,-30
90856611578,90856611574,-4,482,1054,-30
90858155830,90858155832,2,1908,1467,-30
90861893922,90861893927,5,2279,1303,-30
90863409714,90863409722,8,5384,1611,-30
90865847133,90865847137,4,1080,831,-30
90868674586,90868674589,3,1620,1197,-30
90872764502,90872764507,5,2365,1905,-30
90873125502,90873125509,7,9405,3949,-30
90874163585,90874163579,-6,945,5288,-30
90875891487,90875891491,4,1838,1428,-30
90878408067,90878408059,-8,29279,8436,-30
90880205090,90880205091,1,1736,1111,-30
90882023317,90882023321,4,894,828,-30
90885929331,90885929334,3,1994,1125,-30
90893921540,90893921538,-2,964,1264,-30
90895302560,90895302564,4,1715,1243,-30
90896345713,90896345715,2,1297,1041,-30
90899403205,90899403212,7,2601,1337,-30
90899428449,90899428435,-14,2666,872,-30
90902754415,90902754421,6,2251,857,-30
90903159023,90903159020,-3,19430,41306,-30
90903805629,90903805631,2,1986,1582,-30
90906320452,90906320456,4,2215,1572,-30
90910665161,90910665161,0,3541,2962,-30
90911666093,90911666097,4,1944,1385,-30
90912580014,90912579992,-22,1934,1149,-30
90915848338,90915848336,-2,1183,154,-30
90919386358,90919386362,4,1441,980,-30
90923712893,90923712898,5,2162,1405,-30
90925318078,90925318083,5,2585,1683,-30
90934811695,90934811701,6,2874,1139,-30
90934975806,90934975784,-22,2272,1200,-30
90935979013,90935979018,5,2413,1083,-30
90937597914,90937597918,4,2159,1552,-30
90938261366,90938261370,4,2656,1993,-30
90943213925,90943213930,5,1844,902,-30
90943492720,90943492737,17,2040,1358,-30
90948258846,90948258851,5,1827,869,-30
90954181226,90954181230,4,2445,1071,-30
90954228202,90954228208,6,2522,1267,-30
90954615115,90954615121,6,2085,1308,-30
90954848469,90954848474,5,2713,1439,-30
90955089573,90955089578,5,1778,1233,-30
90957065606,90957065612,6,1887,1038,-30
90957963821,90957963828,7,2398,1252,-30
90960090411,90960090415,4,1944,1130,-30
90960650129,90960650114,-15,2944,1096,-30
90961051409,90961051414,5,2715,1616,-30
90967774701,90967774705,4,2159,1213,-30
90971161425,90971161431,6,2533,1500,-30
90974456526,90974456506,-20,960,5618,-30
90975994190,90975994195,5,2844,1999,-30
90976993582,90976993588,6,1694,1280,-30
90977335702,90977335706,4,3245,1820,-30
90977738440,90977738443,3,1434,996,-30
90977975114,90977975119,5,2407,1408,-30
90979788309,90979788315,6,3117,1313,-30
90980657462,90980657467,5,2204,1080,-30
90981131413,90981131419,6,2356,1376,-30
90982516857,90982516862,5,3110,1987,-30
90984497418,90984497423,5,2080,1220,-30
90984617857,90984617863,6,3004,1790,-30
90985154765,90985154766,1,1440,1544,-30
90986506517,90986506521,4,1691,1349,-30
90986954594,90986954592,-2,1148,2439,-30
90989675617,90989675622,5,2427,1301,-30
90994927887,90994927893,6,4859,2011,-30
90995648695,90995648701,6,2999,1737,-30
91000104990,91000104995,5,1586,1135,-30
91002220962,91002220968,6,2159,1071,-30
91004195165,91004195170,5,1899,1318,-30
91007465279,91007465283,4,1448,1090,-30
91008109914,91008109897,-17,2465,678,-30
91008164045,91008164053,8,2835,903,-30
91010866673,91010866676,3,2209,1830,-30
91013383552,91013383555,3,1655,1476,-30
91016622941,91016622945,4,2897,1735,-30
91017277070,91017277073,3,1263,895,-30
91023358973,91023358973,0,2385,3252,-30
91024386932,91024386938,6,3099,1524,-30
91025355326,91025355333,7,3057,1677,-30
91032102601,91032102606,5,2343,1937,-30
91032374443,91032374450,7,1277,921,-30
91036740470,91036740466,-4,1678,3696,-30
91040107358,91040107362,4,2112,1408,-30
91040936385,91040936389,4,1899,912,-30
91043637923,91043637922,-1,1610,2326,-30
91045606138,91045606132,-6,2115,508,-30
91050710458,91050710462,4,2276,1095,-30
91055881099,91055881103,4,2703,1284,-30
91057881377,91057881383,6,1366,689,-30
91058453658,91058453663,5,1762,947,-30
91059091865,91059091870,5,2991,1775,-30
91062683017,91062683021,4,2128,1156,-30
91066032735,91066032740,5,2007,1308,-30
91069239191,91069239195,4,2071,1252,-30
91070164049,91070164071,22,2373,1330,-30
91070649650,91070649654,4,1882,945,-30
91075333010,91075333015,5,2966,1253,-30
91076048864,91076048869,5,2996,1306,-30
91076997389,91076997391,2,2730,1158,-30
91080605274,91080605279,5,2479,1916,-30
91080970913,91080970919,6,3327,1361,-30
91082592746,91082592741,-5,4333,14230,-30
91084323524,91084323522,-2,1943,2191,-30
91084890932,91084890937,5,2847,1533,-30
91085721681,91085721682,1,1508,1505,-30
91088022648,91088022653,5,2054,1399,-30
91088985422,91088985426,4,2539,1435,-30
91089443909,91089443911,2,1820,1410,-30
91090439885,91090439891,6,2380,1348,-30
91091174078,91091174082,4,2888,1847,-30
91091970323,91091970329,6,3618,1604,-30
91092546994,91092546999,5,2278,972,-30
91096119181,91096119187,6,2571,1571,-30
91099317149,91099317154,5,2836,1389,-30
91102044735,91102044743,8,1940,1195,-30
91103183946,91103183950,4,2304,1202,-30
91105118462,91105118466,4,1212,831,-30
91105310893,91105310874,-19,900,144,-30
91106654323,91106654329,6,2263,1562,-30
91108354846,91108354850,4,2051,1292,-30
91109026971,91109026975,4,1881,1005,-30
91109148066,91109148052,-14,1999,1148,-30
91110118570,91110118554,-16,855,809,-30
91110589975,91110589981,6,2039,1127,-30
91113972392,91113972397,5,3147,1457,-30
91115651797,91115651802,5,2164,1061,-30
91118373533,91118373539,6,1636,933,-30
91120270646,91120270650,4,1800,708,-30
91123036050,91123036054,4,2243,1694,-30
91126714605,91126714609,4,2528,1368,-30
91129745856,91129745859,3,1775,1085,-30
91130581763,91130581769,6,2377,1486,-30
91132273790,91132273794,4,2284,1126,-30
91133303586,91133303602,16,12647,50094,-30
91138697974,91138697978,4,1894,1086,-30
91139492111,91139492117,6,2088,899,-30
91140722170,91140722176,6,2264,1430,-30
91142209787,91142209791,4,3905,1808,-30
91144991659,91144991663,4,1674,1245,-30
91145523154,91145523138,-16,724,374,-30
91145887254,91145887259,5,2753,1567,-30
91146031200,91146031206,6,969,642,-30
91146136625,91146136634,9,1669,918,-30
91147779362,91147779368,6,2179,1358,-30
91148222301,91148222305,4,1715,1407,-30
91152582778,91152582783,5,2241,1602,-30
91163381405,91163381410,5,2038,1284,-30
91168159594,91168159598,4,2005,1373,-30
91169467181,91169467183,2,2848,1891,-30
91173027355,91173027359,4,2071,1612,-30
91175774813,91175774818,5,2959,1565,-30
91176281475,91176281480,5,2442,1254,-30
91180592595,91180592599,4,1985,1371,-30
91180860621,91180860629,8,1670,906,-30
91183959610,91183959613,3,2570,1202,-30
91185704832,91185704831,-1,1184,2163,-30
91190923537,91190923542,5,2085,1320,-30
91192989368,91192989371,3,1269,1293,-30
91193979391,91193979396,5,2602,1063,-30
91195078847,91195078852,5,1815,1310,-30
91195278406,91195278411,5,1974,1087,-30
91197476621,91197476625,4,2244,1669,-30
91198543022,91198543025,3,2084,1215,-30
91203148781,91203148785,4,2246,948,-30
91206435489,91206435486,-3,893,1879,-30
91210351321,91210351327,6,1720,1556,-30
91212745306,91212745310,4,3061,1982,-30
91217059329,91217059335,6,1599,1169,-30
91218187451,91218187454,3,1920,1188,-30
91218949069,91218949073,4,3468,1731,-30
91222946625,91222946631,6,2957,1477,-30
91224914613,91224914619,6,2513,1301,-30
91225623994,91225624001,7,2414,959,-30
91226178321,91226178327,6,2188,1341,-30
91230233691,91230233696,5,3507,1605,-30
91232952893,91232952897,4,2211,1525,-30
91234511776,91234511778,2,1132,1060,-30
91236838836,91236838841,5,1091,1240,-30
91238455581,91238455587,6,1581,1075,-30
91238878240,91238878246,6,2890,1280,-30
91244255738,91244255755,17,686,113,-30
91246391833,91246391839,6,1956,1132,-30
91246487095,91246487091,-4,638,196,-30
91250259854,91250259858,4,1754,970,-30
91251410289,91251410293,4,2748,1264,-30
91251492118,91251492126,8,2206,1148,-30
91252639317,91252639321,4,2703,1337,-30
91253869095,91253869101,6,2736,1312,-30
91254857846,91254857850,4,2172,1286,-30
91257815708,91257815713,5,1917,1296,-30
91258933449,91258933453,4,2313,1204,-30
91259189431,91259189436,5,2198,1294,-30
91259650115,91259650118,3,1597,1099,-30
91263379696,91263379701,5,3017,1286,-30
91267961028,91267961033,5,2483,1731,-30
91268803354,91268803355,1,1811,1218,-30
91272878270,91272878275,5,2029,1021,-30
91277066943,91277066947,4,1157,653,-30
91278391262,91278391267,5,2035,1344,-30
91281196668,91281196671,3,1445,1235,-30
91284781381,91284781385,4,2516,1582,-30
91285285384,91285285389,5,2900,1772,-30
91286544172,91286544180,8,3276,1141,-30
91286923970,91286923976,6,2739,1704,-30
91291114758,91291114764,6,2458,1167,-30
91292117048,91292117054,6,2104,1119,-30
91292417973,91292417966,-7,1590,12435,-30
91296522049,91296522054,5,3375,1678,-30
91297738978,91297738984,6,2301,1650,-30
91301146937,91301146924,-13,1166,770,-30
91303350506,91303350514,8,3162,1359,-30
91319697615,91319697622,7,2687,1664,-30
91320493169,91320493174,5,1699,873,-30
91323260578,91323260581,3,1225,1157,-30
91323868253,91323868256,3,2271,1513,-30
91328661454,91328661470,16,2396,1489,-30
91329174005,91329174010,5,2432,1738,-30
91332691075,91332691077,2,2211,1445,-30
91334538895,91334538898,3,2121,1117,-30
91336943734,91336943738,4,1932,919,-30
91338532051,91338532054,3,2996,1302,-30
91343022131,91343022134,3,1715,1515,-30
91346058662,91346058667,5,3480,1528,-30
91359366775,91359366781,6,1677,1688,-30
91361013254,91361013259,5,2101,985,-30
91366506113,91366506119,6,2785,1444,-30
91367958906,91367958901,-5,1544,6175,-30
91369382274,91369382279,5,2989,1459,-30
91375006547,91375006551,4,2075,1171,-30
91378160510,91378160516,6,2477,1215,-30
91378884675,91378884679,4,3205,1656,-30
91379683033,91379683037,4,1855,1065,-30
91380627825,91380627829,4,1923,791,-30
91381469494,91381469483,-11,2757,1006,-30
91382157490,91382157493,3,2730,1297,-30
91387221471,91387221477,6,2038,1072,-30
91387553407,91387553416,9,2540,1539,-30
91392045658,91392045662,4,1714,1898,-30
91392232988,91392232983,-5,1714,4647,-30
91395143481,91395143486,5,2863,1483,-30
91396721057,91396721062,5,1585,1330,-30
91398182266,91398182271,5,2242,1305,-30
91400067761,91400067766,5,2535,1430,-30
91401475337,91401475341,4,2285,1150,-30
91401507246,91401507249,3,2194,1475,-30
91401756103,91401756106,3,2821,1366,-30
91403196313,91403196318,5,1834,1537,-30
91403289802,91403289805,3,2472,1284,-30
91404538674,91404538678,4,1646,1161,-30
91408008328,91408008334,6,1873,1346,-30
91408160347,91408160350,3,1855,1259,-30
91409602587,91409602590,3,1914,1718,-30
91416113166,91416113172,6,2556,1383,-30
91416567080,91416567088,8,3225,1094,-30
91417309919,91417309924,5,2076,1998,-30
91427533676,91427533678,2,1400,1270,-30
91428171840,91428171845,5,2353,1082,-30
91428299929,91428299935,6,3101,1259,-30
91428363347,91428363351,4,10461,6102,-30
91430534050,91430534054,4,2053,1557,-30
91431869900,91431869906,6,2833,1327,-30
91433938269,91433938275,6,1820,1150,-30
91434690273,91434690278,5,2285,1583,-30
91435535222,91435535241,19,1872,1162,-30
91436211029,91436211010,-19,1725,629,-30
91436448805,91436448811,6,2605,1534,-30
91439242686,91439242690,4,2100,1537,-30
91441974898,91441974894,-4,2036,6238,-30
91449107815,91449107821,6,1610,850,-30
91450306493,91450306497,4,2018,1099,-30
91451685342,91451685348,6,2069,1477,-30
91453248825,91453248830,5,2711,1543,-30
91454510666,91454510670,4,2388,1378,-30
91454632511,91454632516,5,2535,1181,-30
91461865806,91461865811,5,2670,1355,-30
91465248352,91465248345,-7,1526,5096,-30
91468236286,91468236292,6,1503,1000,-30
91475279586,91475279590,4,1805,1029,-30
91479270445,91479270450,5,2597,1440,-30
91482112802,91482112806,4,1048,820,-30
91490967819,91490967825,6,2084,1138,-30
91491952284,91491952286,2,2134,1768,-30
91493465540,91493465545,5,2279,1491,-30
91502492222,91502492235,13,3584,44110,-30
91504393197,91504393202,5,3119,1352,-30
91506114786,91506114794,8,1417,669,-30
91507107416,91507107420,4,2163,1157,-30
91509521337,91509521342,5,2481,1056,-30
91509672821,91509672803,-18,1846,1516,-30
91512039353,91512039357,4,2084,1531,-30
91514358726,91514358730,4,2140,1423,-30
91516844419,91516844423,4,1957,1303,-30
91519685607,91519685614,7,39422,16547,-30
91521404994,91521404998,4,2713,1781,-30
91523088318,91523088322,4,1371,970,-30
91524470089,91524470094,5,1494,979,-30
91529694015,91529694020,5,2277,1187,-30
91531968583,91531968587,4,2106,1595,-30
91532186140,91532186143,3,1232,939,-30
91533435697,91533435703,6,2682,1502,-30
91537912729,91537912734,5,2412,1173,-30
91542765545,91542765550,5,3131,1198,-30
91546638194,91546638198,4,1630,1062,-30
91549295227,91549295234,7,2591,1171,-30
91549597831,91549597839,8,1788,1571,-30
91551830978,91551830983,5,1833,1027,-30
91553614895,91553614901,6,2661,1495,-30
91553805761,91553805770,9,2946,1067,-30
91560423279,91560423286,7,2016,1445,-30
91562425599,91562425605,6,1648,1095,-30
91565640109,91565640110,1,1396,1483,-30
91565844343,91565844349,6,2712,1339,-30
91566014076,91566014098,22,2160,1252,-30
91566968084,91566968091,7,2751,1226,-30
91567744297,91567744295,-2,1539,2989,-30
91571751181,91571751186,5,2068,1477,-30
91573797332,91573797333,1,3212,4617,-30
91574114590,91574114595,5,2336,1047,-30
91575406771,91575406776,5,2489,1083,-30
91578441142,91578441147,5,2952,1698,-30
91579253019,91579253026,7,2787,1242,-30
91580874762,91580874766,4,1371,2092,-30
91580973392,91580973399,7,3126,1255,-30
91583891670,91583891677,7,2047,1082,-30
91587082673,91587082677,4,2892,1259,-30
91588160986,91588160990,4,2499,1547,-30
91591699047,91591699051,4,2606,1182,-30
91592462773,91592462778,5,2307,1296,-30
91592896380,91592896385,5,2514,1435,-30
91595707693,91595707686,-7,3692,8404,-30
91596398446,91596398451,5,2127,1316,-30
91596676881,91596676886,5,1331,919,-30
91601964333,91601964338,5,1961,846,-30
91606859686,91606859690,4,2462,1381,-30
91607170175,91607170179,4,2143,1345,-30
91610162794,91610162798,4,2553,1944,-30
91615696516,91615696519,3,1799,1145,-30
91616178720,91616178725,5,2379,1590,-30
91616863626,91616863630,4,2890,1462,-30
91617348584,91617348583,-1,1860,1413,-30
91619472498,91619472503,5,1992,1278,-30
91620055964,91620055970,6,2209,1458,-30
91620601322,91620601333,11,328,1336,-30
91620710782,91620710792,10,773,233,-30
91623837900,91623837906,6,2706,1467,-30
91624327155,91624327154,-1,48593,32953,-30
91624670185,91624670189,4,3269,2178,-30
91626568015,91626568021,6,2065,989,-30
91626669904,91626669911,7,2722,1519,-30
91630185421,91630185425,4,2402,1711,-30
91632429950,91632429955,5,1875,1139,-30
91637475464,91637475468,4,1719,1612,-30
91637670468,91637670490,22,1036,215,-30
91640736834,91640736847,13,2709,1263,-30
91650347046,91650347051,5,1646,1150,-30
91657691022,91657691041,19,2249,1393,-30
91668701631,91668701635,4,2001,1269,-30
91675811339,91675811343,4,1572,1142,-30
91684337682,91684337686,4,2002,1232,-30
91684631871,91684631873,2,1506,975,-30
91687479413,91687479419,6,1367,909,-30
91692913134,91692913137,3,2004,1806,-30
91694313034,91694313041,7,3702,1178,-30
91694799193,91694799198,5,1732,1343,-30
91698112064,91698112068,4,1817,1023,-30
91702953122,91702953118,-4,31766,8605,-30
91704541629,91704541634,5,1885,1081,-30
91705777595,91705777600,5,2500,1126,-30
91706408973,91706408978,5,1783,939,-30
91707509618,91707509622,4,2256,967,-30
91707998143,91707998142,-1,1067,2866,-30
91708051489,91708051493,4,2544,1228,-30
91712670659,91712670665,6,2711,1213,-30
91713680622,91713680628,6,2218,1188,-30
91716099193,91716099198,5,2779,1418,-30
91721195268,91721195271,3,1537,1119,-30
91723088198,91723088202,4,3418,1774,-30
91723707331,91723707340,9,1904,1445,-30
91724272746,91724272751,5,2649,1631,-30
91726582387,91726582392,5,1807,873,-30
91729836460,91729836464,4,1914,1170,-30
91729986570,91729986587,17,753,136,-30
91731798142,91731798147,5,2997,1612,-30
91736322129,91736322134,5,773,503,-30
91737305954,91737305957,3,1879,2224,-30
91737756782,91737756789,7,2071,1314,-30
91743001569,91743001575,6,2590,1653,-30
91744539797,91744539802,5,1786,1428,-30
91749254353,91749254358,5,2651,1633,-30
91752658342,91752658345,3,1490,999,-30
91757243239,91757243248,9,1624,810,-30
91757620132,91757620121,-11,342,115,-30
91761568414,91761568417,3,2080,1645,-30
91763504920,91763504925,5,1916,1221,-30
91763604758,91763604765,7,4378,1404,-30
91772614734,91772614739,5,1546,938,-30
91774244389,91774244392,3,3646,2551,-30
91775691071,91775691077,6,1832,846,-30
91775936778,91775936762,-16,2307,1217,-30
91778976364,91778976369,5,3434,1740,-30
91783379965,91783379969,4,1918,1582,-30
91784536682,91784536686,4,2352,1487,-30
91786263433,91786263438,5,1830,857,-30
91786591385,91786591393,8,1775,1014,-30
91787671922,91787671926,4,2674,1731,-30
91790795900,91790795904,4,2207,1315,-30
91791717173,91791717179,6,2623,908,-30
91793223077,91793223085,8,2231,746,-30
91797833395,91797833399,4,2463,1295,-30
91799700687,91799700688,1,1908,3645,-30
91800008641,91800008645,4,1020,506,-30
91800665486,91800665493,7,1980,1409,-30
91801471873,91801471877,4,1810,1282,-30
91801970670,91801970666,-4,719,372,-30
91803007111,91803007115,4,2134,1020,-30
91804820545,91804820550,5,2372,1499,-30
91812678701,91812678706,5,2769,1552,-30
91820920593,91820920598,5,2432,1201,-30
91821291174,91821291178,4,2639,1252,-30
91824577387,91824577393,6,3477,2166,-30
91825166389,91825166393,4,2191,1617,-30
91825672968,91825672973,5,2871,1210,-30
91827287517,91827287518,1,1883,2292,-30
91829710138,91829710142,4,2861,1373,-30
91837821888,91837821893,5,2505,1467,-30
91839064892,91839064894,2,2399,2133,-30
91841649109,91841649115,6,2271,1263,-30
91842206678,91842206683,5,2741,1408,-30
91844669222,91844669227,5,2516,1186,-30
91857413597,91857413603,6,1359,862,-30
91857680846,91857680854,8,2784,1128,-30
91857931877,91857931877,0,1187,1428,-30
91859416487,91859416477,-10,983,4698,-30
91861430298,91861430302,4,1990,1381,-30
91861489530,91861489536,6,1463,1167,-30
91863353487,91863353494,7,2172,818,-30
91863658041,91863658048,7,3164,1475,-30
91864554579,91864554586,7,2415,1339,-30
91865796685,91865796690,5,1741,1024,-30
91867117450,91867117455,5,1251,944,-30
91867217282,91867217264,-18,1208,584,-30
91868963681,91868963686,5,3352,1571,-30
91869252735,91869252715,-20,2305,1066,-30
91870218664,91870218670,6,2167,1209,-30
91871071222,91871071222,0,1116,1343,-30
91871770890,91871770897,7,1982,1279,-30
91876329024,91876329028,4,1912,1146,-30
91876909849,91876909849,0,1275,1352,-30
91878077643,91878077648,5,1467,1429,-30
91878386255,91878386260,5,2491,1247,-30
91878599449,91878599454,5,2576,1443,-30
91880500814,91880500818,4,2643,1639,-30
91884750530,91884750534,4,2322,1720,-30
91885266858,91885266863,5,1361,2310,-30
91885554147,91885554150,3,1579,1525,-30
91885647920,91885647926,6,2105,1354,-30
91885865686,91885865692,6,1662,1673,-30
91889392106,91889392110,4,1820,1470,-30
91891926617,91891926620,3,2636,1199,-30
91893730262,91893730266,4,2096,1062,-30
91894574658,91894574662,4,1761,1289,-30
91896215120,91896215120,0,1021,1532,-30
91899662758,91899662760,2,2104,1261,-30
91901146748,91901146753,5,2091,1629,-30
91902930334,91902930340,6,3415,1870,-30
91903842446,91903842451,5,2119,1219,-30
91907413853,91907413858,5,2972,1223,-30
91908181674,91908181690,16,1064,1108,-30
91908943781,91908943786,5,2053,1555,-30
91912778550,91912778557,7,2022,932,-30
91914117571,91914117575,4,1911,1277,-30
91915930063,91915930069,6,2792,1124,-30
91917275149,91917275154,5,1630,1184,-30
91917941283,91917941290,7,2809,857,-30
91918480419,91918480423,4,2276,1425,-30
91921110955,91921110958,3,1544,1286,-30
91923935638,91923935642,4,2536,1634,-30
91925941563,91925941567,4,2389,1813,-30
91926966613,91926966618,5,1811,1173,-30
91927206206,91927206211,5,1757,1339,-30
91928705772,91928705777,5,2500,1598,-30
91929698239,91929698240,1,1932,1269,-30
91931334139,91931334145,6,2926,1639,-30
91936437050,91936437055,5,2782,1613,-30
91936865201,91936865205,4,2674,1878,-30
91937064530,91937064535,5,2802,1966,-30
91937523558,91937523563,5,1747,985,-30
91938081556,91938081559,3,1945,1274,-30
91939639033,91939639036,3,2315,1355,-30
91940109081,91940109086,5,1502,1242,-30
91941189126,91941189130,4,1828,1247,-30
91941350474,91941350475,1,1505,1349,-30
91941688854,91941688859,5,3008,1284,-30
91947282574,91947282578,4,1640,1259,-30
91951734233,91951734238,5,1470,763,-30
91952709061,91952709065,4,2034,1204,-30
91953087726,91953087721,-5,1038,2386,-30
91954623317,91954623323,6,2711,1497,-30
91956238943,91956238947,4,1721,1149,-30
91958677628,91958677627,-1,855,2004,-30
91959202873,91959202870,-3,1119,1632,-30
91960354391,91960354395,4,1808,1350,-30
91961810253,91961810258,5,1972,1118,-30
91963258399,91963258412,13,2194,1095,-30
91963294250,91963294243,-7,736,215,-30
91964060516,91964060498,-18,1563,990,-30
91966471050,91966471055,5,998,652,-30
91970488345,91970488341,-4,2541,7206,-30
91973371723,91973371729,6,1822,1293,-30
91977041653,91977041656,3,1784,1004,-30
91978001829,91978001826,-3,1229,2244,-30
91978397441,91978397446,5,2221,868,-30
91980802848,91980802854,6,2926,1310,-30
91982214753,91982214774,21,460,1349,-30
91983065678,91983065682,4,3191,1494,-30
91984264392,91984264395,3,1214,1039,-30
91985385458,91985385463,5,2904,1940,-30
91989091953,91989091963,10,12375,35040,-30
91992948814,91992948819,5,2355,951,-30
91993019933,91993019937,4,2434,1034,-30
91997725379,91997725379,0,2146,2033,-30
91998446209,91998446214,5,2853,1576,-30
92000586218,92000586224,6,1999,1380,-30
92005153781,92005153785,4,1715,1241,-30
92005297837,92005297841,4,1971,1166,-30
92008345475,92008345482,7,3421,1528,-30
92009261821,92009261827,6,1635,1059,-30
92010420907,92010420913,6,2471,1119,-30
92012030935,92012030941,6,1251,838,-30
92014178799,92014178802,3,2727,1947,-30
92017456665,92017456670,5,3535,1213,-30
92018185260,92018185269,9,2041,714,-30
92030504856,92030504861,5,1985,1428,-30
92032896617,92032896621,4,1750,1318,-30
92036876600,92036876603,3,1392,1150,-30
92038699463,92038699469,6,3025,1834,-30
92039714958,92039714962,4,3853,2685,-30
92041775143,92041775146,3,1593,953,-30
92042094142,92042094132,-10,2703,1319,-30
92044677189,92044677194,5,1494,626,-30
92045905070,92045905074,4,2206,1268,-30
92046244437,92046244441,4,2737,1732,-30
92048672086,92048672091,5,1719,1472,-30
92049723232,92049723237,5,2561,1325,-30
92050356877,92050356880,3,2246,1107,-30
92052062376,92052062382,6,1960,796,-30
92053589097,92053589101,4,2101,1103,-30
92055239549,92055239553,4,1521,1275,-30
92056001707,92056001714,7,2110,1846,-30
92057506630,92057506636,6,1353,1025,-30
92058931725,92058931730,5,2432,1203,-30
92059688715,92059688719,4,1820,1209,-30
92060445317,92060445321,4,2227,1507,-30
92061091052,92061091058,6,2031,1299,-30
92063927834,92063927834,0,1424,1180,-30
92064478457,92064478463,6,2032,853,-30
92067453526,92067453530,4,1917,1418,-30
92068021359,92068021365,6,2338,1186,-30
92071790413,92071790416,3,1842,1192,-30
92075059153,92075059158,5,2256,1155,-30
92075956797,92075956776,-21,2449,1220,-30
92079666382,92079666388,6,1289,1062,-30
92082947477,92082947482,5,2282,1552,-30
92088608924,92088608929,5,1919,1228,-30
92093839479,92093839484,5,1615,970,-30
92094038738,92094038741,3,1891,1348,-30
92098265018,92098265021,3,1952,1189,-30
92099452482,92099452485,3,1789,1398,-30
92104934827,92104934826,-1,1726,3247,-30
92106411074,92106411076,2,1666,1675,-30
92107695958,92107695963,5,2937,1132,-30
92108119285,92108119290,5,1832,1539,-30
92112868684,92112868690,6,1949,1103,-30
92115932206,92115932210,4,1546,843,-30
92116053838,92116053818,-20,3196,1267,-30
92119257841,92119257845,4,2279,1021,-30
92120931930,92120931934,4,2734,1475,-30
92124573232,92124573237,5,2398,1263,-30
92125865230,92125865231,1,1130,1618,-30
92128313787,92128313790,3,1461,1353,-30
92128953971,92128953987,16,2344,1226,-30
92129623621,92129623629,8,1554,1199,-30
92131694448,92131694454,6,1798,1048,-30
92137180046,92137180050,4,2130,1252,-30
92137720118,92137720123,5,1869,1170,-30
92138805273,92138805278,5,2303,1454,-30
92144139318,92144139323,5,1735,1229,-30
92145444947,92145444927,-20,2735,1390,-30
92151484030,92151484038,8,1670,914,-30
92155158273,92155158279,6,2661,1329,-30
92160904716,92160904720,4,1740,1619,-30
92164471086,92164471090,4,2901,1412,-30
92165058530,92165058537,7,2173,1500,-30
92167982416,92167982421,5,2735,1582,-30
92168113780,92168113785,5,1755,1342,-30
92175689005,92175689009,4,2202,1304,-30
92178442711,92178442717,6,2560,1643,-30
92178515934,92178515938,4,1875,1460,-30
92180823381,92180823385,4,2064,1044,-30
92188317786,92188317791,5,1274,1246,-30
92189984659,92189984663,4,2758,1551,-30
92194105147,92194105148,1,1276,1086,-30
92196041535,92196041537,2,2122,1069,-30
92199987374,92199987378,4,3176,1669,-30
92200042227,92200042233,6,2776,1227,-30
92201261814,92201261796,-18,1381,696,-30
92202039570,92202039576,6,2923,1456,-30
92205475168,92205475156,-12,3448,1127,-30
92206558361,92206558362,1,2473,1334,-30
92209073010,92209073014,4,1917,1212,-30
92209477126,92209477131,5,2212,884,-30
92209789718,92209789722,4,1743,1490,-30
92210068657,92210068662,5,1564,1424,-30
92212010034,92212010039,5,1634,1517,-30
92213184313,92213184328,15,1005,98,-30
92215009314,92215009319,5,2185,1710,-30
92215265991,92215265996,5,2695,1972,-30
92216206555,92216206558,3,3427,1346,-30
92216921370,92216921375,5,2738,1589,-30
92218023958,92218023963,5,1821,1059,-30
92219252883,92219252887,4,1630,1210,-30
92220893417,92220893422,5,1197,942,-30
92221305506,92221305510,4,2894,1887,-30
92223428154,92223428158,4,2807,1593,-30
92225793014,92225793021,7,2224,1461,-30
92225932974,92225932978,4,2232,1819,-30
92230187366,92230187369,3,2163,1446,-30
92233022770,92233022776,6,2929,1814,-30
92233871604,92233871585,-19,2083,1401,-30
92234927224,92234927227,3,1652,1156,-30
92236504783,92236504789,6,2384,814,-30
92236957645,92236957645,0,1455,1445,-30
92245111989,92245111994,5,2922,1441,-30
92247019074,92247019078,4,2781,2014,-30
92249843755,92249843759,4,2238,1098,-30
92252623850,92252623855,5,2227,1278,-30
92260152688,92260152694,6,2073,910,-30
92264535511,92264535509,-2,1746,3752,-30
92265630420,92265630417,-3,1383,2925,-30
92267715402,92267715405,3,1997,1542,-30
92272355631,92272355641,10,14592,40320,-30
92272955089,92272955094,5,2192,1234,-30
92281593026,92281593032,6,2879,1378,-30
92288137176,92288137180,4,2108,1693,-30
92290097250,92290097233,-17,873,373,-30
92290486917,92290486922,5,1867,1309,-30
92292411339,92292411330,-9,1243,1171,-30
92293044627,92293044631,4,2593,1269,-30
92294735219,92294735223,4,1765,1311,-30
92298248690,92298248694,4,1896,962,-30
92298593206,92298593210,4,1520,842,-30
92304553580,92304553585,5,2226,1032,-30
92304649286,92304649274,-12,3759,1472,-30
92305872205,92305872190,-15,916,323,-30
92306044347,92306044354,7,2623,1512,-30
92307052675,92307052679,4,2809,1936,-30
92310401515,92310401519,4,1628,1496,-30
92311995956,92311995961,5,2483,1297,-30
92313048835,92313048842,7,1243,1144,-30
92315702598,92315702604,6,2546,1366,-30
92317304038,92317304043,5,1880,1411,-30
92317664369,92317664374,5,2895,1786,-30
92320579637,92320579634,-3,2273,4003,-30
92320720709,92320720713,4,1775,1088,-30
92326115645,92326115650,5,2279,1285,-30
92326814143,92326814147,4,1523,805,-30
92327040738,92327040744,6,1795,1197,-30
92329577403,92329577407,4,1806,1145,-30
92334343048,92334343052,4,1076,1019,-30
92335902054,92335902056,2,2496,1408,-30
92336213372,92336213365,-7,1496,10255,-30
92336859449,92336859451,2,1370,973,-30
92338755273,92338755280,7,2341,1152,-30
92343990972,92343990980,8,13301,25848,-30
92352474948,92352474955,7,2550,1296,-30
92352504642,92352504647,5,1995,925,-30
92354313513,92354313510,-3,1310,2770,-30
92356938087,92356938092,5,2470,1909,-30
92359422766,92359422770,4,1486,815,-30
92362904690,92362904695,5,2663,1423,-30
92363933465,92363933470,5,1737,1173,-30
92366226276,92366226263,-13,932,950,-30
92367328463,92367328475,12,730,239,-30
92371001483,92371001486,3,2169,1201,-30
92371086927,92371086935,8,2484,1503,-30
92371522322,92371522328,6,2306,1548,-30
92371787041,92371787046,5,2482,1447,-30
92373763262,92373763269,7,2889,1153,-30
92374888778,92374888792,14,728,302,-30
92379300462,92379300467,5,2230,920,-30
92381624910,92381624916,6,3116,1138,-30
92389302634,92389302640,6,2598,1825,-30
92390041507,92390041514,7,2433,1230,-30
92392077984,92392077990,6,2667,838,-30
92396222854,92396222859,5,1448,842,-30
92403411565,92403411570,5,2062,1178,-30
92408224969,92408224974,5,1582,1045,-30
92416422640,92416422646,6,1459,1090,-30
92416991819,92416991826,7,2450,569,-30
92420443801,92420443806,5,2282,1058,-30
92421739858,92421739862,4,1643,1386,-30
92422624475,92422624479,4,3227,1825,-30
92426199459,92426199465,6,1474,1407,-30
92426530617,92426530621,4,2709,1517,-30
92427911400,92427911406,6,1979,1122,-30
92428932550,92428932553,3,1845,1506,-30
92430616037,92430616037,0,1918,2255,-30
92431588802,92431588802,0,1592,1984,-30
92436038252,92436038258,6,1735,1238,-30
92436600353,92436600363,10,1749,897,-30
92437216510,92437216508,-2,6742,14620,-30
92437815625,92437815629,4,2296,1218,-30
92438573261,92438573267,6,1198,731,-30
92442069903,92442069907,4,1696,938,-30
92443891306,92443891311,5,1771,1240,-30
92445159394,92445159398,4,2208,1075,-30
92445260300,92445260305,5,2731,1840,-30
92447158881,92447158886,5,2476,1434,-30
92451949643,92451949646,3,1703,1054,-30
92459155781,92459155786,5,2105,1688,-30
92462972987,92462972992,5,2769,1362,-30
92466245040,92466245043,3,1830,1018,-30
92467683576,92467683581,5,1950,1213,-30
92477900381,92477900386,5,2769,1213,-30
92478321624,92478321628,4,2552,1491,-30
92479657247,92479657249,2,2109,1884,-30
92480382327,92480382331,4,2764,1120,-30
92481098908,92481098913,5,2153,1180,-30
92486000626,92486000634,8,6454,2169,-30
92486091539,92486091544,5,3093,2091,-30
92487375638,92487375644,6,2686,1181,-30
92489489471,92489489473,2,1626,1093,-30
92495747531,92495747538,7,2145,1102,-30
92496231838,92496231842,4,2189,1012,-30
92496560581,92496560570,-11,675,348,-30
92498660943,92498660951,8,1733,1364,-30
92510264374,92510264377,3,1999,1325,-30
92512563909,92512563915,6,2217,1044,-30
92512804660,92512804666,6,2361,1163,-30
92513634510,92513634514,4,2221,1881,-30
92513855062,92513855062,0,2418,3227,-30
92514533294,92514533298,4,1761,1260,-30
92516739078,92516739072,-6,2230,8115,-30
92516945319,92516945323,4,1626,1017,-30
92520867562,92520867568,6,2996,1093,-30
92521332410,92521332401,-9,1155,5306,-30
92525659826,92525659831,5,2765,1351,-30
92528028190,92528028194,4,2091,1140,-30
92528998175,92528998184,9,925,1789,-30
92529968371,92529968376,5,2192,1625,-30
92535826826,92535826831,5,1369,594,-30
92537292070,92537292070,0,35054,16788,-30
92537420499,92537420503,4,2673,1060,-30
92540101846,92540101850,4,1841,1434,-30
92547033919,92547033924,5,2488,1697,-30
92547081391,92547081393,2,1247,2271,-30
92555073149,92555073155,6,1827,1014,-30
92555783626,92555783634,8,2562,1270,-30
92558750186,92558750193,7,1449,858,-30
92560561993,92560561998,5,2272,1454,-30
92561686386,92561686390,4,2114,1786,-30
92563376500,92563376507,7,1692,1067,-30
92565144653,92565144657,4,2808,1332,-30
92565913207,92565913213,6,1510,1213,-30
92566524134,92566524139,5,1511,1133,-30
92570477439,92570477442,3,1624,1130,-30
92571207130,92571207116,-14,1146,260,-30
92571519629,92571519635,6,1915,1256,-30
92576801094,92576801100,6,3000,1034,-30
92578153460,92578153466,6,1476,729,-30
92578762470,92578762476,6,2871,1296,-30
92582158610,92582158615,5,2744,947,-30
92584279850,92584279846,-4,2354,5234,-30
92584983169,92584983174,5,2264,1706,-30
92586783183,92586783178,-5,1939,1230,-30
92589118341,92589118344,3,2013,1522,-30
92589344017,92589344018,1,550,190,-30
92590478878,92590478883,5,1715,1178,-30
92592583513,92592583518,5,2150,1377,-30
92596543513,92596543518,5,2987,1374,-30
92605763306,92605763307,1,3554,4473,-30
92605857938,92605857939,1,1737,1754,-30
92610022281,92610022280,-1,385,2120,-30
92612869997,92612870002,5,2808,1279,-30
92618868299,92618868305,6,2040,1114,-30
92619355890,92619355886,-4,812,1266,-30
92620532997,92620533002,5,2663,1083,-30
92621331946,92621331946,0,2741,4228,-30
92622911268,92622911264,-4,1613,2622,-30
92623295642,92623295645,3,1387,1380,-30
92624299773,92624299778,5,2553,1128,-30
92625395530,92625395534,4,3280,1681,-30
92629384986,92629384981,-5,1316,4946,-30
92629772278,92629772284,6,1730,1083,-30
92630880646,92630880665,19,85,1055,-30
92634865566,92634865571,5,3443,1676,-30
92635146651,92635146658,7,3374,1966,-30
92635522406,92635522410,4,2817,1718,-30
92637412035,92637412042,7,1608,894,-30
92640285385,92640285394,9,2121,1136,-30
92641464703,92641464708,5,2442,1371,-30
92642610409,92642610414,5,2531,1426,-30
92645380198,92645380204,6,2398,1888,-30
92646249494,92646249500,6,3006,1538,-30
92646834200,92646834207,7,13195,21392,-30
92649576801,92649576806,5,1787,1443,-30
92650103343,92650103348,5,3258,1560,-30
92652958679,92652958686,7,2844,1054,-30
92659946061,92659946067,6,2768,1546,-30
92660820863,92660820867,4,3194,1305,-30
92663622983,92663622985,2,2258,2275,-30
92665517234,92665517237,3,2257,1640,-30
92667899345,92667899350,5,2546,1699,-30
92668873765,92668873771,6,2177,1303,-30
92669199914,92669199913,-1,1492,2161,-30
92672561506,92672561511,5,3176,1660,-30
92673352751,92673352757,6,2133,1359,-30
92673982502,92673982506,4,2694,1626,-30
92679223101,92679223108,7,2402,1125,-30
92680818069,92680818072,3,1882,1448,-30
92680856765,92680856784,19,2286,1369,-30
92682885877,92682885870,-7,1419,5353,-30
92683089402,92683089407,5,1433,718,-30
92683234474,92683234478,4,1664,1290,-30
92683694717,92683694722,5,2359,961,-30
92684301478,92684301483,5,2718,1652,-30
92685488826,92685488831,5,1442,1733,-30
92697318369,92697318372,3,1648,1203,-30
92700256157,92700256164,7,2056,1338,-30
92701268477,92701268483,6,1866,1243,-30
92703563149,92703563154,5,1449,888,-30
92705141693,92705141698,5,2204,1423,-30
92710349394,92710349411,17,9,993,-30
92711183711,92711183717,6,1999,1291,-30
92715792858,92715792862,4,2132,1513,-30
92717028802,92717028787,-15,659,22,-30
92718263951,92718263959,8,3691,1332,-30
92719955141,92719955147,6,2313,1289,-30
92720076657,92720076661,4,2105,1258,-30
92720914176,92720914183,7,2237,1125,-30
92721762473,92721762477,4,2010,1386,-30
92723867561,92723867568,7,2794,1116,-30
92726160449,92726160457,8,1990,1566,-30
92726447070,92726447088,18,1733,958,-30
92727217190,92727217194,4,2122,1245,-30
92732039362,92732039367,5,2240,1317,-30
92732949413,92732949406,-7,1727,10099,-30
92734183656,92734183662,6,2178,1240,-30
92739195805,92739195809,4,2887,1352,-30
92740852850,92740852853,3,1461,963,-30
92741616347,92741616351,4,2241,1261,-30
92741822304,92741822298,-6,32835,14160,-30
92748247226,92748247211,-15,3988,2048,-30
92748590274,92748590275,1,1563,1690,-30
92749564801,92749564806,5,2794,1423,-30
92751800445,92751800450,5,2077,1432,-30
92753449602,92753449608,6,2712,1087,-30
92754078795,92754078802,7,3469,1363,-30
92757349347,92757349354,7,2623,928,-30
92759608052,92759608055,3,1595,945,-30
92760689137,92760689143,6,2026,1130,-30
92761458531,92761458535,4,1563,798,-30
92763621734,92763621739,5,2199,1103,-30
92767477773,92767477778,5,2380,1130,-30
92767675486,92767675466,-20,3576,1256,-30
92771714849,92771714854,5,1851,1304,-30
92777066646,92777066650,4,2754,1750,-30
92783351352,92783351358,6,1851,1375,-30
92787602026,92787602030,4,2860,1533,-30
92789813427,92789813433,6,2420,1324,-30
92790422838,92790422817,-21,2591,4597,-30
92790496518,92790496522,4,1927,1203,-30
92794888509,92794888515,6,1614,751,-30
92795785283,92795785290,7,3110,1498,-30
92796144475,92796144478,3,1268,1636,-30
92797069610,92797069610,0,1736,1570,-30
92800910718,92800910723,5,1875,1195,-30
92804216905,92804216910,5,2031,1403,-30
92809572814,92809572818,4,2562,1622,-30
92811657813,92811657818,5,2262,1749,-30
92813018912,92813018917,5,3215,1845,-30
92815707985,92815707985,0,1824,1905,-30
92815751430,92815751434,4,1816,1085,-30
92819419615,92819419621,6,2559,1228,-30
92821777780,92821777786,6,1959,1000,-30
92822139229,92822139235,6,2854,1055,-30
92825197817,92825197822,5,2167,905,-30
92825953462,92825953467,5,2205,1008,-30
92829287766,92829287770,4,1950,1303,-30
92831046151,92831046156,5,2761,1675,-30
92831807189,92831807194,5,2046,1601,-30
92841531647,92841531650,3,1485,1858,-30
92850433151,92850433157,6,2654,1509,-30
92850663407,92850663387,-20,2689,1034,-30
92850876318,92850876323,5,1494,1371,-30
92854020286,92854020284,-2,1247,2269,-30
92856630643,92856630647,4,1721,1495,-30
92859607885,92859607891,6,2432,1161,-30
92861979973,92861979973,0,1529,2228,-30
92867418261,92867418267,6,2696,1268,-30
92869381077,92869381082,5,2436,1194,-30
92873062242,92873062247,5,2097,1214,-30
92874006735,92874006741,6,1916,1345,-30
92875348576,92875348579,3,1234,1247,-30
92876045490,92876045496,6,1854,951,-30
92876839049,92876839051,2,1543,969,-30
92879054307,92879054310,3,1555,1582,-30
92879572906,92879572914,8,2400,1327,-30
92879863433,92879863438,5,2551,1468,-30
92880108282,92880108287,5,1937,1222,-30
92880809222,92880809200,-22,1341,848,-30
92881619373,92881619377,4,2261,1297,-30
92887202037,92887202041,4,5036,33283,-30
92887596997,92887597001,4,1993,1474,-30
92889678446,92889678451,5,2654,1247,-30
92891247966,92891247973,7,2613,1451,-30
92891362337,92891362343,6,1229,965,-30
92891919399,92891919402,3,2259,1046,-30
92894731653,92894731656,3,1953,1344,-30
92895256536,92895256542,6,2320,1117,-30
92897419492,92897419497,5,1908,1402,-30
92898442921,92898442919,-2,1003,1445,-30
92899281558,92899281563,5,1781,861,-30
92900013791,92900013797,6,2191,1736,-30
92900887962,92900887948,-14,778,124,-30
92902979430,92902979433,3,1690,2046,-30
92903647011,92903647015,4,1793,1595,-30
92905952134,92905952139,5,3011,1285,-30
92909443706,92909443711,5,1547,1430,-30
92910079225,92910079231,6,2842,1277,-30
92912849717,92912849723,6,2499,1636,-30
92915360399,92915360405,6,716,493,-30
92915669319,92915669305,-14,472,319,-30
92921060770,92921060773,3,1206,785,-30
92923830394,92923830399,5,1507,1023,-30
92924054681,92924054685,4,2002,1563,-30
92932483715,92932483722,7,2152,1448,-30
92936291908,92936291913,5,3282,1957,-30
92940476617,92940476622,5,2109,1313,-30
92949891485,92949891491,6,2026,794,-30
92955847086,92955847092,6,2425,1407,-30
92956494721,92956494726,5,5155,2829,-30
92958131621,92958131624,3,1523,1557,-30
92960836634,92960836638,4,1503,1070,-30
92963112422,92963112428,6,2055,1111,-30
92966796238,92966796242,4,2004,1106,-30
92968818349,92968818354,5,2378,1582,-30
92969998833,92969998838,5,2003,1159,-30
92971191649,92971191641,-8,2634,9317,-30
92971399698,92971399700,2,2372,1452,-30
92973034878,92973034886,8,2035,1186,-30
92975546638,92975546642,4,2071,1210,-30
92976045059,92976045062,3,2557,1391,-30
92978192706,92978192714,8,2303,1402,-30
92981114386,92981114390,4,2255,1183,-30
92985806725,92985806727,2,3825,3403,-30
92989077008,92989077014,6,2034,1109,-30
92993010191,92993010196,5,2720,1626,-30
92996767730,92996767735,5,1670,1163,-30
92999518793,92999518795,2,1682,1960,-30
93000983429,93000983435,6,2128,1537,-30
93003095884,93003095887,3,1916,1431,-30
93003377289,93003377295,6,2007,1086,-30
93009683118,93009683125,7,2460,1099,-30
93010956233,93010956251,18,822,258,-30
93014098349,93014098361,12,3054,1153,-30
93014149994,93014149998,4,2270,1387,-30
93015484864,93015484870,6,3319,1884,-30
93017539161,93017539161,0,1676,1313,-30
93017932721,93017932739,18,1691,1223,-30
93019806506,93019806511,5,2127,1239,-30
93021064573,93021064568,-5,1192,3051,-30
93021669298,93021669303,5,2947,2371,-30
93022104001,93022104006,5,2772,1170,-30
93024361726,93024361730,4,1354,756,-30
93026938271,93026938269,-2,1038,2615,-30
93027228893,93027228889,-4,854,2232,-30
93028986086,93028986092,6,2894,1682,-30
93030782517,93030782514,-3,651,2005,-30
93031462603,93031462607,4,2464,1274,-30
93033598553,93033598558,5,2116,1422,-30
93034893005,93034893010,5,2258,1324,-30
93035758602,93035758605,3,2656,1158,-30
93036017534,93036017537,3,1581,1649,-30
93036694062,93036694065,3,1195,1266,-30
93037514470,93037514474,4,2032,1621,-30
93039054933,93039054937,4,1705,1166,-30
93041042441,93041042447,6,3043,1803,-30
93041297600,93041297600,0,1418,1883,-30
93042368981,93042368985,4,2773,1716,-30
93047466354,93047466358,4,2218,953,-30
93048270901,93048270905,4,2120,1515,-30
93048473133,93048473152,19,2866,1207,-30
93048684513,93048684523,10,1203,829,-30
93051850953,93051850957,4,2291,1259,-30
93051989298,93051989313,15,2744,1569,-30
93056803389,93056803394,5,2423,1262,-30
93057938455,93057938460,5,2070,999,-30
93061162952,93061162956,4,2381,1676,-30
93061382818,93061382821,3,2192,1477,-30
93062346277,93062346270,-7,756,2964,-30
93064398687,93064398690,3,2002,1252,-30
93067528201,93067528206,5,1724,1097,-30
93069447017,93069447023,6,1887,1014,-30
93072214515,93072214520,5,1990,1165,-30
93074971210,93074971217,7,1417,875,-30
93086062837,93086062843,6,2277,1417,-30
93091213022,93091213025,3,3084,2777,-30
93091241755,93091241760,5,2177,1769,-30
93091948713,93091948721,8,2404,1111,-30
93092298193,93092298198,5,2639,1257,-30
93098802677,93098802682,5,2581,1688,-30
93100829152,93100829157,5,3138,1349,-30
93101259604,93101259609,5,2735,1339,-30
93109371002,93109371008,6,1660,999,-30
93110882605,93110882610,5,2575,1780,-30
93110912708,93110912714,6,2025,1217,-30
93113157839,93113157844,5,2053,1058,-30
93114132666,93114132670,4,1557,1218,-30
93114187814,93114187795,-19,2489,1176,-30
93118575839,93118575846,7,1572,1119,-30
93122539990,93122539994,4,2039,1360,-30
93123040025,93123040029,4,2557,1430,-30
93124606530,93124606535,5,1404,1337,-30
93127497779,93127497786,7,2366,1509,-30
93132481184,93132481189,5,2652,1994,-30
93134587092,93134587097,5,2186,1218,-30
93136098395,93136098389,-6,942,4959,-30
93141059203,93141059210,7,2759,1236,-30
93148022652,93148022660,8,2118,1330,-30
93149057914,93149057917,3,6106,18746,-30
93150107389,93150107391,2,1289,1655,-30
93150318878,93150318882,4,3885,3049,-30
93150741047,93150741054,7,1924,1093,-30
93150914739,93150914745,6,2600,1486,-30
93151078225,93151078208,-17,1523,1131,-30
93152645397,93152645394,-3,976,3485,-30
93154821358,93154821365,7,2577,1543,-30
93156640750,93156640755,5,2695,1335,-30
93163254379,93163254385,6,3186,1995,-30
93166329145,93166329149,4,2629,1495,-30
93168731846,93168731853,7,2435,938,-30
93168814627,93168814632,5,2381,1248,-30
93174770723,93174770715,-8,1044,318,-30
93178731614,93178731617,3,1732,1294,-30
93182277370,93182277375,5,1742,952,-30
93189093769,93189093774,5,2179,1189,-30
93192521497,93192521503,6,3430,1814,-30
93195155529,93195155534,5,2815,1305,-30
93200178309,93200178312,3,2227,1089,-30
93209111820,93209111834,14,6542,51722,-30
93211138477,93211138484,7,1519,1072,-30
93211460586,93211460590,4,2040,1235,-30
93212165955,93212165970,15,2841,1622,-30
93215317024,93215317030,6,2950,1361,-30
93219144588,93219144594,6,2133,1429,-30
93221138967,93221138973,6,2720,1440,-30
93221441134,93221441138,4,1366,657,-30
93230807426,93230807430,4,2029,1178,-30
93232787375,93232787380,5,1958,1301,-30
93234340268,93234340273,5,2208,2124,-30
93237333089,93237333094,5,1195,1008,-30
93239319490,93239319494,4,2914,1846,-30
93241398653,93241398657,4,2659,1622,-30
93243110238,93243110235,-3,905,8,-30
93248631305,93248631310,5,2490,2287,-30
93250142440,93250142444,4,2076,1207,-30
93254521957,93254521962,5,2016,1172,-30
93257543162,93257543167,5,1586,1104,-30
93258822653,93258822650,-3,4067,8787,-30
93259570123,93259570127,4,1218,809,-30
93259886486,93259886494,8,1773,1106,-30
93260804630,93260804634,4,2336,1277,-30
93263166207,93263166210,3,2949,2631,-30
93270275089,93270275094,5,2108,1566,-30
93271285206,93271285212,6,2596,1463,-30
93274614402,93274614406,4,1788,926,-30
93279916574,93279916579,5,2138,1076,-30
93282683417,93282683421,4,2158,1363,-30
93285441545,93285441553,8,1765,1144,-30
93290199865,93290199865,0,2497,3590,-30
93292651349,93292651355,6,2857,1760,-30
93299136419,93299136423,4,2172,1432,-30
93301987053,93301987058,5,1775,1305,-30
93309258025,93309258029,4,2009,1676,-30
93312706441,93312706443,2,1957,1554,-30
93313068806,93313068809,3,2125,1454,-30
93315114160,93315114167,7,1912,1135,-30
93316906954,93316906958,4,2512,1410,-30
93319234537,93319234542,5,1247,590,-30
93320372210,93320372215,5,3567,1572,-30
93323805198,93323805202,4,1586,948,-30
93325335199,93325335198,-1,1289,1470,-30
93327525869,93327525874,5,1086,1301,-30
93335702632,93335702631,-1,952,1464,-30
93337503429,93337503425,-4,571,199,-30
93340004327,93340004333,6,1286,1109,-30
93340237383,93340237395,12,784,241,-30
93341663798,93341663803,5,1612,1338,-30
93346307040,93346307046,6,1919,1089,-30
93347891105,93347891111,6,2406,987,-30
93352760037,93352760043,6,1661,1267,-30
93353375158,93353375164,6,1071,1226,-30
93356098773,93356098778,5,2080,1283,-30
93364956822,93364956826,4,2220,1398,-30
93368574428,93368574432,4,1703,971,-30
93371117476,93371117481,5,2883,2122,-30
93374448198,93374448204,6,1513,956,-30
93374931169,93374931177,8,1773,1329,-30
93375581858,93375581862,4,1453,1045,-30
93376560375,93376560380,5,2682,1050,-30
93376587668,93376587675,7,2387,1366,-30
93377283093,93377283098,5,9254,3873,-30
93377566754,93377566761,7,1867,1250,-30
93381539250,93381539257,7,2315,1390,-30
93382707739,93382707745,6,2576,1319,-30
93383723879,93383723874,-5,833,2087,-30
93385200811,93385200814,3,1898,1324,-30
93386751254,93386751259,5,2640,1325,-30
93387444344,93387444350,6,2510,1136,-30
93388127740,93388127746,6,2515,1641,-30
93388748662,93388748666,4,2086,1399,-30
93388921546,93388921543,-3,1363,2752,-30
93389230994,93389231000,6,1751,1271,-30
93389534582,93389534586,4,1904,1211,-30
93390581454,93390581462,8,1630,596,-30
93394772603,93394772607,4,1715,1187,-30
93395415029,93395415009,-20,719,325,-30
93400981739,93400981745,6,2655,1573,-30
93405309448,93405309453,5,2645,1227,-30
93405728597,93405728608,11,1009,101,-30
93407098727,93407098731,4,2045,1343,-30
93407254492,93407254495,3,2442,1708,-30
93408041197,93408041202,5,1870,1155,-30
93409183441,93409183446,5,1613,1109,-30
93410482971,93410482975,4,2284,1397,-30
93416487178,93416487185,7,3091,1236,-30
93417321594,93417321602,8,2519,1503,-30
93424405889,93424405882,-7,839,4277,-30
93425523013,93425523018,5,2269,1640,-30
93427465275,93427465255,-20,894,217,-30
93432861975,93432861980,5,2207,1304,-30
93438095390,93438095389,-1,48,1097,-30
93439329279,93439329285,6,2532,1248,-30
93442741290,93442741294,4,2314,1125,-30
93444444182,93444444187,5,3425,1094,-30
93445581547,93445581554,7,2260,1437,-30
93445686737,93445686744,7,1229,783,-30
93445779525,93445779507,-18,2506,1287,-30
93448807662,93448807666,4,1591,803,-30
93449517328,93449517333,5,1597,1413,-30
93449848970,93449848975,5,2504,1725,-30
93450603340,93450603345,5,1992,1177,-30
93453405601,93453405606,5,4899,3264,-30
93454281819,93454281826,7,2167,1233,-30
93455365402,93455365406,4,2841,1827,-30
93455737964,93455737954,-10,594,136,-30
93460512322,93460512326,4,1975,1177,-30
93460681357,93460681361,4,2532,1294,-30
93471228986,93471228991,5,2119,836,-30
93471469454,93471469441,-13,786,295,-30
93480138666,93480138671,5,2415,1171,-30
93481383670,93481383674,4,2731,1318,-30
93482340558,93482340563,5,3051,1293,-30
93484167773,93484167778,5,1964,1285,-30
93486829058,93486829063,5,2457,1553,-30
93488209606,93488209609,3,2568,1427,-30
93488825989,93488825993,4,1837,1164,-30
93489434378,93489434383,5,2285,1538,-30
93490536253,93490536258,5,2159,1612,-30
93494305682,93494305688,6,2252,1240,-30
93500020751,93500020758,7,4558,1394,-30
93503687514,93503687519,5,2300,1547,-30
93504891489,93504891495,6,1708,1027,-30
93506419402,93506419406,4,1256,1301,-30
93507965898,93507965903,5,2565,1496,-30
93511998201,93511998205,4,1526,876,-30
93513120434,93513120439,5,2332,1466,-30
93513672804,93513672809,5,2270,1610,-30
93517484438,93517484445,7,1821,1415,-30
93519862882,93519862887,5,1915,1073,-30
93520120344,93520120328,-16,799,223,-30
93522662746,93522662754,8,3060,1248,-30
93530507765,93530507775,10,11321,32416,-30
93531224641,93531224645,4,1683,1060,-30
93531324485,93531324490,5,2427,1140,-30
93533089374,93533089378,4,1939,1184,-30
93536411283,93536411286,3,2397,1755,-30
93537757438,93537757443,5,2061,1188,-30
93538528327,93538528308,-19,2409,1198,-30
93539062033,93539062036,3,1270,1260,-30
93540811252,93540811259,7,2382,1446,-30
93543507440,93543507445,5,2445,1286,-30
93544575823,93544575829,6,3534,1499,-30
93545285207,93545285212,5,2181,1194,-30
93548113937,93548113942,5,1573,1552,-30
93549123921,93549123926,5,1967,1365,-30
93549236030,93549236033,3,1814,1419,-30
93552334167,93552334172,5,3405,2164,-30
93552467951,93552467955,4,3394,1447,-30
93553056562,93553056566,4,2814,1494,-30
93554024454,93554024459,5,3058,1388,-30
93556394903,93556394908,5,1812,1379,-30
93557487914,93557487917,3,3634,2030,-30
93559915579,93559915582,3,2207,1565,-30
93561516227,93561516231,4,2021,968,-30
93562827214,93562827222,8,2334,1114,-30
93564090048,93564090049,1,3274,3774,-30
93567547085,93567547091,6,3084,1043,-30
93569045701,93569045707,6,3694,1395,-30
93573113122,93573113127,5,2406,1324,-30
93573632897,93573632901,4,1777,1147,-30
93586629646,93586629652,6,2562,909,-30
93593390921,93593390927,6,1835,1056,-30
93593432534,93593432515,-19,836,235,-30
93593892045,93593892049,4,2280,1482,-30
93594215654,93594215661,7,2627,1566,-30
93596682839,93596682845,6,2794,1387,-30
93601720109,93601720114,5,2081,1343,-30
93602020029,93602020038,9,4357,2144,-30
93604144638,93604144637,-1,1275,2494,-30
93607152429,93607152433,4,2779,1316,-30
93607367534,93607367545,11,746,124,-30
93611423384,93611423389,5,2206,1457,-30
93612617055,93612617055,0,1810,1997,-30
93613102182,93613102187,5,2156,1198,-30
93614739393,93614739393,0,602,1434,-30
93616859041,93616859047,6,2744,1550,-30
93619789645,93619789650,5,1895,1205,-30
93620720579,93620720582,3,2012,1130,-30
93623794265,93623794270,5,2100,1067,-30
93624384334,93624384352,18,1611,1255,-30
93624727300,93624727303,3,3367,2118,-30
93627337643,93627337649,6,2132,1494,-30
93627836207,93627836202,-5,813,225,-30
93628865225,93628865229,4,2316,1340,-30
93632333491,93632333496,5,1717,1783,-30
93632525138,93632525144,6,2772,1690,-30
93633952065,93633952069,4,2238,923,-30
93634547256,93634547242,-14,1810,1104,-30
93634612371,93634612378,7,2852,1306,-30
93636088858,93636088863,5,1779,1172,-30
93636131799,93636131804,5,2550,1510,-30
93640769389,93640769395,6,2077,1062,-30
93641560978,93641560983,5,1388,549,-30
93644426275,93644426279,4,2566,1224,-30
93647786173,93647786178,5,2249,1058,-30
93650959411,93650959414,3,680,1269,-30
93651319298,93651319302,4,2350,1122,-30
93652903197,93652903203,6,2519,989,-30
93653324995,93653324998,3,2494,1235,-30
93653665779,93653665784,5,2975,1492,-30
93656213577,93656213582,5,1155,1210,-30
93656855029,93656855033,4,1959,1423,-30
93657119568,93657119574,6,2180,1285,-30
93660336778,93660336783,5,2522,1160,-30
93661690722,93661690725,3,3314,1551,-30
93665092251,93665092233,-18,1851,823,-30
93667125073,93667125078,5,1780,975,-30
93667567087,93667567091,4,2161,928,-30
93669019295,93669019298,3,1905,1216,-30
93669394242,93669394247,5,2498,1424,-30
93671761891,93671761895,4,1849,1081,-30
93672659729,93672659733,4,1712,1719,-30
93675561063,93675561068,5,2206,1748,-30
93677227886,93677227891,5,2434,1741,-30
93683764973,93683764978,5,2344,1356,-30
93684691925,93684691933,8,2330,949,-30
93685929005,93685929010,5,1852,1307,-30
93696736881,93696736885,4,1173,1194,-30
93702124029,93702124033,4,2391,1454,-30
93702555130,93702555136,6,3564,1477,-30
93703135980,93703135985,5,3583,1589,-30
93704157482,93704157487,5,1646,928,-30
93704981669,93704981674,5,2312,1498,-30
93707776610,93707776615,5,2000,1044,-30
93714201153,93714201157,4,2653,1764,-30
93714588763,93714588779,16,2425,976,-30
93717534685,93717534690,5,2339,950,-30
93717731773,93717731753,-20,2402,1626,-30
93723000962,93723000969,7,2561,1691,-30
93724809832,93724809839,7,2373,1205,-30
93724852113,93724852097,-16,2498,1394,-30
93725131419,93725131404,-15,1040,322,-30
93727217125,93727217129,4,1878,1110,-30
93727608437,93727608442,5,2221,1420,-30
93727679178,93727679183,5,1725,1270,-30
93732595535,93732595539,4,2572,1684,-30
93733232105,93733232110,5,2517,1730,-30
93734926513,93734926492,-21,1845,1242,-30
93740625151,93740625157,6,1791,1490,-30
93741506183,93741506187,4,1828,1235,-30
93747354234,93747354239,5,1983,953,-30
93748516662,93748516667,5,932,898,-30
93749360973,93749360973,0,1574,2385,-30
93751538793,93751538799,6,932,463,-30
93753681478,93753681482,4,1810,1336,-30
93756272797,93756272801,4,1550,1251,-30
93757454941,93757454947,6,2583,1833,-30
93765089409,93765089413,4,1977,1094,-30
93767234145,93767234150,5,2607,1451,-30
93767570398,93767570402,4,1776,1218,-30
93767782252,93767782257,5,2585,1642,-30
93789845142,93789845148,6,2385,1353,-30
93790647125,93790647130,5,1894,876,-30
93791602981,93791602986,5,2887,1328,-30
93792230054,93792230059,5,3364,1721,-30
93793912373,93793912367,-6,2534,6898,-30
93796158437,93796158442,5,1942,1485,-30
93796376933,93796376916,-17,1810,910,-30
93796942646,93796942624,-22,1848,961,-30
93799171480,93799171485,5,2126,1315,-30
93800055898,93800055904,6,2861,1717,-30
93800636735,93800636742,7,2254,1241,-30
93801322235,93801322230,-5,3821,13697,-30
93808865945,93808865951,6,2302,1121,-30
93810396906,93810396911,5,2842,1402,-30
93810985539,93810985545,6,2819,1515,-30
93812494542,93812494547,5,1775,679,-30
93815586904,93815586910,6,2088,1153,-30
93823515830,93823515834,4,1347,1328,-30
93824464054,93824464061,7,2455,1126,-30
93827089610,93827089614,4,1452,1200,-30
93827532603,93827532606,3,1947,1176,-30
93829986984,93829986986,2,2025,1640,-30
93830823698,93830823704,6,1684,977,-30
93833209511,93833209518,7,2383,1234,-30
93838834248,93838834252,4,2118,1575,-30
93841254434,93841254442,8,2201,1059,-30
93845461772,93845461774,2,7703,7715,-30
93847084646,93847084651,5,2389,1429,-30
93849104901,93849104903,2,2283,1560,-30
93849787873,93849787878,5,1861,1068,-30
93854304571,93854304577,6,2400,1672,-30
93858116831,93858116836,5,2486,1112,-30
93858705041,93858705045,4,1557,1214,-30
93859776918,93859776915,-3,1109,1650,-30
93863157664,93863157670,6,1975,853,-30
93870287956,93870287960,4,1773,950,-30
93871665940,93871665955,15,1830,1505,-30
93872232686,93872232667,-19,1548,800,-30
93873954402,93873954408,6,3135,2104,-30
93874571486,93874571485,-1,1656,1939,-30
93877616690,93877616691,1,1815,1757,-30
93878550150,93878550157,7,2404,940,-30
93886047030,93886047036,6,1881,1674,-30
93891794239,93891794243,4,1782,1348,-30
93895383360,93895383357,-3,947,2348,-30
93896607851,93896607858,7,2421,1287,-30
93899516493,93899516500,7,2143,995,-30
93899879630,93899879635,5,2514,1030,-30
93903414535,93903414539,4,1883,2000,-30
93904820602,93904820608,6,2949,1531,-30
93905883871,93905883877,6,1665,1335,-30
93906138052,93906138059,7,2558,928,-30
93913034403,93913034406,3,1753,975,-30
93914116826,93914116822,-4,1929,5313,-30
93914748846,93914748850,4,2108,1181,-30
93914908606,93914908616,10,1168,902,-30
93918792456,93918792462,6,2786,1223,-30
93920309510,93920309514,4,958,807,-30
93920775090,93920775090,0,1137,1317,-30
93922859412,93922859414,2,2079,1111,-30
93924765446,93924765449,3,2205,1062,-30
93925552997,93925553003,6,2180,1462,-30
93925973701,93925973705,4,2880,1507,-30
93929117189,93929117195,6,1987,1595,-30
93929653737,93929653742,5,1963,1469,-30
93931689933,93931689939,6,2774,1394,-30
93935820317,93935820321,4,1633,987,-30
93940403281,93940403285,4,2684,1422,-30
93940983327,93940983334,7,1585,1134,-30
93941437046,93941437051,5,2300,1296,-30
93941573245,93941573250,5,2154,1150,-30
93943313988,93943313993,5,1726,1428,-30
93945138125,93945138129,4,2946,1626,-30
93945219878,93945219883,5,1918,1745,-30
93947120798,93947120803,5,2477,1390,-30
93948999197,93948999202,5,1220,761,-30
93949802062,93949802075,13,997,222,-30
93950942453,93950942457,4,2275,1461,-30
93952011187,93952011193,6,2966,1645,-30
93956966482,93956966479,-3,1625,3444,-30
93958769634,93958769641,7,2483,1334,-30
93959387496,93959387499,3,2795,2236,-30
93959870634,93959870638,4,1340,961,-30
93970384013,93970384007,-6,231,1271,-30
93973754889,93973754894,5,2360,1637,-30
93973820356,93973820336,-20,1965,731,-30
93974123355,93974123354,-1,1084,2828,-30
93974575318,93974575322,4,1703,1003,-30
93976211174,93976211180,6,3217,1670,-30
93976751977,93976751982,5,2927,1534,-30
93977233273,93977233278,5,2449,1091,-30
93977389363,93977389346,-17,874,679,-30
93980834402,93980834399,-3,1063,1928,-30
93981720572,93981720578,6,2557,1446,-30
93983170468,93983170472,4,2709,1552,-30
93991926345,93991926350,5,2127,1261,-30
93995246825,93995246826,1,2509,1203,-30
93995391390,93995391398,8,2403,1236,-30
93996359797,93996359790,-7,578,2747,-30
93998410758,93998410764,6,1955,1516,-30
93998507381,93998507361,-20,1145,664,-30
93999135997,93999136003,6,2733,1151,-30
94000526346,94000526350,4,3041,1755,-30
94001910909,94001910914,5,3415,1469,-30
94002750199,94002750196,-3,1316,2288,-30
94006585124,94006585129,5,2723,1345,-30
94008878910,94008878916,6,1463,910,-30
94009376280,94009376282,2,2832,1568,-30
94009544265,94009544269,4,2515,1515,-30
94014175202,94014175207,5,2194,1554,-30
94015560031,94015560034,3,1698,1243,-30
94016412054,94016412059,5,2406,1422,-30
94017175725,94017175730,5,1279,816,-30
94019689242,94019689245,3,1390,908,-30
94020811209,94020811213,4,1915,1480,-30
94022978931,94022978935,4,2696,1152,-30
94025250159,94025250160,1,2411,2373,-30
94027631610,94027631611,1,3300,3496,-30
94027821498,94027821501,3,14176,10757,-30
94028446677,94028446681,4,55128,33534,-30
94029143585,94029143587,2,2113,1081,-30
94031933520,94031933526,6,2339,1349,-30
94034313286,94034313290,4,2895,1323,-30
94035728514,94035728517,3,1346,1381,-30
94037071402,94037071405,3,1688,1670,-30
94043578666,94043578671,5,2767,1478,-30
94044365981,94044365986,5,1849,1004,-30
94046125373,94046125379,6,1302,1103,-30
94049923187,94049923192,5,2088,1447,-30
94050830166,94050830168,2,2858,2065,-30
94052298085,94052298090,5,2489,1493,-30
94054663089,94054663091,2,2129,1020,-30
94054904226,94054904230,4,2380,1137,-30
94056337940,94056337941,1,1330,1806,-30
94056364891,94056364894,3,1904,786,-30
94059189339,94059189339,0,1457,1766,-30
94062233579,94062233574,-5,803,3481,-30
94063934469,94063934474,5,2262,1072,-30
94066917122,94066917124,2,1567,850,-30
94067114474,94067114478,4,1743,1098,-30
94068206603,94068206609,6,3092,1674,-30
94068252934,94068252939,5,1678,840,-30
94070562931,94070562934,3,1132,1024,-30
94071817659,94071817665,6,2452,1222,-30
94071905273,94071905276,3,2206,1007,-30
94076944757,94076944761,4,1704,1010,-30
94078922066,94078922072,6,2412,1302,-30
94080707200,94080707205,5,3179,1816,-30
94082141291,94082141274,-17,2310,1261,-30
94085247893,94085247898,5,1748,1035,-30
94086116118,94086116123,5,1925,1094,-30
94086215362,94086215368,6,1893,1242,-30
94086471089,94086471093,4,1587,1090,-30
94087528924,94087528928,4,2010,1698,-30
94088757857,94088757863,6,2071,1148,-30
94089824945,94089824928,-17,859,752,-30
94090136706,94090136706,0,1434,1826,-30
94090551693,94090551699,6,1721,989,-30
94092821388,94092821392,4,2059,1796,-30
94093185511,94093185515,4,1740,1460,-30
94098596207,94098596210,3,2010,2079,-30
94098850240,94098850245,5,2499,1715,-30
94100113503,94100113507,4,1919,1183,-30
94100598119,94100598138,19,2808,857,-30
94100721815,94100721808,-7,819,352,-30
94101444118,94101444121,3,2119,1015,-30
94104808353,94104808358,5,1987,1231,-30
94104878042,94104878028,-14,1223,812,-30
94106177249,94106177254,5,2756,1906,-30
94107310789,94107310793,4,1790,1014,-30
94110012711,94110012715,4,1246,1531,-30
94113600047,94113600052,5,2267,984,-30
94116346076,94116346079,3,2242,1540,-30
94119620277,94119620278,1,1678,1905,-30
94123302983,94123302989,6,2360,1152,-30
94123442233,94123442238,5,2539,942,-30
94124452795,94124452799,4,2112,954,-30
94129059208,94129059212,4,1933,1324,-30
94131272358,94131272366,8,1036,915,-30
94141500101,94141500105,4,2047,1323,-30
94148068641,94148068646,5,1936,1181,-30
94148193240,94148193226,-14,817,330,-30
94149881449,94149881453,4,2135,1691,-30
94150562002,94150562007,5,1793,1505,-30
94153374353,94153374357,4,2047,1362,-30
94162968801,94162968806,5,2296,1342,-30
94166247634,94166247639,5,2647,1524,-30
94166621785,94166621770,-15,1081,367,-30
94167044803,94167044809,6,2715,1431,-30
94167306478,94167306483,5,2063,1189,-30
94168688088,94168688095,7,2307,1391,-30
94169166241,94169166246,5,2877,1362,-30
94169492039,94169492043,4,2219,1338,-30
94170243017,94170243022,5,3305,1393,-30
94173861742,94173861748,6,2382,1453,-30
94178435102,94178435105,3,2075,1005,-30
94179227073,94179227078,5,1170,667,-30
94179962182,94179962188,6,844,1041,-30
94180660757,94180660763,6,2920,1290,-30
94181289175,94181289156,-19,3382,3394,-30
94181710237,94181710242,5,1496,881,-30
94182094370,94182094378,8,2581,946,-30
94185618118,94185618125,7,1957,1620,-30
94188035834,94188035841,7,2107,1281,-30
94189984097,94189984103,6,2890,2126,-30
94190773903,94190773909,6,2063,684,-30
94191660157,94191660161,4,2413,1302,-30
94193471777,94193471782,5,1821,1239,-30
94206355505,94206355509,4,1830,1121,-30
94207972690,94207972695,5,1409,1450,-30
94211053939,94211053937,-2,2271,4844,-30
94211598211,94211598217,6,2713,1649,-30
94216408850,94216408845,-5,886,4665,-30
94216920518,94216920521,3,2130,1100,-30
94219067719,94219067723,4,2932,1746,-30
94222365818,94222365819,1,1787,1577,-30
94222470514,94222470519,5,2036,1195,-30
94224746647,94224746650,3,999,999,-30
94226978426,94226978429,3,1571,958,-30
94228947433,94228947437,4,1806,1338,-30
94229265063,94229265068,5,2166,1331,-30
94230556020,94230556028,8,16263,17966,-30
94232533695,94232533699,4,2692,1390,-30
94233911790,94233911794,4,1717,972,-30
94236551438,94236551442,4,1100,1081,-30
94237529462,94237529467,5,2673,1176,-30
94242008968,94242008973,5,2100,1634,-30
94245569886,94245569890,4,2394,2046,-30
94247024198,94247024202,4,2755,1675,-30
94252882220,94252882225,5,2256,908,-30
94254593063,94254593069,6,2011,1263,-30
94255170698,94255170703,5,3233,1955,-30
94255450815,94255450804,-11,1010,365,-30
94258584699,94258584694,-5,960,2425,-30
94260771414,94260771417,3,2777,1786,-30
94261168095,94261168100,5,2219,1698,-30
94263755954,94263755961,7,2095,734,-30
94264965810,94264965813,3,1422,943,-30
94265856054,94265856057,3,1667,1199,-30
94266679660,94266679664,4,2553,1625,-30
94268109878,94268109883,5,2094,1831,-30
94269054014,94269054018,4,2083,1483,-30
94269808454,94269808459,5,1935,806,-30
94269878641,94269878642,1,1747,1644,-30
94272884051,94272884054,3,1446,956,-30
94274822649,94274822656,7,73,4538,-30
94276481542,94276481522,-20,2176,1158,-30
94282282676,94282282681,5,1734,1346,-30
94282382158,94282382162,4,2913,1466,-30
94282820004,94282820010,6,1640,1221,-30
94288677065,94288677071,6,2898,1458,-30
94295172787,94295172791,4,3298,1559,-30
94296663944,94296663948,4,1527,1544,-30
94296997174,94296997178,4,1412,1039,-30
94297028642,94297028646,4,1891,1326,-30
94297411611,94297411618,7,2315,1126,-30
94298815781,94298815785,4,1875,1925,-30
94302594442,94302594447,5,1659,923,-30
94307901231,94307901236,5,3077,1773,-30
94308658741,94308658728,-13,30570,17319,-30
94310045182,94310045188,6,1455,1258,-30
94310084014,94310083994,-20,543,563,-30
94310207170,94310207175,5,2119,1379,-30
94311595770,94311595776,6,2172,1547,-30
94311892360,94311892363,3,1474,1049,-30
94312076898,94312076900,2,2346,1540,-30
94312757667,94312757674,7,2448,1404,-30
94315367736,94315367739,3,1660,1604,-30
94315760225,94315760231,6,2341,780,-30
94317808193,94317808198,5,2259,1444,-30
94318963278,94318963276,-2,34038,49035,-30
94322423105,94322423109,4,1731,1126,-30
94324828716,94324828721,5,2880,1103,-30
94328046930,94328046936,6,2321,1734,-30
94328252106,94328252111,5,2293,1311,-30
94328528617,94328528622,5,2115,1238,-30
94331531613,94331531618,5,2097,1253,-30
94332277828,94332277833,5,2169,1825,-30
94333204312,94333204316,4,1963,1435,-30
94336412556,94336412560,4,2747,1311,-30
94338613095,94338613101,6,1858,1064,-30
94340822937,94340822941,4,2630,1483,-30
94340946764,94340946767,3,2741,1441,-30
94341077055,94341077060,5,2230,1025,-30
94342114975,94342114980,5,2580,1528,-30
94349302397,94349302403,6,2490,1107,-30
94350193326,94350193330,4,1834,1395,-30
94350623112,94350623117,5,1782,992,-30
94350659161,94350659165,4,1852,1445,-30
94350927595,94350927600,5,2321,1713,-30
94351234706,94351234710,4,1592,1094,-30
94359242582,94359242586,4,3367,2353,-30
94365186875,94365186878,3,2565,1323,-30
94365843582,94365843587,5,2767,1821,-30
94366621466,94366621471,5,1960,844,-30
94368610554,94368610557,3,1837,1009,-30
94371414515,94371414522,7,2013,1174,-30
94374073819,94374073825,6,1243,622,-30
94375272898,94375272904,6,1836,1086,-30
94376561819,94376561827,8,1944,1221,-30
94376699078,94376699083,5,1876,959,-30
94378857493,94378857495,2,1673,1638,-30
94379644588,94379644594,6,1916,1068,-30
94380938546,94380938550,4,1614,1224,-30
94381909364,94381909362,-2,1229,2571,-30
94383388384,94383388377,-7,4009,9806,-30
94384723521,94384723525,4,1819,1272,-30
94385897362,94385897367,5,2175,1435,-30
94390945062,94390945065,3,2238,1344,-30
94394301566,94394301570,4,1937,1186,-30
94398166144,94398166151,7,2372,1018,-30
94402498190,94402498196,6,2343,1589,-30
94404383866,94404383870,4,2193,1598,-30
94404485268,94404485273,5,2204,1163,-30
94407722882,94407722886,4,3832,1383,-30
94410529955,94410529958,3,1307,1168,-30
94414404235,94414404241,6,1138,668,-30
94420250919,94420250914,-5,813,2069,-30
94420879532,94420879535,3,1975,843,-30
94422209585,94422209590,5,1440,882,-30
94424295033,94424295036,3,1231,1515,-30
94425078347,94425078351,4,2109,1286,-30
94436956231,94436956235,4,1489,1448,-30
94437582524,94437582529,5,1944,1035,-30
94440483758,94440483763,5,3142,1699,-30
94445826411,94445826413,2,3732,2244,-30
94448317473,94448317477,4,2933,2002,-30
94448787011,94448787013,2,1181,1008,-30
94454092039,94454092042,3,1299,765,-30
94454697345,94454697338,-7,696,2453,-30
94456449751,94456449758,7,2327,1387,-30
94459683433,94459683433,0,2158,2692,-30
94460945761,94460945766,5,1978,1389,-30
94468325682,94468325684,2,1254,1156,-30
94469516642,94469516646,4,2746,1567,-30
94470038309,94470038313,4,1932,1376,-30
94474121432,94474121439,7,2595,1379,-30
94476934549,94476934553,4,2821,1380,-30
94479976670,94479976675,5,2535,1692,-30
94480831416,94480831422,6,2194,1125,-30
94483228138,94483228143,5,2052,1603,-30
94483859858,94483859861,3,1383,939,-30
94486317174,94486317180,6,1843,1252,-30
94487420322,94487420326,4,1637,1161,-30
94488809661,94488809662,1,34283,51146,-30
94494625370,94494625375,5,2082,1247,-30
94499315938,94499315943,5,1004,996,-30
94499880734,94499880738,4,2017,1525,-30
94500905257,94500905263,6,1571,901,-30
94508017263,94508017267,4,2712,1269,-30
94509615462,94509615458,-4,1292,3426,-30
94510146873,94510146879,6,1800,1278,-30
94510545392,94510545398,6,3005,1606,-30
94512504460,94512504464,4,1999,1125,-30
94513202763,94513202769,6,2401,1235,-30
94516330886,94516330890,4,2270,1234,-30
94516520882,94516520887,5,1789,1188,-30
94516661639,94516661643,4,1330,1090,-30
94519356415,94519356421,6,1762,1135,-30
94523307453,94523307460,7,1511,1228,-30
94525751510,94525751515,5,2549,1365,-30
94527036873,94527036875,2,2397,2140,-30
94527796784,94527796789,5,2588,1108,-30
94538536535,94538536540,5,2127,1370,-30
94541544499,94541544499,0,1173,1320,-30
94548091391,94548091397,6,2236,1555,-30
94552611254,94552611258,4,2123,1347,-30
94553597916,94553597921,5,3516,1518,-30
94553989169,94553989165,-4,1443,3974,-30
94556034373,94556034378,5,1607,1155,-30
94559475298,94559475303,5,2380,1848,-30
94563224202,94563224203,1,1372,3771,-30
94563512203,94563512210,7,1440,1033,-30
94568047911,94568047918,7,3413,1151,-30
94568391106,94568391090,-16,950,339,-30
94569110717,94569110722,5,2305,1854,-30
94571296419,94571296426,7,2750,1539,-30
94571498051,94571498058,7,2469,1529,-30
94571870937,94571870940,3,1893,1321,-30
94573493698,94573493702,4,3180,951,-30
94574890680,94574890683,3,2505,1504,-30
94575023728,94575023726,-2,1236,3291,-30
94575825865,94575825869,4,3044,1342,-30
94576457559,94576457564,5,2442,1863,-30
94579702169,94579702174,5,1547,729,-30
94584188215,94584188221,6,2304,1665,-30
94584737837,94584737841,4,2815,1293,-30
94585585545,94585585555,10,276,923,-30
94589237017,94589237020,3,1768,1007,-30
94594327965,94594327969,4,2101,887,-30
94597924219,94597924224,5,1745,1426,-30
94599966546,94599966549,3,2276,1291,-30
94600191466,94600191450,-16,2011,1237,-30
94602320696,94602320701,5,1816,1244,-30
94602541634,94602541633,-1,1439,2552,-30
94602857894,94602857899,5,2766,1722,-30
94604484338,94604484344,6,1988,996,-30
94611408493,94611408495,2,1948,1544,-30
94612338581,94612338586,5,1622,1047,-30
94612736522,94612736527,5,2143,1196,-30
94614242685,94614242690,5,2364,935,-30
94618051126,94618051130,4,2073,1575,-30
94620379651,94620379658,7,1006,635,-30
94621020501,94621020484,-17,2543,1112,-30
94622975894,94622975899,5,2131,1100,-30
94625451625,94625451630,5,2331,1085,-30
94629300912,94629300918,6,2716,1606,-30
94631960115,94631960121,6,1386,985,-30
94632533406,94632533407,1,1497,1353,-30
94632687526,94632687530,4,1208,1129,-30
94632926270,94632926280,10,1045,272,-30
94634560420,94634560425,5,2871,1665,-30
94635689345,94635689347,2,1286,1132,-30
94637588948,94637588953,5,2529,1522,-30
94639036827,94639036832,5,2726,1550,-30
94639522494,94639522473,-21,2579,1699,-30
94640275014,94640275022,8,3670,1396,-30
94644894406,94644894415,9,2090,1491,-30
94653262363,94653262367,4,1874,1531,-30
94653609658,94653609665,7,3100,1527,-30
94657226768,94657226766,-2,21735,44838,-30
94659923254,94659923257,3,1723,1318,-30
94662938694,94662938699,5,1302,1079,-30
94664859957,94664859956,-1,2726,3398,-30
94666880551,94666880554,3,1768,1354,-30
94667263718,94667263725,7,2258,1292,-30
94668179861,94668179873,12,2373,1087,-30
94671503265,94671503278,13,15872,31856,-30
94674300857,94674300859,2,1529,781,-30
94678171103,94678171107,4,1528,1182,-30
94678349878,94678349881,3,1670,1047,-30
94678633300,94678633305,5,1862,1517,-30
94679179901,94679179903,2,2098,1846,-30
94680202045,94680202050,5,2056,1618,-30
94681829940,94681829946,6,2303,1645,-30
94684250301,94684250297,-4,1196,4955,-30
94686078551,94686078557,6,2884,1550,-30
94687240108,94687240113,5,1967,1537,-30
94687969801,94687969803,2,2475,1776,-30
94689396186,94689396190,4,3540,1475,-30
94689631486,94689631491,5,2595,1547,-30
94690599277,94690599281,4,1992,1299,-30
94690890189,94690890195,6,2465,1198,-30
94693050142,94693050143,1,1313,1222,-30
94693512777,94693512783,6,2055,1177,-30
94693693638,94693693618,-20,1881,1339,-30
94696342124,94696342129,5,1993,1137,-30
94697249002,94697249007,5,2279,1203,-30
94697598418,94697598422,4,2888,1421,-30
94697705834,94697705818,-16,1131,991,-30
94698016103,94698016082,-21,2362,1109,-30
94698289631,94698289631,0,1135,1743,-30
94700591090,94700591098,8,1583,609,-30
94701565913,94701565917,4,2094,1357,-30
94701769513,94701769519,6,2297,1656,-30
94703141320,94703141325,5,2314,1504,-30
94705325134,94705325133,-1,1549,1384,-30
94706842967,94706842972,5,2375,1528,-30
94708790486,94708790491,5,2238,1395,-30
94710201410,94710201416,6,2606,1253,-30
94710439422,94710439427,5,2841,1261,-30
94710788002,94710788018,16,16758,24474,-30
94716486841,94716486845,4,2576,1601,-30
94718414013,94718414017,4,2227,1113,-30
94719956638,94719956642,4,2119,1479,-30
94721234906,94721234911,5,880,1077,-30
94723774927,94723774934,7,5112,2078,-30
94726310029,94726310034,5,3019,1557,-30
94733365814,94733365819,5,1906,1379,-30
94736378777,94736378781,4,2275,1529,-30
94740862066,94740862053,-13,654,235,-30
94745698444,94745698449,5,2018,1025,-30
94746369491,94746369494,3,1957,1188,-30
94748558268,94748558274,6,2315,959,-30
94748602088,94748602075,-13,1153,946,-30
94751141384,94751141387,3,2378,1537,-30
94751938186,94751938190,4,2375,1457,-30
94755763919,94755763924,5,1806,1071,-30
94758262457,94758262462,5,2256,969,-30
94758873066,94758873070,4,1084,1025,-30
94762766309,94762766303,-6,3614,11780,-30
94766968375,94766968379,4,1709,1388,-30
94770018903,94770018907,4,2727,1764,-30
94772425546,94772425551,5,2208,1350,-30
94775460429,94775460434,5,1851,1332,-30
94775964269,94775964267,-2,936,201,-30
94777829922,94777829926,4,2389,1128,-30
94778255869,94778255852,-17,1854,901,-30
94781844572,94781844576,4,1903,1244,-30
94783352749,94783352748,-1,704,1452,-30
94784059194,94784059199,5,1754,1362,-30
94784306555,94784306562,7,2350,1230,-30
94786104150,94786104153,3,1217,1315,-30
94795873969,94795873973,4,2434,1489,-30
94800765799,94800765803,4,1797,1138,-30
94802979086,94802979094,8,3911,1528,-30
94808754509,94808754514,5,2209,1596,-30
94811151404,94811151410,6,1712,839,-30
94811407843,94811407849,6,2523,1248,-30
94811536709,94811536713,4,4025,1945,-30
94812192206,94812192211,5,2175,1165,-30
94812589934,94812589913,-21,1417,666,-30
94813877322,94813877326,4,2282,1080,-30
94814627449,94814627455,6,2502,1588,-30
94815652425,94815652431,6,2624,1546,-30
94819866558,94819866566,8,2113,1125,-30
94823765569,94823765574,5,1920,1010,-30
94831143298,94831143285,-13,62,1085,-30
94832280593,94832280599,6,2337,1409,-30
94835723533,94835723539,6,2744,1437,-30
94835979057,94835979065,8,2277,1127,-30
94839924995,94839925001,6,2454,1423,-30
94840929027,94840929034,7,2004,1112,-30
94841982968,94841982973,5,3233,1567,-30
94842532050,94842532049,-1,1370,1971,-30
94844111550,94844111553,3,2002,1563,-30
94844819701,94844819701,0,906,1637,-30
94845795768,94845795775,7,2127,1184,-30
94849714338,94849714331,-7,983,4896,-30
94854104323,94854104322,-1,349,478,-30
94854962059,94854962062,3,2005,986,-30
94855750988,94855750993,5,2556,1606,-30
94856266980,94856266975,-5,1053,3675,-30
94857364617,94857364624,7,2590,1564,-30
94858383607,94858383605,-2,1002,1884,-30
94859076859,94859076865,6,2651,876,-30
94862766632,94862766637,5,3216,1573,-30
94863517410,94863517406,-4,1327,2514,-30
94865180439,94865180442,3,2119,1080,-30
94871853633,94871853639,6,1855,1425,-30
94872951814,94872951818,4,1771,572,-30
94873402790,94873402795,5,2440,1589,-30
94879003722,94879003727,5,1490,1296,-30
94881264547,94881264544,-3,2098,6575,-30
94882263693,94882263697,4,2533,1330,-30
94882487212,94882487216,4,2498,1249,-30
94885229741,94885229744,3,2858,1449,-30
94886973313,94886973334,21,840,674,-30
94888218374,94888218379,5,2946,1410,-30
94889415490,94889415494,4,2593,1224,-30
94894710892,94894710897,5,1744,987,-30
94896401074,94896401073,-1,1389,1664,-30
94897313211,94897313218,7,2263,1399,-30
94898264977,94898264983,6,2090,1451,-30
94902674562,94902674567,5,1930,979,-30
94903318649,94903318655,6,1902,1206,-30
94908233249,94908233253,4,1921,1139,-30
94909403633,94909403637,4,2235,1340,-30
94909706298,94909706304,6,2108,1125,-30
94910837113,94910837115,2,2410,1223,-30
94911811918,94911811903,-15,1323,1029,-30
94912977336,94912977339,3,1950,927,-30
94914463008,94914463018,10,12669,41024,-30
94916529614,94916529619,5,2098,855,-30
94916903506,94916903514,8,3218,1151,-30
94917606307,94917606313,6,2045,1669,-30
94918314774,94918314781,7,2364,907,-30
94920980627,94920980633,6,3109,1435,-30
94923822989,94923822994,5,2303,1123,-30
94924829030,94924829035,5,2205,1564,-30
94926612998,94926613003,5,2991,1384,-30
94928832113,94928832118,5,2415,1237,-30
94929045135,94929045116,-19,2009,1356,-30
94930003953,94930003959,6,2640,1243,-30
94935822839,94935822843,4,1242,1018,-30
94937959545,94937959550,5,1574,898,-30
94942951241,94942951245,4,2061,861,-30
94945155294,94945155299,5,2012,1130,-30
94948136946,94948136951,5,1044,685,-30
94949906265,94949906270,5,2311,1069,-30
94958707392,94958707398,6,2020,733,-30
94961980231,94961980234,3,1879,1176,-30
94968102906,94968102910,4,1440,956,-30
94969845842,94969845841,-1,1120,2560,-30
94972134635,94972134633,-2,1101,1180,-30
94975263442,94975263449,7,2791,1266,-30
94976022902,94976022884,-18,1970,1180,-30
94977040619,94977040623,4,3517,1431,-30
94979478414,94979478418,4,1970,917,-30
94986426370,94986426374,4,2243,1341,-30
94987186824,94987186840,16,439,3353,-30
94987394093,94987394094,1,1533,1435,-30
94988097993,94988097997,4,2062,1492,-30
94988525282,94988525266,-16,3573,1868,-30
94990881085,94990881090,5,1876,1419,-30
94995735322,94995735325,3,3048,1766,-30
94997538874,94997538878,4,2134,1172,-30
94997922134,94997922138,4,1692,1222,-30
94999360574,94999360581,7,2519,1348,-30
95000548426,95000548431,5,1693,1050,-30
95000872370,95000872355,-15,1042,684,-30
95001184773,95001184778,5,2883,2164,-30
95001277771,95001277774,3,1941,1223,-30
95001997621,95001997627,6,1601,1528,-30
95003376181,95003376186,5,1703,1090,-30
95004084598,95004084601,3,1783,934,-30
95004988350,95004988351,1,1788,1112,-30
95010077817,95010077821,4,2027,1078,-30
95011503957,95011503940,-17,2520,986,-30
95013770238,95013770244,6,3424,1644,-30
95016234023,95016234029,6,1456,1220,-30
95017794834,95017794839,5,1938,1398,-30
95018022248,95018022253,5,2804,1262,-30
95019472289,95019472294,5,2060,1213,-30
95030593203,95030593206,3,932,1184,-30
95030668836,95030668829,-7,4261,12123,-30
95033980241,95033980247,6,1728,822,-30
95034843598,95034843603,5,1972,1079,-30
95034913670,95034913676,6,2661,1601,-30
95034992450,95034992466,16,2897,1270,-30
95035912221,95035912226,5,3334,1138,-30
95038586309,95038586313,4,2531,1645,-30
95039904494,95039904497,3,1532,1044,-30
95040365415,95040365418,3,1820,1308,-30
95044720725,95044720729,4,2046,1342,-30
95044804123,95044804130,7,2437,1313,-30
95046102798,95046102797,-1,2043,2466,-30
95047567054,95047567058,4,2439,1145,-30
95048217535,95048217530,-5,699,307,-30
95050055285,95050055290,5,2859,1428,-30
95057269456,95057269460,4,2914,1424,-30
95057378979,95057378984,5,2657,1316,-30
95063567590,95063567594,4,2892,1603,-30
95064618482,95064618487,5,1923,841,-30
95067898954,95067898958,4,1503,760,-30
95068768140,95068768147,7,2089,850,-30
95069866650,95069866651,1,919,302,-30
95072509250,95072509257,7,2494,1303,-30
95072624181,95072624187,6,3285,1341,-30
95073256477,95073256482,5,3128,1462,-30
95079055554,95079055559,5,1891,1293,-30
95079756035,95079756041,6,2247,1157,-30
95080238627,95080238633,6,2098,1161,-30
95084822020,95084822025,5,1917,1131,-30
95084978575,95084978576,1,1591,1314,-30
95085044463,95085044464,1,1811,1273,-30
95085712000,95085712004,4,2239,1263,-30
95085838843,95085838844,1,1141,1848,-30
95089648009,95089648013,4,1907,1257,-30
95091590345,95091590351,6,2588,1558,-30
95093887678,95093887684,6,2433,1919,-30
95093940822,95093940844,22,1637,1374,-30
95095588329,95095588334,5,2801,1284,-30
95096709100,95096709106,6,5643,1966,-30
95104443677,95104443681,4,2303,1030,-30
95106725521,95106725528,7,2556,1391,-30
95107952251,95107952256,5,2567,1263,-30
95112605743,95112605746,3,1385,1019,-30
95114456574,95114456578,4,2436,1692,-30
95116036773,95116036777,4,1645,991,-30
95116839508,95116839514,6,2022,1050,-30
95120227144,95120227150,6,2204,1228,-30
95122301430,95122301435,5,2057,1249,-30
95125727889,95125727893,4,2205,901,-30
95127905646,95127905652,6,2225,1253,-30
95137503997,95137503998,1,3529,4003,-30
95141212071,95141212077,6,3143,1765,-30
95143323098,95143323106,8,2031,1088,-30
95146543655,95146543658,3,1564,1425,-30
95150755114,95150755120,6,4126,2613,-30
95152891355,95152891362,7,1526,1235,-30
95158143523,95158143530,7,2017,1211,-30
95163392937,95163392942,5,1450,1200,-30
95163649655,95163649660,5,1946,1097,-30
95164996362,95164996367,5,2887,1244,-30
95166261457,95166261462,5,3350,1196,-30
95169812839,95169812846,7,1389,1066,-30
95172521601,95172521606,5,2350,755,-30
95175242930,95175242938,8,636,274,-30
95179557685,95179557691,6,1826,1581,-30
95184719018,95184719023,5,2521,1232,-30
95185819866,95185819873,7,1935,1537,-30
95185919793,95185919797,4,2053,1113,-30
95187218194,95187218198,4,3370,1922,-30
95187335337,95187335342,5,2145,1379,-30
95188676367,95188676375,8,3628,1872,-30
95189071310,95189071319,9,3003,829,-30
95191398137,95191398142,5,3629,940,-30
95193133717,95193133723,6,2569,1472,-30
95193946808,95193946810,2,1326,1669,-30
95194335858,95194335862,4,2218,996,-30
95194473846,95194473851,5,2131,1557,-30
95196581158,95196581161,3,2214,1261,-30
95198197056,95198197060,4,1501,1236,-30
95200030407,95200030393,-14,1654,4611,-30
95201007405,95201007413,8,2470,918,-30
95201182872,95201182878,6,2035,963,-30
95203790531,95203790547,16,42,716,-30
95204512161,95204512166,5,3162,1996,-30
95205966702,95205966708,6,2583,1530,-30
95206179165,95206179178,13,2629,1995,-30
95208622194,95208622199,5,1239,997,-30
95209161647,95209161652,5,2025,1165,-30
95215704039,95215704044,5,2330,1774,-30
95216320619,95216320625,6,1967,1162,-30
95217837737,95217837742,5,1748,1050,-30
95220056936,95220056938,2,2022,1161,-30
95221979586,95221979592,6,3805,1402,-30
95223141509,95223141514,5,2161,1708,-30
95229618488,95229618493,5,1415,1446,-30
95231045156,95231045161,5,985,1078,-30
95237988392,95237988397,5,1983,1413,-30
95239621913,95239621916,3,2289,1145,-30
95239943894,95239943875,-19,2159,1402,-30
95240162131,95240162136,5,1701,1529,-30
95241043330,95241043334,4,2721,1288,-30
95242060262,95242060267,5,2185,1323,-30
95245617958,95245617942,-16,1300,1009,-30
95245963299,95245963305,6,2406,1173,-30
95252545638,95252545643,5,1464,873,-30
95255410125,95255410130,5,2484,1401,-30
95256503295,95256503302,7,2222,1246,-30
95256868843,95256868849,6,2528,986,-30
95256954102,95256954121,19,2169,967,-30
95258589802,95258589807,5,2411,883,-30
95259284770,95259284775,5,1772,1468,-30
95262041855,95262041861,6,2568,1170,-30
95263151355,95263151360,5,2571,1560,-30
95265002769,95265002775,6,1842,1357,-30
95265383833,95265383817,-16,857,214,-30
95268226253,95268226257,4,1397,1242,-30
95269745589,95269745593,4,1425,1450,-30
95270985101,95270985106,5,2152,1221,-30
95273641921,95273641913,-8,44911,8194,-30
95275374314,95275374322,8,1347,753,-30
95279249978,95279249981,3,2024,1115,-30
95280390149,95280390154,5,2612,1435,-30
95281778882,95281778885,3,2260,1305,-30
95284068513,95284068517,4,2199,1722,-30
95288773365,95288773369,4,2633,1848,-30
95289728793,95289728794,1,1975,1742,-30
95292430313,95292430316,3,2491,1140,-30
95294721641,95294721645,4,3104,1656,-30
95294890302,95294890306,4,1733,1413,-30
95295658822,95295658828,6,2427,2169,-30
95300361434,95300361439,5,2542,1141,-30
95302056403,95302056387,-16,1052,476,-30
95307054967,95307054973,6,2827,1365,-30
95308455465,95308455470,5,1332,1094,-30
95312212994,95312212999,5,2357,1332,-30
95314712102,95314712096,-6,2298,8097,-30
95315070745,95315070749,4,2526,1833,-30
95317985881,95317985886,5,3106,1804,-30
95318839455,95318839458,3,1089,913,-30
95325400517,95325400523,6,3156,1408,-30
95325724929,95325724933,4,1132,632,-30
95333220393,95333220399,6,3012,1614,-30
95334093149,95334093154,5,2445,1462,-30
95334264454,95334264460,6,1820,1366,-30
95335002521,95335002528,7,2424,1499,-30
95335603013,95335603019,6,1688,912,-30
95336979287,95336979291,4,1925,1138,-30
95341667101,95341667104,3,2868,1520,-30
95343343922,95343343925,3,1394,1218,-30
95343482584,95343482570,-14,885,688,-30
95345413557,95345413563,6,2743,1124,-30
95347354689,95347354684,-5,1400,3291,-30
95352895570,95352895581,11,9010,42502,-30
95361443278,95361443282,4,2366,1720,-30
95362205433,95362205439,6,2034,1204,-30
95364342568,95364342574,6,2278,1359,-30
95366905814,95366905817,3,2294,1469,-30
95372869383,95372869399,16,38,479,-30
95373079361,95373079366,5,3152,2263,-30
95385210461,95385210465,4,2414,1388,-30
95387324642,95387324645,3,6648,7067,-30
95389096710,95389096715,5,1106,910,-30
95389420933,95389420938,5,2100,1307,-30
95391816438,95391816441,3,1552,1025,-30
95392707339,95392707341,2,901,1075,-30
95397419323,95397419330,7,2537,1099,-30
95406663350,95406663356,6,1777,1094,-30
95412854504,95412854505,1,1217,1551,-30
95413010425,95413010411,-14,1482,696,-30
95416019758,95416019765,7,2212,1180,-30
95418438894,95418438900,6,2228,1184,-30
95421406043,95421406044,1,3567,3711,-30
95424093323,95424093326,3,2342,1902,-30
95427421011,95427421015,4,2564,1513,-30
95428355498,95428355491,-7,1616,6937,-30
95429386787,95429386791,4,1093,975,-30
95431554041,95431554045,4,1971,1200,-30
95432419628,95432419634,6,1844,1179,-30
95433919954,95433919957,3,2316,1726,-30
95435944577,95435944582,5,2304,1055,-30
95445320325,95445320329,4,2176,1771,-30
95451748893,95451748898,5,2039,803,-30
95454598142,95454598143,1,1766,1314,-30
95454674167,95454674144,-23,2440,1401,-30
95456319977,95456319983,6,2410,1301,-30
95457771937,95457771939,2,1710,1319,-30
95459218726,95459218730,4,2914,1079,-30
95460208543,95460208547,4,2094,1832,-30
95460677314,95460677321,7,2138,1041,-30
95461065726,95461065722,-4,1334,3623,-30
95462785096,95462785100,4,1579,1071,-30
95463778610,95463778616,6,3640,1412,-30
95468331165,95468331170,5,1888,1362,-30
95468837999,95468837979,-20,1246,959,-30
95471599699,95471599704,5,2177,1451,-30
95473773498,95473773503,5,2904,754,-30
95474622998,95474623002,4,2464,1736,-30
95485548797,95485548802,5,1971,1422,-30
95486480098,95486480106,8,5991,2212,-30
95487035580,95487035587,7,2506,1247,-30
95490147413,95490147417,4,2103,1301,-30
95491503306,95491503312,6,2661,1460,-30
95502430929,95502430934,5,2129,1452,-30
95502538457,95502538462,5,2536,1226,-30
95506238452,95506238458,6,2689,1301,-30
95506659262,95506659267,5,3207,1710,-30
95509253538,95509253532,-6,2015,10696,-30
95513636908,95513636904,-4,30072,4510,-30
95513704718,95513704723,5,1729,1341,-30
95522065062,95522065066,4,1913,1056,-30
95522485411,95522485426,15,1578,1417,-30
95523244939,95523244933,-6,1398,283,-30
95523340401,95523340404,3,1868,1450,-30
95523451439,95523451442,3,2322,1277,-30
95523801922,95523801925,3,1639,991,-30
95524153246,95524153258,12,841,228,-30
95526533994,95526533978,-16,1481,2818,-30
95528321652,95528321658,6,2881,1246,-30
95531204229,95531204233,4,2100,760,-30
95531685486,95531685493,7,2679,1459,-30
95532604686,95532604693,7,1657,1267,-30
95537679250,95537679255,5,2452,1236,-30
95539614785,95539614791,6,2403,1383,-30
95540484476,95540484479,3,2758,1340,-30
95542118010,95542118016,6,2390,1027,-30
95545473433,95545473438,5,2322,1445,-30
95548058984,95548058987,3,2243,1527,-30
95549451431,95549451435,4,2483,1599,-30
95550865786,95550865789,3,1963,1238,-30
95551451969,95551451973,4,1878,1494,-30
95552035498,95552035484,-14,2819,1895,-30
95552410718,95552410722,4,1790,1256,-30
95553278201,95553278205,4,729,344,-30
95558120183,95558120187,4,1718,911,-30
95558944616,95558944618,2,1419,1214,-30
95560574610,95560574613,3,2902,1487,-30
95561495392,95561495391,-1,1570,2500,-30
95568476149,95568476150,1,1408,1101,-30
95570168099,95570168096,-3,38160,19661,-30
95571855060,95571855064,4,2665,1640,-30
95572060268,95572060289,21,2894,1274,-30
95573139413,95573139419,6,1871,1043,-30
95573897811,95573897831,20,517,815,-30
95574928255,95574928261,6,1555,1072,-30
95575298794,95575298797,3,2278,1582,-30
95576059923,95576059928,5,1209,1475,-30
95576205671,95576205678,7,1891,1195,-30
95577856859,95577856864,5,1553,1504,-30
95578076310,95578076298,-12,4387,985,-30
95580677215,95580677221,6,2315,2067,-30
95583417752,95583417752,0,38775,23329,-30
95583685600,95583685592,-8,1255,5634,-30
95584926945,95584926950,5,2507,1263,-30
95594083360,95594083365,5,3151,1777,-30
95595081875,95595081881,6,3336,2029,-30
95595593901,95595593906,5,2304,1456,-30
95596167498,95596167499,1,1706,1903,-30
95597237805,95597237811,6,2459,1143,-30
95600383102,95600383109,7,4156,1346,-30
95602093535,95602093539,4,2236,1229,-30
95606773746,95606773751,5,2467,1350,-30
95608399076,95608399081,5,1920,1506,-30
95612998396,95612998401,5,2767,1214,-30
95615507150,95615507157,7,3336,1616,-30
95620032351,95620032355,4,2063,1378,-30
95621591201,95621591206,5,1148,923,-30
95621822617,95621822621,4,1465,1520,-30
95622502212,95622502218,6,1857,1275,-30
95623578262,95623578261,-1,1746,1625,-30
95624607706,95624607711,5,1402,902,-30
95625591867,95625591874,7,1008,161,-30
95625907553,95625907570,17,3115,1284,-30
95628661218,95628661215,-3,1918,4322,-30
95630632894,95630632897,3,2500,1501,-30
95633346681,95633346697,16,1540,653,-30
95634441094,95634441100,6,2743,1548,-30
95643253636,95643253641,5,2095,1164,-30
95645042912,95645042917,5,1694,1243,-30
95645075981,95645075987,6,2092,1051,-30
95645112888,95645112893,5,2574,1569,-30
95646330870,95646330875,5,2590,1511,-30
95647040437,95647040441,4,1908,1064,-30
95648794764,95648794767,3,1908,1276,-30
95649212295,95649212298,3,2343,1127,-30
95649309937,95649309955,18,1700,1043,-30
95650661844,95650661850,6,1860,1130,-30
95651671658,95651671662,4,2406,1234,-30
95653473996,95653473995,-1,1407,1696,-30
95654699222,95654699229,7,4696,1477,-30
95655592461,95655592465,4,2017,993,-30
95656357134,95656357136,2,1293,993,-30
95659425265,95659425266,1,1483,2086,-30
95664622186,95664622191,5,2353,1347,-30
95667929406,95667929411,5,2178,887,-30
95669101138,95669101142,4,1683,1362,-30
95671907667,95671907663,-4,872,1837,-30
95673011626,95673011630,4,1494,1225,-30
95673084401,95673084418,17,1453,1096,-30
95675521596,95675521600,4,2756,1673,-30
95676595571,95676595578,7,1723,1025,-30
95677920306,95677920314,8,3025,966,-30
95679204913,95679204918,5,4015,1991,-30
95679600021,95679600029,8,4865,981,-30
95680986533,95680986538,5,2131,1221,-30
95681136511,95681136515,4,2243,978,-30
95685893334,95685893341,7,3159,1075,-30
95687842636,95687842641,5,1949,1262,-30
95693643461,95693643465,4,2341,2001,-30
95698167839,95698167845,6,2730,1180,-30
95701353182,95701353186,4,2067,1337,-30
95704083677,95704083681,4,2185,1537,-30
95705327391,95705327398,7,3782,1374,-30
95706772122,95706772120,-2,562,100,-30
95707463137,95707463143,6,2807,1191,-30
95709041118,95709041122,4,1683,1378,-30
95716056990,95716056994,4,2601,1483,-30
95720221910,95720221908,-2,25127,4965,-30
95721186518,95721186522,4,1910,1010,-30
95723657815,95723657822,7,3004,1520,-30
95726245701,95726245706,5,2288,1288,-30
95727784914,95727784914,0,1009,1238,-30
95730712726,95730712741,15,2041,994,-30
95730899309,95730899291,-18,1649,1579,-30
95732607738,95732607741,3,1716,1963,-30
95735064012,95735064019,7,2311,1126,-30
95735427987,95735427991,4,2830,1496,-30
95737658584,95737658587,3,2946,1924,-30
95741936202,95741936207,5,1783,1324,-30
95743134114,95743134113,-1,1277,2899,-30
95751124271,95751124277,6,1903,1522,-30
95752195894,95752195895,1,1821,1243,-30
95752507214,95752507218,4,1263,628,-30
95753923475,95753923478,3,1119,1050,-30
95755445065,95755445070,5,2138,1205,-30
95756270314,95756270318,4,1666,949,-30
95757502973,95757502978,5,1698,859,-30
95758412171,95758412177,6,2597,1469,-30
95761070865,95761070868,3,2173,1229,-30
95764200746,95764200750,4,1638,1191,-30
95765642824,95765642830,6,2432,1070,-30
95768242301,95768242305,4,1655,1585,-30
95778478815,95778478819,4,2421,1576,-30
95790602867,95790602872,5,2523,1281,-30
95798515878,95798515880,2,846,1260,-30
95799003021,95799003025,4,2091,1399,-30
95804524148,95804524169,21,2163,1185,-30
95810252488,95810252491,3,1476,915,-30
95813893616,95813893613,-3,741,2691,-30
95814067893,95814067898,5,2380,1265,-30
95815959861,95815959863,2,2216,1414,-30
95820635094,95820635098,4,2498,1475,-30
95825511386,95825511391,5,1628,1108,-30
95829382911,95829382918,7,7673,2768,-30
95830396301,95830396303,2,2316,1209,-30
95831009370,95831009377,7,3043,1138,-30
95842732963,95842732968,5,2038,1180,-30
95843905609,95843905602,-7,2960,9188,-30
95848287782,95848287788,6,2637,1359,-30
95850223858,95850223864,6,3264,1537,-30
95852444607,95852444605,-2,1129,2644,-30
95853594375,95853594381,6,2076,1092,-30
95854437723,95854437729,6,2489,683,-30
95857054918,95857054915,-3,1222,2088,-30
95860801590,95860801594,4,1790,868,-30
95861807042,95861807047,5,1335,878,-30
95864481510,95864481514,4,3813,1556,-30
95864678865,95864678869,4,1536,1209,-30
95866348229,95866348235,6,1675,1746,-30
95868362064,95868362068,4,1679,956,-30
95869798863,95869798866,3,2528,1293,-30
95872724162,95872724166,4,1004,796,-30
95877372381,95877372386,5,2426,1199,-30
95886042220,95886042226,6,2209,1081,-30
95886619321,95886619326,5,1789,1411,-30
95887781221,95887781226,5,1633,1662,-30
95888284382,95888284387,5,2259,1644,-30
95891297554,95891297561,7,2156,1440,-30
95891981603,95891981585,-18,1438,864,-30
95894848272,95894848278,6,1987,1241,-30
95895007286,95895007292,6,3360,1636,-30
95895467854,95895467859,5,1689,1442,-30
95900857568,95900857575,7,2173,744,-30
95902435250,95902435255,5,1247,728,-30
95910490290,95910490295,5,2617,1045,-30
95910731218,95910731222,4,1732,1077,-30
95914456837,95914456842,5,1611,1105,-30
95918630573,95918630577,4,2592,1671,-30
95920482273,95920482256,-17,3027,1438,-30
95923013353,95923013357,4,2342,1108,-30
95923546470,95923546474,4,1530,947,-30
95930865394,95930865398,4,2325,951,-30
95931996160,95931996165,5,2141,1518,-30
95939567946,95939567967,21,435,1809,-30
95940998579,95940998582,3,1667,893,-30
95949724649,95949724654,5,2306,1397,-30
95952159458,95952159464,6,2023,1539,-30
95955846533,95955846538,5,1659,1577,-30
95957130402,95957130407,5,2554,1518,-30
95958489696,95958489698,2,1751,1269,-30
95959890702,95959890706,4,3200,1436,-30
95959961255,95959961244,-11,1511,866,-30
95962444465,95962444470,5,2212,1123,-30
95965119414,95965119417,3,2667,1200,-30
95965205986,95965205990,4,2725,824,-30
95967378431,95967378439,8,2457,1114,-30
95970371518,95970371522,4,2677,1415,-30
95971095717,95971095721,4,3161,1831,-30
95971258678,95971258684,6,2694,1337,-30
95973663618,95973663616,-2,1661,3193,-30
95973814386,95973814391,5,2178,1002,-30
95974876034,95974876039,5,3003,1504,-30
95975034908,95975034914,6,1390,879,-30
95976906888,95976906893,5,2957,1708,-30
95983605507,95983605510,3,687,626,-30
95985902997,95985903002,5,2321,1500,-30
95988583073,95988583079,6,2294,1194,-30
95992246721,95992246726,5,1887,1123,-30
95995011399,95995011402,3,2010,863,-30
95995141094,95995141075,-19,2401,1400,-30
95997575881,95997575887,6,2419,1177,-30
95998454123,95998454130,7,2713,1547,-30
96001060498,96001060503,5,1947,1586,-30
96001668533,96001668538,5,2144,1431,-30
96002355050,96002355055,5,2457,1330,-30
96005033773,96005033779,6,1711,1384,-30
96007189014,96007189018,4,1327,1261,-30
96011276897,96011276901,4,2147,1242,-30
96012313610,96012313614,4,2365,1882,-30
96015392588,96015392592,4,2451,1281,-30
96016217518,96016217524,6,2421,1052,-30
96016870651,96016870658,7,3275,1398,-30
96020723630,96020723635,5,2422,1381,-30
96023296360,96023296362,2,1459,1114,-30
96025138490,96025138493,3,2828,1207,-30
96026032195,96026032201,6,2414,1349,-30
96026217231,96026217236,5,2575,1473,-30
96030386038,96030386044,6,1479,1308,-30
96031228156,96031228159,3,2024,1430,-30
96031282185,96031282189,4,2620,1122,-30
96032154812,96032154801,-11,435,256,-30
96033095985,96033095987,2,2297,1301,-30
96035177382,96035177387,5,3033,1006,-30
96041490650,96041490655,5,2485,1315,-30
96041813734,96041813739,5,1645,1404,-30
96042999553,96042999557,4,2704,1433,-30
96044806860,96044806866,6,2351,1833,-30
96045958991,96045958994,3,2573,1198,-30
96048260682,96048260686,4,2398,1288,-30
96048851074,96048851057,-17,885,388,-30
96057748474,96057748481,7,2152,1143,-30
96063843592,96063843597,5,1498,1013,-30
96065141224,96065141227,3,1730,1048,-30
96067512433,96067512434,1,1323,1813,-30
96071691497,96071691502,5,2527,901,-30
96073062350,96073062356,6,2492,1433,-30
96075100807,96075100810,3,2135,1659,-30
96075743733,96075743740,7,14202,39964,-30
96075769655,96075769649,-6,30250,12956,-30
96079658691,96079658695,4,2508,1728,-30
96081397617,96081397622,5,2493,1424,-30
96090263378,96090263383,5,1599,925,-30
96091465685,96091465689,4,2587,1819,-30
96100932716,96100932722,6,1592,1044,-30
96102994696,96102994701,5,1324,916,-30
96104315506,96104315510,4,2635,1584,-30
96105540369,96105540375,6,2245,1449,-30
96120143577,96120143582,5,2204,1440,-30
96122339253,96122339258,5,2766,1776,-30
96123754856,96123754873,17,1070,2593,-30
96123852158,96123852163,5,2706,1734,-30
96125225700,96125225705,5,2209,1361,-30
96127235427,96127235433,6,2207,1499,-30
96127901140,96127901146,6,4073,2416,-30
96129291654,96129291660,6,2021,1105,-30
96131032582,96131032584,2,1444,1651,-30
96133619114,96133619117,3,2114,1187,-30
96133847703,96133847707,4,3123,1739,-30
96135432629,96135432635,6,1265,1014,-30
96135467419,96135467412,-7,599,125,-30
96136311988,96136311993,5,1967,1457,-30
96136530878,96136530881,3,2347,1362,-30
96139140550,96139140554,4,2056,1743,-30
96140954757,96140954761,4,2515,1387,-30
96145909461,96145909466,5,1755,1249,-30
96149015438,96149015443,5,2294,1384,-30
96151841567,96151841571,4,2332,1848,-30
96152793135,96152793139,4,3269,1714,-30
96157116531,96157116536,5,2352,1486,-30
96157702573,96157702581,8,17951,17960,-30
96157850715,96157850718,3,1262,1609,-30
96158594046,96158594050,4,2051,1247,-30
96158885644,96158885648,4,1360,1271,-30
96162800502,96162800507,5,3149,1720,-30
96164250874,96164250880,6,1615,933,-30
96165192886,96165192882,-4,1592,3334,-30
96166019794,96166019798,4,1739,1102,-30
96167847402,96167847406,4,2677,1718,-30
96170547119,96170547099,-20,1496,1282,-30
96173359049,96173359054,5,2769,1846,-30
96185886652,96185886653,1,1575,1381,-30
96186488181,96186488186,5,3094,1547,-30
96186885530,96186885528,-2,2989,6321,-30
96187307723,96187307726,3,1732,1143,-30
96189956566,96189956570,4,2360,1100,-30
96192090326,96192090333,7,3093,1385,-30
96193822329,96193822337,8,2617,1121,-30
96198667068,96198667071,3,2323,1304,-30
96200114381,96200114377,-4,1140,5375,-30
96205094618,96205094621,3,1889,1018,-30
96206545735,96206545742,7,2768,1036,-30
96211755857,96211755865,8,3015,963,-30
96212616732,96212616736,4,1586,1606,-30
96215415189,96215415194,5,3324,1655,-30
96216141877,96216141881,4,2346,1561,-30
96217013886,96217013890,4,2642,1360,-30
96223631603,96223631604,1,788,1190,-30
96228497350,96228497358,8,2337,1229,-30
96228799869,96228799874,5,2703,1454,-30
96229405006,96229405010,4,1819,897,-30
96233409658,96233409662,4,2299,1671,-30
96234253177,96234253183,6,2174,1123,-30
96239429411,96239429418,7,2585,948,-30
96239702778,96239702777,-1,2040,3397,-30
96240153629,96240153635,6,1816,928,-30
96244775563,96244775569,6,2103,1347,-30
96246193458,96246193463,5,2488,1282,-30
96246645594,96246645598,4,1677,891,-30
96248028917,96248028922,5,2220,938,-30
96248230971,96248230979,8,1672,981,-30
96248271487,96248271465,-22,2134,1558,-30
96248788279,96248788282,3,2074,1344,-30
96251821955,96251821961,6,1980,1104,-30
96252141627,96252141630,3,1793,1332,-30
96253602986,96253602989,3,1832,1352,-30
96260031549,96260031553,4,2312,1145,-30
96262776717,96262776722,5,2682,1368,-30
96264673090,96264673095,5,2607,1264,-30
96264897199,96264897202,3,1969,1580,-30
96279554890,96279554894,4,1508,883,-30
96283550386,96283550365,-21,1093,197,-30
96285193994,96285193999,5,2416,1276,-30
96287677469,96287677475,6,1908,1041,-30
96288081640,96288081637,-3,1491,2666,-30
96291690201,96291690206,5,2182,1573,-30
96292176635,96292176641,6,2165,1395,-30
96295889346,96295889352,6,2504,1563,-30
96296757786,96296757793,7,2139,1951,-30
96299662742,96299662748,6,2471,1277,-30
96300390369,96300390354,-15,1646,1329,-30
96300823580,96300823583,3,915,835,-30
96301168842,96301168837,-5,1678,5132,-30
96301655695,96301655699,4,1785,1072,-30
96302574464,96302574469,5,2306,1467,-30
96303338821,96303338827,6,3781,2144,-30
96303915450,96303915457,7,2394,1209,-30
96304827052,96304827057,5,2003,1106,-30
96305377915,96305377922,7,1604,879,-30
96307174332,96307174338,6,1888,1429,-30
96314065754,96314065760,6,3285,2406,-30
96314938426,96314938431,5,2348,1369,-30
96316428452,96316428458,6,2243,1334,-30
96322663150,96322663158,8,1933,1044,-30
96322885858,96322885862,4,2281,1456,-30
96324176261,96324176265,4,1601,860,-30
96333235681,96333235687,6,2267,1282,-30
96333587153,96333587146,-7,1017,3727,-30
96336039918,96336039922,4,1900,1184,-30
96338835114,96338835118,4,5425,3508,-30
96339047161,96339047166,5,1990,1574,-30
96342473160,96342473165,5,1836,1508,-30
96346064031,96346064031,0,1196,1378,-30
96346684602,96346684605,3,1602,1564,-30
96348660603,96348660605,2,1549,1450,-30
96350613489,96350613494,5,2816,1293,-30
96352326985,96352326991,6,3138,1585,-30
96355768742,96355768747,5,2437,1389,-30
96363548871,96363548869,-2,1681,1880,-30
96371792030,96371792010,-20,546,246,-30
96372676474,96372676479,5,1446,1125,-30
96375471730,96375471733,3,2379,1569,-30
96380623726,96380623730,4,3313,1766,-30
96382113073,96382113078,5,1734,1342,-30
96382410419,96382410425,6,1783,1277,-30
96385925830,96385925833,3,1692,1715,-30
96387368622,96387368629,7,3202,1160,-30
96387815434,96387815437,3,1557,1294,-30
96394806710,96394806714,4,2566,1015,-30
96395415074,96395415089,15,1902,1157,-30
96396862007,96396862010,3,2795,1167,-30
96403644702,96403644699,-3,1644,6022,-30
96404876435,96404876440,5,1927,1078,-30
96407477068,96407477076,8,1956,1113,-30
96409709634,96409709638,4,1703,1046,-30
96411854358,96411854362,4,1900,703,-30
96413299010,96413298993,-17,761,415,-30
96413909347,96413909351,4,2727,1562,-30
96414728047,96414728053,6,2494,1328,-30
96415940256,96415940264,8,2650,1134,-30
96416429597,96416429602,5,1375,1061,-30
96417833363,96417833369,6,582,613,-30
96420293071,96420293076,5,1970,1386,-30
96420492143,96420492153,10,1703,1224,-30
96430844525,96430844531,6,2503,1239,-30
96430914810,96430914815,5,1964,1704,-30
96432066377,96432066382,5,2160,1697,-30
96432865486,96432865489,3,2056,1519,-30
96433168153,96433168150,-3,1383,2404,-30
96433532459,96433532465,6,1631,1114,-30
96434353441,96434353434,-7,476,148,-30
96434567338,96434567342,4,2604,1132,-30
96435730785,96435730789,4,1756,1217,-30
96436797548,96436797551,3,1087,1330,-30
96438143994,96438144002,8,2752,1300,-30
96439154422,96439154423,1,1939,1697,-30
96439596247,96439596251,4,2246,1414,-30
96443084862,96443084867,5,1825,1140,-30
96443656305,96443656310,5,2049,1217,-30
96449146263,96449146269,6,519,57,-30
96450039698,96450039697,-1,675,1534,-30
96450159289,96450159293,4,1215,1271,-30
96451872941,96451872946,5,2229,1310,-30
96452452384,96452452389,5,1704,1374,-30
96458034394,96458034398,4,2310,1254,-30
96458490054,96458490057,3,1528,940,-30
96461702535,96461702539,4,2270,1467,-30
96467956702,96467956707,5,2304,1532,-30
96468410270,96468410275,5,3258,1618,-30
96472008314,96472008320,6,2441,947,-30
96472694197,96472694202,5,2576,1828,-30
96473157401,96473157407,6,2698,1130,-30
96473838224,96473838231,7,1793,1130,-30
96476013386,96476013391,5,2421,1175,-30
96480450767,96480450770,3,2056,1624,-30
96481173557,96481173561,4,1868,1040,-30
96482407634,96482407639,5,2779,1472,-30
96484779041,96484779047,6,1320,799,-30
96485475425,96485475429,4,1181,961,-30
96487453250,96487453255,5,3366,1493,-30
96492308590,96492308595,5,2181,1550,-30
96492569597,96492569599,2,1658,1187,-30
96493434593,96493434589,-4,1019,2365,-30
96498044320,96498044324,4,2369,1719,-30
96502777507,96502777513,6,1794,1159,-30
96506188546,96506188553,7,3374,958,-30
96509319892,96509319895,3,1940,1423,-30
96518851782,96518851788,6,1837,1396,-30
96520918890,96520918894,4,2431,1274,-30
96523172823,96523172826,3,1379,1438,-30
96525249350,96525249353,3,1793,1538,-30
96529763330,96529763337,7,2611,1571,-30
96531530361,96531530366,5,2695,1800,-30
96532660028,96532660033,5,1644,1068,-30
96535194610,96535194614,4,1647,1293,-30
96539635845,96539635850,5,2602,1374,-30
96540691671,96540691669,-2,920,1233,-30
96546752218,96546752222,4,1368,895,-30
96547495963,96547495958,-5,1721,6295,-30
96549101443,96549101449,6,2560,1194,-30
96549483613,96549483614,1,1452,1549,-30
96550495485,96550495489,4,1750,933,-30
96552237138,96552237141,3,1972,1857,-30
96554472208,96554472212,4,2895,1696,-30
96557795034,96557795039,5,2363,1235,-30
96565254862,96565254867,5,2781,1733,-30
96565591637,96565591644,7,3057,1335,-30
96565843875,96565843857,-18,1120,747,-30
96566529406,96566529411,5,3738,1854,-30
96569205625,96569205632,7,1788,1356,-30
96569759494,96569759483,-11,749,153,-30
96570486019,96570486024,5,1929,1203,-30
96576780518,96576780503,-15,1751,675,-30
96577794289,96577794297,8,13144,31198,-30
96578319402,96578319407,5,1241,691,-30
96580892001,96580892006,5,2711,1470,-30
96584549518,96584549499,-19,668,45,-30
96586148355,96586148358,3,2135,1161,-30
96587901435,96587901439,4,1616,855,-30
96589006283,96589006286,3,1304,1123,-30
96589234179,96589234161,-18,1078,242,-30
96592790979,96592790983,4,1314,902,-30
96595070357,96595070363,6,1922,1254,-30
96599736819,96599736822,3,1638,559,-30
96601448854,96601448856,2,1419,911,-30
96603085088,96603085094,6,2294,1200,-30
96605525480,96605525485,5,1792,1619,-30
96606866380,96606866386,6,1826,1260,-30
96609095640,96609095646,6,2654,1473,-30
96609123443,96609123458,15,681,367,-30
96609920641,96609920646,5,1820,1017,-30
96611367193,96611367197,4,2570,1361,-30
96611794925,96611794931,6,2502,1481,-30
96616625549,96616625554,5,1880,1164,-30
96616964153,96616964172,19,839,209,-30
96619654009,96619654014,5,2583,1573,-30
96619835738,96619835743,5,2346,1342,-30
96623688746,96623688753,7,2478,2095,-30
96624465573,96624465578,5,1682,1383,-30
96625200558,96625200563,5,1518,942,-30
96627620144,96627620150,6,2211,1207,-30
96630310323,96630310329,6,2780,1479,-30
96632509709,96632509714,5,2291,1530,-30
96633135809,96633135813,4,1883,943,-30
96635023806,96635023812,6,1918,1211,-30
96635099667,96635099666,-1,2742,3785,-30
96635432979,96635432983,4,2799,1889,-30
96636712081,96636712078,-3,1409,3226,-30
96638407938,96638407941,3,1502,1887,-30
96641001566,96641001570,4,1373,1314,-30
96641906566,96641906573,7,3101,1037,-30
96645962555,96645962558,3,2770,1720,-30
96650730495,96650730500,5,2295,1025,-30
96655192484,96655192489,5,2644,1273,-30
96655423407,96655423396,-11,1139,188,-30
96655889513,96655889511,-2,2148,2883,-30
96657248650,96657248656,6,1704,1391,-30
96658226162,96658226167,5,1372,1052,-30
96661935480,96661935486,6,2685,1336,-30
96662839658,96662839663,5,2714,1233,-30
96665392259,96665392264,5,3220,983,-30
96665585103,96665585106,3,2677,1516,-30
96666544651,96666544652,1,1406,1654,-30
96672970122,96672970115,-7,449,1275,-30
96675378326,96675378332,6,1972,1261,-30
96676907673,96676907678,5,3000,1560,-30
96678578997,96678578998,1,2310,1722,-30
96679283456,96679283461,5,3178,1405,-30
96682044966,96682044974,8,2324,1120,-30
96682516416,96682516422,6,2154,1123,-30
96686592526,96686592531,5,1936,976,-30
96689844975,96689844981,6,2142,1562,-30
96690813733,96690813739,6,1658,929,-30
96692440757,96692440761,4,8604,32202,-30
96694893341,96694893346,5,2444,1666,-30
96695034371,96695034375,4,2449,1542,-30
96697037558,96697037563,5,1964,1150,-30
96697224977,96697224983,6,1583,726,-30
96699237686,96699237691,5,2818,1775,-30
96699528919,96699528924,5,1682,1143,-30
96701832318,96701832317,-1,51466,36046,-30
96705693394,96705693400,6,1519,1230,-30
96705751368,96705751374,6,2438,1370,-30
96708216210,96708216212,2,1545,930,-30
96715375797,96715375803,6,2570,947,-30
96717283941,96717283944,3,2922,2070,-30
96717619198,96717619205,7,2316,1745,-30
96717787311,96717787318,7,1998,1413,-30
96723543762,96723543767,5,1818,955,-30
96724283862,96724283848,-14,580,364,-30
96727142193,96727142197,4,1717,1399,-30
96741311900,96741311902,2,1614,1126,-30
96741498803,96741498785,-18,2181,1031,-30
96745372440,96745372444,4,3201,1555,-30
96747551216,96747551221,5,3191,1367,-30
96747941148,96747941154,6,2441,1382,-30
96750240547,96750240552,5,2465,1341,-30
96752857774,96752857781,7,1764,980,-30
96756472198,96756472202,4,2533,1120,-30
96757544647,96757544652,5,2571,1479,-30
96759383217,96759383220,3,1845,1406,-30
96761589981,96761589985,4,2497,1321,-30
96762295365,96762295374,9,2779,1349,-30
96763921055,96763921061,6,2318,1334,-30
96773495049,96773495055,6,2755,1322,-30
96774354618,96774354620,2,2107,1399,-30
96774550703,96774550723,20,2024,1370,-30
96775214834,96775214827,-7,933,249,-30
96776005327,96776005333,6,4015,1178,-30
96779242634,96779242637,3,2427,1199,-30
96779497272,96779497282,10,2875,1145,-30
96782517219,96782517225,6,2940,1369,-30
96783992683,96783992687,4,2670,1488,-30
96784079890,96784079895,5,2650,1221,-30
96790460297,96790460302,5,2079,1405,-30
96796436743,96796436749,6,1237,722,-30
96796894085,96796894064,-21,1921,864,-30
96796975248,96796975253,5,2485,1695,-30
96798512603,96798512609,6,3089,1346,-30
96804010830,96804010835,5,2454,1551,-30
96805619380,96805619385,5,2164,1322,-30
96808651781,96808651786,5,2178,1402,-30
96809926258,96809926261,3,2241,1653,-30
96810344297,96810344303,6,1495,756,-30
96814551248,96814551252,4,2295,1162,-30
96815094003,96815094009,6,2578,1718,-30
96815771030,96815771035,5,2471,1460,-30
96822316253,96822316258,5,3342,2282,-30
96825192702,96825192710,8,3373,1288,-30
96827995870,96827995875,5,1741,720,-30
96832710103,96832710107,4,3015,1810,-30
96832844877,96832844882,5,2788,1531,-30
96833540961,96833540966,5,2454,933,-30
96835215761,96835215765,4,2312,1221,-30
96839705275,96839705279,4,1086,924,-30
96840688694,96840688674,-20,1045,404,-30
96842981141,96842981143,2,980,1973,-30
96844392622,96844392627,5,1671,1028,-30
96854055731,96854055729,-2,834,1457,-30
96859910345,96859910351,6,2169,1320,-30
96863359242,96863359249,7,3208,1356,-30
96867422638,96867422645,7,2447,1517,-30
96867759557,96867759563,6,2017,1212,-30
96867908814,96867908818,4,1925,1000,-30
96868178186,96868178170,-16,2125,1448,-30
96869719237,96869719241,4,2008,1682,-30
96870220534,96870220539,5,2352,1270,-30
96870486303,96870486289,-14,2314,1161,-30
96873575956,96873575959,3,1781,1025,-30
96874431611,96874431618,7,2396,934,-30
96874985914,96874985918,4,2914,1054,-30
96881198086,96881198090,4,2528,1912,-30
96881280567,96881280578,11,878,234,-30
96883244989,96883244994,5,2528,833,-30
96884822006,96884822014,8,1903,1072,-30
96885426186,96885426191,5,808,545,-30
96889337601,96889337606,5,2067,1248,-30
96889412241,96889412247,6,2291,893,-30
96889759725,96889759731,6,2626,1457,-30
96894034165,96894034171,6,2851,1924,-30
96897015437,96897015444,7,2803,1338,-30
96897532416,96897532421,5,2969,1504,-30
96906864037,96906864041,4,1716,1068,-30
96908716341,96908716345,4,2436,1436,-30
96908794059,96908794065,6,2362,1506,-30
96910868210,96910868216,6,3112,1601,-30
96911129815,96911129794,-21,2067,1525,-30
96911158133,96911158154,21,1258,1303,-30
96913910841,96913910847,6,3244,1543,-30
96914879165,96914879170,5,1889,1458,-30
96917354938,96917354943,5,2112,835,-30
96919920018,96919920021,3,2030,1274,-30
96921939726,96921939726,0,1642,2480,-30
96927587088,96927587094,6,2372,1392,-30
96927693348,96927693337,-11,666,179,-30
96929194191,96929194197,6,2564,1409,-30
96931638806,96931638810,4,1921,1248,-30
96934617121,96934617102,-19,1352,266,-30
96938594863,96938594867,4,2002,1238,-30
96938910465,96938910471,6,3365,1278,-30
96941113114,96941113118,4,3176,1830,-30
96941388693,96941388697,4,1975,1081,-30
96945147034,96945147039,5,2675,1778,-30
96945352360,96945352363,3,2225,1412,-30
96945757811,96945757815,4,1785,1336,-30
96948023082,96948023085,3,1661,1323,-30
96949384849,96949384853,4,2491,1689,-30
96959047814,96959047815,1,1756,857,-30
96965433327,96965433333,6,1484,1611,-30
96967137201,96967137207,6,1674,1167,-30
96968987267,96968987273,6,2290,1114,-30
96974277875,96974277878,3,1582,1354,-30
96976481145,96976481151,6,2035,1669,-30
96978534504,96978534510,6,2053,1168,-30
96979786980,96979786986,6,2148,999,-30
96980836801,96980836806,5,2256,951,-30
96982356989,96982356994,5,1780,859,-30
96982788590,96982788595,5,2686,1604,-30
96988502109,96988502113,4,1797,999,-30
96992838421,96992838425,4,2591,1563,-30
96993737334,96993737338,4,1942,1276,-30
96994508638,96994508642,4,1490,1357,-30
96998029572,96998029576,4,2653,1194,-30
97002779661,97002779665,4,1467,1118,-30
97005428028,97005428032,4,2294,1256,-30
97010354954,97010354959,5,2503,898,-30
97011251728,97011251732,4,2248,1492,-30
97014259978,97014259978,0,1272,975,-30
97017001512,97017001514,2,1740,1547,-30
97017277286,97017277294,8,12588,25677,-30
97022563106,97022563110,4,3342,1153,-30
97022665864,97022665852,-12,1694,858,-30
97027175202,97027175205,3,2662,2107,-30
97028086058,97028086062,4,2272,1302,-30
97028300269,97028300271,2,2259,1568,-30
97029190981,97029190985,4,2467,1375,-30
97031303422,97031303415,-7,2178,8338,-30
97033125759,97033125765,6,546,174,-30
97034310645,97034310650,5,2044,1208,-30
97034714724,97034714729,5,2253,1342,-30
97035474135,97035474115,-20,779,274,-30
97036896054,97036896059,5,2245,1002,-30
97037597097,97037597100,3,2058,1378,-30
97038208662,97038208666,4,1897,1192,-30
97040651218,97040651226,8,2561,1283,-30
97040704958,97040704963,5,1900,1217,-30
97041437459,97041437462,3,2509,1292,-30
97043451529,97043451535,6,2416,1110,-30
97047797073,97047797080,7,2753,1616,-30
97048194233,97048194239,6,2647,1708,-30
97049290997,97049291001,4,2543,1634,-30
97049816116,97049816122,6,2409,1275,-30
97050145273,97050145278,5,3207,1652,-30
97052383109,97052383113,4,2127,1504,-30
97056353242,97056353245,3,5958,17464,-30
97059007933,97059007938,5,2700,1397,-30
97060403465,97060403469,4,2499,1179,-30
97062559724,97062559729,5,2319,1090,-30
97062585742,97062585723,-19,2476,1348,-30
97062658138,97062658142,4,2775,2011,-30
97063048338,97063048343,5,2339,1709,-30
97064293749,97064293754,5,2125,1400,-30
97066787485,97066787489,4,58135,35991,-30
97069497933,97069497937,4,1847,1331,-30
97073171766,97073171764,-2,8363,17767,-30
97075703643,97075703649,6,2089,1436,-30
97078060793,97078060799,6,6442,2536,-30
97082166920,97082166924,4,2173,1012,-30
97082359154,97082359158,4,2009,1491,-30
97085249766,97085249773,7,2378,1196,-30
97088120985,97088120990,5,1371,967,-30
97093630783,97093630789,6,2176,1359,-30
97094599223,97094599229,6,3484,1711,-30
97100312366,97100312371,5,1900,827,-30
97101920159,97101920166,7,2912,1254,-30
97109044697,97109044702,5,2800,1530,-30
97110922850,97110922855,5,2656,1339,-30
97112272341,97112272344,3,10047,55103,-30
97117390463,97117390468,5,2566,1503,-30
97123817585,97123817591,6,2703,2032,-30
97127847161,97127847166,5,2325,1446,-30
97129699662,97129699666,4,2418,1133,-30
97130659357,97130659362,5,3006,1469,-30
97137544069,97137544073,4,2441,1386,-30
97139020769,97139020773,4,1951,1632,-30
97139134359,97139134364,5,2396,1668,-30
97139776973,97139776978,5,2432,1144,-30
97139979687,97139979693,6,2086,920,-30
97144952429,97144952421,-8,1305,7161,-30
97145697842,97145697848,6,3722,1591,-30
97146620566,97146620566,0,2215,3054,-30
97147281401,97147281397,-4,1091,2191,-30
97148314246,97148314252,6,2205,1250,-30
97150861674,97150861678,4,1810,1410,-30
97154401527,97154401524,-3,1252,1950,-30
97156479825,97156479830,5,2537,1857,-30
97157673345,97157673349,4,1599,1211,-30
97158334630,97158334618,-12,647,166,-30
97159372539,97159372545,6,2190,1072,-30
97160121601,97160121607,6,2487,1653,-30
97163198500,97163198506,6,2239,1746,-30
97163535353,97163535357,4,2037,1414,-30
97163892226,97163892229,3,2347,1109,-30
97165525438,97165525442,4,2507,1718,-30
97165649026,97165649033,7,1831,968,-30
97166106011,97166106018,7,4019,1853,-30
97171354277,97171354284,7,2712,1575,-30
97173824810,97173824817,7,2046,1453,-30
97182799955,97182799950,-5,1311,2035,-30
97184662434,97184662440,6,1509,1158,-30
97188166792,97188166796,4,2242,1408,-30
97188623972,97188623977,5,1513,955,-30
97190271535,97190271542,7,1896,843,-30
97198737112,97198737115,3,2642,1229,-30
97200858571,97200858575,4,2535,1328,-30
97202867009,97202867014,5,1467,756,-30
97203601480,97203601485,5,3874,1564,-30
97206852346,97206852350,4,2328,1512,-30
97208164849,97208164854,5,1980,1054,-30
97212347849,97212347854,5,2180,1251,-30
97217532785,97217532793,8,1991,1477,-30
97220005120,97220005112,-8,277,1399,-30
97228199252,97228199255,3,1466,1001,-30
97230899025,97230899031,6,3131,1155,-30
97231019901,97231019906,5,2422,1195,-30
97231312329,97231312345,16,1630,941,-30
97235062947,97235062952,5,1588,918,-30
97240269947,97240269950,3,2328,1328,-30
97241629287,97241629294,7,2475,1131,-30
97245431086,97245431094,8,2099,1292,-30
97246906866,97246906873,7,1923,1108,-30
97248116607,97248116613,6,2250,1542,-30
97249045397,97249045402,5,1571,574,-30
97249654726,97249654736,10,2031,1009,-30
97254579123,97254579131,8,3595,1036,-30
97255316489,97255316492,3,1310,1378,-30
97258824208,97258824211,3,2219,1558,-30
97261267546,97261267552,6,2229,1044,-30
97265525048,97265525051,3,1860,1491,-30
97266457762,97266457768,6,3441,1387,-30
97269035873,97269035878,5,2705,1441,-30
97269085301,97269085303,2,1728,1048,-30
97269525499,97269525482,-17,768,456,-30
97270805490,97270805486,-4,2262,5148,-30
97272373614,97272373618,4,2767,1607,-30
97273390687,97273390692,5,2012,1262,-30
97274219417,97274219421,4,1654,1122,-30
97280284482,97280284487,5,4263,2400,-30
97281582103,97281582108,5,1984,1564,-30
97281859049,97281859053,4,2133,1082,-30
97285461363,97285461366,3,851,661,-30
97286590022,97286590027,5,2739,1246,-30
97287039138,97287039140,2,3263,1627,-30
97287543965,97287543978,13,1706,1499,-30
97293032514,97293032520,6,2681,993,-30
97294997755,97294997752,-3,2122,4021,-30
97301078736,97301078734,-2,2456,4179,-30
97305181265,97305181270,5,2652,1546,-30
97305210419,97305210423,4,2139,1647,-30
97309704245,97309704250,5,1956,1132,-30
97313302133,97313302138,5,2178,1576,-30
97313814569,97313814575,6,1896,1253,-30
97315237422,97315237429,7,2690,1553,-30
97319454602,97319454608,6,1675,1334,-30
97325192058,97325192062,4,1894,1578,-30
97325827790,97325827795,5,2482,1113,-30
97326401036,97326401041,5,1619,1122,-30
97326900934,97326900940,6,2078,1605,-30
97327221101,97327221123,22,2073,1313,-30
97330133065,97330133067,2,2494,1559,-30
97334611385,97334611391,6,1850,1464,-30
97334943798,97334943803,5,1996,1259,-30
97336312949,97336312953,4,1434,1263,-30
97337892830,97337892834,4,2413,1123,-30
97338262558,97338262563,5,1843,860,-30
97339742295,97339742302,7,3165,1412,-30
97359615095,97359615098,3,3619,2519,-30
97360338704,97360338697,-7,2603,9566,-30
97360709957,97360709960,3,2699,1301,-30
97362317963,97362317963,0,1142,1191,-30
97362619238,97362619241,3,1572,1314,-30
97370308703,97370308708,5,2636,1526,-30
97373202139,97373202143,4,2727,1174,-30
97374251614,97374251634,20,1850,1009,-30
97374939511,97374939488,-23,1531,696,-30
97376140475,97376140478,3,2027,1200,-30
97378008998,97378009001,3,2132,1317,-30
97378177858,97378177859,1,2157,2404,-30
97384955207,97384955188,-19,1966,921,-30
97388181709,97388181715,6,3420,1332,-30
97389597206,97389597209,3,1565,1213,-30
97389682426,97389682431,5,2829,1663,-30
97390769897,97390769893,-4,1515,2723,-30
97393688850,97393688857,7,2789,1714,-30
97396279706,97396279710,4,2628,1711,-30
97397078763,97397078766,3,1023,863,-30
97397328159,97397328166,7,2913,1802,-30
97399174630,97399174634,4,2417,1337,-30
97404443589,97404443595,6,1995,835,-30
97405657835,97405657842,7,2222,1697,-30
97406185268,97406185270,2,2279,1226,-30
97408847398,97408847402,4,1463,1042,-30
97409967014,97409967021,7,1831,1308,-30
97410349890,97410349895,5,1737,1305,-30
97412107006,97412107011,5,2247,1308,-30
97413794766,97413794773,7,2082,889,-30
97414241465,97414241472,7,2955,1113,-30
97416453280,97416453275,-5,2122,7649,-30
97416795605,97416795611,6,2485,1566,-30
97420481540,97420481544,4,2209,1667,-30
97421632490,97421632493,3,1176,488,-30
97428191037,97428191042,5,2934,1243,-30
97428329983,97428329987,4,1983,1383,-30
97428835455,97428835460,5,1279,1793,-30
97431933105,97431933111,6,1739,1234,-30
97433135546,97433135550,4,2595,1410,-30
97439538253,97439538258,5,1201,953,-30
97443887770,97443887777,7,1717,1170,-30
97444577906,97444577910,4,2542,1538,-30
97444783811,97444783817,6,1977,1469,-30
97444958048,97444958053,5,2833,1647,-30
97445032167,97445032173,6,2142,1284,-30
97446742528,97446742533,5,2919,1594,-30
97448403295,97448403299,4,2288,1345,-30
97451334855,97451334860,5,1789,1140,-30
97451485482,97451485476,-6,22993,15763,-30
97453748265,97453748271,6,1472,935,-30
97455393992,97455393998,6,1927,888,-30
97458584614,97458584619,5,2366,1293,-30
97458624612,97458624615,3,4014,3160,-30
97464316561,97464316554,-7,2066,10059,-30
97464524590,97464524595,5,1948,1317,-30
97465509535,97465509539,4,2142,1077,-30
97466663310,97466663314,4,2216,1145,-30
97466874461,97466874442,-19,761,640,-30
97467728706,97467728711,5,2063,984,-30
97468240699,97468240703,4,2178,1220,-30
97469606058,97469606061,3,1752,1227,-30
97469997954,97469997958,4,1796,1082,-30
97473337810,97473337814,4,3081,1870,-30
97479637341,97479637345,4,1346,1125,-30
97481407080,97481407083,3,2469,874,-30
97485837034,97485837038,4,2451,1032,-30
97489628287,97489628291,4,1741,1280,-30
97489775271,97489775278,7,2358,1417,-30
97491088418,97491088425,7,2377,1186,-30
97494208809,97494208788,-21,2161,1072,-30
97496006649,97496006654,5,2549,1080,-30
97497917305,97497917310,5,2068,1076,-30
97502162485,97502162490,5,2130,850,-30
97504620034,97504620042,8,1776,1389,-30
97505431846,97505431850,4,2210,1234,-30
97509538149,97509538155,6,2245,1794,-30
97518411076,97518411082,6,4316,1933,-30
97524272957,97524272962,5,2138,1054,-30
97525259106,97525259113,7,2735,1183,-30
97525519142,97525519146,4,1738,1382,-30
97526829681,97526829686,5,1515,932,-30
97531127588,97531127593,5,2514,1518,-30
97533338683,97533338688,5,2414,1426,-30
97534631192,97534631192,0,3232,5130,-30
97535532943,97535532946,3,1821,913,-30
97537390982,97537390987,5,1775,1049,-30
97537850101,97537850098,-3,1177,3310,-30
97543527770,97543527774,4,2667,1446,-30
97544235502,97544235507,5,1545,1870,-30
97545423299,97545423301,2,1739,944,-30
97545584243,97545584249,6,1606,1405,-30
97553476354,97553476362,8,1985,1211,-30
97555365315,97555365321,6,1962,1138,-30
97557588423,97557588427,4,1435,1319,-30
97559874378,97559874383,5,2559,1511,-30
97564418610,97564418615,5,2155,1331,-30
97564659123,97564659114,-9,687,326,-30
97566716379,97566716376,-3,2702,4212,-30
97567094266,97567094270,4,2863,2144,-30
97567860723,97567860730,7,2415,1407,-30
97568625925,97568625930,5,3184,1612,-30
97569358222,97569358226,4,3018,1419,-30
97571623411,97571623411,0,1617,1254,-30
97571851525,97571851530,5,1568,987,-30
97573689689,97573689692,3,2034,1651,-30
97577159561,97577159566,5,1585,1271,-30
97577556443,97577556446,3,1819,1193,-30
97580230624,97580230627,3,977,746,-30
97589597818,97589597822,4,1858,851,-30
97594710915,97594710919,4,1347,972,-30
97597300403,97597300407,4,2109,1598,-30
97597645635,97597645641,6,2925,1300,-30
97599412396,97599412403,7,3465,1228,-30
97600619548,97600619553,5,2329,910,-30
97602245871,97602245876,5,1660,1278,-30
97602590436,97602590441,5,1971,1383,-30
97603871520,97603871524,4,1758,1535,-30
97603999880,97603999885,5,2552,899,-30
97605309427,97605309430,3,1796,1059,-30
97611277633,97611277638,5,1421,1095,-30
97611861955,97611861960,5,1611,1340,-30
97614926571,97614926577,6,2559,956,-30
97616198020,97616198023,3,2617,1387,-30
97618342054,97618342062,8,1933,765,-30
97619248136,97619248130,-6,1453,5332,-30
97619314065,97619314086,21,694,2813,-30
97624909798,97624909802,4,2254,1462,-30
97626376191,97626376195,4,2171,900,-30
97627646670,97627646676,6,2122,1295,-30
97629243857,97629243864,7,2568,1647,-30
97629462136,97629462142,6,1800,1337,-30
97632664901,97632664906,5,1705,1136,-30
97635514063,97635514067,4,1795,755,-30
97636720902,97636720906,4,1475,894,-30
97637997098,97637997102,4,1574,912,-30
97640905904,97640905910,6,3641,1512,-30
97648324489,97648324492,3,2838,1682,-30
97649303781,97649303785,4,1734,989,-30
97653045162,97653045158,-4,1696,4545,-30
97655240153,97655240158,5,2841,1117,-30
97655525322,97655525326,4,2424,1293,-30
97655904031,97655904035,4,2830,1593,-30
97656507981,97656507982,1,2855,3430,-30
97658922074,97658922081,7,2778,1433,-30
97659643498,97659643503,5,1953,1198,-30
97661083103,97661083109,6,1530,1132,-30
97662451406,97662451415,9,8905,26512,-30
97665000839,97665000845,6,2153,1444,-30
97667507587,97667507591,4,3098,1302,-30
97669108687,97669108686,-1,7157,12538,-30
97669960810,97669960815,5,2446,1059,-30
97671498672,97671498678,6,2583,1390,-30
97672380702,97672380707,5,1818,1390,-30
97674400248,97674400254,6,2415,1177,-30
97676850806,97676850810,4,1729,964,-30
97679280056,97679280063,7,3089,1662,-30
97680083108,97680083112,4,2708,1659,-30
97686582070,97686582074,4,1714,1211,-30
97688520234,97688520238,4,2614,1375,-30
97689884450,97689884442,-8,831,2989,-30
97693073477,97693073486,9,14904,25292,-30
97699395356,97699395366,10,10196,38348,-30
97707983573,97707983579,6,1546,746,-30
97709065232,97709065237,5,2102,1608,-30
97709117867,97709117870,3,2209,1128,-30
97711011722,97711011727,5,2656,1197,-30
97715531918,97715531922,4,1403,1596,-30
97719567617,97719567619,2,1653,1140,-30
97721150584,97721150586,2,1677,1382,-30
97723959150,97723959155,5,2355,1834,-30
97725759317,97725759323,6,2084,1719,-30
97727213850,97727213854,4,1323,1263,-30
97729554957,97729554962,5,1348,1458,-30
97730321217,97730321223,6,3018,1581,-30
97730411992,97730411985,-7,227,2860,-30
97736109758,97736109762,4,2260,1148,-30
97738928575,97738928579,4,1719,1279,-30
97742626225,97742626226,1,1265,1129,-30
97745089524,97745089526,2,1252,666,-30
97749619466,97749619471,5,1535,1027,-30
97756040394,97756040399,5,2810,1861,-30
97756488536,97756488541,5,2514,1419,-30
97759557114,97759557118,4,1808,999,-30
97760610354,97760610360,6,2187,1489,-30
97762206706,97762206711,5,1622,1031,-30
97763532443,97763532451,8,1747,1176,-30
97764180744,97764180748,4,2198,2017,-30
97766051706,97766051711,5,3006,1376,-30
97768507042,97768507046,4,1623,721,-30
97770222068,97770222074,6,1882,1505,-30
97774361838,97774361843,5,2831,1331,-30
97776900137,97776900148,11,1698,1059,-30
97779593976,97779593981,5,2580,1536,-30
97783328078,97783328083,5,1775,1339,-30
97789093866,97789093863,-3,23314,7795,-30
97791308868,97791308872,4,1457,937,-30
97796828036,97796828041,5,2604,1511,-30
97800265149,97800265154,5,1888,1817,-30
97800590914,97800590919,5,2607,1606,-30
97803282946,97803282952,6,2027,1544,-30
97803815404,97803815409,5,2810,1364,-30
97804227386,97804227390,4,1912,1316,-30
97804699100,97804699107,7,3856,1791,-30
97805336769,97805336776,7,2149,1186,-30
97805610385,97805610390,5,2134,1178,-30
97808960721,97808960726,5,1638,1161,-30
97811769465,97811769469,4,2179,1149,-30
97811874798,97811874803,5,897,529,-30
97813324591,97813324587,-4,1581,4361,-30
97814741112,97814741117,5,2294,1406,-30
97817589741,97817589747,6,1751,1169,-30
97818056078,97818056071,-7,1790,7032,-30
97822719154,97822719158,4,1051,1532,-30
97824446057,97824446060,3,1962,1637,-30
97824476121,97824476130,9,2279,1340,-30
97828204253,97828204250,-3,1254,2666,-30
97829193782,97829193787,5,2135,1246,-30
97834375155,97834375154,-1,1293,1265,-30
97836767261,97836767264,3,1765,1086,-30
97839264174,97839264179,5,2792,1580,-30
97840406541,97840406545,4,1835,1295,-30
97842562898,97842562903,5,2306,1825,-30
97844728977,97844728979,2,2542,1486,-30
97845078434,97845078438,4,1810,1337,-30
97848692198,97848692198,0,1488,2184,-30
97852806043,97852806047,4,1504,1461,-30
97852993546,97852993550,4,1309,1956,-30
97860761634,97860761638,4,2328,832,-30
97860989838,97860989843,5,2000,959,-30
97868746295,97868746300,5,1056,1253,-30
97869483687,97869483686,-1,1663,2565,-30
97870338300,97870338302,2,1509,955,-30
97871347017,97871347018,1,1697,1065,-30
97872856195,97872856198,3,2078,1234,-30
97873913296,97873913302,6,2148,1020,-30
97875420194,97875420199,5,2355,1182,-30
97876134090,97876134096,6,2654,1325,-30
97876637317,97876637321,4,2415,1232,-30
97877241602,97877241609,7,2179,988,-30
97877487039,97877487058,19,763,140,-30
97886721997,97886722002,5,1214,1070,-30
97887505379,97887505378,-1,2559,4878,-30
97900919701,97900919706,5,1562,994,-30
97909570882,97909570884,2,1868,1178,-30
97918665890,97918665895,5,3368,1412,-30
97923789882,97923789889,7,2487,1693,-30
97924040287,97924040293,6,2352,1176,-30
97927895944,97927895947,3,974,1423,-30
97928269998,97928270003,5,1731,1017,-30
97930026438,97930026438,0,1356,1497,-30
97930569494,97930569495,1,2326,3486,-30
97939833314,97939833320,6,2049,1380,-30
97942765811,97942765817,6,3059,1487,-30
97946847754,97946847755,1,1420,1519,-30
97948911478,97948911483,5,3042,1771,-30
97956189225,97956189218,-7,32242,7019,-30
97959834220,97959834225,5,2859,1905,-30
97961347562,97961347562,0,2871,3374,-30
97962088374,97962088379,5,1871,938,-30
97966485407,97966485411,4,1561,1351,-30
97968425194,97968425201,7,2699,991,-30
97969507213,97969507219,6,3531,1441,-30
97982185991,97982185995,4,3220,2266,-30
97983276405,97983276411,6,2485,1410,-30
97983934001,97983934004,3,1980,1150,-30
97985614644,97985614648,4,1701,1386,-30
97986713777,97986713778,1,1505,1477,-30
97987592305,97987592309,4,1984,1433,-30
97988562141,97988562146,5,2457,1380,-30
97990352697,97990352702,5,3122,1564,-30
97995419793,97995419797,4,1759,1088,-30
97996171949,97996171954,5,2813,1170,-30
97999831441,97999831446,5,2033,1324,-30
97999939821,97999939801,-20,3019,1240,-30
98002431673,98002431679,6,1966,1205,-30
98006601368,98006601374,6,2718,1528,-30
98008090969,98008090973,4,3410,1837,-30
98008689322,98008689325,3,1041,1382,-30
98010329262,98010329268,6,2168,1091,-30
98011747129,98011747134,5,1882,1283,-30
98013037592,98013037594,2,1877,1550,-30
98018098994,98018098996,2,1876,1282,-30
98023507183,98023507188,5,2121,998,-30
98024133656,98024133673,17,1257,1644,-30
98024340455,98024340436,-19,653,529,-30
98029919462,98029919467,5,1107,494,-30
98033554826,98033554833,7,3765,1576,-30
98038856208,98038856214,6,2675,1489,-30
98046317634,98046317614,-20,1218,528,-30
98046919077,98046919082,5,1988,1439,-30
98049452759,98049452750,-9,925,297,-30
98051287982,98051287986,4,1865,1259,-30
98058927034,98058927037,3,2979,1268,-30
98061569789,98061569780,-9,922,2598,-30
98061838281,98061838286,5,2035,1011,-30
98062315910,98062315910,0,2373,1157,-30
98065510273,98065510269,-4,1139,2372,-30
98067200789,98067200793,4,2726,1148,-30
98069598958,98069598963,5,3012,1736,-30
98080998277,98080998282,5,1260,1146,-30
98081607795,98081607809,14,1536,772,-30
98083136090,98083136093,3,1731,1569,-30
98083545655,98083545661,6,1586,729,-30
98083658834,98083658816,-18,1082,568,-30
98090415619,98090415626,7,1676,1014,-30
98091327777,98091327779,2,2116,1238,-30
98094120122,98094120127,5,957,692,-30
98094665586,98094665569,-17,1123,602,-30
98097264547,98097264553,6,2057,1412,-30
98098304021,98098304026,5,2535,1498,-30
98101372390,98101372395,5,1707,643,-30
98104000189,98104000194,5,2555,1308,-30
98107663818,98107663823,5,1603,1105,-30
98108078781,98108078782,1,1847,1083,-30
98111241909,98111241915,6,2420,1238,-30
98111472376,98111472379,3,1694,1212,-30
98113316164,98113316170,6,2014,1259,-30
98117385718,98117385720,2,2267,1332,-30
98118517285,98118517287,2,1102,611,-30
98119509042,98119509046,4,2700,1819,-30
98124135298,98124135302,4,1446,1601,-30
98125160858,98125160862,4,2522,1402,-30
98131548813,98131548818,5,2048,1361,-30
98133721446,98133721445,-1,1162,2416,-30
98134661137,98134661141,4,2230,1291,-30
98145974372,98145974378,6,1730,818,-30
98153644207,98153644210,3,1876,1462,-30
98154023656,98154023656,0,1238,1478,-30
98157245571,98157245576,5,2289,1509,-30
98159750800,98159750818,18,1471,3092,-30
98160677029,98160677035,6,2339,1510,-30
98160883847,98160883843,-4,830,1209,-30
98165261229,98165261234,5,2855,1569,-30
98165843414,98165843418,4,1860,1068,-30
98166266769,98166266754,-15,2455,1365,-30
98166889306,98166889313,7,3323,985,-30
98166955268,98166955290,22,2170,1577,-30
98168672798,98168672804,6,2664,1524,-30
98168862418,98168862425,7,1377,1406,-30
98171553229,98171553234,5,2261,1177,-30
98174287405,98174287410,5,2559,1599,-30
98176034564,98176034578,14,1738,1012,-30
98180191758,98180191763,5,2084,1152,-30
98180391418,98180391422,4,1575,1308,-30
98185801968,98185801972,4,2342,1316,-30
98187016525,98187016531,6,1817,1283,-30
98188629581,98188629560,-21,1282,864,-30
98192182015,98192182018,3,2046,1265,-30
98193792846,98193792851,5,2819,2036,-30
98193944029,98193944033,4,2383,1238,-30
98197232331,98197232334,3,1627,1236,-30
98203198323,98203198327,4,1876,1211,-30
98204856427,98204856433,6,3440,1930,-30
98206788225,98206788229,4,2029,1221,-30
98215232642,98215232623,-19,692,431,-30
98215818829,98215818835,6,2507,1157,-30
98216304635,98216304642,7,2353,1124,-30
98220630639,98220630645,6,2185,1140,-30
98224263951,98224263957,6,2630,1524,-30
98225484302,98225484290,-12,19428,14747,-30
98227921586,98227921592,6,2260,1036,-30
98240413509,98240413514,5,2021,1416,-30
98241523196,98241523201,5,2064,1403,-30
98244151631,98244151637,6,1486,1482,-30
98244535136,98244535139,3,2363,2129,-30
98244870762,98244870769,7,2205,1219,-30
98246924070,98246924073,3,1520,1726,-30
98248906225,98248906230,5,3503,1909,-30
98251322538,98251322543,5,3171,1221,-30
98252685507,98252685513,6,2335,1080,-30
98253352534,98253352538,4,3003,1457,-30
98253434518,98253434500,-18,1789,1546,-30
98253905005,98253905023,18,18543,54412,-30
98254087708,98254087711,3,1416,1200,-30
98257971969,98257971975,6,2398,1143,-30
98259137545,98259137550,5,2155,1351,-30
98259735238,98259735254,16,7277,53118,-30
98260995857,98260995859,2,1050,861,-30
98263594065,98263594070,5,1612,1179,-30
98264273632,98264273614,-18,2336,1230,-30
98264862658,98264862664,6,2702,1359,-30
98267818697,98267818700,3,1575,1355,-30
98277864337,98277864341,4,1508,1053,-30
98284923000,98284923005,5,2217,1213,-30
98285917003,98285917007,4,2739,1455,-30
98286158140,98286158137,-3,907,2280,-30
98287947310,98287947314,4,1820,1401,-30
98292495804,98292495810,6,1909,834,-30
98293260249,98293260233,-16,1395,755,-30
98293584194,98293584199,5,1883,1057,-30
98297935043,98297935046,3,2843,1671,-30
98300597113,98300597119,6,1924,1438,-30
98301685906,98301685910,4,2135,1154,-30
98303072023,98303072028,5,2875,1714,-30
98303683597,98303683601,4,1692,952,-30
98304366705,98304366709,4,2236,1534,-30
98307532162,98307532169,7,2199,1309,-30
98308939982,98308939986,4,1472,1665,-30
98311636794,98311636801,7,2879,1643,-30
98314029125,98314029131,6,2835,1200,-30
98314280265,98314280272,7,12584,25764,-30
98314670640,98314670643,3,2033,1438,-30
98315218003,98315217998,-5,1217,2956,-30
98317106806,98317106810,4,1938,948,-30
98320519162,98320519165,3,1117,1147,-30
98321673280,98321673284,4,2773,1500,-30
98322313050,98322313055,5,2043,1700,-30
98327657793,98327657799,6,2315,1410,-30
98328329443,98328329449,6,2552,1690,-30
98330952138,98330952129,-9,1674,2388,-30
98332911990,98332911997,7,2421,1300,-30
98333593169,98333593175,6,1195,1102,-30
98334014629,98334014650,21,691,640,-30
98335889665,98335889667,2,1577,1101,-30
98337482818,98337482825,7,1401,1489,-30
98349815142,98349815141,-1,1240,1824,-30
98350695620,98350695621,1,1110,1810,-30
98352915889,98352915894,5,2258,1478,-30
98354306936,98354306942,6,2265,1734,-30
98355821089,98355821095,6,1833,1141,-30
98356405269,98356405273,4,1122,167,-30
98359487669,98359487674,5,2388,1654,-30
98360086382,98360086388,6,2911,1728,-30
98360662479,98360662457,-22,881,467,-30
98361264969,98361264974,5,1489,935,-30
98362009950,98362009955,5,2109,1029,-30
98363156542,98363156546,4,2417,1488,-30
98364690061,98364690060,-1,1218,2006,-30
98367464445,98367464449,4,3338,1224,-30
98368337695,98368337699,4,2114,1419,-30
98369068090,98369068098,8,2928,917,-30
98371779549,98371779553,4,2716,1128,-30
98372252731,98372252734,3,1846,1714,-30
98373909509,98373909504,-5,2154,5819,-30
98375185009,98375185007,-2,1182,1088,-30
98375859814,98375859821,7,3246,1359,-30
98379672795,98379672798,3,2511,1375,-30
98380667238,98380667244,6,2985,1616,-30
98383275843,98383275847,4,1542,1011,-30
98386782182,98386782186,4,2930,1088,-30
98387011729,98387011747,18,965,304,-30
98389520386,98389520390,4,2173,1240,-30
98389927065,98389927064,-1,729,316,-30
98390597495,98390597493,-2,7667,14466,-30
98392736548,98392736553,5,2551,1326,-30
98395545448,98395545454,6,2222,1705,-30
98395946578,98395946582,4,2519,1042,-30
98398474425,98398474431,6,2227,1032,-30
98405603302,98405603304,2,2074,1864,-30
98411196520,98411196525,5,2653,1419,-30
98414215033,98414215033,0,1309,2457,-30
98429029511,98429029514,3,1576,1702,-30
98432460309,98432460314,5,2749,1432,-30
98435101789,98435101795,6,2417,1010,-30
98435294435,98435294441,6,2196,1146,-30
98436815949,98436815951,2,2172,1020,-30
98445142241,98445142246,5,1733,704,-30
98445951130,98445951134,4,956,1521,-30
98446030975,98446030979,4,1799,698,-30
98451151345,98451151349,4,1341,904,-30
98451774245,98451774265,20,2973,1278,-30
98454376763,98454376766,3,2760,1283,-30
98456337229,98456337230,1,9917,13866,-30
98456558037,98456558043,6,1614,1033,-30
98458914421,98458914426,5,2698,1015,-30
98459405816,98459405821,5,1887,1223,-30
98461705893,98461705899,6,3269,1166,-30
98462381242,98462381246,4,2125,967,-30
98463893221,98463893217,-4,3521,11999,-30
98464373510,98464373515,5,711,311,-30
98464652537,98464652542,5,2139,1019,-30
98465191049,98465191054,5,1869,942,-30
98465489797,98465489780,-17,2340,1302,-30
98471263052,98471263060,8,2488,1089,-30
98474460420,98474460425,5,1956,1120,-30
98477773518,98477773532,14,412,2310,-30
98479062259,98479062265,6,3185,1795,-30
98480731938,98480731943,5,1981,1427,-30
98481471222,98481471226,4,1295,965,-30
98482971271,98482971276,5,2187,1718,-30
98483073975,98483073968,-7,522,128,-30
98483857097,98483857102,5,2011,1515,-30
98487814206,98487814211,5,2649,1104,-30
98488166955,98488166958,3,2023,1905,-30
98488784738,98488784743,5,3267,1829,-30
98491355268,98491355273,5,2186,1420,-30
98494797286,98494797292,6,2642,1050,-30
98505891727,98505891734,7,2562,1228,-30
98506370927,98506370934,7,2292,904,-30
98506468588,98506468593,5,2285,1500,-30
98507946226,98507946229,3,2318,1431,-30
98508074330,98508074312,-18,2168,1387,-30
98508821264,98508821268,4,2160,1309,-30
98508984776,98508984780,4,2820,1210,-30
98510766147,98510766141,-6,861,3047,-30
98511840861,98511840867,6,3596,1595,-30
98512747331,98512747335,4,1778,1166,-30
98513948191,98513948168,-23,781,203,-30
98515019310,98515019314,4,1966,1426,-30
98515970982,98515970989,7,2152,1364,-30
98516624632,98516624630,-2,1821,2049,-30
98518292128,98518292131,3,2030,1478,-30
98521053075,98521053079,4,2435,1309,-30
98527079865,98527079871,6,2203,1285,-30
98530156567,98530156565,-2,2128,2618,-30
98531133416,98531133419,3,1776,1074,-30
98531697831,98531697835,4,2202,1563,-30
98534753362,98534753367,5,2878,1918,-30
98536952813,98536952818,5,3236,2052,-30
98537543462,98537543467,5,2047,1554,-30
98537570939,98537570934,-5,2451,6934,-30
98537950053,98537950059,6,2270,1209,-30
98540084553,98540084558,5,1958,1153,-30
98545487827,98545487833,6,3316,1720,-30
98545736355,98545736357,2,1938,1715,-30
98546179633,98546179636,3,1998,1236,-30
98548174945,98548174946,1,1952,1541,-30
98549417745,98549417749,4,2527,1258,-30
98551251221,98551251226,5,2326,1702,-30
98556013223,98556013227,4,1870,1225,-30
98556500709,98556500713,4,2801,1191,-30
98558771333,98558771339,6,2123,921,-30
98559142314,98559142323,9,1896,1215,-30
98559781979,98559781985,6,2295,1177,-30
98561184987,98561184991,4,2074,1507,-30
98563809683,98563809688,5,1778,1706,-30
98564386305,98564386310,5,1535,522,-30
98571810425,98571810432,7,2090,1504,-30
98577756257,98577756261,4,3164,1655,-30
98579176322,98579176323,1,2250,1226,-30
98591046482,98591046487,5,2287,1319,-30
98591881173,98591881178,5,1938,1468,-30
98592728014,98592728021,7,2158,1643,-30
98594420139,98594420144,5,1721,1295,-30
98600598497,98600598503,6,2302,1158,-30
98600858202,98600858207,5,1986,894,-30
98602640433,98602640438,5,2008,1462,-30
98612870158,98612870162,4,1730,1304,-30
98614563753,98614563758,5,1326,1188,-30
98621402861,98621402862,1,1779,2958,-30
98622364693,98622364698,5,1869,1386,-30
98623444498,98623444502,4,1917,1278,-30
98624166650,98624166632,-18,2270,1258,-30
98627564050,98627564029,-21,389,6015,-30
98629484246,98629484250,4,2698,1649,-30
98633349934,98633349938,4,2321,1196,-30
98645768254,98645768259,5,3127,1447,-30
98657728353,98657728357,4,2225,1040,-30
98659149426,98659149431,5,2664,1478,-30
98661235814,98661235822,8,6965,2858,-30
98661323566,98661323574,8,3467,1250,-30
98664739939,98664739943,4,2512,1273,-30
98665941574,98665941578,4,1880,1585,-30
98668028683,98668028686,3,1854,1050,-30
98670717279,98670717286,7,2388,1167,-30
98674999914,98674999919,5,2781,1391,-30
98676952621,98676952625,4,2232,1184,-30
98680215047,98680215044,-3,1625,4862,-30
98680755569,98680755573,4,3028,1783,-30
98682109860,98682109863,3,1923,1473,-30
98684760007,98684760007,0,1828,2713,-30
98685496937,98685496942,5,2035,1406,-30
98685599451,98685599451,0,21586,19617,-30
98689429173,98689429178,5,1728,1439,-30
98691412702,98691412700,-2,1666,4253,-30
98693303961,98693303957,-4,1427,2531,-30
98694357327,98694357330,3,1900,1277,-30
98697719982,98697719987,5,2714,990,-30
98702636983,98702636982,-1,1809,3394,-30
98705955319,98705955326,7,2459,1618,-30
98707036209,98707036208,-1,34010,56777,-30
98719066746,98719066751,5,9890,4603,-30
98719471270,98719471274,4,2049,1748,-30
98720176634,98720176639,5,1206,846,-30
98722410893,98722410898,5,1997,1042,-30
98722971329,98722971334,5,2131,1302,-30
98726962639,98726962644,5,3321,1520,-30
98727796481,98727796474,-7,1150,3204,-30
98732124543,98732124547,4,2978,1291,-30
98734852036,98734852041,5,2124,1611,-30
98738376075,98738376079,4,1666,1045,-30
98738774217,98738774221,4,2980,1990,-30
98739996420,98739996413,-7,3333,8825,-30
98741378890,98741378895,5,2521,1752,-30
98752960696,98752960701,5,2349,1033,-30
98755314926,98755314931,5,3072,1229,-30
98756587473,98756587478,5,4076,2207,-30
98757248073,98757248076,3,2169,1197,-30
98759772590,98759772594,4,1448,1381,-30
98759922618,98759922619,1,1858,1799,-30
98760765065,98760765070,5,1358,1177,-30
98762761800,98762761806,6,3317,1215,-30
98771174152,98771174156,4,2569,1297,-30
98774075466,98774075463,-3,1531,2321,-30
98777938702,98777938708,6,2164,1653,-30
98778672198,98778672203,5,2519,1191,-30
98781618706,98781618712,6,1543,510,-30
98784944842,98784944845,3,2022,1361,-30
98787773592,98787773597,5,2114,1232,-30
98790016815,98790016819,4,2565,1385,-30
98790392497,98790392503,6,1687,1027,-30
98791664066,98791664044,-22,264,673,-30
98794868050,98794868054,4,2889,2026,-30
98798529035,98798529039,4,1589,1330,-30
98800146889,98800146895,6,3090,1229,-30
98802185258,98802185262,4,2248,1528,-30
98806289298,98806289303,5,2953,1074,-30
98807032209,98807032212,3,1704,1091,-30
98814049166,98814049170,4,2085,1231,-30
98815343270,98815343280,10,2275,1101,-30
98816099005,98816099007,2,2196,1091,-30
98830791628,98830791631,3,1097,1244,-30
98834200590,98834200597,7,2296,1490,-30
98837283154,98837283159,5,2326,1180,-30
98838559846,98838559849,3,2097,1446,-30
98839118712,98839118717,5,2987,1503,-30
98842954960,98842954965,5,2076,1791,-30
98846132578,98846132582,4,1613,986,-30
98846256462,98846256444,-18,1368,1294,-30
98847689557,98847689557,0,1563,2750,-30
98848607677,98848607681,4,1503,1385,-30
98851359826,98851359830,4,2262,905,-30
98852601829,98852601837,8,2930,1182,-30
98853034454,98853034435,-19,1089,549,-30
98853487786,98853487791,5,1715,1049,-30
98854704185,98854704189,4,2684,1511,-30
98857212527,98857212531,4,1956,1121,-30
98857831634,98857831639,5,3325,1619,-30
98863714759,98863714763,4,2251,1494,-30
98866829938,98866829944,6,1987,1334,-30
98867103798,98867103810,12,1369,1189,-30
98869776353,98869776356,3,1872,1272,-30
98870403705,98870403707,2,1532,1048,-30
98873757241,98873757247,6,2207,1567,-30
98876968157,98876968162,5,2119,1129,-30
98877138508,98877138492,-16,2498,898,-30
98877207365,98877207369,4,2439,1561,-30
98877943767,98877943771,4,1963,1357,-30
98880683861,98880683867,6,1593,947,-30
98881406057,98881406061,4,1863,1302,-30
98882749868,98882749874,6,2382,946,-30
98885939547,98885939552,5,1830,1244,-30
98886320903,98886320909,6,2555,1099,-30
98886597613,98886597618,5,3091,1960,-30
98889410883,98889410889,6,2655,1066,-30
98889722422,98889722427,5,2085,1216,-30
98890028170,98890028174,4,2313,1005,-30
98890395399,98890395405,6,2112,1343,-30
98894990891,98894990898,7,2203,920,-30
98895535157,98895535162,5,1851,843,-30
98899749081,98899749085,4,2018,1981,-30
98900939794,98900939801,7,1637,1007,-30
98905718565,98905718568,3,2276,2369,-30
98907978301,98907978309,8,15347,34784,-30
98909872083,98909872087,4,2320,1560,-30
98912814330,98912814323,-7,2621,10635,-30
98912856629,98912856633,4,2170,1527,-30
98912987505,98912987510,5,2695,1520,-30
98914026773,98914026778,5,1921,1156,-30
98914911031,98914911035,4,2155,1621,-30
98915455742,98915455746,4,1460,708,-30
98915658446,98915658445,-1,1509,2317,-30
98920349085,98920349089,4,1631,1275,-30
98922113978,98922113985,7,2113,1475,-30
98926715671,98926715674,3,1698,1136,-30
98926790593,98926790579,-14,534,353,-30
98929458715,98929458709,-6,950,3893,-30
98931239430,98931239436,6,1653,1014,-30
98932514993,98932514998,5,2073,1243,-30
98937318393,98937318397,4,2058,1018,-30
98937936744,98937936749,5,3242,1929,-30
98938136627,98938136632,5,1953,1526,-30
98939164727,98939164726,-1,919,1194,-30
98939536561,98939536566,5,2593,1717,-30
98944412374,98944412378,4,2115,1159,-30
98944866182,98944866186,4,1987,1280,-30
98946233629,98946233635,6,2374,1163,-30
98952627683,98952627690,7,2037,1513,-30
98957903689,98957903695,6,1963,1031,-30
98960458205,98960458209,4,3132,1715,-30
98961508938,98961508942,4,2730,2300,-30
98963615995,98963616002,7,3200,1358,-30
98966894933,98966894938,5,2034,1463,-30
98973434578,98973434581,3,1669,1566,-30
98983203866,98983203868,2,927,837,-30
98984047701,98984047706,5,2115,1102,-30
98987841581,98987841585,4,1964,1888,-30
98988423537,98988423542,5,2166,1233,-30
98995263677,98995263683,6,2950,1428,-30
98996499821,98996499825,4,2524,2216,-30
98997281646,98997281650,4,2065,1433,-30
99002158705,99002158709,4,1884,1346,-30
99016944762,99016944766,4,2174,1324,-30
99017263340,99017263345,5,3652,1407,-30
99018549085,99018549090,5,1992,1239,-30
99018742108,99018742114,6,1938,940,-30
99021877924,99021877930,6,2998,1115,-30
99024279497,99024279503,6,2444,1370,-30
99027904098,99027904102,4,1990,1258,-30
99036157685,99036157691,6,2223,1194,-30
99038356321,99038356326,5,2184,1351,-30
99039875577,99039875581,4,1431,977,-30
99040396067,99040396070,3,1929,1201,-30
99042818042,99042818048,6,2707,1436,-30
99044687314,99044687321,7,2486,1386,-30
99044876086,99044876086,0,1605,2450,-30
99046287994,99046288003,9,2673,1078,-30
99052138578,99052138582,4,1819,1193,-30
99052425409,99052425403,-6,877,156,-30
99055293682,99055293687,5,2794,1434,-30
99060526792,99060526797,5,2330,1207,-30
99063707043,99063707049,6,2350,1402,-30
99064546965,99064546971,6,2156,28237,-30
99064604305,99064604308,3,1521,955,-30
99069959538,99069959535,-3,1303,2925,-30
99070520798,99070520803,5,982,585,-30
99071218026,99071218026,0,1036,264,-30
99072224887,99072224894,7,1314,871,-30
99072726101,99072726105,4,1738,932,-30
99073239439,99073239446,7,2685,1280,-30
99074778176,99074778178,2,1099,763,-30
99084883766,99084883771,5,1655,1036,-30
99087986146,99087986150,4,2115,1893,-30
99088125846,99088125851,5,1317,1230,-30
99090184188,99090184189,1,1307,806,-30
99090602302,99090602301,-1,1252,2243,-30
99096316225,99096316229,4,1573,1340,-30
99096667767,99096667755,-12,3062,1060,-30
99099082185,99099082190,5,2414,1119,-30
99100452003,99100452006,3,1909,1289,-30
99102373249,99102373253,4,1786,1058,-30
99103363693,99103363698,5,1642,1142,-30
99104633137,99104633144,7,2442,1718,-30
99108207210,99108207217,7,5730,3136,-30
99109260185,99109260183,-2,1328,2324,-30
99110918209,99110918215,6,904,745,-30
99114032902,99114032907,5,2023,1433,-30
99116302573,99116302575,2,1610,1252,-30
99118507088,99118507093,5,2209,1539,-30
99119331336,99119331341,5,2848,999,-30
99121114231,99121114238,7,22837,53211,-30
99132993014,99132993019,5,1776,1271,-30
99134918906,99134918910,4,2131,1466,-30
99139565238,99139565241,3,2269,1089,-30
99143418871,99143418863,-8,921,4267,-30
99145750590,99145750596,6,1620,1202,-30
99150538014,99150538020,6,2137,993,-30
99155146238,99155146235,-3,930,1455,-30
99155394161,99155394167,6,2863,1312,-30
99155439942,99155439947,5,2242,1247,-30
99156129802,99156129805,3,2818,1247,-30
99156426866,99156426849,-17,2287,1143,-30
99157449569,99157449573,4,2666,1373,-30
99157761041,99157761046,5,1541,1147,-30
99158850156,99158850160,4,2241,1491,-30
99161695552,99161695556,4,2413,1396,-30
99162236398,99162236403,5,2280,1256,-30
99162969745,99162969750,5,2755,1328,-30
99166817062,99166817069,7,3400,1744,-30
99170260913,99170260917,4,1812,1406,-30
99170935736,99170935739,3,2620,1253,-30
99173713109,99173713114,5,2491,1293,-30
99174298221,99174298226,5,2043,891,-30
99174619630,99174619609,-21,2259,858,-30
99182305546,99182305552,6,2614,1358,-30
99183567114,99183567120,6,2735,1476,-30
99183644298,99183644304,6,1791,1339,-30
99183727868,99183727866,-2,1287,1334,-30
99190243400,99190243406,6,1502,1158,-30
99191529603,99191529609,6,3424,1111,-30
99193402111,99193402117,6,2198,1345,-30
99195141273,99195141279,6,3692,1641,-30
99203183037,99203183042,5,2640,1440,-30
99203410208,99203410215,7,1792,883,-30
99204521813,99204521816,3,8350,21070,-30
99217418138,99217418142,4,2542,1237,-30
99219007846,99219007850,4,2058,1431,-30
99220059079,99220059086,7,3030,922,-30
99221550149,99221550156,7,1964,1303,-30
99225257509,99225257517,8,1689,629,-30
99226855769,99226855774,5,2312,1331,-30
99233258672,99233258677,5,2167,1383,-30
99238496561,99238496566,5,2309,1462,-30
99238781870,99238781851,-19,691,196,-30
99240636868,99240636870,2,1340,1939,-30
99242486051,99242486055,4,2098,1384,-30
99243228360,99243228362,2,1220,1014,-30
99246314806,99246314810,4,2898,1680,-30
99246986537,99246986535,-2,1218,2355,-30
99247991514,99247991521,7,2339,1265,-30
99248388341,99248388346,5,3182,1113,-30
99248557184,99248557190,6,2264,884,-30
99249396361,99249396365,4,2082,1460,-30
99250528762,99250528762,0,1193,688,-30
99253276516,99253276520,4,2967,1499,-30
99253502141,99253502145,4,2219,1156,-30
99256895822,99256895830,8,39712,2333,-30
99257972650,99257972654,4,1696,1548,-30
99258230349,99258230336,-13,942,592,-30
99259178786,99259178794,8,2859,1101,-30
99261325828,99261325835,7,3285,1176,-30
99264594969,99264594975,6,2028,806,-30
99265395918,99265395922,4,2367,1016,-30
99267084699,99267084702,3,1682,1185,-30
99267499451,99267499451,0,1605,2106,-30
99267904886,99267904891,5,3079,2018,-30
99269971042,99269971046,4,2207,1329,-30
99270774148,99270774153,5,2554,1083,-30
99276298066,99276298071,5,2068,1937,-30
99280338960,99280338966,6,1169,616,-30
99283222970,99283222975,5,1723,864,-30
99283292075,99283292082,7,1444,780,-30
99288869897,99288869903,6,2196,1783,-30
99294538948,99294538941,-7,1629,1170,-30
99294636842,99294636857,15,350,2214,-30
99299222313,99299222319,6,1307,923,-30
99299265461,99299265443,-18,2099,1776,-30
99302860989,99302860993,4,2246,1094,-30
99303837153,99303837159,6,2174,1424,-30
99304425342,99304425349,7,1185,1044,-30
99307070522,99307070527,5,2053,1022,-30
99307246687,99307246694,7,3564,1365,-30
99307475666,99307475675,9,2179,1353,-30
99314679226,99314679230,4,1413,1197,-30
99318404080,99318404086,6,1295,1108,-30
99321229351,99321229354,3,2133,1599,-30
99329703521,99329703529,8,3905,1347,-30
99330353272,99330353273,1,1680,1473,-30
99330706166,99330706145,-21,1642,1031,-30
99334110614,99334110620,6,2923,1585,-30
99337110210,99337110228,18,3168,1285,-30
99340118432,99340118435,3,1292,1106,-30
99342519918,99342519926,8,2741,866,-30
99343020003,99343020008,5,1165,733,-30
99344158418,99344158428,10,1615,935,-30
99345125862,99345125844,-18,1443,900,-30
99348537335,99348537341,6,1952,1238,-30
99351492452,99351492457,5,1998,1507,-30
99356189465,99356189471,6,4330,1664,-30
99357529777,99357529782,5,2715,1953,-30
99361145059,99361145059,0,1005,1362,-30
99361896858,99361896865,7,3280,1728,-30
99374891109,99374891114,5,3213,1320,-30
99376638328,99376638334,6,23255,16443,-30
99379431264,99379431282,18,1505,2364,-30
99381498474,99381498479,5,1673,718,-30
99383341802,99383341807,5,2400,1178,-30
99386226518,99386226522,4,2515,1295,-30
99389455774,99389455778,4,1845,1450,-30
99390785222,99390785224,2,1755,1906,-30
99392991769,99392991784,15,2633,1599,-30
99395061149,99395061154,5,1557,1149,-30
99395829002,99395829008,6,1890,948,-30
99397833553,99397833558,5,3676,1141,-30
99401447164,99401447171,7,2608,1229,-30
99414156738,99414156743,5,1644,935,-30
99414463069,99414463074,5,3407,1627,-30
99414587930,99414587935,5,3467,1760,-30
99414717369,99414717362,-7,742,4218,-30
99415378348,99415378351,3,1641,1047,-30
99417508264,99417508267,3,2059,1241,-30
99421843697,99421843703,6,2075,1353,-30
99422762951,99422762957,6,1740,983,-30
99429781349,99429781354,5,2014,783,-30
99431713623,99431713626,3,2072,1262,-30
99434382829,99434382833,4,2519,1751,-30
99435505086,99435505090,4,1371,1216,-30
99436640674,99436640681,7,2443,1357,-30
99436981406,99436981410,4,2193,1494,-30
99437601178,99437601162,-16,582,423,-30
99437975130,99437975135,5,2548,1874,-30
99441256657,99441256661,4,2612,1725,-30
99442663840,99442663842,2,1712,786,-30
99445919127,99445919131,4,2634,1236,-30
99446109058,99446109044,-14,1175,886,-30
99452371143,99452371147,4,2350,1413,-30
99452715279,99452715277,-2,2212,3961,-30
99454268054,99454268058,4,2742,1372,-30
99456198415,99456198415,0,1466,1107,-30
99460050156,99460050162,6,2147,1411,-30
99461597434,99461597438,4,2352,1330,-30
99470166650,99470166654,4,2615,1474,-30
99471422902,99471422907,5,2721,1442,-30
99475087118,99475087122,4,2552,1299,-30
99475851943,99475851930,-13,2049,788,-30
99477195006,99477195011,5,2702,1498,-30
99478919377,99478919382,5,2480,1796,-30
99480990439,99480990445,6,3246,1808,-30
99485815287,99485815286,-1,960,1354,-30
99485853574,99485853577,3,1736,1294,-30
99488200985,99488200989,4,1635,1346,-30
99489858310,99489858314,4,1938,1321,-30
99490135310,99490135296,-14,925,386,-30
99492748422,99492748426,4,1990,1263,-30
99502179712,99502179718,6,2626,1487,-30
99502925260,99502925266,6,7713,30777,-30
99503132503,99503132509,6,2182,913,-30
99503779777,99503779783,6,2758,1629,-30
99504850156,99504850157,1,2179,1999,-30
99504895711,99504895730,19,905,159,-30
99506449033,99506449035,2,889,1278,-30
99512183494,99512183498,4,1942,1047,-30
99514382841,99514382846,5,2078,1148,-30
99515811450,99515811448,-2,1632,2286,-30
99518751877,99518751882,5,2999,1247,-30
99518994540,99518994547,7,1978,1240,-30
99519028458,99519028464,6,1896,1256,-30
99519253961,99519253944,-17,687,286,-30
99522014383,99522014385,2,1475,1248,-30
99524367082,99524367088,6,1607,1287,-30
99524790274,99524790258,-16,1173,371,-30
99526337167,99526337170,3,1125,908,-30
99528890045,99528890048,3,1323,1733,-30
99531194531,99531194536,5,2359,835,-30
99531762061,99531762066,5,2546,1261,-30
99535655579,99535655581,2,1812,1516,-30
99539640566,99539640570,4,2110,898,-30
99541651464,99541651471,7,2203,1505,-30
99551593374,99551593378,4,2771,1562,-30
99553581470,99553581477,7,2812,1200,-30
99558616587,99558616593,6,2155,1481,-30
99559872149,99559872153,4,2410,1081,-30
99560165644,99560165650,6,3024,1597,-30
99563437922,99563437926,4,2174,1637,-30
99568575109,99568575113,4,2953,1647,-30
99571431745,99571431750,5,1916,1172,-30
99571942942,99571942949,7,2311,1485,-30
99571983398,99571983384,-14,1020,743,-30
99574984928,99574984932,4,2584,1724,-30
99576968066,99576968070,4,2134,1243,-30
99580489143,99580489149,6,2502,1184,-30
99584584218,99584584224,6,2541,1496,-30
99585617125,99585617130,5,1317,898,-30
99589106666,99589106667,1,1595,1175,-30
99592799857,99592799862,5,2148,1403,-30
99593831418,99593831422,4,1617,1356,-30
99599664982,99599664989,7,3007,1596,-30
99601831872,99601831877,5,4369,3671,-30
99607307865,99607307870,5,1771,1299,-30
99613668115,99613668121,6,2105,1449,-30
99613768684,99613768691,7,2425,1447,-30
99616884162,99616884166,4,1745,1612,-30
99621647576,99621647580,4,2369,1695,-30
99622696117,99622696122,5,1049,943,-30
99623881730,99623881735,5,2175,1439,-30
99626404570,99626404573,3,1756,980,-30
99629523704,99629523710,6,2070,921,-30
99637640706,99637640713,7,2846,1729,-30
99637739454,99637739458,4,1272,1009,-30
99640216928,99640216933,5,2504,1196,-30
99641279714,99641279720,6,1608,918,-30
99643675206,99643675201,-5,1475,4403,-30
99645390399,99645390379,-20,1274,733,-30
99646151534,99646151548,14,15910,25243,-30
99651880429,99651880434,5,2022,1795,-30
99652239866,99652239872,6,1737,946,-30
99657163860,99657163864,4,2208,1803,-30
99659694628,99659694633,5,1523,1221,-30
99660484835,99660484840,5,2359,1338,-30
99664467116,99664467121,5,2095,1566,-30
99665811629,99665811627,-2,1476,2592,-30
99666031286,99666031291,5,1566,347,-30
99669660325,99669660332,7,1578,1246,-30
99674797826,99674797830,4,2516,1159,-30
99675546942,99675546941,-1,1783,2215,-30
99676361172,99676361177,5,2238,1542,-30
99677232544,99677232549,5,2095,1316,-30
99678011918,99678011919,1,1885,842,-30
99679000374,99679000377,3,1592,1495,-30
99679732163,99679732166,3,2014,1125,-30
99684627377,99684627383,6,2504,1502,-30
99689413725,99689413729,4,2392,1739,-30
99697253494,99697253498,4,2720,1407,-30
99699388765,99699388770,5,2177,1578,-30
99700523797,99700523802,5,2261,1522,-30
99701033169,99701033175,6,2386,1304,-30
99701797567,99701797574,7,2210,1249,-30
99715160795,99715160801,6,2060,1399,-30
99716655510,99716655514,4,2211,1312,-30
99718609405,99718609409,4,2740,1288,-30
99718687665,99718687675,10,2037,923,-30
99721922492,99721922495,3,2195,1208,-30
99724087130,99724087131,1,1471,1237,-30
99725511918,99725511922,4,2673,1506,-30
99725538895,99725538873,-22,2493,972,-30
99731484886,99731484890,4,1012,929,-30
99735367311,99735367315,4,2204,1353,-30
99736195216,99736195221,5,2241,1106,-30
99743028234,99743028240,6,3244,2270,-30
99743361856,99743361861,5,2166,1074,-30
99743475700,99743475705,5,1371,1010,-30
99745749107,99745749113,6,4093,1714,-30
99748509341,99748509345,4,2250,1255,-30
99750483947,99750483953,6,1676,1387,-30
99751167655,99751167658,3,2245,1430,-30
99753135575,99753135582,7,2238,1155,-30
99754199624,99754199627,3,1866,1028,-30
99754785081,99754785085,4,1412,1522,-30
99755229156,99755229161,5,2166,1435,-30
99757341877,99757341880,3,3310,2686,-30
99758735403,99758735409,6,1996,928,-30
99761473614,99761473617,3,2626,1476,-30
99769062121,99769062128,7,2002,828,-30
99771101182,99771101190,8,2305,1498,-30
99771171363,99771171368,5,2244,1398,-30
99773572685,99773572690,5,3245,1569,-30
99778139366,99778139371,5,2163,1295,-30
99780890391,99780890397,6,3576,1131,-30
99781019572,99781019579,7,1845,1489,-30
99781292650,99781292656,6,2144,1066,-30
99781525760,99781525766,6,2969,1378,-30
99781621855,99781621834,-21,3892,3033,-30
99794079549,99794079554,5,2369,1178,-30
99794675306,99794675310,4,2669,1429,-30
99799407384,99799407389,5,2379,1914,-30
99801277047,99801277051,4,1192,741,-30
99808875944,99808875949,5,2289,1460,-30
99812511990,99812511994,4,2542,1219,-30
99813194977,99813194976,-1,2663,3656,-30
99815055769,99815055775,6,2496,1302,-30
99818538305,99818538309,4,3478,2179,-30
99819360718,99819360723,5,1526,1147,-30
99820803214,99820803219,5,2209,929,-30
99820964544,99820964549,5,2571,1871,-30
99823467040,99823467045,5,4757,2695,-30
99825913858,99825913863,5,2120,1355,-30
99826778246,99826778251,5,1600,1708,-30
99828686429,99828686435,6,3171,1536,-30
99833748766,99833748771,5,2721,1509,-30
99834077774,99834077779,5,4253,2666,-30
99836937778,99836937783,5,3078,1283,-30
99843461873,99843461878,5,684,551,-30
99845455187,99845455189,2,1273,749,-30
99847609709,99847609715,6,2249,1427,-30
99851463580,99851463586,6,3902,1682,-30
99852200765,99852200745,-20,2435,1447,-30
99855051074,99855051073,-1,1008,2029,-30
99856332454,99856332458,4,1967,1128,-30
99860476469,99860476452,-17,1254,1077,-30
99861992273,99861992276,3,1894,1937,-30
99862980391,99862980395,4,1098,796,-30
99864372798,99864372802,4,2045,1164,-30
99867155901,99867155910,9,1157,1147,-30
99867938586,99867938593,7,2493,1552,-30
99868131739,99868131745,6,1252,1036,-30
99872389041,99872389046,5,2622,1670,-30
99874678371,99874678375,4,1777,1091,-30
99877130927,99877130930,3,2456,1192,-30
99877946347,99877946353,6,2787,1371,-30
99879111643,99879111649,6,2555,1529,-30
99881506615,99881506619,4,953,605,-30
99882663470,99882663474,4,2069,1257,-30
99883996359,99883996363,4,2331,1294,-30
99889289493,99889289497,4,2339,1448,-30
99891572074,99891572079,5,976,782,-30
99893160654,99893160651,-3,954,2148,-30
99893272659,99893272663,4,2896,2090,-30
99893498219,99893498222,3,1701,1230,-30
99894277056,99894277062,6,2383,1166,-30
99894617549,99894617549,0,2130,2844,-30
99895080456,99895080461,5,2726,1454,-30
99900378776,99900378770,-6,4343,15083,-30
99900526994,99900527001,7,2480,1263,-30
99900685315,99900685331,16,1262,283,-30
99904016050,99904016056,6,1499,1120,-30
99910700495,99910700502,7,2850,1257,-30
99910859649,99910859642,-7,1424,166,-30
99912994086,99912994068,-18,2202,1042,-30
99913076807,99913076818,11,11362,41311,-30
99917038489,99917038495,6,2520,1533,-30
99919336334,99919336339,5,1074,621,-30
99920335195,99920335209,14,42723,14508,-30
99922306878,99922306885,7,10057,26756,-30
99923545350,99923545354,4,2352,1396,-30
99924057793,99924057776,-17,1046,427,-30
99925554351,99925554355,4,1871,1062,-30
99929602893,99929602897,4,1658,1096,-30
99930789534,99930789528,-6,1574,93,-30
99935765325,99935765330,5,2048,1302,-30
99936116267,99936116265,-2,1138,1948,-30
99937679082,99937679088,6,2255,1244,-30
99939722194,99939722198,4,2645,1107,-30
99941959934,99941959937,3,1585,872,-30
99942598198,99942598201,3,1655,1026,-30
99943593667,99943593671,4,1413,970,-30
99947814529,99947814535,6,3101,1488,-30
99948402277,99948402282,5,2374,1517,-30
99949095653,99949095659,6,3055,955,-30
99950381527,99950381532,5,3274,1193,-30
99952147105,99952147109,4,2018,1060,-30
99956534272,99956534278,6,2213,1161,-30
99957047595,99957047598,3,1900,1077,-30
99957216932,99957216912,-20,2412,1127,-30
99962049846,99962049850,4,2350,1511,-30
99962193039,99962193043,4,1956,868,-30
99963386217,99963386218,1,1379,1792,-30
99963452181,99963452185,4,1538,939,-30
99965287394,99965287395,1,1577,1349,-30
99966217318,99966217321,3,1827,1005,-30
99968090159,99968090165,6,2751,1133,-30
99970563334,99970563340,6,2069,821,-30
99971972846,99971972850,4,1907,1904,-30
99974623870,99974623874,4,2028,1230,-30
99974732780,99974732763,-17,1169,670,-30
99975254246,99975254251,5,2177,994,-30
99977212071,99977212077,6,2647,1512,-30
99977627470,99977627488,18,728,195,-30
99982941775,99982941778,3,1224,1121,-30
99983826006,99983826010,4,3200,1355,-30
99990158118,99990158122,4,2446,1487,-30
99991876041,99991876046,5,2391,1543,-30
99995988943,99995988950,7,2585,1798,-30
99998962838,99998962841,3,1046,1197,-30
100003239705,100003239710,5,1562,1372,-30
100010451023,100010451028,5,2354,1204,-30
100011972219,100011972223,4,2705,1153,-30
100012233553,100012233561,8,1781,1419,-30
100019221962,100019221966,4,2444,1281,-30
100020030362,100020030367,5,1975,1211,-30
100021278353,100021278338,-15,2202,1129,-30
100022799726,100022799731,5,2075,979,-30
100029678786,100029678791,5,1721,1001,-30
100029832679,100029832685,6,2033,1389,-30
100033000586,100033000594,8,17536,21652,-30
100035597330,100035597335,5,3257,1217,-30
100037987256,100037987276,20,1691,598,-30
100049284567,100049284575,8,3341,972,-30
100050670039,100050670042,3,2039,1635,-30
100051006781,100051006785,4,1742,1194,-30
100051584397,100051584395,-2,940,317,-30
100053457902,100053457907,5,1843,1180,-30
100054329727,100054329729,2,2048,1097,-30
100055442881,100055442886,5,1862,1294,-30
100055686431,100055686411,-20,2147,1676,-30
100055790103,100055790080,-23,2172,884,-30
100057649770,100057649775,5,2030,1406,-30
100057853113,100057853114,1,1963,2351,-30
100057919711,100057919718,7,3569,1118,-30
100060265355,100060265360,5,2021,1562,-30
100060819327,100060819333,6,2796,1884,-30
100062649355,100062649361,6,1873,1103,-30
100062850095,100062850076,-19,1469,965,-30
100064594091,100064594097,6,3367,1242,-30
100068237922,100068237927,5,2114,1479,-30
100068335238,100068335241,3,1072,408,-30
100070778961,100070778967,6,2672,1210,-30
100072823806,100072823809,3,1203,870,-30
100082982835,100082982839,4,2768,1267,-30
100084090885,100084090890,5,2397,1240,-30
100084378849,100084378854,5,2094,980,-30
100087301427,100087301423,-4,1600,2900,-30
100087442409,100087442415,6,2394,1082,-30
100088299093,100088299099,6,2056,906,-30
100089736038,100089736043,5,1880,1135,-30
100090412589,100090412594,5,1842,1268,-30
100095260809,100095260812,3,2130,1139,-30
100096922007,100096922010,3,2005,1130,-30
100102377681,100102377685,4,2330,1644,-30
100102746117,100102746122,5,2372,1167,-30
100105409478,100105409485,7,2609,1423,-30
100106760138,100106760142,4,1700,1324,-30
100107032889,100107032894,5,2674,1255,-30
100108194386,100108194390,4,1280,1137,-30
100109091959,100109091961,2,1171,969,-30
100115336638,100115336643,5,2481,1325,-30
100115816826,100115816831,5,1740,1208,-30
100120936438,100120936436,-2,1273,3349,-30
100124763749,100124763754,5,2803,1787,-30
100127062036,100127062041,5,2213,1177,-30
100128376397,100128376401,4,2145,1474,-30
100129541317,100129541323,6,2253,1010,-30
100131909927,100131909932,5,2407,1419,-30
100135655039,100135655034,-5,728,1834,-30
100136043757,100136043763,6,2334,1655,-30
100136854328,100136854333,5,2224,1518,-30
100141137490,100141137494,4,1929,987,-30
100143807926,100143807934,8,1002,716,-30
100150937685,100150937690,5,2301,1362,-30
100152296641,100152296647,6,1684,1105,-30
100161034038,100161034044,6,2103,1356,-30
100162278242,100162278247,5,2509,1410,-30
100162836862,100162836869,7,2616,1801,-30
100164454713,100164454716,3,2629,1613,-30
100165593134,100165593137,3,2173,1120,-30
100165639174,100165639193,19,1418,271,-30
100168230709,100168230716,7,3444,1909,-30
100169602550,100169602549,-1,2280,3630,-30
100173736887,100173736892,5,3272,2335,-30
100174801961,100174801966,5,2468,1330,-30
100175918038,100175918043,5,2324,1326,-30
100177706813,100177706819,6,1201,871,-30
100178177158,100178177163,5,2344,1741,-30
100179982757,100179982763,6,3132,1860,-30
100184018194,100184018199,5,2497,1085,-30
100188020241,100188020247,6,2059,1739,-30
100188186836,100188186841,5,2010,1295,-30
100192980308,100192980319,11,2974,1381,-30
100198965776,100198965782,6,1767,1545,-30
100200211941,100200211947,6,1785,706,-30
100200884070,100200884065,-5,1668,9395,-30
100201356463,100201356467,4,2196,1256,-30
100206922211,100206922215,4,3050,1568,-30
100209425046,100209425050,4,2169,1725,-30
100216248470,100216248475,5,1719,1231,-30
100217029395,100217029408,13,2540,1406,-30
100217634138,100217634138,0,1576,1845,-30
100222777223,100222777228,5,2906,1853,-30
100225244934,100225244939,5,1444,940,-30
100232033675,100232033682,7,2663,1019,-30
100235076759,100235076763,4,1777,868,-30
100238030355,100238030359,4,2050,1592,-30
100239837004,100239837010,6,2144,1737,-30
100257841716,100257841720,4,1602,1048,-30
100258644058,100258644061,3,2685,1752,-30
100259589678,100259589684,6,3583,1529,-30
100261845705,100261845709,4,1800,1393,-30
100262131935,100262131942,7,2890,1479,-30
100265274224,100265274229,5,3693,1750,-30
100266755773,100266755778,5,1940,1755,-30
100267274845,100267274826,-19,2314,1074,-30
100274101386,100274101392,6,2286,1169,-30
100275324830,100275324836,6,1676,1133,-30
100275828153,100275828138,-15,1462,412,-30
100280905021,100280905026,5,2698,1490,-30
100282348193,100282348198,5,2444,1373,-30
100289397947,100289397954,7,3830,1533,-30
100291937065,100291937069,4,2006,1017,-30
100293519445,100293519430,-15,1975,950,-30
100301312266,100301312270,4,2407,957,-30
100302550152,100302550155,3,2155,1079,-30
100304348406,100304348411,5,2752,1335,-30
100308497385,100308497390,5,2587,1550,-30
100314501352,100314501357,5,3120,1992,-30
100319186934,100319186934,0,1952,2830,-30
100319738303,100319738308,5,2358,1187,-30
100322012118,100322012121,3,2140,1508,-30
100322678708,100322678708,0,3507,3323,-30
100324463269,100324463276,7,2153,1400,-30
100325876693,100325876698,5,2423,1099,-30
100327704345,100327704346,1,35655,39683,-30
100333929169,100333929175,6,2078,1014,-30
100335914250,100335914253,3,1970,1384,-30
100336613814,100336613822,8,6261,2573,-30
100338173094,100338173099,5,1613,840,-30
100339017828,100339017833,5,1717,1083,-30
100346500882,100346500886,4,1875,1234,-30
100346772654,100346772632,-22,1228,520,-30
100356314053,100356314058,5,2676,1526,-30
100359533706,100359533711,5,2020,1020,-30
100363549548,100363549552,4,2457,1445,-30
100364353929,100364353925,-4,1239,3623,-30
100365566393,100365566391,-2,1604,1962,-30
100366213298,100366213305,7,3209,1443,-30
100368028789,100368028795,6,1726,1282,-30
100370046354,100370046361,7,2020,1462,-30
100371803059,100371803062,3,1809,746,-30
100375494195,100375494198,3,1584,1247,-30
100377385703,100377385710,7,2188,680,-30
100379417503,100379417509,6,2252,1244,-30
100379797134,100379797138,4,1762,1682,-30
100384844350,100384844357,7,1080,1209,-30
100395036586,100395036590,4,2744,1396,-30
100401010886,100401010892,6,2491,1437,-30
100402662877,100402662880,3,3715,3260,-30
100406601583,100406601587,4,2522,1377,-30
100408585346,100408585351,5,2656,1759,-30
100408817997,100408818001,4,2565,1297,-30
100409566406,100409566396,-10,579,189,-30
100410691494,100410691497,3,2068,1276,-30
100413201485,100413201489,4,2021,1730,-30
100415771830,100415771834,4,2765,1368,-30
100420256526,100420256531,5,1761,875,-30
100421881792,100421881797,5,2588,1655,-30
100422031146,100422031150,4,1172,666,-30
100422918377,100422918376,-1,1235,1885,-30
100424861641,100424861646,5,2205,1163,-30
100427334858,100427334863,5,1413,986,-30
100427757778,100427757782,4,2270,1275,-30
100429570844,100429570850,6,1520,989,-30
100430257714,100430257718,4,2049,867,-30
100433690069,100433690074,5,1206,762,-30
100434038008,100434038011,3,2217,1471,-30
100435640558,100435640566,8,2148,1393,-30
100437364685,100437364690,5,2825,1374,-30
100443413662,100443413669,7,1812,1499,-30
100445044334,100445044328,-6,951,4973,-30
100447674382,100447674388,6,2612,1116,-30
100451014696,100451014702,6,2732,1683,-30
100452687393,100452687398,5,2246,1787,-30
100452817383,100452817387,4,2991,1978,-30
100453007890,100453007895,5,2445,1170,-30
100455765533,100455765538,5,1976,1426,-30
100456165144,100456165148,4,1752,1378,-30
100457236842,100457236846,4,2297,1126,-30
100464061629,100464061634,5,2158,1570,-30
100464999513,100464999531,18,1875,1153,-30
100467490219,100467490224,5,2210,1632,-30
100468133186,100468133191,5,2518,997,-30
100468299256,100468299241,-15,2088,1428,-30
100468448112,100468448105,-7,3924,10620,-30
100468736361,100468736365,4,2387,1010,-30
100469734946,100469734949,3,2180,1352,-30
100470723249,100470723251,2,2337,2046,-30
100472216920,100472216926,6,2165,1390,-30
100474930963,100474930970,7,981,705,-30
100477019996,100477020002,6,3262,1771,-30
100477521434,100477521439,5,3731,1724,-30
100477945713,100477945718,5,2274,1561,-30
100480022132,100480022137,5,2130,1737,-30
100484388181,100484388185,4,2394,1485,-30
100486694993,100486694995,2,1598,1109,-30
100487623945,100487623950,5,1946,1087,-30
100489941137,100489941143,6,2600,1542,-30
100496485677,100496485682,5,3184,1820,-30
100497781779,100497781783,4,2339,1780,-30
100499176385,100499176393,8,673,555,-30
100503342859,100503342865,6,1753,1068,-30
100504813869,100504813873,4,2271,1452,-30
100506197977,100506197981,4,2003,1117,-30
100507178155,100507178160,5,2504,1597,-30
100511504758,100511504762,4,1598,898,-30
100514535435,100514535440,5,1731,1088,-30
100514944966,100514944970,4,1525,823,-30
100515213438,100515213446,8,2907,1249,-30
100515833432,100515833435,3,2271,1086,-30
100516160422,100516160418,-4,821,2396,-30
100517720005,100517720010,5,2309,1018,-30
100518625766,100518625773,7,2697,1246,-30
100519201565,100519201571,6,2236,1329,-30
100519405705,100519405690,-15,1678,1069,-30
100521479905,100521479910,5,3420,1488,-30
100530665656,100530665662,6,2744,1046,-30
100530991762,100530991745,-17,1655,1225,-30
100533217547,100533217551,4,1571,894,-30
100533245155,100533245171,16,664,42,-30
100537569611,100537569613,2,1253,1289,-30
100540686998,100540687002,4,2361,1322,-30
100541043970,100541043974,4,1343,754,-30
100545052005,100545052009,4,1423,983,-30
100547069442,100547069448,6,2097,1345,-30
100548385756,100548385761,5,2213,1448,-30
100549878274,100549878279,5,1491,1604,-30
100553170708,100553170713,5,2383,1232,-30
100556327738,100556327742,4,2078,1647,-30
100560592719,100560592722,3,2224,1343,-30
100564314434,100564314439,5,2156,1192,-30
100565034384,100565034389,5,2514,1167,-30
100567684618,100567684624,6,2126,1194,-30
100574767911,100574767915,4,1680,1033,-30
100576748431,100576748435,4,2194,1329,-30
100577055898,100577055902,4,1935,1087,-30
100580517837,100580517842,5,2312,1244,-30
100581086735,100581086741,6,1940,916,-30
100581624390,100581624395,5,1866,1727,-30
100582937699,100582937705,6,2352,994,-30
100583354733,100583354738,5,1074,945,-30
100585316906,100585316901,-5,1500,6332,-30
100586192867,100586192871,4,1680,1026,-30
100587270107,100587270113,6,1485,1153,-30
100592760670,100592760674,4,2369,1121,-30
100593198098,100593198104,6,2415,1392,-30
100595607310,100595607315,5,2654,1114,-30
100596797171,100596797178,7,2855,1143,-30
100601660191,100601660196,5,2039,1444,-30
100601972986,100601972990,4,2232,1491,-30
100611519931,100611519934,3,2541,1415,-30
100614455468,100614455471,3,1040,984,-30
100619855930,100619855935,5,2318,1342,-30
100621149914,100621149918,4,885,1422,-30
100624715280,100624715285,5,1974,1288,-30
100627546384,100627546387,3,2322,1113,-30
100630901201,100630901204,3,1435,839,-30
100635078315,100635078309,-6,748,2293,-30
100638360825,100638360831,6,1969,775,-30
100641823398,100641823401,3,2565,1591,-30
100643795176,100643795182,6,347,1099,-30
100645577353,100645577358,5,1197,847,-30
100646397263,100646397242,-21,2755,1546,-30
100649663949,100649663950,1,1413,1124,-30
100654252815,100654252821,6,2309,1450,-30
100655197015,100655197019,4,1682,990,-30
100656869435,100656869442,7,1948,1234,-30
100657118917,100657118921,4,563,94,-30
100658473915,100658473921,6,2175,1502,-30
100659639532,100659639536,4,2070,988,-30
100665977205,100665977209,4,1970,1293,-30
100666571285,100666571291,6,3000,1408,-30
100668209628,100668209625,-3,951,3905,-30
100669273795,100669273801,6,2614,901,-30
100671784008,100671784012,4,1883,1765,-30
100684030283,100684030288,5,2519,1349,-30
100688030721,100688030726,5,1203,653,-30
100695410113,100695410106,-7,1355,6110,-30
100701034749,100701034755,6,4064,1876,-30
100702468030,100702468033,3,3230,1484,-30
100702591340,100702591345,5,2030,1128,-30
100703907918,100703907921,3,2004,866,-30
100704758467,100704758471,4,1759,1133,-30
100718158517,100718158511,-6,3417,11634,-30
100718790261,100718790267,6,2059,1118,-30
100718927117,100718927138,21,2011,1279,-30
100720992783,100720992787,4,1678,1366,-30
100721395796,100721395800,4,1794,1182,-30
100724370829,100724370831,2,2373,1143,-30
100729500377,100729500385,8,2578,1014,-30
100730169670,100730169677,7,1825,906,-30
100734844050,100734844057,7,3125,1558,-30
100736413864,100736413870,6,4034,1250,-30
100740657696,100740657700,4,1739,983,-30
100741685994,100741686001,7,2095,1099,-30
100742545295,100742545298,3,1733,1046,-30
100742903658,100742903643,-15,3141,1954,-30
100743535413,100743535417,4,2044,1504,-30
100748592691,100748592670,-21,2743,1432,-30
100753485584,100753485586,2,1237,1244,-30
100755056114,100755056118,4,2702,1627,-30
100757480063,100757480064,1,1729,1190,-30
100758030984,100758030989,5,1607,1085,-30
100759756229,100759756223,-6,2039,6498,-30
100759832573,100759832578,5,2019,1137,-30
100762835110,100762835116,6,1546,667,-30
100764241234,100764241231,-3,1320,1230,-30
100765569444,100765569450,6,3298,1910,-30
100768000990,100768000999,9,2113,989,-30
100768425145,100768425151,6,2806,1273,-30
100771361681,100771361686,5,1830,1609,-30
100772790277,100772790283,6,1856,1161,-30
100772834642,100772834656,14,1491,1110,-30
100773006670,100773006676,6,2551,1593,-30
100776155538,100776155534,-4,676,2697,-30
100776914201,100776914203,2,2322,959,-30
100779373915,100779373919,4,2593,1432,-30
100779929754,100779929758,4,1699,1001,-30
100779993870,100779993874,4,2158,946,-30
100781904081,100781904084,3,2693,1312,-30
100783568376,100783568380,4,1314,975,-30
100785985411,100785985415,4,2598,1767,-30
100786113430,100786113436,6,1627,1129,-30
100792829077,100792829082,5,1702,1541,-30
100802315222,100802315227,5,1903,1210,-30
100802534057,100802534064,7,2846,1188,-30
100802994208,100802994215,7,2570,1676,-30
100807450630,100807450636,6,5103,1281,-30
100809555481,100809555502,21,1200,1199,-30
100809621677,100809621682,5,1482,874,-30
100813248454,100813248462,8,2867,1711,-30
100814812482,100814812487,5,2755,1554,-30
100815758190,100815758195,5,1311,1253,-30
100818048883,100818048888,5,2458,1271,-30
100819816845,100819816849,4,2373,925,-30
100820095225,100820095231,6,2065,1279,-30
100820796349,100820796354,5,2612,1712,-30
100821229030,100821229035,5,2010,1356,-30
100821929742,100821929761,19,1118,588,-30
100824139313,100824139316,3,1736,1539,-30
100826168198,100826168190,-8,1179,5811,-30
100826931802,100826931783,-19,1901,1422,-30
100828878632,100828878639,7,2522,1267,-30
100829707386,100829707390,4,2734,1006,-30
100831282670,100831282674,4,1678,1226,-30
100836394797,100836394803,6,2484,1024,-30
100837245386,100837245391,5,1998,1227,-30
100838062978,100838062983,5,2424,1538,-30
100841576454,100841576458,4,2127,1279,-30
100843913681,100843913684,3,2211,1428,-30
100848375455,100848375459,4,2349,1780,-30
100849273306,100849273309,3,2083,1437,-30
100849532366,100849532384,18,1778,1253,-30
100852436229,100852436223,-6,1886,994,-30
100855298867,100855298875,8,5568,1206,-30
100857980587,100857980591,4,24044,23368,-30
100864331130,100864331136,6,2765,1316,-30
100866468482,100866468484,2,2641,2936,-30
100870103026,100870103033,7,1566,1122,-30
100873318709,100873318715,6,1797,1147,-30
100873560736,100873560752,16,2133,1030,-30
100874850233,100874850238,5,2529,1804,-30
100876676653,100876676655,2,1603,1943,-30
100879405065,100879405070,5,2058,1415,-30
100881416019,100881416023,4,1552,1140,-30
100882695510,100882695513,3,2530,1522,-30
100883978790,100883978797,7,4005,1256,-30
100885457006,100885457013,7,1970,1566,-30
100889372039,100889372039,0,1125,864,-30
100892780530,100892780534,4,2050,1533,-30
100893915207,100893915209,2,2184,1446,-30
100903033294,100903033294,0,1373,1309,-30
100903845237,100903845243,6,2564,1426,-30
100903995080,100903995086,6,2061,1061,-30
100905130036,100905130041,5,1560,853,-30
100906196972,100906196976,4,2631,1779,-30
100913799382,100913799385,3,2349,1428,-30
100914333802,100914333806,4,2256,1337,-30
100916352166,100916352171,5,2447,1425,-30
100922072536,100922072540,4,2144,1004,-30
100923610108,100923610114,6,2018,1094,-30
100926040477,100926040482,5,1869,1212,-30
100933919734,100933919739,5,2494,1952,-30
100935173669,100935173667,-2,856,1507,-30
100938345403,100938345409,6,2379,1084,-30
100939337362,100939337366,4,3094,1461,-30
100943751760,100943751766,6,2422,1242,-30
100944040669,100944040651,-18,638,377,-30
100944349810,100944349810,0,1137,1063,-30
100949965434,100949965439,5,2114,1502,-30
100958634478,100958634483,5,3428,1483,-30
100960953506,100960953510,4,1502,675,-30
100962401585,100962401590,5,2201,1026,-30
100964109794,100964109794,0,1857,2143,-30
100964346846,100964346851,5,1591,1288,-30
100965519593,100965519597,4,2360,1207,-30
100967003377,100967003382,5,1755,1434,-30
100969054574,100969054580,6,2545,1313,-30
100970816679,100970816683,4,2054,1116,-30
100973470937,100973470942,5,1572,1179,-30
100978876895,100978876898,3,2244,1618,-30
100980200454,100980200457,3,1576,1020,-30
100983175399,100983175402,3,1718,1158,-30
100985480806,100985480811,5,3057,1615,-30
100990628414,100990628418,4,2369,1503,-30
100991702563,100991702549,-14,1828,2113,-30
100993024490,100993024495,5,1897,1292,-30
100993671652,100993671657,5,2678,1603,-30
100994390152,100994390158,6,2519,1254,-30
100994929554,100994929559,5,2795,1275,-30
100996508439,100996508445,6,2158,1617,-30
100998793732,100998793736,4,2438,1226,-30
100999017314,100999017310,-4,803,2068,-30
100999092836,100999092841,5,2606,1451,-30
101003364130,101003364133,3,1481,1084,-30
101004980994,101004980993,-1,1153,2739,-30
101005579715,101005579721,6,2308,1123,-30
101006280121,101006280126,5,2522,1546,-30
101007998966,101007998973,7,2298,1408,-30
101008533917,101008533904,-13,721,465,-30
101008721026,101008721032,6,2278,1136,-30
101009615218,101009615221,3,1223,1164,-30
101017109288,101017109292,4,1855,1567,-30
101017971246,101017971250,4,2420,1408,-30
101019807333,101019807338,5,2169,1034,-30
101025366627,101025366634,7,2052,1314,-30
101030140082,101030140086,4,1876,1404,-30
101031248931,101031248936,5,2436,1130,-30
101032162726,101032162730,4,2026,1418,-30
101033081154,101033081136,-18,2504,1365,-30
101034522638,101034522643,5,1838,934,-30
101036584298,101036584303,5,2926,1559,-30
101037485890,101037485894,4,2611,1425,-30
101040339350,101040339354,4,1870,1345,-30
101041009498,101041009502,4,2461,1599,-30
101042880670,101042880676,6,1621,1135,-30
101043752213,101043752218,5,2142,1032,-30
101044498037,101044498018,-19,1936,776,-30
101046419321,101046419320,-1,1574,2550,-30
101046588938,101046588942,4,2157,1135,-30
101047177576,101047177582,6,2571,1179,-30
101048127066,101048127066,0,946,1810,-30
101048196262,101048196267,5,5572,2668,-30
101048529786,101048529790,4,2483,1879,-30
101049506625,101049506629,4,1912,810,-30
101050236409,101050236393,-16,1338,1028,-30
101050576275,101050576281,6,2583,1739,-30
101052006429,101052006434,5,1809,1381,-30
101052223823,101052223829,6,1631,981,-30
101053336625,101053336633,8,2122,1070,-30
101057127490,101057127495,5,2022,1426,-30
101059049672,101059049678,6,2434,1544,-30
101062536413,101062536418,5,2121,1272,-30
101068658266,101068658271,5,1613,1288,-30
101069333589,101069333593,4,2052,1197,-30
101071512984,101071512991,7,3521,1253,-30
101072221377,101072221394,17,961,178,-30
101072489074,101072489091,17,26,1505,-30
101073435207,101073435211,4,2185,801,-30
101073822019,101073822023,4,2094,1257,-30
101075669970,101075669976,6,1158,831,-30
101075772090,101075772094,4,1422,1222,-30
101081565610,101081565605,-5,1693,6376,-30
101086988670,101086988678,8,1840,1164,-30
101093867026,101093867032,6,1865,1572,-30
101097745694,101097745698,4,2250,1341,-30
101100283225,101100283231,6,3142,1294,-30
101103093464,101103093471,7,2947,1408,-30
101106923688,101106923692,4,2387,1251,-30
101110749625,101110749627,2,1055,242,-30
101110879978,101110879981,3,1159,850,-30
101111586788,101111586790,2,3250,1432,-30
101115113849,101115113856,7,1849,1341,-30
101115434639,101115434619,-20,1176,776,-30
101115800425,101115800428,3,1999,1069,-30
101120574042,101120574048,6,2244,1411,-30
101125206663,101125206667,4,2007,1557,-30
101126760170,101126760172,2,1403,942,-30
101128428178,101128428183,5,2343,1885,-30
101131259334,101131259334,0,33687,45243,-30
101132182189,101132182195,6,2043,1277,-30
101134199107,101134199111,4,1832,1322,-30
101135659808,101135659813,5,2607,1234,-30
101135831924,101135831929,5,1991,1385,-30
101136748382,101136748387,5,2275,1583,-30
101137504750,101137504753,3,2181,1416,-30
101137675503,101137675510,7,1813,849,-30
101138303968,101138303974,6,4267,1943,-30
101140217061,101140217066,5,5846,3175,-30
101140634187,101140634185,-2,1272,2058,-30
101142545192,101142545198,6,2106,1506,-30
101144715880,101144715886,6,10719,3024,-30
101145193509,101145193514,5,2999,2062,-30
101148167934,101148167938,4,2692,1321,-30
101148874884,101148874904,20,148,279,-30
101149805554,101149805573,19,1029,1112,-30
101150494973,101150494979,6,2343,994,-30
101157780324,101157780324,0,1493,2090,-30
101158387754,101158387756,2,1628,1081,-30
101159138206,101159138211,5,2574,1489,-30
101160992102,101160992108,6,2724,1751,-30
101162747724,101162747730,6,2673,1175,-30
101165256535,101165256532,-3,987,2919,-30
101167855422,101167855428,6,2113,962,-30
101168263562,101168263562,0,2748,3128,-30
101168828459,101168828462,3,1908,846,-30
101171719513,101171719518,5,1787,1107,-30
101173366807,101173366811,4,2344,1140,-30
101178713881,101178713886,5,2231,1361,-30
101179901838,101179901853,15,2119,1202,-30
101180659426,101180659431,5,2447,1287,-30
101183966572,101183966576,4,3072,2044,-30
101186623906,101186623910,4,2526,1260,-30
101192472738,101192472737,-1,1238,1815,-30
101194762677,101194762682,5,1987,1209,-30
101194828273,101194828278,5,2079,1240,-30
101195467452,101195467458,6,1773,1538,-30
101198027526,101198027531,5,554,254,-30
101202849658,101202849671,13,2870,1570,-30
101204440829,101204440833,4,2082,856,-30
101204607869,101204607851,-18,1798,1298,-30
101208823666,101208823669,3,2078,967,-30
101209083587,101209083591,4,1563,887,-30
101211712402,101211712408,6,1870,921,-30
101217531749,101217531755,6,2272,1124,-30
101220544417,101220544418,1,1432,1496,-30
101225641376,101225641382,6,3497,1414,-30
101225901626,101225901610,-16,1683,1033,-30
101227737934,101227737937,3,1398,871,-30
101233655738,101233655743,5,2880,1220,-30
101235746465,101235746470,5,1899,1075,-30
101239893767,101239893761,-6,39334,20762,-30
101240828206,101240828211,5,2413,1585,-30
101241585050,101241585051,1,1805,1636,-30
101247603344,101247603350,6,2032,1606,-30
101248123258,101248123263,5,2475,1179,-30
101248202237,101248202239,2,672,782,-30
101249742498,101249742503,5,2003,1309,-30
101254190425,101254190430,5,2543,1380,-30
101255264247,101255264249,2,919,1006,-30
101257299250,101257299255,5,1443,994,-30
101257396158,101257396140,-18,2451,1082,-30
101266570230,101266570236,6,1795,1297,-30
101275430398,101275430402,4,3204,2149,-30
101275668986,101275668990,4,2076,1214,-30
101277911265,101277911270,5,2008,1254,-30
101278552626,101278552631,5,1520,890,-30
101281680944,101281680929,-15,2580,1100,-30
101282763949,101282763953,4,2089,990,-30
101283322733,101283322739,6,2125,1094,-30
101284121098,101284121104,6,1845,1085,-30
101284401961,101284401965,4,2845,1272,-30
101289212631,101289212634,3,1900,1239,-30
101289792891,101289792893,2,1806,1948,-30
101294858165,101294858171,6,1950,1103,-30
101298101345,101298101349,4,2173,1445,-30
101300407766,101300407770,4,2801,1127,-30
101301538929,101301538930,1,1158,1020,-30
101303494112,101303494110,-2,1672,3646,-30
101304321223,101304321229,6,2499,1034,-30
101306273606,101306273611,5,1997,1140,-30
101314867029,101314867034,5,723,707,-30
101316225950,101316225958,8,2035,1063,-30
101316940286,101316940290,4,2544,1952,-30
101317220376,101317220379,3,2673,1920,-30
101318385277,101318385282,5,2024,1151,-30
101318692753,101318692753,0,908,1347,-30
101324357474,101324357477,3,1515,1300,-30
101330215136,101330215141,5,2171,852,-30
101330670730,101330670734,4,1975,1464,-30
101334232862,101334232869,7,3015,1465,-30
101340977513,101340977519,6,2113,1464,-30
101341970850,101341970839,-11,2231,896,-30
101344905925,101344905926,1,1619,1365,-30
101354904266,101354904270,4,2603,1432,-30
101357823328,101357823334,6,2581,1611,-30
101358466100,101358466110,10,12295,29247,-30
101359871938,101359871941,3,2056,1334,-30
101359924683,101359924667,-16,1889,1135,-30
101362361259,101362361263,4,1328,1583,-30
101362389269,101362389274,5,3294,1610,-30
101364795628,101364795632,4,2596,1421,-30
101365374057,101365374062,5,2167,1455,-30
101366272272,101366272278,6,1635,1330,-30
101370605198,101370605202,4,2095,1130,-30
101370936215,101370936220,5,2172,1470,-30
101372891066,101372891070,4,2132,1301,-30
101373119659,101373119663,4,2504,1571,-30
101374155697,101374155703,6,1880,997,-30
101378260154,101378260158,4,2543,1688,-30
101380457128,101380457132,4,2096,1593,-30
101389060237,101389060242,5,2332,1357,-30
101392039276,101392039283,7,2569,751,-30
101393596332,101393596336,4,2321,1307,-30
101400720843,101400720845,2,1654,1655,-30
101404119454,101404119458,4,2248,1465,-30
101404150314,101404150315,1,20861,18474,-30
101407799590,101407799594,4,2686,1886,-30
101410101970,101410101974,4,2345,1269,-30
101414548839,101414548839,0,292,2555,-30
101415704510,101415704516,6,2038,1061,-30
101419314706,101419314713,7,2446,1535,-30
101420799793,101420799797,4,1596,976,-30
101426325533,101426325538,5,2165,1343,-30
101431236471,101431236476,5,2316,2111,-30
101433933029,101433933035,6,2350,900,-30
101437016232,101437016230,-2,1581,4039,-30
101437554314,101437554319,5,1745,1458,-30
101439866171,101439866176,5,2238,1325,-30
101440380370,101440380374,4,2424,1255,-30
101442351730,101442351729,-1,1263,2081,-30
101448835869,101448835875,6,2907,1208,-30
101450573426,101450573431,5,2008,1584,-30
101452064920,101452064923,3,1944,1754,-30
101453758354,101453758359,5,805,609,-30
101453975599,101453975579,-20,1740,896,-30
101456097241,101456097246,5,2164,1146,-30
101460344166,101460344169,3,2467,1557,-30
101460865590,101460865590,0,1262,1399,-30
101461098852,101461098854,2,1422,1153,-30
101462322356,101462322362,6,2838,1429,-30
101466743734,101466743722,-12,1007,664,-30
101468371429,101468371449,20,2031,1250,-30
101472158416,101472158422,6,2442,977,-30
101478373752,101478373757,5,2257,1426,-30
101480678607,101480678613,6,1950,1563,-30
101483092974,101483092980,6,1827,1063,-30
101483727382,101483727389,7,2547,1205,-30
101486266821,101486266826,5,1234,627,-30
101490312322,101490312328,6,2817,2125,-30
101491668283,101491668289,6,1753,1114,-30
101492595033,101492595038,5,2083,1303,-30
101499313494,101499313498,4,2473,1643,-30
101499956206,101499956202,-4,1564,6600,-30
101500810076,101500810082,6,3000,1546,-30
101501149166,101501149173,7,1625,946,-30
101501689591,101501689579,-12,2603,447,-30
101504092456,101504092457,1,1423,2082,-30
101507355140,101507355145,5,2926,1427,-30
101507938361,101507938368,7,1965,1414,-30
101508749301,101508749306,5,2143,1225,-30
101509104473,101509104476,3,2706,1838,-30
101510569979,101510569985,6,1133,781,-30
101515093188,101515093191,3,1086,1231,-30
101515554106,101515554090,-16,2169,1095,-30
101515817273,101515817278,5,701,643,-30
101516934112,101516934117,5,3187,1243,-30
101518732506,101518732512,6,3499,1713,-30
101520264830,101520264836,6,1682,1357,-30
101522277817,101522277822,5,2831,2177,-30
101522477936,101522477943,7,2349,1063,-30
101525316563,101525316567,4,2403,1639,-30
101525583174,101525583181,7,2783,1805,-30
101528529731,101528529734,3,1393,1108,-30
101528873370,101528873375,5,2247,1211,-30
101532715248,101532715254,6,2614,1659,-30
101534988450,101534988457,7,2825,1582,-30
101535233273,101535233281,8,2700,1338,-30
101536211322,101536211326,4,1967,1350,-30
101536682394,101536682411,17,3491,1549,-30
101537997102,101537997109,7,3668,1749,-30
101539887130,101539887135,5,2239,1359,-30
101540882516,101540882520,4,2044,1456,-30
101544386177,101544386182,5,1777,1239,-30
101545528922,101545528928,6,1619,872,-30
101546022156,101546022161,5,1677,1005,-30
101546202213,101546202218,5,3184,1755,-30
101550482566,101550482571,5,2663,1354,-30
101552241243,101552241250,7,1587,825,-30
101552949240,101552949228,-12,2129,805,-30
101554864600,101554864601,1,1788,1074,-30
101560114114,101560114119,5,2538,1540,-30
101560385477,101560385483,6,2468,1556,-30
101561459818,101561459822,4,3297,2082,-30
101563119138,101563119143,5,2334,1493,-30
101565163669,101565163674,5,2052,1631,-30
101565561293,101565561300,7,2669,1030,-30
101568870289,101568870293,4,1930,1666,-30
101572659690,101572659693,3,1550,1357,-30
101574747443,101574747448,5,1801,1119,-30
101580435952,101580435957,5,1996,773,-30
101581166574,101581166579,5,2251,947,-30
101583920502,101583920483,-19,1402,879,-30
101584693072,101584693078,6,2317,1067,-30
101586288044,101586288049,5,2274,1296,-30
101589174050,101589174066,16,414,1917,-30
101589271468,101589271474,6,2386,1336,-30
101592278942,101592278944,2,1954,2345,-30
101593651127,101593651135,8,2747,1527,-30
101594918739,101594918743,4,2035,1056,-30
101595042815,101595042821,6,1808,795,-30
101601723602,101601723606,4,1888,1126,-30
101603126726,101603126722,-4,3042,7557,-30
101603279537,101603279538,1,1379,1152,-30
101605338874,101605338877,3,1060,693,-30
101613031524,101613031527,3,2072,1231,-30
101613153549,101613153560,11,1568,874,-30
101613711219,101613711225,6,1999,1227,-30
101614287718,101614287722,4,3306,1633,-30
101614939018,101614939020,2,753,1425,-30
101618589316,101618589322,6,2229,1289,-30
101623191645,101623191650,5,3185,1611,-30
101626134858,101626134862,4,2651,1568,-30
101626907801,101626907803,2,1295,1078,-30
101635549027,101635549032,5,3624,1610,-30
101636020610,101636020616,6,2012,1084,-30
101636726008,101636726013,5,2104,1651,-30
101639672410,101639672416,6,1480,1328,-30
101640372775,101640372778,3,2380,1409,-30
101641591765,101641591767,2,1034,1242,-30
101644524755,101644524759,4,2382,1934,-30
101645481371,101645481375,4,1793,1498,-30
101649269194,101649269198,4,1760,1210,-30
101650139883,101650139878,-5,866,2281,-30
101651487945,101651487950,5,2823,1330,-30
101653348038,101653348045,7,3152,1713,-30
101653396084,101653396078,-6,2027,7208,-30
101658693458,101658693465,7,1939,1137,-30
101662756153,101662756159,6,2549,1082,-30
101663149374,101663149379,5,1875,1489,-30
101665234989,101665234994,5,2637,1417,-30
101666062433,101666062438,5,1760,1296,-30
101667262338,101667262342,4,2276,1387,-30
101670747363,101670747367,4,2845,1266,-30
101670967321,101670967326,5,1689,1625,-30
101671932359,101671932366,7,1968,956,-30
101672558383,101672558386,3,2686,1279,-30
101680109652,101680109658,6,2889,1426,-30
101685034998,101685035005,7,4318,1925,-30
101691972957,101691972962,5,2200,1336,-30
101693082385,101693082390,5,2758,1375,-30
101693883604,101693883607,3,3731,3459,-30
101699528804,101699528807,3,2165,1111,-30
101702844181,101702844187,6,2394,1383,-30
101703793434,101703793438,4,2620,1305,-30
101705069002,101705069007,5,1952,746,-30
101706352316,101706352321,5,2159,1390,-30
101707709218,101707709220,2,1599,1556,-30
101708003842,101708003846,4,2115,1271,-30
101711716772,101711716777,5,2295,1272,-30
101712349881,101712349885,4,2210,1293,-30
101713815194,101713815199,5,2863,1551,-30
101715735849,101715735854,5,1585,1041,-30
101716217502,101716217505,3,1916,1214,-30
101716579645,101716579651,6,2350,1531,-30
101718338425,101718338429,4,2316,1196,-30
101720448114,101720448121,7,2060,949,-30
101721576602,101721576606,4,1290,813,-30
101721776354,101721776354,0,578,272,-30
101724825270,101724825276,6,2802,1454,-30
101727694361,101727694356,-5,1523,3410,-30
101728126270,101728126273,3,2145,1471,-30
101733295153,101733295158,5,1527,1533,-30
101737380642,101737380636,-6,1470,8407,-30
101744561769,101744561776,7,2046,1197,-30
101747919715,101747919713,-2,1363,2682,-30
101748887653,101748887655,2,2709,2089,-30
101751506402,101751506396,-6,1655,3957,-30
101752059641,101752059643,2,1669,950,-30
101758487086,101758487091,5,2236,1004,-30
101759333734,101759333732,-2,1233,3302,-30
101759597959,101759597965,6,1765,1642,-30
101762456075,101762456078,3,2072,1210,-30
101764379927,101764379942,15,10490,55977,-30
101765015922,101765015921,-1,1719,2721,-30
101766072574,101766072578,4,2319,1157,-30
101766654035,101766654041,6,2323,1294,-30
101771081526,101771081529,3,2075,1321,-30
101774054330,101774054335,5,2192,915,-30
101774600703,101774600706,3,2280,1459,-30
101775107606,101775107612,6,2675,1581,-30
101778523358,101778523358,0,1209,1267,-30
101788089105,101788089109,4,1371,769,-30
101788290053,101788290058,5,5575,2834,-30
101788975483,101788975490,7,3487,1830,-30
101789527930,101789527935,5,1819,741,-30
101799168641,101799168647,6,2579,1505,-30
101805593618,101805593624,6,3245,1646,-30
101806399224,101806399231,7,2092,1106,-30
101808685139,101808685142,3,1759,1250,-30
101810596069,101810596071,2,1896,1826,-30
101813780414,101813780418,4,1442,910,-30
101815740150,101815740156,6,2629,1476,-30
101817379398,101817379401,3,2310,1459,-30
101825460338,101825460344,6,4797,1659,-30
101830655497,101830655501,4,3179,1439,-30
101831217781,101831217785,4,2349,1657,-30
101836986533,101836986538,5,2710,1399,-30
101838346597,101838346602,5,3017,974,-30
101839444140,101839444142,2,15085,17607,-30
101842354334,101842354340,6,2156,873,-30
101845992322,101845992327,5,1813,994,-30
101847630979,101847630983,4,2469,1553,-30
101851385451,101851385454,3,2249,1271,-30
101851763087,101851763091,4,659,243,-30
101852847326,101852847330,4,1947,1474,-30
101854237329,101854237335,6,2391,1608,-30
101855436603,101855436607,4,1253,1328,-30
101857784906,101857784911,5,1146,991,-30
101858682393,101858682397,4,1811,1362,-30
101858992922,101858992926,4,2575,1646,-30
101864117034,101864117038,4,2137,934,-30
101867904809,101867904813,4,2740,1592,-30
101870832314,101870832321,7,2921,1937,-30
101871150086,101871150091,5,1357,948,-30
101871478938,101871478933,-5,2761,7532,-30
101872132476,101872132496,20,56,1132,-30
101877488861,101877488865,4,1764,994,-30
101878376010,101878376010,0,1178,1499,-30
101885171010,101885171013,3,2148,1736,-30
101885585820,101885585826,6,2442,1362,-30
101885687988,101885687992,4,2440,1669,-30
101887423574,101887423574,0,780,687,-30
101892806342,101892806348,6,1919,1392,-30
101893880326,101893880330,4,1684,1271,-30
101895054226,101895054233,7,2112,1308,-30
101904585898,101904585903,5,2108,1534,-30
101907818382,101907818387,5,1612,993,-30
101908380426,101908380431,5,2659,1342,-30
101908868479,101908868480,1,1717,2126,-30
101909922190,101909922197,7,2524,806,-30
101915518306,101915518312,6,2093,1525,-30
101917205402,101917205402,0,1331,1643,-30
101920961923,101920961928,5,2400,1081,-30
101923609922,101923609921,-1,1426,1758,-30
101926491921,101926491940,19,3391,13416,-30
101928651522,101928651522,0,1407,1332,-30
101929101870,101929101873,3,1385,1107,-30
101930173730,101930173735,5,2170,1128,-30
101930990466,101930990470,4,2373,1277,-30
101938493297,101938493302,5,3790,1746,-30
101941173049,101941173053,4,1323,1604,-30
101941272783,101941272794,11,2270,1339,-30
101941487111,101941487089,-22,1474,821,-30
101943240008,101943240013,5,1856,906,-30
101947240175,101947240181,6,2319,1475,-30
101947554563,101947554553,-10,715,172,-30
101951564215,101951564220,5,2596,1472,-30
101954285490,101954285497,7,2330,1646,-30
101955370073,101955370078,5,2637,1635,-30
101955901322,101955901326,4,2191,1194,-30
101956141890,101956141873,-17,2283,1678,-30
101957063766,101957063771,5,2460,1208,-30
101958245507,101958245511,4,2087,987,-30
101959502489,101959502494,5,2264,1602,-30
101960554915,101960554918,3,1602,1195,-30
101961763615,101961763618,3,773,1041,-30
101962413130,101962413134,4,1872,1574,-30
101962847570,101962847574,4,1718,983,-30
101965441806,101965441813,7,3561,1563,-30
101968145287,101968145293,6,1834,917,-30
101968351851,101968351855,4,2036,814,-30
101971872437,101971872439,2,1969,1530,-30
101972356801,101972356806,5,1897,1173,-30
101973729342,101973729347,5,2863,1884,-30
101977517906,101977517910,4,2897,1220,-30
101979179461,101979179466,5,2539,1541,-30
101980122753,101980122759,6,2824,1278,-30
101980285829,101980285833,4,3202,1846,-30
101982148277,101982148285,8,2500,1332,-30
101982991921,101982991931,10,13426,33784,-30
101983691176,101983691181,5,3042,2109,-30
101986110613,101986110617,4,1483,1241,-30
101987313246,101987313249,3,1659,1404,-30
101987987909,101987987914,5,1800,1434,-30
101988962598,101988962602,4,2393,1145,-30
101991865771,101991865777,6,2460,1758,-30
101992598399,101992598405,6,3228,2047,-30
101999226113,101999226117,4,2459,1640,-30
102000186651,102000186655,4,2621,2218,-30
102003872502,102003872506,4,2724,1768,-30
102005729366,102005729370,4,1543,1158,-30
102006223187,102006223193,6,3058,1340,-30
102009675924,102009675927,3,2308,1563,-30
102009878702,102009878703,1,3179,3581,-30
102012083978,102012083982,4,1846,1358,-30
102012578235,102012578231,-4,1401,3358,-30
102013889443,102013889443,0,2724,3653,-30
102016811282,102016811287,5,1831,1365,-30
102018300613,102018300618,5,3555,1387,-30
102019309907,102019309888,-19,3409,1418,-30
102019907031,102019907035,4,1707,1540,-30
102020215762,102020215769,7,2473,1222,-30
102028472129,102028472134,5,2482,838,-30
102029951366,102029951371,5,1979,1260,-30
102031392535,102031392539,4,1127,606,-30
102033783909,102033783913,4,1862,1402,-30
102033898602,102033898610,8,1067,441,-30
102035313139,102035313145,6,3267,1415,-30
102035601566,102035601570,4,2655,1591,-30
102037525814,102037525818,4,1920,1276,-30
102037954950,102037954957,7,2261,1606,-30
102043409965,102043409970,5,2791,2041,-30
102045892410,102045892415,5,1468,991,-30
102047202720,102047202726,6,1710,1232,-30
102047390638,102047390643,5,1299,921,-30
102048240575,102048240578,3,1370,1363,-30
102054792158,102054792162,4,1563,966,-30
102056222403,102056222407,4,2331,1683,-30
102056438575,102056438579,4,2717,692,-30
102057094570,102057094574,4,2800,1560,-30
102061611074,102061611078,4,3148,1656,-30
102065535065,102065535070,5,2012,1076,-30
102066619333,102066619339,6,2231,1642,-30
102067459487,102067459493,6,2934,1097,-30
102068933875,102068933877,2,2528,1160,-30
102070383627,102070383627,0,1436,1982,-30
102076925834,102076925841,7,2595,1127,-30
102081865106,102081865110,4,1542,1262,-30
102083116573,102083116578,5,2229,1460,-30
102089844555,102089844560,5,3176,2109,-30
102090043402,102090043406,4,1611,1076,-30
102094631865,102094631870,5,1907,1117,-30
102095336566,102095336563,-3,1046,1543,-30
102095966938,102095966944,6,2101,1506,-30
102096143073,102096143080,7,2202,1678,-30
102100142319,102100142323,4,2183,1176,-30
102100175530,102100175512,-18,1236,606,-30
102100878511,102100878515,4,2194,1399,-30
102102179913,102102179918,5,2309,1355,-30
102108922646,102108922650,4,2695,1791,-30
102111057657,102111057663,6,2164,1165,-30
102115144137,102115144143,6,2740,1427,-30
102123414115,102123414118,3,2132,1803,-30
102124720803,102124720803,0,1371,1789,-30
102126454287,102126454291,4,1630,1022,-30
102131331858,102131331865,7,2586,1344,-30
102134181292,102134181297,5,2085,1904,-30
102136484269,102136484273,4,2401,1433,-30
102138001700,102138001705,5,2993,1688,-30
102138171282,102138171287,5,2373,1046,-30
102138416991,102138416996,5,2188,1099,-30
102138871386,102138871391,5,2359,1155,-30
102139036007,102139036005,-2,1392,1304,-30
102145244790,102145244795,5,1497,988,-30
102145770044,102145770049,5,2836,1656,-30
102147171778,102147171779,1,1211,842,-30
102148706894,102148706898,4,2664,1156,-30
102149443742,102149443746,4,1682,1216,-30
102154730073,102154730077,4,1692,1301,-30
102155901318,102155901322,4,2340,999,-30
102158889335,102158889342,7,1547,1122,-30
102159714157,102159714161,4,1636,2023,-30
102160822210,102160822214,4,2200,1262,-30
102160942638,102160942616,-22,948,589,-30
102160972482,102160972489,7,1840,1229,-30
102163288935,102163288941,6,2291,1442,-30
102166804409,102166804418,9,2247,994,-30
102168992925,102168992930,5,2093,1257,-30
102173966876,102173966881,5,2976,1758,-30
102174244559,102174244563,4,1837,1224,-30
102175773653,102175773632,-21,1795,889,-30
102177002722,102177002730,8,3570,1418,-30
102179139249,102179139256,7,15143,30386,-30
102183453622,102183453627,5,2417,1212,-30
102186432306,102186432312,6,2893,1127,-30
102189988358,102189988363,5,1258,925,-30
102191970674,102191970674,0,1509,1953,-30
102195105902,102195105906,4,2734,1645,-30
102195283069,102195283062,-7,3018,10017,-30
102195316655,102195316659,4,1850,1080,-30
102198491177,102198491182,5,1798,1580,-30
102199415675,102199415670,-5,1308,3398,-30
102203827113,102203827118,5,2585,1721,-30
102213255098,102213255104,6,2616,1353,-30
102219661353,102219661359,6,2957,1554,-30
102220352889,102220352893,4,2028,1453,-30
102222887218,102222887225,7,2431,1712,-30
102223858702,102223858706,4,2331,1031,-30
102229602744,102229602749,5,2663,1485,-30
102229808110,102229808115,5,1928,1098,-30
102240449371,102240449374,3,1949,1458,-30
102245775021,102245775003,-18,867,604,-30
102252553905,102252553908,3,2216,1384,-30
102252659693,102252659674,-19,2018,1060,-30
102254706081,102254706087,6,2173,1385,-30
102255748042,102255748045,3,2325,1550,-30
102256296202,102256296207,5,2773,1718,-30
102256911013,102256911020,7,1916,1046,-30
102259734696,102259734703,7,2822,1502,-30
102260074626,102260074609,-17,1948,1265,-30
102262120574,102262120578,4,1950,1271,-30
102262391629,102262391611,-18,3124,1324,-30
102263143342,102263143346,4,2093,1256,-30
102263800646,102263800625,-21,2653,1360,-30
102264895082,102264895087,5,2160,1658,-30
102268221740,102268221745,5,2304,1591,-30
102269186980,102269186985,5,3383,1779,-30
102270213225,102270213230,5,2329,1315,-30
102271194794,102271194798,4,1645,840,-30
102274178432,102274178438,6,3053,1148,-30
102275824055,102275824052,-3,2399,5501,-30
102276985689,102276985693,4,2854,1149,-30
102277062745,102277062751,6,2805,1340,-30
102278081703,102278081710,7,2565,1576,-30
102279926289,102279926286,-3,2249,5312,-30
102280408274,102280408274,0,1498,1794,-30
102281584065,102281584069,4,2144,1311,-30
102283968849,102283968854,5,2469,1233,-30
102284162905,102284162909,4,2263,1510,-30
102284452982,102284452987,5,2613,1413,-30
102285335443,102285335447,4,2727,1478,-30
102285860191,102285860195,4,1730,1210,-30
102288228767,102288228770,3,3142,1384,-30
102289946038,102289946042,4,1574,988,-30
102295058938,102295058942,4,2025,1482,-30
102299978980,102299978985,5,2334,1629,-30
102300149433,102300149438,5,1231,1152,-30
102301076238,102301076243,5,2130,1492,-30
102302499930,102302499934,4,1642,1506,-30
102303461888,102303461893,5,2090,964,-30
102303635882,102303635887,5,1572,1374,-30
102305668790,102305668798,8,1687,838,-30
102306007136,102306007141,5,2257,1139,-30
102307778593,102307778599,6,1915,1060,-30
102309180179,102309180186,7,2414,947,-30
102309579650,102309579657,7,2595,1355,-30
102309952418,102309952422,4,1576,1021,-30
102311608093,102311608098,5,2541,1306,-30
102312229391,102312229394,3,1377,1512,-30
102318718665,102318718669,4,2637,2095,-30
102321931690,102321931691,1,2625,3569,-30
102322094906,102322094911,5,1787,1330,-30
102335592106,102335592111,5,1450,870,-30
102337125445,102337125449,4,1768,1269,-30
102341179356,102341179362,6,3444,1723,-30
102341527018,102341527022,4,1429,1315,-30
102344508014,102344508019,5,1778,961,-30
102346060858,102346060864,6,2398,1298,-30
102346148526,102346148539,13,1280,1264,-30
102347424552,102347424558,6,2483,1626,-30
102357430522,102357430526,4,2338,1295,-30
102358872074,102358872076,2,2109,1561,-30
102363792583,102363792587,4,2629,1559,-30
102369692306,102369692310,4,1261,1169,-30
102370702522,102370702527,5,2764,1297,-30
102371060622,102371060617,-5,987,4393,-30
102372128859,102372128863,4,3074,1881,-30
102374365817,102374365821,4,1525,1122,-30
102374586720,102374586736,16,3115,1397,-30
102380346515,102380346521,6,2006,1283,-30
102380815338,102380815342,4,1967,1385,-30
102382079902,102382079908,6,1742,1657,-30
102382571210,102382571214,4,1898,1313,-30
102382799505,102382799520,15,1883,1557,-30
102383139937,102383139941,4,2147,880,-30
102387071727,102387071721,-6,1906,7385,-30
102390307198,102390307203,5,3248,1207,-30
102390357453,102390357434,-19,1410,714,-30
102391647726,102391647707,-19,483,99,-30
102393674081,102393674085,4,1539,1001,-30
102395313885,102395313890,5,2625,1698,-30
102396555029,102396555051,22,2169,21160,-30
102396721967,102396721970,3,2222,1286,-30
102398116962,102398116945,-17,1113,376,-30
102400826118,102400826123,5,1715,997,-30
102404434363,102404434367,4,2148,1220,-30
102407281010,102407280993,-17,1961,780,-30
102407842213,102407842218,5,1502,1068,-30
102409540741,102409540743,2,1662,1117,-30
102409629201,102409629206,5,2242,1535,-30
102410616780,102410616785,5,2210,1654,-30
102414600027,102414600030,3,1075,832,-30
102414859303,102414859299,-4,1106,243,-30
102416010770,102416010772,2,1059,1197,-30
102416537157,102416537162,5,2061,1417,-30
102419500769,102419500773,4,1727,1111,-30
102419540003,102419540009,6,1221,1010,-30
102421075151,102421075154,3,2771,1395,-30
102421227114,102421227118,4,2856,1395,-30
102424679982,102424679986,4,1668,1204,-30
102428253790,102428253791,1,2209,1714,-30
102429128671,102429128675,4,2202,1517,-30
102431301202,102431301208,6,3184,1388,-30
102431916285,102431916305,20,2648,1477,-30
102433115297,102433115302,5,1521,893,-30
102436438889,102436438893,4,2217,1412,-30
102437855047,102437855050,3,3220,1537,-30
102439288505,102439288511,6,1498,1227,-30
102439862796,102439862801,5,2684,1760,-30
102439908644,102439908647,3,2855,1755,-30
102442083358,102442083363,5,3419,1293,-30
102444795022,102444795026,4,2423,743,-30
102445279857,102445279862,5,1581,934,-30
102446474487,102446474491,4,1748,1326,-30
102447045111,102447045090,-21,691,464,-30
102447144237,102447144243,6,2490,1178,-30
102447770704,102447770710,6,2115,1615,-30
102447893294,102447893300,6,3064,1283,-30
102448659731,102448659737,6,3257,1819,-30
102451911919,102451911923,4,1497,1007,-30
102452232242,102452232251,9,1207,234,-30
102453119604,102453119610,6,2383,1684,-30
102455364967,102455364969,2,1922,1174,-30
102455785849,102455785856,7,1615,691,-30
102458127863,102458127868,5,2620,1513,-30
102458342656,102458342643,-13,1267,255,-30
102459470950,102459470957,7,2780,977,-30
102459606861,102459606865,4,1883,1247,-30
102460513113,102460513117,4,2747,1686,-30
102461820580,102461820582,2,1965,1944,-30
102461954133,102461954137,4,1780,1214,-30
102465614372,102465614378,6,2629,1189,-30
102467000368,102467000375,7,1607,1233,-30
102471248507,102471248512,5,2360,1397,-30
102474595035,102474595041,6,1408,1668,-30
102476598902,102476598906,4,1553,1484,-30
102476790562,102476790547,-15,1711,1218,-30
102478892331,102478892314,-17,1179,585,-30
102482362158,102482362162,4,2514,1055,-30
102482952694,102482952699,5,2446,1350,-30
102486862267,102486862249,-18,818,4224,-30
102487555327,102487555332,5,2412,1181,-30
102488125589,102488125594,5,1800,1107,-30
102489138502,102489138507,5,1782,898,-30
102494103780,102494103784,4,1821,893,-30
102498189443,102498189422,-21,1461,1205,-30
102500305854,102500305859,5,2536,1991,-30
102501230440,102501230447,7,3811,1316,-30
102504624916,102504624922,6,2682,1527,-30
102505066578,102505066584,6,2125,1446,-30
102505261798,102505261779,-19,799,277,-30
102505648292,102505648297,5,2848,1342,-30
102507109282,102507109289,7,2841,1302,-30
102507207569,102507207574,5,2253,1485,-30
102510376805,102510376810,5,1934,930,-30
102510843753,102510843757,4,2936,1771,-30
102511155553,102511155558,5,2444,992,-30
102513733834,102513733828,-6,1406,5103,-30
102515988967,102515988972,5,1507,954,-30
102517095194,102517095177,-17,3381,955,-30
102521634001,102521634004,3,20587,39941,-30
102522194299,102522194305,6,2093,792,-30
102523503523,102523503528,5,2825,1510,-30
102524137017,102524137017,0,1474,1446,-30
102528571286,102528571292,6,1997,1024,-30
102533572056,102533572059,3,1221,1199,-30
102535930230,102535930226,-4,1605,4620,-30
102536190603,102536190590,-13,1072,1167,-30
102538871932,102538871934,2,979,1317,-30
102542432547,102542432551,4,1519,826,-30
102546294441,102546294445,4,1935,1159,-30
102548241662,102548241667,5,1667,1202,-30
102549029183,102549029190,7,2828,1462,-30
102551964522,102551964529,7,2382,844,-30
102556826062,102556826067,5,2000,1587,-30
102557545713,102557545718,5,1675,805,-30
102558006926,102558006929,3,1780,1392,-30
102559099590,102559099594,4,1691,1398,-30
102563160134,102563160140,6,2996,1960,-30
102566707006,102566707011,5,2772,1460,-30
102572540795,102572540795,0,1354,1553,-30
102572615302,102572615306,4,1775,1500,-30
102572933407,102572933413,6,3172,1314,-30
102573205493,102573205498,5,2005,1479,-30
102573834423,102573834424,1,1141,1449,-30
102574287060,102574287044,-16,1393,719,-30
102576761421,102576761426,5,2788,1191,-30
102577384414,102577384418,4,1717,899,-30
102583561074,102583561068,-6,21466,14830,-30
102583871533,102583871537,4,3212,1891,-30
102586940149,102586940156,7,2001,1096,-30
102591289176,102591289183,7,5037,1108,-30
102591813830,102591813834,4,1400,1059,-30
102593559997,102593560001,4,2719,1418,-30
102594617376,102594617374,-2,2028,4004,-30
102595563490,102595563496,6,2297,1270,-30
102598756765,102598756770,5,2655,1344,-30
102601293325,102601293329,4,999,1141,-30
102602677782,102602677769,-13,772,144,-30
102606769906,102606769911,5,2767,1605,-30
102607517853,102607517859,6,2642,1411,-30
102612847850,102612847853,3,1419,1229,-30
102613035393,102613035410,17,1026,341,-30
102613198681,102613198678,-3,1428,1863,-30
102620953834,102620953839,5,1670,1276,-30
102626517750,102626517755,5,1815,1091,-30
102628810594,102628810600,6,2226,1518,-30
102629903897,102629903901,4,2229,1440,-30
102630684057,102630684062,5,2875,1348,-30
102631158663,102631158666,3,905,870,-30
102631966195,102631966201,6,2796,1442,-30
102635013162,102635013166,4,2607,1216,-30
102638505168,102638505172,4,1546,1029,-30
102638643738,102638643722,-16,1991,850,-30
102638725365,102638725370,5,1597,1233,-30
102639282355,102639282361,6,2929,1375,-30
102642059352,102642059355,3,1575,1046,-30
102642810533,102642810537,4,1591,811,-30
102645633621,102645633623,2,2213,2006,-30
102645727667,102645727672,5,2198,1107,-30
102646781448,102646781455,7,2040,1200,-30
102648165144,102648165147,3,2095,1285,-30
102651232337,102651232344,7,1859,1135,-30
102652053874,102652053874,0,1329,1294,-30
102652952249,102652952255,6,2636,1452,-30
102655653278,102655653286,8,1776,1438,-30
102659024478,102659024478,0,1463,1900,-30
102660183337,102660183340,3,1720,1064,-30
102661442805,102661442803,-2,1544,1939,-30
102662634259,102662634256,-3,1106,2466,-30
102663548487,102663548484,-3,1090,3285,-30
102665375911,102665375906,-5,18237,5736,-30
102666019550,102666019555,5,2144,1449,-30
102667136846,102667136826,-20,1618,757,-30
102667951930,102667951935,5,3243,1697,-30
102670197030,102670197034,4,1902,1352,-30
102672851196,102672851201,5,2116,1403,-30
102673559610,102673559617,7,2825,1209,-30
102674964120,102674964118,-2,1535,2677,-30
102675063906,102675063911,5,2033,1502,-30
102675588541,102675588549,8,1537,1321,-30
102678529702,102678529708,6,2300,789,-30
102681894146,102681894151,5,3031,1837,-30
102686174196,102686174202,6,1875,1483,-30
102686685998,102686686002,4,2655,1473,-30
102688424110,102688424114,4,2420,1098,-30
102689027445,102689027447,2,1718,1050,-30
102691416431,102691416435,4,2131,1050,-30
102691504878,102691504882,4,1454,1488,-30
102691767901,102691767907,6,2738,1358,-30
102693069005,102693069010,5,2826,1137,-30
102701393976,102701393978,2,1442,1118,-30
102707267610,102707267614,4,2654,1442,-30
102707312835,102707312843,8,17601,52034,-30
102707473982,102707473989,7,1878,1407,-30
102707770835,102707770832,-3,1113,2114,-30
102716255045,102716255050,5,1333,1758,-30
102718034468,102718034473,5,2673,1257,-30
102721245306,102721245307,1,1337,1378,-30
102723759227,102723759231,4,1729,770,-30
102724265146,102724265145,-1,611,1388,-30
102727338684,102727338689,5,2450,1265,-30
102727824734,102727824741,7,1235,1212,-30
102730498148,102730498153,5,2093,810,-30
102731535525,102731535518,-7,1289,49,-30
102732001647,102732001625,-22,701,203,-30
102741311058,102741311064,6,2053,1052,-30
102743573883,102743573887,4,2010,1271,-30
102744251157,102744251163,6,2519,1539,-30
102744543064,102744543070,6,1950,927,-30
102745782767,102745782774,7,1135,895,-30
102750647640,102750647646,6,2059,1090,-30
102754882951,102754882955,4,1998,1252,-30
102755742043,102755742051,8,2454,1049,-30
102756542246,102756542233,-13,3456,1232,-30
102762413828,102762413832,4,2067,1399,-30
102764295930,102764295934,4,1676,1433,-30
102767950185,102767950190,5,1683,806,-30
102768335077,102768335082,5,1544,773,-30
102770025825,102770025824,-1,1701,2083,-30
102771252216,102771252223,7,2759,1261,-30
102777302473,102777302480,7,1652,826,-30
102777767265,102777767269,4,2676,1246,-30
102778469730,102778469733,3,1914,1142,-30
102784854597,102784854603,6,2318,1289,-30
102784936614,102784936611,-3,531,276,-30
102788445642,102788445648,6,2546,1220,-30
102791474280,102791474285,5,2692,1553,-30
102795699829,102795699831,2,3652,2992,-30
102797049154,102797049160,6,2828,1404,-30
102804596277,102804596283,6,2770,1345,-30
102805455370,102805455375,5,2087,822,-30
102807760402,102807760407,5,2664,1175,-30
102810669166,102810669170,4,2693,1554,-30
102810939043,102810939048,5,8870,23972,-30
102817779487,102817779494,7,2247,1133,-30
102819495229,102819495231,2,1457,1074,-30
102821448291,102821448296,5,2925,1669,-30
102822423350,102822423344,-6,841,3997,-30
102824689661,102824689665,4,2025,1913,-30
102826104581,102826104585,4,1858,1233,-30
102827123769,102827123774,5,2284,1465,-30
102831379985,102831379984,-1,1783,2045,-30
102832962030,102832962033,3,1777,1235,-30
102835459999,102835460004,5,1116,743,-30
102837734723,102837734728,5,2279,1535,-30
102842627793,102842627797,4,1955,1163,-30
102843135909,102843135914,5,2422,1511,-30
102844733879,102844733884,5,2480,939,-30
102844814539,102844814544,5,2158,1681,-30
102844974632,102844974639,7,1889,1057,-30
102846307014,102846306993,-21,837,471,-30
102853388609,102853388610,1,1652,1831,-30
102853783373,102853783378,5,1778,1673,-30
102856953771,102856953778,7,1636,971,-30
102862730475,102862730478,3,1475,889,-30
102862934310,102862934317,7,2293,1622,-30
102864933227,102864933231,4,1924,1334,-30
102869715155,102869715161,6,1529,1181,-30
102870854499,102870854482,-17,1936,935,-30
102874546833,102874546838,5,3087,1125,-30
102876414463,102876414442,-21,1650,636,-30
102876802093,102876802099,6,1856,1109,-30
102879178280,102879178282,2,1564,1441,-30
102881628489,102881628475,-14,2119,1214,-30
102882424326,102882424331,5,1373,785,-30
102882875332,102882875312,-20,903,118,-30
102883662768,102883662774,6,1955,874,-30
102889893247,102889893251,4,1060,943,-30
102890251308,102890251312,4,2815,1746,-30
102891006325,102891006330,5,1774,1137,-30
102893158631,102893158635,4,1446,769,-30
102895137886,102895137891,5,2442,1348,-30
102898815365,102898815358,-7,41772,15531,-30
102899553716,102899553722,6,3302,1265,-30
102899623655,102899623661,6,2457,1423,-30
102901798453,102901798457,4,1698,1229,-30
102903385960,102903385962,2,1589,1900,-30
102910541173,102910541178,5,2409,1989,-30
102911183330,102911183326,-4,1967,3735,-30
102916254808,102916254813,5,2316,1955,-30
102917041692,102917041705,13,587,2141,-30
102919319543,102919319545,2,1584,1494,-30
102924431134,102924431139,5,2282,1621,-30
102926834300,102926834306,6,2527,1203,-30
102927238798,102927238776,-22,1395,1315,-30
102927487323,102927487328,5,2341,1040,-30
102928207628,102928207631,3,1849,1023,-30
102931869316,102931869313,-3,1929,2732,-30
102935083610,102935083613,3,2218,1473,-30
102936571226,102936571230,4,1222,818,-30
102938100341,102938100342,1,2257,1310,-30
102942250194,102942250198,4,2224,1556,-30
102943272745,102943272749,4,2574,1241,-30
102945478866,102945478852,-14,2129,1298,-30
102947088970,102947088975,5,2588,1447,-30
102947278618,102947278623,5,2581,925,-30
102952836650,102952836666,16,9246,51269,-30
102955371254,102955371262,8,2779,1378,-30
102956429474,102956429482,8,3278,1092,-30
102957486277,102957486281,4,1646,954,-30
102960106621,102960106625,4,3112,1532,-30
102963913791,102963913795,4,2692,1788,-30
102964878265,102964878272,7,2040,1282,-30
102965922293,102965922298,5,2950,1159,-30
102967089105,102967089111,6,1802,1319,-30
102974468423,102974468429,6,2055,1247,-30
102978657966,102978657969,3,1973,1062,-30
102980474074,102980474079,5,2369,716,-30
102983396846,102983396824,-22,1562,1237,-30
102983830778,102983830780,2,1820,1929,-30
102990063750,102990063754,4,2384,1657,-30
102993288854,102993288859,5,2681,1297,-30
102994864837,102994864843,6,2120,1556,-30
103000767562,103000767565,3,1581,1157,-30
103001304409,103001304418,9,1489,979,-30
103002728619,103002728625,6,1208,721,-30
103004261398,103004261403,5,2506,1301,-30
103006028211,103006028218,7,2637,1096,-30
103007700557,103007700559,2,1591,1195,-30
103008447622,103008447626,4,2264,1482,-30
103008956654,103008956660,6,2357,1510,-30
103009370332,103009370336,4,1556,1102,-30
103011411803,103011411802,-1,1086,1422,-30
103012307489,103012307496,7,382,405,-30
103015422879,103015422886,7,11640,4254,-30
103016060271,103016060275,4,1657,1448,-30
103016972660,103016972662,2,2023,1455,-30
103018516306,103018516310,4,1979,1528,-30
103020339666,103020339673,7,2190,1445,-30
103023796927,103023796931,4,2825,1416,-30
103024296794,103024296799,5,2167,1310,-30
103028662113,103028662118,5,3560,1936,-30
103028945464,103028945470,6,3332,1310,-30
103029953099,103029953105,6,2213,1619,-30
103030393866,103030393871,5,1012,1131,-30
103031902202,103031902206,4,1783,1273,-30
103032613105,103032613103,-2,926,1432,-30
103038131374,103038131379,5,2721,1304,-30
103041868515,103041868494,-21,1586,1170,-30
103042554593,103042554597,4,1018,873,-30
103048039482,103048039490,8,2028,950,-30
103049926781,103049926786,5,1825,1181,-30
103057111508,103057111510,2,1563,2131,-30
103057907353,103057907359,6,1892,1460,-30
103059201713,103059201719,6,2622,1420,-30
103062686666,103062686670,4,1881,1408,-30
103063295515,103063295522,7,2172,1054,-30
103063626278,103063626281,3,1272,1073,-30
103065087549,103065087571,22,3501,1271,-30
103069329874,103069329881,7,2393,1545,-30
103069664765,103069664770,5,2260,1204,-30
103069982599,103069982603,4,1838,936,-30
103084760082,103084760082,0,882,1291,-30
103086451948,103086451953,5,1978,1079,-30
103086655845,103086655850,5,2405,1066,-30
103087850969,103087850973,4,1956,1162,-30
103088089668,103088089648,-20,1526,1066,-30
103089124655,103089124663,8,2517,1227,-30
103089727290,103089727295,5,1689,1186,-30
103090847495,103090847495,0,1191,1252,-30
103091425818,103091425819,1,1112,948,-30
103091901203,103091901186,-17,1837,1273,-30
103098926974,103098926979,5,1866,1124,-30
103101316600,103101316606,6,2929,1687,-30
103101970310,103101970315,5,2328,1700,-30
103102768625,103102768630,5,3967,1671,-30
103106887627,103106887633,6,3452,1596,-30
103107732007,103107732011,4,2540,1977,-30
103110764814,103110764819,5,2236,1969,-30
103110985566,103110985570,4,2226,1367,-30
103111718871,103111718877,6,2597,1578,-30
103114428959,103114428963,4,2098,1773,-30
103116116881,103116116886,5,2364,1220,-30
103119378654,103119378658,4,1742,1490,-30
103119617737,103119617741,4,2822,1575,-30
103121042898,103121042884,-14,1656,1209,-30
103121386495,103121386499,4,2173,1214,-30
103122472226,103122472230,4,2214,1567,-30
103123369025,103123369030,5,2615,1628,-30
103124591579,103124591574,-5,2265,7257,-30
103126256305,103126256312,7,1688,958,-30
103129839417,103129839424,7,12307,29000,-30
103131472238,103131472243,5,2124,990,-30
103131722690,103131722692,2,17688,26814,-30
103134340841,103134340848,7,2221,1589,-30
103136865478,103136865484,6,2297,1511,-30
103138480872,103138480852,-20,631,332,-30
103139106405,103139106409,4,1776,1563,-30
103143008708,103143008711,3,2479,1359,-30
103144817538,103144817545,7,1869,1578,-30
103144869469,103144869474,5,2305,1698,-30
103144964906,103144964910,4,2768,1401,-30
103149424316,103149424322,6,2054,1555,-30
103157964556,103157964561,5,2911,1524,-30
103159659882,103159659887,5,2191,1253,-30
103163931493,103163931497,4,2231,1891,-30
103165090409,103165090415,6,1093,1264,-30
103166390729,103166390725,-4,705,1914,-30
103168168805,103168168810,5,2569,1185,-30
103168924424,103168924439,15,43,1110,-30
103169045168,103169045178,10,1401,868,-30
103169481049,103169481054,5,3680,1320,-30
103171077274,103171077279,5,1851,1073,-30
103171424310,103171424292,-18,2004,1087,-30
103174175034,103174175037,3,2255,1180,-30
103174966822,103174966829,7,2433,1194,-30
103175668831,103175668834,3,1626,1453,-30
103175943263,103175943268,5,2524,1697,-30
103177092466,103177092473,7,2414,1262,-30
103178852973,103178852977,4,1978,943,-30
103179634194,103179634202,8,2747,1265,-30
103183671503,103183671497,-6,1745,7234,-30
103186328933,103186328938,5,2758,1190,-30
103188917845,103188917851,6,1230,769,-30
103189425111,103189425092,-19,1585,743,-30
103190473411,103190473414,3,2450,1781,-30
103190978108,103190978113,5,2232,1239,-30
103196913349,103196913355,6,2187,1370,-30
103198464454,103198464458,4,3230,1651,-30
103199428297,103199428302,5,2405,1210,-30
103201089270,103201089270,0,2163,2587,-30
103201919414,103201919419,5,2180,1796,-30
103202461282,103202461286,4,2696,1228,-30
103204424152,103204424154,2,1995,1831,-30
103204746309,103204746313,4,2585,1584,-30
103209650849,103209650830,-19,1311,839,-30
103210392936,103210392942,6,2779,1340,-30
103211387330,103211387334,4,2540,1252,-30
103213349173,103213349175,2,1197,1154,-30
103221749326,103221749324,-2,1179,2820,-30
103223697354,103223697357,3,2379,1245,-30
103225504682,103225504687,5,3607,1413,-30
103228797335,103228797341,6,2537,1846,-30
103230315568,103230315573,5,1755,1722,-30
103231071311,103231071313,2,1694,1291,-30
103234166255,103234166259,4,2077,1360,-30
103235720426,103235720431,5,1760,1582,-30
103236550466,103236550472,6,2342,1722,-30
103239821515,103239821520,5,2124,1494,-30
103241156059,103241156061,2,1230,971,-30
103242074714,103242074719,5,2987,1419,-30
103245175739,103245175744,5,2801,1515,-30
103247351735,103247351740,5,2466,1344,-30
103248931174,103248931179,5,1706,833,-30
103249071043,103249071028,-15,2400,1165,-30
103250321154,103250321159,5,1779,1055,-30
103250831849,103250831845,-4,18741,15988,-30
103255257501,103255257496,-5,2041,4380,-30
103258554078,103258554083,5,1536,889,-30
103258805396,103258805400,4,2609,1344,-30
103262746260,103262746262,2,1241,1031,-30
103263997810,103263997815,5,1984,1268,-30
103265749980,103265749982,2,1842,978,-30
103271103055,103271103057,2,1532,1703,-30
103274711392,103274711397,5,2279,1528,-30
103277669590,103277669595,5,3054,1729,-30
103277778827,103277778832,5,2535,1402,-30
103279952785,103279952790,5,1875,1158,-30
103282281889,103282281893,4,2130,1182,-30
103282360458,103282360457,-1,1426,2104,-30
103283634607,103283634595,-12,96,462,-30
103284632797,103284632793,-4,34,1729,-30
103287851851,103287851856,5,1282,824,-30
103292323152,103292323152,0,17868,13083,-30
103292583133,103292583135,2,1442,1450,-30
103294993554,103294993549,-5,737,2598,-30
103297831842,103297831845,3,2252,1177,-30
103303340738,103303340744,6,2365,1120,-30
103305975063,103305975069,6,2057,971,-30
103307240361,103307240359,-2,924,2150,-30
103307432483,103307432487,4,2037,1292,-30
103307595848,103307595854,6,2788,1557,-30
103311924469,103311924471,2,1512,1293,-30
103316321890,103316321895,5,3002,1538,-30
103318765366,103318765371,5,1896,1219,-30
103319986268,103319986273,5,1948,726,-30
103321153790,103321153800,10,2200,1287,-30
103323134306,103323134311,5,3474,1739,-30
103323546263,103323546267,4,1355,1065,-30
103326567210,103326567217,7,11259,4749,-30
103336968570,103336968575,5,2149,1042,-30
103337181158,103337181138,-20,1701,852,-30
103338892129,103338892126,-3,1608,2287,-30
103340434114,103340434118,4,2811,1981,-30
103344545441,103344545445,4,2603,1129,-30
103345605059,103345605066,7,2102,1517,-30
103345924362,103345924366,4,2691,1266,-30
103348465690,103348465695,5,2145,1507,-30
103348560333,103348560338,5,1985,1061,-30
103349495253,103349495259,6,2385,1006,-30
103359576297,103359576301,4,2554,880,-30
103363258733,103363258732,-1,915,1175,-30
103364171551,103364171550,-1,27844,24881,-30
103364689888,103364689891,3,1991,1344,-30
103367389630,103367389637,7,2859,1218,-30
103368663464,103368663471,7,1324,1006,-30
103373870177,103373870182,5,2330,1887,-30
103373990060,103373990062,2,2800,2116,-30
103375873596,103375873601,5,2331,1299,-30
103381229854,103381229860,6,2788,1559,-30
103381289566,103381289546,-20,2332,1524,-30
103384457359,103384457365,6,2708,1459,-30
103388130622,103388130627,5,1425,1173,-30
103390349987,103390349991,4,1021,1143,-30
103392577865,103392577870,5,1754,1038,-30
103392655754,103392655746,-8,710,92,-30
103393341906,103393341911,5,1940,1175,-30
103393899741,103393899746,5,1428,988,-30
103395698108,103395698114,6,2826,1162,-30
103396863003,103396863004,1,14087,15120,-30
103399067429,103399067432,3,2044,1520,-30
103403447178,103403447178,0,954,2148,-30
103406593954,103406593957,3,2181,1827,-30
103407016785,103407016790,5,2930,1226,-30
103408856303,103408856306,3,1690,1111,-30
103410859812,103410859819,7,7819,2466,-30
103411950410,103411950416,6,1927,1258,-30
103414020250,103414020251,1,1111,1744,-30
103414575356,103414575358,2,1326,1527,-30
103414771975,103414771981,6,2904,1900,-30
103414814404,103414814410,6,2210,1729,-30
103418297730,103418297734,4,2036,1172,-30
103418970080,103418970085,5,1877,1368,-30
103419456442,103419456445,3,37397,34915,-30
103419731932,103419731938,6,3007,1248,-30
103421083820,103421083824,4,1883,1380,-30
103421365643,103421365656,13,1619,930,-30
103422616897,103422616902,5,2451,1240,-30
103426587423,103426587428,5,2354,1325,-30
103427526442,103427526447,5,1960,1411,-30
103428251333,103428251337,4,2251,1176,-30
103428913095,103428913100,5,1563,1314,-30
103428993777,103428993763,-14,786,238,-30
103430380298,103430380297,-1,1480,1667,-30
103431022725,103431022729,4,2332,918,-30
103434817478,103434817483,5,2254,1002,-30
103442925034,103442925038,4,2056,996,-30
103446777046,103446777051,5,2132,1592,-30
103448170683,103448170690,7,2574,1660,-30
103448793915,103448793919,4,2002,1620,-30
103453159498,103453159502,4,1715,1186,-30
103458798188,103458798194,6,2193,1631,-30
103467372993,103467372997,4,2858,1345,-30
103469390197,103469390204,7,2849,1101,-30
103469509310,103469509312,2,483,83,-30
103471223862,103471223865,3,2024,1268,-30
103472246395,103472246387,-8,776,3299,-30
103476565222,103476565226,4,1421,1171,-30
103481275936,103481275942,6,3021,1271,-30
103484050108,103484050112,4,2504,1693,-30
103484233130,103484233115,-15,1483,1009,-30
103484449341,103484449346,5,2170,958,-30
103484648437,103484648443,6,10806,19899,-30
103486515540,103486515545,5,2500,1630,-30
103488094436,103488094441,5,3698,1689,-30
103491007031,103491007034,3,1364,1236,-30
103491395553,103491395559,6,2293,1143,-30
103493268562,103493268567,5,2153,1228,-30
103501060742,103501060746,4,1752,1691,-30
103501260642,103501260646,4,2193,1233,-30
103502203253,103502203258,5,1243,658,-30
103502238175,103502238181,6,1335,1084,-30
103502805429,103502805433,4,2169,1346,-30
103505093463,103505093468,5,3213,2024,-30
103505150039,103505150045,6,2151,1200,-30
103505422253,103505422250,-3,2611,4547,-30
103509619303,103509619306,3,1594,1520,-30
103510769414,103510769421,7,2579,1535,-30
103516345165,103516345170,5,2491,992,-30
103517096987,103517096989,2,774,1513,-30
103517323311,103517323315,4,2060,863,-30
103521356689,103521356694,5,2245,1143,-30
103522187249,103522187254,5,1978,1249,-30
103522996050,103522996056,6,3516,1805,-30
103523198754,103523198754,0,41978,56144,-30
103524103643,103524103648,5,2447,1595,-30
103526297165,103526297167,2,1283,766,-30
103527140670,103527140676,6,3002,1441,-30
103527426759,103527426766,7,2648,1162,-30
103528565734,103528565739,5,2764,1397,-30
103528857355,103528857362,7,1941,1261,-30
103530920877,103530920884,7,2855,1274,-30
103533168204,103533168210,6,1498,1301,-30
103536331887,103536331890,3,1558,1026,-30
103539811710,103539811715,5,2399,1264,-30
103543047693,103543047698,5,1636,1061,-30
103545027499,103545027502,3,1897,1408,-30
103548522571,103548522574,3,2231,1037,-30
103549350645,103549350645,0,4311,4836,-30
103549772419,103549772413,-6,30159,17442,-30
103550432639,103550432645,6,2466,1237,-30
103551110546,103551110553,7,2491,1175,-30
103551266753,103551266768,15,2205,1355,-30
103552171635,103552171636,1,1182,1721,-30
103552605818,103552605823,5,2335,1544,-30
103554566308,103554566313,5,2172,1509,-30
103557760617,103557760612,-5,664,3066,-30
103557935477,103557935481,4,2276,1378,-30
103558631879,103558631886,7,2147,1264,-30
103560202991,103560202982,-9,1007,4580,-30
103562291617,103562291623,6,2638,1641,-30
103562735461,103562735466,5,2972,1445,-30
103564823810,103564823814,4,2094,1315,-30
103575094578,103575094584,6,2470,1105,-30
103576652894,103576652895,1,2255,1158,-30
103581175326,103581175326,0,1969,1995,-30
103589535185,103589535191,6,1868,1616,-30
103590383138,103590383142,4,1498,1593,-30
103592271735,103592271739,4,950,992,-30
103593082065,103593082052,-13,1944,925,-30
103603438252,103603438258,6,2964,1127,-30
103603592106,103603592109,3,1562,1036,-30
103609892942,103609892949,7,2053,1170,-30
103610513973,103610513979,6,2339,1385,-30
103610959921,103610959926,5,2745,1327,-30
103613355147,103613355151,4,2418,1089,-30
103613845919,103613845927,8,5480,1568,-30
103614000357,103614000362,5,1586,1637,-30
103615577773,103615577778,5,2365,1262,-30
103617669545,103617669532,-13,3998,14708,-30
103619847415,103619847427,12,13369,35050,-30
103628130785,103628130790,5,2706,1532,-30
103628331191,103628331195,4,1971,1689,-30
103629006558,103629006564,6,1841,1154,-30
103633910675,103633910682,7,1396,940,-30
103634618722,103634618704,-18,2162,1438,-30
103634859461,103634859458,-3,1987,5444,-30
103636277919,103636277926,7,2922,1320,-30
103636947714,103636947717,3,2555,2183,-30
103637571243,103637571247,4,2724,1540,-30
103641178841,103641178846,5,1854,1082,-30
103641594419,103641594423,4,1882,1374,-30
103643412538,103643412542,4,1714,892,-30
103643624209,103643624193,-16,1070,269,-30
103647563827,103647563833,6,2404,1255,-30
103654036737,103654036740,3,1616,1290,-30
103654804046,103654804050,4,2362,1242,-30
103666361531,103666361537,6,3215,1925,-30
103668157786,103668157784,-2,893,3279,-30
103668238418,103668238423,5,1630,1177,-30
103670896334,103670896338,4,1600,1211,-30
103674418345,103674418353,8,1568,773,-30
103674897031,103674897036,5,2496,1387,-30
103675162253,103675162258,5,3026,1339,-30
103684638548,103684638546,-2,2146,3280,-30
103686831314,103686831319,5,2250,1452,-30
103689139514,103689139518,4,2309,1740,-30
103690331271,103690331281,10,1356,380,-30
103697251881,103697251885,4,2153,1409,-30
103697921392,103697921396,4,1858,1063,-30
103704073946,103704073952,6,2178,831,-30
103707185306,103707185310,4,2222,1440,-30
103707979941,103707979946,5,2398,1413,-30
103714183164,103714183170,6,3603,1503,-30
103716532871,103716532873,2,2039,1404,-30
103720012256,103720012262,6,1786,1268,-30
103725938144,103725938150,6,2735,1139,-30
103728843746,103728843754,8,2139,708,-30
103735837895,103735837901,6,5157,2929,-30
103736178277,103736178280,3,1791,991,-30
103737371514,103737371520,6,1737,943,-30
103737761841,103737761846,5,2856,1843,-30
103738347309,103738347313,4,2331,1300,-30
103741285943,103741285947,4,2151,927,-30
103741437803,103741437810,7,2912,1570,-30
103743289946,103743289953,7,1675,1357,-30
103747289546,103747289548,2,1512,1472,-30
103748530518,103748530522,4,2453,1792,-30
103750396450,103750396455,5,3374,1592,-30
103750670300,103750670305,5,2662,1309,-30
103751458322,103751458329,7,2429,1109,-30
103751506622,103751506643,21,2867,1421,-30
103752870234,103752870240,6,3656,1326,-30
103760062431,103760062435,4,2169,995,-30
103763963146,103763963153,7,2394,1392,-30
103764842574,103764842579,5,3218,1861,-30
103765987173,103765987178,5,2732,1369,-30
103766976863,103766976867,4,1765,1382,-30
103771111422,103771111426,4,2909,2000,-30
103775142306,103775142310,4,1197,882,-30
103777985562,103777985567,5,2827,1340,-30
103779070647,103779070651,4,2111,841,-30
103779720072,103779720075,3,1097,806,-30
103780178487,103780178493,6,2772,1079,-30
103780811218,103780811200,-18,622,225,-30
103782390918,103782390938,20,2136,1697,-30
103783815525,103783815530,5,2120,1159,-30
103783902886,103783902890,4,1812,1417,-30
103786979110,103786979113,3,2078,1452,-30
103787637284,103787637288,4,2295,1315,-30
103789543422,103789543425,3,2027,1219,-30
103790465949,103790465954,5,2585,1193,-30
103792574386,103792574389,3,1395,965,-30
103801317978,103801317973,-5,1124,4047,-30
103805894118,103805894124,6,1555,1373,-30
103806298614,103806298618,4,2373,1605,-30
103806604271,103806604276,5,2251,1511,-30
103807765797,103807765802,5,1908,1856,-30
103814228752,103814228747,-5,707,2788,-30
103817227301,103817227305,4,1660,908,-30
103818995713,103818995718,5,2418,1497,-30
103825253350,103825253353,3,1938,1435,-30
103831134596,103831134601,5,2015,1029,-30
103834201190,103834201197,7,1663,1238,-30
103836177092,103836177097,5,1913,1040,-30
103836808306,103836808313,7,2260,1012,-30
103839433057,103839433061,4,2953,1249,-30
103841346229,103841346234,5,2493,1337,-30
103842466260,103842466262,2,1544,1284,-30
103853012710,103853012715,5,2843,1254,-30
103854109922,103854109928,6,3250,1657,-30
103854529878,103854529879,1,1664,1243,-30
103857316622,103857316625,3,2199,1241,-30
103859785911,103859785915,4,2814,1274,-30
103860536760,103860536763,3,1731,1653,-30
103862141161,103862141155,-6,1224,4191,-30
103862457114,103862457121,7,1474,1252,-30
103865710967,103865710973,6,2419,1395,-30
103868419030,103868419035,5,3243,1596,-30
103876046013,103876046017,4,2266,1104,-30
103876280012,103876279992,-20,2827,1675,-30
103879339243,103879339241,-2,1266,2815,-30
103880096754,103880096758,4,1519,1313,-30
103883346487,103883346494,7,2783,1133,-30
103893186843,103893186849,6,1047,988,-30
103894295510,103894295516,6,2942,1399,-30
103895885045,103895885050,5,1818,1055,-30
103899599951,103899599956,5,10462,24807,-30
103903570082,103903570086,4,2186,1443,-30
103904154726,103904154730,4,2934,1608,-30
103905561785,103905561782,-3,806,1720,-30
103906032401,103906032394,-7,169,5702,-30
103906999946,103906999951,5,2086,1233,-30
103907612807,103907612786,-21,1536,1158,-30
103911005262,103911005267,5,2482,1080,-30
103911497233,103911497240,7,2525,1691,-30
103913846858,103913846862,4,2160,1590,-30
103915917548,103915917553,5,2208,1167,-30
103925586522,103925586529,7,1509,1363,-30
103927918722,103927918726,4,2112,1125,-30
103931345464,103931345471,7,2790,1298,-30
103932125426,103932125441,15,1273,865,-30
103932974157,103932974163,6,3368,1560,-30
103933721058,103933721062,4,2138,1205,-30
103935283119,103935283126,7,1929,1373,-30
103936429398,103936429403,5,2089,1219,-30
103940492921,103940492902,-19,966,1976,-30
103944067541,103944067544,3,1791,1312,-30
103946162054,103946162061,7,2681,1254,-30
103956676568,103956676562,-6,16,2201,-30
103960674469,103960674474,5,1948,1602,-30
103965245622,103965245626,4,2772,1087,-30
103965445185,103965445191,6,2431,1388,-30
103967432590,103967432586,-4,853,1589,-30
103969262527,103969262522,-5,938,3697,-30
103969920817,103969920821,4,1903,1213,-30
103971575318,103971575322,4,2727,1912,-30
103976976601,103976976606,5,1538,1245,-30
103977110178,103977110183,5,2235,1451,-30
103982837388,103982837395,7,2943,1307,-30
103982904299,103982904283,-16,1957,962,-30
103983188246,103983188252,6,2325,1470,-30
103986304285,103986304289,4,2817,1541,-30
103989653721,103989653726,5,1961,976,-30
103994779838,103994779843,5,2424,1750,-30
103995470073,103995470058,-15,1784,1207,-30
103996468681,103996468683,2,2526,1816,-30
104001912838,104001912842,4,1237,1219,-30
104003670553,104003670555,2,1916,1284,-30
104004470290,104004470296,6,2654,1823,-30
104007323487,104007323491,4,1546,972,-30
104009381521,104009381526,5,1707,605,-30
104009629917,104009629921,4,2515,1268,-30
104012676705,104012676709,4,2023,1470,-30
104016014666,104016014671,5,1822,1047,-30
104017358730,104017358722,-8,3849,9087,-30
104018314801,104018314794,-7,1228,7474,-30
104018359828,104018359833,5,2417,1473,-30
104021934458,104021934462,4,2369,1390,-30
104022727317,104022727322,5,2576,1289,-30
104030140618,104030140621,3,1965,1061,-30
104030364144,104030364149,5,2502,1372,-30
104033497001,104033497013,12,16191,36580,-30
104037490627,104037490633,6,2114,1036,-30
104040250240,104040250244,4,1542,1121,-30
104041911636,104041911638,2,1900,1299,-30
104043527826,104043527830,4,2538,1560,-30
104047558652,104047558659,7,4280,1361,-30
104053065735,104053065742,7,3524,1861,-30
104053296899,104053296907,8,825,787,-30
104053430494,104053430513,19,2971,943,-30
104053608408,104053608427,19,2730,1053,-30
104055355717,104055355724,7,3720,1805,-30
104056143218,104056143221,3,2879,1551,-30
104059226178,104059226185,7,2906,1756,-30
104060041914,104060041917,3,1242,1394,-30
104060706755,104060706753,-2,1379,1948,-30
104064966578,104064966585,7,2759,1941,-30
104066012670,104066012675,5,2525,1187,-30
104069390750,104069390755,5,1996,1288,-30
104069583878,104069583886,8,3232,1279,-30
104071701049,104071701054,5,2123,1304,-30
104072283190,104072283171,-19,3941,1159,-30
104073098273,104073098278,5,2942,1675,-30
104073548403,104073548406,3,2038,1363,-30
104075118107,104075118111,4,3284,1141,-30
104075891734,104075891738,4,2031,1207,-30
104086410534,104086410538,4,1950,1827,-30
104090711596,104090711602,6,1669,985,-30
104090921049,104090921052,3,1666,988,-30
104094319107,104094319106,-1,1388,2145,-30
104095201915,104095201919,4,1858,1208,-30
104097612434,104097612438,4,2476,1112,-30
104098115156,104098115161,5,2214,1268,-30
104099196089,104099196096,7,2059,1436,-30
104101964638,104101964645,7,6881,2438,-30
104102092746,104102092751,5,1761,1347,-30
104105540722,104105540727,5,1672,1174,-30
104105613115,104105613121,6,2662,1419,-30
104108333862,104108333867,5,2970,1086,-30
104108504497,104108504482,-15,2370,1272,-30
104108683915,104108683898,-17,1158,374,-30
104112143771,104112143786,15,10871,50533,-30
104114268606,104114268602,-4,1750,4344,-30
104116725728,104116725733,5,3208,1488,-30
104120388442,104120388442,0,1668,2063,-30
104126715698,104126715704,6,3328,1863,-30
104133517965,104133517971,6,2801,1129,-30
104138556904,104138556909,5,1927,1493,-30
104143846080,104143846086,6,2230,1365,-30
104147095650,104147095654,4,2863,1206,-30
104147948799,104147948778,-21,2534,1390,-30
104148885630,104148885636,6,2663,1545,-30
104150147768,104150147772,4,2798,2281,-30
104156162888,104156162892,4,1682,1532,-30
104161431603,104161431608,5,1432,1179,-30
104164323658,104164323649,-9,1687,1722,-30
104170802209,104170802213,4,2127,1140,-30
104171393171,104171393177,6,1948,1219,-30
104172286935,104172286914,-21,3103,2174,-30
104173989410,104173989413,3,2229,2015,-30
104174998255,104174998262,7,3464,1681,-30
104176337111,104176337115,4,3114,1437,-30
104176578045,104176578046,1,2188,3296,-30
104177119281,104177119287,6,2914,1536,-30
104180605971,104180605978,7,3088,1071,-30
104183718957,104183718961,4,2143,1222,-30
104183955118,104183955098,-20,902,718,-30
104185391437,104185391440,3,1949,1224,-30
104190462634,104190462629,-5,217,3912,-30
104191154122,104191154114,-8,2083,8441,-30
104192520778,104192520783,5,2495,1475,-30
104193186764,104193186770,6,2789,1476,-30
104193943094,104193943100,6,1885,1707,-30
104200312110,104200312116,6,3272,1730,-30
104200638747,104200638732,-15,1436,859,-30
104200922571,104200922576,5,2394,1049,-30
104207467145,104207467150,5,2214,1443,-30
104208121118,104208121123,5,3706,1391,-30
104210320841,104210320846,5,2363,1583,-30
104212090242,104212090247,5,2492,1535,-30
104213257233,104213257238,5,2246,1178,-30
104217035143,104217035136,-7,728,2752,-30
104218873414,104218873419,5,1804,1123,-30
104220846837,104220846842,5,1782,1205,-30
104220954354,104220954359,5,2983,1600,-30
104224790083,104224790090,7,5962,2888,-30
104224903116,104224903122,6,1895,972,-30
104224956270,104224956277,7,2567,1021,-30
104226059398,104226059399,1,1012,1481,-30
104226236456,104226236461,5,2369,1405,-30
104228493552,104228493557,5,2598,1718,-30
104231244199,104231244204,5,1805,1236,-30
104231479470,104231479474,4,2352,1646,-30
104238181018,104238181021,3,2654,964,-30
104238352976,104238352978,2,2618,1435,-30
104248636094,104248636102,8,4422,1567,-30
104251488687,104251488692,5,2949,1391,-30
104252466118,104252466126,8,5402,2099,-30
104252507247,104252507251,4,2362,1471,-30
104255077483,104255077489,6,2747,1871,-30
104255248789,104255248793,4,1766,1501,-30
104258259117,104258259116,-1,32542,18236,-30
104259320457,104259320461,4,2385,992,-30
104265698817,104265698823,6,1934,1208,-30
104266227559,104266227566,7,2814,1426,-30
104266603669,104266603673,4,3155,2051,-30
104282573407,104282573411,4,2655,1360,-30
104283961941,104283961946,5,1955,885,-30
104285983522,104285983528,6,2465,1588,-30
104286037313,104286037316,3,1734,1450,-30
104290535298,104290535302,4,1779,1311,-30
104292390301,104292390306,5,1772,1510,-30
104292776858,104292776862,4,2057,1484,-30
104293994433,104293994439,6,2005,1126,-30
104294497299,104294497303,4,3033,1351,-30
104294872133,104294872137,4,1866,1344,-30
104297167182,104297167186,4,1823,885,-30
104298537783,104298537796,13,1216,3416,-30
104301527370,104301527376,6,2766,1274,-30
104302059252,104302059257,5,2524,1560,-30
104304139316,104304139323,7,2137,1048,-30
104305283963,104305283966,3,1492,1110,-30
104308820865,104308820869,4,1260,640,-30
104312032377,104312032384,7,3066,1608,-30
104326978984,104326978988,4,1741,1176,-30
104327574634,104327574640,6,2508,1365,-30
104331746633,104331746638,5,2842,1387,-30
104331855595,104331855599,4,1427,994,-30
104333972839,104333972845,6,2202,1338,-30
104334880510,104334880514,4,1687,1284,-30
104334967419,104334967416,-3,813,186,-30
104338188416,104338188422,6,2408,1397,-30
104338624955,104338624963,8,2801,1537,-30
104340546768,104340546770,2,1279,1399,-30
104342859606,104342859611,5,2387,1043,-30
104345038124,104345038127,3,2373,1389,-30
104349563328,104349563337,9,14244,39208,-30
104350402822,104350402825,3,1748,959,-30
104352150303,104352150317,14,14958,20604,-30
104355318841,104355318846,5,992,1164,-30
104358607484,104358607487,3,1304,902,-30
104361102598,104361102604,6,2730,1488,-30
104365396624,104365396626,2,2027,1248,-30
104366664649,104366664655,6,2331,1294,-30
104369040145,104369040151,6,2671,1400,-30
104374949002,104374949007,5,2143,1090,-30
104376197945,104376197947,2,52327,29197,-30
104376943389,104376943391,2,1336,1174,-30
104377039470,104377039475,5,2554,1617,-30
104378156446,104378156451,5,2106,1319,-30
104380434658,104380434665,7,2430,1231,-30
104380958713,104380958718,5,2035,1125,-30
104385723322,104385723318,-4,1116,4018,-30
104389993100,104389993105,5,2607,1497,-30
104392234237,104392234241,4,1894,1079,-30
104393221286,104393221291,5,2121,1215,-30
104394463749,104394463754,5,3019,1065,-30
104395084193,104395084179,-14,994,610,-30
104400013712,104400013718,6,1866,1365,-30
104405756448,104405756453,5,2260,1322,-30
104406776356,104406776356,0,5804,6902,-30
104407089261,104407089267,6,1216,876,-30
104407608586,104407608589,3,2994,1847,-30
104407965849,104407965853,4,2041,1572,-30
104408432482,104408432486,4,2244,1147,-30
104409014667,104409014671,4,1707,1063,-30
104412139565,104412139567,2,1779,1069,-30
104419840398,104419840405,7,2379,1150,-30
104420402299,104420402302,3,2081,1612,-30
104421174005,104421174008,3,2063,1606,-30
104423787002,104423786995,-7,1413,5377,-30
104424359409,104424359413,4,1836,1570,-30
104424543969,104424543975,6,2312,1689,-30
104424600456,104424600458,2,1229,930,-30
104429371083,104429371089,6,3125,1409,-30
104430416474,104430416459,-15,1616,1672,-30
104430731187,104430731191,4,1049,1086,-30
104431334890,104431334899,9,3522,1107,-30
104436246041,104436246046,5,2628,1891,-30
104439151077,104439151082,5,1842,1457,-30
104439559178,104439559182,4,2252,916,-30
104440575887,104440575891,4,2154,1407,-30
104442065820,104442065826,6,3603,1659,-30
104444877069,104444877074,5,2677,1288,-30
104446449487,104446449485,-2,1048,2508,-30
104447353568,104447353571,3,2009,902,-30
104448016192,104448016185,-7,515,136,-30
104448622610,104448622616,6,2927,1556,-30
104448936956,104448936961,5,2167,1111,-30
104453999401,104453999406,5,2244,960,-30
104454808084,104454808086,2,2181,1566,-30
104458169372,104458169374,2,2415,1544,-30
104462102322,104462102325,3,1521,938,-30
104464386345,104464386350,5,1751,1051,-30
104466929614,104466929615,1,1668,2081,-30
104467958371,104467958378,7,2451,1391,-30
104470495738,104470495746,8,1665,1125,-30
104471767442,104471767447,5,2081,1494,-30
104475800317,104475800322,5,1433,918,-30
104479815930,104479815935,5,3084,1491,-30
104480985783,104480985785,2,3004,2895,-30
104482118614,104482118622,8,3318,1499,-30
104482471133,104482471137,4,2820,1456,-30
104482533714,104482533710,-4,772,2393,-30
104486132330,104486132334,4,2498,1415,-30
104487918498,104487918499,1,1089,1147,-30
104489485218,104489485224,6,1876,1060,-30
104490934579,104490934586,7,4029,1258,-30
104491397042,104491397049,7,2819,1504,-30
104494444882,104494444887,5,1944,1361,-30
104497595853,104497595858,5,2264,1597,-30
104499694672,104499694674,2,1731,1071,-30
104502823521,104502823526,5,2165,1474,-30
104502866502,104502866505,3,2947,1668,-30
104506599773,104506599781,8,2728,1355,-30
104507578482,104507578482,0,1450,2177,-30
104511618705,104511618700,-5,1362,3541,-30
104512106294,104512106295,1,2072,1551,-30
104513635736,104513635739,3,2074,1259,-30
104514954527,104514954533,6,1844,1145,-30
104515429222,104515429226,4,1915,1292,-30
104516857869,104516857874,5,3007,1128,-30
104516899354,104516899368,14,1510,785,-30
104522234331,104522234335,4,2215,1158,-30
104522572817,104522572803,-14,2447,1354,-30
104526151434,104526151438,4,2190,1481,-30
104526302202,104526302208,6,2370,1328,-30
104527393582,104527393590,8,2891,1407,-30
104529317654,104529317655,1,2273,2202,-30
104531555415,104531555410,-5,770,1046,-30
104534585227,104534585234,7,2800,1337,-30
104536783053,104536783061,8,1406,993,-30
104539401133,104539401137,4,2859,1455,-30
104539474930,104539474937,7,1263,662,-30
104552096954,104552096958,4,2095,1284,-30
104553726507,104553726506,-1,3964,4121,-30
104557981494,104557981502,8,4843,2206,-30
104560288505,104560288510,5,1947,986,-30
104560926476,104560926470,-6,2061,6739,-30
104560994218,104560994223,5,2332,1329,-30
104561913622,104561913629,7,1162,746,-30
104566051662,104566051659,-3,1272,2371,-30
104570676049,104570676054,5,2118,1400,-30
104571559554,104571559558,4,2346,1101,-30
104572107910,104572107916,6,1836,1161,-30
104572509319,104572509325,6,3863,1469,-30
104572733438,104572733442,4,2138,1289,-30
104574756637,104574756641,4,3990,2171,-30
104577382034,104577382037,3,1912,1293,-30
104578757858,104578757863,5,1591,938,-30
104579288969,104579288971,2,1540,1341,-30
104580163643,104580163649,6,1780,1426,-30
104581228053,104581228048,-5,28045,13853,-30
104584888222,104584888226,4,2420,1267,-30
104590133044,104590133049,5,3973,2243,-30
104593658202,104593658206,4,1300,1131,-30
104594057660,104594057663,3,1588,1082,-30
104594239599,104594239603,4,2709,1817,-30
104594517217,104594517222,5,1834,1056,-30
104597385572,104597385576,4,2203,1340,-30
104600422330,104600422335,5,3704,1462,-30
104601535066,104601535071,5,2095,1540,-30
104602650929,104602650932,3,2217,1376,-30
104606250121,104606250125,4,1916,1503,-30
104606615650,104606615667,17,711,353,-30
104609124817,104609124822,5,3793,1490,-30
104614068130,104614068135,5,1768,1218,-30
104616845977,104616845982,5,1880,1183,-30
104618065767,104618065776,9,2913,1420,-30
104623071809,104623071814,5,1968,1406,-30
104624263364,104624263368,4,1568,1220,-30
104624539815,104624539826,11,2937,1311,-30
104628070548,104628070551,3,2491,1431,-30
104630754789,104630754794,5,1680,889,-30
104644158038,104644158043,5,3888,1678,-30
104644691838,104644691843,5,2127,1310,-30
104645706509,104645706515,6,2333,1158,-30
104648086993,104648086998,5,2344,1255,-30
104656742018,104656742022,4,1992,1275,-30
104658821733,104658821734,1,1379,1788,-30
104664951209,104664951214,5,2050,1767,-30
104667161894,104667161893,-1,1008,1518,-30
104669947051,104669947056,5,2407,1419,-30
104673350278,104673350282,4,2176,1191,-30
104677139167,104677139172,5,1860,1128,-30
104677776924,104677776927,3,2269,1665,-30
104679277778,104679277783,5,1895,1224,-30
104679527272,104679527275,3,1345,1021,-30
104682523884,104682523885,1,2803,2908,-30
104683714909,104683714912,3,17161,21160,-30
104688836281,104688836282,1,1816,1779,-30
104689611818,104689611825,7,3454,1862,-30
104692396754,104692396757,3,2934,1974,-30
104694743873,104694743881,8,1594,1081,-30
104697987756,104697987761,5,2450,1665,-30
104700688358,104700688362,4,3025,1538,-30
104701003500,104701003505,5,2177,1517,-30
104701838685,104701838671,-14,2221,1261,-30
104702238988,104702238992,4,1711,1254,-30
104702891266,104702891271,5,1267,1277,-30
104706506841,104706506847,6,1876,1112,-30
104706666858,104706666849,-9,994,238,-30
104714547978,104714547982,4,2193,1104,-30
104717288948,104717288954,6,2829,1626,-30
104717473898,104717473904,6,2895,1337,-30
104718023827,104718023836,9,2377,1165,-30
104718334932,104718334938,6,1877,1543,-30
104719137502,104719137503,1,955,1344,-30
104720231225,104720231229,4,2260,1399,-30
104720805453,104720805457,4,1576,945,-30
104727108434,104727108439,5,2143,1054,-30
104727563404,104727563408,4,2292,1219,-30
104730217721,104730217728,7,3409,1483,-30
104736500989,104736500991,2,2304,1673,-30
104737399627,104737399631,4,2280,1190,-30
104738078502,104738078509,7,2578,1126,-30
104738340534,104738340514,-20,892,548,-30
104742219000,104742219006,6,2609,1327,-30
104746981105,104746981109,4,1973,1297,-30
104748303707,104748303711,4,1701,1622,-30
104755630124,104755630122,-2,23573,16090,-30
104757221750,104757221732,-18,2372,1888,-30
104760377294,104760377293,-1,1027,1191,-30
104760509974,104760509978,4,1551,928,-30
104762669982,104762669985,3,2092,1497,-30
104764850742,104764850742,0,1327,1612,-30
104767009129,104767009121,-8,466,3170,-30
104768424421,104768424426,5,1736,1676,-30
104770819338,104770819341,3,1430,1208,-30
104772114990,104772114996,6,2734,1638,-30
104773918661,104773918666,5,1712,1068,-30
104775257106,104775257110,4,1360,825,-30
104778656299,104778656304,5,1575,1025,-30
104778894186,104778894192,6,1881,1398,-30
104782302427,104782302433,6,2331,825,-30
104784984824,104784984830,6,2171,1099,-30
104786346984,104786346990,6,1711,947,-30
104789858462,104789858466,4,1475,1102,-30
104795903239,104795903242,3,2358,2057,-30
104798055602,104798055607,5,1897,1483,-30
104800844451,104800844457,6,2623,1480,-30
104801823814,104801823824,10,907,355,-30
104805081408,104805081410,2,2095,1781,-30
104812901330,104812901331,1,1619,1687,-30
104816492483,104816492490,7,3415,2104,-30
104817171653,104817171658,5,3023,1617,-30
104817506062,104817506068,6,2395,1585,-30
104818962419,104818962423,4,2296,1021,-30
104823556094,104823556098,4,1938,1473,-30
104827130242,104827130245,3,1331,1202,-30
104830304478,104830304474,-4,1413,1454,-30
104830535986,104830536003,17,2360,1302,-30
104831352123,104831352127,4,1835,1572,-30
104832795498,104832795502,4,1404,1382,-30
104834151722,104834151727,5,1272,834,-30
104835172683,104835172687,4,2231,1478,-30
104835574053,104835574058,5,1853,1223,-30
104837996580,104837996583,3,1292,1209,-30
104839101559,104839101565,6,43012,21015,-30
104845738859,104845738864,5,2285,1307,-30
104846241484,104846241499,15,1347,171,-30
104847847409,104847847412,3,2387,1544,-30
104856785806,104856785811,5,2387,1386,-30
104860654139,104860654144,5,2311,1421,-30
104862007084,104862007087,3,1870,1510,-30
104873380802,104873380805,3,2930,1374,-30
104877708465,104877708459,-6,1212,2812,-30
104878496595,104878496602,7,6757,2776,-30
104879677748,104879677753,5,1692,1262,-30
104882460886,104882460886,0,2726,4214,-30
104886472386,104886472384,-2,2085,3716,-30
104888267690,104888267691,1,1083,1473,-30
104891112968,104891112972,4,1858,1255,-30
104892892378,104892892386,8,2039,1192,-30
104895135218,104895135222,4,2607,1552,-30
104898704201,104898704206,5,2855,1855,-30
104900537008,104900537002,-6,1415,2415,-30
104901948085,104901948092,7,1834,858,-30
104904151740,104904151745,5,2423,1466,-30
104904442815,104904442794,-21,2481,1064,-30
104906084837,104906084842,5,2208,1673,-30
104908982917,104908982922,5,2927,1333,-30
104916188151,104916188157,6,2837,1439,-30
104916788583,104916788588,5,3048,1161,-30
104917732278,104917732282,4,3067,1403,-30
104919787061,104919787066,5,2406,1218,-30
104920096278,104920096256,-22,1810,1246,-30
104921314229,104921314211,-18,1222,806,-30
104927651592,104927651596,4,2430,1808,-30
104930613513,104930613519,6,1967,710,-30
104932837286,104932837292,6,2271,1405,-30
104936718530,104936718535,5,1630,988,-30
104938005055,104938005061,6,1439,1319,-30
104943716346,104943716351,5,2250,1391,-30
104944701712,104944701717,5,2441,1105,-30
104945271842,104945271838,-4,2084,6237,-30
104946643574,104946643580,6,3256,1586,-30
104948518481,104948518485,4,2049,1153,-30
104952485262,104952485269,7,3614,1136,-30
104953255773,104953255769,-4,1610,2935,-30
104957041309,104957041313,4,1741,655,-30
104958316602,104958316607,5,2055,1289,-30
104967850946,104967850950,4,2265,1076,-30
104972798601,104972798605,4,2461,1416,-30
104974239354,104974239358,4,1973,1655,-30
104979804291,104979804293,2,1478,1839,-30
104980665530,104980665536,6,2070,1388,-30
104980798771,104980798766,-5,972,1933,-30
104981783107,104981783114,7,1843,943,-30
104982160292,104982160295,3,1633,1494,-30
104983132317,104983132324,7,3165,1862,-30
104985150846,104985150850,4,2307,1140,-30
104987105787,104987105792,5,3069,1752,-30
104991521737,104991521737,0,1138,1704,-30
104996406626,104996406632,6,1925,1450,-30
104998283918,104998283921,3,2250,1561,-30
104998712030,104998712012,-18,1815,1286,-30
104998901570,104998901575,5,2167,1340,-30
105000889390,105000889389,-1,1357,4305,-30
105005265275,105005265279,4,2018,1223,-30
105005626486,105005626470,-16,1152,1542,-30
105005690781,105005690787,6,1936,1216,-30
105010312040,105010312046,6,2324,1263,-30
105012150762,105012150767,5,2293,1282,-30
105015552225,105015552229,4,2682,889,-30
105017536414,105017536419,5,1534,1075,-30
105022179965,105022179971,6,1851,1311,-30
105025372209,105025372213,4,1334,537,-30
105027864400,105027864403,3,2064,1560,-30
105028290579,105028290584,5,2548,1125,-30
105031037104,105031037103,-1,1331,1738,-30
105031909355,105031909340,-15,1852,1031,-30
105033371333,105033371342,9,1868,776,-30
105033767374,105033767379,5,4055,2410,-30
105054137410,105054137414,4,2290,1063,-30
105056130119,105056130120,1,25781,22867,-30
105057190546,105057190551,5,1441,1290,-30
105058272534,105058272539,5,1958,1165,-30
105060165038,105060165043,5,1056,829,-30
105060972234,105060972239,5,1750,743,-30
105061337311,105061337315,4,1801,1180,-30
105065906046,105065906050,4,2225,1335,-30
105066421114,105066421117,3,2217,1909,-30
105068931754,105068931758,4,2034,1329,-30
105069114798,105069114797,-1,1440,1796,-30
105070359098,105070359103,5,1837,1144,-30
105074659001,105074659004,3,1364,1065,-30
105077912796,105077912787,-9,4802,15073,-30
105079588516,105079588521,5,1953,1739,-30
105085566334,105085566338,4,2459,1297,-30
105087081804,105087081807,3,1704,1060,-30
105087804265,105087804270,5,2193,1422,-30
105087925114,105087925118,4,1374,1365,-30
105088218731,105088218734,3,1983,1011,-30
105088335173,105088335156,-17,1982,947,-30
105091328447,105091328451,4,2196,1009,-30
105095564653,105095564659,6,2340,1744,-30
105096229382,105096229385,3,2665,1664,-30
105096550395,105096550399,4,2716,1148,-30
105099077367,105099077372,5,2091,1358,-30
105101769633,105101769638,5,2211,1115,-30
105102831882,105102831886,4,2167,1174,-30
105104582366,105104582371,5,2869,1286,-30
105108243030,105108243037,7,2113,1208,-30
105113488206,105113488212,6,2203,1146,-30
105115786958,105115786961,3,2398,1741,-30
105118660571,105118660579,8,2268,1181,-30
105124017338,105124017343,5,2375,909,-30
105124214737,105124214743,6,3564,1119,-30
105126437390,105126437394,4,3159,1545,-30
105128229434,105128229439,5,2794,1902,-30
105128946703,105128946707,4,1955,1216,-30
105129218765,105129218769,4,2038,1100,-30
105130046698,105130046702,4,1975,980,-30
105132073630,105132073634,4,1926,1446,-30
105132736160,105132736165,5,2293,1390,-30
105133447843,105133447849,6,1949,927,-30
105135074742,105135074749,7,3705,1578,-30
105135758934,105135758915,-19,2669,756,-30
105144925317,105144925321,4,1896,1424,-30
105146158198,105146158177,-21,879,544,-30
105149664898,105149664906,8,2583,1238,-30
105153524906,105153524910,4,2429,1146,-30
105156433767,105156433772,5,1985,1268,-30
105158280799,105158280805,6,1982,1451,-30
105158709825,105158709830,5,2176,1316,-30
105159672116,105159672120,4,2229,1144,-30
105162402038,105162402043,5,1529,1209,-30
105163496902,105163496906,4,1898,1452,-30
105163875962,105163875958,-4,2040,4495,-30
105164286347,105164286352,5,2059,1165,-30
105165183946,105165183953,7,2218,824,-30
105169268749,105169268744,-5,1154,4005,-30
105171752042,105171752046,4,1839,1261,-30
105172459142,105172459144,2,20195,39123,-30
105173093640,105173093643,3,1885,1085,-30
105177632590,105177632594,4,2623,1530,-30
105181597514,105181597517,3,2036,1708,-30
105182535597,105182535601,4,2262,1363,-30
105184830897,105184830898,1,1528,1585,-30
105189710032,105189710037,5,1747,1027,-30
105191849813,105191849817,4,3105,1499,-30
105194011062,105194011067,5,1821,1221,-30
105195424462,105195424469,7,3573,1780,-30
105196665374,105196665378,4,993,376,-30
105198069794,105198069799,5,2575,1661,-30
105202296530,105202296537,7,2802,1477,-30
105202489188,105202489192,4,1323,886,-30
105204718007,105204718013,6,1919,1524,-30
105209231446,105209231452,6,3452,1385,-30
105211366624,105211366631,7,2194,1093,-30
105212178886,105212178891,5,2526,1143,-30
105214164337,105214164343,6,1976,1535,-30
105219114356,105219114363,7,1820,983,-30
105229252709,105229252729,20,2284,1288,-30
105234539777,105234539781,4,1735,1152,-30
105237336742,105237336762,20,662,89,-30
105238668246,105238668250,4,3111,2052,-30
105240039899,105240039891,-8,1626,8808,-30
105241653699,105241653698,-1,2571,4638,-30
105244408354,105244408359,5,1315,798,-30
105245784610,105245784617,7,3691,1006,-30
105246894242,105246894246,4,1952,1052,-30
105252969062,105252969067,5,2188,1176,-30
105256001047,105256001051,4,1645,1362,-30
105258089993,105258090002,9,2754,1038,-30
105258171307,105258171310,3,1562,1203,-30
105258471030,105258471034,4,2713,1360,-30
105258849786,105258849793,7,2313,1274,-30
105259330042,105259330047,5,1596,1347,-30
105262373458,105262373462,4,3244,1901,-30
105269535959,105269535964,5,2368,1627,-30
105271041770,105271041776,6,2183,1241,-30
105271690822,105271690827,5,1425,1284,-30
105272696882,105272696890,8,1520,591,-30
105274007527,105274007533,6,4789,2667,-30
105274417991,105274417996,5,1871,817,-30
105275444170,105275444162,-8,1785,583,-30
105276048262,105276048271,9,3194,1005,-30
105278246789,105278246795,6,3532,1399,-30
105278732729,105278732735,6,2021,1060,-30
105279873196,105279873201,5,2561,1392,-30
105280508773,105280508778,5,3311,1742,-30
105282197525,105282197530,5,1718,1112,-30
105289764517,105289764522,5,2537,923,-30
105291972536,105291972541,5,3909,1556,-30
105292368134,105292368138,4,2848,1268,-30
105292747383,105292747387,4,1678,1331,-30
105293491422,105293491428,6,2272,1363,-30
105295782967,105295782962,-5,3914,12854,-30
105298678891,105298678893,2,1856,1405,-30
105302213393,105302213399,6,2218,1199,-30
105303023246,105303023250,4,2195,865,-30
105304275176,105304275183,7,3051,945,-30
105309178253,105309178258,5,2682,1042,-30
105313500726,105313500731,5,1800,1570,-30
105320911477,105320911481,4,3212,2196,-30
105321258300,105321258307,7,2035,950,-30
105321701594,105321701611,17,739,436,-30
105328806774,105328806778,4,1348,970,-30
105331196750,105331196755,5,2385,1335,-30
105332847493,105332847498,5,2198,1298,-30
105333498588,105333498593,5,2364,975,-30
105335026234,105335026239,5,1176,912,-30
105337947868,105337947873,5,2523,1241,-30
105342632442,105342632446,4,2478,1247,-30
105343765759,105343765765,6,1796,1056,-30
105344590385,105344590391,6,2145,1150,-30
105346766949,105346766955,6,2951,1356,-30
105348619483,105348619487,4,2244,927,-30
105349671419,105349671421,2,1511,1047,-30
105350000606,105350000610,4,1513,1161,-30
105361053267,105361053270,3,2081,1467,-30
105361908331,105361908334,3,1664,1354,-30
105363025646,105363025650,4,2201,1011,-30
105364379936,105364379943,7,2180,950,-30
105366198906,105366198911,5,1169,626,-30
105367201789,105367201794,5,2405,727,-30
105368766747,105368766751,4,1872,1760,-30
105369026488,105369026494,6,3870,1702,-30
105371981909,105371981915,6,2788,909,-30
105373307836,105373307843,7,2071,897,-30
105375691094,105375691098,4,2263,1506,-30
105381644313,105381644306,-7,31146,7243,-30
105391119002,105391119007,5,2803,1078,-30
105395137849,105395137853,4,1672,1038,-30
105403313782,105403313788,6,1853,943,-30
105404782987,105404782976,-11,863,270,-30
105407586374,105407586381,7,2084,1055,-30
105410013078,105410013081,3,1647,999,-30
105412124040,105412124044,4,2451,1257,-30
105412357409,105412357407,-2,1680,3251,-30
105412450075,105412450080,5,2565,914,-30
105416304305,105416304309,4,1869,1434,-30
105416713707,105416713711,4,1675,1440,-30
105421953969,105421953971,2,1830,1233,-30
105423864701,105423864702,1,959,1613,-30
105426043524,105426043530,6,1768,1372,-30
105427861040,105427861021,-19,170,1980,-30
105430077689,105430077691,2,1955,1256,-30
105435283378,105435283384,6,2647,1888,-30
105435598363,105435598367,4,2110,1229,-30
105438732036,105438732039,3,1857,691,-30
105441356322,105441356326,4,1771,691,-30
105443628862,105443628866,4,1705,1704,-30
105454877004,105454877009,5,1901,1525,-30
105456646659,105456646663,4,2548,1655,-30
105457168915,105457168910,-5,479,1325,-30
105457606546,105457606550,4,2670,1453,-30
105462197706,105462197711,5,1436,1525,-30
105464968366,105464968370,4,2006,1199,-30
105465131977,105465131982,5,1868,1343,-30
105469528060,105469528063,3,1809,1366,-30
105473932378,105473932385,7,2391,1317,-30
105475805357,105475805362,5,2516,1869,-30
105480953723,105480953729,6,1980,1267,-30
105481017442,105481017446,4,2711,1674,-30
105482551746,105482551750,4,1845,1458,-30
105483023038,105483023041,3,1536,1294,-30
105490374977,105490374983,6,2256,1023,-30
105492181566,105492181577,11,1888,1072,-30
105493559047,105493559052,5,1382,885,-30
105494570734,105494570738,4,1456,952,-30
105496134277,105496134282,5,2414,1608,-30
105499396990,105499396998,8,2185,849,-30
105500034491,105500034495,4,2073,1073,-30
105500457726,105500457731,5,2481,1408,-30
105501957903,105501957907,4,1392,949,-30
105512659387,105512659391,4,1900,1148,-30
105512815380,105512815383,3,2045,1429,-30
105514238889,105514238894,5,2189,1513,-30
105514810185,105514810191,6,1941,1541,-30
105516287586,105516287592,6,2996,1362,-30
105516895818,105516895824,6,833,388,-30
105517261513,105517261515,2,2059,1781,-30
105518671009,105518671014,5,3138,1651,-30
105519754246,105519754251,5,2175,1134,-30
105521200056,105521200058,2,2102,1171,-30
105522443499,105522443501,2,3226,3061,-30
105524952852,105524952854,2,42336,18560,-30
105525245141,105525245144,3,2126,1149,-30
105525736519,105525736497,-22,1081,605,-30
105527079313,105527079317,4,2483,1278,-30
105527194701,105527194705,4,1880,1516,-30
105528486078,105528486085,7,2960,1486,-30
105529842210,105529842214,4,2498,1624,-30
105530940096,105530940101,5,3296,1470,-30
105531738631,105531738635,4,2525,1013,-30
105531952604,105531952608,4,2340,1345,-30
105537283517,105537283523,6,3106,1684,-30
105537722813,105537722817,4,2317,1672,-30
105542288794,105542288800,6,2090,1410,-30
105543093253,105543093258,5,1963,1431,-30
105546644583,105546644568,-15,967,630,-30
105547870499,105547870503,4,2213,1413,-30
105548867346,105548867344,-2,4872,9916,-30
105549050045,105549050046,1,37651,24254,-30
105550166715,105550166721,6,2498,921,-30
105552691503,105552691506,3,1480,1434,-30
105553064509,105553064515,6,1609,940,-30
105553841903,105553841907,4,1774,1634,-30
105554332328,105554332332,4,1732,1447,-30
105555903005,105555903006,1,1757,1159,-30
105559352011,105559351990,-21,2962,1454,-30
105563150446,105563150450,4,1801,982,-30
105567007693,105567007698,5,2643,1218,-30
105571807810,105571807814,4,2891,1037,-30
105572611777,105572611780,3,2970,1903,-30
105572989746,105572989752,6,2465,1387,-30
105574465508,105574465511,3,2045,1247,-30
105576164988,105576164992,4,2460,1514,-30
105576439284,105576439290,6,1847,937,-30
105579705201,105579705206,5,2216,1354,-30
105579751670,105579751666,-4,946,2334,-30
105581769322,105581769327,5,3007,1941,-30
105586593847,105586593852,5,3662,1454,-30
105588215614,105588215619,5,2009,1152,-30
105590742928,105590742925,-3,856,2336,-30
105593259823,105593259826,3,1334,1303,-30
105593419949,105593419954,5,2719,1651,-30
105594322062,105594322069,7,4273,2636,-30
105600385156,105600385161,5,2156,1428,-30
105607425802,105607425806,4,1235,987,-30
105608272798,105608272801,3,1538,1468,-30
105612819017,105612819018,1,1446,1835,-30
105618447356,105618447362,6,3540,1325,-30
105623098835,105623098841,6,2926,1912,-30
105623393413,105623393419,6,2268,1662,-30
105628626569,105628626575,6,1501,1412,-30
105629110938,105629110942,4,3290,1571,-30
105629555270,105629555277,7,2877,1179,-30
105629869985,105629869989,4,1253,1243,-30
105630106402,105630106411,9,2816,1677,-30
105636111821,105636111826,5,3103,1605,-30
105636362194,105636362199,5,1700,1035,-30
105637518689,105637518689,0,1901,1336,-30
105642420585,105642420590,5,2728,1447,-30
105644119298,105644119304,6,1949,1213,-30
105644733888,105644733892,4,1657,1111,-30
105644870657,105644870663,6,1130,1082,-30
105646299577,105646299583,6,2392,1374,-30
105649079279,105649079284,5,2439,1437,-30
105655595714,105655595714,0,1020,1104,-30
105658181597,105658181601,4,1903,989,-30
105658452788,105658452791,3,2198,1654,-30
105661656658,105661656662,4,2744,1650,-30
105663146481,105663146487,6,3796,1002,-30
105664970636,105664970640,4,2226,1725,-30
105668190019,105668190024,5,2472,1615,-30
105668659554,105668659559,5,2425,1271,-30
105670134809,105670134814,5,1465,1168,-30
105674952104,105674952111,7,1876,1163,-30
105678792864,105678792866,2,2298,3036,-30
105680815582,105680815587,5,2452,1464,-30
105681573489,105681573494,5,2559,1073,-30
105683190491,105683190495,4,3046,2164,-30
105685228630,105685228635,5,1568,947,-30
105685365888,105685365889,1,1581,1534,-30
105692655949,105692655955,6,3055,2128,-30
105694033407,105694033413,6,2078,1285,-30
105694079110,105694079128,18,1522,1094,-30
105697032376,105697032382,6,2942,1445,-30
105705864078,105705864086,8,2687,1129,-30
105708216397,105708216397,0,1194,1665,-30
105709035240,105709035245,5,2029,990,-30
105714765996,105714765998,2,1341,1262,-30
105722449692,105722449697,5,2176,1142,-30
105722941303,105722941309,6,1942,732,-30
105725898666,105725898671,5,1582,1576,-30
105727501934,105727501942,8,2866,1158,-30
105727700220,105727700203,-17,1466,592,-30
105731294601,105731294606,5,2642,1779,-30
105736337018,105736337024,6,1847,828,-30
105737668626,105737668630,4,2586,1327,-30
105737900360,105737900364,4,1434,940,-30
105738215045,105738215027,-18,1972,561,-30
105740609343,105740609349,6,1923,1645,-30
105744376267,105744376273,6,1948,1351,-30
105749223366,105749223369,3,1680,1251,-30
105751909077,105751909082,5,1669,994,-30
105753298585,105753298571,-14,101883,31239,-30
105753749669,105753749674,5,2386,1455,-30
105753947804,105753947807,3,1471,904,-30
105756426655,105756426661,6,3052,1500,-30
105761947025,105761947028,3,1678,1133,-30
105770817893,105770817898,5,2173,1691,-30
105771686399,105771686404,5,10230,25756,-30
105773264921,105773264926,5,2691,1229,-30
105777209768,105777209772,4,2054,890,-30
105778010306,105778010309,3,1144,1155,-30
105780331883,105780331889,6,2093,1353,-30
105781275801,105781275806,5,1848,1476,-30
105782397827,105782397831,4,1688,2092,-30
105782564245,105782564250,5,3099,1906,-30
105788640942,105788640947,5,843,513,-30
105793546582,105793546578,-4,1575,4916,-30
105798062730,105798062724,-6,764,2343,-30
105799093075,105799093081,6,2766,991,-30
105803852749,105803852755,6,2371,1190,-30
105807926872,105807926877,5,1954,1286,-30
105816319904,105816319909,5,2980,1624,-30
105816837840,105816837846,6,2124,1384,-30
105817228109,105817228114,5,3432,2084,-30
105817669654,105817669658,4,2594,2071,-30
105818808873,105818808878,5,1722,1323,-30
105825373037,105825373058,21,1277,2409,-30
105827334743,105827334746,3,1632,909,-30
105829067018,105829067023,5,2287,1282,-30
105829288531,105829288533,2,2020,2364,-30
105835180258,105835180265,7,1908,1083,-30
105836627821,105836627827,6,1867,981,-30
105837526853,105837526856,3,1685,1536,-30
105837624283,105837624277,-6,1685,4754,-30
105838309722,105838309729,7,2546,1347,-30
105844802217,105844802219,2,1376,1279,-30
105850366306,105850366314,8,3368,947,-30
105854386833,105854386839,6,1940,1039,-30
105858117409,105858117414,5,1986,1695,-30
105860910267,105860910275,8,1270,757,-30
105865092307,105865092302,-5,1493,3806,-30
105867969578,105867969585,7,1501,1238,-30
105873427888,105873427893,5,2077,955,-30
105873628108,105873628122,14,2014,1152,-30
105874272141,105874272161,20,1548,1078,-30
105876589044,105876589049,5,1935,841,-30
105876996807,105876996785,-22,1341,693,-30
105877360452,105877360458,6,1922,1160,-30
105881326889,105881326884,-5,59667,91595,-30
105884012849,105884012854,5,1821,1284,-30
105884729326,105884729334,8,2938,1921,-30
105888026686,105888026674,-12,1491,571,-30
105899555158,105899555161,3,1755,1104,-30
105899845299,105899845299,0,1495,2921,-30
105901024426,105901024430,4,1888,1415,-30
105902331722,105902331727,5,3115,1115,-30
105902481356,105902481360,4,2509,1265,-30
105902976179,105902976183,4,2324,1300,-30
105906840111,105906840112,1,1912,1244,-30
105909204333,105909204339,6,1991,1379,-30
105911624436,105911624442,6,1449,1146,-30
105915995729,105915995727,-2,1529,2527,-30
105920241078,105920241083,5,2533,1739,-30
105921175654,105921175652,-2,3347,10922,-30
105921914345,105921914350,5,2382,1041,-30
105928234509,105928234514,5,1900,1219,-30
105929279729,105929279735,6,2106,1411,-30
105930009646,105930009651,5,1467,1046,-30
105938330217,105938330221,4,2084,1401,-30
105940017269,105940017269,0,991,1846,-30
105943516101,105943516102,1,2205,1498,-30
105946345756,105946345762,6,2559,1260,-30
105951099418,105951099423,5,1754,1148,-30
105953794815,105953794822,7,2366,1218,-30
105957169780,105957169784,4,2262,1331,-30
105957705489,105957705494,5,2107,1603,-30
105961519356,105961519362,6,2039,851,-30
105964504159,105964504163,4,2008,1468,-30
105966684115,105966684121,6,1769,1350,-30
105966931618,105966931622,4,1627,1217,-30
105967745423,105967745427,4,2630,1419,-30
105968779898,105968779892,-6,1816,5303,-30
105969833353,105969833356,3,2301,1317,-30
105971956718,105971956723,5,2358,981,-30
105974077953,105974077957,4,2253,1714,-30
105981702505,105981702512,7,3624,1070,-30
105985959217,105985959221,4,1932,1399,-30
105986637349,105986637354,5,2562,1175,-30
105989113299,105989113303,4,2075,1137,-30
105994936429,105994936434,5,2907,1426,-30
106003048963,106003048966,3,1405,1375,-30
106003510902,106003510890,-12,2542,553,-30
106003906057,106003906063,6,1255,802,-30
106004276325,106004276307,-18,2809,1322,-30
106006157349,106006157355,6,1475,836,-30
106007240882,106007240886,4,2734,1644,-30
106008320706,106008320711,5,3139,1711,-30
106009069568,106009069550,-18,1799,781,-30
106012081598,106012081603,5,1328,1065,-30
106018846102,106018846105,3,1778,1492,-30
106019071262,106019071266,4,2641,1086,-30
106020453213,106020453218,5,2221,1099,-30
106022034890,106022034894,4,1919,938,-30
106024138157,106024138162,5,2585,1097,-30
106028113417,106028113422,5,2238,1106,-30
106028907630,106028907635,5,1914,1142,-30
106030518955,106030518963,8,2631,1243,-30
106037664482,106037664487,5,2014,1385,-30
106038311091,106038311095,4,358,845,-30
106040145233,106040145218,-15,2078,566,-30
106043725826,106043725831,5,2215,1395,-30
106046170186,106046170188,2,2204,2096,-30
106046877473,106046877479,6,2217,1213,-30
106049130440,106049130443,3,1786,910,-30
106049812796,106049812787,-9,1109,369,-30
106051299485,106051299489,4,2165,1185,-30
106053516645,106053516649,4,2385,1320,-30
106057544546,106057544551,5,2327,1302,-30
106059052586,106059052591,5,2098,1784,-30
106059511624,106059511629,5,1897,1352,-30
106069815946,106069815949,3,2096,1482,-30
106069915935,106069915941,6,2415,1047,-30
106072275381,106072275386,5,2041,800,-30
106076049955,106076049959,4,1425,916,-30
106078651057,106078651059,2,1734,1116,-30
106085711042,106085711046,4,2396,1811,-30
106086964548,106086964550,2,2359,2045,-30
106089112103,106089112109,6,2460,1423,-30
106091087357,106091087356,-1,1105,1805,-30
106093104581,106093104587,6,2340,949,-30
106096455018,106096455022,4,1166,941,-30
106098412833,106098412835,2,1834,1571,-30
106102025234,106102025234,0,2412,2060,-30
106108021622,106108021627,5,2697,1371,-30
106109728892,106109728897,5,2281,1902,-30
106110075317,106110075323,6,1923,1359,-30
106111337207,106111337215,8,2608,1059,-30
106112182161,106112182166,5,1869,1339,-30
106112224489,106112224495,6,2628,1152,-30
106114686954,106114686959,5,2005,1143,-30
106116327420,106116327426,6,2497,1389,-30
106118951080,106118951083,3,2338,1684,-30
106120361726,106120361730,4,1872,1318,-30
106122219127,106122219129,2,1780,1967,-30
106122284993,106122284998,5,2493,1524,-30
106123960043,106123960048,5,2414,1553,-30
106130412146,106130412148,2,2037,1314,-30
106132397817,106132397821,4,2095,1622,-30
106132566465,106132566469,4,2432,1426,-30
106134679822,106134679826,4,2845,1368,-30
106137274220,106137274223,3,1586,1127,-30
106138456358,106138456363,5,2705,1190,-30
106139549594,106139549598,4,1717,1361,-30
106140286915,106140286897,-18,2326,1082,-30
106141536918,106141536925,7,2098,1452,-30
106143709242,106143709247,5,2140,1488,-30
106144297241,106144297246,5,1240,1134,-30
106147490872,106147490853,-19,3355,1094,-30
106149615245,106149615251,6,1727,988,-30
106151370223,106151370227,4,1717,1267,-30
106155719455,106155719459,4,1209,1075,-30
106156654954,106156654952,-2,50804,5539,-30
106162016596,106162016595,-1,1778,2115,-30
106164622414,106164622419,5,2429,1363,-30
106173254522,106173254525,3,3157,1537,-30
106176968766,106176968762,-4,1219,2163,-30
106178435911,106178435924,13,9,1174,-30
106179987685,106179987691,6,1601,1179,-30
106181423838,106181423844,6,2229,1620,-30
106181875905,106181875910,5,1722,963,-30
106185241464,106185241470,6,2488,1546,-30
106185548786,106185548784,-2,1069,2286,-30
106186509737,106186509742,5,1810,757,-30
106186870859,106186870861,2,2847,1906,-30
106187176969,106187176974,5,2763,1146,-30
106192668098,106192668102,4,1770,1083,-30
106193093968,106193093974,6,3261,1650,-30
106193687994,106193687999,5,1513,1210,-30
106198070957,106198070962,5,1579,1140,-30
106200755898,106200755901,3,2104,1480,-30
106200801748,106200801760,12,1883,1277,-30
106211949284,106211949289,5,2097,1393,-30
106212188038,106212188042,4,1266,901,-30
106225675310,106225675315,5,2325,1027,-30
106229348499,106229348503,4,2704,996,-30
106231066506,106231066512,6,2693,1398,-30
106232432960,106232432965,5,4187,2350,-30
106234282702,106234282709,7,2300,1331,-30
106234406664,106234406669,5,977,622,-30
106234768012,106234768026,14,423,1634,-30
106235674778,106235674782,4,1578,1120,-30
106239385866,106239385872,6,2901,1666,-30
106239704167,106239704185,18,983,396,-30
106245880151,106245880151,0,1752,2212,-30
106249430983,106249430962,-21,1027,750,-30
106252245127,106252245131,4,2286,1538,-30
106254831238,106254831246,8,758,859,-30
106262088821,106262088826,5,2422,1678,-30
106262679006,106262679009,3,1396,1366,-30
106265679758,106265679763,5,1893,1287,-30
106269259879,106269259886,7,2689,1497,-30
106269424165,106269424163,-2,510,328,-30
106270895401,106270895407,6,2182,1358,-30
106272287965,106272287969,4,2211,1108,-30
106273212207,106273212211,4,2496,1273,-30
106276221205,106276221206,1,1629,1414,-30
106276494946,106276494950,4,1410,946,-30
106284170577,106284170582,5,2382,1420,-30
106285556813,106285556818,5,2384,1333,-30
106290457614,106290457610,-4,1167,4333,-30
106290787937,106290787942,5,1635,779,-30
106291883196,106291883176,-20,1768,845,-30
106295735718,106295735718,0,1666,1365,-30
106303627002,106303627006,4,2428,1285,-30
106304402755,106304402761,6,1786,1335,-30
106306898642,106306898646,4,1746,1041,-30
106310054853,106310054858,5,1761,857,-30
106310395797,106310395779,-18,743,605,-30
106311176534,106311176539,5,1980,1238,-30
106316343702,106316343707,5,1476,1037,-30
106322119041,106322119046,5,2335,1641,-30
106322240577,106322240580,3,2663,2013,-30
106322918169,106322918174,5,2391,1256,-30
106323609408,106323609414,6,2076,1442,-30
106325779389,106325779395,6,2736,1065,-30
106327600250,106327600255,5,3006,1622,-30
106327968522,106327968526,4,1890,1530,-30
106331105038,106331105042,4,1276,1185,-30
106331624302,106331624301,-1,1008,2022,-30
106336460089,106336460094,5,2214,1886,-30
106337023181,106337023187,6,2066,1283,-30
106339933569,106339933573,4,2487,1515,-30
106340480380,106340480364,-16,1627,1110,-30
106342903785,106342903789,4,1907,1284,-30
106345805895,106345805899,4,2368,1461,-30
106351808391,106351808394,3,988,827,-30
106352536638,106352536645,7,949,1062,-30
106352862975,106352862979,4,2390,1416,-30
106355476257,106355476262,5,2400,1034,-30
106362688821,106362688826,5,1814,1360,-30
106366519880,106366519877,-3,1802,4959,-30
106373512388,106373512392,4,1784,1312,-30
106374518630,106374518634,4,1144,919,-30
106380458423,106380458431,8,2336,1244,-30
106383295308,106383295314,6,2714,1345,-30
106385609448,106385609453,5,2264,1119,-30
106386198138,106386198142,4,2732,1352,-30
106387894859,106387894865,6,3066,1348,-30
106389235230,106389235234,4,3658,2733,-30
106397340783,106397340787,4,2733,1805,-30
106400908296,106400908302,6,1495,753,-30
106406669729,106406669734,5,3178,1683,-30
106410374931,106410374936,5,1966,1467,-30
106411114116,106411114122,6,2710,1276,-30
106411360725,106411360730,5,2435,1570,-30
106412522880,106412522885,5,2442,1335,-30
106417152790,106417152796,6,2299,1106,-30
106420266030,106420266034,4,2306,1340,-30
106429433672,106429433678,6,1625,896,-30
106431774049,106431774054,5,2158,1030,-30
106434337531,106434337534,3,807,1665,-30
106436852001,106436852006,5,2193,1773,-30
106438212064,106438212069,5,2523,1520,-30
106439129871,106439129877,6,2005,1102,-30
106440393302,106440393305,3,2283,1127,-30
106440972722,106440972726,4,1467,725,-30
106441078220,106441078201,-19,1990,1541,-30
106450606122,106450606128,6,2786,1183,-30
106451478471,106451478474,3,3084,1803,-30
106451570894,106451570900,6,1801,1030,-30
106453042455,106453042460,5,2389,1331,-30
106455447321,106455447325,4,1750,1134,-30
106457962351,106457962356,5,1523,1380,-30
106459917019,106459917021,2,1041,1406,-30
106461082974,106461082957,-17,2861,1255,-30
106467138885,106467138891,6,2304,1337,-30
106470663598,106470663603,5,2088,912,-30
106473574581,106473574585,4,2423,1343,-30
106473893601,106473893606,5,2015,770,-30
106475033975,106475033979,4,1094,642,-30
106476324653,106476324658,5,1657,1266,-30
106476743998,106476744003,5,2427,1034,-30
106477749973,106477749977,4,2262,1133,-30
106478312722,106478312705,-17,910,450,-30
106480626081,106480626085,4,1890,1435,-30
106481577009,106481577014,5,2551,1127,-30
106484875239,106484875245,6,2416,1156,-30
106486792895,106486792914,19,1367,716,-30
106486922958,106486922963,5,2336,1128,-30
106487826441,106487826446,5,2455,1619,-30
106491678233,106491678238,5,1888,1108,-30
106496181219,106496181223,4,1834,1072,-30
106496220130,106496220135,5,2001,1048,-30
106498455278,106498455282,4,2213,1153,-30
106500081370,106500081375,5,1918,1428,-30
106503800946,106503800951,5,2540,1209,-30
106503929962,106503929946,-16,4274,1942,-30
106508541046,106508541053,7,2488,1434,-30
106509406903,106509406909,6,2448,1650,-30
106509540049,106509540052,3,1940,1795,-30
106509878914,106509878918,4,2162,1058,-30
106513011733,106513011739,6,3006,1780,-30
106515459631,106515459637,6,1741,1041,-30
106516584247,106516584250,3,1647,1053,-30
106520409568,106520409567,-1,1201,1833,-30
106523834109,106523834113,4,2294,1384,-30
106524740393,106524740399,6,2253,1236,-30
106526332971,106526332976,5,2522,1387,-30
106528535421,106528535422,1,1481,2043,-30
106531222773,106531222777,4,2188,1045,-30
106534884614,106534884618,4,993,1077,-30
106540303192,106540303197,5,2326,869,-30
106542714973,106542714978,5,1587,1641,-30
106546117702,106546117706,4,2304,841,-30
106548297380,106548297382,2,2138,1248,-30
106549310576,106549310586,10,3633,1011,-30
106551438008,106551438013,5,1992,1431,-30
106551489867,106551489873,6,2487,1002,-30
106557566915,106557566919,4,3157,2157,-30
106558292697,106558292702,5,2108,1096,-30
106558454676,106558454683,7,1529,1391,-30
106560310922,106560310927,5,2355,897,-30
106560563009,106560563013,4,2762,1392,-30
106561084389,106561084392,3,1936,1473,-30
106562674180,106562674183,3,1809,913,-30
106563343906,106563343911,5,2547,1738,-30
106563477370,106563477373,3,4780,2858,-30
106564352980,106564352985,5,2091,1345,-30
106565364453,106565364458,5,1763,1104,-30
106576346815,106576346821,6,1377,657,-30
106578030361,106578030365,4,2291,1519,-30
106578660002,106578660007,5,2108,1380,-30
106579420494,106579420499,5,2731,1314,-30
106579796425,106579796428,3,1972,1538,-30
106582291446,106582291450,4,2001,811,-30
106587376117,106587376123,6,2186,1432,-30
106590742638,106590742643,5,1232,1090,-30
106591790464,106591790467,3,2484,1282,-30
106592289919,106592289922,3,2602,1769,-30
106592815154,106592815159,5,2161,1197,-30
106595504319,106595504322,3,851,822,-30
106603788047,106603788052,5,2832,1572,-30
106608954886,106608954892,6,2741,1511,-30
106610474335,106610474340,5,1654,1249,-30
106611860452,106611860458,6,87580,49870,-30
106614167605,106614167608,3,1984,780,-30
106616994958,106616994960,2,826,1754,-30
106621631489,106621631496,7,2153,1198,-30
106623696904,106623696909,5,1548,1232,-30
106625359007,106625359006,-1,4953,6873,-30
106629270105,106629270111,6,1813,1315,-30
106629722893,106629722913,20,1745,1054,-30
106630987517,106630987497,-20,2544,868,-30
106637445760,106637445765,5,1664,852,-30
106641356270,106641356278,8,3548,1717,-30
106643942762,106643942767,5,2040,1062,-30
106651413610,106651413615,5,2102,1395,-30
106651641169,106651641175,6,1669,1077,-30
106652659890,106652659895,5,1531,1242,-30
106654421866,106654421871,5,2754,1603,-30
106658196060,106658196063,3,1470,1359,-30
106659706881,106659706878,-3,1185,3310,-30
106661144462,106661144466,4,2591,999,-30
106670823099,106670823103,4,2396,1225,-30
106672759303,106672759308,5,1423,900,-30
106678450986,106678450989,3,2012,1411,-30
106678976376,106678976380,4,2038,1648,-30
106686272158,106686272164,6,3648,1556,-30
106689281926,106689281930,4,3138,1302,-30
106693481331,106693481336,5,2223,1119,-30
106694066357,106694066362,5,2177,1282,-30
106706246820,106706246827,7,2088,1109,-30
106709289545,106709289550,5,2807,1408,-30
106710035616,106710035622,6,3341,1131,-30
106715377170,106715377177,7,4629,1871,-30
106719549473,106719549477,4,2280,1361,-30
106720240109,106720240105,-4,3756,12134,-30
106721372743,106721372747,4,2032,1183,-30
106724637362,106724637366,4,1559,962,-30
106725139449,106725139454,5,2113,1514,-30
106730746295,106730746301,6,3239,1291,-30
106733327545,106733327551,6,2268,1258,-30
106735794765,106735794770,5,1336,853,-30
106736764702,106736764705,3,1825,1417,-30
106737595312,106737595318,6,1415,952,-30
106739860034,106739860038,4,1941,1285,-30
106740337598,106740337609,11,780,138,-30
106748756721,106748756726,5,1679,1133,-30
106752014464,106752014470,6,1086,363,-30
106753330172,106753330175,3,1723,1174,-30
106756036552,106756036558,6,3052,1488,-30
106756254670,106756254677,7,2121,1231,-30
106756946201,106756946208,7,2546,1462,-30
106757318996,106757318999,3,1249,620,-30
106764180635,106764180630,-5,1015,6877,-30
106768548887,106768548894,7,2267,992,-30
106771050851,106771050855,4,1643,1222,-30
106772596639,106772596647,8,3350,1763,-30
106778035929,106778035934,5,2991,1348,-30
106779031030,106779031034,4,2342,1090,-30
106779304014,106779304035,21,492,221,-30
106781356658,106781356665,7,1459,1499,-30
106781845963,106781845969,6,2019,1271,-30
106784894517,106784894521,4,1400,1106,-30
106786357442,106786357451,9,2485,1057,-30
106788601178,106788601183,5,1776,1500,-30
106789799549,106789799554,5,1498,910,-30
106791367550,106791367546,-4,1217,2569,-30
106795618047,106795618051,4,2359,1139,-30
106795772761,106795772766,5,1608,1260,-30
106795930467,106795930465,-2,1122,1598,-30
106796521472,106796521475,3,2125,1780,-30
106799765813,106799765816,3,1786,1059,-30
106800845408,106800845414,6,1952,1409,-30
106801108007,106801108013,6,2638,1578,-30
106801278295,106801278299,4,1544,1297,-30
106801730949,106801730954,5,2006,1629,-30
106806871500,106806871507,7,1643,1130,-30
106807785450,106807785453,3,1931,1547,-30
106808182785,106808182790,5,1325,1224,-30
106808900923,106808900927,4,2022,1110,-30
106809504021,106809504025,4,2045,1615,-30
106811224110,106811224114,4,2534,1319,-30
106815192282,106815192288,6,1954,1671,-30
106815295614,106815295609,-5,770,277,-30
106817778200,106817778195,-5,2304,7351,-30
106819680461,106819680466,5,3284,1347,-30
106820642540,106820642545,5,2986,2207,-30
106820833903,106820833909,6,3216,2103,-30
106824815898,106824815903,5,2182,1161,-30
106825086236,106825086239,3,1642,1337,-30
106831176971,106831176978,7,2633,1554,-30
106832329301,106832329306,5,3363,1162,-30
106839732814,106839732819,5,2546,1355,-30
106840354018,106840354018,0,1057,1218,-30
106840926405,106840926410,5,2087,1226,-30
106841625754,106841625759,5,2205,1162,-30
106843771976,106843771982,6,2248,1329,-30
106848217828,106848217831,3,1632,1055,-30
106853039562,106853039567,5,2042,1281,-30
106859163388,106859163393,5,2016,1396,-30
106859532622,106859532628,6,2389,1714,-30
106859692418,106859692426,8,3789,1475,-30
106859817554,106859817538,-16,1699,1103,-30
106868194802,106868194807,5,2544,1223,-30
106869113295,106869113301,6,2333,1936,-30
106871376470,106871376476,6,1757,1196,-30
106872274591,106872274571,-20,18597,26748,-30
106873879862,106873879866,4,2150,1364,-30
106875799211,106875799214,3,1468,1360,-30
106876270270,106876270275,5,1579,860,-30
106877298796,106877298806,10,1435,763,-30
106877655330,106877655339,9,2370,923,-30
106879131014,106879131018,4,1969,1303,-30
106882926401,106882926406,5,2234,1781,-30
106882984071,106882984077,6,2461,913,-30
106884694801,106884694794,-7,2176,8610,-30
106888167360,106888167363,3,1678,1316,-30
106888361354,106888361352,-2,565,264,-30
106892067450,106892067453,3,2080,1889,-30
106892112739,106892112744,5,2667,1544,-30
106895314945,106895314950,5,2445,1496,-30
106897467518,106897467525,7,3167,1546,-30
106903304017,106903304020,3,2012,1518,-30
106908668628,106908668633,5,2825,1631,-30
106910718232,106910718235,3,2457,1634,-30
106911262119,106911262123,4,2695,1367,-30
106912672397,106912672402,5,2326,1196,-30
106923970582,106923970587,5,1928,1622,-30
106926830092,106926830094,2,1824,1236,-30
106928519425,106928519430,5,2828,1160,-30
106928801977,106928801982,5,3623,967,-30
106929346742,106929346747,5,2556,1623,-30
106930952466,106930952470,4,1837,1466,-30
106931139388,106931139396,8,1469,990,-30
106932561004,106932561008,4,2386,1499,-30
106933533683,106933533689,6,2085,1155,-30
106933825191,106933825169,-22,2876,1766,-30
106934480939,106934480945,6,3730,1807,-30
106934628219,106934628223,4,1866,782,-30
106937052110,106937052115,5,2906,1421,-30
106938136986,106938136992,6,1909,1119,-30
106938829294,106938829273,-21,967,574,-30
106939007174,106939007179,5,2655,1327,-30
106947485212,106947485215,3,2201,1133,-30
106949225305,106949225290,-15,1110,5041,-30
106951549910,106951549914,4,2526,1313,-30
106951618374,106951618379,5,2692,1620,-30
106951963646,106951963651,5,2204,1133,-30
106952151326,106952151306,-20,2705,1221,-30
106955224879,106955224883,4,1890,1192,-30
106958755074,106958755080,6,2347,1998,-30
106961336889,106961336891,2,1615,1776,-30
106967015720,106967015726,6,2495,1501,-30
106967522290,106967522296,6,1861,920,-30
106975291742,106975291746,4,3273,1310,-30
106978038127,106978038132,5,1822,1271,-30
106979774809,106979774814,5,2754,1121,-30
106980395634,106980395630,-4,1052,1893,-30
106980649481,106980649478,-3,76,1037,-30
106981590678,106981590684,6,2393,1254,-30
106987209458,106987209460,2,1836,1097,-30
106988938934,106988938940,6,2218,1712,-30
106989861227,106989861231,4,1246,634,-30
106996556446,106996556451,5,1880,1329,-30
106997479525,106997479521,-4,1730,6121,-30
106997964255,106997964261,6,2538,1495,-30
107000071657,107000071662,5,2555,1177,-30
107000127143,107000127120,-23,953,377,-30
107001940121,107001940126,5,2684,1582,-30
107005951699,107005951694,-5,21653,15306,-30
107009557998,107009558002,4,2629,1322,-30
107010810358,107010810363,5,2074,1469,-30
107010847210,107010847215,5,2188,1061,-30
107012801445,107012801449,4,1545,966,-30
107014713297,107014713293,-4,1528,2850,-30
107015000349,107015000354,5,2371,1602,-30
107017402639,107017402642,3,2261,1217,-30
107024354352,107024354358,6,3036,1646,-30
107026129307,107026129312,5,3160,1656,-30
107028625384,107028625389,5,3589,1723,-30
107029625786,107029625790,4,1950,1680,-30
107038116088,107038116095,7,1985,1144,-30
107039875496,107039875503,7,1706,1180,-30
107040242015,107040242018,3,2173,1260,-30
107041718210,107041718214,4,2067,1128,-30
107042315695,107042315701,6,2535,1302,-30
107044108283,107044108286,3,1340,1044,-30
107046440669,107046440669,0,1128,2380,-30
107050239365,107050239368,3,1857,1120,-30
107050272922,107050272926,4,1719,959,-30
107050592962,107050592969,7,2159,1228,-30
107057554242,107057554242,0,808,2154,-30
107060268886,107060268891,5,2476,992,-30
107061705562,107061705568,6,1899,1235,-30
107063380359,107063380362,3,2031,816,-30
107063616926,107063616932,6,2816,1242,-30
107067983209,107067983214,5,1688,922,-30
107068559465,107068559471,6,2344,1277,-30
107069760977,107069760984,7,2729,1481,-30
107070125475,107070125477,2,1544,1600,-30
107073299229,107073299234,5,2141,1590,-30
107073763167,107073763174,7,2044,1508,-30
107076074756,107076074757,1,1255,1441,-30
107077903250,107077903254,4,1541,654,-30
107078637548,107078637532,-16,745,570,-30
107080465888,107080465890,2,1608,1521,-30
107081049353,107081049357,4,1630,1202,-30
107083300901,107083300903,2,2004,1418,-30
107085092347,107085092353,6,2324,1625,-30
107085151720,107085151706,-14,1517,746,-30
107086380366,107086380372,6,2429,1499,-30
107087379769,107087379774,5,2128,1238,-30
107087550518,107087550522,4,2556,1010,-30
107092811642,107092811646,4,2117,1268,-30
107095807286,107095807291,5,2323,1293,-30
107099378039,107099378044,5,2502,1294,-30
107099636466,107099636450,-16,1692,1438,-30
107100649654,107100649658,4,1418,1094,-30
107107644650,107107644647,-3,1025,1394,-30
107123222270,107123222275,5,1343,1005,-30
107131002528,107131002534,6,1999,957,-30
107132156482,107132156481,-1,1089,2281,-30
107134021798,107134021802,4,2005,1918,-30
107134576977,107134576974,-3,764,2196,-30
107136385223,107136385233,10,2505,1287,-30
107138117910,107138117915,5,2558,1450,-30
107138868757,107138868763,6,2580,1165,-30
107144034503,107144034510,7,1627,876,-30
107147560831,107147560837,6,2321,1308,-30
107147667417,107147667422,5,2243,1418,-30
107162863753,107162863758,5,3191,1385,-30
107166078868,107166078876,8,1608,1063,-30
107166380978,107166380963,-15,406,9,-30
107168298973,107168298976,3,1956,1114,-30
107168441439,107168441419,-20,1555,1640,-30
107169317033,107169317038,5,2019,1475,-30
107169506062,107169506067,5,1927,815,-30
107171844562,107171844567,5,2806,1503,-30
107176127736,107176127738,2,2157,1730,-30
107179117591,107179117598,7,2867,1568,-30
107179269222,107179269204,-18,1237,378,-30
107180470222,107180470226,4,2084,1577,-30
107186980210,107186980215,5,1604,989,-30
107187887734,107187887740,6,2828,1530,-30
107190463909,107190463914,5,2403,1397,-30
107192156490,107192156494,4,1674,1075,-30
107195474103,107195474107,4,1728,1417,-30
107197752350,107197752353,3,2647,1566,-30
107202375906,107202375907,1,1388,2444,-30
107203261062,107203261066,4,3267,1201,-30
107204457126,107204457131,5,1489,1760,-30
107207133344,107207133353,9,13182,38299,-30
107207706453,107207706458,5,2139,1148,-30
107210522190,107210522194,4,1484,1455,-30
107213212230,107213212235,5,1955,1207,-30
107214707577,107214707581,4,1856,1316,-30
107215587230,107215587234,4,2807,1950,-30
107216626860,107216626866,6,1663,1440,-30
107218605857,107218605862,5,2643,1326,-30
107218715803,107218715811,8,2041,1143,-30
107218886168,107218886187,19,2291,1310,-30
107219722867,107219722873,6,2515,1064,-30
107220987541,107220987545,4,1910,1173,-30
107228495802,107228495807,5,1968,1411,-30
107233210833,107233210838,5,2586,1591,-30
107234338634,107234338639,5,2219,1508,-30
107243939181,107243939184,3,2254,1168,-30
107247366169,107247366162,-7,1574,5461,-30
107249027315,107249027318,3,2195,1329,-30
107258811921,107258811926,5,1755,842,-30
107259069966,107259069946,-20,964,518,-30
107260339157,107260339162,5,2605,1115,-30
107260451145,107260451158,13,2564,1286,-30
107261620901,107261620910,9,2200,878,-30
107262430662,107262430666,4,1697,907,-30
107264975681,107264975687,6,2187,1445,-30
107266098702,107266098706,4,2263,1441,-30
107266212690,107266212693,3,2039,1227,-30
107267296012,107267296016,4,1979,1306,-30
107268035993,107268035994,1,1076,1058,-30
107268760401,107268760407,6,2421,1282,-30
107269510511,107269510507,-4,518,1420,-30
107272283957,107272283962,5,2379,1151,-30
107272703574,107272703579,5,3119,1636,-30
107276101090,107276101095,5,2105,1427,-30
107279986733,107279986737,4,2540,1104,-30
107286072538,107286072545,7,2839,1650,-30
107287195059,107287195065,6,1438,1371,-30
107290874607,107290874610,3,1982,1049,-30
107290909783,107290909787,4,2522,1086,-30
107291713462,107291713466,4,2698,1184,-30
107296272119,107296272125,6,3109,1157,-30
107298241081,107298241085,4,1392,895,-30
107298467635,107298467641,6,2188,1152,-30
107300375115,107300375119,4,2938,1619,-30
107301118215,107301118220,5,2382,1746,-30
107301619442,107301619445,3,2585,2021,-30
107306810401,107306810408,7,2610,1223,-30
107309027494,107309027499,5,3599,1218,-30
107311475503,107311475503,0,926,1491,-30
107312712325,107312712330,5,1468,1401,-30
107313051920,107313051926,6,2562,1080,-30
107316596954,107316596959,5,2096,1545,-30
107325827862,107325827867,5,1742,898,-30
107326655826,107326655831,5,2379,993,-30
107326942537,107326942553,16,2247,1210,-30
107326984342,107326984347,5,3392,1408,-30
107327082241,107327082246,5,2734,1294,-30
107328423995,107328423999,4,1974,1297,-30
107330640614,107330640618,4,2393,918,-30
107334644117,107334644121,4,2177,1699,-30
107339372248,107339372250,2,1149,1026,-30
107339944827,107339944832,5,1951,1286,-30
107341801702,107341801708,6,2169,1012,-30
107342073478,107342073460,-18,3071,1288,-30
107342660494,107342660498,4,2502,1268,-30
107344927550,107344927555,5,2282,1304,-30
107347317537,107347317541,4,1026,791,-30
107347790359,107347790362,3,2145,1323,-30
107350415497,107350415504,7,1564,1270,-30
107350534945,107350534948,3,2338,1246,-30
107353895444,107353895449,5,2345,1676,-30
107356028171,107356028176,5,1923,1351,-30
107357921345,107357921351,6,2820,1927,-30
107363248622,107363248630,8,2622,1699,-30
107366242257,107366242258,1,2176,1183,-30
107366984394,107366984402,8,2177,1193,-30
107367633974,107367633979,5,2623,1046,-30
107367968118,107367968129,11,1168,202,-30
107368489105,107368489108,3,3256,2901,-30
107368729446,107368729451,5,1916,1032,-30
107369274486,107369274490,4,2143,1314,-30
107374205687,107374205691,4,3170,1605,-30
107374779526,107374779530,4,1973,1193,-30
107380596708,107380596714,6,2201,1476,-30
107381254913,107381254918,5,2391,1723,-30
107382717359,107382717363,4,1717,1230,-30
107385249158,107385249163,5,3126,1177,-30
107386181333,107386181338,5,3051,1535,-30
107388563109,107388563113,4,3532,2232,-30
107397141892,107397141898,6,1906,1350,-30
107397309825,107397309830,5,1480,1591,-30
107397882351,107397882359,8,2501,1101,-30
107397966477,107397966475,-2,1404,404,-30
107398918482,107398918491,9,2520,1092,-30
107399108951,107399108955,4,2733,1402,-30
107399843528,107399843531,3,1322,908,-30
107402482729,107402482733,4,2919,1463,-30
107403971173,107403971177,4,1485,690,-30
107406229461,107406229466,5,1881,1056,-30
107406469161,107406469166,5,2248,1282,-30
107407494905,107407494884,-21,1982,902,-30
107409191246,107409191249,3,1992,1128,-30
107410828955,107410828961,6,3215,1575,-30
107410937035,107410937055,20,1727,1358,-30
107411081452,107411081456,4,1499,1053,-30
107415488412,107415488417,5,2235,1640,-30
107416134211,107416134218,7,1934,1014,-30
107416614010,107416614015,5,2269,1496,-30
107418980901,107418980907,6,2112,1220,-30
107419280739,107419280745,6,2755,1657,-30
107426463707,107426463711,4,2014,1764,-30
107427313564,107427313568,4,719,655,-30
107430051533,107430051537,4,2189,1342,-30
107432974697,107432974700,3,2952,1018,-30
107434197947,107434197951,4,2894,1370,-30
107437516413,107437516418,5,2842,1204,-30
107440922251,107440922257,6,2276,795,-30
107441029933,107441029946,13,2286,976,-30
107442538327,107442538330,3,4163,3065,-30
107442845498,107442845500,2,7312,8431,-30
107442888902,107442888913,11,804,186,-30
107450697426,107450697430,4,1779,985,-30
107451829811,107451829815,4,1668,1417,-30
107452147771,107452147774,3,1506,1860,-30
107455198069,107455198074,5,2275,1868,-30
107455548121,107455548123,2,1870,1194,-30
107458667417,107458667420,3,2014,1245,-30
107461835686,107461835689,3,1480,1037,-30
107466832153,107466832158,5,3163,1342,-30
107470812585,107470812591,6,1557,874,-30
107477933748,107477933755,7,1287,869,-30
107478762615,107478762595,-20,1373,809,-30
107481289486,107481289492,6,2246,1193,-30
107482025534,107482025539,5,2522,1088,-30
107484458146,107484458150,4,2146,1123,-30
107487012538,107487012547,9,1653,1119,-30
107489163726,107489163732,6,2981,928,-30
107492624821,107492624826,5,1953,1316,-30
107494948157,107494948163,6,2443,1288,-30
107501706909,107501706914,5,1800,1584,-30
107503737494,107503737494,0,1188,1341,-30
107504603235,107504603218,-17,1014,220,-30
107508746549,107508746551,2,1742,1578,-30
107511474273,107511474279,6,3029,1524,-30
107512720602,107512720616,14,2651,2132,-30
107513248202,107513248206,4,1976,1497,-30
107513386147,107513386132,-15,866,315,-30
107514218035,107514218038,3,2129,2228,-30
107515518646,107515518647,1,1733,1105,-30
107517118055,107517118060,5,3414,1810,-30
107523992640,107523992645,5,1874,1223,-30
107536454225,107536454230,5,1812,1100,-30
107538952027,107538952031,4,1950,1255,-30
107539578558,107539578563,5,2008,1046,-30
107541055625,107541055624,-1,7482,12428,-30
107543455378,107543455382,4,2191,1487,-30
107544891834,107544891840,6,1654,1196,-30
107549588550,107549588546,-4,717,2388,-30
107551237318,107551237321,3,2194,1499,-30
107552464873,107552464878,5,2355,1526,-30
107556526418,107556526423,5,2040,1243,-30
107559809313,107559809314,1,17832,19609,-30
107561915923,107561915928,5,1809,1062,-30
107563591973,107563591979,6,2282,1272,-30
107564002622,107564002627,5,2150,1172,-30
107564437635,107564437626,-9,595,239,-30
107570945803,107570945810,7,2382,1250,-30
107571523838,107571523848,10,2330,956,-30
107572193403,107572193409,6,2380,1229,-30
107578656868,107578656875,7,2094,1413,-30
107578795886,107578795889,3,1957,1356,-30
107581389322,107581389329,7,2686,1062,-30
107582024067,107582024054,-13,1058,1497,-30
107582687353,107582687356,3,1585,1086,-30
107582750765,107582750770,5,1316,1077,-30
107584821934,107584821939,5,3051,1626,-30
107588533533,107588533538,5,2392,1073,-30
107590896768,107590896773,5,1879,1383,-30
107592104553,107592104558,5,2307,844,-30
107594174825,107594174828,3,1668,1078,-30
107594644978,107594644984,6,1602,1472,-30
107598100185,107598100189,4,1675,952,-30
107598927946,107598927924,-22,1723,1242,-30
107599930874,107599930871,-3,1298,2142,-30
107605108118,107605108125,7,1746,1078,-30
107606406375,107606406379,4,1810,1598,-30
107612975675,107612975681,6,3271,1595,-30
107614142142,107614142147,5,2877,1417,-30
107615274590,107615274595,5,2372,1609,-30
107619018489,107619018493,4,2378,1128,-30
107620196405,107620196398,-7,425,3492,-30
107624821311,107624821316,5,2248,1234,-30
107626098658,107626098663,5,2169,1320,-30
107626588721,107626588726,5,1529,1202,-30
107627911646,107627911626,-20,1071,738,-30
107628980610,107628980606,-4,1824,4393,-30
107632324549,107632324555,6,2304,1705,-30
107640398042,107640398048,6,2620,1120,-30
107645015942,107645015945,3,2117,1137,-30
107646808052,107646808058,6,5150,2958,-30
107653098251,107653098255,4,1627,800,-30
107655928758,107655928763,5,2434,1105,-30
107656709575,107656709579,4,2856,1311,-30
107657777025,107657777029,4,2223,1287,-30
107658147284,107658147291,7,1686,1277,-30
107661057090,107661057096,6,2024,1297,-30
107661164206,107661164209,3,2123,326,-30
107661996029,107661996034,5,1550,1112,-30
107668121930,107668121932,2,1786,1269,-30
107672120978,107672120994,16,13806,50813,-30
107683973250,107683973255,5,2510,1300,-30
107684268730,107684268734,4,1875,1067,-30
107684715758,107684715762,4,3243,1845,-30
107685673446,107685673451,5,1376,1394,-30
107688575505,107688575511,6,7494,2212,-30
107688862720,107688862724,4,1760,1079,-30
107691901685,107691901693,8,1975,1308,-30
107692434075,107692434081,6,3623,2259,-30
107693134149,107693134152,3,2563,1556,-30
107696092150,107696092154,4,2977,1809,-30
107701567893,107701567899,6,3650,1558,-30
107701818458,107701818463,5,2442,1577,-30
107703062779,107703062782,3,2867,1841,-30
107706872759,107706872763,4,2132,1285,-30
107707042485,107707042490,5,1911,1205,-30
107709198947,107709198950,3,2998,1499,-30
107710280110,107710280114,4,2314,1437,-30
107710805718,107710805723,5,1992,1376,-30
107714651630,107714651635,5,2367,1241,-30
107716250434,107716250438,4,1379,1219,-30
107716543576,107716543596,20,1068,187,-30
107716955605,107716955610,5,2565,1771,-30
107717430024,107717430028,4,2336,1185,-30
107720545106,107720545098,-8,37908,14697,-30
107724319609,107724319614,5,1333,1000,-30
107727231197,107727231194,-3,1216,1440,-30
107727958854,107727958861,7,2437,1735,-30
107728294971,107728294977,6,1733,1133,-30
107734841952,107734841956,4,2809,1148,-30
107743278885,107743278890,5,1581,1085,-30
107746145949,107746145955,6,3122,1477,-30
107750546357,107750546361,4,2135,1883,-30
107753395274,107753395279,5,1383,797,-30
107756387828,107756387830,2,2295,1610,-30
107759493349,107759493356,7,3294,1350,-30
107760025526,107760025504,-22,816,818,-30
107762285178,107762285183,5,1501,1394,-30
107763980178,107763980182,4,1814,1124,-30
107764956477,107764956481,4,1665,877,-30
107765984712,107765984718,6,3584,2199,-30
107769903443,107769903448,5,2354,1273,-30
107771223378,107771223382,4,2145,1187,-30
107774176021,107774176025,4,2207,969,-30
107777014434,107777014439,5,3119,1642,-30
107779477738,107779477744,6,2181,1218,-30
107780270246,107780270250,4,3073,1896,-30
107782435713,107782435716,3,2097,1311,-30
107783733351,107783733357,6,2264,1231,-30
107785330014,107785330019,5,2396,1309,-30
107787193811,107787193818,7,2118,1032,-30
107787286065,107787286051,-14,1328,541,-30
107796003150,107796003154,4,2597,2186,-30
107796228489,107796228495,6,1860,1544,-30
107799376694,107799376694,0,1859,1968,-30
107801683445,107801683450,5,3066,1205,-30
107802919743,107802919750,7,2545,962,-30
107803339905,107803339905,0,1596,2711,-30
107808889186,107808889185,-1,1359,1977,-30
107809780197,107809780201,4,2124,1465,-30
107810715507,107810715507,0,733,394,-30
107811176620,107811176629,9,2361,1439,-30
107812735127,107812735131,4,2025,1335,-30
107816959438,107816959442,4,1836,1010,-30
107818225997,107818226003,6,1862,1232,-30
107819505244,107819505249,5,2343,963,-30
107820670909,107820670915,6,3031,1497,-30
107825112126,107825112129,3,1859,1666,-30
107826161734,107826161738,4,2083,1319,-30
107828823785,107828823790,5,2340,1419,-30
107830070043,107830070046,3,1956,1403,-30
107830802966,107830802966,0,10557,15923,-30
107832168465,107832168470,5,2568,1691,-30
107833998701,107833998706,5,2907,1267,-30
107834130894,107834130873,-21,2679,1264,-30
107834407781,107834407787,6,2024,1347,-30
107837988966,107837988970,4,2271,1428,-30
107841127399,107841127401,2,1639,1051,-30
107841527621,107841527625,4,1554,924,-30
107844784522,107844784530,8,2858,934,-30
107847449518,107847449524,6,2119,1272,-30
107848510599,107848510606,7,3097,1293,-30
107852858830,107852858835,5,967,885,-30
107853325293,107853325298,5,2033,1148,-30
107853518593,107853518598,5,1719,991,-30
107857641149,107857641153,4,1278,900,-30
107858891105,107858891107,2,1684,1874,-30
107863829286,107863829290,4,2249,1189,-30
107864044498,107864044503,5,1400,1543,-30
107864774602,107864774607,5,1156,1044,-30
107868840402,107868840387,-15,374,2194,-30
107872849047,107872849053,6,2238,1733,-30
107881065326,107881065331,5,2300,1062,-30
107884506424,107884506430,6,3335,1820,-30
107887206424,107887206429,5,1550,1101,-30
107890774861,107890774864,3,2865,1630,-30
107890988834,107890988838,4,2108,1539,-30
107892101155,107892101161,6,2665,1212,-30
107894494232,107894494237,5,2382,1249,-30
107897260440,107897260446,6,1315,1472,-30
107898455588,107898455590,2,1287,1696,-30
107900960415,107900960420,5,1910,1146,-30
107901794069,107901794075,6,3182,1285,-30
107902627066,107902627072,6,1585,911,-30
107909006094,107909006099,5,2333,1612,-30
107909629577,107909629582,5,2612,2214,-30
107914092226,107914092231,5,2183,1427,-30
107915208864,107915208869,5,2567,1287,-30
107919452897,107919452903,6,2127,1844,-30
107920436587,107920436591,4,1404,890,-30
107924765203,107924765209,6,1871,1457,-30
107926496915,107926496919,4,2252,1631,-30
107928604677,107928604683,6,1349,1255,-30
107928829538,107928829542,4,1947,1536,-30
107929167506,107929167511,5,1959,1209,-30
107929535862,107929535880,18,3930,1196,-30
107930237952,107930237947,-5,23834,13348,-30
107931271939,107931271938,-1,828,1583,-30
107940284250,107940284254,4,3256,1678,-30
107941917752,107941917757,5,2125,1265,-30
107943696158,107943696165,7,3123,1655,-30
107947544316,107947544321,5,2789,1412,-30
107949174869,107949174882,13,10935,45572,-30
107950770039,107950770046,7,4308,1082,-30
107954009064,107954009069,5,1825,1483,-30
107956337979,107956337984,5,3022,2084,-30
107957299421,107957299427,6,2925,2025,-30
107957338300,107957338295,-5,1413,3629,-30
107967481590,107967481596,6,2722,1692,-30
107968328887,107968328893,6,3718,1441,-30
107969413134,107969413139,5,2291,1354,-30
107973096382,107973096386,4,2963,1707,-30
107973321622,107973321628,6,733,126,-30
107975336637,107975336645,8,2425,970,-30
107980366403,107980366406,3,1107,647,-30
107981640242,107981640224,-18,2246,1358,-30
107982413917,107982413922,5,2723,1095,-30
107983142218,107983142223,5,1303,957,-30
107983632518,107983632522,4,1819,1288,-30
107983804565,107983804567,2,1864,1074,-30
107985517754,107985517759,5,1897,1366,-30
107992301897,107992301902,5,3061,1346,-30
107992642918,107992642913,-5,884,74,-30
107995989741,107995989746,5,1872,1124,-30
107997373810,107997373815,5,1786,1098,-30
108001179286,108001179290,4,1700,1128,-30
108002062568,108002062561,-7,3675,10174,-30
108006414426,108006414430,4,2506,1910,-30
108006549862,108006549869,7,3362,1614,-30
108011510734,108011510739,5,1778,1225,-30
108014415768,108014415775,7,3103,1065,-30
108026023109,108026023115,6,1679,1111,-30
108031124365,108031124370,5,1901,1397,-30
108033931050,108033931057,7,2291,1405,-30
108035512605,108035512587,-18,2122,1155,-30
108041232382,108041232387,5,1078,173,-30
108043260572,108043260577,5,1765,1033,-30
108044991233,108044991238,5,2174,1754,-30
108045969422,108045969425,3,1136,1301,-30
108047979947,108047979953,6,1263,1263,-30
108059988774,108059988779,5,2087,1022,-30
108062281826,108062281833,7,2602,1448,-30
108065538944,108065538951,7,2130,1697,-30
108070060441,108070060446,5,2170,1362,-30
108070613741,108070613746,5,2005,743,-30
108071147725,108071147722,-3,1606,239,-30
108073171694,108073171699,5,2004,1014,-30
108077493973,108077493978,5,3107,1639,-30
108084701456,108084701460,4,4414,2151,-30
108085355712,108085355717,5,2799,1584,-30
108089046650,108089046654,4,1273,1012,-30
108091872282,108091872286,4,2180,1406,-30
108094561573,108094561579,6,2506,1349,-30
108095050930,108095050913,-17,2110,1242,-30
108097451160,108097451162,2,680,1268,-30
108100002760,108100002764,4,2119,1437,-30
108100369047,108100369025,-22,2404,1287,-30
108100658463,108100658443,-20,753,356,-30
108101980709,108101980716,7,2636,1326,-30
108102522678,108102522657,-21,1557,755,-30
108103222749,108103222752,3,1391,1011,-30
108103321267,108103321276,9,816,64,-30
108103853291,108103853310,19,512,2862,-30
108105628106,108105628111,5,1169,1329,-30
108111309470,108111309475,5,2515,1599,-30
108111945599,108111945603,4,1580,458,-30
108114210936,108114210938,2,1861,1386,-30
108115855942,108115855947,5,2091,1293,-30
108118784958,108118784964,6,2768,1566,-30
108121936118,108121936122,4,3046,1464,-30
108122943950,108122943955,5,546,469,-30
108123172280,108123172286,6,2100,1225,-30
108124967129,108124967134,5,1437,1425,-30
108125190755,108125190736,-19,1592,1134,-30
108135176142,108135176144,2,2565,1343,-30
108136853577,108136853582,5,2422,1145,-30
108140140225,108140140229,4,1977,1392,-30
108142946857,108142946862,5,2043,1017,-30
108143055930,108143055936,6,898,151,-30
108145171355,108145171362,7,2249,1062,-30
108147674363,108147674361,-2,1803,3940,-30
108148358137,108148358143,6,2469,1287,-30
108148887481,108148887486,5,1418,757,-30
108151212218,108151212214,-4,1209,1959,-30
108152255189,108152255194,5,2253,1324,-30
108155477876,108155477881,5,3463,1078,-30
108156859194,108156859198,4,2173,1279,-30
108157664834,108157664839,5,2071,1303,-30
108158047629,108158047635,6,1573,938,-30
108158748041,108158748039,-2,23537,13696,-30
108161128378,108161128383,5,1243,760,-30
108165236326,108165236347,21,785,222,-30
108165923374,108165923371,-3,1698,3354,-30
108166078855,108166078861,6,2094,1228,-30
108170790210,108170790225,15,2214,1295,-30
108171940262,108171940267,5,2445,1278,-30
108172167905,108172167911,6,2427,1161,-30
108181314331,108181314336,5,2452,1973,-30
108185733665,108185733670,5,2040,1156,-30
108186241526,108186241531,5,2225,1461,-30
108189004770,108189004777,7,2777,1648,-30
108192149497,108192149503,6,3082,1791,-30
108192385362,108192385367,5,3477,1863,-30
108193200127,108193200130,3,2264,1360,-30
108198060773,108198060778,5,3291,1896,-30
108199356181,108199356186,5,2256,955,-30
108201712557,108201712561,4,1468,1333,-30
108203489646,108203489651,5,1062,1014,-30
108204101410,108204101391,-19,48,1238,-30
108206244338,108206244342,4,1542,1031,-30
108213247562,108213247566,4,2187,1302,-30
108219791936,108219791942,6,2570,1023,-30
108226027721,108226027720,-1,1651,2445,-30
108228646690,108228646693,3,1379,931,-30
108228860407,108228860412,5,3152,1646,-30
108233474550,108233474555,5,2339,1698,-30
108234090657,108234090663,6,3004,1214,-30
108237374490,108237374495,5,3176,1530,-30
108239045690,108239045695,5,2712,1537,-30
108241885114,108241885118,4,1455,1055,-30
108242626019,108242626017,-2,927,2045,-30
108243114250,108243114257,7,2149,1483,-30
108243601837,108243601818,-19,2105,1565,-30
108244452570,108244452573,3,2193,1737,-30
108245547758,108245547763,5,3473,1821,-30
108245927089,108245927091,2,1797,1134,-30
108247150463,108247150443,-20,1218,644,-30
108247780235,108247780239,4,1950,1064,-30
108249088991,108249088995,4,2704,1052,-30
108250973545,108250973549,4,1884,1243,-30
108251852238,108251852244,6,2305,1319,-30
108256453507,108256453519,12,8167,45409,-30
108256752129,108256752134,5,3347,1841,-30
108257173221,108257173218,-3,1551,3934,-30
108258163595,108258163602,7,1559,673,-30
108258579222,108258579229,7,2157,1289,-30
108260486174,108260486178,4,2462,1042,-30
108263674698,108263674701,3,1904,1311,-30
108263959585,108263959582,-3,1030,1568,-30
108265750158,108265750167,9,9955,1242,-30
108267107582,108267107576,-6,1670,5432,-30
108267667265,108267667270,5,2278,1952,-30
108268455731,108268455736,5,1757,773,-30
108270482062,108270482066,4,1663,1126,-30
108270604033,108270604041,8,1652,850,-30
108270670823,108270670833,10,1454,923,-30
108271172941,108271172946,5,1654,1530,-30
108273927434,108273927441,7,2366,964,-30
108276869054,108276869059,5,1367,648,-30
108278686395,108278686402,7,2901,1331,-30
108282673210,108282673216,6,2049,1459,-30
108284173160,108284173164,4,2806,1738,-30
108284472971,108284472973,2,1438,2029,-30
108290957046,108290957050,4,1298,973,-30
108291106806,108291106807,1,1544,1415,-30
108295204464,108295204466,2,2187,1780,-30
108300628207,108300628204,-3,1430,1784,-30
108305354900,108305354905,5,2046,1000,-30
108305554714,108305554717,3,1914,741,-30
108309159197,108309159202,5,2209,1369,-30
108309383328,108309383333,5,2343,1278,-30
108311240741,108311240746,5,3395,1255,-30
108311428215,108311428221,6,2426,1590,-30
108315143085,108315143090,5,2074,1438,-30
108318055799,108318055801,2,1802,1144,-30
108319187002,108319187006,4,2110,1196,-30
108322374205,108322374210,5,2128,981,-30
108326058265,108326058270,5,1987,1310,-30
108331818478,108331818482,4,2849,1635,-30
108341269363,108341269362,-1,1134,2437,-30
108341361582,108341361587,5,2113,1091,-30
108342223990,108342223996,6,2124,1027,-30
108344357105,108344357102,-3,2359,5038,-30
108344432677,108344432683,6,1861,584,-30
108344578826,108344578831,5,3053,1366,-30
108347364161,108347364167,6,2572,1198,-30
108347573270,108347573275,5,2069,1423,-30
108350417845,108350417851,6,1617,744,-30
108354772595,108354772593,-2,2053,2527,-30
108355652588,108355652590,2,2019,1947,-30
108357136807,108357136812,5,2868,1466,-30
108364049230,108364049231,1,1418,1932,-30
108365822814,108365822821,7,2222,1043,-30
108368587927,108368587922,-5,2065,5401,-30
108374468272,108374468276,4,2231,1535,-30
108374941974,108374941978,4,2626,1581,-30
108377486414,108377486419,5,2694,1393,-30
108377844184,108377844189,5,2778,1704,-30
108383644478,108383644485,7,2591,1448,-30
108385935490,108385935495,5,2206,988,-30
108386990645,108386990640,-5,1201,5509,-30
108389883289,108389883293,4,2246,1321,-30
108393016901,108393016906,5,1661,1544,-30
108395411390,108395411372,-18,1862,1198,-30
108396401017,108396401024,7,1863,1298,-30
108399242797,108399242803,6,2294,1902,-30
108403456447,108403456451,4,1444,841,-30
108403792570,108403792571,1,890,118,-30
108404866705,108404866706,1,1767,1722,-30
108405831689,108405831695,6,1864,1259,-30
108408313502,108408313509,7,2375,1752,-30
108408948169,108408948173,4,3413,2157,-30
108410175142,108410175143,1,1165,1440,-30
108413219043,108413219046,3,1725,2652,-30
108417754332,108417754335,3,1894,1322,-30
108419421613,108419421618,5,2494,1639,-30
108425866067,108425866073,6,2095,1123,-30
108426599675,108426599681,6,2758,1589,-30
108427924771,108427924785,14,1732,1252,-30
108429506412,108429506417,5,2502,1295,-30
108429698588,108429698593,5,2455,1412,-30
108429774172,108429774175,3,2125,1012,-30
108437537162,108437537166,4,2571,1352,-30
108443751922,108443751927,5,2820,1561,-30
108445612889,108445612895,6,1657,1046,-30
108446238639,108446238643,4,1102,868,-30
108446597572,108446597577,5,1551,979,-30
108448877722,108448877730,8,1292,908,-30
108449811715,108449811720,5,1669,1308,-30
108450166193,108450166180,-13,2146,786,-30
108450443928,108450443933,5,2047,1186,-30
108453835905,108453835912,7,2203,1793,-30
108457267744,108457267746,2,1169,1485,-30
108462905129,108462905134,5,1532,1099,-30
108463325847,108463325851,4,1696,1432,-30
108469582670,108469582675,5,1764,1125,-30
108472353531,108472353537,6,1640,853,-30
108473596039,108473596045,6,2270,1325,-30
108473711203,108473711207,4,2155,975,-30
108479709827,108479709827,0,30486,21758,-30
108481257122,108481257127,5,2065,1160,-30
108481792090,108481792095,5,1535,1101,-30
108482562758,108482562765,7,1541,1032,-30
108484110737,108484110725,-12,58,1157,-30
108485310921,108485310925,4,2795,1879,-30
108485433002,108485433006,4,1782,765,-30
108490872393,108490872398,5,3068,853,-30
108491086209,108491086215,6,2025,1307,-30
108492839315,108492839320,5,2410,2066,-30
108498700928,108498700928,0,2121,1757,-30
108499687226,108499687233,7,1787,818,-30
108501893670,108501893674,4,2189,1199,-30
108502374121,108502374132,11,1582,1678,-30
108504290425,108504290430,5,2224,1402,-30
108504794406,108504794410,4,1694,1701,-30
108505905393,108505905397,4,1819,840,-30
108506733329,108506733333,4,2458,1362,-30
108507396437,108507396441,4,2396,1768,-30
108507931870,108507931871,1,1172,1145,-30
108508953463,108508953470,7,3449,1691,-30
108510672470,108510672477,7,2904,1411,-30
108517416906,108517416913,7,3381,1716,-30
108519619801,108519619803,2,2045,693,-30
108520620466,108520620471,5,1634,955,-30
108522648469,108522648476,7,1368,764,-30
108526317598,108526317601,3,1863,1615,-30
108526346445,108526346427,-18,1917,1001,-30
108527639868,108527639873,5,2427,1054,-30
108528046822,108528046827,5,2483,1746,-30
108528597012,108528597017,5,2475,1483,-30
108528862813,108528862821,8,2384,1233,-30
108529095318,108529095324,6,2599,1436,-30
108529805967,108529805970,3,1951,1204,-30
108530791854,108530791858,4,1751,1183,-30
108531740391,108531740396,5,1693,1325,-30
108534370026,108534370029,3,2335,1562,-30
108535525293,108535525286,-7,1327,265,-30
108540712337,108540712341,4,3228,1719,-30
108546205279,108546205283,4,1545,857,-30
108546422604,108546422607,3,2664,1874,-30
108551220393,108551220399,6,2548,1196,-30
108556324422,108556324428,6,1546,1202,-30
108560056990,108560056994,4,2414,1098,-30
108564746705,108564746711,6,2327,1753,-30
108567451252,108567451255,3,1618,1273,-30
108568841475,108568841481,6,3140,1555,-30
108572746593,108572746599,6,2814,1481,-30
108576856717,108576856721,4,2674,1334,-30
108577822783,108577822788,5,1994,977,-30
108578044502,108578044521,19,2056,1046,-30
108579877752,108579877758,6,2277,1220,-30
108581844186,108581844190,4,2270,1313,-30
108583367722,108583367723,1,759,1578,-30
108585853928,108585853934,6,2579,1503,-30
108586585315,108586585312,-3,1408,1853,-30
108586893162,108586893169,7,1506,941,-30
108587464334,108587464338,4,1413,500,-30
108590078841,108590078846,5,2921,1453,-30
108592418706,108592418714,8,1858,842,-30
108595110098,108595110097,-1,1155,1685,-30
108595495003,108595495009,6,2108,1468,-30
108602470666,108602470671,5,1982,953,-30
108605316673,108605316678,5,2349,945,-30
108613608431,108613608436,5,2284,1238,-30
108614192266,108614192272,6,2841,1055,-30
108614674487,108614674504,17,855,229,-30
108617973179,108617973184,5,1905,1563,-30
108619513206,108619513207,1,1839,1679,-30
108622471437,108622471443,6,2305,1860,-30
108624734273,108624734267,-6,868,3514,-30
108626161021,108626161027,6,2871,1297,-30
108626884477,108626884478,1,1460,939,-30
108629945412,108629945418,6,8000,3284,-30
108630619326,108630619330,4,1849,1052,-30
108631578118,108631578123,5,1527,963,-30
108631856194,108631856210,16,1774,1202,-30
108632463089,108632463095,6,1381,989,-30
108638501795,108638501800,5,2438,1075,-30
108639843907,108639843911,4,3135,1916,-30
108642109598,108642109605,7,1679,1295,-30
108644043338,108644043345,7,1743,1219,-30
108648393862,108648393868,6,2977,1112,-30
108648592623,108648592608,-15,4920,2484,-30
108649969718,108649969723,5,3145,1163,-30
108654533395,108654533401,6,1472,1001,-30
108657646874,108657646866,-8,34186,12378,-30
108661107190,108661107195,5,2121,1129,-30
108661264632,108661264636,4,1483,864,-30
108662025485,108662025490,5,2604,1127,-30
108662229262,108662229272,10,2269,1234,-30
108662565390,108662565395,5,1322,823,-30
108664252066,108664252071,5,2098,1210,-30
108667939999,108667940005,6,2447,1460,-30
108668934313,108668934317,4,3972,1374,-30
108671556743,108671556750,7,2705,1194,-30
108675750387,108675750376,-11,1602,754,-30
108676093158,108676093159,1,1821,928,-30
108677367896,108677367899,3,2322,1466,-30
108677772478,108677772478,0,1999,1667,-30
108677854634,108677854638,4,2201,1160,-30
108679897621,108679897627,6,2255,1526,-30
108680533768,108680533772,4,1507,1132,-30
108681604664,108681604670,6,1788,1058,-30
108682257505,108682257489,-16,3625,1608,-30
108682452748,108682452753,5,2684,1061,-30
108688694414,108688694419,5,1751,773,-30
108691662185,108691662178,-7,44397,15575,-30
108693349353,108693349356,3,1511,1425,-30
108694075978,108694075984,6,3004,1476,-30
108694176079,108694176085,6,1755,1453,-30
108706033577,108706033583,6,1086,919,-30
108707589883,108707589887,4,2298,1595,-30
108707848421,108707848425,4,2496,1112,-30
108714167977,108714167982,5,2565,1446,-30
108715550978,108715550982,4,2367,1640,-30
108719643386,108719643393,7,3270,1520,-30
108720053866,108720053873,7,2309,1282,-30
108720530638,108720530643,5,1850,1388,-30
108721285790,108721285795,5,2731,1355,-30
108722579990,108722579994,4,2112,1258,-30
108726284796,108726284798,2,2207,1136,-30
108727983701,108727983698,-3,3373,7169,-30
108734579933,108734579937,4,2141,1619,-30
108735288965,108735288970,5,2086,736,-30
108740262606,108740262592,-14,620,473,-30
108744953377,108744953383,6,2690,985,-30
108745343806,108745343786,-20,1804,1249,-30
108757487721,108757487724,3,2072,1087,-30
108759723768,108759723773,5,2196,978,-30
108760892991,108760892971,-20,1526,645,-30
108761521041,108761521046,5,1728,1468,-30
108763823938,108763823944,6,2861,1262,-30
108765138778,108765138784,6,1630,928,-30
108765228394,108765228376,-18,2140,1292,-30
108766313978,108766313982,4,2220,1190,-30
108768284030,108768284035,5,16868,6649,-30
108769260922,108769260927,5,2167,1318,-30
108769678267,108769678270,3,2460,1329,-30
108772689342,108772689348,6,1844,1157,-30
108779482646,108779482650,4,3038,1350,-30
108780160826,108780160831,5,2853,1760,-30
108781662698,108781662703,5,2156,1166,-30
108781848402,108781848399,-3,1368,2480,-30
108784441543,108784441541,-2,1206,1601,-30
108786994880,108786994886,6,1848,1070,-30
108787031784,108787031786,2,2387,1793,-30
108794515113,108794515117,4,2098,1544,-30
108801460538,108801460534,-4,637,2879,-30
108802104043,108802104049,6,3081,1637,-30
108802133202,108802133210,8,2367,1264,-30
108803347806,108803347806,0,1143,1289,-30
108804217599,108804217602,3,2848,1602,-30
108805277898,108805277902,4,2319,2012,-30
108806065169,108806065171,2,1476,1169,-30
108806312062,108806312067,5,2439,1265,-30
108813490358,108813490358,0,938,1372,-30
108816617090,108816617096,6,1810,1465,-30
108822081731,108822081729,-2,669,1432,-30
108825068435,108825068439,4,1891,886,-30
108825353145,108825353149,4,2251,1316,-30
108827410641,108827410646,5,1295,965,-30
108829511904,108829511908,4,2629,1686,-30
108829702670,108829702682,12,1443,95,-30
108831704797,108831704801,4,2274,1296,-30
108831927850,108831927855,5,1962,1499,-30
108834014322,108834014334,12,15018,26284,-30
108834761470,108834761472,2,1997,1275,-30
108840384345,108840384349,4,2059,1668,-30
108840873276,108840873279,3,1656,1037,-30
108842950547,108842950555,8,3176,1106,-30
108843393563,108843393544,-19,1621,827,-30
108843576370,108843576373,3,2186,1208,-30
108844410512,108844410518,6,1739,875,-30
108845864102,108845864106,4,2277,1195,-30
108850460933,108850460939,6,1753,1388,-30
108852667142,108852667150,8,2264,928,-30
108852823038,108852823025,-13,1160,589,-30
108853375499,108853375503,4,1870,1800,-30
108854500894,108854500898,4,1980,1585,-30
108854892790,108854892794,4,754,55,-30
108860883620,108860883624,4,2564,1593,-30
108864942358,108864942354,-4,1077,5071,-30
108870481489,108870481492,3,1938,1119,-30
108877496110,108877496115,5,1908,1378,-30
108877626050,108877626056,6,2501,1005,-30
108879792130,108879792135,5,1966,1179,-30
108879920191,108879920172,-19,1406,781,-30
108890350330,108890350333,3,1866,1010,-30
108895738797,108895738801,4,3156,1599,-30
108901990187,108901990192,5,2289,1745,-30
108902571254,108902571259,5,2174,1375,-30
108906748742,108906748741,-1,1543,2117,-30
108914232674,108914232672,-2,1197,1870,-30
108914847590,108914847589,-1,1849,2147,-30
108915446785,108915446789,4,2330,1505,-30
108919182101,108919182104,3,2157,1088,-30
108920486945,108920486950,5,2859,1517,-30
108921230771,108921230777,6,2772,1477,-30
108921432490,108921432499,9,2620,1467,-30
108921915990,108921915978,-12,12936,38043,-30
108922549646,108922549642,-4,1527,3389,-30
108925100833,108925100840,7,9946,40416,-30
108926094391,108926094406,15,1138,90,-30
108929116103,108929116109,6,2366,1230,-30
108929494326,108929494332,6,3084,1737,-30
108932069786,108932069793,7,1870,1102,-30
108933674278,108933674283,5,2026,1020,-30
108934574543,108934574548,5,2513,1411,-30
108935636414,108935636419,5,3319,1318,-30
108940062280,108940062285,5,2090,1179,-30
108940525149,108940525155,6,2390,1023,-30
108941666258,108941666264,6,1725,1076,-30
108942559133,108942559137,4,1617,971,-30
108942753350,108942753353,3,1718,1029,-30
108942788508,108942788513,5,3326,1395,-30
108944782147,108944782154,7,2354,1375,-30
108945295338,108945295345,7,2531,1078,-30
108945553624,108945553629,5,1244,983,-30
108949572006,108949572010,4,3139,1403,-30
108950037471,108950037465,-6,975,4020,-30
108957301306,108957301310,4,2792,1566,-30
108958521500,108958521504,4,2426,1209,-30
108962570525,108962570529,4,2519,1614,-30
108968027774,108968027758,-16,3520,1468,-30
108970509930,108970509937,7,3594,1686,-30
108976173727,108976173733,6,2378,1672,-30
108978246897,108978246902,5,1818,1155,-30
108978616975,108978616954,-21,1345,713,-30
108979008556,108979008561,5,2128,1104,-30
108982696742,108982696748,6,3498,1462,-30
108986806276,108986806280,4,2452,1082,-30
108987544665,108987544670,5,2120,1279,-30
108989255840,108989255826,-14,1565,1257,-30
108997803013,108997803018,5,2450,1521,-30
109007790273,109007790272,-1,2840,3857,-30
109010343385,109010343390,5,3440,2795,-30
109010486862,109010486866,4,1725,1564,-30
109011014413,109011014413,0,1923,1915,-30
109012802158,109012802146,-12,2244,752,-30
109014062300,109014062310,10,476,2052,-30
109019514365,109019514370,5,2480,1464,-30
109020821321,109020821326,5,2037,940,-30
109025333274,109025333281,7,1949,1038,-30
109029756865,109029756869,4,2389,1897,-30
109030559097,109030559103,6,2322,1761,-30
109033789107,109033789099,-8,39140,11709,-30
109034739790,109034739796,6,2300,1346,-30
109038714278,109038714282,4,2193,1288,-30
109039994781,109039994786,5,2684,1900,-30
109044401657,109044401661,4,2639,1152,-30
109044564563,109044564546,-17,2849,1310,-30
109052184216,109052184223,7,2490,1538,-30
109053124911,109053124913,2,1414,1112,-30
109058354970,109058354977,7,2194,1129,-30
109065025243,109065025246,3,2329,1509,-30
109071740261,109071740266,5,2311,1020,-30
109076245278,109076245282,4,1480,1401,-30
109079167423,109079167429,6,2277,1114,-30
109080070724,109080070729,5,1646,1074,-30
109080234309,109080234314,5,2455,1749,-30
109081274622,109081274621,-1,2438,5671,-30
109083328675,109083328675,0,931,1245,-30
109086234170,109086234175,5,2016,1554,-30
109088300422,109088300427,5,2746,1168,-30
109088898569,109088898574,5,2365,867,-30
109091503302,109091503309,7,3273,1510,-30
109099867006,109099867013,7,2136,1666,-30
109105459195,109105459200,5,2432,1596,-30
109109640518,109109640525,7,2529,1581,-30
109111735493,109111735498,5,2111,1309,-30
109115365490,109115365494,4,2945,1294,-30
109116241965,109116241948,-17,1303,1081,-30
109116670845,109116670847,2,1313,820,-30
109120478992,109120478997,5,2539,1824,-30
109123910278,109123910282,4,1261,999,-30
109124932066,109124932070,4,2073,1291,-30
109125290677,109125290682,5,3525,1142,-30
109127096153,109127096159,6,2919,1401,-30
109128344890,109128344897,7,2385,1497,-30
109133830621,109133830627,6,2014,900,-30
109138273057,109138273060,3,3289,1469,-30
109143702017,109143702022,5,2163,1291,-30
109144185709,109144185690,-19,1932,766,-30
109144697438,109144697442,4,2957,1404,-30
109151914338,109151914342,4,2004,1035,-30
109152464256,109152464262,6,1927,1277,-30
109154586578,109154586585,7,2011,1125,-30
109156061841,109156061840,-1,1075,1912,-30
109159013316,109159013322,6,4380,1882,-30
109159775752,109159775757,5,2558,1077,-30
109167085986,109167085990,4,2721,1708,-30
109174803958,109174803962,4,1764,1224,-30
109174829166,109174829173,7,3498,1721,-30
109176123375,109176123380,5,2099,1003,-30
109176575753,109176575758,5,1892,996,-30
109178887858,109178887862,4,2411,1400,-30
109179186414,109179186395,-19,3067,1304,-30
109179867242,109179867247,5,2406,1399,-30
109183631934,109183631938,4,2807,1638,-30
109183811083,109183811089,6,2653,1141,-30
109186787846,109186787852,6,3859,1647,-30
109189223242,109189223246,4,1358,918,-30
109191237100,109191237106,6,1960,1206,-30
109193932718,109193932719,1,1939,938,-30
109196713637,109196713639,2,2462,1732,-30
109201291369,109201291374,5,2458,1372,-30
109202073669,109202073675,6,2208,1325,-30
109204608500,109204608505,5,1510,1436,-30
109205044368,109205044372,4,3173,1326,-30
109209646346,109209646327,-19,1603,722,-30
109213855766,109213855771,5,2537,1496,-30
109214490085,109214490091,6,2330,1290,-30
109214588263,109214588270,7,1714,818,-30
109219709597,109219709602,5,1572,1297,-30
109220894196,109220894199,3,1120,1070,-30
109226974721,109226974727,6,1456,1017,-30
109228598814,109228598819,5,2653,1205,-30
109229060211,109229060216,5,2100,1525,-30
109229410215,109229410210,-5,2917,5420,-30
109235253294,109235253298,4,2689,1622,-30
109239501798,109239501806,8,2368,1360,-30
109239836361,109239836366,5,2228,1649,-30
109241968774,109241968778,4,3568,1658,-30
109242468199,109242468203,4,2252,1077,-30
109242670645,109242670650,5,2378,1558,-30
109244326044,109244326051,7,3416,1544,-30
109246911606,109246911613,7,2403,1063,-30
109248502746,109248502750,4,1232,1506,-30
109248552413,109248552420,7,5022,1175,-30
109251996426,109251996433,7,2007,1776,-30
109253140859,109253140863,4,1830,815,-30
109255862120,109255862126,6,2797,1236,-30
109258502780,109258502785,5,1567,917,-30
109262557761,109262557765,4,2216,1311,-30
109263187416,109263187421,5,1447,1493,-30
109264534138,109264534141,3,2124,1087,-30
109267793553,109267793555,2,2163,1004,-30
109268451361,109268451371,10,2937,1290,-30
109269047866,109269047870,4,2152,1262,-30
109270248493,109270248499,6,3247,1476,-30
109272765639,109272765643,4,2486,1288,-30
109278266238,109278266246,8,1993,1302,-30
109280596199,109280596202,3,2275,1064,-30
109281260650,109281260658,8,2977,1171,-30
109284755502,109284755508,6,2346,1418,-30
109285206746,109285206751,5,2049,1206,-30
109286798009,109286798014,5,1883,1103,-30
109287294693,109287294697,4,2256,1290,-30
109289145615,109289145619,4,2059,1469,-30
109293993444,109293993451,7,2116,1170,-30
109301527290,109301527295,5,2270,1320,-30
109303943938,109303943930,-8,1252,7834,-30
109305749835,109305749841,6,2259,998,-30
109306332281,109306332285,4,2496,1561,-30
109306960215,109306960219,4,1914,1655,-30
109307703168,109307703174,6,1958,1318,-30
109313343772,109313343779,7,2069,1006,-30
109314881831,109314881834,3,2338,2330,-30
109315827619,109315827623,4,2744,1445,-30
109316668322,109316668325,3,1912,872,-30
109317845517,109317845498,-19,2060,1255,-30
109318476199,109318476203,4,2294,1146,-30
109319200960,109319200966,6,2667,1242,-30
109319981089,109319981092,3,1866,1176,-30
109324302196,109324302202,6,2293,1331,-30
109327265474,109327265478,4,2553,1058,-30
109327919782,109327919786,4,2114,1570,-30
109328688846,109328688846,0,15086,27467,-30
109329705326,109329705331,5,2526,1648,-30
109330817122,109330817124,2,1833,1316,-30
109333283435,109333283438,3,2014,1280,-30
109333421234,109333421220,-14,2383,1272,-30
109338630526,109338630531,5,2175,1323,-30
109340518585,109340518588,3,1953,1432,-30
109340802453,109340802433,-20,1051,404,-30
109341118423,109341118415,-8,855,548,-30
109346493695,109346493698,3,2044,1212,-30
109349234254,109349234258,4,1174,1208,-30
109350550090,109350550095,5,2331,1519,-30
109351149279,109351149300,21,1015,900,-30
109351340854,109351340860,6,2653,1198,-30
109352209566,109352209569,3,1313,1346,-30
109352507971,109352507974,3,1459,1335,-30
109355041892,109355041896,4,2145,1117,-30
109359078309,109359078313,4,2120,1585,-30
109361005246,109361005249,3,1308,1017,-30
109361721049,109361721054,5,2266,1327,-30
109365960759,109365960765,6,1591,1213,-30
109368172143,109368172146,3,1781,1051,-30
109374097271,109374097276,5,2337,1499,-30
109376704678,109376704682,4,2430,1537,-30
109378326970,109378326974,4,2210,1328,-30
109378902178,109378902183,5,2531,1487,-30
109383059661,109383059669,8,1281,939,-30
109384696590,109384696594,4,2377,1266,-30
109385119573,109385119579,6,3308,1635,-30
109385965037,109385965041,4,2141,1350,-30
109389878753,109389878755,2,1327,1176,-30
109395587934,109395587941,7,1474,1123,-30
109403477846,109403477851,5,3154,1292,-30
109404217691,109404217695,4,2567,1492,-30
109405944525,109405944527,2,3311,4086,-30
109412326054,109412326059,5,1734,1259,-30
109414740429,109414740434,5,2077,1371,-30
109415201634,109415201638,4,1666,989,-30
109415245813,109415245818,5,1279,1056,-30
109415762051,109415762055,4,1356,838,-30
109418112716,109418112719,3,2145,2066,-30
109419884294,109419884301,7,3016,1247,-30
109425743615,109425743620,5,2080,1695,-30
109430375532,109430375538,6,1934,1142,-30
109439429609,109439429611,2,2329,884,-30
109439544967,109439544962,-5,1230,5048,-30
109441938741,109441938746,5,2563,1217,-30
109443542880,109443542884,4,1985,1772,-30
109448633399,109448633393,-6,770,4922,-30
109450128750,109450128731,-19,600,533,-30
109450761903,109450761907,4,1836,1149,-30
109454402709,109454402714,5,2565,2246,-30
109454798560,109454798564,4,2411,1120,-30
109457705341,109457705347,6,2960,1393,-30
109458201146,109458201152,6,2194,1529,-30
109459780821,109459780826,5,2077,1370,-30
109463303548,109463303555,7,2278,1089,-30
109464027774,109464027767,-7,1082,3982,-30
109465108834,109465108838,4,2452,1227,-30
109469801705,109469801709,4,2433,1452,-30
109470581537,109470581542,5,2603,1331,-30
109475136854,109475136861,7,2461,750,-30
109479101235,109479101239,4,1921,1875,-30
109480712931,109480712935,4,1944,967,-30
109481646862,109481646864,2,1177,2044,-30
109485386161,109485386164,3,1952,1170,-30
109488251305,109488251309,4,2835,1236,-30
109489514409,109489514413,4,3016,1371,-30
109490390966,109490390971,5,2408,1511,-30
109493397513,109493397518,5,2225,994,-30
109495093118,109495093117,-1,782,1217,-30
109495660226,109495660231,5,2858,1571,-30
109498398064,109498398070,6,1833,1157,-30
109501769958,109501769966,8,2572,1153,-30
109507430906,109507430910,4,1771,1174,-30
109508194646,109508194659,13,2964,1230,-30
109508247109,109508247099,-10,703,157,-30
109509012158,109509012158,0,1674,1518,-30
109510687214,109510687221,7,1301,1079,-30
109514875992,109514875997,5,2545,1575,-30
109516194135,109516194140,5,2836,1459,-30
109516395846,109516395856,10,425,240,-30
109517421147,109517421153,6,1972,1178,-30
109528005689,109528005691,2,2084,1497,-30
109528405525,109528405531,6,1249,1143,-30
109529406603,109529406609,6,2121,1030,-30
109532145417,109532145420,3,1415,803,-30
109536877299,109536877304,5,2141,1797,-30
109536947813,109536947817,4,2251,1021,-30
109538172106,109538172113,7,1857,1272,-30
109539243173,109539243175,2,2421,1665,-30
109542313834,109542313839,5,3058,1860,-30
109545999911,109545999915,4,2523,1251,-30
109555446229,109555446235,6,2685,1274,-30
109563714404,109563714412,8,22945,36673,-30
109571367908,109571367910,2,2123,1395,-30
109571570389,109571570393,4,2191,1565,-30
109573235917,109573235920,3,2248,1730,-30
109575072710,109575072717,7,2671,1410,-30
109576757170,109576757174,4,2483,1296,-30
109583095804,109583095809,5,1943,1352,-30
109583934826,109583934833,7,3197,1470,-30
109584232116,109584232122,6,1642,924,-30
109584465780,109584465763,-17,1406,1088,-30
109587973098,109587973103,5,2515,1464,-30
109590041897,109590041901,4,2950,1654,-30
109592944095,109592944102,7,3055,1220,-30
109593589338,109593589344,6,2160,1139,-30
109593931019,109593931025,6,2369,1247,-30
109597393774,109597393757,-17,2775,1340,-30
109599041716,109599041719,3,2677,1723,-30
109600937214,109600937215,1,2226,2912,-30
109601763617,109601763618,1,1578,1594,-30
109601837563,109601837567,4,2057,1181,-30
109602740767,109602740769,2,1240,999,-30
109602841782,109602841787,5,2810,1884,-30
109607762312,109607762317,5,1757,1019,-30
109608921501,109608921504,3,1686,1248,-30
109610741563,109610741550,-13,33884,16443,-30
109615162354,109615162360,6,2370,1667,-30
109618398246,109618398250,4,1636,1065,-30
109620680487,109620680493,6,2400,1133,-30
109624995368,109624995374,6,3060,1309,-30
109629899464,109629899467,3,2042,1468,-30
109632063543,109632063549,6,2466,1114,-30
109634206267,109634206266,-1,618,1234,-30
109641080175,109641080178,3,795,471,-30
109642287105,109642287106,1,1092,1490,-30
109643328502,109643328506,4,1570,1171,-30
109647435373,109647435376,3,1797,939,-30
109647481109,109647481107,-2,3711,5918,-30
109648885066,109648885069,3,1595,1038,-30
109651403519,109651403527,8,2211,1011,-30
109652654056,109652654058,2,1775,1524,-30
109653237328,109653237319,-9,43260,10307,-30
109655326421,109655326426,5,2247,1620,-30
109656179143,109656179148,5,3740,2195,-30
109660696509,109660696514,5,1591,630,-30
109666972039,109666972046,7,3058,1353,-30
109667942249,109667942254,5,1907,1122,-30
109669473549,109669473555,6,1672,1028,-30
109679591408,109679591414,6,2582,1062,-30
109685947442,109685947447,5,1812,707,-30
109687286902,109687286902,0,749,905,-30
109689422270,109689422278,8,104,929,-30
109690636678,109690636685,7,2480,1213,-30
109692615057,109692615036,-21,1694,1204,-30
109693673072,109693673078,6,2282,1099,-30
109694834889,109694834894,5,2331,2128,-30
109695435061,109695435065,4,2760,1725,-30
109696187951,109696187958,7,2997,1460,-30
109701172582,109701172587,5,2116,1077,-30
109706107327,109706107330,3,2803,1027,-30
109706713037,109706713041,4,2493,1474,-30
109708237239,109708237245,6,1690,1141,-30
109709698394,109709698401,7,2409,1165,-30
109709861211,109709861210,-1,1266,1685,-30
109710212914,109710212917,3,2098,1152,-30
109711021387,109711021402,15,762,283,-30
109713484725,109713484730,5,3270,1488,-30
109715654647,109715654653,6,2446,1831,-30
109716847730,109716847737,7,3230,1692,-30
109720321487,109720321492,5,2426,1889,-30
109722895823,109722895827,4,1466,1030,-30
109723675044,109723675049,5,1851,1311,-30
109724870517,109724870522,5,2418,1521,-30
109725008504,109725008510,6,2980,1743,-30
109725396550,109725396554,4,2587,1893,-30
109727199055,109727199061,6,1958,931,-30
109729273213,109729273218,5,2270,1361,-30
109734532200,109734532203,3,2012,977,-30
109735732621,109735732627,6,1572,1300,-30
109737630953,109737630958,5,1659,769,-30
109742287311,109742287318,7,2977,1810,-30
109742369434,109742369420,-14,3509,1520,-30
109744310546,109744310550,4,2125,1760,-30
109747880505,109747880511,6,2368,1297,-30
109748964832,109748964834,2,1797,1060,-30
109751604298,109751604303,5,3458,1690,-30
109757216770,109757216774,4,2802,1405,-30
109762179331,109762179334,3,2918,1177,-30
109767795370,109767795374,4,1906,1809,-30
109768416674,109768416680,6,1750,1305,-30
109768640331,109768640335,4,1741,1003,-30
109769099705,109769099710,5,1945,1489,-30
109770511113,109770511118,5,1692,1199,-30
109770961435,109770961428,-7,812,305,-30
109775758662,109775758667,5,1348,933,-30
109777284942,109777284948,6,2207,1297,-30
109777834994,109777835002,8,1926,1287,-30
109778831361,109778831365,4,1744,1397,-30
109779564315,109779564297,-18,1886,753,-30
109785608684,109785608689,5,2186,1662,-30
109790702478,109790702483,5,2244,1675,-30
109792133991,109792133995,4,2194,1471,-30
109794848001,109794848005,4,2418,1297,-30
109795363976,109795363982,6,2985,1715,-30
109803097389,109803097394,5,1777,1472,-30
109803721558,109803721558,0,2031,1525,-30
109809941459,109809941466,7,2823,1464,-30
109810176160,109810176164,4,2978,1607,-30
109815025389,109815025392,3,1769,1261,-30
109816149589,109816149595,6,1614,813,-30
109816201443,109816201459,16,2604,1289,-30
109816910436,109816910441,5,1883,1276,-30
109819216061,109819216066,5,2252,1548,-30
109819446070,109819446074,4,2431,958,-30
109819670546,109819670552,6,2544,1169,-30
109821587950,109821587955,5,2240,1355,-30
109824352653,109824352658,5,2037,1254,-30
109826591198,109826591202,4,2075,1559,-30
109828444158,109828444162,4,1427,1136,-30
109830173706,109830173712,6,2678,1634,-30
109837076074,109837076079,5,1000,1111,-30
109837590997,109837591003,6,1903,1530,-30
109838992537,109838992531,-6,1721,6702,-30
109839380279,109839380282,3,2880,1233,-30
109843407148,109843407153,5,1582,1449,-30
109844309914,109844309934,20,2498,5892,-30
109851549708,109851549715,7,3064,804,-30
109854649720,109854649726,6,1506,1087,-30
109857133714,109857133721,7,3378,1231,-30
109860080446,109860080450,4,3004,1524,-30
109861389985,109861389990,5,2381,1501,-30
109864338348,109864338351,3,2606,1226,-30
109867138227,109867138234,7,2628,1454,-30
109873736073,109873736079,6,1882,1485,-30
109882050223,109882050227,4,2287,1678,-30
109884106006,109884106008,2,8471,18780,-30
109885184729,109885184733,4,2001,1238,-30
109885625521,109885625525,4,1965,1059,-30
109886262338,109886262342,4,1839,1466,-30
109890585214,109890585220,6,2465,1268,-30
109891941799,109891941802,3,1798,2218,-30
109892546865,109892546871,6,1996,1409,-30
109894801497,109894801503,6,2138,1576,-30
109897904041,109897904045,4,1906,1163,-30
109901049311,109901049315,4,1707,1140,-30
109904116379,109904116383,4,1521,1253,-30
109904597259,109904597265,6,2031,1040,-30
109908110764,109908110769,5,1417,1089,-30
109908907158,109908907162,4,1412,1238,-30
109911062344,109911062347,3,2343,1391,-30
109911723736,109911723742,6,2580,1422,-30
109912268506,109912268508,2,17362,16829,-30
109912936289,109912936294,5,2877,1180,-30
109918967906,109918967913,7,2507,1245,-30
109919094370,109919094374,4,1945,1379,-30
109921735927,109921735921,-6,1021,1872,-30
109921978381,109921978386,5,2269,1611,-30
109923512584,109923512589,5,2862,1470,-30
109925407335,109925407342,7,2817,1300,-30
109926206729,109926206734,5,2717,1680,-30
109926800945,109926800949,4,2069,1172,-30
109931461490,109931461494,4,1245,959,-30
109934128455,109934128468,13,896,264,-30
109934797551,109934797555,4,2512,1379,-30
109936718057,109936718061,4,1408,1095,-30
109944416740,109944416744,4,2833,1912,-30
109944563227,109944563232,5,662,596,-30
109947741025,109947741024,-1,2797,3696,-30
109947831100,109947831105,5,1310,920,-30
109956578983,109956578987,4,1901,1348,-30
109956975522,109956975527,5,2817,1622,-30
109958682846,109958682851,5,1669,1031,-30
109959080182,109959080185,3,2913,1635,-30
109968288504,109968288522,18,109,4532,-30
109968396178,109968396182,4,2559,1219,-30
109968480321,109968480327,6,2732,1263,-30
109973800175,109973800179,4,1026,1004,-30
109974301712,109974301709,-3,1713,3715,-30
109977256972,109977256982,10,2890,1601,-30
109980164980,109980164985,5,3325,1740,-30
109981499050,109981499054,4,3081,1558,-30
109987974199,109987974204,5,2549,1474,-30
109988556087,109988556086,-1,2284,2409,-30
109992399086,109992399090,4,2062,1731,-30
109994182965,109994182971,6,3492,1586,-30
109995629171,109995629177,6,2305,1340,-30
109998943075,109998943083,8,5369,2519,-30
109999819653,109999819657,4,2015,875,-30
110001213183,110001213188,5,1830,1624,-30
110003482523,110003482527,4,2362,1134,-30
110010707934,110010707934,0,1315,1100,-30
110010737926,110010737905,-21,3140,1557,-30
110011492834,110011492841,7,2569,1389,-30
110015061673,110015061678,5,2447,1110,-30
110015303802,110015303807,5,2186,1158,-30
110016640515,110016640522,7,2682,1305,-30
110017166478,110017166482,4,2117,1556,-30
110019076715,110019076721,6,2021,1265,-30
110021530210,110021530214,4,1383,1076,-30
110021898675,110021898679,4,2160,944,-30
110023241219,110023241222,3,1919,1358,-30
110026459035,110026459039,4,1803,1204,-30
110029824234,110029824240,6,1585,1563,-30
110030481124,110030481117,-7,2063,8327,-30
110032993357,110032993362,5,2219,1048,-30
110035355416,110035355419,3,973,833,-30
110038027290,110038027296,6,2411,1235,-30
110038274898,110038274903,5,1893,1343,-30
110039355482,110039355488,6,2403,1612,-30
110040238711,110040238715,4,1240,684,-30
110040919553,110040919556,3,2097,1344,-30
110043595748,110043595752,4,2646,1583,-30
110045108813,110045108814,1,2126,1855,-30
110046615954,110046615934,-20,1616,1136,-30
110047422778,110047422782,4,2216,1517,-30
110053981980,110053981994,14,568,1555,-30
110054797334,110054797338,4,2304,1024,-30
110057501865,110057501869,4,2684,1372,-30
110061933092,110061933097,5,2652,1706,-30
110062279182,110062279186,4,2637,1317,-30
110066452431,110066452438,7,2056,990,-30
110066915390,110066915368,-22,1480,699,-30
110067366665,110067366670,5,2221,1412,-30
110068516253,110068516257,4,1469,924,-30
110074109729,110074109733,4,1770,1948,-30
110074587499,110074587501,2,1543,1391,-30
110079335350,110079335357,7,2311,1149,-30
110080122653,110080122657,4,2404,1177,-30
110082286890,110082286891,1,948,915,-30
110082974368,110082974363,-5,1244,4131,-30
110084067718,110084067721,3,2089,1374,-30
110088266082,110088266085,3,2690,1432,-30
110092825567,110092825572,5,1348,1509,-30
110095620684,110095620690,6,2216,1365,-30
110097358294,110097358299,5,1709,1377,-30
110098665932,110098665934,2,1797,1529,-30
110099144690,110099144696,6,1975,1126,-30
110099921150,110099921171,21,2614,1325,-30
110103258197,110103258204,7,2798,1466,-30
110104232126,110104232129,3,2401,1363,-30
110107154507,110107154514,7,1958,853,-30
110109917965,110109917971,6,1324,860,-30
110113230078,110113230082,4,2478,1556,-30
110114037726,110114037706,-20,866,133,-30
110118766172,110118766175,3,2862,1893,-30
110119865319,110119865326,7,2245,1489,-30
110126260005,110126260009,4,1638,1420,-30
110126896389,110126896395,6,2921,961,-30
110131145501,110131145507,6,2452,1393,-30
110134322380,110134322385,5,3376,2231,-30
110134836670,110134836675,5,2958,1270,-30
110136276751,110136276757,6,2683,1664,-30
110136488930,110136488937,7,2856,1873,-30
110152046608,110152046614,6,1817,1284,-30
110153845896,110153845901,5,1923,1837,-30
110154261029,110154261031,2,2433,2042,-30
110165999229,110165999236,7,2256,1022,-30
110167505922,110167505926,4,2470,1164,-30
110168302966,110168302970,4,1392,1341,-30
110168552473,110168552479,6,2436,1199,-30
110168704410,110168704393,-17,2175,1552,-30
110175402725,110175402729,4,1968,936,-30
110175998106,110175998096,-10,737,304,-30
110178784865,110178784867,2,1673,1512,-30
110180567272,110180567275,3,2044,1239,-30
110181306677,110181306684,7,2203,1131,-30
110181394922,110181394932,10,1950,1202,-30
110182155945,110182155951,6,3185,1897,-30
110183087863,110183087859,-4,1309,3007,-30
110184656891,110184656897,6,1446,1378,-30
110187417589,110187417593,4,2392,1099,-30
110188731174,110188731179,5,2671,1781,-30
110190418758,110190418763,5,1888,1241,-30
110191389629,110191389632,3,1580,1502,-30
110192674054,110192674057,3,2150,1372,-30
110193699233,110193699217,-16,880,272,-30
110194237477,110194237483,6,2089,864,-30
110197084855,110197084858,3,1684,1159,-30
110197152530,110197152515,-15,2788,1572,-30
110198520574,110198520581,7,2398,1566,-30
110199320234,110199320241,7,3005,1483,-30
110199581274,110199581291,17,1098,271,-30
110202434459,110202434466,7,2982,1553,-30
110204978913,110204978919,6,3356,1450,-30
110206924164,110206924167,3,2139,919,-30
110207062011,110207061994,-17,1669,1069,-30
110207977148,110207977155,7,2420,1121,-30
110208043154,110208043158,4,3842,2738,-30
110215158978,110215158985,7,2977,967,-30
110215362317,110215362338,21,2855,1518,-30
110216037723,110216037727,4,1531,1396,-30
110222877910,110222877905,-5,1604,3464,-30
110225288030,110225288038,8,2526,1607,-30
110225837178,110225837183,5,1628,1465,-30
110227146366,110227146369,3,2451,1137,-30
110227709152,110227709148,-4,3335,10652,-30
110228984310,110228984318,8,3362,995,-30
110235089981,110235089986,5,2143,1380,-30
110235529707,110235529705,-2,1075,1716,-30
110238853318,110238853322,4,1859,1147,-30
110240775754,110240775757,3,2413,1363,-30
110241584940,110241584943,3,3477,1755,-30
110246638561,110246638556,-5,765,3530,-30
110247436610,110247436614,4,1821,1123,-30
110253503736,110253503741,5,2590,1404,-30
110257813391,110257813398,7,1310,926,-30
110258528898,110258528904,6,2381,1655,-30
110258631172,110258631178,6,2217,1247,-30
110258687715,110258687697,-18,1254,9,-30
110258879430,110258879448,18,2377,1214,-30
110262361878,110262361883,5,1763,1497,-30
110264544833,110264544839,6,1717,1236,-30
110264611383,110264611387,4,2632,1282,-30
110265408450,110265408456,6,2550,1826,-30
110265807718,110265807697,-21,2717,1246,-30
110267729693,110267729698,5,2112,1052,-30
110269332410,110269332414,4,2230,802,-30
110273231580,110273231580,0,1257,1931,-30
110275131030,110275131030,0,1917,1738,-30
110275798306,110275798311,5,2278,1147,-30
110277878814,110277878810,-4,1248,2883,-30
110279818046,110279818048,2,2103,1393,-30
110281095874,110281095878,4,2008,1501,-30
110282013946,110282013954,8,1852,768,-30
110285027761,110285027766,5,3326,1541,-30
110285158482,110285158486,4,3154,1671,-30
110288042065,110288042070,5,1993,1302,-30
110292836431,110292836436,5,1465,870,-30
110295712325,110295712329,4,2879,1618,-30
110296985370,110296985374,4,961,1154,-30
110297339535,110297339538,3,2006,1010,-30
110298818271,110298818274,3,1757,1199,-30
110300235768,110300235773,5,2015,1899,-30
110305984461,110305984467,6,2274,1386,-30
110307200142,110307200147,5,2126,1517,-30
110307458456,110307458462,6,1110,788,-30
110316938400,110316938402,2,2376,1081,-30
110323478488,110323478492,4,1511,1463,-30
110324570618,110324570623,5,1452,853,-30
110324745919,110324745925,6,2964,1254,-30
110325483773,110325483777,4,2732,1728,-30
110328868768,110328868774,6,2519,887,-30
110331789361,110331789366,5,1948,1159,-30
110332640754,110332640764,10,3861,1661,-30
110333519058,110333519059,1,1986,1969,-30
110334577084,110334577088,4,2251,1311,-30
110334884281,110334884285,4,965,1151,-30
110338889496,110338889500,4,2097,1340,-30
110343505686,110343505690,4,2231,1329,-30
110346030748,110346030753,5,2447,1578,-30
110347537531,110347537535,4,2725,1760,-30
110354969426,110354969430,4,2253,909,-30
110359831942,110359831947,5,1755,1199,-30
110359881001,110359881005,4,2633,1444,-30
110366510260,110366510262,2,33541,20021,-30
110367182723,110367182728,5,1874,1368,-30
110370006438,110370006442,4,2522,1173,-30
110370126372,110370126376,4,2254,1522,-30
110371902508,110371902511,3,1446,900,-30
110375270053,110375270060,7,1726,869,-30
110376612954,110376612960,6,2504,1537,-30
110379321509,110379321502,-7,955,3696,-30
110379816398,110379816395,-3,1909,3730,-30
110381651390,110381651393,3,2624,1362,-30
110388139886,110388139892,6,2567,1126,-30
110391970727,110391970734,7,7284,2747,-30
110403728151,110403728157,6,3142,1486,-30
110404505751,110404505757,6,2015,1183,-30
110405897166,110405897169,3,2731,2038,-30
110407504421,110407504420,-1,31,2028,-30
110408416111,110408416118,7,2226,1178,-30
110412196614,110412196619,5,2698,1407,-30
110412549321,110412549326,5,2430,1547,-30
110414315713,110414315717,4,1536,1150,-30
110415643490,110415643494,4,1897,1287,-30
110417098646,110417098651,5,2314,1058,-30
110418344444,110418344450,6,2413,1188,-30
110418673482,110418673465,-17,1492,1068,-30
110423074725,110423074731,6,2990,1215,-30
110424131573,110424131579,6,2155,1282,-30
110427278688,110427278693,5,2320,1709,-30
110428171671,110428171675,4,1914,1277,-30
110430398066,110430398067,1,1247,1120,-30
110431158594,110431158600,6,1163,903,-30
110432221330,110432221334,4,2324,1379,-30
110439071854,110439071859,5,2930,1182,-30
110440265845,110440265848,3,2430,1601,-30
110441861889,110441861894,5,2178,1544,-30
110442248978,110442248982,4,1375,979,-30
110442406466,110442406473,7,3108,1428,-30
110447359119,110447359124,5,2399,1449,-30
110447482652,110447482657,5,2283,1443,-30
110453754799,110453754803,4,2571,1293,-30
110458205266,110458205271,5,1916,1419,-30
110462038548,110462038554,6,2097,1826,-30
110463168398,110463168402,4,1501,1267,-30
110463297258,110463297265,7,2478,1158,-30
110466297582,110466297587,5,1647,1041,-30
110468050134,110468050140,6,2637,1372,-30
110469704865,110469704871,6,2650,1212,-30
110470421599,110470421577,-22,581,221,-30
110474402304,110474402310,6,2290,1511,-30
110476479549,110476479553,4,2017,1112,-30
110481962613,110481962618,5,3588,1496,-30
110483862874,110483862874,0,1330,1552,-30
110484060241,110484060245,4,2312,1353,-30
110486175849,110486175855,6,2192,1100,-30
110488151209,110488151211,2,1973,1484,-30
110488229707,110488229715,8,2332,948,-30
110498552082,110498552089,7,1902,1412,-30
110500826793,110500826798,5,1633,949,-30
110500965291,110500965295,4,1963,1398,-30
110504093846,110504093852,6,2530,1309,-30
110505942290,110505942295,5,2648,1036,-30
110506842070,110506842077,7,2450,1368,-30
110509604713,110509604719,6,1913,1034,-30
110509888823,110509888827,4,2455,1148,-30
110510416890,110510416895,5,1927,1161,-30
110510815375,110510815363,-12,825,355,-30
110511966653,110511966658,5,2072,1373,-30
110514814525,110514814533,8,2094,1071,-30
110516452134,110516452141,7,2789,1315,-30
110516816310,110516816316,6,1321,1004,-30
110516994773,110516994752,-21,2219,1295,-30
110518357854,110518357861,7,2777,1283,-30
110519677478,110519677482,4,2314,1188,-30
110519981878,110519981882,4,2452,1468,-30
110520629235,110520629241,6,4984,1629,-30
110520837908,110520837901,-7,1474,12335,-30
110521447357,110521447361,4,1908,1263,-30
110521668361,110521668364,3,1976,1154,-30
110523334007,110523334002,-5,662,391,-30
110527826125,110527826130,5,1834,1345,-30
110533298417,110533298420,3,2165,1384,-30
110533444186,110533444170,-16,1396,585,-30
110540802679,110540802684,5,3126,1286,-30
110540972597,110540972580,-17,1272,579,-30
110541341826,110541341830,4,3726,1134,-30
110542297247,110542297252,5,2043,1483,-30
110548741334,110548741338,4,2048,1586,-30
110550548041,110550548047,6,2077,1031,-30
110552846570,110552846569,-1,1540,1962,-30
110553068970,110553068971,1,2043,1550,-30
110554753849,110554753856,7,2476,1560,-30
110555088981,110555088987,6,2425,1341,-30
110556314940,110556314947,7,1836,942,-30
110558338398,110558338402,4,1474,1298,-30
110559482125,110559482131,6,2569,2296,-30
110559568120,110559568126,6,1623,1265,-30
110560915722,110560915736,14,1940,1096,-30
110562098635,110562098639,4,2693,1735,-30
110562658796,110562658798,2,1921,1485,-30
110567606794,110567606798,4,1929,1297,-30
110569769786,110569769789,3,1929,1038,-30
110571353245,110571353241,-4,881,2675,-30
110574852218,110574852226,8,1674,1080,-30
110579600971,110579600974,3,1817,798,-30
110579684959,110579684962,3,1535,1035,-30
110583286366,110583286373,7,3273,1412,-30
110583667746,110583667750,4,1509,1184,-30
110584259099,110584259082,-17,1976,933,-30
110586983474,110586983478,4,2579,1349,-30
110588555332,110588555328,-4,901,2620,-30
110590992324,110590992318,-6,1695,6139,-30
110591441740,110591441744,4,2395,1542,-30
110592169381,110592169386,5,1638,984,-30
110593673237,110593673242,5,1944,1184,-30
110598850485,110598850489,4,2367,811,-30
110599998788,110599998793,5,185,1252,-30
110602129234,110602129237,3,2192,1837,-30
110602975973,110602975980,7,2784,1228,-30
110605208050,110605208054,4,1764,1181,-30
110607088762,110607088766,4,2112,1161,-30
110609106617,110609106622,5,3052,1830,-30
110610333383,110610333390,7,1892,1424,-30
110613448411,110613448414,3,1039,1172,-30
110615966976,110615966981,5,3096,1986,-30
110619193846,110619193850,4,2787,1356,-30
110619884989,110619884994,5,1949,1268,-30
110620666602,110620666607,5,2444,1309,-30
110623756122,110623756128,6,3617,1934,-30
110626260553,110626260557,4,2777,1715,-30
110629460702,110629460703,1,1013,1492,-30
110632233689,110632233694,5,2418,1196,-30
110635017156,110635017154,-2,1124,1417,-30
110635990547,110635990551,4,2213,1455,-30
110640582960,110640582966,6,2632,1551,-30
110641911894,110641911898,4,1748,1146,-30
110643489293,110643489299,6,1635,1133,-30
110644410385,110644410390,5,2592,953,-30
110644610253,110644610235,-18,1641,1274,-30
110647324091,110647324095,4,2403,1456,-30
110647829565,110647829571,6,2324,1669,-30
110650623659,110650623663,4,1521,1183,-30
110651408794,110651408798,4,2655,1208,-30
110655416991,110655416998,7,2675,1288,-30
110657518025,110657518028,3,2280,1211,-30
110663962077,110663962083,6,2120,1463,-30
110664595136,110664595142,6,2118,1627,-30
110666855286,110666855293,7,2167,1311,-30
110673399426,110673399431,5,2600,1692,-30
110678862347,110678862353,6,5783,2630,-30
110679615538,110679615543,5,1599,1334,-30
110680859735,110680859738,3,894,794,-30
110681447495,110681447498,3,1836,933,-30
110682505099,110682505103,4,3009,1241,-30
110683602010,110683602015,5,2164,1425,-30
110683631071,110683631077,6,1869,1209,-30
110688493122,110688493126,4,1591,1118,-30
110689622605,110689622610,5,2232,1297,-30
110692855030,110692855031,1,1503,908,-30
110693892681,110693892688,7,2312,1469,-30
110694245151,110694245130,-21,793,119,-30
110702881059,110702881066,7,2431,1048,-30
110707789830,110707789829,-1,1245,1061,-30
110707852212,110707852218,6,2276,1347,-30
110707938960,110707938966,6,2576,1468,-30
110708521194,110708521180,-14,3532,1637,-30
110714444986,110714444991,5,1905,1003,-30
110715712014,110715712020,6,3261,1450,-30
110717126994,110717126999,5,2447,1265,-30
110719093482,110719093487,5,2466,1460,-30
110719779619,110719779623,4,2868,1190,-30
110721555377,110721555379,2,1667,1043,-30
110727717775,110727717782,7,1893,1144,-30
110731629619,110731629625,6,2110,1328,-30
110734152730,110734152734,4,1905,841,-30
110738369471,110738369475,4,2461,1397,-30
110740080765,110740080767,2,1369,1358,-30
110745117779,110745117785,6,2346,1151,-30
110746011706,110746011714,8,659,67,-30
110748406610,110748406617,7,3665,1381,-30
110749438135,110749438141,6,2670,1630,-30
110751406362,110751406368,6,2855,2026,-30
110752827589,110752827595,6,2841,1275,-30
110768512966,110768512971,5,2742,1467,-30
110769623776,110769623782,6,3029,1351,-30
110773622778,110773622783,5,2169,1673,-30
110778549010,110778549014,4,2459,1557,-30
110783409508,110783409514,6,1728,650,-30
110785294819,110785294820,1,1980,1459,-30
110786428338,110786428341,3,972,1798,-30
110788785537,110788785542,5,1820,1474,-30
110789601231,110789601236,5,1631,1029,-30
110792731666,110792731671,5,1938,1071,-30
110792948437,110792948457,20,2796,1507,-30
110794082405,110794082409,4,2357,1800,-30
110794410370,110794410375,5,2062,1523,-30
110795934201,110795934203,2,1657,1343,-30
110798757970,110798757975,5,2141,1794,-30
110799023413,110799023417,4,1166,934,-30
110800333077,110800333083,6,1379,808,-30
110801227152,110801227158,6,3305,1930,-30
110802082135,110802082133,-2,26725,51482,-30
110803278621,110803278626,5,1763,1090,-30
110804845922,110804845926,4,3363,1188,-30
110807098203,110807098206,3,2551,1642,-30
110807866782,110807866787,5,1643,799,-30
110812794190,110812794195,5,3407,2089,-30
110814304046,110814304041,-5,646,2119,-30
110816797530,110816797534,4,3040,1482,-30
110823610659,110823610664,5,1735,987,-30
110826249760,110826249761,1,1654,1605,-30
110830703110,110830703115,5,2007,1579,-30
110838537970,110838537971,1,2286,1273,-30
110842153920,110842153926,6,2553,1251,-30
110845181934,110845181941,7,2654,1435,-30
110845352438,110845352439,1,1437,1182,-30
110847149287,110847149291,4,2430,1594,-30
110847317631,110847317637,6,1918,1351,-30
110848066741,110848066746,5,2540,1422,-30
110850949103,110850949108,5,2355,1756,-30
110851328277,110851328283,6,1841,1088,-30
110855676197,110855676202,5,2770,1128,-30
110858958813,110858958818,5,1964,925,-30
110862345991,110862345997,6,1244,1005,-30
110864667341,110864667346,5,2068,1212,-30
110865354495,110865354498,3,2243,1296,-30
110865473051,110865473033,-18,2017,1427,-30
110868162845,110868162850,5,2816,1456,-30
110871124258,110871124263,5,1517,1005,-30
110873414450,110873414455,5,2113,1507,-30
110874154130,110874154134,4,1949,879,-30
110874916661,110874916680,19,947,94,-30
110883656787,110883656790,3,2097,1369,-30
110884334070,110884334074,4,2493,1645,-30
110887505800,110887505803,3,1570,1204,-30
110888671041,110888671028,-13,1403,970,-30
110893541775,110893541778,3,1953,1868,-30
110893723925,110893723930,5,2334,898,-30
110897425581,110897425586,5,1765,1297,-30
110898230015,110898230021,6,1865,1407,-30
110899637110,110899637103,-7,1953,7479,-30
110900500319,110900500323,4,2149,1074,-30
110901940022,110901940026,4,1712,1038,-30
110903516857,110903516860,3,1690,1095,-30
110906429070,110906429069,-1,1479,1454,-30
110914152289,110914152292,3,2117,1085,-30
110919976443,110919976447,4,1676,903,-30
110920949052,110920949055,3,1724,1184,-30
110923529897,110923529903,6,2677,1196,-30
110924590703,110924590708,5,2159,1977,-30
110924749979,110924749992,13,3152,1922,-30
110926114541,110926114544,3,4057,2578,-30
110926574426,110926574431,5,2340,1306,-30
110930630696,110930630699,3,1663,1478,-30
110930698366,110930698354,-12,732,477,-30
110931927031,110931927039,8,2348,1247,-30
110933970966,110933970966,0,6152,7669,-30
110934800418,110934800422,4,2257,1595,-30
110934894041,110934894046,5,1194,815,-30
110935027654,110935027659,5,2463,1022,-30
110937628498,110937628495,-3,1969,3131,-30
110940288501,110940288507,6,1814,1302,-30
110940637486,110940637483,-3,1286,1376,-30
110941829506,110941829513,7,2788,1253,-30
110943207598,110943207603,5,3211,1686,-30
110944714489,110944714493,4,2055,1169,-30
110946520378,110946520382,4,2927,1622,-30
110946726445,110946726451,6,2535,1215,-30
110947220315,110947220300,-15,1241,839,-30
110948261323,110948261329,6,1214,1035,-30
110955096462,110955096467,5,2315,1290,-30
110955518321,110955518327,6,2424,978,-30
110956583925,110956583929,4,1985,1607,-30
110965363467,110965363468,1,1899,2062,-30
110973218406,110973218411,5,1488,1063,-30
110975017995,110975017999,4,2013,1179,-30
110976603997,110976604002,5,1707,1152,-30
110979650679,110979650683,4,1609,1209,-30
110981373518,110981373521,3,3022,1420,-30
110982735361,110982735367,6,3526,1000,-30
110983191120,110983191127,7,1688,1197,-30
110984701394,110984701390,-4,2886,4749,-30
110985306552,110985306557,5,2925,1683,-30
110985946237,110985946242,5,1364,889,-30
110986634330,110986634334,4,1736,1220,-30
110986847941,110986847946,5,1576,819,-30
110990891382,110990891386,4,2697,2027,-30
110996536440,110996536443,3,1870,1379,-30
111000046077,111000046075,-2,1173,1605,-30
111001142629,111001142633,4,1810,1290,-30
111011364610,111011364615,5,3048,1950,-30
111017193914,111017193914,0,1268,1313,-30
111017846182,111017846200,18,2529,1376,-30
111018470338,111018470322,-16,1460,977,-30
111018948946,111018948950,4,2244,1015,-30
111019267321,111019267328,7,2706,1479,-30
111019320175,111019320155,-20,2257,1227,-30
111023369350,111023369354,4,2212,1508,-30
111024267506,111024267510,4,1804,1152,-30
111024517853,111024517856,3,1972,1021,-30
111031916747,111031916752,5,1567,1332,-30
111032401926,111032401915,-11,1018,241,-30
111036905238,111036905243,5,3201,1409,-30
111038215198,111038215202,4,2854,1754,-30
111040638050,111040638053,3,1712,2175,-30
111040827229,111040827235,6,2788,1514,-30
111041354946,111041354951,5,2468,1008,-30
111041476043,111041476025,-18,1552,731,-30
111042967614,111042967618,4,2480,1905,-30
111044020198,111044020200,2,903,639,-30
111045516073,111045516077,4,3195,1939,-30
111051295435,111051295439,4,2315,1514,-30
111053142078,111053142083,5,2813,1374,-30
111053268334,111053268339,5,2449,1320,-30
111055376213,111055376217,4,2554,1628,-30
111057220172,111057220179,7,2696,968,-30
111058651690,111058651695,5,1779,1438,-30
111062391995,111062392001,6,2757,1106,-30
111068146455,111068146442,-13,22459,16579,-30
111069460215,111069460219,4,2478,1401,-30
111071375210,111071375216,6,1787,1145,-30
111071426275,111071426279,4,1142,955,-30
111074328973,111074328977,4,1735,1039,-30
111077398757,111077398762,5,2543,1942,-30
111080421990,111080421995,5,1869,1501,-30
111082649231,111082649235,4,2409,1660,-30
111082847913,111082847919,6,3044,1236,-30
111083510109,111083510115,6,1850,1096,-30
111084741718,111084741723,5,1944,1442,-30
111085903840,111085903845,5,2089,1391,-30
111087210275,111087210274,-1,1068,1565,-30
111091263041,111091263047,6,1407,1063,-30
111096296315,111096296318,3,2813,1206,-30
111096564675,111096564679,4,2144,1404,-30
111100256291,111100256294,3,2855,2202,-30
111100521527,111100521532,5,3017,1165,-30
111101738920,111101738925,5,1997,1358,-30
111102461586,111102461590,4,1742,950,-30
111103525454,111103525463,9,2204,1375,-30
111104635077,111104635080,3,1384,755,-30
111107383473,111107383477,4,2284,1040,-30
111107919440,111107919444,4,1899,1233,-30
111110101002,111110101008,6,3357,1532,-30
111110549842,111110549847,5,2248,996,-30
111111392980,111111392983,3,1007,1221,-30
111116604917,111116604923,6,3039,1603,-30
111118032754,111118032761,7,1646,1132,-30
111119161669,111119161675,6,2194,1317,-30
111123687348,111123687348,0,1332,2046,-30
111125120890,111125120893,3,2535,1631,-30
111125297425,111125297408,-17,1751,1407,-30
111128625316,111128625321,5,1281,988,-30
111130766902,111130766907,5,2237,1091,-30
111131936625,111131936631,6,2906,1307,-30
111132373852,111132373856,4,2108,1784,-30
111132956112,111132956117,5,2412,1688,-30
111137552630,111137552636,6,2454,1006,-30
111142963403,111142963408,5,2158,1079,-30
111143011422,111143011436,14,3101,1559,-30
111146643026,111146643030,4,2555,1288,-30
111146963202,111146963209,7,3012,1814,-30
111148344613,111148344618,5,1410,915,-30
111148857795,111148857798,3,1674,726,-30
111149676966,111149676970,4,1428,1561,-30
111151389338,111151389343,5,1936,1672,-30
111154017181,111154017186,5,1870,1311,-30
111156760285,111156760288,3,2981,1610,-30
111158400550,111158400554,4,1674,1206,-30
111158774802,111158774810,8,4410,1062,-30
111160630672,111160630676,4,2782,1945,-30
111160754126,111160754105,-21,2863,1306,-30
111164579380,111164579388,8,3732,1589,-30
111165279946,111165279951,5,2440,1408,-30
111168863544,111168863550,6,1810,1118,-30
111169733246,111169733251,5,2871,1196,-30
111173863441,111173863446,5,3060,1182,-30
111174182275,111174182281,6,1970,1334,-30
111177151880,111177151886,6,2086,1347,-30
111179035981,111179035986,5,3225,1320,-30
111179797470,111179797473,3,3341,1730,-30
111183552519,111183552524,5,2457,1439,-30
111184829483,111184829488,5,2359,1281,-30
111184989152,111184989160,8,2161,1528,-30
111189904043,111189904047,4,2291,1554,-30
111190195255,111190195234,-21,1552,922,-30
111193197114,111193197118,4,2184,1842,-30
111196939979,111196939986,7,1965,1018,-30
111200643225,111200643230,5,1074,611,-30
111201979305,111201979311,6,4438,2731,-30
111203391019,111203391023,4,2755,1222,-30
111205498830,111205498835,5,988,613,-30
111206407677,111206407682,5,1556,807,-30
111215078506,111215078511,5,3262,1636,-30
111215226967,111215226971,4,1668,886,-30
111218264221,111218264226,5,3182,1639,-30
111220381354,111220381360,6,3125,1393,-30
111220528145,111220528149,4,2157,1153,-30
111227258121,111227258125,4,2362,1348,-30
111229352539,111229352546,7,2773,1570,-30
111236891250,111236891254,4,1896,1251,-30
111237718508,111237718513,5,2433,2098,-30
111239042139,111239042143,4,1214,805,-30
111241402750,111241402764,14,2121,1271,-30
111246902100,111246902091,-9,17788,27275,-30
111247637161,111247637166,5,1981,1339,-30
111247683767,111247683772,5,2631,2117,-30
111248306878,111248306874,-4,1286,869,-30
111248721643,111248721649,6,2339,1733,-30
111249552234,111249552233,-1,1794,2734,-30
111252650037,111252650042,5,2079,1489,-30
111253114654,111253114661,7,2578,1409,-30
111255645886,111255645890,4,2395,1342,-30
111256512306,111256512311,5,1254,1019,-30
111258342733,111258342738,5,1694,1210,-30
111261369181,111261369186,5,1881,875,-30
111266304674,111266304680,6,2586,1279,-30
111274240126,111274240132,6,1742,1478,-30
111278382827,111278382835,8,1656,902,-30
111279245911,111279245915,4,1938,1117,-30
111283224215,111283224221,6,2583,1582,-30
111283984969,111283984975,6,2860,1332,-30
111284645413,111284645418,5,2435,1452,-30
111286570977,111286570982,5,1872,1125,-30
111287105515,111287105519,4,1370,1037,-30
111289270907,111289270911,4,1881,605,-30
111291139855,111291139859,4,2526,1507,-30
111295195627,111295195634,7,2871,1324,-30
111295858511,111295858515,4,2082,1084,-30
111298997562,111298997571,9,1829,913,-30
111306207299,111306207282,-17,40,1640,-30
111306451423,111306451427,4,2243,1259,-30
111306928159,111306928138,-21,618,304,-30
111311866765,111311866771,6,2511,905,-30
111312388660,111312388663,3,2136,1355,-30
111316864873,111316864879,6,2169,1315,-30
111318676841,111318676846,5,2116,883,-30
111322603266,111322603271,5,966,835,-30
111328184917,111328184923,6,2677,761,-30
111331212078,111331212090,12,2317,1450,-30
111331405047,111331405045,-2,887,1580,-30
111333372652,111333372657,5,2737,1713,-30
111335639894,111335639899,5,2706,1712,-30
111336323339,111336323345,6,1978,1327,-30
111337578292,111337578297,5,1927,1152,-30
111338262480,111338262465,-15,2278,938,-30
111346284100,111346284105,5,2213,1157,-30
111346426899,111346426906,7,2196,1345,-30
111347105837,111347105841,4,3257,1496,-30
111348193134,111348193116,-18,1744,1084,-30
111350275534,111350275529,-5,1380,4996,-30
111353337950,111353337955,5,2237,1143,-30
111357332582,111357332589,7,2033,1338,-30
111358203466,111358203471,5,1954,1223,-30
111362602109,111362602104,-5,1304,3735,-30
111362918145,111362918149,4,2053,1160,-30
111362968367,111362968371,4,1755,1089,-30
111363891114,111363891119,5,1974,1599,-30
111365725871,111365725864,-7,1719,8790,-30
111366453963,111366453970,7,2733,1261,-30
111367050724,111367050721,-3,1499,2718,-30
111374676546,111374676548,2,1286,708,-30
111376266284,111376266289,5,2009,1174,-30
111377896427,111377896441,14,1788,1089,-30
111378031939,111378031942,3,1620,673,-30
111378379916,111378379922,6,2536,1377,-30
111380053965,111380053972,7,1939,836,-30
111381652231,111381652235,4,1806,891,-30
111382411607,111382411611,4,1910,1277,-30
111383380686,111383380689,3,1229,1204,-30
111383797421,111383797427,6,2360,927,-30
111386868421,111386868427,6,3020,1249,-30
111387259783,111387259795,12,914,213,-30
111387852982,111387852987,5,2569,1098,-30
111391806345,111391806354,9,2396,856,-30
111393109800,111393109806,6,2849,1984,-30
111394349006,111394349011,5,2080,977,-30
111394470373,111394470377,4,2457,1407,-30
111395259270,111395259280,10,1226,245,-30
111395657548,111395657562,14,2277,1424,-30
111396106101,111396106098,-3,462,358,-30
111396252810,111396252814,4,1599,1217,-30
111398968113,111398968118,5,1954,1425,-30
111403951590,111403951597,7,2193,977,-30
111404293920,111404293926,6,2227,1175,-30
111404566089,111404566092,3,41946,27248,-30
111405149016,111405149017,1,1439,1633,-30
111406329054,111406329059,5,1679,1438,-30
111407308315,111407308318,3,1350,1219,-30
111407466558,111407466565,7,1957,968,-30
111409516310,111409516329,19,2283,636,-30
111410035001,111410035007,6,1847,1718,-30
111410714337,111410714343,6,2581,1496,-30
111413205960,111413205966,6,1629,1437,-30
111415306263,111415306269,6,2687,1414,-30
111418788594,111418788577,-17,1345,641,-30
111427571525,111427571531,6,1825,1080,-30
111428665190,111428665195,5,1771,848,-30
111429755445,111429755451,6,2335,1318,-30
111431108110,111431108115,5,2105,945,-30
111436526020,111436526025,5,2325,1388,-30
111444161889,111444161893,4,1680,1130,-30
111445044153,111445044158,5,2019,1095,-30
111445707526,111445707533,7,5159,2333,-30
111446761769,111446761774,5,6611,2523,-30
111446865355,111446865359,4,1682,1192,-30
111447518561,111447518565,4,3191,1619,-30
111449216784,111449216789,5,2812,2013,-30
111450001278,111450001283,5,2921,1182,-30
111468649541,111468649545,4,2013,1345,-30
111471533745,111471533750,5,1888,1084,-30
111476812052,111476812057,5,2030,1124,-30
111480792806,111480792811,5,2219,1577,-30
111482858209,111482858214,5,3258,1880,-30
111490930534,111490930539,5,2619,1571,-30
111491783909,111491783915,6,1479,741,-30
111491817406,111491817396,-10,954,334,-30
111492623634,111492623629,-5,1233,2892,-30
111494376190,111494376194,4,2654,1299,-30
111495322830,111495322834,4,2487,1404,-30
111496439884,111496439886,2,1608,914,-30
111498316280,111498316282,2,3816,3151,-30
111499741825,111499741830,5,2282,1172,-30
111500902071,111500902075,4,1741,1729,-30
111502670683,111502670690,7,2651,1670,-30
111502744748,111502744752,4,1671,1505,-30
111508581782,111508581765,-17,1642,820,-30
111509700471,111509700478,7,3570,2299,-30
111511088520,111511088526,6,1983,1227,-30
111515185045,111515185050,5,2751,1852,-30
111515766771,111515766779,8,2005,965,-30
111515928273,111515928279,6,2955,1114,-30
111517652536,111517652542,6,2522,1337,-30
111518781153,111518781140,-13,1561,597,-30
111518858649,111518858653,4,1019,851,-30
111519670670,111519670675,5,1877,1418,-30
111522369437,111522369442,5,2122,1505,-30
111522735919,111522735897,-22,2647,2124,-30
111523836726,111523836733,7,3335,940,-30
111523945168,111523945187,19,2063,1405,-30
111528562720,111528562723,3,1515,1341,-30
111528828786,111528828792,6,2038,1564,-30
111529384333,111529384337,4,2601,1454,-30
111529534331,111529534338,7,1366,1164,-30
111529998170,111529998177,7,1656,930,-30
111530134606,111530134618,12,1158,171,-30
111538386454,111538386453,-1,557,237,-30
111538608605,111538608603,-2,1021,1490,-30
111540506466,111540506471,5,2837,2259,-30
111540801998,111540802002,4,2613,1670,-30
111548659595,111548659601,6,1605,1074,-30
111551850118,111551850125,7,2914,1205,-30
111553677906,111553677911,5,2253,1491,-30
111557480963,111557480967,4,1716,1215,-30
111558189117,111558189121,4,1769,1215,-30
111562409131,111562409137,6,2795,1755,-30
111564238079,111564238083,4,2519,1003,-30
111565042638,111565042637,-1,3122,3592,-30
111566068401,111566068394,-7,1291,4743,-30
111566267521,111566267527,6,1593,1033,-30
111567175175,111567175179,4,1059,433,-30
111571289258,111571289263,5,3027,1430,-30
111571363014,111571363018,4,2373,1650,-30
111574608897,111574608902,5,2597,997,-30
111575450154,111575450159,5,1209,1023,-30
111578182834,111578182839,5,1832,1065,-30
111579082645,111579082650,5,1408,1421,-30
111579757427,111579757422,-5,829,2280,-30
111581146219,111581146222,3,1453,1237,-30
111583380263,111583380269,6,2583,1529,-30
111583600033,111583600029,-4,2489,5192,-30
111585661691,111585661697,6,2882,1289,-30
111585794006,111585794010,4,1854,1048,-30
111587945398,111587945399,1,1990,1105,-30
111588591162,111588591168,6,4096,1155,-30
111588914453,111588914457,4,3879,1630,-30
111588947725,111588947727,2,2243,1427,-30
111590885362,111590885355,-7,1361,8610,-30
111591769625,111591769631,6,1258,856,-30
111592316530,111592316514,-16,2487,1048,-30
111592489726,111592489733,7,2515,1649,-30
111596469066,111596469066,0,1035,2431,-30
111602337222,111602337229,7,2159,1349,-30
111604970828,111604970832,4,2646,1091,-30
111609306853,111609306854,1,1500,1664,-30
111612924217,111612924218,1,3411,2323,-30
111613262542,111613262546,4,2291,1124,-30
111613435989,111613435992,3,2957,1981,-30
111615444425,111615444430,5,2617,1793,-30
111616439305,111616439310,5,2448,1257,-30
111619123117,111619123123,6,2317,678,-30
111620514701,111620514704,3,2392,1021,-30
111621538488,111621538474,-14,1863,1093,-30
111623632458,111623632464,6,2068,1222,-30
111639437161,111639437167,6,2369,1296,-30
111642375825,111642375829,4,2076,1333,-30
111642401854,111642401861,7,2861,1054,-30
111642571088,111642571094,6,2767,1558,-30
111645422439,111645422443,4,3417,1519,-30
111649523650,111649523657,7,2530,1383,-30
111650069674,111650069682,8,1580,1555,-30
111656459614,111656459619,5,1737,1743,-30
111657310538,111657310543,5,1720,1384,-30
111662753727,111662753734,7,1848,1168,-30
111663312490,111663312495,5,2239,1613,-30
111664365073,111664365077,4,1762,1366,-30
111665153034,111665153039,5,1632,1129,-30
111667908310,111667908314,4,2714,1456,-30
111670163721,111670163726,5,3370,970,-30
111672869566,111672869568,2,17662,15939,-30
111673938882,111673938886,4,1027,790,-30
111674951671,111674951676,5,2365,923,-30
111677583388,111677583391,3,1467,1141,-30
111678018821,111678018825,4,1562,1390,-30
111682711162,111682711167,5,2319,1798,-30
111683516154,111683516159,5,2378,1015,-30
111684849002,111684849009,7,2099,1069,-30
111686090701,111686090705,4,2245,1832,-30
111687590700,111687590705,5,1830,1285,-30
111689358360,111689358378,18,1893,1420,-30
111690640261,111690640267,6,2235,1209,-30
111691484502,111691484497,-5,1738,4988,-30
111691565258,111691565264,6,2496,1499,-30
111692993510,111692993515,5,1903,1621,-30
111695521616,111695521622,6,1920,1312,-30
111695679877,111695679900,23,416,115,-30
111698051334,111698051339,5,1951,978,-30
111704808997,111704809002,5,1751,947,-30
111704879884,111704879886,2,25290,18006,-30
111707637113,111707637111,-2,1844,1772,-30
111707672512,111707672506,-6,3753,24302,-30
111708846574,111708846594,20,347,1071,-30
111710569053,111710569057,4,1968,1922,-30
111710642750,111710642762,12,1459,937,-30
111711629794,111711629787,-7,1218,4507,-30
111711867036,111711867042,6,2924,1232,-30
111712869670,111712869675,5,2210,2134,-30
111717220616,111717220622,6,3025,1274,-30
111725104685,111725104690,5,2648,1372,-30
111729337489,111729337493,4,2374,1379,-30
111729647344,111729647354,10,3019,1553,-30
111733061844,111733061849,5,1960,1344,-30
111734548956,111734548961,5,1566,1183,-30
111735622842,111735622845,3,2414,1922,-30
111736129257,111736129261,4,2338,1454,-30
111744040569,111744040573,4,2192,1059,-30
111745866438,111745866445,7,2124,1100,-30
111747374545,111747374548,3,1936,1835,-30
111748327006,111748327011,5,2453,1383,-30
111748907141,111748907145,4,1721,1675,-30
111750561357,111750561363,6,1292,1046,-30
111765526665,111765526669,4,1977,978,-30
111767722966,111767722970,4,820,509,-30
111768579534,111768579539,5,2893,1460,-30
111769936554,111769936557,3,1592,1401,-30
111770933724,111770933718,-6,1173,2209,-30
111773350927,111773350932,5,2373,1225,-30
111773573162,111773573147,-15,792,445,-30
111774628865,111774628846,-19,2453,1374,-30
111775163426,111775163428,2,1694,1270,-30
111775863214,111775863193,-21,1081,477,-30
111776954467,111776954473,6,2249,1370,-30
111778519848,111778519852,4,1208,734,-30
111779247546,111779247552,6,3100,2290,-30
111779778904,111779778890,-14,625,309,-30
111780652862,111780652867,5,2399,1322,-30
111783562735,111783562738,3,2270,1213,-30
111785938236,111785938242,6,2362,1591,-30
111787931840,111787931841,1,1470,2155,-30
111788113305,111788113310,5,2573,1393,-30
111788505782,111788505801,19,18047,51704,-30
111789460585,111789460590,5,2794,1725,-30
111790248197,111790248202,5,2511,2017,-30
111790986386,111790986388,2,2123,1475,-30
111794181965,111794181968,3,2201,1397,-30
111799133072,111799133078,6,2022,1219,-30
111801757606,111801757610,4,2431,910,-30
111802538220,111802538225,5,2304,1388,-30
111807536381,111807536383,2,1452,1969,-30
111810167609,111810167614,5,2865,1727,-30
111811740310,111811740315,5,2119,1319,-30
111817276904,111817276905,1,966,1387,-30
111820774203,111820774209,6,2425,1592,-30
111823965151,111823965157,6,2641,1541,-30
111825318894,111825318887,-7,1427,1330,-30
111825859353,111825859358,5,2296,1011,-30
111828287627,111828287635,8,2098,1562,-30
111828764785,111828764788,3,2192,1187,-30
111831103613,111831103613,0,2518,3392,-30
111836708265,111836708269,4,2483,2008,-30
111841071546,111841071552,6,2702,1519,-30
111842552086,111842552090,4,3013,1547,-30
111849068153,111849068155,2,1986,1036,-30
111849171378,111849171382,4,2517,1327,-30
111851077437,111851077441,4,2396,1141,-30
111860961733,111860961737,4,2060,1068,-30
111864452513,111864452510,-3,184,882,-30
111866831733,111866831739,6,3510,1243,-30
111873006009,111873006012,3,2055,1625,-30
111874766361,111874766366,5,2186,1400,-30
111874963541,111874963522,-19,2887,871,-30
111875175523,111875175522,-1,1887,2495,-30
111876914182,111876914187,5,1749,1024,-30
111878846427,111878846431,4,2743,1895,-30
111879073556,111879073562,6,3074,1509,-30
111881559676,111881559682,6,2298,1109,-30
111882670806,111882670800,-6,49633,26282,-30
111887727989,111887727995,6,1895,834,-30
111888487197,111888487194,-3,19467,8233,-30
111889297485,111889297489,4,2610,1645,-30
111890454272,111890454268,-4,26887,11036,-30
111890773369,111890773372,3,2771,1106,-30
111894690596,111894690602,6,2983,1333,-30
111895382085,111895382091,6,1567,710,-30
111899799589,111899799592,3,2353,1891,-30
111900034350,111900034358,8,1282,816,-30
111903849090,111903849097,7,2528,802,-30
111905728242,111905728246,4,2304,1138,-30
111907885876,111907885880,4,1930,1088,-30
111908746928,111908746930,2,1598,1435,-30
111909084217,111909084214,-3,858,2547,-30
111910753913,111910753919,6,2301,1512,-30
111911892886,111911892907,21,16630,52902,-30
111913761381,111913761385,4,2923,1656,-30
111914265371,111914265374,3,1548,993,-30
111919750014,111919750019,5,1919,1402,-30
111922296471,111922296474,3,1814,1081,-30
111922649262,111922649269,7,2265,1120,-30
111923374205,111923374211,6,5445,1587,-30
111923607842,111923607840,-2,1377,2418,-30
111924128194,111924128202,8,2211,1284,-30
111924779933,111924779936,3,1672,1130,-30
111925027999,111925028001,2,1000,1074,-30
111926361690,111926361697,7,2429,1415,-30
111927855178,111927855185,7,3080,1417,-30
111930052125,111930052127,2,1468,1223,-30
111930452374,111930452375,1,1461,1486,-30
111932413543,111932413547,4,1840,1218,-30
111933109195,111933109201,6,4899,2494,-30
111933270786,111933270791,5,2080,1140,-30
111933597634,111933597638,4,2327,1292,-30
111934128124,111934128107,-17,2565,1553,-30
111935683841,111935683846,5,1799,854,-30
111936984799,111936984801,2,1452,1921,-30
111940389979,111940389981,2,1960,1500,-30
111940706963,111940706945,-18,704,198,-30
111942580461,111942580466,5,2253,1214,-30
111944614240,111944614246,6,2265,1125,-30
111949390579,111949390586,7,190,1170,-30
111950349964,111950349968,4,2285,1217,-30
111953998636,111953998641,5,1712,1108,-30
111956196414,111956196418,4,1990,1391,-30
111961494386,111961494390,4,1843,1069,-30
111964029379,111964029389,10,15235,31730,-30
111964596832,111964596837,5,2364,1812,-30
111965241917,111965241922,5,2696,1031,-30
111966383848,111966383853,5,1782,1562,-30
111970541228,111970541233,5,3156,1167,-30
111970728437,111970728442,5,1846,1085,-30
111971090588,111971090591,3,1194,1038,-30
111972796549,111972796554,5,2061,1056,-30
111980453602,111980453606,4,2397,1836,-30
111981832915,111981832919,4,2316,1260,-30
111987570592,111987570597,5,1861,1287,-30
111987764012,111987764018,6,1993,1399,-30
111988566622,111988566629,7,2593,1554,-30
111990844774,111990844780,6,2267,1070,-30
111993720918,111993720923,5,2694,971,-30
111996068034,111996068040,6,2682,1437,-30
112002071390,112002071395,5,2316,1394,-30
112003266701,112003266706,5,1407,908,-30
112007503059,112007503064,5,3429,1846,-30
112007802234,112007802238,4,2764,1283,-30
112010913545,112010913550,5,2373,1595,-30
112015272973,112015272979,6,2629,1733,-30
112015366762,112015366766,4,2237,1230,-30
112016693667,112016693650,-17,2348,1526,-30
112016737422,112016737427,5,3178,1974,-30
112025404098,112025404101,3,1918,1369,-30
112030298754,112030298758,4,2174,980,-30
112030512983,112030512986,3,2538,1123,-30
112031215180,112031215176,-4,1466,2658,-30
112031721417,112031721400,-17,1180,573,-30
112039729619,112039729623,4,2027,1656,-30
112040385429,112040385435,6,3970,2218,-30
112042455130,112042455112,-18,2179,1380,-30
112043671791,112043671795,4,1782,1373,-30
112044657087,112044657093,6,3200,887,-30
112045244238,112045244249,11,1136,528,-30
112045996388,112045996394,6,3417,1444,-30
112047317602,112047317607,5,1669,828,-30
112049341698,112049341702,4,1102,708,-30
112049491825,112049491827,2,1934,2120,-30
112050234949,112050234953,4,2034,1281,-30
112052277054,112052277058,4,3155,1805,-30
112057277074,112057277070,-4,1222,2194,-30
112057613235,112057613241,6,2054,1379,-30
112057702031,112057702017,-14,1360,1205,-30
112058009005,112058009010,5,2593,1404,-30
112058831026,112058831032,6,1893,1367,-30
112061041892,112061041895,3,1702,1002,-30
112063158218,112063158218,0,1289,1290,-30
112064650691,112064650697,6,1962,1444,-30
112066340910,112066340910,0,834,1064,-30
112068798651,112068798652,1,861,955,-30
112072754074,112072754080,6,2957,1702,-30
112073137230,112073137241,11,1996,942,-30
112075935666,112075935670,4,1407,1315,-30
112076415510,112076415515,5,1939,1403,-30
112078952688,112078952693,5,2537,1449,-30
112080321050,112080321055,5,2064,1076,-30
112080695638,112080695644,6,2852,1785,-30
112080756205,112080756210,5,2392,1725,-30
112082929946,112082929950,4,2286,1103,-30
112084095995,112084095993,-2,1406,2529,-30
112084996690,112084996696,6,2347,1226,-30
112085055907,112085055913,6,3316,1263,-30
112085819166,112085819171,5,2193,1639,-30
112086039699,112086039705,6,946,686,-30
112086328471,112086328452,-19,1025,521,-30
112088167304,112088167310,6,1639,1145,-30
112090542257,112090542263,6,2073,817,-30
112090845954,112090845961,7,2640,1266,-30
112095527815,112095527818,3,1089,660,-30
112097179075,112097179079,4,2354,1247,-30
112098453830,112098453836,6,1478,953,-30
112098944867,112098944872,5,1766,1302,-30
112099057136,112099057141,5,1548,1318,-30
112102775771,112102775768,-3,26219,11713,-30
112106308713,112106308719,6,3027,1555,-30
112107659315,112107659322,7,2839,1194,-30
112107886353,112107886358,5,1934,1186,-30
112108896235,112108896248,13,1671,1067,-30
112109298403,112109298409,6,3642,1732,-30
112110201319,112110201322,3,2083,1087,-30
112111315290,112111315294,4,987,726,-30
112113122366,112113122371,5,2244,1190,-30
112113649911,112113649915,4,2005,1550,-30
112116073149,112116073155,6,2543,1358,-30
112116519600,112116519602,2,2969,3943,-30
112116545059,112116545062,3,2136,1775,-30
112116750022,112116750023,1,701,1017,-30
112119770521,112119770521,0,1509,1920,-30
112120759587,112120759591,4,1339,1071,-30
112122341274,112122341279,5,1066,921,-30
112125064117,112125064119,2,2318,1848,-30
112127576450,112127576454,4,1713,1043,-30
112131069893,112131069898,5,2576,1850,-30
112131984773,112131984779,6,3619,1599,-30
112135990410,112135990416,6,2120,1493,-30
112137644924,112137644926,2,2067,1150,-30
112138332586,112138332593,7,2695,2005,-30
112138950505,112138950502,-3,969,2460,-30
112139379268,112139379275,7,2476,1671,-30
112140151432,112140151437,5,2255,1810,-30
112141909543,112141909537,-6,2190,12013,-30
112145885118,112145885122,4,1797,1297,-30
112151600394,112151600392,-2,1404,1663,-30
112152224219,112152224226,7,2579,1508,-30
112155972866,112155972845,-21,4744,1180,-30
112158682470,112158682477,7,1803,968,-30
112161396494,112161396499,5,2545,1564,-30
112164265849,112164265853,4,2840,1735,-30
112164780295,112164780299,4,2291,1052,-30
112165061838,112165061843,5,2277,907,-30
112166191223,112166191222,-1,1860,2192,-30
112167879541,112167879547,6,2114,1121,-30
112173453286,112173453291,5,4304,2042,-30
112174075065,112174075073,8,10501,39703,-30
112180292922,112180292928,6,2672,969,-30
112180853489,112180853499,10,11569,21023,-30
112181427829,112181427834,5,1414,1044,-30
112182437249,112182437254,5,2687,1239,-30
112182853913,112182853918,5,3620,2011,-30
112186315682,112186315687,5,1492,1279,-30
112186600530,112186600535,5,1759,1098,-30
112187160102,112187160105,3,2927,1761,-30
112188795668,112188795672,4,1888,1266,-30
112190412575,112190412581,6,1959,1178,-30
112191201218,112191201221,3,2376,1476,-30
112195797287,112195797286,-1,6856,9656,-30
112195892365,112195892345,-20,1427,643,-30
112195992410,112195992413,3,1977,1648,-30
112201249007,112201249013,6,3084,1443,-30
112203236822,112203236815,-7,1541,4308,-30
112203685249,112203685246,-3,1745,2158,-30
112204501036,112204501042,6,3411,1408,-30
112206247242,112206247248,6,1221,816,-30
112207385763,112207385765,2,784,1419,-30
112208325733,112208325737,4,2026,1372,-30
112210748447,112210748443,-4,1408,3251,-30
112210871231,112210871236,5,2787,1041,-30
112213142792,112213142795,3,2064,951,-30
112219316081,112219316087,6,2607,906,-30
112222641245,112222641250,5,2314,1145,-30
112223077752,112223077757,5,2480,1364,-30
112223593282,112223593288,6,1256,1050,-30
112226859196,112226859202,6,2846,1334,-30
112229451189,112229451192,3,2040,1410,-30
112229498510,112229498514,4,2650,1133,-30
112230176609,112230176617,8,1966,1108,-30
112230301341,112230301345,4,1443,1499,-30
112230682028,112230682033,5,2956,1269,-30
112230925417,112230925421,4,2445,1625,-30
112232378905,112232378910,5,1656,1215,-30
112233756483,112233756488,5,2293,1560,-30
112235895702,112235895709,7,2033,1469,-30
112237857502,112237857510,8,1466,964,-30
112238033100,112238033112,12,2487,1189,-30
112238064494,112238064499,5,2770,1635,-30
112240878263,112240878268,5,3149,2560,-30
112244103651,112244103657,6,1593,727,-30
112244605851,112244605857,6,2551,1431,-30
112248336634,112248336635,1,1285,946,-30
112250009613,112250009619,6,2529,1756,-30
112251370578,112251370583,5,2449,1367,-30
112257316817,112257316821,4,2706,1684,-30
112258014921,112258014926,5,1781,1063,-30
112258624933,112258624931,-2,544,220,-30
112266932989,112266932993,4,2741,1395,-30
112268794103,112268794107,4,2711,1940,-30
112269404407,112269404407,0,913,1151,-30
112271745903,112271745909,6,1217,1132,-30
112272554418,112272554422,4,2148,1508,-30
112278268878,112278268883,5,708,520,-30
112279584957,112279584964,7,2327,1279,-30
112282640994,112282640999,5,3723,2081,-30
112285400353,112285400355,2,1870,1412,-30
112291197009,112291197014,5,2450,1326,-30
112291939373,112291939352,-21,1094,743,-30
112294591218,112294591222,4,2144,1206,-30
112295042039,112295042043,4,2168,1965,-30
112297572933,112297572938,5,2048,1438,-30
112298968822,112298968821,-1,1378,2016,-30
112299082034,112299082039,5,2236,1704,-30
112300660030,112300660034,4,2938,1207,-30
112300998916,112300998921,5,2210,1254,-30
112303779463,112303779467,4,2316,1259,-30
112305514314,112305514319,5,2600,1284,-30
112308805244,112308805250,6,1710,827,-30
112309956642,112309956649,7,2264,1609,-30
112310937139,112310937138,-1,958,1077,-30
112316592803,112316592807,4,1178,1175,-30
112318416573,112318416578,5,2676,1496,-30
112318883342,112318883355,13,1074,833,-30
112321410707,112321410715,8,1893,852,-30
112321446851,112321446855,4,1515,804,-30
112324129804,112324129808,4,2209,1014,-30
112327179048,112327179054,6,2733,1663,-30
112330915102,112330915109,7,2546,1457,-30
112331509723,112331509730,7,2263,1342,-30
112332550265,112332550252,-13,1083,368,-30
112337510222,112337510227,5,2276,1224,-30
112339167726,112339167730,4,2792,1896,-30
112342370993,112342370998,5,2563,1026,-30
112343516136,112343516140,4,2616,1735,-30
112347117599,112347117609,10,12214,34401,-30
112348224602,112348224599,-3,853,1844,-30
112351878786,112351878791,5,1824,1101,-30
112356630898,112356630903,5,2345,1419,-30
112356781425,112356781431,6,2534,1349,-30
112357358654,112357358658,4,1890,975,-30
112357491157,112357491162,5,2116,1452,-30
112358116753,112358116758,5,2425,1204,-30
112359145598,112359145603,5,2281,1497,-30
112363063439,112363063443,4,1961,1292,-30
112366026768,112366026761,-7,1514,1376,-30
112369465963,112369465970,7,3728,1126,-30
112369574098,112369574102,4,1966,835,-30
112371651269,112371651274,5,1350,1102,-30
112377693574,112377693569,-5,1140,5602,-30
112383849753,112383849755,2,1641,1352,-30
112388366041,112388366046,5,1776,1097,-30
112388790722,112388790726,4,1946,841,-30
112390495878,112390495885,7,2330,836,-30
112394046800,112394046805,5,2698,1637,-30
112397843371,112397843374,3,2043,1917,-30
112399744350,112399744354,4,2322,1499,-30
112404712939,112404712945,6,2160,1063,-30
112410078330,112410078334,4,2975,1213,-30
112415996340,112415996346,6,3240,1563,-30
112417223181,112417223186,5,2369,1352,-30
112417488898,112417488902,4,2020,1120,-30
112420642843,112420642847,4,2251,1854,-30
112423670894,112423670899,5,1964,1220,-30
112426501422,112426501427,5,2760,1420,-30
112430830821,112430830825,4,2443,1477,-30
112431929770,112431929776,6,1889,1104,-30
112432792610,112432792615,5,1976,1693,-30
112437242948,112437242953,5,2057,1003,-30
112443688661,112443688657,-4,1310,3298,-30
112445320390,112445320394,4,3003,1235,-30
112446323605,112446323610,5,2043,1082,-30
112446649687,112446649690,3,3300,2025,-30
112447569221,112447569226,5,2444,1166,-30
112451171293,112451171295,2,2199,1323,-30
112452034797,112452034798,1,1363,1846,-30
112453802598,112453802601,3,2516,1703,-30
112455694318,112455694322,4,2664,1728,-30
112465253235,112465253240,5,2963,1384,-30
112465675314,112465675319,5,841,491,-30
112468122882,112468122888,6,2031,988,-30
112470311459,112470311466,7,2178,1365,-30
112472278358,112472278362,4,1846,1531,-30
112472386585,112472386589,4,2611,1335,-30
112475724025,112475724030,5,2821,1766,-30
112476444308,112476444313,5,1435,1113,-30
112480687193,112480687197,4,2081,1393,-30
112481502514,112481502518,4,2114,1357,-30
112483578605,112483578609,4,2422,1188,-30
112484935556,112484935563,7,2310,1098,-30
112485766575,112485766581,6,2446,906,-30
112487005598,112487005602,4,2110,957,-30
112487440229,112487440233,4,1433,1295,-30
112491184142,112491184149,7,4327,2432,-30
112493621070,112493621075,5,2984,1889,-30
112493998050,112493998054,4,1608,942,-30
112500039290,112500039294,4,2008,1343,-30
112502929325,112502929331,6,3531,1512,-30
112505382289,112505382294,5,2337,1567,-30
112511932629,112511932633,4,1658,1124,-30
112515541845,112515541830,-15,18413,43830,-30
112519145715,112519145721,6,2806,1573,-30
112521501397,112521501403,6,2555,1491,-30
112522837630,112522837634,4,2248,1166,-30
112523909759,112523909739,-20,2904,1077,-30
112526633105,112526633109,4,2907,1580,-30
112527264445,112527264426,-19,3797,847,-30
112528407519,112528407523,4,2419,1732,-30
112529923009,112529923014,5,2428,1667,-30
112531655648,112531655651,3,2674,1392,-30
112532474984,112532474990,6,2519,1264,-30
112533364944,112533364949,5,2051,1102,-30
112534421553,112534421557,4,2172,1157,-30
112540302409,112540302414,5,1602,1168,-30
112541435077,112541435083,6,2546,1597,-30
112542717022,112542717022,0,1620,1986,-30
112551791898,112551791904,6,2544,1282,-30
112553360574,112553360574,0,10344,15886,-30
112555979473,112555979480,7,6077,38504,-30
112560694246,112560694250,4,2328,1273,-30
112562676467,112562676474,7,2765,1185,-30
112562739789,112562739811,22,292,212,-30
112570562553,112570562558,5,2689,1199,-30
112572393611,112572393616,5,1588,942,-30
112575805450,112575805457,7,30606,58240,-30
112575970910,112575970914,4,1930,1024,-30
112577768042,112577768046,4,1928,1529,-30
112582864656,112582864660,4,2499,1833,-30
112583180686,112583180667,-19,389,388,-30
112587162274,112587162278,4,2115,888,-30
112587325229,112587325233,4,1716,1230,-30
112588387594,112588387602,8,2401,1125,-30
112589224644,112589224650,6,4883,2605,-30
112592195066,112592195071,5,1933,1201,-30
112594401466,112594401470,4,1910,943,-30
112598883146,112598883150,4,2730,1775,-30
112601109044,112601109046,2,1347,1183,-30
112601649064,112601649070,6,4851,2608,-30
112603811606,112603811611,5,2140,1344,-30
112605840941,112605840946,5,2467,1592,-30
112609636925,112609636927,2,1927,945,-30
112609711594,112609711598,4,2406,1455,-30
112610314855,112610314832,-23,498,140,-30
112612089979,112612089983,4,1579,1439,-30
112617630575,112617630579,4,2761,1365,-30
112623894540,112623894545,5,2632,1644,-30
112623931142,112623931147,5,2425,1678,-30
112625304734,112625304741,7,2418,1422,-30
112629960118,112629960122,4,2158,1549,-30
112630815823,112630815820,-3,1128,2246,-30
112638094991,112638094976,-15,1998,1161,-30
112638655682,112638655681,-1,1529,2478,-30
112639138213,112639138217,4,1628,1707,-30
112641206960,112641206966,6,2485,1941,-30
112642031369,112642031366,-3,1685,3794,-30
112646432260,112646432266,6,2200,965,-30
112660682860,112660682866,6,1347,805,-30
112665642862,112665642867,5,2264,1221,-30
112665986210,112665986216,6,2304,1107,-30
112667810149,112667810154,5,2277,1081,-30
112667963348,112667963353,5,2008,983,-30
112668162735,112668162720,-15,1487,207,-30
112671891833,112671891838,5,2690,1374,-30
112674119152,112674119148,-4,30562,12768,-30
112677147809,112677147802,-7,3740,10308,-30
112678017250,112678017254,4,1907,847,-30
112685412803,112685412806,3,2556,1728,-30
112685674471,112685674475,4,1996,1634,-30
112688433427,112688433433,6,2323,1705,-30
112691042306,112691042310,4,2177,1235,-30
112697978369,112697978376,7,2493,1159,-30
112698675386,112698675390,4,1635,1518,-30
112699858154,112699858159,5,2047,896,-30
112700457009,112700457014,5,2445,1236,-30
112701990603,112701990607,4,2297,1099,-30
112702779396,112702779408,12,1329,781,-30
112705239396,112705239405,9,1688,1129,-30
112707267078,112707267085,7,3254,1636,-30
112709029927,112709029930,3,2049,1443,-30
112711449553,112711449555,2,1538,1174,-30
112711962641,112711962646,5,1952,1247,-30
112714268440,112714268445,5,2510,1655,-30
112716173598,112716173602,4,1207,996,-30
112720839802,112720839806,4,1993,1402,-30
112722887923,112722887928,5,2327,1179,-30
112726355997,112726356002,5,2360,1437,-30
112726389638,112726389643,5,2272,1303,-30
112727788481,112727788486,5,2533,1466,-30
112730148474,112730148480,6,3564,1196,-30
112730477091,112730477098,7,2778,1224,-30
112731125142,112731125122,-20,4669,2002,-30
112734006551,112734006557,6,2625,1204,-30
112735096189,112735096186,-3,1297,2639,-30
112736687406,112736687410,4,1731,1009,-30
112736741957,112736741961,4,1871,858,-30
112740138797,112740138801,4,1490,1172,-30
112740198501,112740198489,-12,805,430,-30
112741263286,112741263291,5,1650,1140,-30
112741726758,112741726755,-3,720,205,-30
112742421174,112742421182,8,1026,998,-30
112743105582,112743105585,3,2504,1364,-30
112745298060,112745298067,7,1661,1250,-30
112746168597,112746168618,21,1950,1460,-30
112747062297,112747062305,8,2221,1116,-30
112747494970,112747494969,-1,968,1511,-30
112755709277,112755709281,4,2693,1668,-30
112757258756,112757258760,4,2326,1630,-30
112760052351,112760052347,-4,1293,1780,-30
112760282833,112760282838,5,2126,1097,-30
112760438519,112760438523,4,1342,1062,-30
112760515553,112760515539,-14,2034,897,-30
112760647944,112760647946,2,1847,1367,-30
112760710261,112760710266,5,1742,1032,-30
112765953254,112765953260,6,2629,1548,-30
112766291442,112766291449,7,3416,1265,-30
112770077958,112770077955,-3,2849,40680,-30
112770401342,112770401348,6,1584,1447,-30
112770526716,112770526697,-19,2603,998,-30
112770913842,112770913847,5,2016,1126,-30
112775623951,112775623955,4,1853,1308,-30
112775784205,112775784206,1,1410,1352,-30
112777189984,112777189990,6,2134,1118,-30
112777825163,112777825169,6,2546,1106,-30
112778364183,112778364187,4,2503,1314,-30
112779172148,112779172153,5,1893,974,-30
112786109614,112786109618,4,2591,1886,-30
112787591898,112787591902,4,1887,1276,-30
112788168932,112788168914,-18,1149,1375,-30
112789059870,112789059876,6,2429,1056,-30
112790127073,112790127079,6,2833,1146,-30
112793409969,112793409975,6,1899,1263,-30
112798604020,112798604026,6,2741,1258,-30
112808521686,112808521693,7,2518,1175,-30
112810822850,112810822854,4,2574,1845,-30
112821947297,112821947303,6,2589,1323,-30
112823857270,112823857272,2,530,474,-30
112825742383,112825742386,3,2342,971,-30
112831345163,112831345166,3,2288,992,-30
112832983367,112832983371,4,1727,1202,-30
112835425450,112835425453,3,1214,988,-30
112835466366,112835466370,4,1958,1153,-30
112839074034,112839074041,7,1820,1450,-30
112839416588,112839416593,5,2109,1486,-30
112848218877,112848218883,6,2166,1329,-30
112852832878,112852832878,0,1325,1116,-30
112854281564,112854281568,4,2266,1414,-30
112855455932,112855455935,3,1241,1129,-30
112855580726,112855580704,-22,2145,1528,-30
112855933927,112855933933,6,1235,901,-30
112858594351,112858594353,2,1406,1774,-30
112860905473,112860905477,4,1904,1185,-30
112861446153,112861446158,5,1655,1142,-30
112863509630,112863509635,5,2630,987,-30
112865691123,112865691129,6,2169,1424,-30
112866404705,112866404709,4,2492,1629,-30
112867935146,112867935151,5,2831,1406,-30
112868992885,112868992890,5,2270,1627,-30
112869452782,112869452789,7,2035,1255,-30
112871453610,112871453614,4,2521,1399,-30
112872796805,112872796791,-14,1286,1011,-30
112873014749,112873014754,5,2885,1603,-30
112873622737,112873622743,6,1507,1167,-30
112878553683,112878553688,5,3189,1537,-30
112880156535,112880156538,3,1822,1228,-30
112883490258,112883490261,3,1965,1402,-30
112884039616,112884039621,5,2287,1257,-30
112886124873,112886124880,7,2889,1153,-30
112886989893,112886989899,6,2183,1038,-30
112888941641,112888941646,5,1879,804,-30
112892537954,112892537957,3,2096,1003,-30
112895129995,112895129998,3,1171,845,-30
112896853087,112896853092,5,2119,918,-30
112904085266,112904085271,5,3385,1680,-30
112906793610,112906793615,5,1892,1296,-30
112907390234,112907390239,5,1621,859,-30
112911656155,112911656162,7,1985,1255,-30
112912097017,112912097021,4,2575,1557,-30
112913455302,112913455307,5,2585,1173,-30
112915256024,112915256031,7,2208,1106,-30
112922718703,112922718707,4,1977,975,-30
112924086265,112924086270,5,2530,1373,-30
112929786540,112929786543,3,975,594,-30
112931562191,112931562197,6,2669,1487,-30
112935488138,112935488141,3,2098,1531,-30
112937166996,112937167004,8,3765,1226,-30
112941668260,112941668265,5,2001,1406,-30
112942397227,112942397226,-1,4133,5891,-30
112943490919,112943490925,6,1789,1251,-30
112946225656,112946225660,4,1619,1574,-30
112946639461,112946639457,-4,3138,5164,-30
112947826145,112947826147,2,1605,998,-30
112951660113,112951660106,-7,31714,14733,-30
112952451525,112952451524,-1,1281,1495,-30
112953018315,112953018318,3,1573,1638,-30
112954112305,112954112311,6,1816,965,-30
112954914192,112954914197,5,3401,1485,-30
112958620949,112958620955,6,3122,1324,-30
112959335849,112959335851,2,1738,1240,-30
112959488150,112959488132,-18,1213,612,-30
112960793850,112960793857,7,2335,1469,-30
112961669854,112961669861,7,2936,1594,-30
112963564262,112963564266,4,2109,1838,-30
112964066275,112964066281,6,3453,1635,-30
112964602013,112964601999,-14,1009,582,-30
112967272402,112967272408,6,2952,1422,-30
112971075389,112971075394,5,1563,962,-30
112972180425,112972180429,4,2329,1191,-30
112972797983,112972797987,4,1476,1482,-30
112972853348,112972853353,5,2942,1752,-30
112976736489,112976736494,5,2726,1093,-30
112977283712,112977283717,5,1380,1169,-30
112984014074,112984014079,5,2382,1180,-30
112987698654,112987698659,5,2563,1614,-30
112991296759,112991296762,3,2378,1539,-30
112992585960,112992585965,5,1749,1508,-30
112993042758,112993042764,6,2883,1261,-30
112996836915,112996836895,-20,2426,1098,-30
112997615799,112997615805,6,2906,1399,-30
112998676022,112998676027,5,2664,1608,-30
112998734581,112998734563,-18,1890,1259,-30
113001415702,113001415707,5,1347,989,-30
113001499597,113001499602,5,2771,1671,-30
113004437879,113004437886,7,2123,1091,-30
113006643867,113006643864,-3,1125,3068,-30
113010724445,113010724451,6,22661,33186,-30
113015087573,113015087575,2,2280,1218,-30
113015687285,113015687289,4,2226,947,-30
113015866828,113015866833,5,1951,1541,-30
113019548421,113019548417,-4,1122,3380,-30
113019767704,113019767709,5,2415,973,-30
113020176266,113020176270,4,1370,923,-30
113020964569,113020964573,4,2337,1511,-30
113022425449,113022425447,-2,1548,2161,-30
113029800177,113029800184,7,1676,1015,-30
113035346814,113035346818,4,2789,1707,-30
113037694870,113037694874,4,1893,1171,-30
113040410203,113040410207,4,2001,1455,-30
113041574799,113041574805,6,2307,1123,-30
113042206684,113042206690,6,1547,1022,-30
113045141164,113045141170,6,3375,2109,-30
113046467749,113046467754,5,1227,1307,-30
113047608563,113047608557,-6,1860,6970,-30
113047733433,113047733440,7,2468,1278,-30
113048343042,113048343049,7,3008,1885,-30
113049785639,113049785645,6,2392,1377,-30
113052538357,113052538359,2,11965,10089,-30
113054117442,113054117440,-2,1224,2691,-30
113068424049,113068424054,5,2157,1330,-30
113074742233,113074742238,5,947,849,-30
113075407658,113075407662,4,2572,1366,-30
113076331982,113076331985,3,2505,1263,-30
113077946146,113077946153,7,3240,1495,-30
113080432854,113080432858,4,1484,833,-30
113081601649,113081601654,5,3089,1541,-30
113081846373,113081846380,7,1439,1245,-30
113086013569,113086013578,9,2269,1345,-30
113089272940,113089272964,24,2133,1256,-30
113091627429,113091627435,6,2027,1227,-30
113091725479,113091725485,6,1951,1415,-30
113093104497,113093104502,5,1603,1085,-30
113096102500,113096102506,6,2639,1562,-30
113096482162,113096482168,6,3404,1735,-30
113098867065,113098867069,4,2139,998,-30
113101687069,113101687074,5,2663,1472,-30
113102582998,113102583003,5,1734,971,-30
113103072429,113103072434,5,1653,1052,-30
113108460476,113108460481,5,2071,1203,-30
113109168286,113109168265,-21,1547,222,-30
113111483401,113111483404,3,2548,1833,-30
113114181504,113114181509,5,14065,7612,-30
113115180710,113115180711,1,33323,33344,-30
113119589741,113119589744,3,2642,1258,-30
113121572233,113121572238,5,3342,1515,-30
113123965545,113123965550,5,2813,1430,-30
113124274119,113124274123,4,1146,866,-30
113124436958,113124436961,3,656,253,-30
113130666089,113130666096,7,3506,1545,-30
113134358665,113134358670,5,2386,1389,-30
113135729724,113135729728,4,2825,1579,-30
113137418775,113137418779,4,2069,1283,-30
113143457756,113143457761,5,1448,1145,-30
113144456330,113144456337,7,1421,1151,-30
113145321562,113145321569,7,2291,1252,-30
113148089281,113148089286,5,2185,1009,-30
113148468374,113148468378,4,2552,2002,-30
113149154446,113149154452,6,2784,910,-30
113150445312,113150445316,4,2606,1443,-30
113151066465,113151066469,4,1875,1491,-30
113154764222,113154764229,7,2135,1518,-30
113155956626,113155956631,5,1719,1237,-30
113163211790,113163211796,6,2194,1569,-30
113166575428,113166575432,4,2127,1429,-30
113169842302,113169842306,4,1489,1423,-30
113170198146,113170198147,1,1143,1772,-30
113170630619,113170630625,6,2028,1094,-30
113172058051,113172058057,6,2085,1361,-30
113172593078,113172593081,3,1356,1682,-30
113173933619,113173933627,8,2392,1435,-30
113174337498,113174337504,6,3271,1636,-30
113174582283,113174582281,-2,668,441,-30
113176642078,113176642083,5,1897,1106,-30
113183779364,113183779371,7,2722,1174,-30
113183846580,113183846592,12,841,401,-30
113187654917,113187654922,5,2225,1198,-30
113188414684,113188414689,5,1370,1250,-30
113188854842,113188854827,-15,2430,1113,-30
113191306912,113191306918,6,2727,1171,-30
113191645242,113191645246,4,2090,1123,-30
113193004829,113193004833,4,2793,1297,-30
113198519567,113198519565,-2,2933,4912,-30
113201198736,113201198743,7,2611,1778,-30
113201651777,113201651782,5,1700,1494,-30
113205344250,113205344255,5,2964,1092,-30
113207600306,113207600311,5,2182,1479,-30
113209041238,113209041241,3,2446,1578,-30
113209844129,113209844116,-13,2645,1471,-30
113210691414,113210691418,4,2354,1277,-30
113212906853,113212906858,5,2989,942,-30
113218967865,113218967869,4,1307,853,-30
113219417013,113219417025,12,642,206,-30
113227982989,113227982992,3,2029,875,-30
113234270057,113234270061,4,2661,1652,-30
113235490484,113235490483,-1,1377,1081,-30
113235938233,113235938237,4,2716,1101,-30
113236166673,113236166678,5,2204,1187,-30
113239352356,113239352362,6,1942,1105,-30
113241179006,113241179013,7,1409,892,-30
113241779003,113241778984,-19,2747,1729,-30
113246843252,113246843263,11,270,1378,-30
113250092721,113250092726,5,2306,1369,-30
113262065253,113262065258,5,2411,1607,-30
113266891023,113266891028,5,3093,1414,-30
113268004122,113268004126,4,1930,1533,-30
113270452994,113270452999,5,1148,1475,-30
113272972851,113272972847,-4,1404,3071,-30
113273940213,113273940219,6,2467,1635,-30
113276819489,113276819491,2,1322,1282,-30
113282286717,113282286723,6,2924,1202,-30
113285493841,113285493845,4,1524,762,-30
113288489750,113288489754,4,2385,1263,-30
113294055128,113294055134,6,2233,1755,-30
113297847058,113297847065,7,2138,1425,-30
113297993505,113297993510,5,2373,1584,-30
113298954981,113298954987,6,1461,897,-30
113300399366,113300399371,5,2575,1538,-30
113302209946,113302209949,3,10371,9439,-30
113306544734,113306544739,5,2346,914,-30
113310707102,113310707107,5,2918,1334,-30
113311359798,113311359802,4,1919,1314,-30
113312997950,113312997957,7,2672,1030,-30
113313621051,113313621064,13,1885,826,-30
113319381135,113319381129,-6,1626,5453,-30
113319589995,113319589998,3,2011,1484,-30
113320068066,113320068062,-4,566,1746,-30
113320337794,113320337799,5,1693,1426,-30
113320856745,113320856749,4,2167,1144,-30
113321381221,113321381225,4,3903,1530,-30
113323803562,113323803566,4,2141,1767,-30
113325257363,113325257369,6,2450,1770,-30
113334440847,113334440854,7,2202,1321,-30
113335461482,113335461488,6,2144,1455,-30
113336667182,113336667188,6,2953,1799,-30
113338043029,113338043034,5,3481,1838,-30
113350137119,113350137123,4,2716,2008,-30
113350386903,113350386908,5,2939,1734,-30
113353953010,113353953014,4,2299,1029,-30
113358964175,113358964178,3,1526,1450,-30
113363265230,113363265235,5,1089,1162,-30
113365875093,113365875097,4,1547,1519,-30
113371709365,113371709354,-11,1074,1947,-30
113373791717,113373791723,6,2319,1260,-30
113374229677,113374229682,5,2412,1478,-30
113383258389,113383258394,5,1063,706,-30
113384123645,113384123649,4,2332,1255,-30
113384210684,113384210689,5,2683,1260,-30
113386715205,113386715210,5,1956,1219,-30
113387789359,113387789365,6,2550,1155,-30
113394396933,113394396939,6,1782,1522,-30
113396672782,113396672787,5,2294,1344,-30
113397882146,113397882149,3,1789,1028,-30
113407640880,113407640885,5,3442,1728,-30
113409713359,113409713353,-6,1482,5716,-30
113410925411,113410925414,3,2249,1191,-30
113411468749,113411468754,5,2241,997,-30
113411634250,113411634236,-14,1875,1170,-30
113414476569,113414476568,-1,813,1779,-30
113419069302,113419069309,7,3112,1244,-30
113421133872,113421133870,-2,1257,2003,-30
113425678605,113425678610,5,4360,1079,-30
113426012770,113426012774,4,2461,1275,-30
113426124729,113426124734,5,2324,1454,-30
113427534497,113427534504,7,2057,1331,-30
113430076246,113430076254,8,1984,1354,-30
113431908628,113431908644,16,46,577,-30
113435480407,113435480402,-5,587,186,-30
113436695269,113436695274,5,1718,1155,-30
113444143969,113444143974,5,1741,1019,-30
113444291899,113444291883,-16,1270,1272,-30
113447306953,113447306954,1,2453,1959,-30
113448888101,113448888102,1,1831,1347,-30
113456443894,113456443897,3,2277,1538,-30
113456768022,113456768022,0,1020,988,-30
113460033930,113460033937,7,2335,1303,-30
113461598257,113461598263,6,2584,1449,-30
113464829558,113464829562,4,12235,6842,-30
113471636199,113471636205,6,2416,1222,-30
113472435769,113472435773,4,2858,1705,-30
113472727025,113472727030,5,2517,1247,-30
113474148915,113474148920,5,2611,1301,-30
113475258488,113475258494,6,2309,929,-30
113477944467,113477944470,3,2152,1047,-30
113481559716,113481559718,2,1341,991,-30
113483949288,113483949295,7,2981,1269,-30
113484672578,113484672582,4,3525,1858,-30
113486385148,113486385153,5,2392,1927,-30
113490600249,113490600256,7,2604,1056,-30
113492804707,113492804711,4,1913,1556,-30
113492976163,113492976169,6,1852,1769,-30
113493635624,113493635629,5,2002,1253,-30
113500645083,113500645086,3,1050,1149,-30
113503875121,113503875126,5,2371,987,-30
113505428702,113505428706,4,3238,1541,-30
113507188726,113507188730,4,1295,1053,-30
113507381055,113507381062,7,1908,950,-30
113510764623,113510764627,4,2511,1789,-30
113517684251,113517684254,3,1751,1574,-30
113520868344,113520868335,-9,44945,9761,-30
113521681345,113521681348,3,2116,1323,-30
113524259694,113524259698,4,2825,1291,-30
113525689425,113525689430,5,2595,1268,-30
113527158058,113527158062,4,3075,1181,-30
113529584797,113529584800,3,1961,1127,-30
113529871349,113529871348,-1,26096,24606,-30
113532409817,113532409823,6,2213,1367,-30
113533837683,113533837688,5,2613,1328,-30
113534206873,113534206881,8,1641,1005,-30
113534998212,113534998201,-11,924,1289,-30
113541498461,113541498465,4,1990,954,-30
113543098271,113543098278,7,2425,1053,-30
113545642272,113545642265,-7,750,2691,-30
113545700952,113545700957,5,2407,1658,-30
113547389410,113547389416,6,2480,1396,-30
113547818561,113547818565,4,1902,1030,-30
113548467561,113548467566,5,2847,1932,-30
113549313030,113549313035,5,2986,1673,-30
113549873609,113549873614,5,1699,1145,-30
113552012746,113552012751,5,2283,1282,-30
113554386565,113554386567,2,3551,2130,-30
113554809134,113554809139,5,2818,1528,-30
113556020460,113556020461,1,2226,1281,-30
113557290194,113557290201,7,2070,1146,-30
113559284240,113559284243,3,2072,1303,-30
113565545994,113565545999,5,1985,1507,-30
113565843825,113565843810,-15,4161,1354,-30
113570660761,113570660766,5,2246,1362,-30
113573852906,113573852901,-5,1400,5764,-30
113573955362,113573955366,4,3135,1429,-30
113575804242,113575804246,4,1618,954,-30
113578389793,113578389799,6,989,927,-30
113581646652,113581646658,6,2491,1220,-30
113581865917,113581865900,-17,1556,1058,-30
113583590138,113583590143,5,2171,1334,-30
113584389884,113584389889,5,2529,1929,-30
113586831474,113586831481,7,2194,1590,-30
113587166110,113587166115,5,2664,1407,-30
113588778437,113588778442,5,2764,1243,-30
113590844845,113590844850,5,1883,1294,-30
113593136063,113593136070,7,1564,1146,-30
113598242038,113598242037,-1,1123,1492,-30
113601268294,113601268298,4,2189,1621,-30
113602136390,113602136395,5,1660,1469,-30
113602630243,113602630249,6,2425,1322,-30
113603684702,113603684707,5,1995,999,-30
113605515580,113605515580,0,30327,20771,-30
113609239142,113609239140,-2,1256,3595,-30
113610646560,113610646566,6,2601,1247,-30
113611230115,113611230119,4,1462,1314,-30
113611382427,113611382443,16,1584,1256,-30
113612958357,113612958361,4,2014,1206,-30
113615533277,113615533281,4,1939,1230,-30
113618030675,113618030680,5,2917,1795,-30
113626833462,113626833467,5,2707,1463,-30
113630898388,113630898393,5,1953,1161,-30
113630972238,113630972245,7,4078,1872,-30
113631494116,113631494122,6,1559,861,-30
113631947644,113631947647,3,1924,1420,-30
113632042297,113632042302,5,2427,1239,-30
113638982357,113638982361,4,2475,1197,-30
113639436590,113639436610,20,1280,914,-30
113642023447,113642023450,3,1104,1483,-30
113643303688,113643303695,7,3289,1684,-30
113647555370,113647555373,3,2188,1720,-30
113650934170,113650934176,6,2816,1621,-30
113652854959,113652854970,11,654,199,-30
113653963005,113653963010,5,1538,1173,-30
113659570885,113659570889,4,2258,1459,-30
113660165854,113660165859,5,1351,971,-30
113660442573,113660442554,-19,2357,886,-30
113662960000,113662960004,4,2298,1354,-30
113663460898,113663460902,4,2631,1327,-30
113663750334,113663750314,-20,1249,621,-30
113665522386,113665522390,4,2157,1298,-30
113667031394,113667031398,4,2192,1168,-30
113674342541,113674342546,5,2480,1468,-30
113676325661,113676325666,5,3266,949,-30
113679075098,113679075096,-2,1230,2414,-30
113689364837,113689364842,5,2217,923,-30
113689851844,113689851826,-18,2091,964,-30
113692301492,113692301498,6,3122,1383,-30
113693457223,113693457230,7,2011,1402,-30
113695237602,113695237609,7,2502,1450,-30
113695810328,113695810334,6,2337,2133,-30
113697290091,113697290097,6,3399,1846,-30
113698652474,113698652478,4,1821,1265,-30
113701140070,113701140075,5,2070,1182,-30
113701878713,113701878717,4,2610,1378,-30
113703124676,113703124682,6,2128,1140,-30
113704309715,113704309720,5,2418,1571,-30
113705438606,113705438611,5,2534,1285,-30
113708012581,113708012583,2,2443,1219,-30
113708326102,113708326106,4,2754,1491,-30
113709517722,113709517726,4,2316,1596,-30
113709910082,113709910087,5,1066,1036,-30
113719429769,113719429774,5,2020,240,-30
113722433785,113722433771,-14,1813,1052,-30
113722527510,113722527517,7,2245,1697,-30
113726661158,113726661163,5,2560,1690,-30
113727760018,113727760024,6,2374,1547,-30
113728331625,113728331625,0,1258,2624,-30
113735438222,113735438222,0,2725,1393,-30
113735481278,113735481287,9,3365,1134,-30
113735667657,113735667662,5,2886,1315,-30
113738823246,113738823250,4,1599,1242,-30
113741953782,113741953786,4,2075,1344,-30
113743457177,113743457185,8,3120,1398,-30
113743681086,113743681090,4,2324,1343,-30
113744226822,113744226829,7,2872,1151,-30
113752211943,113752211949,6,1818,1107,-30
113755727247,113755727253,6,2630,1666,-30
113758523058,113758523063,5,2956,1564,-30
113759255434,113759255438,4,2344,1207,-30
113760147523,113760147526,3,1688,1498,-30
113763672372,113763672377,5,1616,1007,-30
113765333185,113765333190,5,2017,1203,-30
113767641321,113767641328,7,6271,1121,-30
113768021661,113768021656,-5,46195,19271,-30
113768801641,113768801647,6,1948,1082,-30
113768945155,113768945139,-16,1081,586,-30
113771515481,113771515486,5,1367,678,-30
113771554520,113771554529,9,1973,1166,-30
113773202773,113773202778,5,1769,1543,-30
113773959101,113773959106,5,2125,1538,-30
113776132669,113776132674,5,2673,1078,-30
113778374394,113778374399,5,2142,1162,-30
113781415017,113781415023,6,2293,1165,-30
113785988045,113785988048,3,2650,1224,-30
113786986113,113786986119,6,1603,750,-30
113790232298,113790232294,-4,2497,5536,-30
113790644019,113790644026,7,5416,1259,-30
113791329206,113791329210,4,1867,1226,-30
113792017489,113792017491,2,1065,1221,-30
113796163761,113796163764,3,1548,1384,-30
113799241989,113799241993,4,3409,1611,-30
113799651090,113799651074,-16,1868,1056,-30
113801129002,113801129003,1,1547,1626,-30
113808429734,113808429739,5,1857,1061,-30
113808658040,113808658045,5,2339,1177,-30
113810023982,113810023986,4,2594,1274,-30
113814714764,113814714769,5,1691,1969,-30
113814963594,113814963598,4,1950,965,-30
113818733890,113818733894,4,2028,1291,-30
113824809897,113824809902,5,3144,1626,-30
113825903090,113825903094,4,2083,1440,-30
113825978156,113825978162,6,2222,1364,-30
113827103428,113827103433,5,2801,1723,-30
113833422614,113833422619,5,2707,1710,-30
113833520083,113833520087,4,1625,1196,-30
113834143241,113834143245,4,2096,1626,-30
113839107513,113839107518,5,2826,1606,-30
113841491356,113841491362,6,2648,1413,-30
113842320825,113842320828,3,2377,1535,-30
113842853777,113842853782,5,2279,1609,-30
113843464872,113843464869,-3,1367,3183,-30
113845801345,113845801350,5,2204,1861,-30
113847017326,113847017332,6,2756,1552,-30
113851570969,113851570977,8,2319,1518,-30
113858836613,113858836619,6,2567,1292,-30
113858978825,113858978823,-2,921,850,-30
113859548705,113859548711,6,2225,1157,-30
113859904778,113859904783,5,1536,748,-30
113865029639,113865029645,6,1922,874,-30
113866767268,113866767273,5,2183,1554,-30
113866839723,113866839731,8,2224,681,-30
113867556867,113867556862,-5,1516,5477,-30
113874191462,113874191467,5,1985,954,-30
113875038610,113875038605,-5,2086,7405,-30
113878222960,113878222965,5,2309,1170,-30
113878951538,113878951542,4,3177,1046,-30
113885556431,113885556430,-1,776,1059,-30
113888546769,113888546773,4,1028,395,-30
113889307449,113889307451,2,1850,1230,-30
113890655524,113890655529,5,1812,1352,-30
113892760421,113892760426,5,2061,1146,-30
113895938826,113895938831,5,3789,2261,-30
113896794200,113896794202,2,2651,1243,-30
113902504025,113902504031,6,2037,1237,-30
113903525867,113903525872,5,2126,1285,-30
113909079946,113909079952,6,1897,1155,-30
113913433026,113913433030,4,3056,1467,-30
113915259950,113915259956,6,2420,1619,-30
113919539407,113919539414,7,2094,834,-30
113928187205,113928187211,6,2150,1340,-30
113930715994,113930715993,-1,1155,3645,-30
113933940733,113933940738,5,2061,1313,-30
113939423066,113939423070,4,1710,1332,-30
113944755365,113944755369,4,1749,840,-30
113950603818,113950603823,5,2744,1286,-30
113951352518,113951352523,5,2987,1705,-30
113955646830,113955646831,1,719,1152,-30
113960776554,113960776557,3,2233,1455,-30
113961560953,113961560957,4,3659,1917,-30
113963565428,113963565431,3,2017,1820,-30
113964749873,113964749878,5,1786,1603,-30
113972313846,113972313851,5,1907,969,-30
113974810529,113974810547,18,2391,1397,-30
113978082181,113978082185,4,2962,1920,-30
113979633212,113979633215,3,2060,1157,-30
113980285614,113980285618,4,2114,1135,-30
113981754427,113981754431,4,1222,1140,-30
113982676838,113982676843,5,2281,1367,-30
113982912505,113982912509,4,2749,1887,-30
113991351899,113991351904,5,2402,1438,-30
113992949549,113992949555,6,3120,1692,-30
113993132017,113993132021,4,2517,1250,-30
113996881800,113996881804,4,2602,1425,-30
113999561211,113999561215,4,2794,1117,-30
114000360062,114000360066,4,2108,1057,-30
114003907261,114003907266,5,2011,1324,-30
114005948018,114005948018,0,1244,819,-30
114006303318,114006303323,5,2390,1489,-30
114008864734,114008864739,5,1842,1063,-30
114010379489,114010379494,5,2636,1226,-30
114012402104,114012402107,3,2041,983,-30
114016771715,114016771721,6,2481,1289,-30
114022387785,114022387788,3,1629,1190,-30
114023205106,114023205113,7,3553,1456,-30
114025235779,114025235783,4,1692,1249,-30
114030319912,114030319914,2,2150,1164,-30
114033404934,114033404941,7,1693,734,-30
114034213773,114034213779,6,2082,1230,-30
114036230187,114036230194,7,2201,1566,-30
114037402219,114037402226,7,2478,1139,-30
114037969070,114037969083,13,1071,297,-30
114038656202,114038656207,5,1788,1093,-30
114038838882,114038838888,6,2614,2010,-30
114038870576,114038870593,17,2685,1404,-30
114045088526,114045088531,5,1623,1620,-30
114051523161,114051523166,5,1929,1528,-30
114052456945,114052456951,6,2682,1472,-30
114053342383,114053342387,4,2089,1200,-30
114056688073,114056688078,5,2445,1621,-30
114066312794,114066312798,4,1833,1242,-30
114066385093,114066385105,12,874,202,-30
114073051244,114073051250,6,1899,1027,-30
114074155386,114074155391,5,2201,947,-30
114076186569,114076186574,5,1957,1187,-30
114077167674,114077167679,5,1628,1142,-30
114077651983,114077651969,-14,2305,1232,-30
114078348722,114078348727,5,2655,1598,-30
114079752782,114079752783,1,1273,1547,-30
114080756074,114080756080,6,2243,1122,-30
114085876958,114085876964,6,2938,1252,-30
114086816636,114086816643,7,3886,901,-30
114089368650,114089368654,4,1310,1434,-30
114089768517,114089768527,10,1665,1255,-30
114090918274,114090918270,-4,1116,2732,-30
114091357673,114091357678,5,2538,1621,-30
114093946666,114093946671,5,2316,1247,-30
114095483771,114095483778,7,2621,1237,-30
114099917878,114099917884,6,2285,1169,-30
114109738977,114109738979,2,1299,1415,-30
114111983399,114111983403,4,1218,1370,-30
114115703784,114115703787,3,2015,1334,-30
114116184135,114116184138,3,2252,1504,-30
114116442271,114116442278,7,4085,1425,-30
114117493354,114117493358,4,2199,1272,-30
114117714020,114117714025,5,3260,2062,-30
114123870838,114123870842,4,2823,1582,-30
114129494547,114129494553,6,2215,1133,-30
114131623882,114131623866,-16,1366,637,-30
114140970312,114140970318,6,3142,1464,-30
114143821993,114143821998,5,1772,1358,-30
114144489988,114144489994,6,2061,978,-30
114144992063,114144992061,-2,2280,5462,-30
114147293847,114147293851,4,1914,1574,-30
114152827521,114152827525,4,2729,1785,-30
114161688048,114161688050,2,1598,1475,-30
114162599774,114162599779,5,1525,1407,-30
114165245369,114165245373,4,3232,1663,-30
114165355950,114165355954,4,2231,1374,-30
114167164594,114167164589,-5,1467,7415,-30
114167928995,114167929002,7,2558,1136,-30
114170166006,114170166011,5,1730,1214,-30
114177829621,114177829627,6,2461,1767,-30
114178160382,114178160385,3,2094,1158,-30
114181555043,114181555048,5,1852,1396,-30
114185045782,114185045786,4,1682,1778,-30
114191148724,114191148726,2,3022,1208,-30
114191551144,114191551150,6,2718,1069,-30
114198258830,114198258834,4,1395,926,-30
114200117251,114200117257,6,2217,1443,-30
114201930323,114201930327,4,2159,1556,-30
114204910661,114204910667,6,1937,1238,-30
114207417023,114207417017,-6,729,2633,-30
114208577253,114208577255,2,3237,1409,-30
114222354420,114222354422,2,1518,590,-30
114224328611,114224328615,4,1814,1137,-30
114229553649,114229553654,5,1318,1147,-30
114233547949,114233547954,5,2448,1161,-30
114239542607,114239542611,4,1520,1045,-30
114239864209,114239864213,4,2222,1114,-30
114241819374,114241819382,8,2183,1109,-30
114242652546,114242652540,-6,570,217,-30
114245184001,114245184006,5,1606,1019,-30
114246863951,114246863957,6,2529,788,-30
114249812615,114249812622,7,1776,1015,-30
114250409154,114250409140,-14,3010,1469,-30
114254941477,114254941482,5,1929,1332,-30
114258929341,114258929324,-17,3025,1450,-30
114259065554,114259065558,4,1814,1209,-30
114259320839,114259320845,6,2175,1451,-30
114259419427,114259419425,-2,1026,1379,-30
114259526020,114259526025,5,2240,913,-30
114268187341,114268187334,-7,730,3318,-30
114274543335,114274543335,0,1615,1759,-30
114276813933,114276813938,5,1880,1226,-30
114277853931,114277853937,6,2425,1524,-30
114278150335,114278150312,-23,1147,1510,-30
114279961803,114279961809,6,2098,1572,-30
114281296668,114281296674,6,1412,909,-30
114282636556,114282636561,5,2614,1869,-30
114283382270,114283382275,5,2932,1376,-30
114289045132,114289045138,6,1686,1388,-30
114292586895,114292586890,-5,2442,5654,-30
114294120110,114294120113,3,1274,768,-30
114295930553,114295930557,4,2616,1261,-30
114295988699,114295988705,6,3286,1517,-30
114304454230,114304454235,5,2324,968,-30
114304820658,114304820642,-16,1736,903,-30
114307292898,114307292902,4,1455,1345,-30
114311714253,114311714259,6,1482,990,-30
114316542826,114316542832,6,2053,994,-30
114316785750,114316785754,4,2100,1392,-30
114318836695,114318836702,7,4272,1266,-30
114328718307,114328718311,4,1950,932,-30
114333240726,114333240735,9,10996,28735,-30
114336694392,114336694393,1,1387,1460,-30
114337157383,114337157386,3,1781,1298,-30
114342131109,114342131112,3,2234,1263,-30
114352207358,114352207362,4,2058,1228,-30
114355958443,114355958447,4,1723,1428,-30
114356453349,114356453349,0,3023,4396,-30
114357264016,114357264021,5,2334,1197,-30
114363163867,114363163870,3,2862,1786,-30
114365780227,114365780234,7,2065,1271,-30
114366250054,114366250033,-21,1883,346,-30
114369349178,114369349181,3,2317,1170,-30
114370644394,114370644398,4,2040,1812,-30
114371415903,114371415902,-1,2814,4506,-30
114373426317,114373426322,5,2832,1603,-30
114373862017,114373862017,0,20973,25455,-30
114377052021,114377052027,6,3811,1641,-30
114377743063,114377743068,5,1990,1519,-30
114379879535,114379879539,4,1289,966,-30
114383653581,114383653585,4,1956,1045,-30
114386145029,114386145035,6,3234,1452,-30
114388159868,114388159867,-1,1489,1770,-30
114388839511,114388839514,3,2343,1584,-30
114390558592,114390558597,5,1990,1154,-30
114393801598,114393801602,4,1622,1335,-30
114394663966,114394663971,5,1362,779,-30
114395620359,114395620365,6,2858,1203,-30
114395981830,114395981833,3,8646,7417,-30
114397121245,114397121248,3,2899,1441,-30
114398060372,114398060378,6,3042,1728,-30
114401428642,114401428642,0,1402,1677,-30
114402012004,114402012010,6,3477,1775,-30
114403238918,114403238923,5,2825,1525,-30
114403397853,114403397873,20,2579,1570,-30
114403738859,114403738864,5,2905,1427,-30
114407199642,114407199647,5,1860,1400,-30
114408288412,114408288415,3,2250,1151,-30
114413457538,114413457533,-5,2122,8656,-30
114416039586,114416039590,4,3461,2116,-30
114418240057,114418240062,5,2780,1526,-30
114420200482,114420200488,6,2438,1314,-30
114420924397,114420924403,6,2791,1267,-30
114422733389,114422733394,5,1977,1703,-30
114427945650,114427945655,5,3205,1523,-30
114430211120,114430211122,2,2031,1638,-30
114432663559,114432663565,6,2222,1525,-30
114435425442,114435425447,5,2329,1334,-30
114439253754,114439253760,6,4457,1721,-30
114441301051,114441301051,0,1225,1745,-30
114442595853,114442595857,4,1994,1360,-30
114442897580,114442897585,5,2400,1204,-30
114445075474,114445075479,5,2901,1143,-30
114445323813,114445323817,4,1929,1069,-30
114448636229,114448636234,5,2606,1496,-30
114448872775,114448872752,-23,2442,1375,-30
114450367033,114450367039,6,2545,964,-30
114452493286,114452493290,4,2205,1602,-30
114452971436,114452971441,5,1856,1491,-30
114468435845,114468435851,6,1555,1192,-30
114470500019,114470500024,5,2000,1457,-30
114472244627,114472244631,4,2388,1265,-30
114472343336,114472343342,6,1852,1012,-30
114472387232,114472387233,1,1935,3082,-30
114475340498,114475340503,5,1645,1037,-30
114480115678,114480115684,6,3091,1823,-30
114485239363,114485239370,7,1977,1331,-30
114490572175,114490572173,-2,1505,5298,-30
114492488271,114492488277,6,2128,1251,-30
114496058943,114496058946,3,1456,1115,-30
114497124128,114497124133,5,1802,1582,-30
114498201789,114498201795,6,1701,1319,-30
114499085489,114499085494,5,1913,1118,-30
114500765541,114500765549,8,1378,988,-30
114504209066,114504209071,5,2395,1446,-30
114504769537,114504769542,5,2113,1164,-30
114509134690,114509134694,4,2625,912,-30
114509763926,114509763932,6,2844,1222,-30
114510083990,114510083998,8,3050,1636,-30
114510559126,114510559130,4,2593,1067,-30
114513722538,114513722545,7,2938,2005,-30
114515559494,114515559500,6,2497,1290,-30
114516995013,114516995017,4,1333,985,-30
114518746349,114518746352,3,4181,2281,-30
114522959014,114522959020,6,1955,1693,-30
114523255346,114523255350,4,2139,930,-30
114525850948,114525850953,5,2679,1120,-30
114527125538,114527125522,-16,2601,1542,-30
114530949518,114530949524,6,1636,756,-30
114535359693,114535359698,5,2886,1197,-30
114539008526,114539008533,7,1455,518,-30
114540778369,114540778373,4,2181,1479,-30
114542105930,114542105935,5,1717,978,-30
114542277239,114542277221,-18,3204,1599,-30
114545138753,114545138758,5,2667,1243,-30
114546660923,114546660930,7,3675,1526,-30
114550313484,114550313490,6,863,340,-30
114555146871,114555146875,4,3538,1579,-30
114556783801,114556783807,6,1831,848,-30
114558045535,114558045540,5,3406,2024,-30
114559165329,114559165333,4,1773,1351,-30
114565678166,114565678173,7,1752,1324,-30
114567482049,114567482055,6,2682,976,-30
114567937782,114567937787,5,2950,1430,-30
114570166413,114570166418,5,2675,1890,-30
114573010038,114573010043,5,2329,1013,-30
114574918206,114574918209,3,1670,1240,-30
114575734598,114575734604,6,2192,1331,-30
114578375603,114578375608,5,2120,1338,-30
114578569158,114578569168,10,2043,1424,-30
114582418617,114582418616,-1,1377,1370,-30
114583833621,114583833626,5,3274,1716,-30
114585015613,114585015618,5,2570,1117,-30
114585530139,114585530143,4,2772,1491,-30
114592633755,114592633759,4,962,870,-30
114593175989,114593175990,1,1757,1436,-30
114601632493,114601632498,5,2817,1355,-30
114604937373,114604937379,6,3212,1906,-30
114606889081,114606889083,2,1006,978,-30
114607613274,114607613272,-2,2216,3549,-30
114611507982,114611507986,4,1769,1064,-30
114612874918,114612874923,5,749,504,-30
114620239358,114620239361,3,1464,1225,-30
114622649693,114622649698,5,3514,2065,-30
114624708850,114624708854,4,1887,958,-30
114629178668,114629178674,6,2079,1421,-30
114629941402,114629941408,6,2444,1670,-30
114631601854,114631601858,4,2057,1269,-30
114633024706,114633024710,4,2910,1515,-30
114635626397,114635626402,5,2003,1331,-30
114636095268,114636095273,5,2612,1073,-30
114636967661,114636967669,8,2748,1504,-30
114640718017,114640718022,5,2435,1850,-30
114642397989,114642397993,4,1818,1154,-30
114643736889,114643736893,4,1736,1380,-30
114645310286,114645310290,4,2187,1313,-30
114646979830,114646979835,5,1616,1053,-30
114651770921,114651770925,4,1769,1275,-30
114654025668,114654025670,2,1800,1230,-30
114659673577,114659673581,4,2394,1932,-30
114663603112,114663603116,4,2010,1324,-30
114665897362,114665897347,-15,1401,672,-30
114668908427,114668908434,7,2520,1326,-30
114673465785,114673465790,5,1854,1013,-30
114675521182,114675521187,5,1910,1436,-30
114676774097,114676774103,6,2612,1224,-30
114679385174,114679385176,2,2173,1881,-30
114682617365,114682617367,2,1450,1168,-30
114689847241,114689847246,5,2249,1444,-30
114689942981,114689942989,8,1718,1165,-30
114690128042,114690128048,6,1063,323,-30
114692385947,114692385952,5,2193,1551,-30
114693863413,114693863418,5,1583,726,-30
114694751962,114694751967,5,2076,1443,-30
114695992295,114695992302,7,2131,960,-30
114696984582,114696984587,5,2234,984,-30
114699323269,114699323274,5,1859,1107,-30
114700924977,114700924982,5,1862,1179,-30
114701534110,114701534107,-3,80,3195,-30
114702455276,114702455280,4,2542,1226,-30
114703035033,114703035038,5,730,530,-30
114703811855,114703811858,3,3747,3236,-30
114704913498,114704913503,5,1857,839,-30
114708214909,114708214913,4,2504,1220,-30
114708922189,114708922168,-21,2297,1110,-30
114709745975,114709745975,0,1681,1897,-30
114710972541,114710972538,-3,1960,3901,-30
114712111767,114712111772,5,1838,1192,-30
114712250120,114712250131,11,2062,1060,-30
114714860825,114714860829,4,1908,1302,-30
114715113549,114715113556,7,4208,1404,-30
114716421550,114716421534,-16,2809,1696,-30
114719993372,114719993378,6,3075,1214,-30
114724748624,114724748629,5,1873,938,-30
114725297762,114725297767,5,2106,931,-30
114725492245,114725492248,3,2294,1401,-30
114730946900,114730946905,5,2436,1548,-30
114732553639,114732553645,6,2620,1298,-30
114734013235,114734013239,4,3176,1420,-30
114734088108,114734088113,5,1271,730,-30
114734682822,114734682828,6,2198,1806,-30
114736187246,114736187250,4,2838,1545,-30
114736658534,114736658539,5,1979,758,-30
114742011619,114742011625,6,2983,1956,-30
114743091074,114743091078,4,1467,1134,-30
114744848373,114744848377,4,2759,1927,-30
114747087312,114747087315,3,1821,1241,-30
114748264833,114748264834,1,1126,1808,-30
114750326251,114750326255,4,21677,18928,-30
114752872031,114752872036,5,2060,1965,-30
114753332429,114753332434,5,2491,1291,-30
114757143737,114757143742,5,2855,1362,-30
114758155646,114758155649,3,1707,1424,-30
114758865162,114758865167,5,2214,1138,-30
114762391034,114762391039,5,1947,977,-30
114765946225,114765946230,5,1854,1736,-30
114769250889,114769250894,5,2788,1996,-30
114775111660,114775111665,5,2461,1886,-30
114775367762,114775367767,5,2215,1008,-30
114775881540,114775881546,6,1831,1133,-30
114776032929,114776032913,-16,1695,1723,-30
114776837114,114776837111,-3,661,209,-30
114779636323,114779636328,5,2357,1075,-30
114780567094,114780567099,5,2267,943,-30
114780850993,114780850987,-6,1092,3374,-30
114782285839,114782285842,3,2452,1355,-30
114783912212,114783912217,5,3164,1994,-30
114784631098,114784631098,0,1803,1752,-30
114785737102,114785737107,5,1641,1004,-30
114789177719,114789177710,-9,1645,5325,-30
114792916962,114792916968,6,2929,1280,-30
114794334286,114794334289,3,1794,1155,-30
114795286737,114795286742,5,867,1180,-30
114796173191,114796173197,6,2096,1041,-30
114804513738,114804513743,5,1920,1220,-30
114804563781,114804563781,0,3804,3972,-30
114808645887,114808645892,5,1894,1289,-30
114809142897,114809142906,9,1355,743,-30
114809808699,114809808704,5,1843,962,-30
114811428390,114811428395,5,2599,1794,-30
114813570870,114813570874,4,2143,1064,-30
114816676686,114816676692,6,3958,1578,-30
114821493952,114821493960,8,3305,1390,-30
114823185954,114823185959,5,2746,1480,-30
114823324204,114823324209,5,1524,1413,-30
114830321002,114830321010,8,6689,1143,-30
114830997658,114830997641,-17,1945,927,-30
114833716576,114833716581,5,2272,1338,-30
114836043009,114836043015,6,2349,1253,-30
114838782542,114838782543,1,1221,1359,-30
114840653473,114840653478,5,2161,1163,-30
114845592105,114845592110,5,897,688,-30
114847385939,114847385945,6,2755,1199,-30
114847965079,114847965083,4,1873,1434,-30
114849082842,114849082845,3,1644,1158,-30
114850909921,114850909926,5,2079,1409,-30
114856489865,114856489870,5,2893,1547,-30
114856832926,114856832932,6,3091,1773,-30
114857072814,114857072817,3,2046,1857,-30
114864149256,114864149255,-1,1147,1291,-30
114868263858,114868263864,6,2487,1208,-30
114868948897,114868948898,1,1463,1089,-30
114872198229,114872198234,5,2506,1860,-30
114874751475,114874751483,8,5719,1368,-30
114876866334,114876866338,4,1890,1089,-30
114877480353,114877480346,-7,818,5116,-30
114877670507,114877670511,4,2168,1157,-30
114877999636,114877999640,4,1893,887,-30
114879577134,114879577140,6,1741,1084,-30
114883765394,114883765401,7,2965,1550,-30
114885227946,114885227951,5,2297,1180,-30
114890922836,114890922833,-3,50697,25640,-30
114893716406,114893716411,5,2297,1001,-30
114898544338,114898544341,3,2155,1379,-30
114898590602,114898590586,-16,1247,613,-30
114899460363,114899460369,6,1875,831,-30
114900527349,114900527348,-1,1322,3541,-30
114900726398,114900726403,5,2973,1710,-30
114900939979,114900939983,4,3454,1666,-30
114903752867,114903752863,-4,1432,4075,-30
114906944346,114906944352,6,6228,2176,-30
114907514005,114907514009,4,2175,1306,-30
114910683564,114910683569,5,1845,1451,-30
114914369757,114914369762,5,2422,1192,-30
114917703915,114917703921,6,2153,1496,-30
114918035644,114918035626,-18,2218,1406,-30
114918319138,114918319143,5,3726,1235,-30
114918401029,114918401035,6,2382,1278,-30
114922259881,114922259874,-7,1095,5271,-30
114931004680,114931004687,7,3698,1270,-30
114935009673,114935009672,-1,1118,2532,-30
114936450309,114936450314,5,2685,1600,-30
114942460063,114942460070,7,2251,1213,-30
114950748912,114950748916,4,1898,1463,-30
114951645101,114951645105,4,2338,1119,-30
114952459269,114952459274,5,4436,2315,-30
114955569424,114955569427,3,1821,1160,-30
114955767653,114955767644,-9,927,376,-30
114958394224,114958394230,6,1662,836,-30
114959203904,114959203914,10,13142,28831,-30
114959721159,114959721165,6,2011,1656,-30
114961452340,114961452344,4,3163,2088,-30
114961602119,114961602124,5,1944,1167,-30
114970489298,114970489279,-19,1476,861,-30
114974910231,114974910230,-1,3005,6674,-30
114976488882,114976488890,8,1998,1159,-30
114977951830,114977951834,4,3455,1652,-30
114978974959,114978974976,17,652,261,-30
114980503561,114980503567,6,2560,1430,-30
114992449185,114992449191,6,1633,1265,-30
114993577854,114993577859,5,2221,1361,-30
114999069517,114999069505,-12,850,281,-30
115000390173,115000390179,6,1855,1252,-30
115002844021,115002844027,6,1995,1107,-30
115005500007,115005500013,6,1898,865,-30
115007654877,115007654881,4,2460,1545,-30
115007983598,115007983605,7,3520,1824,-30
115012531685,115012531686,1,1290,1413,-30
115016087188,115016087193,5,2816,1403,-30
115016431659,115016431664,5,2235,1862,-30
115016654974,115016654979,5,2303,1276,-30
115017125769,115017125774,5,3325,1791,-30
115018925961,115018925966,5,1774,1149,-30
115022255859,115022255863,4,1928,930,-30
115023828648,115023828652,4,2185,1357,-30
115025539301,115025539309,8,22432,53626,-30
115027023782,115027023788,6,3120,1703,-30
115028246804,115028246809,5,2065,1472,-30
115031042245,115031042252,7,4974,1275,-30
115032658789,115032658794,5,2752,1675,-30
115037496063,115037496067,4,2024,1421,-30
115041088695,115041088698,3,2356,1202,-30
115043009049,115043009054,5,2348,1607,-30
115043597118,115043597125,7,1734,1308,-30
115044123738,115044123743,5,2217,1602,-30
115049411693,115049411699,6,1375,856,-30
115049629600,115049629605,5,3082,2119,-30
115051895224,115051895230,6,1448,1171,-30
115054699530,115054699538,8,2433,1169,-30
115055129520,115055129523,3,2509,1053,-30
115057159158,115057159163,5,1965,886,-30
115062815543,115062815542,-1,1261,1731,-30
115062905944,115062905938,-6,1155,656,-30
115064654702,115064654707,5,2228,1620,-30
115064707681,115064707686,5,2249,1165,-30
115066703522,115066703527,5,3329,1581,-30
115068658558,115068658563,5,2052,1316,-30
115069120863,115069120867,4,1634,891,-30
115069360420,115069360412,-8,39303,10982,-30
115070609042,115070609046,4,1722,1357,-30
115071148769,115071148776,7,2256,1041,-30
115071902482,115071902481,-1,1288,2099,-30
115073369781,115073369781,0,2162,1660,-30
115078271799,115078271803,4,2081,1589,-30
115079542696,115079542699,3,1691,1258,-30
115081805822,115081805826,4,1763,1468,-30
115093256364,115093256371,7,2385,1037,-30
115094838977,115094838981,4,1721,765,-30
115095971035,115095971039,4,2347,1271,-30
115097009990,115097009995,5,2994,1365,-30
115105740714,115105740718,4,2124,1184,-30
115107914825,115107914829,4,1815,1553,-30
115110175123,115110175130,7,2466,1146,-30
115110367558,115110367537,-21,1269,1153,-30
115110771398,115110771403,5,2456,1194,-30
115114107509,115114107512,3,2335,1323,-30
115114713781,115114713787,6,1545,1283,-30
115115460686,115115460691,5,2524,1776,-30
115116495631,115116495635,4,1957,1349,-30
115116692802,115116692807,5,1715,1041,-30
115122801674,115122801677,3,1893,1337,-30
115126075892,115126075897,5,2469,1278,-30
115126131887,115126131884,-3,16297,40032,-30
115126758391,115126758386,-5,1230,2744,-30
115130630882,115130630886,4,2491,1569,-30
115130703019,115130703000,-19,1352,685,-30
115131494886,115131494891,5,1766,1045,-30
115132726987,115132726981,-6,2256,5499,-30
115133351531,115133351534,3,2506,2078,-30
115135609432,115135609434,2,1632,831,-30
115136093170,115136093153,-17,2375,1546,-30
115137774992,115137774997,5,2575,1424,-30
115148831631,115148831635,4,1260,624,-30
115150516684,115150516690,6,2555,1187,-30
115153893626,115153893628,2,2004,1794,-30
115155349775,115155349777,2,1184,870,-30
115155704573,115155704593,20,933,373,-30
115157224783,115157224790,7,4279,2203,-30
115158817866,115158817868,2,1957,2186,-30
115159001804,115159001808,4,3066,1226,-30
115160705266,115160705270,4,1562,1452,-30
115163490254,115163490259,5,4379,1549,-30
115166286318,115166286323,5,2171,1371,-30
115177021178,115177021184,6,2400,984,-30
115181747589,115181747594,5,2673,1707,-30
115185602822,115185602820,-2,3375,5587,-30
115185940434,115185940439,5,2242,1328,-30
115187836717,115187836722,5,1648,1040,-30
115193518281,115193518286,5,1884,808,-30
115196911639,115196911644,5,2480,1345,-30
115198702720,115198702722,2,2434,1168,-30
115199030202,115199030206,4,1857,1521,-30
115200381245,115200381251,6,2189,988,-30
115200742622,115200742630,8,2662,845,-30
115203521841,115203521848,7,2917,1224,-30
115211926869,115211926874,5,1441,1025,-30
115216160424,115216160429,5,3073,2285,-30
115219914850,115219914855,5,2176,1358,-30
115220751633,115220751638,5,1270,1113,-30
115227225322,115227225326,4,2386,1186,-30
115228077914,115228077917,3,1409,1424,-30
115228105730,115228105735,5,2225,1414,-30
115236742948,115236742949,1,5579,5661,-30
115239237894,115239237897,3,2480,1229,-30
115241585950,115241585955,5,1596,777,-30
115247449539,115247449516,-23,870,610,-30
115248189453,115248189459,6,1730,919,-30
115256638342,115256638349,7,3059,1480,-30
115258323315,115258323319,4,1983,1256,-30
115262745493,115262745497,4,2527,1213,-30
115266977858,115266977863,5,2159,1462,-30
115268217817,115268217822,5,1800,1044,-30
115274695893,115274695898,5,2428,1159,-30
115274797451,115274797454,3,1162,804,-30
115275148593,115275148597,4,2292,1679,-30
115277231005,115277231009,4,2062,1355,-30
115280256605,115280256611,6,2388,1168,-30
115281658806,115281658810,4,5635,2541,-30
115284422920,115284422925,5,2702,1538,-30
115289320495,115289320499,4,2758,2275,-30
115291899701,115291899705,4,1742,897,-30
115296167699,115296167705,6,2394,832,-30
115297987333,115297987339,6,2997,1653,-30
115298964457,115298964461,4,2011,1359,-30
115304642522,115304642527,5,2003,1308,-30
115305839150,115305839154,4,2580,2332,-30
115307165313,115307165322,9,3280,1380,-30
115307841870,115307841856,-14,998,309,-30
115308356285,115308356290,5,1805,1321,-30
115309101465,115309101467,2,2172,1322,-30
115311505522,115311505527,5,2451,1105,-30
115311531338,115311531322,-16,691,178,-30
115314117889,115314117896,7,2251,1346,-30
115315004725,115315004721,-4,2885,10031,-30
115316444461,115316444466,5,1670,1084,-30
115317615073,115317615078,5,2494,1519,-30
115321972008,115321972011,3,1439,863,-30
115324322845,115324322849,4,1772,1381,-30
115327354919,115327354922,3,2160,1315,-30
115331206587,115331206588,1,1695,1583,-30
115332209601,115332209606,5,2525,1438,-30
115332552606,115332552610,4,2114,1606,-30
115333220936,115333220942,6,2050,1340,-30
115333523902,115333523907,5,2966,1417,-30
115340289935,115340289940,5,7846,33476,-30
115341352775,115341352782,7,2993,1749,-30
115346321041,115346321046,5,2607,1607,-30
115347232386,115347232389,3,1447,1158,-30
115348521269,115348521274,5,1567,1166,-30
115348732871,115348732875,4,3757,1305,-30
115360676021,115360676025,4,2182,1823,-30
115361094506,115361094507,1,1708,1415,-30
115365643630,115365643635,5,1845,1112,-30
115366551710,115366551707,-3,1022,3039,-30
115368406215,115368406220,5,2499,1594,-30
115370421695,115370421690,-5,47418,128170,-30
115374807830,115374807835,5,2163,1331,-30
115391776026,115391776032,6,2253,1135,-30
115393268198,115393268203,5,2584,1300,-30
115394859731,115394859738,7,1502,1301,-30
115402656686,115402656689,3,2538,1445,-30
115408867934,115408867939,5,2565,1293,-30
115411650573,115411650579,6,3350,1547,-30
115412760015,115412760021,6,2120,1297,-30
115413061838,115413061817,-21,1487,586,-30
115414693703,115414693707,4,2054,962,-30
115421603097,115421603102,5,2607,1309,-30
115422284828,115422284834,6,1698,925,-30
115423839542,115423839547,5,2419,1198,-30
115424392966,115424392971,5,1785,953,-30
115424663693,115424663712,19,1314,152,-30
115426910760,115426910765,5,2529,1350,-30
115429025396,115429025400,4,2296,1280,-30
115431172282,115431172289,7,2516,1007,-30
115431972347,115431972352,5,25621,47191,-30
115433461043,115433461044,1,1483,1335,-30
115435243966,115435243967,1,1902,1643,-30
115436653329,115436653334,5,2345,1429,-30
115437151065,115437151064,-1,550,186,-30
115437296237,115437296241,4,1860,1146,-30
115439345995,115439346001,6,2461,1314,-30
115448701619,115448701618,-1,868,1686,-30
115448837966,115448837971,5,829,531,-30
115454981162,115454981166,4,2204,1468,-30
115460501810,115460501814,4,1779,1764,-30
115464050485,115464050490,5,2904,1560,-30
115464269234,115464269239,5,1863,1576,-30
115466172937,115466172941,4,2836,1364,-30
115471219546,115471219554,8,8115,2506,-30
115475292478,115475292484,6,3520,1477,-30
115476289163,115476289169,6,1916,1164,-30
115476350222,115476350204,-18,1238,547,-30
115476829649,115476829654,5,948,616,-30
115480844091,115480844095,4,2283,1458,-30
115482745356,115482745362,6,3673,1536,-30
115483065917,115483065923,6,2328,1197,-30
115483389086,115483389094,8,2723,1434,-30
115485619858,115485619863,5,1568,1420,-30
115486300507,115486300513,6,2410,1444,-30
115495743885,115495743889,4,1838,1595,-30
115497129008,115497129011,3,1511,1261,-30
115497498584,115497498586,2,1400,1073,-30
115498720838,115498720842,4,2645,1597,-30
115500280970,115500280975,5,2813,1296,-30
115501367313,115501367319,6,2611,1403,-30
115502361179,115502361173,-6,1324,8860,-30
115503444026,115503444032,6,3123,1317,-30
115503968003,115503967998,-5,1604,5522,-30
115505124201,115505124201,0,32450,19758,-30
115508621344,115508621347,3,2221,1347,-30
115510217850,115510217856,6,1713,1185,-30
115512293625,115512293630,5,2301,1274,-30
115513384022,115513384027,5,2892,1424,-30
115515751145,115515751150,5,3086,1176,-30
115516521513,115516521520,7,3595,1291,-30
115519410225,115519410229,4,1850,1070,-30
115520472762,115520472766,4,2715,1338,-30
115525659045,115525659050,5,2232,1093,-30
115532341876,115532341881,5,2989,1555,-30
115532971595,115532971603,8,2858,1387,-30
115537057776,115537057781,5,1817,1461,-30
115538649959,115538649962,3,1741,1404,-30
115543343414,115543343419,5,2999,1588,-30
115552346070,115552346074,4,1834,1146,-30
115556560316,115556560322,6,2291,1710,-30
115556997173,115556997179,6,2011,959,-30
115560998966,115560998973,7,2059,1170,-30
115564748772,115564748776,4,2598,1497,-30
115564774949,115564774963,14,1886,1614,-30
115566093762,115566093766,4,1569,1294,-30
115566618876,115566618857,-19,1404,909,-30
115571437975,115571437954,-21,1083,1419,-30
115576401158,115576401162,4,1908,887,-30
115579882529,115579882535,6,2175,1269,-30
115581033437,115581033442,5,1735,807,-30
115581232574,115581232578,4,1210,1059,-30
115582160425,115582160430,5,1775,1321,-30
115583507337,115583507342,5,2865,1053,-30
115584024961,115584024945,-16,863,555,-30
115586889754,115586889758,4,2632,1364,-30
115594501312,115594501318,6,2774,1129,-30
115597439010,115597439014,4,2501,632,-30
115602089679,115602089685,6,3008,1774,-30
115602797049,115602797058,9,5463,1429,-30
115617006883,115617006888,5,1515,949,-30
115618606447,115618606451,4,1940,1305,-30
115618658846,115618658849,3,1675,1185,-30
115620440350,115620440356,6,2389,1154,-30
115622176386,115622176392,6,2711,1154,-30
115626096893,115626096898,5,1865,899,-30
115631877894,115631877900,6,2840,1477,-30
115631979926,115631979932,6,2340,833,-30
115633563742,115633563747,5,2017,1132,-30
115639023948,115639023953,5,2814,1386,-30
115639206603,115639206607,4,1414,884,-30
115642115525,115642115530,5,2109,944,-30
115642729193,115642729198,5,2647,1363,-30
115647224705,115647224708,3,802,483,-30
115650327101,115650327107,6,2521,1304,-30
115653665285,115653665289,4,2340,1516,-30
115656470362,115656470367,5,2316,1463,-30
115659848220,115659848216,-4,1141,3071,-30
115660082247,115660082243,-4,1240,2466,-30
115663064336,115663064336,0,1601,3025,-30
115663667298,115663667290,-8,30664,13555,-30
115664370527,115664370532,5,2677,1943,-30
115666102347,115666102352,5,2346,1526,-30
115667711922,115667711929,7,2029,927,-30
115668438902,115668438894,-8,829,5167,-30
115672745113,115672745118,5,3237,1669,-30
115673292535,115673292542,7,2817,1266,-30
115677576012,115677576017,5,2074,1307,-30
115679238750,115679238753,3,1429,1815,-30
115681448764,115681448769,5,2026,1386,-30
115688142298,115688142302,4,2875,1247,-30
115689031447,115689031426,-21,1246,229,-30
115689124000,115689124006,6,1770,656,-30
115696482116,115696482122,6,1537,814,-30
115699503334,115699503338,4,1626,922,-30
115700664621,115700664625,4,2476,1195,-30
115704071197,115704071199,2,1962,1147,-30
115705062821,115705062825,4,1714,1551,-30
115705745787,115705745793,6,2215,1230,-30
115707763662,115707763667,5,1896,1154,-30
115710988461,115710988466,5,52277,28122,-30
115718085138,115718085142,4,2733,1273,-30
115723082956,115723082960,4,3086,1561,-30
115727834575,115727834579,4,2736,1142,-30
115728084270,115728084277,7,2219,1418,-30
115728752661,115728752662,1,1644,3130,-30
115728862382,115728862386,4,2266,1294,-30
115731960594,115731960598,4,2401,1492,-30
115748170690,115748170695,5,2898,1480,-30
115749832997,115749833001,4,2083,1743,-30
115752294078,115752294086,8,2836,1579,-30
115753295217,115753295223,6,1654,1008,-30
115754100732,115754100737,5,2313,1340,-30
115754240317,115754240298,-19,1881,1371,-30
115755590597,115755590576,-21,679,74,-30
115757410129,115757410131,2,1648,1177,-30
115758399042,115758399047,5,2356,1297,-30
115758562709,115758562711,2,2207,1624,-30
115759702427,115759702431,4,2441,1605,-30
115760332562,115760332566,4,2096,1504,-30
115760606889,115760606894,5,2610,1452,-30
115760995758,115760995763,5,899,449,-30
115763083665,115763083670,5,2801,1645,-30
115763286570,115763286585,15,2517,1096,-30
115764251215,115764251220,5,3601,1382,-30
115764420535,115764420539,4,2600,1434,-30
115764626842,115764626848,6,2244,1544,-30
115765187339,115765187339,0,100,853,-30
115768295490,115768295494,4,2239,1451,-30
115772978266,115772978271,5,2766,1224,-30
115773062030,115773062033,3,1542,1504,-30
115781835310,115781835315,5,1750,892,-30
115784297212,115784297217,5,1785,1427,-30
115786170753,115786170757,4,2103,1218,-30
115790425524,115790425530,6,3017,1993,-30
115792711373,115792711378,5,1963,1311,-30
115792837887,115792837882,-5,473,61,-30
115794081339,115794081342,3,1810,1094,-30
115796184013,115796184019,6,2891,1682,-30
115796588609,115796588615,6,2645,850,-30
115802133049,115802133053,4,2415,1840,-30
115804038888,115804038894,6,2229,766,-30
115809600077,115809600081,4,1651,931,-30
115810431650,115810431656,6,2259,842,-30
115811986177,115811986182,5,3042,1297,-30
115814743642,115814743647,5,1814,1177,-30
115815469995,115815469998,3,1833,1111,-30
115816416007,115816416010,3,637,1049,-30
115818780021,115818780027,6,2358,1174,-30
115821427761,115821427766,5,2603,1122,-30
115824831284,115824831289,5,2552,1162,-30
115826215846,115826215851,5,3251,1245,-30
115828105715,115828105721,6,2649,1172,-30
115828636597,115828636576,-21,2312,1674,-30
115830104465,115830104469,4,2368,1241,-30
115830818545,115830818557,12,10677,46422,-30
115833036511,115833036514,3,1929,890,-30
115833357197,115833357177,-20,1318,937,-30
115838512027,115838512024,-3,2577,5171,-30
115838791189,115838791194,5,1336,954,-30
115840685182,115840685187,5,1948,1129,-30
115842072602,115842072606,4,2040,915,-30
115843021193,115843021197,4,2482,1301,-30
115844963731,115844963736,5,2192,1565,-30
115846937921,115846937925,4,1105,945,-30
115850719617,115850719622,5,2014,1264,-30
115855698988,115855698992,4,2453,1906,-30
115859229093,115859229097,4,2019,1487,-30
115861834341,115861834349,8,2927,1451,-30
115861971954,115861971939,-15,784,280,-30
115862939061,115862939068,7,1228,831,-30
115864299450,115864299455,5,1913,1304,-30
115864512849,115864512853,4,2829,1721,-30
115865326650,115865326655,5,1954,992,-30
115865799232,115865799238,6,2763,1629,-30
115868192891,115868192894,3,3645,1067,-30
115873419443,115873419450,7,3180,1483,-30
115875252087,115875252091,4,1967,1042,-30
115876985278,115876985283,5,2558,1901,-30
115877676202,115877676205,3,1400,889,-30
115880081504,115880081502,-2,942,1400,-30
115881957137,115881957142,5,2880,1373,-30
115891768129,115891768134,5,2332,1346,-30
115892616610,115892616615,5,1612,1027,-30
115893306043,115893306049,6,2818,1297,-30
115894216638,115894216642,4,2312,1397,-30
115894283933,115894283938,5,2771,1256,-30
115894991317,115894991337,20,676,402,-30
115897465243,115897465247,4,1723,903,-30
115898100816,115898100821,5,2388,1865,-30
115901627498,115901627504,6,2878,1582,-30
115908658790,115908658798,8,3620,1788,-30
115911696011,115911696015,4,2768,1706,-30
115916945717,115916945722,5,1803,945,-30
115917220231,115917220237,6,2095,1945,-30
115917721582,115917721587,5,2183,1312,-30
115918510298,115918510301,3,2575,1376,-30
115920575925,115920575928,3,2525,1570,-30
115921425605,115921425610,5,3015,1448,-30
115922515121,115922515120,-1,1505,2802,-30
115926248993,115926248998,5,2696,1127,-30
115926906295,115926906294,-1,1212,1687,-30
115930746255,115930746261,6,2781,1240,-30
115931524706,115931524710,4,1704,1685,-30
115933388050,115933388057,7,2297,1573,-30
115934317761,115934317747,-14,1112,739,-30
115939991133,115939991138,5,2047,1246,-30
115940575478,115940575483,5,1955,1739,-30
115941874240,115941874221,-19,1488,717,-30
115946110238,115946110243,5,2041,1119,-30
115947465522,115947465527,5,2818,1361,-30
115948453054,115948453061,7,1764,915,-30
115949991484,115949991486,2,1945,1369,-30
115950537598,115950537603,5,1942,1496,-30
115950788338,115950788343,5,1501,1221,-30
115952999942,115952999946,4,1791,1631,-30
115957103992,115957103994,2,2391,796,-30
115959823574,115959823579,5,2210,1519,-30
115960417696,115960417702,6,3301,1975,-30
115966252878,115966252893,15,1944,1329,-30
115969811999,115969812005,6,2281,1117,-30
115970645386,115970645386,0,1086,1413,-30
115971924953,115971924949,-4,938,2557,-30
115974629368,115974629373,5,2711,1704,-30
115974654909,115974654913,4,2709,1349,-30
115978013293,115978013294,1,12469,13396,-30
115978335765,115978335772,7,2166,1090,-30
115980283367,115980283347,-20,1639,738,-30
115981125019,115981125023,4,1225,652,-30
115981547881,115981547885,4,1484,976,-30
115985001598,115985001599,1,1352,1598,-30
115985075521,115985075523,2,1498,1450,-30
115987970682,115987970683,1,1176,1368,-30
115988640603,115988640608,5,2360,1433,-30
115989558502,115989558507,5,1555,1528,-30
115990097938,115990097935,-3,97,1145,-30
115990889063,115990889067,4,2236,1846,-30
116000021838,116000021842,4,2741,1178,-30
116002422156,116002422161,5,2198,1289,-30
116002783939,116002783943,4,1901,1150,-30
116003272509,116003272513,4,2156,1299,-30
116005046064,116005046069,5,3434,978,-30
116005941513,116005941517,4,1746,1519,-30
116008079901,116008079905,4,2687,1278,-30
116008674536,116008674543,7,1499,1051,-30
116010478835,116010478840,5,2627,1488,-30
116014915686,116014915690,4,2091,1166,-30
116016184853,116016184859,6,2541,1542,-30
116020888782,116020888786,4,2272,1447,-30
116021105330,116021105330,0,1581,1615,-30
116026104753,116026104757,4,2733,1077,-30
116027880344,116027880350,6,2621,1563,-30
116028152325,116028152330,5,1689,785,-30
116028641237,116028641242,5,2126,1439,-30
116031744841,116031744846,5,1293,727,-30
116033528501,116033528506,5,1733,1207,-30
116036555991,116036555970,-21,2027,1377,-30
116038674243,116038674250,7,2143,1737,-30
116043322813,116043322818,5,1928,1709,-30
116043501957,116043501977,20,1156,255,-30
116046427186,116046427191,5,2667,1839,-30
116049145286,116049145291,5,1619,1204,-30
116050555980,116050555983,3,1595,896,-30
116058446969,116058446973,4,3089,1780,-30
116060534626,116060534633,7,2244,1091,-30
116060964206,116060964212,6,2159,1145,-30
116061759044,116061759047,3,1969,1331,-30
116063044455,116063044454,-1,1084,1868,-30
116076467458,116076467463,5,40830,2792,-30
116076537430,116076537436,6,1888,1298,-30
116076801395,116076801399,4,1727,1275,-30
116078987101,116078987106,5,3488,1809,-30
116080351575,116080351581,6,2523,1341,-30
116082795972,116082795974,2,61283,34426,-30
116083456008,116083456013,5,1438,951,-30
116083689997,116083690003,6,1566,1227,-30
116094853054,116094853058,4,910,920,-30
116097100100,116097100098,-2,319,2000,-30
116101919981,116101919985,4,2509,1120,-30
116105154299,116105154303,4,1669,882,-30
116107595058,116107595063,5,6549,29015,-30
116108259238,116108259242,4,2293,1674,-30
116111320230,116111320235,5,1641,901,-30
116112344386,116112344390,4,2286,891,-30
116112754522,116112754522,0,24301,19698,-30
116115697938,116115697943,5,2261,1235,-30
116120631697,116120631698,1,1692,1028,-30
116125134094,116125134099,5,1831,1502,-30
116125295582,116125295586,4,1418,1472,-30
116132371045,116132371049,4,1695,772,-30
116138841182,116138841187,5,2187,1209,-30
116138866713,116138866718,5,2116,1067,-30
116139874215,116139874221,6,1748,1313,-30
116144309742,116144309746,4,2240,1091,-30
116147544722,116147544726,4,2550,1728,-30
116149502138,116149502143,5,2569,1222,-30
116155485742,116155485746,4,1884,734,-30
116155573674,116155573669,-5,3371,10672,-30
116156053007,116156053011,4,2322,1289,-30
116159624074,116159624058,-16,1045,233,-30
116162903988,116162903993,5,2602,1998,-30
116162982382,116162982387,5,1847,1111,-30
116163569224,116163569210,-14,2608,1620,-30
116167791015,116167791020,5,1681,866,-30
116168434125,116168434146,21,1219,223,-30
116173573594,116173573598,4,1408,1381,-30
116174199908,116174199911,3,2352,2012,-30
116175699686,116175699690,4,2021,1419,-30
116178611689,116178611696,7,2895,1246,-30
116179143973,116179143993,20,2696,995,-30
116182004880,116182004885,5,2463,1887,-30
116182505302,116182505301,-1,1336,1497,-30
116183940599,116183940603,4,1414,1015,-30
116188265100,116188265107,7,1848,1009,-30
116188412874,116188412882,8,6849,2175,-30
116190162497,116190162501,4,3173,1359,-30
116190964167,116190964170,3,1340,1647,-30
116194029142,116194029147,5,2995,1828,-30
116194091749,116194091754,5,3253,1760,-30
116198108050,116198108055,5,2150,1149,-30
116202047471,116202047474,3,2761,1428,-30
116204136558,116204136559,1,1262,1096,-30
116204239599,116204239607,8,2611,1375,-30
116204481984,116204481987,3,1720,1151,-30
116207462542,116207462547,5,2679,1808,-30
116208911673,116208911677,4,2328,1163,-30
116212294600,116212294605,5,2384,1238,-30
116212707083,116212707091,8,24077,45358,-30
116214475790,116214475794,4,3011,1313,-30
116215013562,116215013566,4,1890,1246,-30
116217041962,116217041966,4,2436,1179,-30
116219772006,116219772009,3,4632,3171,-30
116220945190,116220945196,6,2190,1212,-30
116221137476,116221137460,-16,1707,1106,-30
116223895547,116223895551,4,1443,1066,-30
116232463915,116232463920,5,1921,1223,-30
116234789473,116234789471,-2,1047,2113,-30
116235352112,116235352117,5,2288,1580,-30
116243074194,116243074199,5,2496,1167,-30
116248249171,116248249177,6,3038,1738,-30
116248809766,116248809770,4,1300,907,-30
116250287866,116250287870,4,2208,1236,-30
116252556995,116252556998,3,2820,2020,-30
116252620974,116252620978,4,2053,888,-30
116253595179,116253595160,-19,620,593,-30
116257901314,116257901319,5,2290,1165,-30
116262767777,116262767782,5,2105,1263,-30
116267204489,116267204494,5,2234,1325,-30
116269261310,116269261312,2,4109,3401,-30
116271143555,116271143563,8,3272,1340,-30
116272006204,116272006210,6,2277,868,-30
116272292934,116272292940,6,2415,1446,-30
116276770705,116276770711,6,2616,1140,-30
116281768446,116281768449,3,2115,1464,-30
116289031652,116289031658,6,1836,1515,-30
116289966958,116289966956,-2,1592,2738,-30
116290539997,116290540001,4,1878,1085,-30
116291287777,116291287782,5,1111,1212,-30
116293552507,116293552502,-5,1862,5783,-30
116301771181,116301771186,5,1989,1195,-30
116307378061,116307378069,8,2647,1187,-30
116308607205,116308607210,5,2462,1117,-30
116311574167,116311574162,-5,715,2126,-30
116312004552,116312004555,3,2344,1257,-30
116313811363,116313811367,4,1894,1029,-30
116314064186,116314064191,5,2399,1276,-30
116323683450,116323683455,5,2740,1288,-30
116324529858,116324529864,6,1857,1014,-30
116332270682,116332270661,-21,1891,1016,-30
116337181059,116337181063,4,2394,1586,-30
116338663421,116338663426,5,2669,1362,-30
116339428868,116339428874,6,2119,1022,-30
116339920289,116339920293,4,2511,1493,-30
116343838218,116343838223,5,3292,1579,-30
116344480326,116344480330,4,1235,1128,-30
116344761842,116344761826,-16,2575,1720,-30
116345954606,116345954611,5,1733,925,-30
116346525474,116346525468,-6,49332,21546,-30
116350343753,116350343758,5,1634,1014,-30
116352052897,116352052902,5,1993,1505,-30
116356735867,116356735869,2,31008,20563,-30
116362442858,116362442863,5,1779,922,-30
116365626314,116365626318,4,2391,1129,-30
116365979681,116365979665,-16,2097,1261,-30
116368723293,116368723306,13,21,1383,-30
116374300983,116374300989,6,1260,1172,-30
116378220301,116378220306,5,2047,1039,-30
116378590719,116378590697,-22,2313,1235,-30
116380656458,116380656453,-5,2272,10813,-30
116382176038,116382176042,4,1740,953,-30
116383681541,116383681545,4,1580,1277,-30
116386982151,116386982155,4,1630,1324,-30
116387563689,116387563697,8,2073,1125,-30
116390975597,116390975601,4,2525,1728,-30
116391836077,116391836080,3,2523,1614,-30
116396190297,116396190304,7,1497,1021,-30
116401574462,116401574443,-19,1580,1019,-30
116403654275,116403654281,6,1546,1177,-30
116406672853,116406672858,5,1934,1327,-30
116409370858,116409370862,4,2461,1338,-30
116412089541,116412089546,5,3096,1664,-30
116412890471,116412890466,-5,983,2836,-30
116414540115,116414540122,7,2349,1074,-30
116414609637,116414609649,12,2030,1134,-30
116417510377,116417510382,5,2277,1158,-30
116418944566,116418944571,5,2738,1310,-30
116419176555,116419176559,4,2419,1069,-30
116420808492,116420808498,6,2332,1343,-30
116423382741,116423382747,6,2204,1306,-30
116428019349,116428019354,5,1774,1249,-30
116430810799,116430810803,4,2205,1077,-30
116433716118,116433716124,6,2424,1525,-30
116434040322,116434040338,16,2763,1338,-30
116435238830,116435238835,5,2217,1190,-30
116435336014,116435336018,4,1436,1060,-30
116452578925,116452578931,6,1784,1449,-30
116457226852,116457226871,19,15791,31846,-30
116457745806,116457745810,4,1944,1166,-30
116459131678,116459131683,5,3053,1522,-30
116462548175,116462548178,3,2629,1362,-30
116463368010,116463367996,-14,1034,579,-30
116463952043,116463952052,9,1733,1060,-30
116464370402,116464370407,5,2138,1289,-30
116469076386,116469076391,5,2731,1363,-30
116470355217,116470355222,5,3076,1540,-30
116471439989,116471439994,5,2871,1470,-30
116473321743,116473321749,6,1916,1134,-30
116478012162,116478012167,5,3004,1491,-30
116481564185,116481564191,6,2034,1658,-30
116481752658,116481752666,8,824,699,-30
116482462037,116482462043,6,2087,1196,-30
116482599462,116482599466,4,2388,1243,-30
116483253479,116483253482,3,42766,8277,-30
116486884759,116486884762,3,1711,1220,-30
116487143713,116487143713,0,2880,2765,-30
116493431848,116493431852,4,2838,1777,-30
116493564409,116493564416,7,2358,1331,-30
116493975075,116493975078,3,1711,1203,-30
116495892577,116495892580,3,2576,1314,-30
116502492030,116502492034,4,1906,1521,-30
116504602311,116504602318,7,2400,1278,-30
116505355500,116505355505,5,1389,935,-30
116506293766,116506293787,21,1983,1280,-30
116506526564,116506526569,5,2207,1373,-30
116508419787,116508419792,5,2360,1568,-30
116508938546,116508938548,2,1189,1426,-30
116513756121,116513756122,1,1715,1255,-30
116515118473,116515118477,4,2595,1406,-30
116517710681,116517710685,4,1851,1289,-30
116520875975,116520875979,4,1583,1241,-30
116525426730,116525426734,4,1666,911,-30
116525590705,116525590709,4,2030,1101,-30
116528392783,116528392789,6,2581,1903,-30
116537531144,116537531151,7,1832,1013,-30
116538912506,116538912512,6,1675,922,-30
116541818150,116541818152,2,2096,2415,-30
116544672450,116544672457,7,1895,1623,-30
116544815960,116544815964,4,2141,1785,-30
116546037912,116546037918,6,2192,1284,-30
116549012426,116549012430,4,2240,1589,-30
116555370442,116555370445,3,1565,1459,-30
116558061731,116558061735,4,1471,1195,-30
116559548522,116559548529,7,1840,1387,-30
116561999999,116562000004,5,2082,1476,-30
116566940351,116566940357,6,2953,1258,-30
116569808405,116569808409,4,2421,1760,-30
116574561372,116574561378,6,2055,1229,-30
116574638277,116574638298,21,1942,1053,-30
116574777803,116574777810,7,2436,1440,-30
116575031579,116575031563,-16,1348,768,-30
116576630846,116576630849,3,1474,1362,-30
116577723420,116577723426,6,1687,964,-30
116582783848,116582783850,2,1457,1508,-30
116583931266,116583931271,5,2079,1359,-30
116587507985,116587507990,5,2811,1144,-30
116588667233,116588667237,4,2652,1225,-30
116624635684,116624635691,7,2114,1284,-30
116628422841,116628422842,1,3759,5265,-30
116633940342,116633940348,6,2501,1224,-30
116634490859,116634490863,4,2042,985,-30
116634620798,116634620819,21,2513,1472,-30
116638297506,116638297511,5,4599,2518,-30
116643608046,116643608053,7,2062,1384,-30
116647301436,116647301439,3,2296,1853,-30
116648337540,116648337545,5,1644,1672,-30
116651260597,116651260602,5,1916,1244,-30
116651979775,116651979778,3,1997,1207,-30
116652568475,116652568455,-20,1293,939,-30
116655420427,116655420430,3,2023,977,-30
116655518081,116655518083,2,811,303,-30
116656196367,116656196370,3,1957,1284,-30
116658402095,116658402102,7,3014,1095,-30
116658908066,116658908073,7,1515,846,-30
116659402880,116659402886,6,3630,1402,-30
116659451382,116659451389,7,2061,1380,-30
116660224368,116660224356,-12,1449,678,-30
116662185990,116662186002,12,357,1032,-30
116664987359,116664987366,7,3093,1913,-30
116671884806,116671884810,4,2732,1287,-30
116674004457,116674004461,4,2081,1340,-30
116674329223,116674329201,-22,2000,790,-30
116675019575,116675019580,5,2226,1454,-30
116677080465,116677080472,7,2822,1611,-30
116679889774,116679889779,5,4152,3388,-30
116680039166,116680039177,11,15572,19939,-30
116683180417,116683180422,5,1892,1020,-30
116685631998,116685632002,4,2503,1405,-30
116686324486,116686324490,4,2142,924,-30
116686449979,116686449986,7,4355,1411,-30
116686563257,116686563262,5,2819,1626,-30
116689535224,116689535229,5,2648,1670,-30
116689828243,116689828247,4,2696,1321,-30
116690076422,116690076426,4,925,188,-30
116691777759,116691777755,-4,1825,3181,-30
116691955471,116691955476,5,2310,1551,-30
116692191313,116692191319,6,2086,1206,-30
116694629458,116694629463,5,1718,1248,-30
116696239658,116696239658,0,1157,1598,-30
116699793256,116699793258,2,1615,905,-30
116700197553,116700197539,-14,2941,1219,-30
116700589418,116700589423,5,2054,1010,-30
116701277508,116701277513,5,2669,1584,-30
116702610857,116702610861,4,2474,1254,-30
116704822863,116704822869,6,2508,1421,-30
116709294775,116709294778,3,1801,1335,-30
116713917539,116713917544,5,2493,1304,-30
116715603811,116715603818,7,1536,918,-30
116730391275,116730391278,3,1400,1276,-30
116731221142,116731221147,5,1280,1134,-30
116732160693,116732160697,4,1908,1441,-30
116732738166,116732738170,4,2147,1376,-30
116736808849,116736808853,4,2379,978,-30
116737809858,116737809864,6,2581,1443,-30
116738247058,116738247073,15,1881,1026,-30
116738504622,116738504626,4,2728,1814,-30
116739499995,116739500000,5,2833,1359,-30
116742331198,116742331203,5,1505,1049,-30
116747106808,116747106808,0,1737,1014,-30
116747443210,116747443216,6,2607,1212,-30
116748429663,116748429649,-14,1195,347,-30
116750719606,116750719610,4,2035,906,-30
116751441886,116751441891,5,2081,1641,-30
116755433286,116755433289,3,2004,1430,-30
116756044607,116756044610,3,1545,1501,-30
116763512959,116763512963,4,2215,744,-30
116763868394,116763868377,-17,3232,1235,-30
116766444143,116766444148,5,2468,1844,-30
116767151006,116767151001,-5,1946,6727,-30
116771896983,116771896988,5,2682,1437,-30
116775089481,116775089484,3,2188,1387,-30
116775221742,116775221746,4,1870,1462,-30
116782668021,116782668027,6,3711,1665,-30
116785355410,116785355411,1,1241,2188,-30
116786477172,116786477169,-3,1522,4864,-30
116787769786,116787769791,5,3121,1310,-30
116788694305,116788694310,5,3014,1625,-30
116791143650,116791143655,5,2193,1393,-30
116791506199,116791506203,4,1007,517,-30
116793129658,116793129661,3,2051,1095,-30
116795144601,116795144596,-5,915,3812,-30
116798696770,116798696774,4,1701,1032,-30
116806922122,116806922122,0,1833,1774,-30
116814653096,116814653100,4,2592,1866,-30
116815124505,116815124510,5,1702,1020,-30
116816119655,116816119658,3,2090,1121,-30
116817699384,116817699387,3,2038,1140,-30
116818976178,116818976183,5,1038,1230,-30
116819639043,116819639047,4,2298,1358,-30
116821077284,116821077288,4,2173,1697,-30
116822242298,116822242303,5,1962,668,-30
116823341567,116823341572,5,2148,1573,-30
116827901568,116827901574,6,2589,1304,-30
116828162444,116828162449,5,2308,1106,-30
116830605754,116830605758,4,1735,1054,-30
116831910051,116831910057,6,2526,941,-30
116832157318,116832157323,5,1477,808,-30
116835097593,116835097595,2,2074,1585,-30
116841372060,116841372065,5,2119,1261,-30
116842998889,116842998895,6,1770,1175,-30
116844324109,116844324114,5,2678,1152,-30
116844785149,116844785128,-21,612,365,-30
116847792791,116847792795,4,2253,1168,-30
116849797533,116849797539,6,1859,1046,-30
116858615670,116858615669,-1,2302,2738,-30
116860168444,116860168450,6,919,373,-30
116860971454,116860971459,5,2411,1384,-30
116861584882,116861584887,5,2524,1065,-30
116863386833,116863386830,-3,1072,2784,-30
116865099624,116865099629,5,7110,33814,-30
116866391397,116866391401,4,2513,1179,-30
116866513651,116866513634,-17,853,460,-30
116866997570,116866997574,4,2752,1397,-30
116867383605,116867383609,4,2479,1331,-30
116867556854,116867556866,12,2100,1160,-30
116869859444,116869859449,5,2916,1333,-30
116872513160,116872513144,-16,1839,1180,-30
116876419735,116876419739,4,2256,1113,-30
116879272046,116879272065,19,1589,1019,-30
116879677807,116879677786,-21,3012,1551,-30
116884343301,116884343281,-20,792,207,-30
116884982535,116884982540,5,530,88,-30
116886061159,116886061166,7,2364,1341,-30
116887508950,116887508954,4,2234,1232,-30
116887701992,116887701997,5,2118,1550,-30
116888065977,116888065981,4,2445,1351,-30
116888197723,116888197712,-11,644,185,-30
116888823237,116888823241,4,2060,1002,-30
116888940626,116888940632,6,2232,1456,-30
116893165414,116893165418,4,1952,1220,-30
116896644205,116896644210,5,2153,1219,-30
116898592965,116898592970,5,2106,1380,-30
116900807124,116900807130,6,2899,1296,-30
116901231896,116901231901,5,1567,1183,-30
116903645078,116903645086,8,2030,862,-30
116904073193,116904073194,1,3851,3165,-30
116904632630,116904632633,3,1927,1146,-30
116905622930,116905622931,1,1738,1060,-30
116910372948,116910372942,-6,40884,19663,-30
116911455670,116911455675,5,2522,1607,-30
116914557266,116914557278,12,187,681,-30
116915764648,116915764654,6,2691,1032,-30
116917968030,116917968034,4,1771,1085,-30
116918379628,116918379610,-18,508,343,-30
116919775951,116919775950,-1,795,854,-30
116920138305,116920138321,16,1518,1451,-30
116920765962,116920765944,-18,462,548,-30
116924564186,116924564186,0,1440,1526,-30
116927502058,116927502062,4,1599,1302,-30
116930143950,116930143955,5,2649,1230,-30
116931816119,116931816125,6,2307,1321,-30
116932367718,116932367723,5,1753,1043,-30
116933910949,116933910954,5,1445,671,-30
116936421349,116936421353,4,2422,1745,-30
116939094021,116939094026,5,2280,1216,-30
116940305720,116940305717,-3,1542,3122,-30
116941490452,116941490458,6,1970,1330,-30
116941536917,116941536922,5,478,573,-30
116942406179,116942406177,-2,931,318,-30
116943811973,116943811974,1,1585,1142,-30
116944220895,116944220901,6,2592,1265,-30
116944402621,116944402604,-17,1343,545,-30
116947842234,116947842238,4,2177,1198,-30
116953114810,116953114804,-6,1328,3344,-30
116956446086,116956446092,6,2465,1382,-30
116959909986,116959909991,5,1832,1204,-30
116965035910,116965035914,4,1991,1079,-30
116969391115,116969391120,5,2683,1863,-30
116970499709,116970499714,5,1378,1101,-30
116970597028,116970597031,3,1476,821,-30
116970994791,116970994790,-1,1372,1152,-30
116972854070,116972854075,5,1306,689,-30
116973470821,116973470803,-18,2524,1160,-30
116974376993,116974376997,4,2053,1546,-30
116974712409,116974712414,5,4692,3223,-30
116978483970,116978483973,3,2273,1878,-30
116988943252,116988943254,2,1569,1028,-30
116989732854,116989732858,4,2270,1042,-30
116990304478,116990304482,4,2183,1202,-30
116991815658,116991815663,5,2296,1323,-30
116992891331,116992891336,5,2492,1357,-30
116993910639,116993910622,-17,2918,1416,-30
116996629134,116996629143,9,705,827,-30
116996791964,116996791970,6,2600,915,-30
116997252475,116997252457,-18,2268,844,-30
116998947198,116998947202,4,2282,1333,-30
116999116903,116999116905,2,1940,1648,-30
116999930526,116999930531,5,2136,1043,-30
117007785822,117007785840,18,1932,1234,-30
117009281418,117009281426,8,2354,1148,-30
117010595826,117010595847,21,3755,1431,-30
117010971597,117010971602,5,2771,1726,-30
117015539962,117015539966,4,2667,1542,-30
117016058757,117016058771,14,593,112,-30
117016750146,117016750151,5,2524,1038,-30
117022889042,117022889046,4,1953,1402,-30
117025406826,117025406830,4,1827,1447,-30
117026288342,117026288321,-21,2317,1225,-30
117026515080,117026515087,7,2341,1244,-30
117030961038,117030961041,3,2794,1797,-30
117035168958,117035168963,5,2688,889,-30
117035640014,117035640018,4,2193,1371,-30
117037141446,117037141449,3,2405,1420,-30
117039770365,117039770369,4,2193,1165,-30
117041425706,117041425711,5,1779,1213,-30
117042370531,117042370538,7,3150,1450,-30
117043477966,117043477973,7,2238,1146,-30
117044186227,117044186232,5,2439,1231,-30
117044669201,117044669206,5,1726,1213,-30
117045575455,117045575461,6,2056,1178,-30
117047597517,117047597522,5,2442,1094,-30
117047733404,117047733409,5,2290,1370,-30
117047975974,117047975978,4,3345,1614,-30
117049839514,117049839521,7,2933,1141,-30
117050045998,117050046002,4,1571,2153,-30
117053186069,117053186074,5,2244,1418,-30
117053726143,117053726149,6,2400,1328,-30
117056653089,117056653095,6,2126,1121,-30
117059486708,117059486713,5,2300,1281,-30
117060765597,117060765601,4,1931,1416,-30
117062386546,117062386553,7,2783,1691,-30
117068329030,117068329038,8,4197,1815,-30
117069100249,117069100254,5,1880,1421,-30
117077539746,117077539752,6,2120,1733,-30
117079044562,117079044568,6,2460,1113,-30
117079797407,117079797424,17,2595,1484,-30
117079833708,117079833688,-20,1983,896,-30
117081642577,117081642582,5,1816,1419,-30
117085040247,117085040252,5,2511,1568,-30
117085803025,117085803020,-5,977,3073,-30
117086134135,117086134137,2,1083,1763,-30
117086823833,117086823837,4,2118,1213,-30
117089424521,117089424527,6,2658,1233,-30
117091563810,117091563814,4,963,1135,-30
117092185598,117092185579,-19,2548,916,-30
117097765059,117097765063,4,2436,1296,-30
117099214146,117099214150,4,1820,1215,-30
117099662001,117099662008,7,2457,1450,-30
117100952257,117100952263,6,3499,1209,-30
117102388746,117102388751,5,1565,940,-30
117102911132,117102911137,5,2139,1682,-30
117107245455,117107245459,4,1816,1526,-30
117109161005,117109161009,4,1920,1453,-30
117110271151,117110271156,5,2180,1741,-30
117111217245,117111217243,-2,1471,2097,-30
117117039937,117117039932,-5,1065,3952,-30
117118326184,117118326190,6,2973,2359,-30
117120906924,117120906923,-1,1317,1916,-30
117126120214,117126120219,5,1142,752,-30
117131154073,117131154078,5,1949,996,-30
117133224114,117133224118,4,2429,1399,-30
117133868331,117133868324,-7,2049,9000,-30
117136223200,117136223194,-6,1068,2742,-30
117137772353,117137772356,3,1250,1102,-30
117139122782,117139122787,5,2377,1334,-30
117140683984,117140683989,5,2066,1502,-30
117144861153,117144861158,5,2404,1425,-30
117149436669,117149436675,6,2182,1803,-30
117149614610,117149614617,7,3019,1276,-30
117154580024,117154580029,5,2144,1209,-30
117154904753,117154904759,6,3537,1407,-30
117156353131,117156353137,6,1644,1027,-30
117157971869,117157971873,4,3005,1807,-30
117158091468,117158091475,7,2154,1154,-30
117159866757,117159866762,5,1957,1089,-30
117161071384,117161071389,5,2510,1442,-30
117165906237,117165906243,6,2101,1228,-30
117168483910,117168483917,7,2065,1643,-30
117168677634,117168677639,5,1913,950,-30
117170958587,117170958584,-3,877,2463,-30
117177639654,117177639659,5,2238,1085,-30
117178897793,117178897799,6,1606,1120,-30
117179634332,117179634338,6,2162,1009,-30
117180091772,117180091754,-18,1225,373,-30
117184347863,117184347869,6,1913,1378,-30
117189242701,117189242705,4,1535,1440,-30
117190017084,117190017090,6,1643,965,-30
117190177518,117190177522,4,2710,1668,-30
117193809313,117193809318,5,3642,1619,-30
117197307268,117197307273,5,1767,1385,-30
117203083402,117203083406,4,1862,1239,-30
117203748402,117203748403,1,1543,1155,-30
117205734883,117205734890,7,2442,1379,-30
117206104906,117206104909,3,2067,1559,-30
117206195290,117206195298,8,2752,1160,-30
117206475887,117206475892,5,1792,1355,-30
117207059120,117207059125,5,1800,1696,-30
117207465366,117207465369,3,2386,1630,-30
117208037342,117208037349,7,2180,1005,-30
117210630157,117210630161,4,870,1090,-30
117210961987,117210961993,6,2125,1069,-30
117211965389,117211965394,5,2220,1071,-30
117215762035,117215762041,6,2052,790,-30
117216296903,117216296883,-20,1756,868,-30
117216818518,117216818523,5,1872,1308,-30
117217068403,117217068386,-17,912,393,-30
117217781730,117217781735,5,1852,854,-30
117218460602,117218460607,5,2267,1318,-30
117227955703,117227955707,4,1483,869,-30
117228028870,117228028880,10,845,201,-30
117228395793,117228395798,5,2764,1078,-30
117231682838,117231682843,5,1339,1052,-30
117235313346,117235313353,7,2094,1432,-30
117241874471,117241874478,7,2290,1485,-30
117242343457,117242343464,7,1859,1316,-30
117244612794,117244612798,4,2274,1457,-30
117248007670,117248007663,-7,1542,9786,-30
117254749398,117254749404,6,3051,1949,-30
117265804715,117265804720,5,2926,1594,-30
117266146246,117266146253,7,3166,1842,-30
117266701355,117266701339,-16,49,431,-30
117269658512,117269658519,7,1990,1218,-30
117271161485,117271161485,0,1103,2171,-30
117272447230,117272447237,7,1780,1469,-30
117274085267,117274085260,-7,54,725,-30
117276352693,117276352697,4,3394,1631,-30
117276809569,117276809575,6,1656,820,-30
117276932200,117276932211,11,2512,1504,-30
117283523634,117283523635,1,1272,1042,-30
117284194114,117284194100,-14,2330,1152,-30
117287049729,117287049734,5,2660,1454,-30
117287997524,117287997527,3,1807,1354,-30
117294605415,117294605416,1,2904,3288,-30
117296087366,117296087371,5,2658,1497,-30
117296296253,117296296258,5,1763,1815,-30
117297760403,117297760409,6,1444,816,-30
117304282557,117304282562,5,2344,1818,-30
117305730092,117305730096,4,3166,1441,-30
117306719211,117306719214,3,2418,917,-30
117307687575,117307687586,11,2006,1214,-30
117310792962,117310792969,7,2482,1582,-30
117312891377,117312891383,6,3175,1590,-30
117313579191,117313579196,5,2208,1539,-30
117315150295,117315150299,4,1573,1002,-30
117315686299,117315686293,-6,1821,6972,-30
117316563493,117316563498,5,1592,1020,-30
117321328061,117321328062,1,1318,1387,-30
117323295635,117323295639,4,2585,1166,-30
117323791650,117323791655,5,4731,3047,-30
117325729307,117325729311,4,3179,1302,-30
117326886367,117326886373,6,2329,1170,-30
117327587021,117327587024,3,1341,1653,-30
117336597399,117336597405,6,2195,1591,-30
117336739658,117336739662,4,1751,933,-30
117338809474,117338809478,4,3821,1530,-30
117345202842,117345202843,1,1872,1838,-30
117351320058,117351320065,7,2525,1450,-30
117353079642,117353079647,5,1951,1132,-30
117356470601,117356470606,5,2519,1372,-30
117359084233,117359084239,6,1483,897,-30
117360505238,117360505244,6,2216,1465,-30
117364214397,117364214402,5,2210,840,-30
117364921677,117364921684,7,1724,929,-30
117370870822,117370870828,6,2039,923,-30
117371862498,117371862503,5,1880,1166,-30
117373748512,117373748519,7,1930,1058,-30
117375994364,117375994370,6,1805,1163,-30
117376725698,117376725690,-8,2000,12990,-30
117380886961,117380886965,4,1319,1240,-30
117381361524,117381361539,15,2617,1609,-30
117382481934,117382481935,1,1828,1448,-30
117383482254,117383482262,8,1727,873,-30
117387064504,117387064509,5,1510,719,-30
117389235648,117389235653,5,1724,1091,-30
117389270006,117389269993,-13,689,311,-30
117395125357,117395125363,6,1582,887,-30
117397010025,117397010038,13,6189,52691,-30
117399604859,117399604866,7,2027,982,-30
117402820431,117402820433,2,2196,1921,-30
117404295215,117404295219,4,1781,1274,-30
117408028721,117408028727,6,1174,1108,-30
117414448312,117414448326,14,17513,39141,-30
117418371151,117418371154,3,1527,1216,-30
117419177766,117419177775,9,3789,1154,-30
117419978038,117419978043,5,1947,1553,-30
117421920651,117421920654,3,1406,1672,-30
117423384314,117423384318,4,1979,1420,-30
117438689079,117438689092,13,15658,28890,-30
117441369763,117441369768,5,2578,1454,-30
117441762758,117441762763,5,2910,1514,-30
117445817223,117445817226,3,2766,1686,-30
117452865006,117452865011,5,2156,1380,-30
117461030342,117461030333,-9,604,251,-30
117465115096,117465115100,4,2592,896,-30
117466777416,117466777423,7,2310,1220,-30
117469914614,117469914609,-5,1867,3351,-30
117471550955,117471550954,-1,1742,3233,-30
117471680367,117471680373,6,2385,1288,-30
117474004155,117474004167,12,13733,21032,-30
117476656009,117476656012,3,1763,1387,-30
117477866049,117477866053,4,2933,1484,-30
117483240002,117483240009,7,83980,34352,-30
117488198089,117488198095,6,1502,1000,-30
117492185059,117492185063,4,2074,825,-30
117492485817,117492485822,5,3529,2244,-30
117495184756,117495184775,19,9,2090,-30
117495740780,117495740782,2,3352,2773,-30
117500139377,117500139382,5,2920,1741,-30
117500846251,117500846247,-4,1412,3528,-30
117501873586,117501873591,5,2544,1347,-30
117503045461,117503045465,4,1825,1694,-30
117504014351,117504014355,4,2309,1746,-30
117504530848,117504530855,7,5617,1680,-30
117504603877,117504603883,6,2843,1597,-30
117504929206,117504929211,5,2145,835,-30
117507572533,117507572537,4,2741,1122,-30
117509357221,117509357240,19,578,212,-30
117511986993,117511986998,5,2106,1147,-30
117514216231,117514216234,3,2316,2152,-30
117518579902,117518579900,-2,1037,1490,-30
117519949701,117519949708,7,2207,1268,-30
117522701165,117522701170,5,2036,1237,-30
117524579973,117524579956,-17,1913,741,-30
117529902409,117529902413,4,2263,1701,-30
117533673130,117533673134,4,2406,1082,-30
117537357582,117537357588,6,3313,1656,-30
117539111781,117539111785,4,1764,1442,-30
117539261537,117539261524,-13,1879,1036,-30
117539728588,117539728593,5,1485,764,-30
117543698408,117543698414,6,2337,912,-30
117544883915,117544883917,2,1120,1068,-30
117551375916,117551375921,5,2584,1397,-30
117555357758,117555357763,5,2644,1143,-30
117556205420,117556205405,-15,3119,1252,-30
117562365183,117562365189,6,2123,1157,-30
117562896867,117562896864,-3,1534,4553,-30
117565883913,117565883919,6,2452,1485,-30
117567625573,117567625577,4,2445,1558,-30
117569789130,117569789136,6,3991,1494,-30
117570832598,117570832602,4,2118,1352,-30
117574493207,117574493213,6,2386,1749,-30
117578647486,117578647478,-8,1157,5016,-30
117579502861,117579502867,6,2677,1318,-30
117581060635,117581060639,4,2892,2127,-30
117583124249,117583124229,-20,952,2631,-30
117585756798,117585756803,5,1823,1097,-30
117588395616,117588395619,3,1907,1125,-30
117594628969,117594628976,7,2070,1179,-30
117594846535,117594846540,5,1948,1318,-30
117596266904,117596266910,6,1438,1352,-30
117600860934,117600860940,6,2889,1221,-30
117604398823,117604398826,3,1519,1372,-30
117604481796,117604481800,4,2721,1860,-30
117606645028,117606645034,6,1639,1275,-30
117607068074,117607068074,0,1326,1422,-30
117609638571,117609638573,2,1602,1238,-30
117618591048,117618591050,2,2334,1254,-30
117622015730,117622015735,5,2868,1689,-30
117622186982,117622186976,-6,2424,5360,-30
117624022767,117624022772,5,1904,1690,-30
117626643798,117626643804,6,2653,1071,-30
117630104789,117630104793,4,1848,1272,-30
117631093776,117631093781,5,2556,1737,-30
117634465597,117634465602,5,2030,1565,-30
117636841715,117636841718,3,1856,1185,-30
117638297791,117638297798,7,2712,1307,-30
117639188294,117639188302,8,3269,1312,-30
117641356537,117641356546,9,838,310,-30
117642741193,117642741197,4,3216,1701,-30
117651721719,117651721723,4,2115,2019,-30
117652582914,117652582917,3,1508,875,-30
117658546072,117658546078,6,1664,1414,-30
117661353042,117661353043,1,2021,2712,-30
117663897226,117663897230,4,1329,853,-30
117666186258,117666186262,4,2891,1561,-30
117668055298,117668055301,3,2615,1489,-30
117671486246,117671486250,4,2194,1778,-30
117672366398,117672366404,6,2721,1386,-30
117674394653,117674394658,5,2446,1164,-30
117675627101,117675627106,5,2753,1710,-30
117677302098,117677302103,5,2158,1159,-30
117681701350,117681701355,5,1440,906,-30
117683946078,117683946078,0,1068,1027,-30
117685049810,117685049811,1,2870,2775,-30
117687501006,117687501010,4,1978,1312,-30
117689445046,117689445050,4,1825,742,-30
117689726789,117689726793,4,2479,1773,-30
117695050497,117695050501,4,13243,8658,-30
117696381471,117696381475,4,906,565,-30
117698747346,117698747360,14,4,1249,-30
117710008494,117710008501,7,2451,1003,-30
117711620718,117711620725,7,2214,1518,-30
117716563409,117716563413,4,1857,1243,-30
117716760198,117716760187,-11,1662,590,-30
117717513861,117717513866,5,1778,1097,-30
117721825122,117721825125,3,1718,1050,-30
117724404638,117724404643,5,2013,1240,-30
117724837501,117724837482,-19,2579,1207,-30
117725575051,117725575055,4,2678,1671,-30
117726428826,117726428830,4,2532,800,-30
117727219918,117727219910,-8,659,3461,-30
117728275599,117728275605,6,3090,1469,-30
117732657301,117732657305,4,1506,1249,-30
117733840961,117733840964,3,3591,2986,-30
117735105718,117735105720,2,34198,36068,-30
117735660009,117735660008,-1,1207,1703,-30
117736951564,117736951570,6,1592,827,-30
117737464583,117737464590,7,2735,1536,-30
117740697133,117740697139,6,2036,1228,-30
117741305028,117741305035,7,283,1878,-30
117741896959,117741896964,5,2576,1621,-30
117742188033,117742188037,4,2383,1763,-30
117743210704,117743210710,6,2164,1308,-30
117745094007,117745094012,5,2200,1125,-30
117745829541,117745829546,5,1627,1383,-30
117747922474,117747922471,-3,1338,3527,-30
117749482641,117749482647,6,2441,1443,-30
117749838108,117749838113,5,3219,1316,-30
117750682617,117750682622,5,2861,1261,-30
117757548113,117757548119,6,2294,1506,-30
117761593327,117761593334,7,2221,1011,-30
117762210414,117762210413,-1,1338,1056,-30
117762704046,117762704048,2,8359,6654,-30
117765728605,117765728611,6,3358,1340,-30
117770108446,117770108447,1,1422,1653,-30
117772516486,117772516494,8,5836,2824,-30
117774160190,117774160195,5,1239,1349,-30
117776839210,117776839194,-16,2731,1078,-30
117779249321,117779249325,4,1831,1451,-30
117795177216,117795177221,5,1546,1059,-30
117797915248,117797915252,4,1154,844,-30
117798140958,117798140969,11,3798,1402,-30
117798471235,117798471241,6,2248,1008,-30
117799900262,117799900262,0,2219,3415,-30
117801054646,117801054649,3,1235,865,-30
117803889812,117803889817,5,2219,1309,-30
117803988930,117803988938,8,1188,744,-30
117805086493,117805086498,5,4003,1802,-30
117805138951,117805138958,7,2993,1054,-30
117809420980,117809420985,5,2160,1184,-30
117824220746,117824220751,5,2000,1050,-30
117827035485,117827035491,6,2424,1238,-30
117829954201,117829954206,5,2828,1720,-30
117831168115,117831168122,7,2935,1134,-30
117831609775,117831609794,19,364,219,-30
117831746427,117831746431,4,2266,1119,-30
117834086490,117834086494,4,1810,1302,-30
117834597963,117834597966,3,1901,1326,-30
117840889558,117840889562,4,1923,898,-30
117841111990,117841111972,-18,2418,1094,-30
117841973037,117841973041,4,1695,1090,-30
117842130342,117842130363,21,2848,1362,-30
117843469848,117843469854,6,2915,1421,-30
117845120340,117845120344,4,2001,1620,-30
117848313687,117848313671,-16,1774,1085,-30
117849512141,117849512146,5,1744,1351,-30
117854426427,117854426430,3,2504,1888,-30
117860241409,117860241418,9,3208,1187,-30
117861306797,117861306802,5,2333,1108,-30
117861808196,117861808201,5,1180,1036,-30
117862290918,117862290921,3,2117,1433,-30
117862509617,117862509623,6,2312,1187,-30
117863350018,117863350023,5,2950,1790,-30
117864728070,117864728076,6,2172,1531,-30
117867670575,117867670577,2,642,936,-30
117871948501,117871948505,4,2123,1110,-30
117876083867,117876083874,7,2653,1416,-30
117876352707,117876352712,5,2244,1039,-30
117878180310,117878180314,4,2161,1007,-30
117882847613,117882847618,5,1765,1200,-30
117882906913,117882906922,9,2877,1506,-30
117884077106,117884077090,-16,1923,1144,-30
117886276426,117886276432,6,1980,1188,-30
117887807294,117887807301,7,2193,1076,-30
117888513514,117888513518,4,2198,598,-30
117889461327,117889461333,6,1829,1287,-30
117890083254,117890083251,-3,1190,2588,-30
117890195842,117890195848,6,3074,1792,-30
117890941715,117890941713,-2,1120,2559,-30
117891313173,117891313179,6,1829,902,-30
117892355117,117892355120,3,1175,1028,-30
117896729749,117896729753,4,1777,1200,-30
117901060290,117901060294,4,1680,1213,-30
117902175958,117902175959,1,2753,1724,-30
117902905754,117902905759,5,3217,1247,-30
117903859660,117903859657,-3,1282,2768,-30
117904365707,117904365711,4,2694,1254,-30
117904895714,117904895719,5,2336,1320,-30
117905834725,117905834730,5,2863,1599,-30
117909456102,117909456105,3,2257,1970,-30
117910081057,117910081061,4,2381,1576,-30
117912912278,117912912283,5,1878,1381,-30
117916082375,117916082382,7,2903,1012,-30
117918620886,117918620890,4,1646,1088,-30
117921150450,117921150430,-20,964,426,-30
117921621141,117921621148,7,3025,1137,-30
117922787142,117922787147,5,2698,1481,-30
117927456257,117927456265,8,1543,1291,-30
117931112725,117931112730,5,2782,1298,-30
117934011770,117934011763,-7,1087,4651,-30
117935065804,117935065808,4,2902,1401,-30
117936519538,117936519543,5,2211,1231,-30
117941960327,117941960330,3,1825,1580,-30
117942225556,117942225554,-2,864,1012,-30
117943646906,117943646911,5,2716,1753,-30
117948241338,117948241342,4,1149,657,-30
117951059463,117951059469,6,1507,980,-30
117951570342,117951570347,5,1660,1117,-30
117955673585,117955673591,6,1706,1144,-30
117957832882,117957832887,5,2282,1512,-30
117960595713,117960595719,6,2547,1630,-30
117961937767,117961937772,5,2786,1800,-30
117969448581,117969448586,5,2004,1158,-30
117971885095,117971885093,-2,1321,2289,-30
117972063128,117972063132,4,2101,1315,-30
117973562121,117973562123,2,2331,1548,-30
117976296763,117976296763,0,1449,2147,-30
117976549917,117976549921,4,800,803,-30
117977017347,117977017351,4,2042,1301,-30
117977678510,117977678515,5,3085,1469,-30
117980142317,117980142322,5,3096,1117,-30
117982984968,117982984973,5,2198,1418,-30
117983404325,117983404331,6,2459,1588,-30
117992757535,117992757530,-5,969,3016,-30
117993251763,117993251741,-22,268,1994,-30
117995805258,117995805262,4,2197,1482,-30
117996260317,117996260322,5,3282,3043,-30
117998794065,117998794071,6,1920,1203,-30
118000006361,118000006367,6,2418,1501,-30
118003153014,118003153019,5,2067,1353,-30
118003482697,118003482705,8,1310,979,-30
118003741490,118003741496,6,3447,1512,-30
118005596215,118005596210,-5,1360,4352,-30
118007167871,118007167884,13,302,6305,-30
118007940520,118007940526,6,1649,1652,-30
118008846825,118008846829,4,2419,1155,-30
118009695935,118009695932,-3,2500,4489,-30
118016436574,118016436578,4,1801,1036,-30
118016895562,118016895566,4,1656,1196,-30
118018004501,118018004507,6,1386,671,-30
118022646542,118022646547,5,1810,1127,-30
118025654314,118025654322,8,2435,877,-30
118027141450,118027141455,5,3968,1690,-30
118027517314,118027517321,7,1968,993,-30
118028002569,118028002573,4,2708,1277,-30
118032372846,118032372851,5,3288,1571,-30
118033162006,118033162014,8,8406,2899,-30
118037188018,118037188020,2,3082,2732,-30
118042300374,118042300379,5,1972,1339,-30
118053354391,118053354395,4,1682,740,-30
118056354778,118056354783,5,1911,1410,-30
118057166671,118057166674,3,2471,2272,-30
118062635205,118062635211,6,2983,1303,-30
118066007790,118066007795,5,2406,1447,-30
118067017493,118067017498,5,1471,1397,-30
118070878031,118070878035,4,1357,889,-30
118073607858,118073607841,-17,2918,1297,-30
118078261074,118078261079,5,2666,1439,-30
118080057373,118080057378,5,2496,1700,-30
118083133513,118083133517,4,2375,1214,-30
118084764929,118084764930,1,1420,1183,-30
118085393482,118085393464,-18,1675,852,-30
118094809337,118094809320,-17,2675,1361,-30
118098147127,118098147129,2,1362,991,-30
118098239058,118098239073,15,2042,1107,-30
118100509159,118100509164,5,2139,1033,-30
118100962237,118100962243,6,2869,1289,-30
118106103962,118106103969,7,1953,1116,-30
118110459966,118110459974,8,1853,972,-30
118112901233,118112901238,5,2160,1446,-30
118113970558,118113970565,7,918,832,-30
118123060666,118123060669,3,2143,1167,-30
118126879469,118126879473,4,2523,1137,-30
118127443005,118127443011,6,2575,1126,-30
118149096146,118149096149,3,1972,1919,-30
118149997105,118149997109,4,1716,1435,-30
118155242927,118155242932,5,1501,1215,-30
118155486287,118155486266,-21,1450,1094,-30
118155753369,118155753373,4,2622,1403,-30
118161186190,118161186190,0,2298,2691,-30
118161327368,118161327372,4,2762,1521,-30
118166315559,118166315564,5,2488,1432,-30
118166511888,118166511897,9,2214,1092,-30
118169127729,118169127734,5,2653,921,-30
118171858026,118171858022,-4,6876,17387,-30
118178688471,118178688474,3,2387,1456,-30
118181758358,118181758365,7,2342,1541,-30
118182952424,118182952429,5,1575,1446,-30
118183789086,118183789089,3,1143,809,-30
118188430885,118188430889,4,2483,1720,-30
118190758091,118190758080,-11,1715,1283,-30
118194772328,118194772333,5,2064,1427,-30
118195039769,118195039773,4,2480,1205,-30
118196755178,118196755182,4,2498,1228,-30
118198279302,118198279307,5,1848,1112,-30
118205744727,118205744733,6,5655,1847,-30
118207590610,118207590616,6,2575,1021,-30
118209505718,118209505725,7,2534,1610,-30
118209922689,118209922672,-17,2313,971,-30
118212057134,118212057141,7,2549,1546,-30
118212095260,118212095272,12,728,208,-30
118213029154,118213029158,4,2962,1577,-30
118218961166,118218961171,5,1827,1297,-30
118220506039,118220506047,8,2253,857,-30
118223436193,118223436195,2,1540,1060,-30
118225422491,118225422495,4,1806,1570,-30
118227058563,118227058567,4,2559,1784,-30
118227887077,118227887082,5,1918,1054,-30
118233792945,118233792949,4,3407,1456,-30
118236186046,118236186050,4,1256,806,-30
118237575711,118237575714,3,1570,1266,-30
118239863917,118239863923,6,2295,1190,-30
118239941166,118239941178,12,1294,765,-30
118241347567,118241347574,7,1978,1322,-30
118244040571,118244040577,6,2274,1071,-30
118244135889,118244135887,-2,1542,1883,-30
118244233106,118244233111,5,2129,1164,-30
118245510835,118245510842,7,2745,2105,-30
118250783713,118250783715,2,3851,1835,-30
118250810169,118250810174,5,2128,1565,-30
118251692186,118251692189,3,1309,1340,-30
118253011594,118253011602,8,17169,21978,-30
118253522151,118253522157,6,1191,741,-30
118254288053,118254288058,5,2938,2112,-30
118255694617,118255694622,5,1753,1044,-30
118256264832,118256264835,3,2552,1641,-30
118259926746,118259926751,5,1828,925,-30
118277504229,118277504234,5,2386,1460,-30
118280087228,118280087234,6,1831,1233,-30
118281184433,118281184433,0,2109,1417,-30
118286525326,118286525330,4,2174,1182,-30
118286699283,118286699288,5,1617,1198,-30
118287505004,118287505008,4,1953,1057,-30
118290579697,118290579699,2,1359,1089,-30
118300607453,118300607459,6,2762,1855,-30
118302085210,118302085214,4,1910,1194,-30
118303236783,118303236783,0,1343,2413,-30
118311988806,118311988812,6,2562,1610,-30
118317197369,118317197374,5,2706,1097,-30
118320198410,118320198416,6,3202,1268,-30
118320750846,118320750826,-20,1158,623,-30
118322123406,118322123411,5,2217,852,-30
118322317838,118322317842,4,1507,1300,-30
118323926818,118323926823,5,2670,2231,-30
118329569906,118329569911,5,3265,1820,-30
118330885605,118330885610,5,2376,1592,-30
118331734967,118331734967,0,1761,2286,-30
118332857021,118332857027,6,1861,1321,-30
118335797130,118335797135,5,2361,1136,-30
118346814722,118346814726,4,2508,1590,-30
118349199311,118349199317,6,1690,1084,-30
118350052249,118350052254,5,2150,1136,-30
118350879800,118350879805,5,2337,1370,-30
118351224665,118351224659,-6,784,331,-30
118352357587,118352357593,6,2479,1878,-30
118354320749,118354320755,6,2274,1532,-30
118355479011,118355479015,4,2194,1270,-30
118355591610,118355591614,4,2629,1218,-30
118357598262,118357598266,4,2104,675,-30
118359235722,118359235726,4,2334,1366,-30
118359616847,118359616850,3,1940,1110,-30
118360400352,118360400355,3,2260,1494,-30
118363060618,118363060623,5,2994,1522,-30
118371387251,118371387257,6,2903,1140,-30
118372968329,118372968335,6,2420,1524,-30
118374194610,118374194616,6,3058,1404,-30
118377607242,118377607247,5,2270,1633,-30
118379792197,118379792201,4,1711,1698,-30
118385353693,118385353698,5,1594,1232,-30
118387943047,118387943053,6,3182,1504,-30
118388019162,118388019166,4,2110,1738,-30
118389693093,118389693080,-13,2957,1177,-30
118394868056,118394868061,5,2874,1217,-30
118402354058,118402354063,5,2976,1024,-30
118403480034,118403480038,4,2041,1124,-30
118406015746,118406015752,6,3532,1698,-30
118406571981,118406571986,5,1980,1358,-30
118406750394,118406750380,-14,1371,1223,-30
118408916705,118408916709,4,2451,1113,-30
118412404818,118412404823,5,3474,1574,-30
118418839556,118418839561,5,1585,904,-30
118420584782,118420584786,4,2660,1101,-30
118426088091,118426088098,7,1878,1236,-30
118432883277,118432883263,-14,4321,13533,-30
118434096334,118434096329,-5,1661,5720,-30
118436249250,118436249248,-2,7978,14263,-30
118439547936,118439547940,4,1833,1002,-30
118440029750,118440029755,5,2242,1515,-30
118440090629,118440090629,0,1993,2272,-30
118445824747,118445824755,8,2127,1877,-30
118450976573,118450976579,6,1788,1054,-30
118451567728,118451567734,6,2217,1270,-30
118452403942,118452403945,3,1978,1091,-30
118454988827,118454988827,0,1727,2093,-30
118455056498,118455056492,-6,1493,4280,-30
118455254414,118455254421,7,14369,20126,-30
118455393681,118455393688,7,2889,1333,-30
118457730538,118457730534,-4,16211,17055,-30
118459179147,118459179151,4,1538,1380,-30
118461132406,118461132409,3,2161,1354,-30
118462060055,118462060062,7,2937,1535,-30
118464853762,118464853766,4,2368,1378,-30
118466218827,118466218833,6,2177,1306,-30
118468576059,118468576063,4,2100,1046,-30
118468997022,118468997021,-1,7,1548,-30
118471464489,118471464492,3,1955,1405,-30
118472036239,118472036242,3,937,1378,-30
118474755965,118474755970,5,2666,1659,-30
118475043582,118475043587,5,3273,1418,-30
118476787741,118476787746,5,1981,1385,-30
118480593447,118480593451,4,3311,1830,-30
118483992793,118483992799,6,2019,1394,-30
118491927622,118491927627,5,2055,847,-30
118495404662,118495404666,4,2450,1778,-30
118497189024,118497189029,5,1883,1475,-30
118507870282,118507870288,6,2456,1201,-30
118509879715,118509879720,5,2439,2179,-30
118511148835,118511148841,6,2389,1389,-30
118511531427,118511531431,4,1896,1754,-30
118515896407,118515896413,6,2845,2149,-30
118520032166,118520032169,3,2161,1529,-30
118520292754,118520292738,-16,1433,444,-30
118520502961,118520502965,4,1615,1474,-30
118520783078,118520783082,4,1252,945,-30
118522218346,118522218349,3,2612,2066,-30
118523114412,118523114419,7,6918,2817,-30
118523305305,118523305313,8,2859,1052,-30
118523861858,118523861863,5,2474,1350,-30
118524154828,118524154831,3,2744,1412,-30
118525465044,118525465050,6,2607,1833,-30
118527239245,118527239250,5,2083,1089,-30
118532538102,118532538095,-7,1406,7435,-30
118532739852,118532739859,7,1757,1089,-30
118535570013,118535570020,7,2726,886,-30
118535671004,118535670987,-17,1229,993,-30
118536732927,118536732934,7,3451,1335,-30
118538568701,118538568695,-6,1030,3452,-30
118539766069,118539766072,3,1702,1064,-30
118541233686,118541233689,3,1724,1152,-30
118543773977,118543773982,5,2326,1598,-30
118545347098,118545347102,4,2264,1261,-30
118546433684,118546433689,5,2610,1188,-30
118547440421,118547440425,4,1728,1264,-30
118550520033,118550520035,2,1986,1669,-30
118552300573,118552300579,6,2775,1095,-30
118558160827,118558160833,6,2018,1274,-30
118563052760,118563052757,-3,2585,5759,-30
118567083699,118567083681,-18,1327,808,-30
118568525615,118568525619,4,3032,1284,-30
118573230907,118573230911,4,1751,824,-30
118577672871,118577672875,4,2816,1535,-30
118577937966,118577937972,6,2192,1673,-30
118579491598,118579491605,7,3185,1674,-30
118579949217,118579949222,5,2167,964,-30
118580064682,118580064683,1,1379,2146,-30
118580640846,118580640852,6,2037,1395,-30
118581549203,118581549193,-10,948,1769,-30
118582263097,118582263101,4,2605,1505,-30
118582830953,118582830957,4,1751,1323,-30
118582870567,118582870572,5,2800,1194,-30
118584838000,118584837997,-3,988,2510,-30
118585631454,118585631459,5,2573,2054,-30
118592363318,118592363322,4,2008,1047,-30
118594921336,118594921342,6,2185,1302,-30
118606117935,118606117943,8,3429,1410,-30
118607929436,118607929439,3,1851,1579,-30
118608363374,118608363378,4,2008,886,-30
118609546906,118609546911,5,2498,2069,-30
118618005732,118618005735,3,1795,1219,-30
118618191718,118618191722,4,1941,1180,-30
118620391167,118620391171,4,1893,1609,-30
118621217113,118621217116,3,2387,1235,-30
118621433186,118621433192,6,3186,1710,-30
118623677022,118623677026,4,2499,1461,-30
118623987482,118623987487,5,2648,1230,-30
118625986049,118625986055,6,2315,1097,-30
118629474260,118629474262,2,2304,2045,-30
118630269666,118630269672,6,3378,1620,-30
118631814198,118631814203,5,2464,1285,-30
118634665794,118634665797,3,1362,900,-30
118635329713,118635329718,5,2327,1217,-30
118641820177,118641820182,5,1523,1183,-30
118642830762,118642830748,-14,2366,966,-30
118644525914,118644525919,5,2316,1224,-30
118645991393,118645991397,4,2580,1626,-30
118648966457,118648966461,4,1051,736,-30
118650032482,118650032486,4,2448,1290,-30
118652311002,118652311007,5,2248,1320,-30
118652792583,118652792587,4,2704,1694,-30
118658903659,118658903662,3,1147,1008,-30
118665027245,118665027247,2,1687,1281,-30
